data,concelho,confirmados_14,confirmados_1,incidencia,incidencia_categoria,incidencia_risco,tendencia_incidencia,tendencia_categoria,tendencia_desc,casos_14dias,ars,distrito,dicofre,area,population,population_65_69,population_70_74,population_75_79,population_80_84,population_85_mais,population_80_mais,population_75_mais,population_70_mais,population_65_mais,densidade_populacional,densidade_1,densidade_2,densidade_3
11-11-2020,ABRANTES,142,10,404,"[240,Max]",Muito elevada,,,,142,Lisboa e Vale do Tejo,SANTARÉM,1401,71469.08,35130,2473,2213,1730,1748,2021,3769,5499,7712,10185,49.15,14.25,10.79,7.69
11-11-2020,ÁGUEDA,206,15,447,"[240,Max]",Muito elevada,,,,206,Centro,AVEIRO,0101,33527.44,46075,3237,2713,2090,1635,1496,3131,5221,7934,11171,137.43,33.32,23.66,15.57
11-11-2020,AGUIAR DA BEIRA,8,1,172,"[120,240]",Elevada,,,,8,Centro,GUARDA,0901,20676.57,4652,304,281,235,239,148,387,622,903,1207,22.5,5.84,4.37,3.01
11-11-2020,ALANDROAL,4,0,80,"[60,120]",Moderada,,,,4,Alentejo,ÉVORA,0701,54267.81,4992,307,256,296,299,377,676,972,1228,1535,9.2,2.83,2.26,1.79
11-11-2020,ALBERGARIA-A-VELHA,109,8,451,"[240,Max]",Muito elevada,,,,109,Centro,AVEIRO,0102,15882.5,24144,1550,1298,996,687,680,1367,2363,3661,5211,152.02,32.81,23.05,14.88
11-11-2020,ALBUFEIRA,118,8,284,"[240,Max]",Muito elevada,,,,118,Algarve,FARO,0801,14066.42,41528,2067,1717,1425,985,858,1843,3268,4985,7052,295.24,50.14,35.44,23.23
11-11-2020,ALCÁCER DO SAL,32,2,274,"[240,Max]",Muito elevada,,,,32,Alentejo,SETÚBAL,1501,149987.3,11659,884,814,623,623,602,1225,1848,2662,3546,7.77,2.36,1.77,1.23
11-11-2020,ALCANENA,43,3,336,"[240,Max]",Muito elevada,,,,43,Lisboa e Vale do Tejo,SANTARÉM,1402,12732.86,12809,891,744,628,536,588,1124,1752,2496,3387,100.6,26.6,19.6,13.76
11-11-2020,ALCOBAÇA,96,7,179,"[120,240]",Elevada,,,,96,Lisboa e Vale do Tejo,LEIRIA,1001,40814.09,53555,3420,2927,2466,2059,1676,3735,6201,9128,12548,131.22,30.74,22.36,15.19
11-11-2020,ALCOCHETE,39,3,197,"[120,240]",Elevada,,,,39,Lisboa e Vale do Tejo,SETÚBAL,1502,12836.48,19787,857,834,691,476,447,923,1614,2448,3305,154.15,25.75,19.07,12.57
11-11-2020,ALCOUTIM,2,0,93,"[60,120]",Moderada,,,,2,Algarve,FARO,0802,57536.33,2159,191,188,163,190,267,457,620,808,999,3.75,1.74,1.4,1.08
11-11-2020,ALENQUER,187,13,424,"[240,Max]",Muito elevada,,,,187,Lisboa e Vale do Tejo,LISBOA,1101,30421.92,44052,2298,2062,1629,1330,1155,2485,4114,6176,8474,144.8,27.85,20.3,13.52
11-11-2020,ALFÂNDEGA DA FÉ,21,2,462,"[240,Max]",Muito elevada,,,,21,Norte,BRAGANÇA,0401,32194.64,4550,325,277,301,274,325,599,900,1177,1502,14.13,4.67,3.66,2.8
11-11-2020,ALIJÓ,51,4,480,"[240,Max]",Muito elevada,,,,51,Norte,VILA REAL,1701,29759.89,10625,766,687,635,542,666,1208,1843,2530,3296,35.7,11.08,8.5,6.19
11-11-2020,ALJEZUR,1,0,18,"[0,20]",Muito baixa,,,,1,Algarve,FARO,0803,32349.95,5594,316,336,335,320,410,730,1065,1401,1717,17.29,5.31,4.33,3.29
11-11-2020,ALJUSTREL,20,1,243,"[240,Max]",Muito elevada,,,,20,Alentejo,BEJA,0201,45847.41,8247,635,521,443,347,358,705,1148,1669,2304,17.99,5.03,3.64,2.5
11-11-2020,ALMADA,823,59,487,"[240,Max]",Muito elevada,,,,823,Lisboa e Vale do Tejo,SETÚBAL,1503,7000.89,169039,10469,9777,7876,6144,5111,11255,19131,28908,39377,2414.5,562.45,412.91,273.26
11-11-2020,ALMEIDA,21,1,360,"[240,Max]",Muito elevada,,,,21,Centro,GUARDA,0902,51798.46,5830,441,419,396,458,393,851,1247,1666,2107,11.26,4.07,3.22,2.41
11-11-2020,ALMEIRIM,81,6,359,"[240,Max]",Muito elevada,,,,81,Lisboa e Vale do Tejo,SANTARÉM,1403,22212.05,22546,1342,1353,1106,866,843,1709,2815,4168,5510,101.5,24.81,18.76,12.67
11-11-2020,ALMODÔVAR,6,0,89,"[60,120]",Moderada,,,,6,Alentejo,BEJA,0202,77788.03,6725,414,443,396,373,328,701,1097,1540,1954,8.65,2.51,1.98,1.41
11-11-2020,ALPIARÇA,3,0,42,"[20,60]",Baixa,,,,3,Lisboa e Vale do Tejo,SANTARÉM,1404,9536.33,7059,515,486,363,333,274,607,970,1456,1971,74.02,20.67,15.27,10.17
11-11-2020,ALTER DO CHÃO,6,0,190,"[120,240]",Elevada,,,,6,Alentejo,PORTALEGRE,1201,36206.62,3165,201,163,136,208,187,395,531,694,895,8.74,2.47,1.92,1.47
11-11-2020,ALVAIÁZERE,18,1,273,"[240,Max]",Muito elevada,,,,18,Centro,LEIRIA,1002,16047.76,6597,419,389,346,406,539,945,1291,1680,2099,41.11,13.08,10.47,8.04
11-11-2020,ALVITO,1,0,40,"[20,60]",Baixa,,,,1,Alentejo,BEJA,0203,26485.32,2477,145,110,105,111,89,200,305,415,560,9.35,2.11,1.57,1.15
11-11-2020,AMADORA,773,55,420,"[240,Max]",Muito elevada,,,,773,Lisboa e Vale do Tejo,LISBOA,1115,2378.47,184106,11186,10936,8780,6460,5890,12350,21130,32066,43252,7742.05,1818.84,1348.44,888.56
11-11-2020,AMARANTE,551,39,1036,"[240,Max]",Muito elevada,,,,551,Norte,PORTO,1301,30133.15,53193,3086,2413,1812,1643,1311,2954,4766,7179,10265,176.53,34.07,23.82,15.82
11-11-2020,AMARES,133,10,734,"[240,Max]",Muito elevada,,,,133,Norte,BRAGA,0301,8195.41,18129,1001,829,622,489,524,1013,1635,2464,3465,221.22,42.28,30.07,19.95
11-11-2020,ANADIA,66,5,242,"[240,Max]",Muito elevada,,,,66,Centro,AVEIRO,0103,21663.48,27258,1931,1698,1376,1208,1262,2470,3846,5544,7475,125.83,34.51,25.59,17.75
11-11-2020,ANGRA DO HEROÍSMO,17,1,50,"[20,60]",Baixa,,,,17,Açores,AÇORES,4301,23899.66,33807,2006,1473,1122,768,635,1403,2525,3998,6004,141.45,25.12,16.73,10.56
11-11-2020,ANSIÃO,30,2,249,"[240,Max]",Muito elevada,,,,30,Centro,LEIRIA,1003,17609.42,12039,727,709,646,694,530,1224,1870,2579,3306,68.37,18.77,14.65,10.62
11-11-2020,ARCOS DE VALDEVEZ,68,5,325,"[240,Max]",Muito elevada,,,,68,Norte,VIANA DO CASTELO,1601,44759.64,20926,1329,1338,1282,1343,1515,2858,4140,5478,6807,46.75,15.21,12.24,9.25
11-11-2020,ARGANIL,47,3,427,"[240,Max]",Muito elevada,,,,47,Centro,COIMBRA,0601,33283.93,11014,672,648,612,559,596,1155,1767,2415,3087,33.09,9.27,7.26,5.31
11-11-2020,ARMAMAR,8,1,139,"[120,240]",Elevada,,,,8,Norte,VISEU,1801,11723.73,5769,357,305,309,285,310,595,904,1209,1566,49.21,13.36,10.31,7.71
11-11-2020,AROUCA,155,11,748,"[240,Max]",Muito elevada,,,,155,Norte,AVEIRO,0104,32910.52,20720,1306,1047,753,683,683,1366,2119,3166,4472,62.96,13.59,9.62,6.44
11-11-2020,ARRAIOLOS,8,1,115,"[60,120]",Moderada,,,,8,Alentejo,ÉVORA,0702,68374.55,6928,435,384,283,367,480,847,1130,1514,1949,10.13,2.85,2.21,1.65
11-11-2020,ARRONCHES,16,1,567,"[240,Max]",Muito elevada,,,,16,Alentejo,PORTALEGRE,1202,31464.72,2820,155,142,162,187,179,366,528,670,825,8.96,2.62,2.13,1.68
11-11-2020,ARRUDA DOS VINHOS,49,4,318,"[240,Max]",Muito elevada,,,,49,Lisboa e Vale do Tejo,LISBOA,1102,7795.93,15412,738,738,562,509,438,947,1509,2247,2985,197.69,38.29,28.82,19.36
11-11-2020,AVEIRO,361,26,459,"[240,Max]",Muito elevada,,,,361,Centro,AVEIRO,0105,19757.57,78734,4520,4004,3050,2250,2103,4353,7403,11407,15927,398.49,80.61,57.73,37.47
11-11-2020,AVIS,3,0,71,"[60,120]",Moderada,,,,3,Alentejo,PORTALEGRE,1203,60596.51,4247,315,225,206,251,273,524,730,955,1270,7.01,2.1,1.58,1.2
11-11-2020,AZAMBUJA,99,7,436,"[240,Max]",Muito elevada,,,,99,Lisboa e Vale do Tejo,LISBOA,1103,26265.65,22716,1322,1171,1070,798,618,1416,2486,3657,4979,86.48,18.96,13.92,9.46
11-11-2020,BAIÃO,107,8,571,"[240,Max]",Muito elevada,,,,107,Norte,PORTO,1302,17452.83,18748,1070,862,714,686,725,1411,2125,2987,4057,107.42,23.25,17.11,12.18
11-11-2020,BARCELOS,928,66,799,"[240,Max]",Muito elevada,,,,928,Norte,BRAGA,0302,37890.14,116187,6721,5325,3619,2991,2562,5553,9172,14497,21218,306.64,56.0,38.26,24.21
11-11-2020,BARRANCOS,1,0,61,"[60,120]",Moderada,,,,1,Alentejo,BEJA,0204,16841.73,1634,90,65,65,94,61,155,220,285,375,9.7,2.23,1.69,1.31
11-11-2020,BARREIRO,218,16,290,"[240,Max]",Muito elevada,,,,218,Lisboa e Vale do Tejo,SETÚBAL,1504,3639.07,75147,5194,5565,4459,3105,1767,4872,9331,14896,20090,2065.05,552.07,409.34,256.42
11-11-2020,BATALHA,27,2,169,"[120,240]",Elevada,,,,27,Centro,LEIRIA,1004,10341.6,15963,873,762,649,529,549,1078,1727,2489,3362,154.35,32.51,24.07,16.7
11-11-2020,BEJA,108,8,322,"[240,Max]",Muito elevada,,,,108,Alentejo,BEJA,0205,114647.55,33579,2005,1840,1386,1272,1039,2311,3697,5537,7542,29.29,6.58,4.83,3.22
11-11-2020,BELMONTE,113,8,1766,"[240,Max]",Muito elevada,,,,113,Centro,CASTELO BRANCO,0501,11875.91,6398,444,321,325,310,355,665,990,1311,1755,53.87,14.78,11.04,8.34
11-11-2020,BENAVENTE,107,8,350,"[240,Max]",Muito elevada,,,,107,Lisboa e Vale do Tejo,SANTARÉM,1405,52138.39,30602,1468,1376,1141,876,643,1519,2660,4036,5504,58.69,10.56,7.74,5.1
11-11-2020,BOMBARRAL,7,1,56,"[20,60]",Baixa,,,,7,Lisboa e Vale do Tejo,LEIRIA,1005,9128.55,12558,875,714,561,491,429,920,1481,2195,3070,137.56,33.63,24.04,16.22
11-11-2020,BORBA,20,1,297,"[240,Max]",Muito elevada,,,,20,Alentejo,ÉVORA,0703,14518.65,6736,430,375,279,436,392,828,1107,1482,1912,46.39,13.17,10.21,7.62
11-11-2020,BOTICAS,20,1,400,"[240,Max]",Muito elevada,,,,20,Norte,VILA REAL,1702,32195.66,4998,347,306,311,305,380,685,996,1302,1649,15.52,5.12,4.04,3.09
11-11-2020,BRAGA,1505,108,824,"[240,Max]",Muito elevada,,,,1505,Norte,BRAGA,0303,18339.95,182679,10029,7963,5241,4320,3671,7991,13232,21195,31224,996.07,170.25,115.57,72.15
11-11-2020,BRAGANÇA,171,12,509,"[240,Max]",Muito elevada,,,,171,Norte,BRAGANÇA,0402,117357.27,33607,2402,1855,1652,1393,1163,2556,4208,6063,8465,28.64,7.21,5.17,3.59
11-11-2020,CABECEIRAS DE BASTO,68,5,435,"[240,Max]",Muito elevada,,,,68,Norte,BRAGA,0304,24182.16,15628,774,594,544,575,574,1149,1693,2287,3061,64.63,12.66,9.46,7.0
11-11-2020,CADAVAL,32,2,234,"[120,240]",Elevada,,,,32,Lisboa e Vale do Tejo,LISBOA,1104,17489.3,13673,813,796,756,621,625,1246,2002,2798,3611,78.18,20.65,16.0,11.45
11-11-2020,CALDAS DA RAINHA,110,8,212,"[120,240]",Elevada,,,,110,Lisboa e Vale do Tejo,LEIRIA,1006,25569.47,51912,3035,2684,2186,1899,1705,3604,5790,8474,11509,203.03,45.01,33.14,22.64
11-11-2020,CALHETA,8,1,74,"[60,120]",Moderada,,,,8,Madeira,MADEIRA,3101,11150.43,10867,576,497,507,399,415,814,1321,1818,2394,97.46,21.47,16.3,11.85
11-11-2020,CALHETA (AÇORES),0,0,0,"[0,20]",Muito baixa,,,,0,Açores,AÇORES,4501,12626.4,3184,215,159,141,139,122,261,402,561,776,25.22,6.15,4.44,3.18
11-11-2020,CÂMARA DE LOBOS,8,1,24,"[20,60]",Baixa,,,,8,Madeira,MADEIRA,3102,5216.67,33675,1396,1059,834,545,381,926,1760,2819,4215,645.49,80.79,54.03,33.74
11-11-2020,CAMINHA,154,11,970,"[240,Max]",Muito elevada,,,,154,Norte,VIANA DO CASTELO,1602,13652.14,15877,1046,944,818,646,656,1302,2120,3064,4110,116.3,30.11,22.44,15.53
11-11-2020,CAMPO MAIOR,27,2,343,"[240,Max]",Muito elevada,,,,27,Alentejo,PORTALEGRE,1204,24720.16,7874,471,364,351,279,327,606,957,1321,1792,31.85,7.25,5.34,3.87
11-11-2020,CANTANHEDE,126,9,360,"[240,Max]",Muito elevada,,,,126,Centro,COIMBRA,0602,39088.02,35011,2346,2096,1880,1709,1451,3160,5040,7136,9482,89.57,24.26,18.26,12.89
11-11-2020,CARRAZEDA DE ANSIÃES,16,1,282,"[240,Max]",Muito elevada,,,,16,Norte,BRAGANÇA,0403,27924.09,5666,424,389,391,312,465,777,1168,1557,1981,20.29,7.09,5.58,4.18
11-11-2020,CARREGAL DO SAL,10,1,108,"[60,120]",Moderada,,,,10,Centro,VISEU,1802,11689.21,9271,587,562,486,462,376,838,1324,1886,2473,79.31,21.16,16.13,11.33
11-11-2020,CARTAXO,82,6,344,"[240,Max]",Muito elevada,,,,82,Lisboa e Vale do Tejo,SANTARÉM,1406,15817.28,23843,1415,1376,1142,861,632,1493,2635,4011,5426,150.74,34.3,25.36,16.66
11-11-2020,CASCAIS,1173,84,549,"[240,Max]",Muito elevada,,,,1173,Lisboa e Vale do Tejo,LISBOA,1105,9740.17,213608,12151,11444,8680,6469,5248,11717,20397,31841,43992,2193.1,451.66,326.91,209.41
11-11-2020,CASTANHEIRA DE PÊRA,1,0,38,"[20,60]",Baixa,,,,1,Centro,LEIRIA,1007,6677.45,2614,233,195,157,190,187,377,534,729,962,39.15,14.41,10.92,8.0
11-11-2020,CASTELO BRANCO,178,13,342,"[240,Max]",Muito elevada,,,,178,Centro,CASTELO BRANCO,0502,143819.15,51987,3528,3042,2499,2229,2225,4454,6953,9995,13523,36.15,9.4,6.95,4.83
11-11-2020,CASTELO DE PAIVA,121,9,783,"[240,Max]",Muito elevada,,,,121,Norte,AVEIRO,0106,11500.53,15454,881,697,545,420,431,851,1396,2093,2974,134.37,25.86,18.2,12.14
11-11-2020,CASTELO DE VIDE,1,0,34,"[20,60]",Baixa,,,,1,Alentejo,PORTALEGRE,1205,26491.24,2919,204,173,179,147,170,317,496,669,873,11.02,3.3,2.53,1.87
11-11-2020,CASTRO DAIRE,81,6,586,"[240,Max]",Muito elevada,,,,81,Centro,VISEU,1803,37904.13,13823,942,857,765,732,773,1505,2270,3127,4069,36.47,10.74,8.25,5.99
11-11-2020,CASTRO MARIM,6,0,96,"[60,120]",Moderada,,,,6,Algarve,FARO,0804,30084.37,6237,370,345,334,322,344,666,1000,1345,1715,20.73,5.7,4.47,3.32
11-11-2020,CASTRO VERDE,5,0,72,"[60,120]",Moderada,,,,5,Alentejo,BEJA,0206,56944.23,6949,437,347,303,275,227,502,805,1152,1589,12.2,2.79,2.02,1.41
11-11-2020,CELORICO DA BEIRA,42,3,606,"[240,Max]",Muito elevada,,,,42,Centro,GUARDA,0903,24721.63,6928,430,416,363,369,535,904,1267,1683,2113,28.02,8.55,6.81,5.12
11-11-2020,CELORICO DE BASTO,118,8,620,"[240,Max]",Muito elevada,,,,118,Norte,BRAGA,0305,18107.02,19040,1001,802,668,728,729,1457,2125,2927,3928,105.15,21.69,16.17,11.74
11-11-2020,CHAMUSCA,25,2,272,"[240,Max]",Muito elevada,,,,25,Lisboa e Vale do Tejo,SANTARÉM,1407,74600.54,9197,629,583,553,465,579,1044,1597,2180,2809,12.33,3.77,2.92,2.14
11-11-2020,CHAVES,195,14,496,"[240,Max]",Muito elevada,,,,195,Norte,VILA REAL,1703,59122.95,39343,2676,2429,1991,1886,1918,3804,5795,8224,10900,66.54,18.44,13.91,9.8
11-11-2020,CINFÃES,237,17,1299,"[240,Max]",Muito elevada,,,,237,Norte,VISEU,1804,23928.76,18244,1067,902,779,734,758,1492,2271,3173,4240,76.24,17.72,13.26,9.49
11-11-2020,COIMBRA,508,36,379,"[240,Max]",Muito elevada,,,,508,Centro,COIMBRA,0603,31939.94,134166,9489,8734,6353,5139,5074,10213,16566,25300,34789,420.06,108.92,79.21,51.87
11-11-2020,CONDEIXA-A-NOVA,58,4,327,"[240,Max]",Muito elevada,,,,58,Centro,COIMBRA,0604,13867.47,17733,871,809,717,583,490,1073,1790,2599,3470,127.88,25.02,18.74,12.91
11-11-2020,CONSTÂNCIA,13,1,323,"[240,Max]",Muito elevada,,,,13,Lisboa e Vale do Tejo,SANTARÉM,1408,8036.58,4030,211,183,187,148,155,303,490,673,884,50.14,11.0,8.37,6.1
11-11-2020,CORUCHE,140,10,801,"[240,Max]",Muito elevada,,,,140,Lisboa e Vale do Tejo,SANTARÉM,1409,111572.03,17471,1294,1090,1095,1096,1019,2115,3210,4300,5594,15.66,5.01,3.85,2.88
11-11-2020,CORVO,0,0,0,"[0,20]",Muito baixa,,,,0,Açores,AÇORES,4901,1711.45,464,22,21,11,13,19,32,43,64,86,27.12,5.03,3.74,2.51
11-11-2020,COVILHÃ,192,14,410,"[240,Max]",Muito elevada,,,,192,Centro,CASTELO BRANCO,0503,55560.06,46787,3533,2998,2365,2111,2193,4304,6669,9667,13200,84.21,23.76,17.4,12.0
11-11-2020,CRATO,10,1,320,"[240,Max]",Muito elevada,,,,10,Alentejo,PORTALEGRE,1206,39806.88,3129,229,258,163,182,228,410,573,831,1060,7.86,2.66,2.09,1.44
11-11-2020,CUBA,16,1,348,"[240,Max]",Muito elevada,,,,16,Alentejo,BEJA,0207,17208.72,4595,255,233,206,190,143,333,539,772,1027,26.7,5.97,4.49,3.13
11-11-2020,ELVAS,57,4,278,"[240,Max]",Muito elevada,,,,57,Alentejo,PORTALEGRE,1207,63128.86,20528,1057,1145,902,852,810,1662,2564,3709,4766,32.52,7.55,5.88,4.06
11-11-2020,ENTRONCAMENTO,42,3,195,"[120,240]",Elevada,,,,42,Lisboa e Vale do Tejo,SANTARÉM,1410,1372.81,21558,1066,930,868,695,592,1287,2155,3085,4151,1570.14,302.33,224.69,156.96
11-11-2020,ESPINHO,261,19,884,"[240,Max]",Muito elevada,,,,261,Norte,AVEIRO,0107,2105.68,29516,2205,1993,1430,1177,960,2137,3567,5560,7765,1401.52,368.71,264.01,169.37
11-11-2020,ESPOSENDE,204,15,597,"[240,Max]",Muito elevada,,,,204,Norte,BRAGA,0306,9540.98,34177,1831,1522,1095,894,723,1617,2712,4234,6065,358.21,63.57,44.38,28.42
11-11-2020,ESTARREJA,91,7,350,"[240,Max]",Muito elevada,,,,91,Centro,AVEIRO,0108,10817.33,26006,1503,1399,1106,953,728,1681,2787,4186,5689,240.42,52.59,38.7,25.76
11-11-2020,ESTREMOZ,75,5,589,"[240,Max]",Muito elevada,,,,75,Alentejo,ÉVORA,0704,51379.95,12728,789,613,697,786,877,1663,2360,2973,3762,24.77,7.32,5.79,4.59
11-11-2020,ÉVORA,154,11,294,"[240,Max]",Muito elevada,,,,154,Alentejo,ÉVORA,0705,130707.58,52428,3569,2852,2176,1966,1803,3769,5945,8797,12366,40.11,9.46,6.73,4.55
11-11-2020,FAFE,859,61,1787,"[240,Max]",Muito elevada,,,,859,Norte,BRAGA,0307,21908.11,48060,3044,2455,1679,1403,1208,2611,4290,6745,9789,219.37,44.68,30.79,19.58
11-11-2020,FARO,213,15,349,"[240,Max]",Muito elevada,,,,213,Algarve,FARO,0805,20256.79,61015,3847,3364,2604,2055,1601,3656,6260,9624,13471,301.2,66.5,47.51,30.9
11-11-2020,FELGUEIRAS,970,69,1719,"[240,Max]",Muito elevada,,,,970,Norte,PORTO,1303,11573.75,56422,2951,2302,1601,1316,973,2289,3890,6192,9143,487.49,79.0,53.5,33.61
11-11-2020,FERREIRA DO ALENTEJO,28,2,357,"[240,Max]",Muito elevada,,,,28,Alentejo,BEJA,0208,64820.68,7845,515,414,372,343,345,688,1060,1474,1989,12.1,3.07,2.27,1.64
11-11-2020,FERREIRA DO ZÊZERE,7,1,88,"[60,120]",Moderada,,,,7,Lisboa e Vale do Tejo,SANTARÉM,1411,19038.03,7959,470,370,416,465,456,921,1337,1707,2177,41.81,11.44,8.97,7.02
11-11-2020,FIGUEIRA DA FOZ,299,21,509,"[240,Max]",Muito elevada,,,,299,Centro,COIMBRA,0605,37905.26,58747,4032,3597,2887,2495,2043,4538,7425,11022,15054,154.98,39.72,29.08,19.59
11-11-2020,FIGUEIRA DE CASTELO RODRIGO,50,4,895,"[240,Max]",Muito elevada,,,,50,Centro,GUARDA,0904,50857.46,5584,347,352,290,352,391,743,1033,1385,1732,10.98,3.41,2.72,2.03
11-11-2020,FIGUEIRÓ DOS VINHOS,6,0,108,"[60,120]",Moderada,,,,6,Centro,LEIRIA,1008,17344.0,5568,402,386,322,309,351,660,982,1368,1770,32.1,10.21,7.89,5.66
11-11-2020,FORNOS DE ALGODRES,11,1,243,"[240,Max]",Muito elevada,,,,11,Centro,GUARDA,0905,13145.05,4528,261,218,247,256,232,488,735,953,1214,34.45,9.24,7.25,5.59
11-11-2020,FREIXO DE ESPADA À CINTA,51,4,1546,"[240,Max]",Muito elevada,,,,51,Norte,BRAGANÇA,0404,24414.29,3298,211,177,231,196,189,385,616,793,1004,13.51,4.11,3.25,2.52
11-11-2020,FRONTEIRA,2,0,67,"[60,120]",Moderada,,,,2,Alentejo,PORTALEGRE,1208,24859.58,2974,213,182,149,156,168,324,473,655,868,11.96,3.49,2.63,1.9
11-11-2020,FUNCHAL,82,6,79,"[60,120]",Moderada,,,,82,Madeira,MADEIRA,3103,7616.2,104024,6382,5086,3643,2821,1990,4811,8454,13540,19922,1365.86,261.58,177.78,111.0
11-11-2020,FUNDÃO,183,13,691,"[240,Max]",Muito elevada,,,,183,Centro,CASTELO BRANCO,0504,70019.79,26495,1781,1464,1432,1357,1643,3000,4432,5896,7677,37.84,10.96,8.42,6.33
11-11-2020,GAVIÃO,6,0,184,"[120,240]",Elevada,,,,6,Alentejo,PORTALEGRE,1209,29459.45,3263,189,186,222,263,293,556,778,964,1153,11.08,3.91,3.27,2.64
11-11-2020,GÓIS,5,0,131,"[120,240]",Elevada,,,,5,Centro,COIMBRA,0606,26330.19,3805,235,199,240,233,244,477,717,916,1151,14.45,4.37,3.48,2.72
11-11-2020,GOLEGÃ,8,1,150,"[120,240]",Elevada,,,,8,Lisboa e Vale do Tejo,SANTARÉM,1412,8431.67,5339,356,299,281,243,255,498,779,1078,1434,63.32,17.01,12.78,9.24
11-11-2020,GONDOMAR,1525,109,919,"[240,Max]",Muito elevada,,,,1525,Norte,PORTO,1304,13191.76,165985,10555,8755,6222,4450,3364,7814,14036,22791,33346,1258.22,252.77,172.76,106.4
11-11-2020,GOUVEIA,17,1,137,"[120,240]",Elevada,,,,17,Centro,GUARDA,0906,30061.17,12387,871,931,780,783,810,1593,2373,3304,4175,41.21,13.89,10.99,7.89
11-11-2020,GRÂNDOLA,62,4,424,"[240,Max]",Muito elevada,,,,62,Alentejo,SETÚBAL,1505,82593.66,14639,834,834,708,688,672,1360,2068,2902,3736,17.72,4.52,3.51,2.5
11-11-2020,GUARDA,411,29,1055,"[240,Max]",Muito elevada,,,,411,Centro,GUARDA,0907,71209.58,38969,2477,2041,1686,1415,1474,2889,4575,6616,9093,54.72,12.77,9.29,6.42
11-11-2020,GUIMARÃES,2873,205,1886,"[240,Max]",Muito elevada,,,,2873,Norte,BRAGA,0308,24099.96,152309,9394,7074,4809,3877,2948,6825,11634,18708,28102,631.99,116.61,77.63,48.27
11-11-2020,HORTA,4,0,28,"[20,60]",Baixa,,,,4,Açores,AÇORES,4701,17305.53,14521,818,658,468,352,302,654,1122,1780,2598,83.91,15.01,10.29,6.48
11-11-2020,IDANHA-A-NOVA,85,6,1057,"[240,Max]",Muito elevada,,,,85,Centro,CASTELO BRANCO,0505,141633.51,8043,518,490,519,672,974,1646,2165,2655,3173,5.68,2.24,1.87,1.53
11-11-2020,ÍLHAVO,160,11,413,"[240,Max]",Muito elevada,,,,160,Centro,AVEIRO,0110,7347.55,38699,2227,1943,1444,1193,850,2043,3487,5430,7657,526.66,104.21,73.9,47.46
11-11-2020,LAGOA (FARO),37,3,163,"[120,240]",Elevada,,,,37,Algarve,FARO,0806,8825.45,22762,1314,1168,919,749,670,1419,2338,3506,4820,257.93,54.62,39.73,26.49
11-11-2020,LAGOA,8,1,54,"[20,60]",Baixa,,,,8,Açores,AÇORES,4201,4559.32,14721,536,458,349,238,235,473,822,1280,1816,322.9,39.83,28.08,18.03
11-11-2020,LAGOS,74,5,244,"[240,Max]",Muito elevada,,,,74,Algarve,FARO,0807,21299.27,30374,1744,1434,1247,1053,1029,2082,3329,4763,6507,142.61,30.55,22.36,15.63
11-11-2020,LAJES DAS FLORES,0,0,0,"[0,20]",Muito baixa,,,,0,Açores,AÇORES,4801,7004.79,1463,88,53,62,46,54,100,162,215,303,20.89,4.33,3.07,2.31
11-11-2020,LAJES DO PICO,0,0,0,"[0,20]",Muito baixa,,,,0,Açores,AÇORES,4601,15531.09,4490,304,231,223,159,162,321,544,775,1079,28.91,6.95,4.99,3.5
11-11-2020,LAMEGO,72,5,289,"[240,Max]",Muito elevada,,,,72,Norte,VISEU,1805,16542.11,24895,1639,1284,1124,898,783,1681,2805,4089,5728,150.5,34.63,24.72,16.96
11-11-2020,LEIRIA,294,21,235,"[120,240]",Elevada,,,,294,Centro,LEIRIA,1009,56508.83,125267,7389,6366,5090,3902,3159,7061,12151,18517,25906,221.68,45.84,32.77,21.5
11-11-2020,LISBOA,2935,210,576,"[240,Max]",Muito elevada,,,,2935,Lisboa e Vale do Tejo,LISBOA,1106,10005.43,509515,33197,33340,27706,23037,26770,49807,77513,110853,144050,5092.6,1439.78,1107.98,774.74
11-11-2020,LOULÉ,148,11,215,"[120,240]",Elevada,,,,148,Algarve,FARO,0808,76366.91,68697,3890,3350,2780,2358,2251,4609,7389,10739,14629,89.96,19.16,14.06,9.68
11-11-2020,LOURES,1096,78,513,"[240,Max]",Muito elevada,,,,1096,Lisboa e Vale do Tejo,LISBOA,1107,16723.99,213687,12746,12794,9644,6669,5033,11702,21346,34140,46886,1277.73,280.35,204.14,127.64
11-11-2020,LOURINHÃ,55,4,213,"[120,240]",Elevada,,,,55,Lisboa e Vale do Tejo,LISBOA,1108,14717.2,25855,1584,1243,992,842,645,1487,2479,3722,5306,175.68,36.05,25.29,16.84
11-11-2020,LOUSÃ,41,3,239,"[120,240]",Elevada,,,,41,Centro,COIMBRA,0607,13840.01,17158,946,866,658,528,450,978,1636,2502,3448,123.97,24.91,18.08,11.82
11-11-2020,LOUSADA,1572,112,3362,"[240,Max]",Muito elevada,,,,1572,Norte,PORTO,1305,9608.01,46755,2289,1698,1176,853,621,1474,2650,4348,6637,486.63,69.08,45.25,27.58
11-11-2020,MAÇÃO,3,0,48,"[20,60]",Baixa,,,,3,Lisboa e Vale do Tejo,SANTARÉM,1413,39997.98,6267,386,362,390,440,657,1097,1487,1849,2235,15.67,5.59,4.62,3.72
11-11-2020,MACEDO DE CAVALEIROS,67,5,462,"[240,Max]",Muito elevada,,,,67,Norte,BRAGANÇA,0405,69914.08,14516,1082,889,878,823,938,1761,2639,3528,4610,20.76,6.59,5.05,3.77
11-11-2020,MACHICO,6,0,30,"[20,60]",Baixa,,,,6,Madeira,MADEIRA,3104,6825.1,19981,1197,860,662,455,331,786,1448,2308,3505,292.76,51.36,33.82,21.22
11-11-2020,MADALENA,0,0,0,"[0,20]",Muito baixa,,,,0,Açores,AÇORES,4602,14712.33,5895,334,256,173,190,179,369,542,798,1132,40.07,7.69,5.42,3.68
11-11-2020,MAFRA,417,30,492,"[240,Max]",Muito elevada,,,,417,Lisboa e Vale do Tejo,LISBOA,1109,29165.5,84816,3613,3334,2839,2089,1899,3988,6827,10161,13774,290.81,47.23,34.84,23.41
11-11-2020,MAIA,1281,92,922,"[240,Max]",Muito elevada,,,,1281,Norte,PORTO,1306,8293.94,138971,7801,6617,4512,3339,2631,5970,10482,17099,24900,1675.56,300.22,206.16,126.38
11-11-2020,MANGUALDE,90,6,486,"[240,Max]",Muito elevada,,,,90,Centro,VISEU,1806,21925.56,18510,1198,1128,885,852,743,1595,2480,3608,4806,84.42,21.92,16.46,11.31
11-11-2020,MANTEIGAS,79,6,2627,"[240,Max]",Muito elevada,,,,79,Centro,GUARDA,0908,12197.55,3007,258,197,159,167,146,313,472,669,927,24.65,7.6,5.48,3.87
11-11-2020,MARCO DE CANAVESES,710,51,1379,"[240,Max]",Muito elevada,,,,710,Norte,PORTO,1307,20188.98,51496,2678,2060,1488,1265,1023,2288,3776,5836,8514,255.07,42.17,28.91,18.7
11-11-2020,MARINHA GRANDE,88,6,229,"[120,240]",Elevada,,,,88,Centro,LEIRIA,1010,18725.19,38508,2365,2302,1638,1359,1058,2417,4055,6357,8722,205.65,46.58,33.95,21.66
11-11-2020,MARVÃO,4,0,133,"[120,240]",Elevada,,,,4,Alentejo,PORTALEGRE,1210,15489.9,3005,198,185,142,197,237,434,576,761,959,19.4,6.19,4.91,3.72
11-11-2020,MATOSINHOS,2052,147,1170,"[240,Max]",Muito elevada,,,,2052,Norte,PORTO,1308,6241.97,175357,11850,9977,7023,5024,3884,8908,15931,25908,37758,2809.31,604.9,415.06,255.22
11-11-2020,MEALHADA,127,9,638,"[240,Max]",Muito elevada,,,,127,Centro,AVEIRO,0111,11065.66,19914,1163,1039,810,828,831,1659,2469,3508,4671,179.96,42.21,31.7,22.31
11-11-2020,MÊDA,23,2,501,"[240,Max]",Muito elevada,,,,23,Centro,GUARDA,0909,28604.92,4587,343,306,290,288,443,731,1021,1327,1670,16.04,5.84,4.64,3.57
11-11-2020,MELGAÇO,10,1,124,"[120,240]",Elevada,,,,10,Norte,VIANA DO CASTELO,1603,23824.58,8093,507,567,578,614,675,1289,1867,2434,2941,33.97,12.34,10.22,7.84
11-11-2020,MÉRTOLA,8,1,130,"[120,240]",Elevada,,,,8,Alentejo,BEJA,0209,129287.34,6142,400,390,378,423,600,1023,1401,1791,2191,4.75,1.69,1.39,1.08
11-11-2020,MESÃO FRIO,5,0,126,"[120,240]",Elevada,,,,5,Norte,VILA REAL,1704,2664.87,3964,265,205,168,157,120,277,445,650,915,148.74,34.33,24.39,16.7
11-11-2020,MIRA,50,4,423,"[240,Max]",Muito elevada,,,,50,Centro,COIMBRA,0608,12403.38,11832,727,729,659,550,466,1016,1675,2404,3131,95.4,25.24,19.38,13.5
11-11-2020,MIRANDA DO CORVO,43,3,338,"[240,Max]",Muito elevada,,,,43,Centro,COIMBRA,0609,12637.79,12708,706,659,568,498,404,902,1470,2129,2835,100.55,22.43,16.85,11.63
11-11-2020,MIRANDA DO DOURO,31,2,454,"[240,Max]",Muito elevada,,,,31,Norte,BRAGANÇA,0406,48718.31,6830,482,429,442,463,470,933,1375,1804,2286,14.02,4.69,3.7,2.82
11-11-2020,MIRANDELA,75,5,345,"[240,Max]",Muito elevada,,,,75,Norte,BRAGANÇA,0407,65895.67,21754,1640,1315,1204,1078,947,2025,3229,4544,6184,33.01,9.38,6.9,4.9
11-11-2020,MOGADOURO,69,5,822,"[240,Max]",Muito elevada,,,,69,Norte,BRAGANÇA,0408,76064.93,8392,589,529,576,630,655,1285,1861,2390,2979,11.03,3.92,3.14,2.45
11-11-2020,MOIMENTA DA BEIRA,22,2,226,"[120,240]",Elevada,,,,22,Norte,VISEU,1807,21996.9,9736,576,514,471,416,461,877,1348,1862,2438,44.26,11.08,8.46,6.13
11-11-2020,MOITA,169,12,262,"[240,Max]",Muito elevada,,,,169,Lisboa e Vale do Tejo,SETÚBAL,1506,5525.98,64407,4226,3646,2623,1801,1425,3226,5849,9495,13721,1165.53,248.3,171.82,105.85
11-11-2020,MONÇÃO,36,3,201,"[120,240]",Elevada,,,,36,Norte,VIANA DO CASTELO,1604,21130.85,17869,1161,1105,1031,1006,972,1978,3009,4114,5275,84.56,24.96,19.47,14.24
11-11-2020,MONCHIQUE,0,0,0,"[0,20]",Muito baixa,,,,0,Algarve,FARO,0809,39530.43,5077,353,384,321,355,392,747,1068,1452,1805,12.84,4.57,3.67,2.7
11-11-2020,MONDIM DE BASTO,21,1,302,"[240,Max]",Muito elevada,,,,21,Norte,VILA REAL,1705,17207.52,6946,395,300,314,284,283,567,881,1181,1576,40.36,9.16,6.86,5.12
11-11-2020,MONFORTE,20,1,672,"[240,Max]",Muito elevada,,,,20,Alentejo,PORTALEGRE,1211,42024.82,2975,139,115,117,192,168,360,477,592,731,7.08,1.74,1.41,1.14
11-11-2020,MONTALEGRE,29,2,322,"[240,Max]",Muito elevada,,,,29,Norte,VILA REAL,1706,80545.71,8997,699,628,595,603,730,1333,1928,2556,3255,11.17,4.04,3.17,2.39
11-11-2020,MONTEMOR-O-NOVO,35,3,224,"[120,240]",Elevada,,,,35,Alentejo,ÉVORA,0706,123296.65,15647,991,953,868,878,971,1849,2717,3670,4661,12.69,3.78,2.98,2.2
11-11-2020,MONTEMOR-O-VELHO,81,6,321,"[240,Max]",Muito elevada,,,,81,Centro,COIMBRA,0610,22896.23,25224,1496,1397,1217,1057,988,2045,3262,4659,6155,110.17,26.88,20.35,14.25
11-11-2020,MONTIJO,113,8,196,"[120,240]",Elevada,,,,113,Lisboa e Vale do Tejo,SETÚBAL,1507,34861.64,57614,2771,2441,1990,1554,1109,2663,4653,7094,9865,165.26,28.3,20.35,13.35
11-11-2020,MORA,21,1,507,"[240,Max]",Muito elevada,,,,21,Alentejo,ÉVORA,0707,44395.02,4138,336,275,252,238,257,495,747,1022,1358,9.32,3.06,2.3,1.68
11-11-2020,MORTÁGUA,20,1,227,"[120,240]",Elevada,,,,20,Centro,VISEU,1808,25117.82,8803,638,584,535,499,460,959,1494,2078,2716,35.05,10.81,8.27,5.95
11-11-2020,MOURA,7,0,51,"[20,60]",Baixa,,,,7,Alentejo,BEJA,0210,95845.55,13718,817,656,665,542,461,1003,1668,2324,3141,14.31,3.28,2.42,1.74
11-11-2020,MOURÃO,1,0,41,"[20,60]",Baixa,,,,1,Alentejo,ÉVORA,0708,27862.98,2450,139,108,80,104,109,213,293,401,540,8.79,1.94,1.44,1.05
11-11-2020,MURÇA,65,5,1190,"[240,Max]",Muito elevada,,,,65,Norte,VILA REAL,1707,18937.11,5463,384,341,307,306,319,625,932,1273,1657,28.85,8.75,6.72,4.92
11-11-2020,MURTOSA,30,2,292,"[240,Max]",Muito elevada,,,,30,Centro,AVEIRO,0112,7308.78,10279,509,473,403,353,409,762,1165,1638,2147,140.63,29.37,22.41,15.94
11-11-2020,NAZARÉ,32,2,226,"[120,240]",Elevada,,,,32,Lisboa e Vale do Tejo,LEIRIA,1011,8243.43,14165,967,903,670,420,396,816,1486,2389,3356,171.84,40.71,28.98,18.03
11-11-2020,NELAS,69,5,532,"[240,Max]",Muito elevada,,,,69,Centro,VISEU,1809,12571.48,12974,924,787,668,604,583,1187,1855,2642,3566,103.21,28.37,21.02,14.76
11-11-2020,NISA,2,0,33,"[20,60]",Baixa,,,,2,Alentejo,PORTALEGRE,1212,57567.84,6061,405,389,355,483,478,961,1316,1705,2110,10.53,3.67,2.96,2.29
11-11-2020,NORDESTE,1,0,21,"[20,60]",Baixa,,,,1,Açores,AÇORES,4202,10146.8,4862,246,180,124,161,162,323,447,627,873,47.92,8.6,6.18,4.41
11-11-2020,ÓBIDOS,20,1,169,"[120,240]",Elevada,,,,20,Lisboa e Vale do Tejo,LEIRIA,1012,14155.44,11850,743,650,574,452,436,888,1462,2112,2855,83.72,20.17,14.92,10.33
11-11-2020,ODEMIRA,38,3,154,"[120,240]",Elevada,,,,38,Alentejo,BEJA,0211,172060.15,24717,1475,1317,1225,1397,1349,2746,3971,5288,6763,14.37,3.93,3.07,2.31
11-11-2020,ODIVELAS,872,62,539,"[240,Max]",Muito elevada,,,,872,Lisboa e Vale do Tejo,LISBOA,1116,2654.36,161774,9562,9038,6952,4641,3812,8453,15405,24443,34005,6095.48,1281.27,920.99,580.44
11-11-2020,OEIRAS,788,56,444,"[240,Max]",Muito elevada,,,,788,Lisboa e Vale do Tejo,LISBOA,1110,4588.31,177408,11580,11575,8566,6211,5855,12066,20632,32207,43787,3866.78,954.38,701.98,449.69
11-11-2020,OLEIROS,3,0,60,"[60,120]",Moderada,,,,3,Centro,CASTELO BRANCO,0506,47109.31,5003,384,341,366,397,487,884,1250,1591,1975,10.62,4.19,3.38,2.65
11-11-2020,OLHÃO,86,6,194,"[120,240]",Elevada,,,,86,Algarve,FARO,0810,13086.38,44405,2455,2309,1689,1342,1268,2610,4299,6608,9063,339.33,69.26,50.5,32.85
11-11-2020,OLIVEIRA DE AZEMÉIS,787,56,1192,"[240,Max]",Muito elevada,,,,787,Norte,AVEIRO,0113,16110.41,66011,4155,3614,2794,2183,1738,3921,6715,10329,14484,409.75,89.91,64.12,41.68
11-11-2020,OLIVEIRA DE FRADES,46,3,463,"[240,Max]",Muito elevada,,,,46,Centro,VISEU,1810,14534.62,9936,553,475,438,359,415,774,1212,1687,2240,68.36,15.41,11.61,8.34
11-11-2020,OLIVEIRA DO BAIRRO,104,7,428,"[240,Max]",Muito elevada,,,,104,Centro,AVEIRO,0114,8731.99,24277,1327,1182,999,786,810,1596,2595,3777,5104,278.02,58.45,43.25,29.72
11-11-2020,OLIVEIRA DO HOSPITAL,28,2,145,"[120,240]",Elevada,,,,28,Centro,COIMBRA,0611,23451.66,19253,1161,1097,962,924,960,1884,2846,3943,5104,82.1,21.76,16.81,12.14
11-11-2020,OURÉM,207,15,470,"[240,Max]",Muito elevada,,,,207,Lisboa e Vale do Tejo,SANTARÉM,1421,41668.03,44044,2463,2069,1899,1817,1603,3420,5319,7388,9851,105.7,23.64,17.73,12.77
11-11-2020,OURIQUE,4,0,87,"[60,120]",Moderada,,,,4,Alentejo,BEJA,0212,66331.36,4607,313,287,284,268,227,495,779,1066,1379,6.95,2.08,1.61,1.17
11-11-2020,OVAR,478,34,881,"[240,Max]",Muito elevada,,,,478,Centro,AVEIRO,0115,14770.25,54260,3294,2709,1994,1636,1234,2870,4864,7573,10867,367.37,73.57,51.27,32.93
11-11-2020,PAÇOS DE FERREIRA,2098,150,3698,"[240,Max]",Muito elevada,,,,2098,Norte,PORTO,1309,7099.29,56728,2903,2193,1518,1135,664,1799,3317,5510,8413,799.1,118.51,77.62,46.72
11-11-2020,PALMELA,254,18,395,"[240,Max]",Muito elevada,,,,254,Lisboa e Vale do Tejo,SETÚBAL,1508,46512.01,64269,3402,3244,2635,1846,1391,3237,5872,9116,12518,138.18,26.91,19.6,12.62
11-11-2020,PAMPILHOSA DA SERRA,19,1,471,"[240,Max]",Muito elevada,,,,19,Centro,COIMBRA,0612,39646.24,4037,238,254,295,339,423,762,1057,1311,1549,10.18,3.91,3.31,2.67
11-11-2020,PAREDES,1835,131,2132,"[240,Max]",Muito elevada,,,,1835,Norte,PORTO,1310,15675.69,86067,4272,3532,2412,1717,1258,2975,5387,8919,13191,549.04,84.15,56.9,34.36
11-11-2020,PAREDES DE COURA,52,4,609,"[240,Max]",Muito elevada,,,,52,Norte,VIANA DO CASTELO,1605,13818.59,8535,466,528,407,465,515,980,1387,1915,2381,61.76,17.23,13.86,10.04
11-11-2020,PEDRÓGÃO GRANDE,7,0,205,"[120,240]",Elevada,,,,7,Centro,LEIRIA,1013,12874.75,3410,175,173,196,221,252,473,669,842,1017,26.49,7.9,6.54,5.2
11-11-2020,PENACOVA,56,4,409,"[240,Max]",Muito elevada,,,,56,Centro,COIMBRA,0613,21673.23,13694,968,923,745,621,703,1324,2069,2992,3960,63.18,18.27,13.81,9.55
11-11-2020,PENAFIEL,1434,102,2055,"[240,Max]",Muito elevada,,,,1434,Norte,PORTO,1311,21224.27,69772,3648,2823,2032,1663,1230,2893,4925,7748,11396,328.74,53.69,36.51,23.2
11-11-2020,PENALVA DO CASTELO,21,1,295,"[240,Max]",Muito elevada,,,,21,Centro,VISEU,1811,13433.92,7115,449,457,413,391,426,817,1230,1687,2136,52.96,15.9,12.56,9.16
11-11-2020,PENAMACOR,14,1,294,"[240,Max]",Muito elevada,,,,14,Centro,CASTELO BRANCO,0507,56370.69,4755,262,248,273,451,633,1084,1357,1605,1867,8.44,3.31,2.85,2.41
11-11-2020,PENEDONO,3,0,116,"[60,120]",Moderada,,,,3,Norte,VISEU,1812,13370.75,2591,172,113,129,156,138,294,423,536,708,19.38,5.3,4.01,3.16
11-11-2020,PENELA,25,2,463,"[240,Max]",Muito elevada,,,,25,Centro,COIMBRA,0614,13480.0,5397,314,324,274,359,344,703,977,1301,1615,40.04,11.98,9.65,7.25
11-11-2020,PENICHE,38,3,143,"[120,240]",Elevada,,,,38,Lisboa e Vale do Tejo,LEIRIA,1014,7754.98,26501,1746,1504,1203,926,707,1633,2836,4340,6086,341.73,78.48,55.96,36.57
11-11-2020,PESO DA RÉGUA,81,6,514,"[240,Max]",Muito elevada,,,,81,Norte,VILA REAL,1708,9486.01,15773,1076,843,650,659,455,1114,1764,2607,3683,166.28,38.83,27.48,18.6
11-11-2020,PINHEL,19,1,223,"[120,240]",Elevada,,,,19,Centro,GUARDA,0910,48452.12,8511,577,566,551,538,689,1227,1778,2344,2921,17.57,6.03,4.84,3.67
11-11-2020,POMBAL,117,8,227,"[120,240]",Elevada,,,,117,Centro,LEIRIA,1015,62600.28,51461,3187,2791,2494,2328,2027,4355,6849,9640,12827,82.21,20.49,15.4,10.94
11-11-2020,PONTA DELGADA,49,3,72,"[60,120]",Moderada,,,,49,Açores,AÇORES,4203,23298.65,67935,3108,2435,1726,1133,902,2035,3761,6196,9304,291.58,39.93,26.59,16.14
11-11-2020,PONTA DO SOL,7,0,81,"[60,120]",Moderada,,,,7,Madeira,MADEIRA,3105,4622.03,8593,319,283,347,208,221,429,776,1059,1378,185.92,29.81,22.91,16.79
11-11-2020,PONTE DA BARCA,17,1,152,"[120,240]",Elevada,,,,17,Norte,VIANA DO CASTELO,1606,18211.37,11180,635,576,517,554,490,1044,1561,2137,2772,61.39,15.22,11.73,8.57
11-11-2020,PONTE DE LIMA,224,16,542,"[240,Max]",Muito elevada,,,,224,Norte,VIANA DO CASTELO,1607,32025.46,41315,2321,2022,1720,1596,1462,3058,4778,6800,9121,129.01,28.48,21.23,14.92
11-11-2020,PONTE DE SOR,50,4,333,"[240,Max]",Muito elevada,,,,50,Alentejo,PORTALEGRE,1213,83971.16,14994,939,800,716,739,831,1570,2286,3086,4025,17.86,4.79,3.68,2.72
11-11-2020,PORTALEGRE,58,4,262,"[240,Max]",Muito elevada,,,,58,Alentejo,PORTALEGRE,1214,44713.64,22172,1577,1351,1137,993,984,1977,3114,4465,6042,49.59,13.51,9.99,6.96
11-11-2020,PORTEL,2,0,34,"[20,60]",Baixa,,,,2,Alentejo,ÉVORA,0709,60100.57,5828,336,358,283,331,305,636,919,1277,1613,9.7,2.68,2.12,1.53
11-11-2020,PORTIMÃO,143,10,258,"[240,Max]",Muito elevada,,,,143,Algarve,FARO,0811,18206.29,55483,3182,2927,2116,1582,1400,2982,5098,8025,11207,304.75,61.56,44.08,28.0
11-11-2020,PORTO,2489,178,1149,"[240,Max]",Muito elevada,,,,2489,Norte,PORTO,1312,4142.02,216606,15790,15193,11280,9409,10044,19453,30733,45926,61716,5229.5,1490.0,1108.79,741.98
11-11-2020,PORTO DE MÓS,50,4,215,"[120,240]",Elevada,,,,50,Centro,LEIRIA,1016,26183.41,23275,1355,1210,1034,888,872,1760,2794,4004,5359,88.89,20.47,15.29,10.67
11-11-2020,PORTO MONIZ,0,0,0,"[0,20]",Muito baixa,,,,0,Madeira,MADEIRA,3106,8293.38,2342,143,130,95,98,120,218,313,443,586,28.24,7.07,5.34,3.77
11-11-2020,PORTO SANTO,1,0,19,"[0,20]",Muito baixa,,,,1,Madeira,MADEIRA,3201,4300.7,5202,240,157,134,110,68,178,312,469,709,120.95,16.48,10.9,7.25
11-11-2020,PÓVOA DE LANHOSO,145,10,674,"[240,Max]",Muito elevada,,,,145,Norte,BRAGA,0309,13465.29,21499,1175,909,732,673,624,1297,2029,2938,4113,159.67,30.55,21.82,15.07
11-11-2020,PÓVOA DE VARZIM,584,42,930,"[240,Max]",Muito elevada,,,,584,Norte,PORTO,1313,8220.59,62784,3712,3120,2134,1594,1305,2899,5033,8153,11865,763.7,144.33,99.17,61.22
11-11-2020,POVOAÇÃO,1,0,17,"[0,20]",Muito baixa,,,,1,Açores,AÇORES,4204,10640.77,5927,293,212,191,144,134,278,469,681,974,55.7,9.15,6.4,4.41
11-11-2020,VILA DA PRAIA DA VITÓRIA,14,1,66,"[60,120]",Moderada,,,,14,Açores,AÇORES,4302,16127.06,21317,1133,789,619,436,336,772,1391,2180,3313,132.18,20.54,13.52,8.63
11-11-2020,PROENÇA-A-NOVA,50,4,685,"[240,Max]",Muito elevada,,,,50,Centro,CASTELO BRANCO,0508,39539.96,7298,508,465,389,400,560,960,1349,1814,2322,18.46,5.87,4.59,3.41
11-11-2020,REDONDO,51,4,803,"[240,Max]",Muito elevada,,,,51,Alentejo,ÉVORA,0710,36950.87,6353,349,325,288,288,354,642,930,1255,1604,17.19,4.34,3.4,2.52
11-11-2020,REGUENGOS DE MONSARAZ,31,2,310,"[240,Max]",Muito elevada,,,,31,Alentejo,ÉVORA,0711,46399.72,10015,602,511,455,462,473,935,1390,1901,2503,21.58,5.39,4.1,3.0
11-11-2020,RESENDE,43,3,424,"[240,Max]",Muito elevada,,,,43,Norte,VISEU,1813,12334.93,10137,560,493,448,433,422,855,1303,1796,2356,82.18,19.1,14.56,10.56
11-11-2020,RIBEIRA BRAVA,5,0,40,"[20,60]",Baixa,,,,5,Madeira,MADEIRA,3107,6544.88,12435,648,500,411,311,287,598,1009,1509,2157,189.99,32.96,23.06,15.42
11-11-2020,RIBEIRA DE PENA,21,1,349,"[240,Max]",Muito elevada,,,,21,Norte,VILA REAL,1709,21745.98,6016,371,301,290,310,368,678,968,1269,1640,27.66,7.54,5.84,4.45
11-11-2020,RIBEIRA GRANDE,26,2,79,"[60,120]",Moderada,,,,26,Açores,AÇORES,4205,18015.13,32811,1163,689,512,345,253,598,1110,1799,2962,182.13,16.44,9.99,6.16
11-11-2020,RIO MAIOR,49,3,240,"[240,Max]",Muito elevada,,,,49,Lisboa e Vale do Tejo,SANTARÉM,1414,27276.45,20379,1251,1144,941,795,648,1443,2384,3528,4779,74.71,17.52,12.93,8.74
11-11-2020,SABROSA,35,2,591,"[240,Max]",Muito elevada,,,,35,Norte,VILA REAL,1710,15692.45,5918,393,314,304,302,350,652,956,1270,1663,37.71,10.6,8.09,6.09
11-11-2020,SABUGAL,22,2,208,"[120,240]",Elevada,,,,22,Centro,GUARDA,0911,82269.82,10585,724,707,694,796,1009,1805,2499,3206,3930,12.87,4.78,3.9,3.04
11-11-2020,SALVATERRA DE MAGOS,101,7,474,"[240,Max]",Muito elevada,,,,101,Lisboa e Vale do Tejo,SANTARÉM,1415,24393.2,21295,1275,1181,1060,799,772,1571,2631,3812,5087,87.3,20.85,15.63,10.79
11-11-2020,SANTA COMBA DÃO,28,2,268,"[240,Max]",Muito elevada,,,,28,Centro,VISEU,1814,11194.77,10452,732,684,569,538,464,1002,1571,2255,2987,93.36,26.68,20.14,14.03
11-11-2020,SANTA CRUZ,79,6,174,"[120,240]",Elevada,,,,79,Madeira,MADEIRA,3108,8150.28,45281,1817,1301,974,716,523,1239,2213,3514,5331,555.6,65.41,43.12,27.15
11-11-2020,SANTA CRUZ DA GRACIOSA,1,0,24,"[20,60]",Baixa,,,,1,Açores,AÇORES,4401,6065.78,4208,228,180,163,124,145,269,432,612,840,69.37,13.85,10.09,7.12
11-11-2020,SANTA CRUZ DAS FLORES,0,0,0,"[0,20]",Muito baixa,,,,0,Açores,AÇORES,4802,7091.44,2165,125,98,74,56,51,107,181,279,404,30.53,5.7,3.93,2.55
11-11-2020,SANTA MARIA DA FEIRA,1273,91,918,"[240,Max]",Muito elevada,,,,1273,Norte,AVEIRO,0109,21587.65,138636,8182,6743,4771,3856,3079,6935,11706,18449,26631,642.19,123.36,85.46,54.22
11-11-2020,SANTA MARTA DE PENAGUIÃO,42,3,636,"[240,Max]",Muito elevada,,,,42,Norte,VILA REAL,1711,6928.13,6599,483,373,337,316,317,633,970,1343,1826,95.25,26.36,19.39,14.0
11-11-2020,SANTANA,1,0,15,"[0,20]",Muito baixa,,,,1,Madeira,MADEIRA,3109,9547.3,6711,418,353,343,282,277,559,902,1255,1673,70.29,17.52,13.15,9.45
11-11-2020,SANTARÉM,305,22,531,"[240,Max]",Muito elevada,,,,305,Lisboa e Vale do Tejo,SANTARÉM,1416,55253.58,57421,3654,3441,2760,2466,2206,4672,7432,10873,14527,103.92,26.29,19.68,13.45
11-11-2020,SANTIAGO DO CACÉM,24,2,83,"[60,120]",Moderada,,,,24,Alentejo,SETÚBAL,1509,105969.29,28791,2144,1689,1472,1295,1215,2510,3982,5671,7815,27.17,7.37,5.35,3.76
11-11-2020,SANTO TIRSO,1213,87,1782,"[240,Max]",Muito elevada,,,,1213,Norte,PORTO,1314,13655.52,68055,4911,3935,2761,2257,1810,4067,6828,10763,15674,498.35,114.78,78.82,50.0
11-11-2020,SÃO BRÁS DE ALPORTEL,34,2,326,"[240,Max]",Muito elevada,,,,34,Algarve,FARO,0812,15336.92,10416,596,468,467,404,401,805,1272,1740,2336,67.91,15.23,11.35,8.29
11-11-2020,SÃO JOÃO DA MADEIRA,225,16,1025,"[240,Max]",Muito elevada,,,,225,Norte,AVEIRO,0116,794.3,21958,1347,1069,796,601,593,1194,1990,3059,4406,2765.49,554.91,385.26,250.63
11-11-2020,SÃO JOÃO DA PESQUEIRA,14,1,196,"[120,240]",Elevada,,,,14,Norte,VISEU,1815,26610.85,7125,417,330,294,328,328,656,950,1280,1697,26.77,6.38,4.81,3.57
11-11-2020,SÃO PEDRO DO SUL,54,4,351,"[240,Max]",Muito elevada,,,,54,Centro,VISEU,1816,34895.09,15403,990,962,861,759,909,1668,2529,3491,4481,44.14,12.84,10.0,7.25
11-11-2020,SÃO ROQUE DO PICO,1,0,31,"[20,60]",Baixa,,,,1,Açores,AÇORES,4603,14236.1,3266,199,141,93,96,113,209,302,443,642,22.94,4.51,3.11,2.12
11-11-2020,SÃO VICENTE,0,0,0,"[0,20]",Muito baixa,,,,0,Madeira,MADEIRA,3110,7883.71,5143,272,264,266,225,280,505,771,1035,1307,65.23,16.58,13.13,9.78
11-11-2020,SARDOAL,11,1,294,"[240,Max]",Muito elevada,,,,11,Lisboa e Vale do Tejo,SANTARÉM,1417,9214.72,3741,227,178,148,165,248,413,561,739,966,40.6,10.48,8.02,6.09
11-11-2020,SÁTÃO,28,2,242,"[240,Max]",Muito elevada,,,,28,Centro,VISEU,1817,20194.11,11580,765,671,515,465,476,941,1456,2127,2892,57.34,14.32,10.53,7.21
11-11-2020,SEIA,153,11,688,"[240,Max]",Muito elevada,,,,153,Centro,GUARDA,0912,43568.83,22234,1807,1589,1238,1122,721,1843,3081,4670,6477,51.03,14.87,10.72,7.07
11-11-2020,SEIXAL,726,52,433,"[240,Max]",Muito elevada,,,,726,Lisboa e Vale do Tejo,SETÚBAL,1510,9545.17,167752,10586,9270,6661,4391,2930,7321,13982,23252,33838,1757.49,354.51,243.6,146.49
11-11-2020,SERNANCELHE,5,0,93,"[60,120]",Moderada,,,,5,Norte,VISEU,1818,22861.22,5396,305,293,286,273,260,533,819,1112,1417,23.6,6.2,4.86,3.58
11-11-2020,SERPA,5,0,35,"[20,60]",Baixa,,,,5,Alentejo,BEJA,0213,110563.34,14304,903,761,719,697,626,1323,2042,2803,3706,12.94,3.35,2.54,1.85
11-11-2020,SERTÃ,22,2,151,"[120,240]",Elevada,,,,22,Centro,CASTELO BRANCO,0509,44673.17,14577,870,779,790,767,1020,1787,2577,3356,4226,32.63,9.46,7.51,5.77
11-11-2020,SESIMBRA,194,14,374,"[240,Max]",Muito elevada,,,,194,Lisboa e Vale do Tejo,SETÚBAL,1511,19571.75,51858,2400,2321,1853,1257,1083,2340,4193,6514,8914,264.96,45.54,33.28,21.42
11-11-2020,SETÚBAL,682,49,592,"[240,Max]",Muito elevada,,,,682,Lisboa e Vale do Tejo,SETÚBAL,1512,23032.5,115126,7425,6929,5075,3775,2655,6430,11505,18434,25859,499.83,112.27,80.03,49.95
11-11-2020,SEVER DO VOUGA,138,10,1218,"[240,Max]",Muito elevada,,,,138,Centro,AVEIRO,0117,12987.56,11331,766,637,568,540,567,1107,1675,2312,3078,87.24,23.7,17.8,12.9
11-11-2020,SILVES,59,4,163,"[120,240]",Elevada,,,,59,Algarve,FARO,0813,68006.23,36226,2137,1869,1610,1423,1600,3023,4633,6502,8639,53.27,12.7,9.56,6.81
11-11-2020,SINES,78,6,569,"[240,Max]",Muito elevada,,,,78,Alentejo,SETÚBAL,1513,20330.17,13715,888,791,551,416,268,684,1235,2026,2914,67.46,14.33,9.97,6.07
11-11-2020,SINTRA,1797,128,459,"[240,Max]",Muito elevada,,,,1797,Lisboa e Vale do Tejo,LISBOA,1111,31922.73,391402,20490,18316,13545,9137,7284,16421,29966,48282,68772,1226.08,215.43,151.25,93.87
11-11-2020,SOBRAL DE MONTE AGRAÇO,41,3,385,"[240,Max]",Muito elevada,,,,41,Lisboa e Vale do Tejo,LISBOA,1112,5210.32,10651,564,507,352,272,212,484,836,1343,1907,204.43,36.6,25.78,16.05
11-11-2020,SOURE,28,2,164,"[120,240]",Elevada,,,,28,Centro,COIMBRA,0615,26506.07,17120,1173,1142,1004,883,987,1870,2874,4016,5189,64.59,19.58,15.15,10.84
11-11-2020,SOUSEL,13,1,295,"[240,Max]",Muito elevada,,,,13,Alentejo,PORTALEGRE,1215,27932.18,4412,261,274,208,302,292,594,802,1076,1337,15.8,4.79,3.85,2.87
11-11-2020,TÁBUA,30,2,264,"[240,Max]",Muito elevada,,,,30,Centro,COIMBRA,0616,19978.58,11368,729,584,524,430,464,894,1418,2002,2731,56.9,13.67,10.02,7.1
11-11-2020,TABUAÇO,13,1,215,"[120,240]",Elevada,,,,13,Norte,VISEU,1819,13385.67,6033,372,314,217,282,363,645,862,1176,1548,45.07,11.56,8.79,6.44
11-11-2020,TAROUCA,16,1,205,"[120,240]",Elevada,,,,16,Norte,VISEU,1820,10008.49,7804,405,335,313,277,324,601,914,1249,1654,77.98,16.53,12.48,9.13
11-11-2020,TAVIRA,60,4,245,"[240,Max]",Muito elevada,,,,60,Algarve,FARO,0814,60696.7,24530,1493,1415,1252,1066,1277,2343,3595,5010,6503,40.41,10.71,8.25,5.92
11-11-2020,TERRAS DE BOURO,13,1,204,"[120,240]",Elevada,,,,13,Norte,BRAGA,0310,27746.07,6361,391,372,296,319,340,659,955,1327,1718,22.93,6.19,4.78,3.44
11-11-2020,TOMAR,82,6,223,"[120,240]",Elevada,,,,82,Lisboa e Vale do Tejo,SANTARÉM,1418,35120.44,36748,2403,2189,1868,1853,1822,3675,5543,7732,10135,104.64,28.86,22.02,15.78
11-11-2020,TONDELA,55,4,209,"[120,240]",Elevada,,,,55,Centro,VISEU,1821,37121.73,26357,1768,1722,1518,1475,1417,2892,4410,6132,7900,71.0,21.28,16.52,11.88
11-11-2020,TORRE DE MONCORVO,39,3,507,"[240,Max]",Muito elevada,,,,39,Norte,BRAGANÇA,0409,53155.67,7695,556,478,488,551,719,1270,1758,2236,2792,14.48,5.25,4.21,3.31
11-11-2020,TORRES NOVAS,74,5,212,"[240,Max]",Muito elevada,,,,74,Lisboa e Vale do Tejo,SANTARÉM,1419,26999.68,34933,2324,1979,1738,1406,1475,2881,4619,6598,8922,129.38,33.04,24.44,17.11
11-11-2020,TORRES VEDRAS,178,13,227,"[240,Max]",Muito elevada,,,,178,Lisboa e Vale do Tejo,LISBOA,1113,40714.89,78530,4513,3945,3447,2628,2104,4732,8179,12124,16637,192.88,40.86,29.78,20.09
11-11-2020,TRANCOSO,108,8,1217,"[240,Max]",Muito elevada,,,,108,Centro,GUARDA,0913,36152.47,8875,581,557,542,586,496,1082,1624,2181,2762,24.55,7.64,6.03,4.49
11-11-2020,TROFA,460,33,1197,"[240,Max]",Muito elevada,,,,460,Norte,PORTO,1318,7201.76,38418,2336,1894,1231,939,684,1623,2854,4748,7084,533.44,98.36,65.93,39.63
11-11-2020,VAGOS,70,5,308,"[240,Max]",Muito elevada,,,,70,Centro,AVEIRO,0118,16491.5,22740,1320,1205,922,784,724,1508,2430,3635,4955,137.89,30.04,22.04,14.73
11-11-2020,VALE DE CAMBRA,143,10,671,"[240,Max]",Muito elevada,,,,143,Norte,AVEIRO,0119,14733.47,21327,1491,1363,1005,831,798,1629,2634,3997,5488,144.76,37.25,27.13,17.88
11-11-2020,VALENÇA,105,7,790,"[240,Max]",Muito elevada,,,,105,Norte,VIANA DO CASTELO,1608,11712.86,13290,867,791,582,582,503,1085,1667,2458,3325,113.46,28.39,20.99,14.23
11-11-2020,VALONGO,993,71,1019,"[240,Max]",Muito elevada,,,,993,Norte,PORTO,1315,7512.45,97444,5629,4696,3207,2462,1829,4291,7498,12194,17823,1297.18,237.26,162.33,99.81
11-11-2020,VALPAÇOS,24,2,162,"[120,240]",Elevada,,,,24,Norte,VILA REAL,1712,54873.93,14818,1217,1118,999,928,997,1925,2924,4042,5259,27.0,9.58,7.37,5.33
11-11-2020,VELAS,4,0,79,"[60,120]",Moderada,,,,4,Açores,AÇORES,4502,11738.38,5093,278,208,166,153,113,266,432,640,918,43.39,7.82,5.45,3.68
11-11-2020,VENDAS NOVAS,8,1,71,"[60,120]",Moderada,,,,8,Alentejo,ÉVORA,0712,22238.88,11255,677,768,655,501,532,1033,1688,2456,3133,50.61,14.09,11.04,7.59
11-11-2020,VIANA DO ALENTEJO,20,1,389,"[240,Max]",Muito elevada,,,,20,Alentejo,ÉVORA,0713,39367.29,5145,245,208,235,210,214,424,659,867,1112,13.07,2.82,2.2,1.67
11-11-2020,VIANA DO CASTELO,272,19,322,"[240,Max]",Muito elevada,,,,272,Norte,VIANA DO CASTELO,1609,31902.01,84417,5470,4433,3591,3061,2982,6043,9634,14067,19537,264.61,61.24,44.09,30.2
11-11-2020,VIDIGUEIRA,1,0,18,"[0,20]",Muito baixa,,,,1,Alentejo,BEJA,0214,31661.09,5510,300,248,215,233,275,508,723,971,1271,17.4,4.01,3.07,2.28
11-11-2020,VIEIRA DO MINHO,78,6,659,"[240,Max]",Muito elevada,,,,78,Norte,BRAGA,0311,21644.35,11842,703,594,525,548,482,1030,1555,2149,2852,54.71,13.18,9.93,7.18
11-11-2020,VILA DE REI,2,0,60,"[60,120]",Moderada,,,,2,Centro,CASTELO BRANCO,0510,19154.6,3323,169,128,172,247,302,549,721,849,1018,17.35,5.31,4.43,3.76
11-11-2020,VILA DO BISPO,24,2,466,"[240,Max]",Muito elevada,,,,24,Algarve,FARO,0815,17906.06,5154,302,302,314,232,233,465,779,1081,1383,28.78,7.72,6.04,4.35
11-11-2020,VILA DO CONDE,691,49,865,"[240,Max]",Muito elevada,,,,691,Norte,PORTO,1316,14902.77,79899,4726,3875,2819,2070,1743,3813,6632,10507,15233,536.13,102.21,70.5,44.5
11-11-2020,VILA DO PORTO,2,0,36,"[20,60]",Baixa,,,,2,Açores,AÇORES,4101,9688.74,5616,274,212,135,96,123,219,354,566,840,57.96,8.67,5.84,3.65
11-11-2020,VILA FLOR,17,1,281,"[240,Max]",Muito elevada,,,,17,Norte,BRAGANÇA,0410,26581.14,6044,429,362,422,294,331,625,1047,1409,1838,22.74,6.91,5.3,3.94
11-11-2020,VILA FRANCA DE XIRA,735,53,518,"[240,Max]",Muito elevada,,,,735,Lisboa e Vale do Tejo,LISBOA,1114,31819.39,141957,8501,6852,4869,3425,2472,5897,10766,17618,26119,446.14,82.09,55.37,33.84
11-11-2020,VILA FRANCA DO CAMPO,1,0,9,"[0,20]",Muito baixa,,,,1,Açores,AÇORES,4206,7796.82,11051,450,344,248,217,154,371,619,963,1413,141.73,18.12,12.35,7.94
11-11-2020,VILA NOVA DA BARQUINHA,13,1,174,"[120,240]",Elevada,,,,13,Lisboa e Vale do Tejo,SANTARÉM,1420,4952.97,7461,415,406,392,364,338,702,1094,1500,1915,150.64,38.66,30.28,22.09
11-11-2020,VILA NOVA DE CERVEIRA,56,4,629,"[240,Max]",Muito elevada,,,,56,Norte,VIANA DO CASTELO,1610,10846.66,8910,531,444,410,384,334,718,1128,1572,2103,82.14,19.39,14.49,10.4
11-11-2020,VILA NOVA DE FAMALICÃO,1776,127,1349,"[240,Max]",Muito elevada,,,,1776,Norte,BRAGA,0312,20159.26,131676,7817,6164,4202,3282,2749,6031,10233,16397,24214,653.19,120.12,81.34,50.76
11-11-2020,VILA NOVA DE FOZ CÔA,34,2,523,"[240,Max]",Muito elevada,,,,34,Centro,GUARDA,0914,39815.18,6503,442,385,390,398,429,827,1217,1602,2044,16.33,5.13,4.02,3.06
11-11-2020,VILA NOVA DE GAIA,2638,188,878,"[240,Max]",Muito elevada,,,,2638,Norte,PORTO,1317,16846.43,300472,18349,15568,10972,8224,6281,14505,25477,41045,59394,1783.64,352.57,243.65,151.23
11-11-2020,VILA NOVA DE PAIVA,13,1,277,"[240,Max]",Muito elevada,,,,13,Centro,VISEU,1822,17553.28,4687,289,272,233,217,241,458,691,963,1252,26.7,7.13,5.49,3.94
11-11-2020,VILA NOVA DE POIARES,7,1,101,"[60,120]",Moderada,,,,7,Centro,COIMBRA,0617,8445.3,6939,380,284,262,235,182,417,679,963,1343,82.17,15.9,11.4,8.04
11-11-2020,VILA POUCA DE AGUIAR,66,5,552,"[240,Max]",Muito elevada,,,,66,Norte,VILA REAL,1713,43706.62,11961,860,817,733,601,627,1228,1961,2778,3638,27.37,8.32,6.36,4.49
11-11-2020,VILA REAL,299,21,598,"[240,Max]",Muito elevada,,,,299,Norte,VILA REAL,1714,37880.28,49962,3025,2498,2065,1579,1466,3045,5110,7608,10633,131.9,28.07,20.08,13.49
11-11-2020,VILA REAL DE SANTO ANTÓNIO,54,4,288,"[240,Max]",Muito elevada,,,,54,Algarve,FARO,0816,6125.0,18749,1172,1069,811,569,586,1155,1966,3035,4207,306.11,68.69,49.55,32.1
11-11-2020,VILA VELHA DE RÓDÃO,12,1,382,"[240,Max]",Muito elevada,,,,12,Centro,CASTELO BRANCO,0511,32991.16,3144,209,229,180,283,306,589,769,998,1207,9.53,3.66,3.03,2.33
11-11-2020,VILA VERDE,222,16,473,"[240,Max]",Muito elevada,,,,222,Norte,BRAGA,0313,22866.52,46911,2365,2063,1667,1494,1437,2931,4598,6661,9026,205.15,39.47,29.13,20.11
11-11-2020,VILA VIÇOSA,69,5,901,"[240,Max]",Muito elevada,,,,69,Alentejo,ÉVORA,0714,19485.89,7656,487,379,342,345,324,669,1011,1390,1877,39.29,9.63,7.13,5.19
11-11-2020,VIMIOSO,8,1,199,"[120,240]",Elevada,,,,8,Norte,BRAGANÇA,0411,48158.51,4023,274,230,261,293,335,628,889,1119,1393,8.35,2.89,2.32,1.85
11-11-2020,VINHAIS,14,1,181,"[120,240]",Elevada,,,,14,Norte,BRAGANÇA,0412,69475.09,7746,599,577,636,641,815,1456,2092,2669,3268,11.15,4.7,3.84,3.01
11-11-2020,VISEU,305,22,314,"[240,Max]",Muito elevada,,,,305,Centro,VISEU,1823,50710.14,97249,5769,5038,4140,3158,2710,5868,10008,15046,20815,191.77,41.05,29.67,19.74
11-11-2020,VIZELA,634,45,2653,"[240,Max]",Muito elevada,,,,634,Norte,BRAGA,0314,2469.83,23897,1258,928,655,509,371,880,1535,2463,3721,967.49,150.65,99.72,62.15
11-11-2020,VOUZELA,14,1,146,"[120,240]",Elevada,,,,14,Centro,VISEU,1824,19369.46,9619,626,605,554,532,507,1039,1593,2198,2824,49.66,14.58,11.35,8.22
20-11-2020,ABRANTES,203,15,578,"[480,960]",Muito Elevado,,,,203,Lisboa e Vale do Tejo,SANTARÉM,1401,71469.08,35130,2473,2213,1730,1748,2021,3769,5499,7712,10185,49.15,14.25,10.79,7.69
20-11-2020,ÁGUEDA,273,20,593,"[480,960]",Muito Elevado,,,,273,Centro,AVEIRO,0101,33527.44,46075,3237,2713,2090,1635,1496,3131,5221,7934,11171,137.43,33.32,23.66,15.57
20-11-2020,AGUIAR DA BEIRA,11,1,236,"[120,240]",Moderado,,,,11,Centro,GUARDA,0901,20676.57,4652,304,281,235,239,148,387,622,903,1207,22.5,5.84,4.37,3.01
20-11-2020,ALANDROAL,10,1,200,"[120,240]",Moderado,,,,10,Alentejo,ÉVORA,0701,54267.81,4992,307,256,296,299,377,676,972,1228,1535,9.2,2.83,2.26,1.79
20-11-2020,ALBERGARIA-A-VELHA,140,10,580,"[480,960]",Muito Elevado,,,,140,Centro,AVEIRO,0102,15882.5,24144,1550,1298,996,687,680,1367,2363,3661,5211,152.02,32.81,23.05,14.88
20-11-2020,ALBUFEIRA,125,9,301,"[240,480]",Elevado,,,,125,Algarve,FARO,0801,14066.42,41528,2067,1717,1425,985,858,1843,3268,4985,7052,295.24,50.14,35.44,23.23
20-11-2020,ALCÁCER DO SAL,31,2,266,"[240,480]",Elevado,,,,31,Alentejo,SETÚBAL,1501,149987.3,11659,884,814,623,623,602,1225,1848,2662,3546,7.77,2.36,1.77,1.23
20-11-2020,ALCANENA,123,9,960,"[960,Max]",Extremamente Elevado,,,,123,Lisboa e Vale do Tejo,SANTARÉM,1402,12732.86,12809,891,744,628,536,588,1124,1752,2496,3387,100.6,26.6,19.6,13.76
20-11-2020,ALCOBAÇA,186,13,347,"[240,480]",Elevado,,,,186,Lisboa e Vale do Tejo,LEIRIA,1001,40814.09,53555,3420,2927,2466,2059,1676,3735,6201,9128,12548,131.22,30.74,22.36,15.19
20-11-2020,ALCOCHETE,58,4,293,"[240,480]",Elevado,,,,58,Lisboa e Vale do Tejo,SETÚBAL,1502,12836.48,19787,857,834,691,476,447,923,1614,2448,3305,154.15,25.75,19.07,12.57
20-11-2020,ALCOUTIM,2,0,93,"[60,120]",Moderado,,,,2,Algarve,FARO,0802,57536.33,2159,191,188,163,190,267,457,620,808,999,3.75,1.74,1.4,1.08
20-11-2020,ALENQUER,170,12,386,"[240,480]",Elevado,,,,170,Lisboa e Vale do Tejo,LISBOA,1101,30421.92,44052,2298,2062,1629,1330,1155,2485,4114,6176,8474,144.8,27.85,20.3,13.52
20-11-2020,ALFÂNDEGA DA FÉ,44,3,967,"[960,Max]",Extremamente Elevado,,,,44,Norte,BRAGANÇA,0401,32194.64,4550,325,277,301,274,325,599,900,1177,1502,14.13,4.67,3.66,2.8
20-11-2020,ALIJÓ,60,4,565,"[480,960]",Muito Elevado,,,,60,Norte,VILA REAL,1701,29759.89,10625,766,687,635,542,666,1208,1843,2530,3296,35.7,11.08,8.5,6.19
20-11-2020,ALJEZUR,3,0,54,"[20,60]",Moderado,,,,3,Algarve,FARO,0803,32349.95,5594,316,336,335,320,410,730,1065,1401,1717,17.29,5.31,4.33,3.29
20-11-2020,ALJUSTREL,19,1,230,"[120,240]",Moderado,,,,19,Alentejo,BEJA,0201,45847.41,8247,635,521,443,347,358,705,1148,1669,2304,17.99,5.03,3.64,2.5
20-11-2020,ALMADA,1117,80,661,"[480,960]",Muito Elevado,,,,1117,Lisboa e Vale do Tejo,SETÚBAL,1503,7000.89,169039,10469,9777,7876,6144,5111,11255,19131,28908,39377,2414.5,562.45,412.91,273.26
20-11-2020,ALMEIDA,20,1,343,"[240,480]",Elevado,,,,20,Centro,GUARDA,0902,51798.46,5830,441,419,396,458,393,851,1247,1666,2107,11.26,4.07,3.22,2.41
20-11-2020,ALMEIRIM,80,6,355,"[240,480]",Elevado,,,,80,Lisboa e Vale do Tejo,SANTARÉM,1403,22212.05,22546,1342,1353,1106,866,843,1709,2815,4168,5510,101.5,24.81,18.76,12.67
20-11-2020,ALMODÔVAR,6,0,89,"[60,120]",Moderado,,,,6,Alentejo,BEJA,0202,77788.03,6725,414,443,396,373,328,701,1097,1540,1954,8.65,2.51,1.98,1.41
20-11-2020,ALPIARÇA,10,1,142,"[120,240]",Moderado,,,,10,Lisboa e Vale do Tejo,SANTARÉM,1404,9536.33,7059,515,486,363,333,274,607,970,1456,1971,74.02,20.67,15.27,10.17
20-11-2020,ALTER DO CHÃO,7,0,221,"[120,240]",Moderado,,,,7,Alentejo,PORTALEGRE,1201,36206.62,3165,201,163,136,208,187,395,531,694,895,8.74,2.47,1.92,1.47
20-11-2020,ALVAIÁZERE,6,0,91,"[60,120]",Moderado,,,,6,Centro,LEIRIA,1002,16047.76,6597,419,389,346,406,539,945,1291,1680,2099,41.11,13.08,10.47,8.04
20-11-2020,ALVITO,1,0,40,"[20,60]",Moderado,,,,1,Alentejo,BEJA,0203,26485.32,2477,145,110,105,111,89,200,305,415,560,9.35,2.11,1.57,1.15
20-11-2020,AMADORA,952,68,517,"[480,960]",Muito Elevado,,,,952,Lisboa e Vale do Tejo,LISBOA,1115,2378.47,184106,11186,10936,8780,6460,5890,12350,21130,32066,43252,7742.05,1818.84,1348.44,888.56
20-11-2020,AMARANTE,606,43,1139,"[960,Max]",Extremamente Elevado,,,,606,Norte,PORTO,1301,30133.15,53193,3086,2413,1812,1643,1311,2954,4766,7179,10265,176.53,34.07,23.82,15.82
20-11-2020,AMARES,217,16,1197,"[960,Max]",Extremamente Elevado,,,,217,Norte,BRAGA,0301,8195.41,18129,1001,829,622,489,524,1013,1635,2464,3465,221.22,42.28,30.07,19.95
20-11-2020,ANADIA,128,9,470,"[240,480]",Elevado,,,,128,Centro,AVEIRO,0103,21663.48,27258,1931,1698,1376,1208,1262,2470,3846,5544,7475,125.83,34.51,25.59,17.75
20-11-2020,ANGRA DO HEROÍSMO,25,2,74,"[60,120]",Moderado,,,,25,Açores,AÇORES,4301,23899.66,33807,2006,1473,1122,768,635,1403,2525,3998,6004,141.45,25.12,16.73,10.56
20-11-2020,ANSIÃO,34,2,282,"[240,480]",Elevado,,,,34,Centro,LEIRIA,1003,17609.42,12039,727,709,646,694,530,1224,1870,2579,3306,68.37,18.77,14.65,10.62
20-11-2020,ARCOS DE VALDEVEZ,120,9,573,"[480,960]",Muito Elevado,,,,120,Norte,VIANA DO CASTELO,1601,44759.64,20926,1329,1338,1282,1343,1515,2858,4140,5478,6807,46.75,15.21,12.24,9.25
20-11-2020,ARGANIL,104,7,944,"[480,960]",Muito Elevado,,,,104,Centro,COIMBRA,0601,33283.93,11014,672,648,612,559,596,1155,1767,2415,3087,33.09,9.27,7.26,5.31
20-11-2020,ARMAMAR,49,3,849,"[480,960]",Muito Elevado,,,,49,Norte,VISEU,1801,11723.73,5769,357,305,309,285,310,595,904,1209,1566,49.21,13.36,10.31,7.71
20-11-2020,AROUCA,215,15,1038,"[960,Max]",Extremamente Elevado,,,,215,Norte,AVEIRO,0104,32910.52,20720,1306,1047,753,683,683,1366,2119,3166,4472,62.96,13.59,9.62,6.44
20-11-2020,ARRAIOLOS,6,0,87,"[60,120]",Moderado,,,,6,Alentejo,ÉVORA,0702,68374.55,6928,435,384,283,367,480,847,1130,1514,1949,10.13,2.85,2.21,1.65
20-11-2020,ARRONCHES,8,1,284,"[240,480]",Elevado,,,,8,Alentejo,PORTALEGRE,1202,31464.72,2820,155,142,162,187,179,366,528,670,825,8.96,2.62,2.13,1.68
20-11-2020,ARRUDA DOS VINHOS,51,4,331,"[240,480]",Elevado,,,,51,Lisboa e Vale do Tejo,LISBOA,1102,7795.93,15412,738,738,562,509,438,947,1509,2247,2985,197.69,38.29,28.82,19.36
20-11-2020,AVEIRO,400,29,508,"[480,960]",Muito Elevado,,,,400,Centro,AVEIRO,0105,19757.57,78734,4520,4004,3050,2250,2103,4353,7403,11407,15927,398.49,80.61,57.73,37.47
20-11-2020,AVIS,7,1,165,"[120,240]",Moderado,,,,7,Alentejo,PORTALEGRE,1203,60596.51,4247,315,225,206,251,273,524,730,955,1270,7.01,2.1,1.58,1.2
20-11-2020,AZAMBUJA,127,9,559,"[480,960]",Muito Elevado,,,,127,Lisboa e Vale do Tejo,LISBOA,1103,26265.65,22716,1322,1171,1070,798,618,1416,2486,3657,4979,86.48,18.96,13.92,9.46
20-11-2020,BAIÃO,122,9,651,"[480,960]",Muito Elevado,,,,122,Norte,PORTO,1302,17452.83,18748,1070,862,714,686,725,1411,2125,2987,4057,107.42,23.25,17.11,12.18
20-11-2020,BARCELOS,1549,111,1333,"[960,Max]",Extremamente Elevado,,,,1549,Norte,BRAGA,0302,37890.14,116187,6721,5325,3619,2991,2562,5553,9172,14497,21218,306.64,56.0,38.26,24.21
20-11-2020,BARRANCOS,3,0,184,"[120,240]",Moderado,,,,3,Alentejo,BEJA,0204,16841.73,1634,90,65,65,94,61,155,220,285,375,9.7,2.23,1.69,1.31
20-11-2020,BARREIRO,271,19,361,"[240,480]",Elevado,,,,271,Lisboa e Vale do Tejo,SETÚBAL,1504,3639.07,75147,5194,5565,4459,3105,1767,4872,9331,14896,20090,2065.05,552.07,409.34,256.42
20-11-2020,BATALHA,39,3,244,"[240,480]",Elevado,,,,39,Centro,LEIRIA,1004,10341.6,15963,873,762,649,529,549,1078,1727,2489,3362,154.35,32.51,24.07,16.7
20-11-2020,BEJA,49,4,146,"[120,240]",Moderado,,,,49,Alentejo,BEJA,0205,114647.55,33579,2005,1840,1386,1272,1039,2311,3697,5537,7542,29.29,6.58,4.83,3.22
20-11-2020,BELMONTE,108,8,1688,"[960,Max]",Extremamente Elevado,,,,108,Centro,CASTELO BRANCO,0501,11875.91,6398,444,321,325,310,355,665,990,1311,1755,53.87,14.78,11.04,8.34
20-11-2020,BENAVENTE,83,6,271,"[240,480]",Elevado,,,,83,Lisboa e Vale do Tejo,SANTARÉM,1405,52138.39,30602,1468,1376,1141,876,643,1519,2660,4036,5504,58.69,10.56,7.74,5.1
20-11-2020,BOMBARRAL,26,2,207,"[120,240]",Moderado,,,,26,Lisboa e Vale do Tejo,LEIRIA,1005,9128.55,12558,875,714,561,491,429,920,1481,2195,3070,137.56,33.63,24.04,16.22
20-11-2020,BORBA,9,1,134,"[120,240]",Moderado,,,,9,Alentejo,ÉVORA,0703,14518.65,6736,430,375,279,436,392,828,1107,1482,1912,46.39,13.17,10.21,7.62
20-11-2020,BOTICAS,26,2,520,"[480,960]",Muito Elevado,,,,26,Norte,VILA REAL,1702,32195.66,4998,347,306,311,305,380,685,996,1302,1649,15.52,5.12,4.04,3.09
20-11-2020,BRAGA,2231,159,1221,"[960,Max]",Extremamente Elevado,,,,2231,Norte,BRAGA,0303,18339.95,182679,10029,7963,5241,4320,3671,7991,13232,21195,31224,996.07,170.25,115.57,72.15
20-11-2020,BRAGANÇA,191,14,568,"[480,960]",Muito Elevado,,,,191,Norte,BRAGANÇA,0402,117357.27,33607,2402,1855,1652,1393,1163,2556,4208,6063,8465,28.64,7.21,5.17,3.59
20-11-2020,CABECEIRAS DE BASTO,132,9,845,"[480,960]",Muito Elevado,,,,132,Norte,BRAGA,0304,24182.16,15628,774,594,544,575,574,1149,1693,2287,3061,64.63,12.66,9.46,7.0
20-11-2020,CADAVAL,50,4,366,"[240,480]",Elevado,,,,50,Lisboa e Vale do Tejo,LISBOA,1104,17489.3,13673,813,796,756,621,625,1246,2002,2798,3611,78.18,20.65,16.0,11.45
20-11-2020,CALDAS DA RAINHA,113,8,218,"[120,240]",Moderado,,,,113,Lisboa e Vale do Tejo,LEIRIA,1006,25569.47,51912,3035,2684,2186,1899,1705,3604,5790,8474,11509,203.03,45.01,33.14,22.64
20-11-2020,CALHETA,5,0,46,"[20,60]",Moderado,,,,5,Madeira,MADEIRA,3101,11150.43,10867,576,497,507,399,415,814,1321,1818,2394,97.46,21.47,16.3,11.85
20-11-2020,CALHETA (AÇORES),0,0,0,"[0,20]",Moderado,,,,0,Açores,AÇORES,4501,12626.4,3184,215,159,141,139,122,261,402,561,776,25.22,6.15,4.44,3.18
20-11-2020,CÂMARA DE LOBOS,23,2,68,"[60,120]",Moderado,,,,23,Madeira,MADEIRA,3102,5216.67,33675,1396,1059,834,545,381,926,1760,2819,4215,645.49,80.79,54.03,33.74
20-11-2020,CAMINHA,175,12,1102,"[960,Max]",Extremamente Elevado,,,,175,Norte,VIANA DO CASTELO,1602,13652.14,15877,1046,944,818,646,656,1302,2120,3064,4110,116.3,30.11,22.44,15.53
20-11-2020,CAMPO MAIOR,27,2,343,"[240,480]",Elevado,,,,27,Alentejo,PORTALEGRE,1204,24720.16,7874,471,364,351,279,327,606,957,1321,1792,31.85,7.25,5.34,3.87
20-11-2020,CANTANHEDE,180,13,514,"[480,960]",Muito Elevado,,,,180,Centro,COIMBRA,0602,39088.02,35011,2346,2096,1880,1709,1451,3160,5040,7136,9482,89.57,24.26,18.26,12.89
20-11-2020,CARRAZEDA DE ANSIÃES,13,1,229,"[120,240]",Moderado,,,,13,Norte,BRAGANÇA,0403,27924.09,5666,424,389,391,312,465,777,1168,1557,1981,20.29,7.09,5.58,4.18
20-11-2020,CARREGAL DO SAL,20,1,216,"[120,240]",Moderado,,,,20,Centro,VISEU,1802,11689.21,9271,587,562,486,462,376,838,1324,1886,2473,79.31,21.16,16.13,11.33
20-11-2020,CARTAXO,135,10,566,"[480,960]",Muito Elevado,,,,135,Lisboa e Vale do Tejo,SANTARÉM,1406,15817.28,23843,1415,1376,1142,861,632,1493,2635,4011,5426,150.74,34.3,25.36,16.66
20-11-2020,CASCAIS,1307,93,612,"[480,960]",Muito Elevado,,,,1307,Lisboa e Vale do Tejo,LISBOA,1105,9740.17,213608,12151,11444,8680,6469,5248,11717,20397,31841,43992,2193.1,451.66,326.91,209.41
20-11-2020,CASTANHEIRA DE PÊRA,5,0,191,"[120,240]",Moderado,,,,5,Centro,LEIRIA,1007,6677.45,2614,233,195,157,190,187,377,534,729,962,39.15,14.41,10.92,8.0
20-11-2020,CASTELO BRANCO,191,14,367,"[240,480]",Elevado,,,,191,Centro,CASTELO BRANCO,0502,143819.15,51987,3528,3042,2499,2229,2225,4454,6953,9995,13523,36.15,9.4,6.95,4.83
20-11-2020,CASTELO DE PAIVA,194,14,1255,"[960,Max]",Extremamente Elevado,,,,194,Norte,AVEIRO,0106,11500.53,15454,881,697,545,420,431,851,1396,2093,2974,134.37,25.86,18.2,12.14
20-11-2020,CASTELO DE VIDE,3,0,103,"[60,120]",Moderado,,,,3,Alentejo,PORTALEGRE,1205,26491.24,2919,204,173,179,147,170,317,496,669,873,11.02,3.3,2.53,1.87
20-11-2020,CASTRO DAIRE,61,4,441,"[240,480]",Elevado,,,,61,Centro,VISEU,1803,37904.13,13823,942,857,765,732,773,1505,2270,3127,4069,36.47,10.74,8.25,5.99
20-11-2020,CASTRO MARIM,4,0,64,"[60,120]",Moderado,,,,4,Algarve,FARO,0804,30084.37,6237,370,345,334,322,344,666,1000,1345,1715,20.73,5.7,4.47,3.32
20-11-2020,CASTRO VERDE,12,1,173,"[120,240]",Moderado,,,,12,Alentejo,BEJA,0206,56944.23,6949,437,347,303,275,227,502,805,1152,1589,12.2,2.79,2.02,1.41
20-11-2020,CELORICO DA BEIRA,131,9,1891,"[960,Max]",Extremamente Elevado,,,,131,Centro,GUARDA,0903,24721.63,6928,430,416,363,369,535,904,1267,1683,2113,28.02,8.55,6.81,5.12
20-11-2020,CELORICO DE BASTO,183,13,961,"[960,Max]",Extremamente Elevado,,,,183,Norte,BRAGA,0305,18107.02,19040,1001,802,668,728,729,1457,2125,2927,3928,105.15,21.69,16.17,11.74
20-11-2020,CHAMUSCA,38,3,413,"[240,480]",Elevado,,,,38,Lisboa e Vale do Tejo,SANTARÉM,1407,74600.54,9197,629,583,553,465,579,1044,1597,2180,2809,12.33,3.77,2.92,2.14
20-11-2020,CHAVES,333,24,846,"[480,960]",Muito Elevado,,,,333,Norte,VILA REAL,1703,59122.95,39343,2676,2429,1991,1886,1918,3804,5795,8224,10900,66.54,18.44,13.91,9.8
20-11-2020,CINFÃES,232,17,1272,"[960,Max]",Extremamente Elevado,,,,232,Norte,VISEU,1804,23928.76,18244,1067,902,779,734,758,1492,2271,3173,4240,76.24,17.72,13.26,9.49
20-11-2020,COIMBRA,614,44,458,"[240,480]",Elevado,,,,614,Centro,COIMBRA,0603,31939.94,134166,9489,8734,6353,5139,5074,10213,16566,25300,34789,420.06,108.92,79.21,51.87
20-11-2020,CONDEIXA-A-NOVA,72,5,406,"[240,480]",Elevado,,,,72,Centro,COIMBRA,0604,13867.47,17733,871,809,717,583,490,1073,1790,2599,3470,127.88,25.02,18.74,12.91
20-11-2020,CONSTÂNCIA,24,2,596,"[480,960]",Muito Elevado,,,,24,Lisboa e Vale do Tejo,SANTARÉM,1408,8036.58,4030,211,183,187,148,155,303,490,673,884,50.14,11.0,8.37,6.1
20-11-2020,CORUCHE,91,7,521,"[480,960]",Muito Elevado,,,,91,Lisboa e Vale do Tejo,SANTARÉM,1409,111572.03,17471,1294,1090,1095,1096,1019,2115,3210,4300,5594,15.66,5.01,3.85,2.88
20-11-2020,CORVO,0,0,0,"[0,20]",Moderado,,,,0,Açores,AÇORES,4901,1711.45,464,22,21,11,13,19,32,43,64,86,27.12,5.03,3.74,2.51
20-11-2020,COVILHÃ,316,23,675,"[480,960]",Muito Elevado,,,,316,Centro,CASTELO BRANCO,0503,55560.06,46787,3533,2998,2365,2111,2193,4304,6669,9667,13200,84.21,23.76,17.4,12.0
20-11-2020,CRATO,40,3,1278,"[960,Max]",Extremamente Elevado,,,,40,Alentejo,PORTALEGRE,1206,39806.88,3129,229,258,163,182,228,410,573,831,1060,7.86,2.66,2.09,1.44
20-11-2020,CUBA,13,1,283,"[240,480]",Elevado,,,,13,Alentejo,BEJA,0207,17208.72,4595,255,233,206,190,143,333,539,772,1027,26.7,5.97,4.49,3.13
20-11-2020,ELVAS,69,5,336,"[240,480]",Elevado,,,,69,Alentejo,PORTALEGRE,1207,63128.86,20528,1057,1145,902,852,810,1662,2564,3709,4766,32.52,7.55,5.88,4.06
20-11-2020,ENTRONCAMENTO,75,5,348,"[240,480]",Elevado,,,,75,Lisboa e Vale do Tejo,SANTARÉM,1410,1372.81,21558,1066,930,868,695,592,1287,2155,3085,4151,1570.14,302.33,224.69,156.96
20-11-2020,ESPINHO,370,26,1254,"[960,Max]",Extremamente Elevado,,,,370,Norte,AVEIRO,0107,2105.68,29516,2205,1993,1430,1177,960,2137,3567,5560,7765,1401.52,368.71,264.01,169.37
20-11-2020,ESPOSENDE,278,20,813,"[480,960]",Muito Elevado,,,,278,Norte,BRAGA,0306,9540.98,34177,1831,1522,1095,894,723,1617,2712,4234,6065,358.21,63.57,44.38,28.42
20-11-2020,ESTARREJA,163,12,627,"[480,960]",Muito Elevado,,,,163,Centro,AVEIRO,0108,10817.33,26006,1503,1399,1106,953,728,1681,2787,4186,5689,240.42,52.59,38.7,25.76
20-11-2020,ESTREMOZ,34,2,267,"[240,480]",Elevado,,,,34,Alentejo,ÉVORA,0704,51379.95,12728,789,613,697,786,877,1663,2360,2973,3762,24.77,7.32,5.79,4.59
20-11-2020,ÉVORA,208,15,397,"[240,480]",Elevado,,,,208,Alentejo,ÉVORA,0705,130707.58,52428,3569,2852,2176,1966,1803,3769,5945,8797,12366,40.11,9.46,6.73,4.55
20-11-2020,FAFE,997,71,2074,"[960,Max]",Extremamente Elevado,,,,997,Norte,BRAGA,0307,21908.11,48060,3044,2455,1679,1403,1208,2611,4290,6745,9789,219.37,44.68,30.79,19.58
20-11-2020,FARO,184,13,302,"[240,480]",Elevado,,,,184,Algarve,FARO,0805,20256.79,61015,3847,3364,2604,2055,1601,3656,6260,9624,13471,301.2,66.5,47.51,30.9
20-11-2020,FELGUEIRAS,1253,90,2221,"[960,Max]",Extremamente Elevado,,,,1253,Norte,PORTO,1303,11573.75,56422,2951,2302,1601,1316,973,2289,3890,6192,9143,487.49,79.0,53.5,33.61
20-11-2020,FERREIRA DO ALENTEJO,15,1,191,"[120,240]",Moderado,,,,15,Alentejo,BEJA,0208,64820.68,7845,515,414,372,343,345,688,1060,1474,1989,12.1,3.07,2.27,1.64
20-11-2020,FERREIRA DO ZÊZERE,14,1,176,"[120,240]",Moderado,,,,14,Lisboa e Vale do Tejo,SANTARÉM,1411,19038.03,7959,470,370,416,465,456,921,1337,1707,2177,41.81,11.44,8.97,7.02
20-11-2020,FIGUEIRA DA FOZ,372,27,633,"[480,960]",Muito Elevado,,,,372,Centro,COIMBRA,0605,37905.26,58747,4032,3597,2887,2495,2043,4538,7425,11022,15054,154.98,39.72,29.08,19.59
20-11-2020,FIGUEIRA DE CASTELO RODRIGO,82,6,1468,"[960,Max]",Extremamente Elevado,,,,82,Centro,GUARDA,0904,50857.46,5584,347,352,290,352,391,743,1033,1385,1732,10.98,3.41,2.72,2.03
20-11-2020,FIGUEIRÓ DOS VINHOS,8,1,144,"[120,240]",Moderado,,,,8,Centro,LEIRIA,1008,17344.0,5568,402,386,322,309,351,660,982,1368,1770,32.1,10.21,7.89,5.66
20-11-2020,FORNOS DE ALGODRES,9,1,199,"[120,240]",Moderado,,,,9,Centro,GUARDA,0905,13145.05,4528,261,218,247,256,232,488,735,953,1214,34.45,9.24,7.25,5.59
20-11-2020,FREIXO DE ESPADA À CINTA,77,6,2335,"[960,Max]",Extremamente Elevado,,,,77,Norte,BRAGANÇA,0404,24414.29,3298,211,177,231,196,189,385,616,793,1004,13.51,4.11,3.25,2.52
20-11-2020,FRONTEIRA,6,0,202,"[120,240]",Moderado,,,,6,Alentejo,PORTALEGRE,1208,24859.58,2974,213,182,149,156,168,324,473,655,868,11.96,3.49,2.63,1.9
20-11-2020,FUNCHAL,83,6,80,"[60,120]",Moderado,,,,83,Madeira,MADEIRA,3103,7616.2,104024,6382,5086,3643,2821,1990,4811,8454,13540,19922,1365.86,261.58,177.78,111.0
20-11-2020,FUNDÃO,188,13,710,"[480,960]",Muito Elevado,,,,188,Centro,CASTELO BRANCO,0504,70019.79,26495,1781,1464,1432,1357,1643,3000,4432,5896,7677,37.84,10.96,8.42,6.33
20-11-2020,GAVIÃO,13,1,398,"[240,480]",Elevado,,,,13,Alentejo,PORTALEGRE,1209,29459.45,3263,189,186,222,263,293,556,778,964,1153,11.08,3.91,3.27,2.64
20-11-2020,GÓIS,4,0,105,"[60,120]",Moderado,,,,4,Centro,COIMBRA,0606,26330.19,3805,235,199,240,233,244,477,717,916,1151,14.45,4.37,3.48,2.72
20-11-2020,GOLEGÃ,10,1,187,"[120,240]",Moderado,,,,10,Lisboa e Vale do Tejo,SANTARÉM,1412,8431.67,5339,356,299,281,243,255,498,779,1078,1434,63.32,17.01,12.78,9.24
20-11-2020,GONDOMAR,1997,143,1203,"[960,Max]",Extremamente Elevado,,,,1997,Norte,PORTO,1304,13191.76,165985,10555,8755,6222,4450,3364,7814,14036,22791,33346,1258.22,252.77,172.76,106.4
20-11-2020,GOUVEIA,26,2,210,"[120,240]",Moderado,,,,26,Centro,GUARDA,0906,30061.17,12387,871,931,780,783,810,1593,2373,3304,4175,41.21,13.89,10.99,7.89
20-11-2020,GRÂNDOLA,49,4,335,"[240,480]",Elevado,,,,49,Alentejo,SETÚBAL,1505,82593.66,14639,834,834,708,688,672,1360,2068,2902,3736,17.72,4.52,3.51,2.5
20-11-2020,GUARDA,300,21,770,"[480,960]",Muito Elevado,,,,300,Centro,GUARDA,0907,71209.58,38969,2477,2041,1686,1415,1474,2889,4575,6616,9093,54.72,12.77,9.29,6.42
20-11-2020,GUIMARÃES,3569,255,2343,"[960,Max]",Extremamente Elevado,,,,3569,Norte,BRAGA,0308,24099.96,152309,9394,7074,4809,3877,2948,6825,11634,18708,28102,631.99,116.61,77.63,48.27
20-11-2020,HORTA,6,0,41,"[20,60]",Moderado,,,,6,Açores,AÇORES,4701,17305.53,14521,818,658,468,352,302,654,1122,1780,2598,83.91,15.01,10.29,6.48
20-11-2020,IDANHA-A-NOVA,28,2,348,"[240,480]",Elevado,,,,28,Centro,CASTELO BRANCO,0505,141633.51,8043,518,490,519,672,974,1646,2165,2655,3173,5.68,2.24,1.87,1.53
20-11-2020,ÍLHAVO,229,16,592,"[480,960]",Muito Elevado,,,,229,Centro,AVEIRO,0110,7347.55,38699,2227,1943,1444,1193,850,2043,3487,5430,7657,526.66,104.21,73.9,47.46
20-11-2020,LAGOA (FARO),67,5,294,"[240,480]",Elevado,,,,67,Algarve,FARO,0806,8825.45,22762,1314,1168,919,749,670,1419,2338,3506,4820,257.93,54.62,39.73,26.49
20-11-2020,LAGOA,28,2,190,"[120,240]",Moderado,,,,28,Açores,AÇORES,4201,4559.32,14721,536,458,349,238,235,473,822,1280,1816,322.9,39.83,28.08,18.03
20-11-2020,LAGOS,77,6,254,"[240,480]",Elevado,,,,77,Algarve,FARO,0807,21299.27,30374,1744,1434,1247,1053,1029,2082,3329,4763,6507,142.61,30.55,22.36,15.63
20-11-2020,LAJES DAS FLORES,0,0,0,"[0,20]",Moderado,,,,0,Açores,AÇORES,4801,7004.79,1463,88,53,62,46,54,100,162,215,303,20.89,4.33,3.07,2.31
20-11-2020,LAJES DO PICO,0,0,0,"[0,20]",Moderado,,,,0,Açores,AÇORES,4601,15531.09,4490,304,231,223,159,162,321,544,775,1079,28.91,6.95,4.99,3.5
20-11-2020,LAMEGO,124,9,498,"[480,960]",Muito Elevado,,,,124,Norte,VISEU,1805,16542.11,24895,1639,1284,1124,898,783,1681,2805,4089,5728,150.5,34.63,24.72,16.96
20-11-2020,LEIRIA,386,28,308,"[240,480]",Elevado,,,,386,Centro,LEIRIA,1009,56508.83,125267,7389,6366,5090,3902,3159,7061,12151,18517,25906,221.68,45.84,32.77,21.5
20-11-2020,LISBOA,3184,227,625,"[480,960]",Muito Elevado,,,,3184,Lisboa e Vale do Tejo,LISBOA,1106,10005.43,509515,33197,33340,27706,23037,26770,49807,77513,110853,144050,5092.6,1439.78,1107.98,774.74
20-11-2020,LOULÉ,164,12,239,"[120,240]",Moderado,,,,164,Algarve,FARO,0808,76366.91,68697,3890,3350,2780,2358,2251,4609,7389,10739,14629,89.96,19.16,14.06,9.68
20-11-2020,LOURES,1248,89,584,"[480,960]",Muito Elevado,,,,1248,Lisboa e Vale do Tejo,LISBOA,1107,16723.99,213687,12746,12794,9644,6669,5033,11702,21346,34140,46886,1277.73,280.35,204.14,127.64
20-11-2020,LOURINHÃ,41,3,159,"[120,240]",Moderado,,,,41,Lisboa e Vale do Tejo,LISBOA,1108,14717.2,25855,1584,1243,992,842,645,1487,2479,3722,5306,175.68,36.05,25.29,16.84
20-11-2020,LOUSÃ,77,6,449,"[240,480]",Elevado,,,,77,Centro,COIMBRA,0607,13840.01,17158,946,866,658,528,450,978,1636,2502,3448,123.97,24.91,18.08,11.82
20-11-2020,LOUSADA,1305,93,2791,"[960,Max]",Extremamente Elevado,,,,1305,Norte,PORTO,1305,9608.01,46755,2289,1698,1176,853,621,1474,2650,4348,6637,486.63,69.08,45.25,27.58
20-11-2020,MAÇÃO,12,1,191,"[120,240]",Moderado,,,,12,Lisboa e Vale do Tejo,SANTARÉM,1413,39997.98,6267,386,362,390,440,657,1097,1487,1849,2235,15.67,5.59,4.62,3.72
20-11-2020,MACEDO DE CAVALEIROS,105,7,723,"[480,960]",Muito Elevado,,,,105,Norte,BRAGANÇA,0405,69914.08,14516,1082,889,878,823,938,1761,2639,3528,4610,20.76,6.59,5.05,3.77
20-11-2020,MACHICO,8,1,40,"[20,60]",Moderado,,,,8,Madeira,MADEIRA,3104,6825.1,19981,1197,860,662,455,331,786,1448,2308,3505,292.76,51.36,33.82,21.22
20-11-2020,MADALENA,0,0,0,"[0,20]",Moderado,,,,0,Açores,AÇORES,4602,14712.33,5895,334,256,173,190,179,369,542,798,1132,40.07,7.69,5.42,3.68
20-11-2020,MAFRA,388,28,457,"[240,480]",Elevado,,,,388,Lisboa e Vale do Tejo,LISBOA,1109,29165.5,84816,3613,3334,2839,2089,1899,3988,6827,10161,13774,290.81,47.23,34.84,23.41
20-11-2020,MAIA,1359,97,978,"[960,Max]",Extremamente Elevado,,,,1359,Norte,PORTO,1306,8293.94,138971,7801,6617,4512,3339,2631,5970,10482,17099,24900,1675.56,300.22,206.16,126.38
20-11-2020,MANGUALDE,97,7,524,"[480,960]",Muito Elevado,,,,97,Centro,VISEU,1806,21925.56,18510,1198,1128,885,852,743,1595,2480,3608,4806,84.42,21.92,16.46,11.31
20-11-2020,MANTEIGAS,61,4,2029,"[960,Max]",Extremamente Elevado,,,,61,Centro,GUARDA,0908,12197.55,3007,258,197,159,167,146,313,472,669,927,24.65,7.6,5.48,3.87
20-11-2020,MARCO DE CANAVESES,772,55,1499,"[960,Max]",Extremamente Elevado,,,,772,Norte,PORTO,1307,20188.98,51496,2678,2060,1488,1265,1023,2288,3776,5836,8514,255.07,42.17,28.91,18.7
20-11-2020,MARINHA GRANDE,103,7,267,"[240,480]",Elevado,,,,103,Centro,LEIRIA,1010,18725.19,38508,2365,2302,1638,1359,1058,2417,4055,6357,8722,205.65,46.58,33.95,21.66
20-11-2020,MARVÃO,4,0,133,"[120,240]",Moderado,,,,4,Alentejo,PORTALEGRE,1210,15489.9,3005,198,185,142,197,237,434,576,761,959,19.4,6.19,4.91,3.72
20-11-2020,MATOSINHOS,1866,133,1064,"[960,Max]",Extremamente Elevado,,,,1866,Norte,PORTO,1308,6241.97,175357,11850,9977,7023,5024,3884,8908,15931,25908,37758,2809.31,604.9,415.06,255.22
20-11-2020,MEALHADA,145,10,728,"[480,960]",Muito Elevado,,,,145,Centro,AVEIRO,0111,11065.66,19914,1163,1039,810,828,831,1659,2469,3508,4671,179.96,42.21,31.7,22.31
20-11-2020,MÊDA,24,2,523,"[480,960]",Muito Elevado,,,,24,Centro,GUARDA,0909,28604.92,4587,343,306,290,288,443,731,1021,1327,1670,16.04,5.84,4.64,3.57
20-11-2020,MELGAÇO,22,2,272,"[240,480]",Elevado,,,,22,Norte,VIANA DO CASTELO,1603,23824.58,8093,507,567,578,614,675,1289,1867,2434,2941,33.97,12.34,10.22,7.84
20-11-2020,MÉRTOLA,3,0,49,"[20,60]",Moderado,,,,3,Alentejo,BEJA,0209,129287.34,6142,400,390,378,423,600,1023,1401,1791,2191,4.75,1.69,1.39,1.08
20-11-2020,MESÃO FRIO,10,1,252,"[240,480]",Elevado,,,,10,Norte,VILA REAL,1704,2664.87,3964,265,205,168,157,120,277,445,650,915,148.74,34.33,24.39,16.7
20-11-2020,MIRA,56,4,473,"[240,480]",Elevado,,,,56,Centro,COIMBRA,0608,12403.38,11832,727,729,659,550,466,1016,1675,2404,3131,95.4,25.24,19.38,13.5
20-11-2020,MIRANDA DO CORVO,120,9,944,"[480,960]",Muito Elevado,,,,120,Centro,COIMBRA,0609,12637.79,12708,706,659,568,498,404,902,1470,2129,2835,100.55,22.43,16.85,11.63
20-11-2020,MIRANDA DO DOURO,28,2,410,"[240,480]",Elevado,,,,28,Norte,BRAGANÇA,0406,48718.31,6830,482,429,442,463,470,933,1375,1804,2286,14.02,4.69,3.7,2.82
20-11-2020,MIRANDELA,109,8,501,"[480,960]",Muito Elevado,,,,109,Norte,BRAGANÇA,0407,65895.67,21754,1640,1315,1204,1078,947,2025,3229,4544,6184,33.01,9.38,6.9,4.9
20-11-2020,MOGADOURO,58,4,691,"[480,960]",Muito Elevado,,,,58,Norte,BRAGANÇA,0408,76064.93,8392,589,529,576,630,655,1285,1861,2390,2979,11.03,3.92,3.14,2.45
20-11-2020,MOIMENTA DA BEIRA,15,1,154,"[120,240]",Moderado,,,,15,Norte,VISEU,1807,21996.9,9736,576,514,471,416,461,877,1348,1862,2438,44.26,11.08,8.46,6.13
20-11-2020,MOITA,230,16,357,"[240,480]",Elevado,,,,230,Lisboa e Vale do Tejo,SETÚBAL,1506,5525.98,64407,4226,3646,2623,1801,1425,3226,5849,9495,13721,1165.53,248.3,171.82,105.85
20-11-2020,MONÇÃO,55,4,308,"[240,480]",Elevado,,,,55,Norte,VIANA DO CASTELO,1604,21130.85,17869,1161,1105,1031,1006,972,1978,3009,4114,5275,84.56,24.96,19.47,14.24
20-11-2020,MONCHIQUE,8,1,158,"[120,240]",Moderado,,,,8,Algarve,FARO,0809,39530.43,5077,353,384,321,355,392,747,1068,1452,1805,12.84,4.57,3.67,2.7
20-11-2020,MONDIM DE BASTO,48,3,691,"[480,960]",Muito Elevado,,,,48,Norte,VILA REAL,1705,17207.52,6946,395,300,314,284,283,567,881,1181,1576,40.36,9.16,6.86,5.12
20-11-2020,MONFORTE,14,1,471,"[240,480]",Elevado,,,,14,Alentejo,PORTALEGRE,1211,42024.82,2975,139,115,117,192,168,360,477,592,731,7.08,1.74,1.41,1.14
20-11-2020,MONTALEGRE,42,3,467,"[240,480]",Elevado,,,,42,Norte,VILA REAL,1706,80545.71,8997,699,628,595,603,730,1333,1928,2556,3255,11.17,4.04,3.17,2.39
20-11-2020,MONTEMOR-O-NOVO,38,3,243,"[240,480]",Elevado,,,,38,Alentejo,ÉVORA,0706,123296.65,15647,991,953,868,878,971,1849,2717,3670,4661,12.69,3.78,2.98,2.2
20-11-2020,MONTEMOR-O-VELHO,79,6,313,"[240,480]",Elevado,,,,79,Centro,COIMBRA,0610,22896.23,25224,1496,1397,1217,1057,988,2045,3262,4659,6155,110.17,26.88,20.35,14.25
20-11-2020,MONTIJO,198,14,344,"[240,480]",Elevado,,,,198,Lisboa e Vale do Tejo,SETÚBAL,1507,34861.64,57614,2771,2441,1990,1554,1109,2663,4653,7094,9865,165.26,28.3,20.35,13.35
20-11-2020,MORA,33,2,797,"[480,960]",Muito Elevado,,,,33,Alentejo,ÉVORA,0707,44395.02,4138,336,275,252,238,257,495,747,1022,1358,9.32,3.06,2.3,1.68
20-11-2020,MORTÁGUA,24,2,273,"[240,480]",Elevado,,,,24,Centro,VISEU,1808,25117.82,8803,638,584,535,499,460,959,1494,2078,2716,35.05,10.81,8.27,5.95
20-11-2020,MOURA,8,1,58,"[20,60]",Moderado,,,,8,Alentejo,BEJA,0210,95845.55,13718,817,656,665,542,461,1003,1668,2324,3141,14.31,3.28,2.42,1.74
20-11-2020,MOURÃO,1,0,41,"[20,60]",Moderado,,,,1,Alentejo,ÉVORA,0708,27862.98,2450,139,108,80,104,109,213,293,401,540,8.79,1.94,1.44,1.05
20-11-2020,MURÇA,38,3,696,"[480,960]",Muito Elevado,,,,38,Norte,VILA REAL,1707,18937.11,5463,384,341,307,306,319,625,932,1273,1657,28.85,8.75,6.72,4.92
20-11-2020,MURTOSA,72,5,700,"[480,960]",Muito Elevado,,,,72,Centro,AVEIRO,0112,7308.78,10279,509,473,403,353,409,762,1165,1638,2147,140.63,29.37,22.41,15.94
20-11-2020,NAZARÉ,72,5,508,"[480,960]",Muito Elevado,,,,72,Lisboa e Vale do Tejo,LEIRIA,1011,8243.43,14165,967,903,670,420,396,816,1486,2389,3356,171.84,40.71,28.98,18.03
20-11-2020,NELAS,48,3,370,"[240,480]",Elevado,,,,48,Centro,VISEU,1809,12571.48,12974,924,787,668,604,583,1187,1855,2642,3566,103.21,28.37,21.02,14.76
20-11-2020,NISA,37,3,610,"[480,960]",Muito Elevado,,,,37,Alentejo,PORTALEGRE,1212,57567.84,6061,405,389,355,483,478,961,1316,1705,2110,10.53,3.67,2.96,2.29
20-11-2020,NORDESTE,1,0,21,"[20,60]",Moderado,,,,1,Açores,AÇORES,4202,10146.8,4862,246,180,124,161,162,323,447,627,873,47.92,8.6,6.18,4.41
20-11-2020,ÓBIDOS,27,2,228,"[120,240]",Moderado,,,,27,Lisboa e Vale do Tejo,LEIRIA,1012,14155.44,11850,743,650,574,452,436,888,1462,2112,2855,83.72,20.17,14.92,10.33
20-11-2020,ODEMIRA,49,3,198,"[120,240]",Moderado,,,,49,Alentejo,BEJA,0211,172060.15,24717,1475,1317,1225,1397,1349,2746,3971,5288,6763,14.37,3.93,3.07,2.31
20-11-2020,ODIVELAS,912,65,564,"[480,960]",Muito Elevado,,,,912,Lisboa e Vale do Tejo,LISBOA,1116,2654.36,161774,9562,9038,6952,4641,3812,8453,15405,24443,34005,6095.48,1281.27,920.99,580.44
20-11-2020,OEIRAS,734,52,414,"[240,480]",Elevado,,,,734,Lisboa e Vale do Tejo,LISBOA,1110,4588.31,177408,11580,11575,8566,6211,5855,12066,20632,32207,43787,3866.78,954.38,701.98,449.69
20-11-2020,OLEIROS,26,2,520,"[480,960]",Muito Elevado,,,,26,Centro,CASTELO BRANCO,0506,47109.31,5003,384,341,366,397,487,884,1250,1591,1975,10.62,4.19,3.38,2.65
20-11-2020,OLHÃO,86,6,194,"[120,240]",Moderado,,,,86,Algarve,FARO,0810,13086.38,44405,2455,2309,1689,1342,1268,2610,4299,6608,9063,339.33,69.26,50.5,32.85
20-11-2020,OLIVEIRA DE AZEMÉIS,985,70,1492,"[960,Max]",Extremamente Elevado,,,,985,Norte,AVEIRO,0113,16110.41,66011,4155,3614,2794,2183,1738,3921,6715,10329,14484,409.75,89.91,64.12,41.68
20-11-2020,OLIVEIRA DE FRADES,58,4,584,"[480,960]",Muito Elevado,,,,58,Centro,VISEU,1810,14534.62,9936,553,475,438,359,415,774,1212,1687,2240,68.36,15.41,11.61,8.34
20-11-2020,OLIVEIRA DO BAIRRO,150,11,618,"[480,960]",Muito Elevado,,,,150,Centro,AVEIRO,0114,8731.99,24277,1327,1182,999,786,810,1596,2595,3777,5104,278.02,58.45,43.25,29.72
20-11-2020,OLIVEIRA DO HOSPITAL,29,2,151,"[120,240]",Moderado,,,,29,Centro,COIMBRA,0611,23451.66,19253,1161,1097,962,924,960,1884,2846,3943,5104,82.1,21.76,16.81,12.14
20-11-2020,OURÉM,257,18,584,"[480,960]",Muito Elevado,,,,257,Lisboa e Vale do Tejo,SANTARÉM,1421,41668.03,44044,2463,2069,1899,1817,1603,3420,5319,7388,9851,105.7,23.64,17.73,12.77
20-11-2020,OURIQUE,3,0,65,"[60,120]",Moderado,,,,3,Alentejo,BEJA,0212,66331.36,4607,313,287,284,268,227,495,779,1066,1379,6.95,2.08,1.61,1.17
20-11-2020,OVAR,545,39,1004,"[960,Max]",Extremamente Elevado,,,,545,Centro,AVEIRO,0115,14770.25,54260,3294,2709,1994,1636,1234,2870,4864,7573,10867,367.37,73.57,51.27,32.93
20-11-2020,PAÇOS DE FERREIRA,1437,103,2533,"[960,Max]",Extremamente Elevado,,,,1437,Norte,PORTO,1309,7099.29,56728,2903,2193,1518,1135,664,1799,3317,5510,8413,799.1,118.51,77.62,46.72
20-11-2020,PALMELA,221,16,344,"[240,480]",Elevado,,,,221,Lisboa e Vale do Tejo,SETÚBAL,1508,46512.01,64269,3402,3244,2635,1846,1391,3237,5872,9116,12518,138.18,26.91,19.6,12.62
20-11-2020,PAMPILHOSA DA SERRA,28,2,694,"[480,960]",Muito Elevado,,,,28,Centro,COIMBRA,0612,39646.24,4037,238,254,295,339,423,762,1057,1311,1549,10.18,3.91,3.31,2.67
20-11-2020,PAREDES,1469,105,1707,"[960,Max]",Extremamente Elevado,,,,1469,Norte,PORTO,1310,15675.69,86067,4272,3532,2412,1717,1258,2975,5387,8919,13191,549.04,84.15,56.9,34.36
20-11-2020,PAREDES DE COURA,27,2,316,"[240,480]",Elevado,,,,27,Norte,VIANA DO CASTELO,1605,13818.59,8535,466,528,407,465,515,980,1387,1915,2381,61.76,17.23,13.86,10.04
20-11-2020,PEDRÓGÃO GRANDE,6,0,176,"[120,240]",Moderado,,,,6,Centro,LEIRIA,1013,12874.75,3410,175,173,196,221,252,473,669,842,1017,26.49,7.9,6.54,5.2
20-11-2020,PENACOVA,68,5,497,"[480,960]",Muito Elevado,,,,68,Centro,COIMBRA,0613,21673.23,13694,968,923,745,621,703,1324,2069,2992,3960,63.18,18.27,13.81,9.55
20-11-2020,PENAFIEL,1471,105,2108,"[960,Max]",Extremamente Elevado,,,,1471,Norte,PORTO,1311,21224.27,69772,3648,2823,2032,1663,1230,2893,4925,7748,11396,328.74,53.69,36.51,23.2
20-11-2020,PENALVA DO CASTELO,27,2,379,"[240,480]",Elevado,,,,27,Centro,VISEU,1811,13433.92,7115,449,457,413,391,426,817,1230,1687,2136,52.96,15.9,12.56,9.16
20-11-2020,PENAMACOR,24,2,505,"[480,960]",Muito Elevado,,,,24,Centro,CASTELO BRANCO,0507,56370.69,4755,262,248,273,451,633,1084,1357,1605,1867,8.44,3.31,2.85,2.41
20-11-2020,PENEDONO,7,0,270,"[240,480]",Elevado,,,,7,Norte,VISEU,1812,13370.75,2591,172,113,129,156,138,294,423,536,708,19.38,5.3,4.01,3.16
20-11-2020,PENELA,28,2,519,"[480,960]",Muito Elevado,,,,28,Centro,COIMBRA,0614,13480.0,5397,314,324,274,359,344,703,977,1301,1615,40.04,11.98,9.65,7.25
20-11-2020,PENICHE,110,8,415,"[240,480]",Elevado,,,,110,Lisboa e Vale do Tejo,LEIRIA,1014,7754.98,26501,1746,1504,1203,926,707,1633,2836,4340,6086,341.73,78.48,55.96,36.57
20-11-2020,PESO DA RÉGUA,53,4,336,"[240,480]",Elevado,,,,53,Norte,VILA REAL,1708,9486.01,15773,1076,843,650,659,455,1114,1764,2607,3683,166.28,38.83,27.48,18.6
20-11-2020,PINHEL,10,1,117,"[60,120]",Moderado,,,,10,Centro,GUARDA,0910,48452.12,8511,577,566,551,538,689,1227,1778,2344,2921,17.57,6.03,4.84,3.67
20-11-2020,POMBAL,296,21,575,"[480,960]",Muito Elevado,,,,296,Centro,LEIRIA,1015,62600.28,51461,3187,2791,2494,2328,2027,4355,6849,9640,12827,82.21,20.49,15.4,10.94
20-11-2020,PONTA DELGADA,127,9,187,"[120,240]",Moderado,,,,127,Açores,AÇORES,4203,23298.65,67935,3108,2435,1726,1133,902,2035,3761,6196,9304,291.58,39.93,26.59,16.14
20-11-2020,PONTA DO SOL,5,0,58,"[20,60]",Moderado,,,,5,Madeira,MADEIRA,3105,4622.03,8593,319,283,347,208,221,429,776,1059,1378,185.92,29.81,22.91,16.79
20-11-2020,PONTE DA BARCA,33,2,295,"[240,480]",Elevado,,,,33,Norte,VIANA DO CASTELO,1606,18211.37,11180,635,576,517,554,490,1044,1561,2137,2772,61.39,15.22,11.73,8.57
20-11-2020,PONTE DE LIMA,359,26,869,"[480,960]",Muito Elevado,,,,359,Norte,VIANA DO CASTELO,1607,32025.46,41315,2321,2022,1720,1596,1462,3058,4778,6800,9121,129.01,28.48,21.23,14.92
20-11-2020,PONTE DE SOR,38,3,253,"[240,480]",Elevado,,,,38,Alentejo,PORTALEGRE,1213,83971.16,14994,939,800,716,739,831,1570,2286,3086,4025,17.86,4.79,3.68,2.72
20-11-2020,PORTALEGRE,294,21,1326,"[960,Max]",Extremamente Elevado,,,,294,Alentejo,PORTALEGRE,1214,44713.64,22172,1577,1351,1137,993,984,1977,3114,4465,6042,49.59,13.51,9.99,6.96
20-11-2020,PORTEL,2,0,34,"[20,60]",Moderado,,,,2,Alentejo,ÉVORA,0709,60100.57,5828,336,358,283,331,305,636,919,1277,1613,9.7,2.68,2.12,1.53
20-11-2020,PORTIMÃO,205,15,369,"[240,480]",Elevado,,,,205,Algarve,FARO,0811,18206.29,55483,3182,2927,2116,1582,1400,2982,5098,8025,11207,304.75,61.56,44.08,28.0
20-11-2020,PORTO,2372,169,1095,"[960,Max]",Extremamente Elevado,,,,2372,Norte,PORTO,1312,4142.02,216606,15790,15193,11280,9409,10044,19453,30733,45926,61716,5229.5,1490.0,1108.79,741.98
20-11-2020,PORTO DE MÓS,73,5,314,"[240,480]",Elevado,,,,73,Centro,LEIRIA,1016,26183.41,23275,1355,1210,1034,888,872,1760,2794,4004,5359,88.89,20.47,15.29,10.67
20-11-2020,PORTO MONIZ,0,0,0,"[0,20]",Moderado,,,,0,Madeira,MADEIRA,3106,8293.38,2342,143,130,95,98,120,218,313,443,586,28.24,7.07,5.34,3.77
20-11-2020,PORTO SANTO,1,0,19,"[0,20]",Moderado,,,,1,Madeira,MADEIRA,3201,4300.7,5202,240,157,134,110,68,178,312,469,709,120.95,16.48,10.9,7.25
20-11-2020,PÓVOA DE LANHOSO,286,20,1330,"[960,Max]",Extremamente Elevado,,,,286,Norte,BRAGA,0309,13465.29,21499,1175,909,732,673,624,1297,2029,2938,4113,159.67,30.55,21.82,15.07
20-11-2020,PÓVOA DE VARZIM,1021,73,1626,"[960,Max]",Extremamente Elevado,,,,1021,Norte,PORTO,1313,8220.59,62784,3712,3120,2134,1594,1305,2899,5033,8153,11865,763.7,144.33,99.17,61.22
20-11-2020,POVOAÇÃO,2,0,34,"[20,60]",Moderado,,,,2,Açores,AÇORES,4204,10640.77,5927,293,212,191,144,134,278,469,681,974,55.7,9.15,6.4,4.41
20-11-2020,VILA DA PRAIA DA VITÓRIA,29,2,136,"[120,240]",Moderado,,,,29,Açores,AÇORES,4302,16127.06,21317,1133,789,619,436,336,772,1391,2180,3313,132.18,20.54,13.52,8.63
20-11-2020,PROENÇA-A-NOVA,46,3,630,"[480,960]",Muito Elevado,,,,46,Centro,CASTELO BRANCO,0508,39539.96,7298,508,465,389,400,560,960,1349,1814,2322,18.46,5.87,4.59,3.41
20-11-2020,REDONDO,24,2,378,"[240,480]",Elevado,,,,24,Alentejo,ÉVORA,0710,36950.87,6353,349,325,288,288,354,642,930,1255,1604,17.19,4.34,3.4,2.52
20-11-2020,REGUENGOS DE MONSARAZ,56,4,559,"[480,960]",Muito Elevado,,,,56,Alentejo,ÉVORA,0711,46399.72,10015,602,511,455,462,473,935,1390,1901,2503,21.58,5.39,4.1,3.0
20-11-2020,RESENDE,51,4,503,"[480,960]",Muito Elevado,,,,51,Norte,VISEU,1813,12334.93,10137,560,493,448,433,422,855,1303,1796,2356,82.18,19.1,14.56,10.56
20-11-2020,RIBEIRA BRAVA,6,0,48,"[20,60]",Moderado,,,,6,Madeira,MADEIRA,3107,6544.88,12435,648,500,411,311,287,598,1009,1509,2157,189.99,32.96,23.06,15.42
20-11-2020,RIBEIRA DE PENA,26,2,432,"[240,480]",Elevado,,,,26,Norte,VILA REAL,1709,21745.98,6016,371,301,290,310,368,678,968,1269,1640,27.66,7.54,5.84,4.45
20-11-2020,RIBEIRA GRANDE,54,4,165,"[120,240]",Moderado,,,,54,Açores,AÇORES,4205,18015.13,32811,1163,689,512,345,253,598,1110,1799,2962,182.13,16.44,9.99,6.16
20-11-2020,RIO MAIOR,67,5,329,"[240,480]",Elevado,,,,67,Lisboa e Vale do Tejo,SANTARÉM,1414,27276.45,20379,1251,1144,941,795,648,1443,2384,3528,4779,74.71,17.52,12.93,8.74
20-11-2020,SABROSA,32,2,541,"[480,960]",Muito Elevado,,,,32,Norte,VILA REAL,1710,15692.45,5918,393,314,304,302,350,652,956,1270,1663,37.71,10.6,8.09,6.09
20-11-2020,SABUGAL,71,5,671,"[480,960]",Muito Elevado,,,,71,Centro,GUARDA,0911,82269.82,10585,724,707,694,796,1009,1805,2499,3206,3930,12.87,4.78,3.9,3.04
20-11-2020,SALVATERRA DE MAGOS,87,6,409,"[240,480]",Elevado,,,,87,Lisboa e Vale do Tejo,SANTARÉM,1415,24393.2,21295,1275,1181,1060,799,772,1571,2631,3812,5087,87.3,20.85,15.63,10.79
20-11-2020,SANTA COMBA DÃO,18,1,172,"[120,240]",Moderado,,,,18,Centro,VISEU,1814,11194.77,10452,732,684,569,538,464,1002,1571,2255,2987,93.36,26.68,20.14,14.03
20-11-2020,SANTA CRUZ,70,5,155,"[120,240]",Moderado,,,,70,Madeira,MADEIRA,3108,8150.28,45281,1817,1301,974,716,523,1239,2213,3514,5331,555.6,65.41,43.12,27.15
20-11-2020,SANTA CRUZ DA GRACIOSA,0,0,0,"[0,20]",Moderado,,,,0,Açores,AÇORES,4401,6065.78,4208,228,180,163,124,145,269,432,612,840,69.37,13.85,10.09,7.12
20-11-2020,SANTA CRUZ DAS FLORES,2,0,92,"[60,120]",Moderado,,,,2,Açores,AÇORES,4802,7091.44,2165,125,98,74,56,51,107,181,279,404,30.53,5.7,3.93,2.55
20-11-2020,SANTA MARIA DA FEIRA,2048,146,1477,"[960,Max]",Extremamente Elevado,,,,2048,Norte,AVEIRO,0109,21587.65,138636,8182,6743,4771,3856,3079,6935,11706,18449,26631,642.19,123.36,85.46,54.22
20-11-2020,SANTA MARTA DE PENAGUIÃO,56,4,849,"[480,960]",Muito Elevado,,,,56,Norte,VILA REAL,1711,6928.13,6599,483,373,337,316,317,633,970,1343,1826,95.25,26.36,19.39,14.0
20-11-2020,SANTANA,0,0,0,"[0,20]",Moderado,,,,0,Madeira,MADEIRA,3109,9547.3,6711,418,353,343,282,277,559,902,1255,1673,70.29,17.52,13.15,9.45
20-11-2020,SANTARÉM,270,19,470,"[240,480]",Elevado,,,,270,Lisboa e Vale do Tejo,SANTARÉM,1416,55253.58,57421,3654,3441,2760,2466,2206,4672,7432,10873,14527,103.92,26.29,19.68,13.45
20-11-2020,SANTIAGO DO CACÉM,26,2,90,"[60,120]",Moderado,,,,26,Alentejo,SETÚBAL,1509,105969.29,28791,2144,1689,1472,1295,1215,2510,3982,5671,7815,27.17,7.37,5.35,3.76
20-11-2020,SANTO TIRSO,1317,94,1935,"[960,Max]",Extremamente Elevado,,,,1317,Norte,PORTO,1314,13655.52,68055,4911,3935,2761,2257,1810,4067,6828,10763,15674,498.35,114.78,78.82,50.0
20-11-2020,SÃO BRÁS DE ALPORTEL,17,1,163,"[120,240]",Moderado,,,,17,Algarve,FARO,0812,15336.92,10416,596,468,467,404,401,805,1272,1740,2336,67.91,15.23,11.35,8.29
20-11-2020,SÃO JOÃO DA MADEIRA,339,24,1544,"[960,Max]",Extremamente Elevado,,,,339,Norte,AVEIRO,0116,794.3,21958,1347,1069,796,601,593,1194,1990,3059,4406,2765.49,554.91,385.26,250.63
20-11-2020,SÃO JOÃO DA PESQUEIRA,26,2,365,"[240,480]",Elevado,,,,26,Norte,VISEU,1815,26610.85,7125,417,330,294,328,328,656,950,1280,1697,26.77,6.38,4.81,3.57
20-11-2020,SÃO PEDRO DO SUL,79,6,513,"[480,960]",Muito Elevado,,,,79,Centro,VISEU,1816,34895.09,15403,990,962,861,759,909,1668,2529,3491,4481,44.14,12.84,10.0,7.25
20-11-2020,SÃO ROQUE DO PICO,2,0,61,"[60,120]",Moderado,,,,2,Açores,AÇORES,4603,14236.1,3266,199,141,93,96,113,209,302,443,642,22.94,4.51,3.11,2.12
20-11-2020,SÃO VICENTE,0,0,0,"[0,20]",Moderado,,,,0,Madeira,MADEIRA,3110,7883.71,5143,272,264,266,225,280,505,771,1035,1307,65.23,16.58,13.13,9.78
20-11-2020,SARDOAL,15,1,401,"[240,480]",Elevado,,,,15,Lisboa e Vale do Tejo,SANTARÉM,1417,9214.72,3741,227,178,148,165,248,413,561,739,966,40.6,10.48,8.02,6.09
20-11-2020,SÁTÃO,90,6,777,"[480,960]",Muito Elevado,,,,90,Centro,VISEU,1817,20194.11,11580,765,671,515,465,476,941,1456,2127,2892,57.34,14.32,10.53,7.21
20-11-2020,SEIA,136,10,612,"[480,960]",Muito Elevado,,,,136,Centro,GUARDA,0912,43568.83,22234,1807,1589,1238,1122,721,1843,3081,4670,6477,51.03,14.87,10.72,7.07
20-11-2020,SEIXAL,882,63,526,"[480,960]",Muito Elevado,,,,882,Lisboa e Vale do Tejo,SETÚBAL,1510,9545.17,167752,10586,9270,6661,4391,2930,7321,13982,23252,33838,1757.49,354.51,243.6,146.49
20-11-2020,SERNANCELHE,2,0,37,"[20,60]",Moderado,,,,2,Norte,VISEU,1818,22861.22,5396,305,293,286,273,260,533,819,1112,1417,23.6,6.2,4.86,3.58
20-11-2020,SERPA,41,3,287,"[240,480]",Elevado,,,,41,Alentejo,BEJA,0213,110563.34,14304,903,761,719,697,626,1323,2042,2803,3706,12.94,3.35,2.54,1.85
20-11-2020,SERTÃ,18,1,123,"[120,240]",Moderado,,,,18,Centro,CASTELO BRANCO,0509,44673.17,14577,870,779,790,767,1020,1787,2577,3356,4226,32.63,9.46,7.51,5.77
20-11-2020,SESIMBRA,178,13,343,"[240,480]",Elevado,,,,178,Lisboa e Vale do Tejo,SETÚBAL,1511,19571.75,51858,2400,2321,1853,1257,1083,2340,4193,6514,8914,264.96,45.54,33.28,21.42
20-11-2020,SETÚBAL,599,43,520,"[480,960]",Muito Elevado,,,,599,Lisboa e Vale do Tejo,SETÚBAL,1512,23032.5,115126,7425,6929,5075,3775,2655,6430,11505,18434,25859,499.83,112.27,80.03,49.95
20-11-2020,SEVER DO VOUGA,66,5,582,"[480,960]",Muito Elevado,,,,66,Centro,AVEIRO,0117,12987.56,11331,766,637,568,540,567,1107,1675,2312,3078,87.24,23.7,17.8,12.9
20-11-2020,SILVES,64,5,177,"[120,240]",Moderado,,,,64,Algarve,FARO,0813,68006.23,36226,2137,1869,1610,1423,1600,3023,4633,6502,8639,53.27,12.7,9.56,6.81
20-11-2020,SINES,69,5,503,"[480,960]",Muito Elevado,,,,69,Alentejo,SETÚBAL,1513,20330.17,13715,888,791,551,416,268,684,1235,2026,2914,67.46,14.33,9.97,6.07
20-11-2020,SINTRA,1965,140,502,"[480,960]",Muito Elevado,,,,1965,Lisboa e Vale do Tejo,LISBOA,1111,31922.73,391402,20490,18316,13545,9137,7284,16421,29966,48282,68772,1226.08,215.43,151.25,93.87
20-11-2020,SOBRAL DE MONTE AGRAÇO,36,3,338,"[240,480]",Elevado,,,,36,Lisboa e Vale do Tejo,LISBOA,1112,5210.32,10651,564,507,352,272,212,484,836,1343,1907,204.43,36.6,25.78,16.05
20-11-2020,SOURE,45,3,263,"[240,480]",Elevado,,,,45,Centro,COIMBRA,0615,26506.07,17120,1173,1142,1004,883,987,1870,2874,4016,5189,64.59,19.58,15.15,10.84
20-11-2020,SOUSEL,9,1,204,"[120,240]",Moderado,,,,9,Alentejo,PORTALEGRE,1215,27932.18,4412,261,274,208,302,292,594,802,1076,1337,15.8,4.79,3.85,2.87
20-11-2020,TÁBUA,24,2,211,"[120,240]",Moderado,,,,24,Centro,COIMBRA,0616,19978.58,11368,729,584,524,430,464,894,1418,2002,2731,56.9,13.67,10.02,7.1
20-11-2020,TABUAÇO,12,1,199,"[120,240]",Moderado,,,,12,Norte,VISEU,1819,13385.67,6033,372,314,217,282,363,645,862,1176,1548,45.07,11.56,8.79,6.44
20-11-2020,TAROUCA,38,3,487,"[480,960]",Muito Elevado,,,,38,Norte,VISEU,1820,10008.49,7804,405,335,313,277,324,601,914,1249,1654,77.98,16.53,12.48,9.13
20-11-2020,TAVIRA,49,4,200,"[120,240]",Moderado,,,,49,Algarve,FARO,0814,60696.7,24530,1493,1415,1252,1066,1277,2343,3595,5010,6503,40.41,10.71,8.25,5.92
20-11-2020,TERRAS DE BOURO,20,1,314,"[240,480]",Elevado,,,,20,Norte,BRAGA,0310,27746.07,6361,391,372,296,319,340,659,955,1327,1718,22.93,6.19,4.78,3.44
20-11-2020,TOMAR,140,10,381,"[240,480]",Elevado,,,,140,Lisboa e Vale do Tejo,SANTARÉM,1418,35120.44,36748,2403,2189,1868,1853,1822,3675,5543,7732,10135,104.64,28.86,22.02,15.78
20-11-2020,TONDELA,71,5,269,"[240,480]",Elevado,,,,71,Centro,VISEU,1821,37121.73,26357,1768,1722,1518,1475,1417,2892,4410,6132,7900,71.0,21.28,16.52,11.88
20-11-2020,TORRE DE MONCORVO,50,4,650,"[480,960]",Muito Elevado,,,,50,Norte,BRAGANÇA,0409,53155.67,7695,556,478,488,551,719,1270,1758,2236,2792,14.48,5.25,4.21,3.31
20-11-2020,TORRES NOVAS,137,10,392,"[240,480]",Elevado,,,,137,Lisboa e Vale do Tejo,SANTARÉM,1419,26999.68,34933,2324,1979,1738,1406,1475,2881,4619,6598,8922,129.38,33.04,24.44,17.11
20-11-2020,TORRES VEDRAS,252,18,321,"[240,480]",Elevado,,,,252,Lisboa e Vale do Tejo,LISBOA,1113,40714.89,78530,4513,3945,3447,2628,2104,4732,8179,12124,16637,192.88,40.86,29.78,20.09
20-11-2020,TRANCOSO,37,3,417,"[240,480]",Elevado,,,,37,Centro,GUARDA,0913,36152.47,8875,581,557,542,586,496,1082,1624,2181,2762,24.55,7.64,6.03,4.49
20-11-2020,TROFA,668,48,1739,"[960,Max]",Extremamente Elevado,,,,668,Norte,PORTO,1318,7201.76,38418,2336,1894,1231,939,684,1623,2854,4748,7084,533.44,98.36,65.93,39.63
20-11-2020,VAGOS,121,9,532,"[480,960]",Muito Elevado,,,,121,Centro,AVEIRO,0118,16491.5,22740,1320,1205,922,784,724,1508,2430,3635,4955,137.89,30.04,22.04,14.73
20-11-2020,VALE DE CAMBRA,268,19,1257,"[960,Max]",Extremamente Elevado,,,,268,Norte,AVEIRO,0119,14733.47,21327,1491,1363,1005,831,798,1629,2634,3997,5488,144.76,37.25,27.13,17.88
20-11-2020,VALENÇA,164,12,1234,"[960,Max]",Extremamente Elevado,,,,164,Norte,VIANA DO CASTELO,1608,11712.86,13290,867,791,582,582,503,1085,1667,2458,3325,113.46,28.39,20.99,14.23
20-11-2020,VALONGO,1238,88,1270,"[960,Max]",Extremamente Elevado,,,,1238,Norte,PORTO,1315,7512.45,97444,5629,4696,3207,2462,1829,4291,7498,12194,17823,1297.18,237.26,162.33,99.81
20-11-2020,VALPAÇOS,96,7,648,"[480,960]",Muito Elevado,,,,96,Norte,VILA REAL,1712,54873.93,14818,1217,1118,999,928,997,1925,2924,4042,5259,27.0,9.58,7.37,5.33
20-11-2020,VELAS,5,0,98,"[60,120]",Moderado,,,,5,Açores,AÇORES,4502,11738.38,5093,278,208,166,153,113,266,432,640,918,43.39,7.82,5.45,3.68
20-11-2020,VENDAS NOVAS,8,1,71,"[60,120]",Moderado,,,,8,Alentejo,ÉVORA,0712,22238.88,11255,677,768,655,501,532,1033,1688,2456,3133,50.61,14.09,11.04,7.59
20-11-2020,VIANA DO ALENTEJO,18,1,350,"[240,480]",Elevado,,,,18,Alentejo,ÉVORA,0713,39367.29,5145,245,208,235,210,214,424,659,867,1112,13.07,2.82,2.2,1.67
20-11-2020,VIANA DO CASTELO,316,23,374,"[240,480]",Elevado,,,,316,Norte,VIANA DO CASTELO,1609,31902.01,84417,5470,4433,3591,3061,2982,6043,9634,14067,19537,264.61,61.24,44.09,30.2
20-11-2020,VIDIGUEIRA,3,0,54,"[20,60]",Moderado,,,,3,Alentejo,BEJA,0214,31661.09,5510,300,248,215,233,275,508,723,971,1271,17.4,4.01,3.07,2.28
20-11-2020,VIEIRA DO MINHO,144,10,1216,"[960,Max]",Extremamente Elevado,,,,144,Norte,BRAGA,0311,21644.35,11842,703,594,525,548,482,1030,1555,2149,2852,54.71,13.18,9.93,7.18
20-11-2020,VILA DE REI,3,0,90,"[60,120]",Moderado,,,,3,Centro,CASTELO BRANCO,0510,19154.6,3323,169,128,172,247,302,549,721,849,1018,17.35,5.31,4.43,3.76
20-11-2020,VILA DO BISPO,16,1,310,"[240,480]",Elevado,,,,16,Algarve,FARO,0815,17906.06,5154,302,302,314,232,233,465,779,1081,1383,28.78,7.72,6.04,4.35
20-11-2020,VILA DO CONDE,1282,92,1605,"[960,Max]",Extremamente Elevado,,,,1282,Norte,PORTO,1316,14902.77,79899,4726,3875,2819,2070,1743,3813,6632,10507,15233,536.13,102.21,70.5,44.5
20-11-2020,VILA DO PORTO,2,0,36,"[20,60]",Moderado,,,,2,Açores,AÇORES,4101,9688.74,5616,274,212,135,96,123,219,354,566,840,57.96,8.67,5.84,3.65
20-11-2020,VILA FLOR,10,1,165,"[120,240]",Moderado,,,,10,Norte,BRAGANÇA,0410,26581.14,6044,429,362,422,294,331,625,1047,1409,1838,22.74,6.91,5.3,3.94
20-11-2020,VILA FRANCA DE XIRA,836,60,589,"[480,960]",Muito Elevado,,,,836,Lisboa e Vale do Tejo,LISBOA,1114,31819.39,141957,8501,6852,4869,3425,2472,5897,10766,17618,26119,446.14,82.09,55.37,33.84
20-11-2020,VILA FRANCA DO CAMPO,3,0,27,"[20,60]",Moderado,,,,3,Açores,AÇORES,4206,7796.82,11051,450,344,248,217,154,371,619,963,1413,141.73,18.12,12.35,7.94
20-11-2020,VILA NOVA DA BARQUINHA,24,2,322,"[240,480]",Elevado,,,,24,Lisboa e Vale do Tejo,SANTARÉM,1420,4952.97,7461,415,406,392,364,338,702,1094,1500,1915,150.64,38.66,30.28,22.09
20-11-2020,VILA NOVA DE CERVEIRA,42,3,471,"[240,480]",Elevado,,,,42,Norte,VIANA DO CASTELO,1610,10846.66,8910,531,444,410,384,334,718,1128,1572,2103,82.14,19.39,14.49,10.4
20-11-2020,VILA NOVA DE FAMALICÃO,2445,175,1857,"[960,Max]",Extremamente Elevado,,,,2445,Norte,BRAGA,0312,20159.26,131676,7817,6164,4202,3282,2749,6031,10233,16397,24214,653.19,120.12,81.34,50.76
20-11-2020,VILA NOVA DE FOZ CÔA,37,3,569,"[480,960]",Muito Elevado,,,,37,Centro,GUARDA,0914,39815.18,6503,442,385,390,398,429,827,1217,1602,2044,16.33,5.13,4.02,3.06
20-11-2020,VILA NOVA DE GAIA,3251,232,1082,"[960,Max]",Extremamente Elevado,,,,3251,Norte,PORTO,1317,16846.43,300472,18349,15568,10972,8224,6281,14505,25477,41045,59394,1783.64,352.57,243.65,151.23
20-11-2020,VILA NOVA DE PAIVA,34,2,725,"[480,960]",Muito Elevado,,,,34,Centro,VISEU,1822,17553.28,4687,289,272,233,217,241,458,691,963,1252,26.7,7.13,5.49,3.94
20-11-2020,VILA NOVA DE POIARES,24,2,346,"[240,480]",Elevado,,,,24,Centro,COIMBRA,0617,8445.3,6939,380,284,262,235,182,417,679,963,1343,82.17,15.9,11.4,8.04
20-11-2020,VILA POUCA DE AGUIAR,81,6,677,"[480,960]",Muito Elevado,,,,81,Norte,VILA REAL,1713,43706.62,11961,860,817,733,601,627,1228,1961,2778,3638,27.37,8.32,6.36,4.49
20-11-2020,VILA REAL,338,24,677,"[480,960]",Muito Elevado,,,,338,Norte,VILA REAL,1714,37880.28,49962,3025,2498,2065,1579,1466,3045,5110,7608,10633,131.9,28.07,20.08,13.49
20-11-2020,VILA REAL DE SANTO ANTÓNIO,28,2,149,"[120,240]",Moderado,,,,28,Algarve,FARO,0816,6125.0,18749,1172,1069,811,569,586,1155,1966,3035,4207,306.11,68.69,49.55,32.1
20-11-2020,VILA VELHA DE RÓDÃO,0,0,0,"[0,20]",Moderado,,,,0,Centro,CASTELO BRANCO,0511,32991.16,3144,209,229,180,283,306,589,769,998,1207,9.53,3.66,3.03,2.33
20-11-2020,VILA VERDE,412,29,878,"[480,960]",Muito Elevado,,,,412,Norte,BRAGA,0313,22866.52,46911,2365,2063,1667,1494,1437,2931,4598,6661,9026,205.15,39.47,29.13,20.11
20-11-2020,VILA VIÇOSA,19,1,248,"[240,480]",Elevado,,,,19,Alentejo,ÉVORA,0714,19485.89,7656,487,379,342,345,324,669,1011,1390,1877,39.29,9.63,7.13,5.19
20-11-2020,VIMIOSO,16,1,398,"[240,480]",Elevado,,,,16,Norte,BRAGANÇA,0411,48158.51,4023,274,230,261,293,335,628,889,1119,1393,8.35,2.89,2.32,1.85
20-11-2020,VINHAIS,28,2,361,"[240,480]",Elevado,,,,28,Norte,BRAGANÇA,0412,69475.09,7746,599,577,636,641,815,1456,2092,2669,3268,11.15,4.7,3.84,3.01
20-11-2020,VISEU,414,30,426,"[240,480]",Elevado,,,,414,Centro,VISEU,1823,50710.14,97249,5769,5038,4140,3158,2710,5868,10008,15046,20815,191.77,41.05,29.67,19.74
20-11-2020,VIZELA,603,43,2523,"[960,Max]",Extremamente Elevado,,,,603,Norte,BRAGA,0314,2469.83,23897,1258,928,655,509,371,880,1535,2463,3721,967.49,150.65,99.72,62.15
20-11-2020,VOUZELA,20,1,208,"[120,240]",Moderado,,,,20,Centro,VISEU,1824,19369.46,9619,626,605,554,532,507,1039,1593,2198,2824,49.66,14.58,11.35,8.22
26-11-2020,ABRANTES,147,10,418,"[240,480]",Elevado,,,,147,Lisboa e Vale do Tejo,SANTARÉM,1401,71469.08,35130,2473,2213,1730,1748,2021,3769,5499,7712,10185,49.15,14.25,10.79,7.69
26-11-2020,ÁGUEDA,322,23,699,"[480,960]",Muito Elevado,,,,322,Centro,AVEIRO,0101,33527.44,46075,3237,2713,2090,1635,1496,3131,5221,7934,11171,137.43,33.32,23.66,15.57
26-11-2020,AGUIAR DA BEIRA,11,1,236,"[0,240]",Moderado,,,,11,Centro,GUARDA,0901,20676.57,4652,304,281,235,239,148,387,622,903,1207,22.5,5.84,4.37,3.01
26-11-2020,ALANDROAL,27,2,541,"[480,960]",Muito Elevado,,,,27,Alentejo,ÉVORA,0701,54267.81,4992,307,256,296,299,377,676,972,1228,1535,9.2,2.83,2.26,1.79
26-11-2020,ALBERGARIA-A-VELHA,167,12,692,"[480,960]",Muito Elevado,,,,167,Centro,AVEIRO,0102,15882.5,24144,1550,1298,996,687,680,1367,2363,3661,5211,152.02,32.81,23.05,14.88
26-11-2020,ALBUFEIRA,113,8,272,"[240,480]",Elevado,,,,113,Algarve,FARO,0801,14066.42,41528,2067,1717,1425,985,858,1843,3268,4985,7052,295.24,50.14,35.44,23.23
26-11-2020,ALCÁCER DO SAL,24,2,206,"[0,240]",Moderado,,,,24,Alentejo,SETÚBAL,1501,149987.3,11659,884,814,623,623,602,1225,1848,2662,3546,7.77,2.36,1.77,1.23
26-11-2020,ALCANENA,142,10,1109,"[960,Max]",Extremamente Elevado,,,,142,Lisboa e Vale do Tejo,SANTARÉM,1402,12732.86,12809,891,744,628,536,588,1124,1752,2496,3387,100.6,26.6,19.6,13.76
26-11-2020,ALCOBAÇA,206,15,385,"[240,480]",Elevado,,,,206,Lisboa e Vale do Tejo,LEIRIA,1001,40814.09,53555,3420,2927,2466,2059,1676,3735,6201,9128,12548,131.22,30.74,22.36,15.19
26-11-2020,ALCOCHETE,72,5,364,"[240,480]",Elevado,,,,72,Lisboa e Vale do Tejo,SETÚBAL,1502,12836.48,19787,857,834,691,476,447,923,1614,2448,3305,154.15,25.75,19.07,12.57
26-11-2020,ALCOUTIM,0,0,0,"[0,240]",Moderado,,,,0,Algarve,FARO,0802,57536.33,2159,191,188,163,190,267,457,620,808,999,3.75,1.74,1.4,1.08
26-11-2020,ALENQUER,187,13,424,"[240,480]",Elevado,,,,187,Lisboa e Vale do Tejo,LISBOA,1101,30421.92,44052,2298,2062,1629,1330,1155,2485,4114,6176,8474,144.8,27.85,20.3,13.52
26-11-2020,ALFÂNDEGA DA FÉ,44,3,967,"[960,Max]",Extremamente Elevado,,,,44,Norte,BRAGANÇA,0401,32194.64,4550,325,277,301,274,325,599,900,1177,1502,14.13,4.67,3.66,2.8
26-11-2020,ALIJÓ,67,5,631,"[480,960]",Muito Elevado,,,,67,Norte,VILA REAL,1701,29759.89,10625,766,687,635,542,666,1208,1843,2530,3296,35.7,11.08,8.5,6.19
26-11-2020,ALJEZUR,5,0,89,"[0,240]",Moderado,,,,5,Algarve,FARO,0803,32349.95,5594,316,336,335,320,410,730,1065,1401,1717,17.29,5.31,4.33,3.29
26-11-2020,ALJUSTREL,14,1,170,"[0,240]",Moderado,,,,14,Alentejo,BEJA,0201,45847.41,8247,635,521,443,347,358,705,1148,1669,2304,17.99,5.03,3.64,2.5
26-11-2020,ALMADA,1155,82,683,"[480,960]",Muito Elevado,,,,1155,Lisboa e Vale do Tejo,SETÚBAL,1503,7000.89,169039,10469,9777,7876,6144,5111,11255,19131,28908,39377,2414.5,562.45,412.91,273.26
26-11-2020,ALMEIDA,20,1,343,"[240,480]",Elevado,,,,20,Centro,GUARDA,0902,51798.46,5830,441,419,396,458,393,851,1247,1666,2107,11.26,4.07,3.22,2.41
26-11-2020,ALMEIRIM,69,5,306,"[240,480]",Elevado,,,,69,Lisboa e Vale do Tejo,SANTARÉM,1403,22212.05,22546,1342,1353,1106,866,843,1709,2815,4168,5510,101.5,24.81,18.76,12.67
26-11-2020,ALMODÔVAR,5,0,74,"[0,240]",Moderado,,,,5,Alentejo,BEJA,0202,77788.03,6725,414,443,396,373,328,701,1097,1540,1954,8.65,2.51,1.98,1.41
26-11-2020,ALPIARÇA,11,1,156,"[0,240]",Moderado,,,,11,Lisboa e Vale do Tejo,SANTARÉM,1404,9536.33,7059,515,486,363,333,274,607,970,1456,1971,74.02,20.67,15.27,10.17
26-11-2020,ALTER DO CHÃO,7,0,221,"[0,240]",Moderado,,,,7,Alentejo,PORTALEGRE,1201,36206.62,3165,201,163,136,208,187,395,531,694,895,8.74,2.47,1.92,1.47
26-11-2020,ALVAIÁZERE,9,1,136,"[0,240]",Moderado,,,,9,Centro,LEIRIA,1002,16047.76,6597,419,389,346,406,539,945,1291,1680,2099,41.11,13.08,10.47,8.04
26-11-2020,ALVITO,2,0,81,"[0,240]",Moderado,,,,2,Alentejo,BEJA,0203,26485.32,2477,145,110,105,111,89,200,305,415,560,9.35,2.11,1.57,1.15
26-11-2020,AMADORA,983,70,534,"[480,960]",Muito Elevado,,,,983,Lisboa e Vale do Tejo,LISBOA,1115,2378.47,184106,11186,10936,8780,6460,5890,12350,21130,32066,43252,7742.05,1818.84,1348.44,888.56
26-11-2020,AMARANTE,614,44,1154,"[960,Max]",Extremamente Elevado,,,,614,Norte,PORTO,1301,30133.15,53193,3086,2413,1812,1643,1311,2954,4766,7179,10265,176.53,34.07,23.82,15.82
26-11-2020,AMARES,217,16,1197,"[960,Max]",Extremamente Elevado,,,,217,Norte,BRAGA,0301,8195.41,18129,1001,829,622,489,524,1013,1635,2464,3465,221.22,42.28,30.07,19.95
26-11-2020,ANADIA,182,13,668,"[480,960]",Muito Elevado,,,,182,Centro,AVEIRO,0103,21663.48,27258,1931,1698,1376,1208,1262,2470,3846,5544,7475,125.83,34.51,25.59,17.75
26-11-2020,ANGRA DO HEROÍSMO,44,3,130,"[0,240]",Moderado,,,,44,Açores,AÇORES,4301,23899.66,33807,2006,1473,1122,768,635,1403,2525,3998,6004,141.45,25.12,16.73,10.56
26-11-2020,ANSIÃO,56,4,465,"[240,480]",Elevado,,,,56,Centro,LEIRIA,1003,17609.42,12039,727,709,646,694,530,1224,1870,2579,3306,68.37,18.77,14.65,10.62
26-11-2020,ARCOS DE VALDEVEZ,112,8,535,"[480,960]",Muito Elevado,,,,112,Norte,VIANA DO CASTELO,1601,44759.64,20926,1329,1338,1282,1343,1515,2858,4140,5478,6807,46.75,15.21,12.24,9.25
26-11-2020,ARGANIL,74,5,672,"[480,960]",Muito Elevado,,,,74,Centro,COIMBRA,0601,33283.93,11014,672,648,612,559,596,1155,1767,2415,3087,33.09,9.27,7.26,5.31
26-11-2020,ARMAMAR,78,6,1352,"[960,Max]",Extremamente Elevado,,,,78,Norte,VISEU,1801,11723.73,5769,357,305,309,285,310,595,904,1209,1566,49.21,13.36,10.31,7.71
26-11-2020,AROUCA,196,14,946,"[480,960]",Muito Elevado,,,,196,Norte,AVEIRO,0104,32910.52,20720,1306,1047,753,683,683,1366,2119,3166,4472,62.96,13.59,9.62,6.44
26-11-2020,ARRAIOLOS,15,1,217,"[0,240]",Moderado,,,,15,Alentejo,ÉVORA,0702,68374.55,6928,435,384,283,367,480,847,1130,1514,1949,10.13,2.85,2.21,1.65
26-11-2020,ARRONCHES,9,1,319,"[240,480]",Elevado,,,,9,Alentejo,PORTALEGRE,1202,31464.72,2820,155,142,162,187,179,366,528,670,825,8.96,2.62,2.13,1.68
26-11-2020,ARRUDA DOS VINHOS,39,3,253,"[240,480]",Elevado,,,,39,Lisboa e Vale do Tejo,LISBOA,1102,7795.93,15412,738,738,562,509,438,947,1509,2247,2985,197.69,38.29,28.82,19.36
26-11-2020,AVEIRO,475,34,603,"[480,960]",Muito Elevado,,,,475,Centro,AVEIRO,0105,19757.57,78734,4520,4004,3050,2250,2103,4353,7403,11407,15927,398.49,80.61,57.73,37.47
26-11-2020,AVIS,7,1,165,"[0,240]",Moderado,,,,7,Alentejo,PORTALEGRE,1203,60596.51,4247,315,225,206,251,273,524,730,955,1270,7.01,2.1,1.58,1.2
26-11-2020,AZAMBUJA,171,12,753,"[480,960]",Muito Elevado,,,,171,Lisboa e Vale do Tejo,LISBOA,1103,26265.65,22716,1322,1171,1070,798,618,1416,2486,3657,4979,86.48,18.96,13.92,9.46
26-11-2020,BAIÃO,152,11,811,"[480,960]",Muito Elevado,,,,152,Norte,PORTO,1302,17452.83,18748,1070,862,714,686,725,1411,2125,2987,4057,107.42,23.25,17.11,12.18
26-11-2020,BARCELOS,1873,134,1612,"[960,Max]",Extremamente Elevado,,,,1873,Norte,BRAGA,0302,37890.14,116187,6721,5325,3619,2991,2562,5553,9172,14497,21218,306.64,56.0,38.26,24.21
26-11-2020,BARRANCOS,4,0,245,"[240,480]",Elevado,,,,4,Alentejo,BEJA,0204,16841.73,1634,90,65,65,94,61,155,220,285,375,9.7,2.23,1.69,1.31
26-11-2020,BARREIRO,356,25,474,"[240,480]",Elevado,,,,356,Lisboa e Vale do Tejo,SETÚBAL,1504,3639.07,75147,5194,5565,4459,3105,1767,4872,9331,14896,20090,2065.05,552.07,409.34,256.42
26-11-2020,BATALHA,38,3,238,"[0,240]",Moderado,,,,38,Centro,LEIRIA,1004,10341.6,15963,873,762,649,529,549,1078,1727,2489,3362,154.35,32.51,24.07,16.7
26-11-2020,BEJA,52,4,155,"[0,240]",Moderado,,,,52,Alentejo,BEJA,0205,114647.55,33579,2005,1840,1386,1272,1039,2311,3697,5537,7542,29.29,6.58,4.83,3.22
26-11-2020,BELMONTE,96,7,1500,"[960,Max]",Extremamente Elevado,,,,96,Centro,CASTELO BRANCO,0501,11875.91,6398,444,321,325,310,355,665,990,1311,1755,53.87,14.78,11.04,8.34
26-11-2020,BENAVENTE,85,6,278,"[240,480]",Elevado,,,,85,Lisboa e Vale do Tejo,SANTARÉM,1405,52138.39,30602,1468,1376,1141,876,643,1519,2660,4036,5504,58.69,10.56,7.74,5.1
26-11-2020,BOMBARRAL,30,2,239,"[0,240]",Moderado,,,,30,Lisboa e Vale do Tejo,LEIRIA,1005,9128.55,12558,875,714,561,491,429,920,1481,2195,3070,137.56,33.63,24.04,16.22
26-11-2020,BORBA,5,0,74,"[0,240]",Moderado,,,,5,Alentejo,ÉVORA,0703,14518.65,6736,430,375,279,436,392,828,1107,1482,1912,46.39,13.17,10.21,7.62
26-11-2020,BOTICAS,32,2,640,"[480,960]",Muito Elevado,,,,32,Norte,VILA REAL,1702,32195.66,4998,347,306,311,305,380,685,996,1302,1649,15.52,5.12,4.04,3.09
26-11-2020,BRAGA,2473,177,1354,"[960,Max]",Extremamente Elevado,,,,2473,Norte,BRAGA,0303,18339.95,182679,10029,7963,5241,4320,3671,7991,13232,21195,31224,996.07,170.25,115.57,72.15
26-11-2020,BRAGANÇA,264,19,786,"[480,960]",Muito Elevado,,,,264,Norte,BRAGANÇA,0402,117357.27,33607,2402,1855,1652,1393,1163,2556,4208,6063,8465,28.64,7.21,5.17,3.59
26-11-2020,CABECEIRAS DE BASTO,177,13,1133,"[960,Max]",Extremamente Elevado,,,,177,Norte,BRAGA,0304,24182.16,15628,774,594,544,575,574,1149,1693,2287,3061,64.63,12.66,9.46,7.0
26-11-2020,CADAVAL,40,3,293,"[240,480]",Elevado,,,,40,Lisboa e Vale do Tejo,LISBOA,1104,17489.3,13673,813,796,756,621,625,1246,2002,2798,3611,78.18,20.65,16.0,11.45
26-11-2020,CALDAS DA RAINHA,132,9,254,"[240,480]",Elevado,,,,132,Lisboa e Vale do Tejo,LEIRIA,1006,25569.47,51912,3035,2684,2186,1899,1705,3604,5790,8474,11509,203.03,45.01,33.14,22.64
26-11-2020,CALHETA,4,0,37,"[0,240]",Moderado,,,,4,Madeira,MADEIRA,3101,11150.43,10867,576,497,507,399,415,814,1321,1818,2394,97.46,21.47,16.3,11.85
26-11-2020,CALHETA (AÇORES),1,0,31,"[0,240]",Moderado,,,,1,Açores,AÇORES,4501,12626.4,3184,215,159,141,139,122,261,402,561,776,25.22,6.15,4.44,3.18
26-11-2020,CÂMARA DE LOBOS,44,3,131,"[0,240]",Moderado,,,,44,Madeira,MADEIRA,3102,5216.67,33675,1396,1059,834,545,381,926,1760,2819,4215,645.49,80.79,54.03,33.74
26-11-2020,CAMINHA,129,9,812,"[480,960]",Muito Elevado,,,,129,Norte,VIANA DO CASTELO,1602,13652.14,15877,1046,944,818,646,656,1302,2120,3064,4110,116.3,30.11,22.44,15.53
26-11-2020,CAMPO MAIOR,11,1,140,"[0,240]",Moderado,,,,11,Alentejo,PORTALEGRE,1204,24720.16,7874,471,364,351,279,327,606,957,1321,1792,31.85,7.25,5.34,3.87
26-11-2020,CANTANHEDE,190,14,543,"[480,960]",Muito Elevado,,,,190,Centro,COIMBRA,0602,39088.02,35011,2346,2096,1880,1709,1451,3160,5040,7136,9482,89.57,24.26,18.26,12.89
26-11-2020,CARRAZEDA DE ANSIÃES,9,1,159,"[0,240]",Moderado,,,,9,Norte,BRAGANÇA,0403,27924.09,5666,424,389,391,312,465,777,1168,1557,1981,20.29,7.09,5.58,4.18
26-11-2020,CARREGAL DO SAL,30,2,324,"[240,480]",Elevado,,,,30,Centro,VISEU,1802,11689.21,9271,587,562,486,462,376,838,1324,1886,2473,79.31,21.16,16.13,11.33
26-11-2020,CARTAXO,166,12,696,"[480,960]",Muito Elevado,,,,166,Lisboa e Vale do Tejo,SANTARÉM,1406,15817.28,23843,1415,1376,1142,861,632,1493,2635,4011,5426,150.74,34.3,25.36,16.66
26-11-2020,CASCAIS,1098,78,514,"[480,960]",Muito Elevado,,,,1098,Lisboa e Vale do Tejo,LISBOA,1105,9740.17,213608,12151,11444,8680,6469,5248,11717,20397,31841,43992,2193.1,451.66,326.91,209.41
26-11-2020,CASTANHEIRA DE PÊRA,4,0,153,"[0,240]",Moderado,,,,4,Centro,LEIRIA,1007,6677.45,2614,233,195,157,190,187,377,534,729,962,39.15,14.41,10.92,8.0
26-11-2020,CASTELO BRANCO,255,18,491,"[480,960]",Muito Elevado,,,,255,Centro,CASTELO BRANCO,0502,143819.15,51987,3528,3042,2499,2229,2225,4454,6953,9995,13523,36.15,9.4,6.95,4.83
26-11-2020,CASTELO DE PAIVA,178,13,1152,"[960,Max]",Extremamente Elevado,,,,178,Norte,AVEIRO,0106,11500.53,15454,881,697,545,420,431,851,1396,2093,2974,134.37,25.86,18.2,12.14
26-11-2020,CASTELO DE VIDE,8,1,274,"[240,480]",Elevado,,,,8,Alentejo,PORTALEGRE,1205,26491.24,2919,204,173,179,147,170,317,496,669,873,11.02,3.3,2.53,1.87
26-11-2020,CASTRO DAIRE,61,4,441,"[240,480]",Elevado,,,,61,Centro,VISEU,1803,37904.13,13823,942,857,765,732,773,1505,2270,3127,4069,36.47,10.74,8.25,5.99
26-11-2020,CASTRO MARIM,4,0,64,"[0,240]",Moderado,,,,4,Algarve,FARO,0804,30084.37,6237,370,345,334,322,344,666,1000,1345,1715,20.73,5.7,4.47,3.32
26-11-2020,CASTRO VERDE,17,1,245,"[240,480]",Elevado,,,,17,Alentejo,BEJA,0206,56944.23,6949,437,347,303,275,227,502,805,1152,1589,12.2,2.79,2.02,1.41
26-11-2020,CELORICO DA BEIRA,86,6,1241,"[960,Max]",Extremamente Elevado,,,,86,Centro,GUARDA,0903,24721.63,6928,430,416,363,369,535,904,1267,1683,2113,28.02,8.55,6.81,5.12
26-11-2020,CELORICO DE BASTO,168,12,882,"[480,960]",Muito Elevado,,,,168,Norte,BRAGA,0305,18107.02,19040,1001,802,668,728,729,1457,2125,2927,3928,105.15,21.69,16.17,11.74
26-11-2020,CHAMUSCA,50,4,544,"[480,960]",Muito Elevado,,,,50,Lisboa e Vale do Tejo,SANTARÉM,1407,74600.54,9197,629,583,553,465,579,1044,1597,2180,2809,12.33,3.77,2.92,2.14
26-11-2020,CHAVES,465,33,1182,"[960,Max]",Extremamente Elevado,,,,465,Norte,VILA REAL,1703,59122.95,39343,2676,2429,1991,1886,1918,3804,5795,8224,10900,66.54,18.44,13.91,9.8
26-11-2020,CINFÃES,217,15,1189,"[960,Max]",Extremamente Elevado,,,,217,Norte,VISEU,1804,23928.76,18244,1067,902,779,734,758,1492,2271,3173,4240,76.24,17.72,13.26,9.49
26-11-2020,COIMBRA,682,49,508,"[480,960]",Muito Elevado,,,,682,Centro,COIMBRA,0603,31939.94,134166,9489,8734,6353,5139,5074,10213,16566,25300,34789,420.06,108.92,79.21,51.87
26-11-2020,CONDEIXA-A-NOVA,83,6,468,"[240,480]",Elevado,,,,83,Centro,COIMBRA,0604,13867.47,17733,871,809,717,583,490,1073,1790,2599,3470,127.88,25.02,18.74,12.91
26-11-2020,CONSTÂNCIA,18,1,447,"[240,480]",Elevado,,,,18,Lisboa e Vale do Tejo,SANTARÉM,1408,8036.58,4030,211,183,187,148,155,303,490,673,884,50.14,11.0,8.37,6.1
26-11-2020,CORUCHE,77,6,441,"[240,480]",Elevado,,,,77,Lisboa e Vale do Tejo,SANTARÉM,1409,111572.03,17471,1294,1090,1095,1096,1019,2115,3210,4300,5594,15.66,5.01,3.85,2.88
26-11-2020,CORVO,0,0,0,"[0,20]",Moderado,,,,0,Açores,AÇORES,4901,1711.45,464,22,21,11,13,19,32,43,64,86,27.12,5.03,3.74,2.51
26-11-2020,COVILHÃ,357,25,763,"[480,960]",Muito Elevado,,,,357,Centro,CASTELO BRANCO,0503,55560.06,46787,3533,2998,2365,2111,2193,4304,6669,9667,13200,84.21,23.76,17.4,12.0
26-11-2020,CRATO,39,3,1246,"[960,Max]",Extremamente Elevado,,,,39,Alentejo,PORTALEGRE,1206,39806.88,3129,229,258,163,182,228,410,573,831,1060,7.86,2.66,2.09,1.44
26-11-2020,CUBA,28,2,609,"[480,960]",Muito Elevado,,,,28,Alentejo,BEJA,0207,17208.72,4595,255,233,206,190,143,333,539,772,1027,26.7,5.97,4.49,3.13
26-11-2020,ELVAS,57,4,278,"[240,480]",Elevado,,,,57,Alentejo,PORTALEGRE,1207,63128.86,20528,1057,1145,902,852,810,1662,2564,3709,4766,32.52,7.55,5.88,4.06
26-11-2020,ENTRONCAMENTO,69,5,320,"[240,480]",Elevado,,,,69,Lisboa e Vale do Tejo,SANTARÉM,1410,1372.81,21558,1066,930,868,695,592,1287,2155,3085,4151,1570.14,302.33,224.69,156.96
26-11-2020,ESPINHO,427,31,1447,"[960,Max]",Extremamente Elevado,,,,427,Norte,AVEIRO,0107,2105.68,29516,2205,1993,1430,1177,960,2137,3567,5560,7765,1401.52,368.71,264.01,169.37
26-11-2020,ESPOSENDE,340,24,995,"[960,Max]",Extremamente Elevado,,,,340,Norte,BRAGA,0306,9540.98,34177,1831,1522,1095,894,723,1617,2712,4234,6065,358.21,63.57,44.38,28.42
26-11-2020,ESTARREJA,170,12,654,"[480,960]",Muito Elevado,,,,170,Centro,AVEIRO,0108,10817.33,26006,1503,1399,1106,953,728,1681,2787,4186,5689,240.42,52.59,38.7,25.76
26-11-2020,ESTREMOZ,28,2,220,"[0,240]",Moderado,,,,28,Alentejo,ÉVORA,0704,51379.95,12728,789,613,697,786,877,1663,2360,2973,3762,24.77,7.32,5.79,4.59
26-11-2020,ÉVORA,278,20,530,"[480,960]",Muito Elevado,,,,278,Alentejo,ÉVORA,0705,130707.58,52428,3569,2852,2176,1966,1803,3769,5945,8797,12366,40.11,9.46,6.73,4.55
26-11-2020,FAFE,1034,74,2151,"[960,Max]",Extremamente Elevado,,,,1034,Norte,BRAGA,0307,21908.11,48060,3044,2455,1679,1403,1208,2611,4290,6745,9789,219.37,44.68,30.79,19.58
26-11-2020,FARO,179,13,293,"[240,480]",Elevado,,,,179,Algarve,FARO,0805,20256.79,61015,3847,3364,2604,2055,1601,3656,6260,9624,13471,301.2,66.5,47.51,30.9
26-11-2020,FELGUEIRAS,1095,78,1941,"[960,Max]",Extremamente Elevado,,,,1095,Norte,PORTO,1303,11573.75,56422,2951,2302,1601,1316,973,2289,3890,6192,9143,487.49,79.0,53.5,33.61
26-11-2020,FERREIRA DO ALENTEJO,13,1,166,"[0,240]",Moderado,,,,13,Alentejo,BEJA,0208,64820.68,7845,515,414,372,343,345,688,1060,1474,1989,12.1,3.07,2.27,1.64
26-11-2020,FERREIRA DO ZÊZERE,17,1,214,"[0,240]",Moderado,,,,17,Lisboa e Vale do Tejo,SANTARÉM,1411,19038.03,7959,470,370,416,465,456,921,1337,1707,2177,41.81,11.44,8.97,7.02
26-11-2020,FIGUEIRA DA FOZ,459,33,781,"[480,960]",Muito Elevado,,,,459,Centro,COIMBRA,0605,37905.26,58747,4032,3597,2887,2495,2043,4538,7425,11022,15054,154.98,39.72,29.08,19.59
26-11-2020,FIGUEIRA DE CASTELO RODRIGO,45,3,806,"[480,960]",Muito Elevado,,,,45,Centro,GUARDA,0904,50857.46,5584,347,352,290,352,391,743,1033,1385,1732,10.98,3.41,2.72,2.03
26-11-2020,FIGUEIRÓ DOS VINHOS,10,1,180,"[0,240]",Moderado,,,,10,Centro,LEIRIA,1008,17344.0,5568,402,386,322,309,351,660,982,1368,1770,32.1,10.21,7.89,5.66
26-11-2020,FORNOS DE ALGODRES,7,1,155,"[0,240]",Moderado,,,,7,Centro,GUARDA,0905,13145.05,4528,261,218,247,256,232,488,735,953,1214,34.45,9.24,7.25,5.59
26-11-2020,FREIXO DE ESPADA À CINTA,104,7,3153,"[960,Max]",Extremamente Elevado,,,,104,Norte,BRAGANÇA,0404,24414.29,3298,211,177,231,196,189,385,616,793,1004,13.51,4.11,3.25,2.52
26-11-2020,FRONTEIRA,6,0,202,"[0,240]",Moderado,,,,6,Alentejo,PORTALEGRE,1208,24859.58,2974,213,182,149,156,168,324,473,655,868,11.96,3.49,2.63,1.9
26-11-2020,FUNCHAL,101,7,97,"[0,240]",Moderado,,,,101,Madeira,MADEIRA,3103,7616.2,104024,6382,5086,3643,2821,1990,4811,8454,13540,19922,1365.86,261.58,177.78,111.0
26-11-2020,FUNDÃO,172,12,649,"[480,960]",Muito Elevado,,,,172,Centro,CASTELO BRANCO,0504,70019.79,26495,1781,1464,1432,1357,1643,3000,4432,5896,7677,37.84,10.96,8.42,6.33
26-11-2020,GAVIÃO,47,3,1440,"[960,Max]",Extremamente Elevado,,,,47,Alentejo,PORTALEGRE,1209,29459.45,3263,189,186,222,263,293,556,778,964,1153,11.08,3.91,3.27,2.64
26-11-2020,GÓIS,6,0,158,"[0,240]",Moderado,,,,6,Centro,COIMBRA,0606,26330.19,3805,235,199,240,233,244,477,717,916,1151,14.45,4.37,3.48,2.72
26-11-2020,GOLEGÃ,20,1,375,"[240,480]",Elevado,,,,20,Lisboa e Vale do Tejo,SANTARÉM,1412,8431.67,5339,356,299,281,243,255,498,779,1078,1434,63.32,17.01,12.78,9.24
26-11-2020,GONDOMAR,1985,142,1196,"[960,Max]",Extremamente Elevado,,,,1985,Norte,PORTO,1304,13191.76,165985,10555,8755,6222,4450,3364,7814,14036,22791,33346,1258.22,252.77,172.76,106.4
26-11-2020,GOUVEIA,47,3,379,"[240,480]",Elevado,,,,47,Centro,GUARDA,0906,30061.17,12387,871,931,780,783,810,1593,2373,3304,4175,41.21,13.89,10.99,7.89
26-11-2020,GRÂNDOLA,50,4,342,"[240,480]",Elevado,,,,50,Alentejo,SETÚBAL,1505,82593.66,14639,834,834,708,688,672,1360,2068,2902,3736,17.72,4.52,3.51,2.5
26-11-2020,GUARDA,255,18,654,"[480,960]",Muito Elevado,,,,255,Centro,GUARDA,0907,71209.58,38969,2477,2041,1686,1415,1474,2889,4575,6616,9093,54.72,12.77,9.29,6.42
26-11-2020,GUIMARÃES,3492,249,2293,"[960,Max]",Extremamente Elevado,,,,3492,Norte,BRAGA,0308,24099.96,152309,9394,7074,4809,3877,2948,6825,11634,18708,28102,631.99,116.61,77.63,48.27
26-11-2020,HORTA,1,0,7,"[0,240]",Moderado,,,,1,Açores,AÇORES,4701,17305.53,14521,818,658,468,352,302,654,1122,1780,2598,83.91,15.01,10.29,6.48
26-11-2020,IDANHA-A-NOVA,19,1,236,"[0,240]",Moderado,,,,19,Centro,CASTELO BRANCO,0505,141633.51,8043,518,490,519,672,974,1646,2165,2655,3173,5.68,2.24,1.87,1.53
26-11-2020,ÍLHAVO,248,18,641,"[480,960]",Muito Elevado,,,,248,Centro,AVEIRO,0110,7347.55,38699,2227,1943,1444,1193,850,2043,3487,5430,7657,526.66,104.21,73.9,47.46
26-11-2020,LAGOA (FARO),95,7,417,"[240,480]",Elevado,,,,95,Algarve,FARO,0806,8825.45,22762,1314,1168,919,749,670,1419,2338,3506,4820,257.93,54.62,39.73,26.49
26-11-2020,LAGOA,29,2,197,"[0,240]",Moderado,,,,29,Açores,AÇORES,4201,4559.32,14721,536,458,349,238,235,473,822,1280,1816,322.9,39.83,28.08,18.03
26-11-2020,LAGOS,82,6,270,"[240,480]",Elevado,,,,82,Algarve,FARO,0807,21299.27,30374,1744,1434,1247,1053,1029,2082,3329,4763,6507,142.61,30.55,22.36,15.63
26-11-2020,LAJES DAS FLORES,0,0,0,"[0,20]",Moderado,,,,0,Açores,AÇORES,4801,7004.79,1463,88,53,62,46,54,100,162,215,303,20.89,4.33,3.07,2.31
26-11-2020,LAJES DO PICO,0,0,0,"[0,240]",Moderado,,,,0,Açores,AÇORES,4601,15531.09,4490,304,231,223,159,162,321,544,775,1079,28.91,6.95,4.99,3.5
26-11-2020,LAMEGO,162,12,651,"[480,960]",Muito Elevado,,,,162,Norte,VISEU,1805,16542.11,24895,1639,1284,1124,898,783,1681,2805,4089,5728,150.5,34.63,24.72,16.96
26-11-2020,LEIRIA,457,33,365,"[240,480]",Elevado,,,,457,Centro,LEIRIA,1009,56508.83,125267,7389,6366,5090,3902,3159,7061,12151,18517,25906,221.68,45.84,32.77,21.5
26-11-2020,LISBOA,3281,234,644,"[480,960]",Muito Elevado,,,,3281,Lisboa e Vale do Tejo,LISBOA,1106,10005.43,509515,33197,33340,27706,23037,26770,49807,77513,110853,144050,5092.6,1439.78,1107.98,774.74
26-11-2020,LOULÉ,184,13,268,"[240,480]",Elevado,,,,184,Algarve,FARO,0808,76366.91,68697,3890,3350,2780,2358,2251,4609,7389,10739,14629,89.96,19.16,14.06,9.68
26-11-2020,LOURES,1329,95,622,"[480,960]",Muito Elevado,,,,1329,Lisboa e Vale do Tejo,LISBOA,1107,16723.99,213687,12746,12794,9644,6669,5033,11702,21346,34140,46886,1277.73,280.35,204.14,127.64
26-11-2020,LOURINHÃ,40,3,155,"[0,240]",Moderado,,,,40,Lisboa e Vale do Tejo,LISBOA,1108,14717.2,25855,1584,1243,992,842,645,1487,2479,3722,5306,175.68,36.05,25.29,16.84
26-11-2020,LOUSÃ,90,6,525,"[480,960]",Muito Elevado,,,,90,Centro,COIMBRA,0607,13840.01,17158,946,866,658,528,450,978,1636,2502,3448,123.97,24.91,18.08,11.82
26-11-2020,LOUSADA,1129,81,2415,"[960,Max]",Extremamente Elevado,,,,1129,Norte,PORTO,1305,9608.01,46755,2289,1698,1176,853,621,1474,2650,4348,6637,486.63,69.08,45.25,27.58
26-11-2020,MAÇÃO,19,1,303,"[240,480]",Elevado,,,,19,Lisboa e Vale do Tejo,SANTARÉM,1413,39997.98,6267,386,362,390,440,657,1097,1487,1849,2235,15.67,5.59,4.62,3.72
26-11-2020,MACEDO DE CAVALEIROS,133,9,916,"[480,960]",Muito Elevado,,,,133,Norte,BRAGANÇA,0405,69914.08,14516,1082,889,878,823,938,1761,2639,3528,4610,20.76,6.59,5.05,3.77
26-11-2020,MACHICO,10,1,50,"[0,240]",Moderado,,,,10,Madeira,MADEIRA,3104,6825.1,19981,1197,860,662,455,331,786,1448,2308,3505,292.76,51.36,33.82,21.22
26-11-2020,MADALENA,0,0,0,"[0,240]",Moderado,,,,0,Açores,AÇORES,4602,14712.33,5895,334,256,173,190,179,369,542,798,1132,40.07,7.69,5.42,3.68
26-11-2020,MAFRA,395,28,466,"[240,480]",Elevado,,,,395,Lisboa e Vale do Tejo,LISBOA,1109,29165.5,84816,3613,3334,2839,2089,1899,3988,6827,10161,13774,290.81,47.23,34.84,23.41
26-11-2020,MAIA,1411,101,1015,"[960,Max]",Extremamente Elevado,,,,1411,Norte,PORTO,1306,8293.94,138971,7801,6617,4512,3339,2631,5970,10482,17099,24900,1675.56,300.22,206.16,126.38
26-11-2020,MANGUALDE,77,6,416,"[240,480]",Elevado,,,,77,Centro,VISEU,1806,21925.56,18510,1198,1128,885,852,743,1595,2480,3608,4806,84.42,21.92,16.46,11.31
26-11-2020,MANTEIGAS,41,3,1363,"[960,Max]",Extremamente Elevado,,,,41,Centro,GUARDA,0908,12197.55,3007,258,197,159,167,146,313,472,669,927,24.65,7.6,5.48,3.87
26-11-2020,MARCO DE CANAVESES,707,51,1373,"[960,Max]",Extremamente Elevado,,,,707,Norte,PORTO,1307,20188.98,51496,2678,2060,1488,1265,1023,2288,3776,5836,8514,255.07,42.17,28.91,18.7
26-11-2020,MARINHA GRANDE,127,9,330,"[240,480]",Elevado,,,,127,Centro,LEIRIA,1010,18725.19,38508,2365,2302,1638,1359,1058,2417,4055,6357,8722,205.65,46.58,33.95,21.66
26-11-2020,MARVÃO,21,2,699,"[480,960]",Muito Elevado,,,,21,Alentejo,PORTALEGRE,1210,15489.9,3005,198,185,142,197,237,434,576,761,959,19.4,6.19,4.91,3.72
26-11-2020,MATOSINHOS,1662,119,948,"[480,960]",Muito Elevado,,,,1662,Norte,PORTO,1308,6241.97,175357,11850,9977,7023,5024,3884,8908,15931,25908,37758,2809.31,604.9,415.06,255.22
26-11-2020,MEALHADA,107,8,537,"[480,960]",Muito Elevado,,,,107,Centro,AVEIRO,0111,11065.66,19914,1163,1039,810,828,831,1659,2469,3508,4671,179.96,42.21,31.7,22.31
26-11-2020,MÊDA,19,1,414,"[240,480]",Elevado,,,,19,Centro,GUARDA,0909,28604.92,4587,343,306,290,288,443,731,1021,1327,1670,16.04,5.84,4.64,3.57
26-11-2020,MELGAÇO,31,2,383,"[240,480]",Elevado,,,,31,Norte,VIANA DO CASTELO,1603,23824.58,8093,507,567,578,614,675,1289,1867,2434,2941,33.97,12.34,10.22,7.84
26-11-2020,MÉRTOLA,6,0,98,"[0,240]",Moderado,,,,6,Alentejo,BEJA,0209,129287.34,6142,400,390,378,423,600,1023,1401,1791,2191,4.75,1.69,1.39,1.08
26-11-2020,MESÃO FRIO,13,1,328,"[240,480]",Elevado,,,,13,Norte,VILA REAL,1704,2664.87,3964,265,205,168,157,120,277,445,650,915,148.74,34.33,24.39,16.7
26-11-2020,MIRA,63,4,532,"[480,960]",Muito Elevado,,,,63,Centro,COIMBRA,0608,12403.38,11832,727,729,659,550,466,1016,1675,2404,3131,95.4,25.24,19.38,13.5
26-11-2020,MIRANDA DO CORVO,164,12,1291,"[960,Max]",Extremamente Elevado,,,,164,Centro,COIMBRA,0609,12637.79,12708,706,659,568,498,404,902,1470,2129,2835,100.55,22.43,16.85,11.63
26-11-2020,MIRANDA DO DOURO,49,3,717,"[480,960]",Muito Elevado,,,,49,Norte,BRAGANÇA,0406,48718.31,6830,482,429,442,463,470,933,1375,1804,2286,14.02,4.69,3.7,2.82
26-11-2020,MIRANDELA,117,8,538,"[480,960]",Muito Elevado,,,,117,Norte,BRAGANÇA,0407,65895.67,21754,1640,1315,1204,1078,947,2025,3229,4544,6184,33.01,9.38,6.9,4.9
26-11-2020,MOGADOURO,43,3,512,"[480,960]",Muito Elevado,,,,43,Norte,BRAGANÇA,0408,76064.93,8392,589,529,576,630,655,1285,1861,2390,2979,11.03,3.92,3.14,2.45
26-11-2020,MOIMENTA DA BEIRA,14,1,144,"[0,240]",Moderado,,,,14,Norte,VISEU,1807,21996.9,9736,576,514,471,416,461,877,1348,1862,2438,44.26,11.08,8.46,6.13
26-11-2020,MOITA,262,19,407,"[240,480]",Elevado,,,,262,Lisboa e Vale do Tejo,SETÚBAL,1506,5525.98,64407,4226,3646,2623,1801,1425,3226,5849,9495,13721,1165.53,248.3,171.82,105.85
26-11-2020,MONÇÃO,80,6,448,"[240,480]",Elevado,,,,80,Norte,VIANA DO CASTELO,1604,21130.85,17869,1161,1105,1031,1006,972,1978,3009,4114,5275,84.56,24.96,19.47,14.24
26-11-2020,MONCHIQUE,18,1,355,"[240,480]",Elevado,,,,18,Algarve,FARO,0809,39530.43,5077,353,384,321,355,392,747,1068,1452,1805,12.84,4.57,3.67,2.7
26-11-2020,MONDIM DE BASTO,107,8,1540,"[960,Max]",Extremamente Elevado,,,,107,Norte,VILA REAL,1705,17207.52,6946,395,300,314,284,283,567,881,1181,1576,40.36,9.16,6.86,5.12
26-11-2020,MONFORTE,8,1,269,"[240,480]",Elevado,,,,8,Alentejo,PORTALEGRE,1211,42024.82,2975,139,115,117,192,168,360,477,592,731,7.08,1.74,1.41,1.14
26-11-2020,MONTALEGRE,49,4,545,"[480,960]",Muito Elevado,,,,49,Norte,VILA REAL,1706,80545.71,8997,699,628,595,603,730,1333,1928,2556,3255,11.17,4.04,3.17,2.39
26-11-2020,MONTEMOR-O-NOVO,56,4,358,"[240,480]",Elevado,,,,56,Alentejo,ÉVORA,0706,123296.65,15647,991,953,868,878,971,1849,2717,3670,4661,12.69,3.78,2.98,2.2
26-11-2020,MONTEMOR-O-VELHO,115,8,456,"[240,480]",Elevado,,,,115,Centro,COIMBRA,0610,22896.23,25224,1496,1397,1217,1057,988,2045,3262,4659,6155,110.17,26.88,20.35,14.25
26-11-2020,MONTIJO,230,16,399,"[240,480]",Elevado,,,,230,Lisboa e Vale do Tejo,SETÚBAL,1507,34861.64,57614,2771,2441,1990,1554,1109,2663,4653,7094,9865,165.26,28.3,20.35,13.35
26-11-2020,MORA,23,2,556,"[480,960]",Muito Elevado,,,,23,Alentejo,ÉVORA,0707,44395.02,4138,336,275,252,238,257,495,747,1022,1358,9.32,3.06,2.3,1.68
26-11-2020,MORTÁGUA,28,2,318,"[240,480]",Elevado,,,,28,Centro,VISEU,1808,25117.82,8803,638,584,535,499,460,959,1494,2078,2716,35.05,10.81,8.27,5.95
26-11-2020,MOURA,7,0,51,"[0,240]",Moderado,,,,7,Alentejo,BEJA,0210,95845.55,13718,817,656,665,542,461,1003,1668,2324,3141,14.31,3.28,2.42,1.74
26-11-2020,MOURÃO,8,1,327,"[240,480]",Elevado,,,,8,Alentejo,ÉVORA,0708,27862.98,2450,139,108,80,104,109,213,293,401,540,8.79,1.94,1.44,1.05
26-11-2020,MURÇA,44,3,805,"[480,960]",Muito Elevado,,,,44,Norte,VILA REAL,1707,18937.11,5463,384,341,307,306,319,625,932,1273,1657,28.85,8.75,6.72,4.92
26-11-2020,MURTOSA,98,7,953,"[480,960]",Muito Elevado,,,,98,Centro,AVEIRO,0112,7308.78,10279,509,473,403,353,409,762,1165,1638,2147,140.63,29.37,22.41,15.94
26-11-2020,NAZARÉ,67,5,473,"[240,480]",Elevado,,,,67,Lisboa e Vale do Tejo,LEIRIA,1011,8243.43,14165,967,903,670,420,396,816,1486,2389,3356,171.84,40.71,28.98,18.03
26-11-2020,NELAS,22,2,170,"[0,240]",Moderado,,,,22,Centro,VISEU,1809,12571.48,12974,924,787,668,604,583,1187,1855,2642,3566,103.21,28.37,21.02,14.76
26-11-2020,NISA,49,3,808,"[480,960]",Muito Elevado,,,,49,Alentejo,PORTALEGRE,1212,57567.84,6061,405,389,355,483,478,961,1316,1705,2110,10.53,3.67,2.96,2.29
26-11-2020,NORDESTE,1,0,21,"[0,240]",Moderado,,,,1,Açores,AÇORES,4202,10146.8,4862,246,180,124,161,162,323,447,627,873,47.92,8.6,6.18,4.41
26-11-2020,ÓBIDOS,28,2,236,"[0,240]",Moderado,,,,28,Lisboa e Vale do Tejo,LEIRIA,1012,14155.44,11850,743,650,574,452,436,888,1462,2112,2855,83.72,20.17,14.92,10.33
26-11-2020,ODEMIRA,103,7,417,"[240,480]",Elevado,,,,103,Alentejo,BEJA,0211,172060.15,24717,1475,1317,1225,1397,1349,2746,3971,5288,6763,14.37,3.93,3.07,2.31
26-11-2020,ODIVELAS,862,62,533,"[480,960]",Muito Elevado,,,,862,Lisboa e Vale do Tejo,LISBOA,1116,2654.36,161774,9562,9038,6952,4641,3812,8453,15405,24443,34005,6095.48,1281.27,920.99,580.44
26-11-2020,OEIRAS,711,51,401,"[240,480]",Elevado,,,,711,Lisboa e Vale do Tejo,LISBOA,1110,4588.31,177408,11580,11575,8566,6211,5855,12066,20632,32207,43787,3866.78,954.38,701.98,449.69
26-11-2020,OLEIROS,34,2,680,"[480,960]",Muito Elevado,,,,34,Centro,CASTELO BRANCO,0506,47109.31,5003,384,341,366,397,487,884,1250,1591,1975,10.62,4.19,3.38,2.65
26-11-2020,OLHÃO,82,6,185,"[0,240]",Moderado,,,,82,Algarve,FARO,0810,13086.38,44405,2455,2309,1689,1342,1268,2610,4299,6608,9063,339.33,69.26,50.5,32.85
26-11-2020,OLIVEIRA DE AZEMÉIS,870,62,1318,"[960,Max]",Extremamente Elevado,,,,870,Norte,AVEIRO,0113,16110.41,66011,4155,3614,2794,2183,1738,3921,6715,10329,14484,409.75,89.91,64.12,41.68
26-11-2020,OLIVEIRA DE FRADES,41,3,413,"[240,480]",Elevado,,,,41,Centro,VISEU,1810,14534.62,9936,553,475,438,359,415,774,1212,1687,2240,68.36,15.41,11.61,8.34
26-11-2020,OLIVEIRA DO BAIRRO,170,12,700,"[480,960]",Muito Elevado,,,,170,Centro,AVEIRO,0114,8731.99,24277,1327,1182,999,786,810,1596,2595,3777,5104,278.02,58.45,43.25,29.72
26-11-2020,OLIVEIRA DO HOSPITAL,29,2,151,"[0,240]",Moderado,,,,29,Centro,COIMBRA,0611,23451.66,19253,1161,1097,962,924,960,1884,2846,3943,5104,82.1,21.76,16.81,12.14
26-11-2020,OURÉM,242,17,549,"[480,960]",Muito Elevado,,,,242,Lisboa e Vale do Tejo,SANTARÉM,1421,41668.03,44044,2463,2069,1899,1817,1603,3420,5319,7388,9851,105.7,23.64,17.73,12.77
26-11-2020,OURIQUE,3,0,65,"[0,240]",Moderado,,,,3,Alentejo,BEJA,0212,66331.36,4607,313,287,284,268,227,495,779,1066,1379,6.95,2.08,1.61,1.17
26-11-2020,OVAR,549,39,1012,"[960,Max]",Extremamente Elevado,,,,549,Centro,AVEIRO,0115,14770.25,54260,3294,2709,1994,1636,1234,2870,4864,7573,10867,367.37,73.57,51.27,32.93
26-11-2020,PAÇOS DE FERREIRA,1126,80,1985,"[960,Max]",Extremamente Elevado,,,,1126,Norte,PORTO,1309,7099.29,56728,2903,2193,1518,1135,664,1799,3317,5510,8413,799.1,118.51,77.62,46.72
26-11-2020,PALMELA,230,16,358,"[240,480]",Elevado,,,,230,Lisboa e Vale do Tejo,SETÚBAL,1508,46512.01,64269,3402,3244,2635,1846,1391,3237,5872,9116,12518,138.18,26.91,19.6,12.62
26-11-2020,PAMPILHOSA DA SERRA,25,2,619,"[480,960]",Muito Elevado,,,,25,Centro,COIMBRA,0612,39646.24,4037,238,254,295,339,423,762,1057,1311,1549,10.18,3.91,3.31,2.67
26-11-2020,PAREDES,1337,95,1553,"[960,Max]",Extremamente Elevado,,,,1337,Norte,PORTO,1310,15675.69,86067,4272,3532,2412,1717,1258,2975,5387,8919,13191,549.04,84.15,56.9,34.36
26-11-2020,PAREDES DE COURA,24,2,281,"[240,480]",Elevado,,,,24,Norte,VIANA DO CASTELO,1605,13818.59,8535,466,528,407,465,515,980,1387,1915,2381,61.76,17.23,13.86,10.04
26-11-2020,PEDRÓGÃO GRANDE,2,0,59,"[0,240]",Moderado,,,,2,Centro,LEIRIA,1013,12874.75,3410,175,173,196,221,252,473,669,842,1017,26.49,7.9,6.54,5.2
26-11-2020,PENACOVA,77,5,562,"[480,960]",Muito Elevado,,,,77,Centro,COIMBRA,0613,21673.23,13694,968,923,745,621,703,1324,2069,2992,3960,63.18,18.27,13.81,9.55
26-11-2020,PENAFIEL,1298,93,1860,"[960,Max]",Extremamente Elevado,,,,1298,Norte,PORTO,1311,21224.27,69772,3648,2823,2032,1663,1230,2893,4925,7748,11396,328.74,53.69,36.51,23.2
26-11-2020,PENALVA DO CASTELO,34,2,478,"[240,480]",Elevado,,,,34,Centro,VISEU,1811,13433.92,7115,449,457,413,391,426,817,1230,1687,2136,52.96,15.9,12.56,9.16
26-11-2020,PENAMACOR,20,1,421,"[240,480]",Elevado,,,,20,Centro,CASTELO BRANCO,0507,56370.69,4755,262,248,273,451,633,1084,1357,1605,1867,8.44,3.31,2.85,2.41
26-11-2020,PENEDONO,12,1,463,"[240,480]",Elevado,,,,12,Norte,VISEU,1812,13370.75,2591,172,113,129,156,138,294,423,536,708,19.38,5.3,4.01,3.16
26-11-2020,PENELA,28,2,519,"[480,960]",Muito Elevado,,,,28,Centro,COIMBRA,0614,13480.0,5397,314,324,274,359,344,703,977,1301,1615,40.04,11.98,9.65,7.25
26-11-2020,PENICHE,128,9,483,"[480,960]",Muito Elevado,,,,128,Lisboa e Vale do Tejo,LEIRIA,1014,7754.98,26501,1746,1504,1203,926,707,1633,2836,4340,6086,341.73,78.48,55.96,36.57
26-11-2020,PESO DA RÉGUA,44,3,279,"[240,480]",Elevado,,,,44,Norte,VILA REAL,1708,9486.01,15773,1076,843,650,659,455,1114,1764,2607,3683,166.28,38.83,27.48,18.6
26-11-2020,PINHEL,8,1,94,"[0,240]",Moderado,,,,8,Centro,GUARDA,0910,48452.12,8511,577,566,551,538,689,1227,1778,2344,2921,17.57,6.03,4.84,3.67
26-11-2020,POMBAL,303,22,589,"[480,960]",Muito Elevado,,,,303,Centro,LEIRIA,1015,62600.28,51461,3187,2791,2494,2328,2027,4355,6849,9640,12827,82.21,20.49,15.4,10.94
26-11-2020,PONTA DELGADA,156,11,230,"[0,240]",Moderado,,,,156,Açores,AÇORES,4203,23298.65,67935,3108,2435,1726,1133,902,2035,3761,6196,9304,291.58,39.93,26.59,16.14
26-11-2020,PONTA DO SOL,3,0,35,"[0,240]",Moderado,,,,3,Madeira,MADEIRA,3105,4622.03,8593,319,283,347,208,221,429,776,1059,1378,185.92,29.81,22.91,16.79
26-11-2020,PONTE DA BARCA,61,4,546,"[480,960]",Muito Elevado,,,,61,Norte,VIANA DO CASTELO,1606,18211.37,11180,635,576,517,554,490,1044,1561,2137,2772,61.39,15.22,11.73,8.57
26-11-2020,PONTE DE LIMA,338,24,818,"[480,960]",Muito Elevado,,,,338,Norte,VIANA DO CASTELO,1607,32025.46,41315,2321,2022,1720,1596,1462,3058,4778,6800,9121,129.01,28.48,21.23,14.92
26-11-2020,PONTE DE SOR,25,2,167,"[0,240]",Moderado,,,,25,Alentejo,PORTALEGRE,1213,83971.16,14994,939,800,716,739,831,1570,2286,3086,4025,17.86,4.79,3.68,2.72
26-11-2020,PORTALEGRE,341,24,1538,"[960,Max]",Extremamente Elevado,,,,341,Alentejo,PORTALEGRE,1214,44713.64,22172,1577,1351,1137,993,984,1977,3114,4465,6042,49.59,13.51,9.99,6.96
26-11-2020,PORTEL,0,0,0,"[0,240]",Moderado,,,,0,Alentejo,ÉVORA,0709,60100.57,5828,336,358,283,331,305,636,919,1277,1613,9.7,2.68,2.12,1.53
26-11-2020,PORTIMÃO,243,17,438,"[240,480]",Elevado,,,,243,Algarve,FARO,0811,18206.29,55483,3182,2927,2116,1582,1400,2982,5098,8025,11207,304.75,61.56,44.08,28.0
26-11-2020,PORTO,2207,158,1019,"[960,Max]",Extremamente Elevado,,,,2207,Norte,PORTO,1312,4142.02,216606,15790,15193,11280,9409,10044,19453,30733,45926,61716,5229.5,1490.0,1108.79,741.98
26-11-2020,PORTO DE MÓS,68,5,292,"[240,480]",Elevado,,,,68,Centro,LEIRIA,1016,26183.41,23275,1355,1210,1034,888,872,1760,2794,4004,5359,88.89,20.47,15.29,10.67
26-11-2020,PORTO MONIZ,1,0,43,"[0,240]",Moderado,,,,1,Madeira,MADEIRA,3106,8293.38,2342,143,130,95,98,120,218,313,443,586,28.24,7.07,5.34,3.77
26-11-2020,PORTO SANTO,0,0,0,"[0,240]",Moderado,,,,0,Madeira,MADEIRA,3201,4300.7,5202,240,157,134,110,68,178,312,469,709,120.95,16.48,10.9,7.25
26-11-2020,PÓVOA DE LANHOSO,399,29,1856,"[960,Max]",Extremamente Elevado,,,,399,Norte,BRAGA,0309,13465.29,21499,1175,909,732,673,624,1297,2029,2938,4113,159.67,30.55,21.82,15.07
26-11-2020,PÓVOA DE VARZIM,1232,88,1962,"[960,Max]",Extremamente Elevado,,,,1232,Norte,PORTO,1313,8220.59,62784,3712,3120,2134,1594,1305,2899,5033,8153,11865,763.7,144.33,99.17,61.22
26-11-2020,POVOAÇÃO,16,1,270,"[240,480]",Elevado,,,,16,Açores,AÇORES,4204,10640.77,5927,293,212,191,144,134,278,469,681,974,55.7,9.15,6.4,4.41
26-11-2020,VILA DA PRAIA DA VITÓRIA,37,3,174,"[0,240]",Moderado,,,,37,Açores,AÇORES,4302,16127.06,21317,1133,789,619,436,336,772,1391,2180,3313,132.18,20.54,13.52,8.63
26-11-2020,PROENÇA-A-NOVA,27,2,370,"[240,480]",Elevado,,,,27,Centro,CASTELO BRANCO,0508,39539.96,7298,508,465,389,400,560,960,1349,1814,2322,18.46,5.87,4.59,3.41
26-11-2020,REDONDO,20,1,315,"[240,480]",Elevado,,,,20,Alentejo,ÉVORA,0710,36950.87,6353,349,325,288,288,354,642,930,1255,1604,17.19,4.34,3.4,2.52
26-11-2020,REGUENGOS DE MONSARAZ,65,5,649,"[480,960]",Muito Elevado,,,,65,Alentejo,ÉVORA,0711,46399.72,10015,602,511,455,462,473,935,1390,1901,2503,21.58,5.39,4.1,3.0
26-11-2020,RESENDE,53,4,523,"[480,960]",Muito Elevado,,,,53,Norte,VISEU,1813,12334.93,10137,560,493,448,433,422,855,1303,1796,2356,82.18,19.1,14.56,10.56
26-11-2020,RIBEIRA BRAVA,3,0,24,"[0,240]",Moderado,,,,3,Madeira,MADEIRA,3107,6544.88,12435,648,500,411,311,287,598,1009,1509,2157,189.99,32.96,23.06,15.42
26-11-2020,RIBEIRA DE PENA,14,1,233,"[0,240]",Moderado,,,,14,Norte,VILA REAL,1709,21745.98,6016,371,301,290,310,368,678,968,1269,1640,27.66,7.54,5.84,4.45
26-11-2020,RIBEIRA GRANDE,44,3,134,"[0,240]",Moderado,,,,44,Açores,AÇORES,4205,18015.13,32811,1163,689,512,345,253,598,1110,1799,2962,182.13,16.44,9.99,6.16
26-11-2020,RIO MAIOR,87,6,427,"[240,480]",Elevado,,,,87,Lisboa e Vale do Tejo,SANTARÉM,1414,27276.45,20379,1251,1144,941,795,648,1443,2384,3528,4779,74.71,17.52,12.93,8.74
26-11-2020,SABROSA,18,1,304,"[240,480]",Elevado,,,,18,Norte,VILA REAL,1710,15692.45,5918,393,314,304,302,350,652,956,1270,1663,37.71,10.6,8.09,6.09
26-11-2020,SABUGAL,92,7,869,"[480,960]",Muito Elevado,,,,92,Centro,GUARDA,0911,82269.82,10585,724,707,694,796,1009,1805,2499,3206,3930,12.87,4.78,3.9,3.04
26-11-2020,SALVATERRA DE MAGOS,78,6,366,"[240,480]",Elevado,,,,78,Lisboa e Vale do Tejo,SANTARÉM,1415,24393.2,21295,1275,1181,1060,799,772,1571,2631,3812,5087,87.3,20.85,15.63,10.79
26-11-2020,SANTA COMBA DÃO,20,1,191,"[0,240]",Moderado,,,,20,Centro,VISEU,1814,11194.77,10452,732,684,569,538,464,1002,1571,2255,2987,93.36,26.68,20.14,14.03
26-11-2020,SANTA CRUZ,47,3,104,"[0,240]",Moderado,,,,47,Madeira,MADEIRA,3108,8150.28,45281,1817,1301,974,716,523,1239,2213,3514,5331,555.6,65.41,43.12,27.15
26-11-2020,SANTA CRUZ DA GRACIOSA,2,0,48,"[0,240]",Moderado,,,,2,Açores,AÇORES,4401,6065.78,4208,228,180,163,124,145,269,432,612,840,69.37,13.85,10.09,7.12
26-11-2020,SANTA CRUZ DAS FLORES,2,0,92,"[0,240]",Moderado,,,,2,Açores,AÇORES,4802,7091.44,2165,125,98,74,56,51,107,181,279,404,30.53,5.7,3.93,2.55
26-11-2020,SANTA MARIA DA FEIRA,2186,156,1577,"[960,Max]",Extremamente Elevado,,,,2186,Norte,AVEIRO,0109,21587.65,138636,8182,6743,4771,3856,3079,6935,11706,18449,26631,642.19,123.36,85.46,54.22
26-11-2020,SANTA MARTA DE PENAGUIÃO,44,3,667,"[480,960]",Muito Elevado,,,,44,Norte,VILA REAL,1711,6928.13,6599,483,373,337,316,317,633,970,1343,1826,95.25,26.36,19.39,14.0
26-11-2020,SANTANA,3,0,45,"[0,240]",Moderado,,,,3,Madeira,MADEIRA,3109,9547.3,6711,418,353,343,282,277,559,902,1255,1673,70.29,17.52,13.15,9.45
26-11-2020,SANTARÉM,288,21,502,"[480,960]",Muito Elevado,,,,288,Lisboa e Vale do Tejo,SANTARÉM,1416,55253.58,57421,3654,3441,2760,2466,2206,4672,7432,10873,14527,103.92,26.29,19.68,13.45
26-11-2020,SANTIAGO DO CACÉM,41,3,142,"[0,240]",Moderado,,,,41,Alentejo,SETÚBAL,1509,105969.29,28791,2144,1689,1472,1295,1215,2510,3982,5671,7815,27.17,7.37,5.35,3.76
26-11-2020,SANTO TIRSO,1199,86,1762,"[960,Max]",Extremamente Elevado,,,,1199,Norte,PORTO,1314,13655.52,68055,4911,3935,2761,2257,1810,4067,6828,10763,15674,498.35,114.78,78.82,50.0
26-11-2020,SÃO BRÁS DE ALPORTEL,15,1,144,"[0,240]",Moderado,,,,15,Algarve,FARO,0812,15336.92,10416,596,468,467,404,401,805,1272,1740,2336,67.91,15.23,11.35,8.29
26-11-2020,SÃO JOÃO DA MADEIRA,331,24,1507,"[960,Max]",Extremamente Elevado,,,,331,Norte,AVEIRO,0116,794.3,21958,1347,1069,796,601,593,1194,1990,3059,4406,2765.49,554.91,385.26,250.63
26-11-2020,SÃO JOÃO DA PESQUEIRA,24,2,337,"[240,480]",Elevado,,,,24,Norte,VISEU,1815,26610.85,7125,417,330,294,328,328,656,950,1280,1697,26.77,6.38,4.81,3.57
26-11-2020,SÃO PEDRO DO SUL,67,5,435,"[240,480]",Elevado,,,,67,Centro,VISEU,1816,34895.09,15403,990,962,861,759,909,1668,2529,3491,4481,44.14,12.84,10.0,7.25
26-11-2020,SÃO ROQUE DO PICO,1,0,31,"[0,240]",Moderado,,,,1,Açores,AÇORES,4603,14236.1,3266,199,141,93,96,113,209,302,443,642,22.94,4.51,3.11,2.12
26-11-2020,SÃO VICENTE,1,0,19,"[0,240]",Moderado,,,,1,Madeira,MADEIRA,3110,7883.71,5143,272,264,266,225,280,505,771,1035,1307,65.23,16.58,13.13,9.78
26-11-2020,SARDOAL,31,2,829,"[480,960]",Muito Elevado,,,,31,Lisboa e Vale do Tejo,SANTARÉM,1417,9214.72,3741,227,178,148,165,248,413,561,739,966,40.6,10.48,8.02,6.09
26-11-2020,SÁTÃO,96,7,829,"[480,960]",Muito Elevado,,,,96,Centro,VISEU,1817,20194.11,11580,765,671,515,465,476,941,1456,2127,2892,57.34,14.32,10.53,7.21
26-11-2020,SEIA,153,11,688,"[480,960]",Muito Elevado,,,,153,Centro,GUARDA,0912,43568.83,22234,1807,1589,1238,1122,721,1843,3081,4670,6477,51.03,14.87,10.72,7.07
26-11-2020,SEIXAL,923,66,550,"[480,960]",Muito Elevado,,,,923,Lisboa e Vale do Tejo,SETÚBAL,1510,9545.17,167752,10586,9270,6661,4391,2930,7321,13982,23252,33838,1757.49,354.51,243.6,146.49
26-11-2020,SERNANCELHE,3,0,56,"[0,240]",Moderado,,,,3,Norte,VISEU,1818,22861.22,5396,305,293,286,273,260,533,819,1112,1417,23.6,6.2,4.86,3.58
26-11-2020,SERPA,65,5,454,"[240,480]",Elevado,,,,65,Alentejo,BEJA,0213,110563.34,14304,903,761,719,697,626,1323,2042,2803,3706,12.94,3.35,2.54,1.85
26-11-2020,SERTÃ,15,1,103,"[0,240]",Moderado,,,,15,Centro,CASTELO BRANCO,0509,44673.17,14577,870,779,790,767,1020,1787,2577,3356,4226,32.63,9.46,7.51,5.77
26-11-2020,SESIMBRA,202,14,390,"[240,480]",Elevado,,,,202,Lisboa e Vale do Tejo,SETÚBAL,1511,19571.75,51858,2400,2321,1853,1257,1083,2340,4193,6514,8914,264.96,45.54,33.28,21.42
26-11-2020,SETÚBAL,577,41,501,"[480,960]",Muito Elevado,,,,577,Lisboa e Vale do Tejo,SETÚBAL,1512,23032.5,115126,7425,6929,5075,3775,2655,6430,11505,18434,25859,499.83,112.27,80.03,49.95
26-11-2020,SEVER DO VOUGA,51,4,450,"[240,480]",Elevado,,,,51,Centro,AVEIRO,0117,12987.56,11331,766,637,568,540,567,1107,1675,2312,3078,87.24,23.7,17.8,12.9
26-11-2020,SILVES,68,5,188,"[0,240]",Moderado,,,,68,Algarve,FARO,0813,68006.23,36226,2137,1869,1610,1423,1600,3023,4633,6502,8639,53.27,12.7,9.56,6.81
26-11-2020,SINES,78,6,569,"[480,960]",Muito Elevado,,,,78,Alentejo,SETÚBAL,1513,20330.17,13715,888,791,551,416,268,684,1235,2026,2914,67.46,14.33,9.97,6.07
26-11-2020,SINTRA,2098,150,536,"[480,960]",Muito Elevado,,,,2098,Lisboa e Vale do Tejo,LISBOA,1111,31922.73,391402,20490,18316,13545,9137,7284,16421,29966,48282,68772,1226.08,215.43,151.25,93.87
26-11-2020,SOBRAL DE MONTE AGRAÇO,47,3,441,"[240,480]",Elevado,,,,47,Lisboa e Vale do Tejo,LISBOA,1112,5210.32,10651,564,507,352,272,212,484,836,1343,1907,204.43,36.6,25.78,16.05
26-11-2020,SOURE,71,5,415,"[240,480]",Elevado,,,,71,Centro,COIMBRA,0615,26506.07,17120,1173,1142,1004,883,987,1870,2874,4016,5189,64.59,19.58,15.15,10.84
26-11-2020,SOUSEL,4,0,91,"[0,240]",Moderado,,,,4,Alentejo,PORTALEGRE,1215,27932.18,4412,261,274,208,302,292,594,802,1076,1337,15.8,4.79,3.85,2.87
26-11-2020,TÁBUA,27,2,238,"[0,240]",Moderado,,,,27,Centro,COIMBRA,0616,19978.58,11368,729,584,524,430,464,894,1418,2002,2731,56.9,13.67,10.02,7.1
26-11-2020,TABUAÇO,13,1,215,"[0,240]",Moderado,,,,13,Norte,VISEU,1819,13385.67,6033,372,314,217,282,363,645,862,1176,1548,45.07,11.56,8.79,6.44
26-11-2020,TAROUCA,47,3,602,"[480,960]",Muito Elevado,,,,47,Norte,VISEU,1820,10008.49,7804,405,335,313,277,324,601,914,1249,1654,77.98,16.53,12.48,9.13
26-11-2020,TAVIRA,58,4,236,"[0,240]",Moderado,,,,58,Algarve,FARO,0814,60696.7,24530,1493,1415,1252,1066,1277,2343,3595,5010,6503,40.41,10.71,8.25,5.92
26-11-2020,TERRAS DE BOURO,25,2,393,"[240,480]",Elevado,,,,25,Norte,BRAGA,0310,27746.07,6361,391,372,296,319,340,659,955,1327,1718,22.93,6.19,4.78,3.44
26-11-2020,TOMAR,118,8,321,"[240,480]",Elevado,,,,118,Lisboa e Vale do Tejo,SANTARÉM,1418,35120.44,36748,2403,2189,1868,1853,1822,3675,5543,7732,10135,104.64,28.86,22.02,15.78
26-11-2020,TONDELA,62,4,235,"[0,240]",Moderado,,,,62,Centro,VISEU,1821,37121.73,26357,1768,1722,1518,1475,1417,2892,4410,6132,7900,71.0,21.28,16.52,11.88
26-11-2020,TORRE DE MONCORVO,48,3,624,"[480,960]",Muito Elevado,,,,48,Norte,BRAGANÇA,0409,53155.67,7695,556,478,488,551,719,1270,1758,2236,2792,14.48,5.25,4.21,3.31
26-11-2020,TORRES NOVAS,145,10,415,"[240,480]",Elevado,,,,145,Lisboa e Vale do Tejo,SANTARÉM,1419,26999.68,34933,2324,1979,1738,1406,1475,2881,4619,6598,8922,129.38,33.04,24.44,17.11
26-11-2020,TORRES VEDRAS,385,27,490,"[480,960]",Muito Elevado,,,,385,Lisboa e Vale do Tejo,LISBOA,1113,40714.89,78530,4513,3945,3447,2628,2104,4732,8179,12124,16637,192.88,40.86,29.78,20.09
26-11-2020,TRANCOSO,39,3,439,"[240,480]",Elevado,,,,39,Centro,GUARDA,0913,36152.47,8875,581,557,542,586,496,1082,1624,2181,2762,24.55,7.64,6.03,4.49
26-11-2020,TROFA,753,54,1960,"[960,Max]",Extremamente Elevado,,,,753,Norte,PORTO,1318,7201.76,38418,2336,1894,1231,939,684,1623,2854,4748,7084,533.44,98.36,65.93,39.63
26-11-2020,VAGOS,131,9,576,"[480,960]",Muito Elevado,,,,131,Centro,AVEIRO,0118,16491.5,22740,1320,1205,922,784,724,1508,2430,3635,4955,137.89,30.04,22.04,14.73
26-11-2020,VALE DE CAMBRA,267,19,1252,"[960,Max]",Extremamente Elevado,,,,267,Norte,AVEIRO,0119,14733.47,21327,1491,1363,1005,831,798,1629,2634,3997,5488,144.76,37.25,27.13,17.88
26-11-2020,VALENÇA,188,13,1415,"[960,Max]",Extremamente Elevado,,,,188,Norte,VIANA DO CASTELO,1608,11712.86,13290,867,791,582,582,503,1085,1667,2458,3325,113.46,28.39,20.99,14.23
26-11-2020,VALONGO,1258,90,1291,"[960,Max]",Extremamente Elevado,,,,1258,Norte,PORTO,1315,7512.45,97444,5629,4696,3207,2462,1829,4291,7498,12194,17823,1297.18,237.26,162.33,99.81
26-11-2020,VALPAÇOS,133,10,898,"[480,960]",Muito Elevado,,,,133,Norte,VILA REAL,1712,54873.93,14818,1217,1118,999,928,997,1925,2924,4042,5259,27.0,9.58,7.37,5.33
26-11-2020,VELAS,2,0,39,"[0,240]",Moderado,,,,2,Açores,AÇORES,4502,11738.38,5093,278,208,166,153,113,266,432,640,918,43.39,7.82,5.45,3.68
26-11-2020,VENDAS NOVAS,7,0,62,"[0,240]",Moderado,,,,7,Alentejo,ÉVORA,0712,22238.88,11255,677,768,655,501,532,1033,1688,2456,3133,50.61,14.09,11.04,7.59
26-11-2020,VIANA DO ALENTEJO,11,1,214,"[0,240]",Moderado,,,,11,Alentejo,ÉVORA,0713,39367.29,5145,245,208,235,210,214,424,659,867,1112,13.07,2.82,2.2,1.67
26-11-2020,VIANA DO CASTELO,485,35,575,"[480,960]",Muito Elevado,,,,485,Norte,VIANA DO CASTELO,1609,31902.01,84417,5470,4433,3591,3061,2982,6043,9634,14067,19537,264.61,61.24,44.09,30.2
26-11-2020,VIDIGUEIRA,5,0,91,"[0,240]",Moderado,,,,5,Alentejo,BEJA,0214,31661.09,5510,300,248,215,233,275,508,723,971,1271,17.4,4.01,3.07,2.28
26-11-2020,VIEIRA DO MINHO,170,12,1436,"[960,Max]",Extremamente Elevado,,,,170,Norte,BRAGA,0311,21644.35,11842,703,594,525,548,482,1030,1555,2149,2852,54.71,13.18,9.93,7.18
26-11-2020,VILA DE REI,2,0,60,"[0,240]",Moderado,,,,2,Centro,CASTELO BRANCO,0510,19154.6,3323,169,128,172,247,302,549,721,849,1018,17.35,5.31,4.43,3.76
26-11-2020,VILA DO BISPO,23,2,446,"[240,480]",Elevado,,,,23,Algarve,FARO,0815,17906.06,5154,302,302,314,232,233,465,779,1081,1383,28.78,7.72,6.04,4.35
26-11-2020,VILA DO CONDE,1444,103,1807,"[960,Max]",Extremamente Elevado,,,,1444,Norte,PORTO,1316,14902.77,79899,4726,3875,2819,2070,1743,3813,6632,10507,15233,536.13,102.21,70.5,44.5
26-11-2020,VILA DO PORTO,5,0,89,"[0,240]",Moderado,,,,5,Açores,AÇORES,4101,9688.74,5616,274,212,135,96,123,219,354,566,840,57.96,8.67,5.84,3.65
26-11-2020,VILA FLOR,12,1,199,"[0,240]",Moderado,,,,12,Norte,BRAGANÇA,0410,26581.14,6044,429,362,422,294,331,625,1047,1409,1838,22.74,6.91,5.3,3.94
26-11-2020,VILA FRANCA DE XIRA,795,57,560,"[480,960]",Muito Elevado,,,,795,Lisboa e Vale do Tejo,LISBOA,1114,31819.39,141957,8501,6852,4869,3425,2472,5897,10766,17618,26119,446.14,82.09,55.37,33.84
26-11-2020,VILA FRANCA DO CAMPO,7,0,63,"[0,240]",Moderado,,,,7,Açores,AÇORES,4206,7796.82,11051,450,344,248,217,154,371,619,963,1413,141.73,18.12,12.35,7.94
26-11-2020,VILA NOVA DA BARQUINHA,21,1,281,"[240,480]",Elevado,,,,21,Lisboa e Vale do Tejo,SANTARÉM,1420,4952.97,7461,415,406,392,364,338,702,1094,1500,1915,150.64,38.66,30.28,22.09
26-11-2020,VILA NOVA DE CERVEIRA,36,3,404,"[240,480]",Elevado,,,,36,Norte,VIANA DO CASTELO,1610,10846.66,8910,531,444,410,384,334,718,1128,1572,2103,82.14,19.39,14.49,10.4
26-11-2020,VILA NOVA DE FAMALICÃO,2774,198,2107,"[960,Max]",Extremamente Elevado,,,,2774,Norte,BRAGA,0312,20159.26,131676,7817,6164,4202,3282,2749,6031,10233,16397,24214,653.19,120.12,81.34,50.76
26-11-2020,VILA NOVA DE FOZ CÔA,34,2,523,"[480,960]",Muito Elevado,,,,34,Centro,GUARDA,0914,39815.18,6503,442,385,390,398,429,827,1217,1602,2044,16.33,5.13,4.02,3.06
26-11-2020,VILA NOVA DE GAIA,3311,237,1102,"[960,Max]",Extremamente Elevado,,,,3311,Norte,PORTO,1317,16846.43,300472,18349,15568,10972,8224,6281,14505,25477,41045,59394,1783.64,352.57,243.65,151.23
26-11-2020,VILA NOVA DE PAIVA,37,3,789,"[480,960]",Muito Elevado,,,,37,Centro,VISEU,1822,17553.28,4687,289,272,233,217,241,458,691,963,1252,26.7,7.13,5.49,3.94
26-11-2020,VILA NOVA DE POIARES,36,3,519,"[480,960]",Muito Elevado,,,,36,Centro,COIMBRA,0617,8445.3,6939,380,284,262,235,182,417,679,963,1343,82.17,15.9,11.4,8.04
26-11-2020,VILA POUCA DE AGUIAR,99,7,828,"[480,960]",Muito Elevado,,,,99,Norte,VILA REAL,1713,43706.62,11961,860,817,733,601,627,1228,1961,2778,3638,27.37,8.32,6.36,4.49
26-11-2020,VILA REAL,327,23,654,"[480,960]",Muito Elevado,,,,327,Norte,VILA REAL,1714,37880.28,49962,3025,2498,2065,1579,1466,3045,5110,7608,10633,131.9,28.07,20.08,13.49
26-11-2020,VILA REAL DE SANTO ANTÓNIO,25,2,133,"[0,240]",Moderado,,,,25,Algarve,FARO,0816,6125.0,18749,1172,1069,811,569,586,1155,1966,3035,4207,306.11,68.69,49.55,32.1
26-11-2020,VILA VELHA DE RÓDÃO,0,0,0,"[0,240]",Moderado,,,,0,Centro,CASTELO BRANCO,0511,32991.16,3144,209,229,180,283,306,589,769,998,1207,9.53,3.66,3.03,2.33
26-11-2020,VILA VERDE,477,34,1017,"[960,Max]",Extremamente Elevado,,,,477,Norte,BRAGA,0313,22866.52,46911,2365,2063,1667,1494,1437,2931,4598,6661,9026,205.15,39.47,29.13,20.11
26-11-2020,VILA VIÇOSA,15,1,196,"[0,240]",Moderado,,,,15,Alentejo,ÉVORA,0714,19485.89,7656,487,379,342,345,324,669,1011,1390,1877,39.29,9.63,7.13,5.19
26-11-2020,VIMIOSO,28,2,696,"[480,960]",Muito Elevado,,,,28,Norte,BRAGANÇA,0411,48158.51,4023,274,230,261,293,335,628,889,1119,1393,8.35,2.89,2.32,1.85
26-11-2020,VINHAIS,29,2,374,"[240,480]",Elevado,,,,29,Norte,BRAGANÇA,0412,69475.09,7746,599,577,636,641,815,1456,2092,2669,3268,11.15,4.7,3.84,3.01
26-11-2020,VISEU,448,32,461,"[240,480]",Elevado,,,,448,Centro,VISEU,1823,50710.14,97249,5769,5038,4140,3158,2710,5868,10008,15046,20815,191.77,41.05,29.67,19.74
26-11-2020,VIZELA,463,33,1937,"[960,Max]",Extremamente Elevado,,,,463,Norte,BRAGA,0314,2469.83,23897,1258,928,655,509,371,880,1535,2463,3721,967.49,150.65,99.72,62.15
26-11-2020,VOUZELA,30,2,312,"[240,480]",Elevado,,,,30,Centro,VISEU,1824,19369.46,9619,626,605,554,532,507,1039,1593,2198,2824,49.66,14.58,11.35,8.22
03-12-2020,ABRANTES,78,6,222,"[0,240]",Moderado,-191.0,"[Min,-30]",Fortemente decrescente,78,Lisboa e Vale do Tejo,SANTARÉM,1401,71469.08,35130,2473,2213,1730,1748,2021,3769,5499,7712,10185,49.15,14.25,10.79,7.69
03-12-2020,ÁGUEDA,302,22,655,"[480,960]",Muito Elevado,-35.0,"[Min,-30]",Fortemente decrescente,302,Centro,AVEIRO,0101,33527.44,46075,3237,2713,2090,1635,1496,3131,5221,7934,11171,137.43,33.32,23.66,15.57
03-12-2020,AGUIAR DA BEIRA,30,2,645,"[480,960]",Muito Elevado,430.0,"[30,Max]",Fortemente crescente,30,Centro,GUARDA,0901,20676.57,4652,304,281,235,239,148,387,622,903,1207,22.5,5.84,4.37,3.01
03-12-2020,ALANDROAL,30,2,601,"[480,960]",Muito Elevado,40.0,"[30,Max]",Fortemente crescente,30,Alentejo,ÉVORA,0701,54267.81,4992,307,256,296,299,377,676,972,1228,1535,9.2,2.83,2.26,1.79
03-12-2020,ALBERGARIA-A-VELHA,167,12,692,"[480,960]",Muito Elevado,0.0,"[-10,10]",Estável,167,Centro,AVEIRO,0102,15882.5,24144,1550,1298,996,687,680,1367,2363,3661,5211,152.02,32.81,23.05,14.88
03-12-2020,ALBUFEIRA,88,6,212,"[0,240]",Moderado,-48.0,"[Min,-30]",Fortemente decrescente,88,Algarve,FARO,0801,14066.42,41528,2067,1717,1425,985,858,1843,3268,4985,7052,295.24,50.14,35.44,23.23
03-12-2020,ALCÁCER DO SAL,28,2,240,"[240,480]",Elevado,26.0,"[10,30]",Crescente,28,Alentejo,SETÚBAL,1501,149987.3,11659,884,814,623,623,602,1225,1848,2662,3546,7.77,2.36,1.77,1.23
03-12-2020,ALCANENA,74,5,578,"[480,960]",Muito Elevado,-531.0,"[Min,-30]",Fortemente decrescente,74,Lisboa e Vale do Tejo,SANTARÉM,1402,12732.86,12809,891,744,628,536,588,1124,1752,2496,3387,100.6,26.6,19.6,13.76
03-12-2020,ALCOBAÇA,137,10,256,"[240,480]",Elevado,-131.0,"[Min,-30]",Fortemente decrescente,137,Lisboa e Vale do Tejo,LEIRIA,1001,40814.09,53555,3420,2927,2466,2059,1676,3735,6201,9128,12548,131.22,30.74,22.36,15.19
03-12-2020,ALCOCHETE,77,5,389,"[240,480]",Elevado,30.0,"[30,Max]",Fortemente crescente,77,Lisboa e Vale do Tejo,SETÚBAL,1502,12836.48,19787,857,834,691,476,447,923,1614,2448,3305,154.15,25.75,19.07,12.57
03-12-2020,ALCOUTIM,1,0,46,"[0,240]",Moderado,46.0,"[30,Max]",Fortemente crescente,1,Algarve,FARO,0802,57536.33,2159,191,188,163,190,267,457,620,808,999,3.75,1.74,1.4,1.08
03-12-2020,ALENQUER,190,14,431,"[240,480]",Elevado,119.0,"[30,Max]",Fortemente crescente,190,Lisboa e Vale do Tejo,LISBOA,1101,30421.92,44052,2298,2062,1629,1330,1155,2485,4114,6176,8474,144.8,27.85,20.3,13.52
03-12-2020,ALFÂNDEGA DA FÉ,40,3,879,"[480,960]",Muito Elevado,-88.0,"[Min,-30]",Fortemente decrescente,40,Norte,BRAGANÇA,0401,32194.64,4550,325,277,301,274,325,599,900,1177,1502,14.13,4.67,3.66,2.8
03-12-2020,ALIJÓ,58,4,546,"[480,960]",Muito Elevado,-85.0,"[Min,-30]",Fortemente decrescente,58,Norte,VILA REAL,1701,29759.89,10625,766,687,635,542,666,1208,1843,2530,3296,35.7,11.08,8.5,6.19
03-12-2020,ALJEZUR,6,0,107,"[0,240]",Moderado,18.0,"[10,30]",Crescente,6,Algarve,FARO,0803,32349.95,5594,316,336,335,320,410,730,1065,1401,1717,17.29,5.31,4.33,3.29
03-12-2020,ALJUSTREL,3,0,36,"[0,240]",Moderado,-134.0,"[Min,-30]",Fortemente decrescente,3,Alentejo,BEJA,0201,45847.41,8247,635,521,443,347,358,705,1148,1669,2304,17.99,5.03,3.64,2.5
03-12-2020,ALMADA,935,67,553,"[480,960]",Muito Elevado,-127.0,"[Min,-30]",Fortemente decrescente,935,Lisboa e Vale do Tejo,SETÚBAL,1503,7000.89,169039,10469,9777,7876,6144,5111,11255,19131,28908,39377,2414.5,562.45,412.91,273.26
03-12-2020,ALMEIDA,18,1,309,"[240,480]",Elevado,-17.0,"[-30,-10]",Decrescente,18,Centro,GUARDA,0902,51798.46,5830,441,419,396,458,393,851,1247,1666,2107,11.26,4.07,3.22,2.41
03-12-2020,ALMEIRIM,69,5,306,"[240,480]",Elevado,0.0,"[-10,10]",Estável,69,Lisboa e Vale do Tejo,SANTARÉM,1403,22212.05,22546,1342,1353,1106,866,843,1709,2815,4168,5510,101.5,24.81,18.76,12.67
03-12-2020,ALMODÔVAR,7,0,104,"[0,240]",Moderado,45.0,"[30,Max]",Fortemente crescente,7,Alentejo,BEJA,0202,77788.03,6725,414,443,396,373,328,701,1097,1540,1954,8.65,2.51,1.98,1.41
03-12-2020,ALPIARÇA,5,0,71,"[0,240]",Moderado,-85.0,"[Min,-30]",Fortemente decrescente,5,Lisboa e Vale do Tejo,SANTARÉM,1404,9536.33,7059,515,486,363,333,274,607,970,1456,1971,74.02,20.67,15.27,10.17
03-12-2020,ALTER DO CHÃO,10,1,316,"[240,480]",Elevado,95.0,"[30,Max]",Fortemente crescente,10,Alentejo,PORTALEGRE,1201,36206.62,3165,201,163,136,208,187,395,531,694,895,8.74,2.47,1.92,1.47
03-12-2020,ALVAIÁZERE,10,1,152,"[0,240]",Moderado,16.0,"[10,30]",Crescente,10,Centro,LEIRIA,1002,16047.76,6597,419,389,346,406,539,945,1291,1680,2099,41.11,13.08,10.47,8.04
03-12-2020,ALVITO,2,0,81,"[0,240]",Moderado,0.0,"[-10,10]",Estável,2,Alentejo,BEJA,0203,26485.32,2477,145,110,105,111,89,200,305,415,560,9.35,2.11,1.57,1.15
03-12-2020,AMADORA,878,63,477,"[240,480]",Elevado,-50.0,"[Min,-30]",Fortemente decrescente,878,Lisboa e Vale do Tejo,LISBOA,1115,2378.47,184106,11186,10936,8780,6460,5890,12350,21130,32066,43252,7742.05,1818.84,1348.44,888.56
03-12-2020,AMARANTE,506,36,951,"[480,960]",Muito Elevado,-196.0,"[Min,-30]",Fortemente decrescente,506,Norte,PORTO,1301,30133.15,53193,3086,2413,1812,1643,1311,2954,4766,7179,10265,176.53,34.07,23.82,15.82
03-12-2020,AMARES,151,11,833,"[480,960]",Muito Elevado,-364.0,"[Min,-30]",Fortemente decrescente,151,Norte,BRAGA,0301,8195.41,18129,1001,829,622,489,524,1013,1635,2464,3465,221.22,42.28,30.07,19.95
03-12-2020,ANADIA,199,14,730,"[480,960]",Muito Elevado,62.0,"[30,Max]",Fortemente crescente,199,Centro,AVEIRO,0103,21663.48,27258,1931,1698,1376,1208,1262,2470,3846,5544,7475,125.83,34.51,25.59,17.75
03-12-2020,ANGRA DO HEROÍSMO,91,6,269,"[240,480]",Elevado,136.0,"[30,Max]",Fortemente crescente,91,Açores,AÇORES,4301,23899.66,33807,2006,1473,1122,768,635,1403,2525,3998,6004,141.45,25.12,16.73,10.56
03-12-2020,ANSIÃO,59,4,490,"[480,960]",Muito Elevado,25.0,"[10,30]",Crescente,59,Centro,LEIRIA,1003,17609.42,12039,727,709,646,694,530,1224,1870,2579,3306,68.37,18.77,14.65,10.62
03-12-2020,ARCOS DE VALDEVEZ,118,8,564,"[480,960]",Muito Elevado,29.0,"[10,30]",Crescente,118,Norte,VIANA DO CASTELO,1601,44759.64,20926,1329,1338,1282,1343,1515,2858,4140,5478,6807,46.75,15.21,12.24,9.25
03-12-2020,ARGANIL,37,3,336,"[240,480]",Elevado,-336.0,"[Min,-30]",Fortemente decrescente,37,Centro,COIMBRA,0601,33283.93,11014,672,648,612,559,596,1155,1767,2415,3087,33.09,9.27,7.26,5.31
03-12-2020,ARMAMAR,80,6,1387,"[960,Max]",Extremamente Elevado,35.0,"[30,Max]",Fortemente crescente,80,Norte,VISEU,1801,11723.73,5769,357,305,309,285,310,595,904,1209,1566,49.21,13.36,10.31,7.71
03-12-2020,AROUCA,163,12,787,"[480,960]",Muito Elevado,-154.0,"[Min,-30]",Fortemente decrescente,163,Norte,AVEIRO,0104,32910.52,20720,1306,1047,753,683,683,1366,2119,3166,4472,62.96,13.59,9.62,6.44
03-12-2020,ARRAIOLOS,19,1,274,"[240,480]",Elevado,57.0,"[30,Max]",Fortemente crescente,19,Alentejo,ÉVORA,0702,68374.55,6928,435,384,283,367,480,847,1130,1514,1949,10.13,2.85,2.21,1.65
03-12-2020,ARRONCHES,9,1,319,"[240,480]",Elevado,0.0,"[-10,10]",Estável,9,Alentejo,PORTALEGRE,1202,31464.72,2820,155,142,162,187,179,366,528,670,825,8.96,2.62,2.13,1.68
03-12-2020,ARRUDA DOS VINHOS,37,3,240,"[240,480]",Elevado,-20.0,"[-30,-10]",Decrescente,37,Lisboa e Vale do Tejo,LISBOA,1102,7795.93,15412,738,738,562,509,438,947,1509,2247,2985,197.69,38.29,28.82,19.36
03-12-2020,AVEIRO,416,30,528,"[480,960]",Muito Elevado,-71.0,"[Min,-30]",Fortemente decrescente,416,Centro,AVEIRO,0105,19757.57,78734,4520,4004,3050,2250,2103,4353,7403,11407,15927,398.49,80.61,57.73,37.47
03-12-2020,AVIS,6,0,141,"[0,240]",Moderado,-24.0,"[-30,-10]",Decrescente,6,Alentejo,PORTALEGRE,1203,60596.51,4247,315,225,206,251,273,524,730,955,1270,7.01,2.1,1.58,1.2
03-12-2020,AZAMBUJA,155,11,682,"[480,960]",Muito Elevado,-88.0,"[Min,-30]",Fortemente decrescente,155,Lisboa e Vale do Tejo,LISBOA,1103,26265.65,22716,1322,1171,1070,798,618,1416,2486,3657,4979,86.48,18.96,13.92,9.46
03-12-2020,BAIÃO,171,12,912,"[480,960]",Muito Elevado,101.0,"[30,Max]",Fortemente crescente,171,Norte,PORTO,1302,17452.83,18748,1070,862,714,686,725,1411,2125,2987,4057,107.42,23.25,17.11,12.18
03-12-2020,BARCELOS,1652,118,1422,"[960,Max]",Extremamente Elevado,-188.0,"[Min,-30]",Fortemente decrescente,1652,Norte,BRAGA,0302,37890.14,116187,6721,5325,3619,2991,2562,5553,9172,14497,21218,306.64,56.0,38.26,24.21
03-12-2020,BARRANCOS,6,0,367,"[240,480]",Elevado,122.0,"[30,Max]",Fortemente crescente,6,Alentejo,BEJA,0204,16841.73,1634,90,65,65,94,61,155,220,285,375,9.7,2.23,1.69,1.31
03-12-2020,BARREIRO,375,27,499,"[480,960]",Muito Elevado,24.0,"[10,30]",Crescente,375,Lisboa e Vale do Tejo,SETÚBAL,1504,3639.07,75147,5194,5565,4459,3105,1767,4872,9331,14896,20090,2065.05,552.07,409.34,256.42
03-12-2020,BATALHA,35,2,219,"[0,240]",Moderado,0.0,"[-10,10]",Estável,35,Centro,LEIRIA,1004,10341.6,15963,873,762,649,529,549,1078,1727,2489,3362,154.35,32.51,24.07,16.7
03-12-2020,BEJA,36,3,107,"[0,240]",Moderado,-51.0,"[Min,-30]",Fortemente decrescente,36,Alentejo,BEJA,0205,114647.55,33579,2005,1840,1386,1272,1039,2311,3697,5537,7542,29.29,6.58,4.83,3.22
03-12-2020,BELMONTE,64,5,1000,"[960,Max]",Extremamente Elevado,-500.0,"[Min,-30]",Fortemente decrescente,64,Centro,CASTELO BRANCO,0501,11875.91,6398,444,321,325,310,355,665,990,1311,1755,53.87,14.78,11.04,8.34
03-12-2020,BENAVENTE,46,3,150,"[0,240]",Moderado,-128.0,"[Min,-30]",Fortemente decrescente,46,Lisboa e Vale do Tejo,SANTARÉM,1405,52138.39,30602,1468,1376,1141,876,643,1519,2660,4036,5504,58.69,10.56,7.74,5.1
03-12-2020,BOMBARRAL,16,1,127,"[0,240]",Moderado,-112.0,"[Min,-30]",Fortemente decrescente,16,Lisboa e Vale do Tejo,LEIRIA,1005,9128.55,12558,875,714,561,491,429,920,1481,2195,3070,137.56,33.63,24.04,16.22
03-12-2020,BORBA,5,0,74,"[0,240]",Moderado,0.0,"[-10,10]",Estável,5,Alentejo,ÉVORA,0703,14518.65,6736,430,375,279,436,392,828,1107,1482,1912,46.39,13.17,10.21,7.62
03-12-2020,BOTICAS,38,3,760,"[480,960]",Muito Elevado,120.0,"[30,Max]",Fortemente crescente,38,Norte,VILA REAL,1702,32195.66,4998,347,306,311,305,380,685,996,1302,1649,15.52,5.12,4.04,3.09
03-12-2020,BRAGA,2134,152,1168,"[960,Max]",Extremamente Elevado,-182.0,"[Min,-30]",Fortemente decrescente,2133,Norte,BRAGA,0303,18339.95,182679,10029,7963,5241,4320,3671,7991,13232,21195,31224,996.07,170.25,115.57,72.15
03-12-2020,BRAGANÇA,254,18,756,"[480,960]",Muito Elevado,-30.0,"[-30,-10]",Decrescente,254,Norte,BRAGANÇA,0402,117357.27,33607,2402,1855,1652,1393,1163,2556,4208,6063,8465,28.64,7.21,5.17,3.59
03-12-2020,CABECEIRAS DE BASTO,159,11,1017,"[960,Max]",Extremamente Elevado,-116.0,"[Min,-30]",Fortemente decrescente,159,Norte,BRAGA,0304,24182.16,15628,774,594,544,575,574,1149,1693,2287,3061,64.63,12.66,9.46,7.0
03-12-2020,CADAVAL,27,2,197,"[0,240]",Moderado,-96.0,"[Min,-30]",Fortemente decrescente,27,Lisboa e Vale do Tejo,LISBOA,1104,17489.3,13673,813,796,756,621,625,1246,2002,2798,3611,78.18,20.65,16.0,11.45
03-12-2020,CALDAS DA RAINHA,121,9,233,"[0,240]",Moderado,-21.0,"[-30,-10]",Decrescente,121,Lisboa e Vale do Tejo,LEIRIA,1006,25569.47,51912,3035,2684,2186,1899,1705,3604,5790,8474,11509,203.03,45.01,33.14,22.64
03-12-2020,CALHETA,6,0,55,"[0,240]",Moderado,18.0,"[10,30]",Crescente,6,Madeira,MADEIRA,3101,11150.43,10867,576,497,507,399,415,814,1321,1818,2394,97.46,21.47,16.3,11.85
03-12-2020,CALHETA (AÇORES),1,0,31,"[0,240]",Moderado,0.0,"[-10,10]",Estável,1,Açores,AÇORES,4501,12626.4,3184,215,159,141,139,122,261,402,561,776,25.22,6.15,4.44,3.18
03-12-2020,CÂMARA DE LOBOS,50,4,148,"[0,240]",Moderado,20.0,"[10,30]",Crescente,50,Madeira,MADEIRA,3102,5216.67,33675,1396,1059,834,545,381,926,1760,2819,4215,645.49,80.79,54.03,33.74
03-12-2020,CAMINHA,84,6,529,"[480,960]",Muito Elevado,-277.0,"[Min,-30]",Fortemente decrescente,84,Norte,VIANA DO CASTELO,1602,13652.14,15877,1046,944,818,646,656,1302,2120,3064,4110,116.3,30.11,22.44,15.53
03-12-2020,CAMPO MAIOR,13,1,165,"[0,240]",Moderado,25.0,"[10,30]",Crescente,13,Alentejo,PORTALEGRE,1204,24720.16,7874,471,364,351,279,327,606,957,1321,1792,31.85,7.25,5.34,3.87
03-12-2020,CANTANHEDE,173,12,494,"[480,960]",Muito Elevado,-49.0,"[Min,-30]",Fortemente decrescente,173,Centro,COIMBRA,0602,39088.02,35011,2346,2096,1880,1709,1451,3160,5040,7136,9482,89.57,24.26,18.26,12.89
03-12-2020,CARRAZEDA DE ANSIÃES,5,0,88,"[0,240]",Moderado,-71.0,"[Min,-30]",Fortemente decrescente,5,Norte,BRAGANÇA,0403,27924.09,5666,424,389,391,312,465,777,1168,1557,1981,20.29,7.09,5.58,4.18
03-12-2020,CARREGAL DO SAL,28,2,302,"[240,480]",Elevado,-32.0,"[Min,-30]",Fortemente decrescente,28,Centro,VISEU,1802,11689.21,9271,587,562,486,462,376,838,1324,1886,2473,79.31,21.16,16.13,11.33
03-12-2020,CARTAXO,140,10,587,"[480,960]",Muito Elevado,-109.0,"[Min,-30]",Fortemente decrescente,140,Lisboa e Vale do Tejo,SANTARÉM,1406,15817.28,23843,1415,1376,1142,861,632,1493,2635,4011,5426,150.74,34.3,25.36,16.66
03-12-2020,CASCAIS,891,64,417,"[240,480]",Elevado,-98.0,"[Min,-30]",Fortemente decrescente,890,Lisboa e Vale do Tejo,LISBOA,1105,9740.17,213608,12151,11444,8680,6469,5248,11717,20397,31841,43992,2193.1,451.66,326.91,209.41
03-12-2020,CASTANHEIRA DE PÊRA,5,0,191,"[0,240]",Moderado,38.0,"[30,Max]",Fortemente crescente,5,Centro,LEIRIA,1007,6677.45,2614,233,195,157,190,187,377,534,729,962,39.15,14.41,10.92,8.0
03-12-2020,CASTELO BRANCO,320,23,616,"[480,960]",Muito Elevado,127.0,"[30,Max]",Fortemente crescente,320,Centro,CASTELO BRANCO,0502,143819.15,51987,3528,3042,2499,2229,2225,4454,6953,9995,13523,36.15,9.4,6.95,4.83
03-12-2020,CASTELO DE PAIVA,90,6,582,"[480,960]",Muito Elevado,-570.0,"[Min,-30]",Fortemente decrescente,90,Norte,AVEIRO,0106,11500.53,15454,881,697,545,420,431,851,1396,2093,2974,134.37,25.86,18.2,12.14
03-12-2020,CASTELO DE VIDE,10,1,343,"[240,480]",Elevado,69.0,"[30,Max]",Fortemente crescente,10,Alentejo,PORTALEGRE,1205,26491.24,2919,204,173,179,147,170,317,496,669,873,11.02,3.3,2.53,1.87
03-12-2020,CASTRO DAIRE,62,4,449,"[240,480]",Elevado,65.0,"[30,Max]",Fortemente crescente,62,Centro,VISEU,1803,37904.13,13823,942,857,765,732,773,1505,2270,3127,4069,36.47,10.74,8.25,5.99
03-12-2020,CASTRO MARIM,8,1,128,"[0,240]",Moderado,64.0,"[30,Max]",Fortemente crescente,8,Algarve,FARO,0804,30084.37,6237,370,345,334,322,344,666,1000,1345,1715,20.73,5.7,4.47,3.32
03-12-2020,CASTRO VERDE,14,1,201,"[0,240]",Moderado,-44.0,"[Min,-30]",Fortemente decrescente,14,Alentejo,BEJA,0206,56944.23,6949,437,347,303,275,227,502,805,1152,1589,12.2,2.79,2.02,1.41
03-12-2020,CELORICO DA BEIRA,28,2,404,"[240,480]",Elevado,-837.0,"[Min,-30]",Fortemente decrescente,28,Centro,GUARDA,0903,24721.63,6928,430,416,363,369,535,904,1267,1683,2113,28.02,8.55,6.81,5.12
03-12-2020,CELORICO DE BASTO,128,9,672,"[480,960]",Muito Elevado,-205.0,"[Min,-30]",Fortemente decrescente,128,Norte,BRAGA,0305,18107.02,19040,1001,802,668,728,729,1457,2125,2927,3928,105.15,21.69,16.17,11.74
03-12-2020,CHAMUSCA,54,4,587,"[480,960]",Muito Elevado,43.0,"[30,Max]",Fortemente crescente,54,Lisboa e Vale do Tejo,SANTARÉM,1407,74600.54,9197,629,583,553,465,579,1044,1597,2180,2809,12.33,3.77,2.92,2.14
03-12-2020,CHAVES,612,44,1556,"[960,Max]",Extremamente Elevado,379.0,"[30,Max]",Fortemente crescente,612,Norte,VILA REAL,1703,59122.95,39343,2676,2429,1991,1886,1918,3804,5795,8224,10900,66.54,18.44,13.91,9.8
03-12-2020,CINFÃES,120,9,658,"[480,960]",Muito Elevado,-537.0,"[Min,-30]",Fortemente decrescente,120,Norte,VISEU,1804,23928.76,18244,1067,902,779,734,758,1492,2271,3173,4240,76.24,17.72,13.26,9.49
03-12-2020,COIMBRA,598,43,446,"[240,480]",Elevado,-61.0,"[Min,-30]",Fortemente decrescente,599,Centro,COIMBRA,0603,31939.94,134166,9489,8734,6353,5139,5074,10213,16566,25300,34789,420.06,108.92,79.21,51.87
03-12-2020,CONDEIXA-A-NOVA,86,6,485,"[480,960]",Muito Elevado,23.0,"[10,30]",Crescente,86,Centro,COIMBRA,0604,13867.47,17733,871,809,717,583,490,1073,1790,2599,3470,127.88,25.02,18.74,12.91
03-12-2020,CONSTÂNCIA,8,1,199,"[0,240]",Moderado,-248.0,"[Min,-30]",Fortemente decrescente,8,Lisboa e Vale do Tejo,SANTARÉM,1408,8036.58,4030,211,183,187,148,155,303,490,673,884,50.14,11.0,8.37,6.1
03-12-2020,CORUCHE,37,3,212,"[0,240]",Moderado,-223.0,"[Min,-30]",Fortemente decrescente,37,Lisboa e Vale do Tejo,SANTARÉM,1409,111572.03,17471,1294,1090,1095,1096,1019,2115,3210,4300,5594,15.66,5.01,3.85,2.88
03-12-2020,CORVO,0,0,0,"[0,240]",Moderado,0.0,"[-10,10]",Estável,0,Açores,AÇORES,4901,1711.45,464,22,21,11,13,19,32,43,64,86,27.12,5.03,3.74,2.51
03-12-2020,COVILHÃ,285,20,609,"[480,960]",Muito Elevado,-154.0,"[Min,-30]",Fortemente decrescente,285,Centro,CASTELO BRANCO,0503,55560.06,46787,3533,2998,2365,2111,2193,4304,6669,9667,13200,84.21,23.76,17.4,12.0
03-12-2020,CRATO,28,2,895,"[480,960]",Muito Elevado,-351.0,"[Min,-30]",Fortemente decrescente,28,Alentejo,PORTALEGRE,1206,39806.88,3129,229,258,163,182,228,410,573,831,1060,7.86,2.66,2.09,1.44
03-12-2020,CUBA,30,2,653,"[480,960]",Muito Elevado,65.0,"[30,Max]",Fortemente crescente,30,Alentejo,BEJA,0207,17208.72,4595,255,233,206,190,143,333,539,772,1027,26.7,5.97,4.49,3.13
03-12-2020,ELVAS,50,4,244,"[240,480]",Elevado,-43.0,"[Min,-30]",Fortemente decrescente,50,Alentejo,PORTALEGRE,1207,63128.86,20528,1057,1145,902,852,810,1662,2564,3709,4766,32.52,7.55,5.88,4.06
03-12-2020,ENTRONCAMENTO,55,4,255,"[240,480]",Elevado,-56.0,"[Min,-30]",Fortemente decrescente,55,Lisboa e Vale do Tejo,SANTARÉM,1410,1372.81,21558,1066,930,868,695,592,1287,2155,3085,4151,1570.14,302.33,224.69,156.96
03-12-2020,ESPINHO,424,30,1437,"[960,Max]",Extremamente Elevado,-3.0,"[-10,10]",Estável,424,Norte,AVEIRO,0107,2105.68,29516,2205,1993,1430,1177,960,2137,3567,5560,7765,1401.52,368.71,264.01,169.37
03-12-2020,ESPOSENDE,435,31,1273,"[960,Max]",Extremamente Elevado,275.0,"[30,Max]",Fortemente crescente,435,Norte,BRAGA,0306,9540.98,34177,1831,1522,1095,894,723,1617,2712,4234,6065,358.21,63.57,44.38,28.42
03-12-2020,ESTARREJA,141,10,542,"[480,960]",Muito Elevado,-112.0,"[Min,-30]",Fortemente decrescente,141,Centro,AVEIRO,0108,10817.33,26006,1503,1399,1106,953,728,1681,2787,4186,5689,240.42,52.59,38.7,25.76
03-12-2020,ESTREMOZ,25,2,196,"[0,240]",Moderado,-40.0,"[Min,-30]",Fortemente decrescente,25,Alentejo,ÉVORA,0704,51379.95,12728,789,613,697,786,877,1663,2360,2973,3762,24.77,7.32,5.79,4.59
03-12-2020,ÉVORA,220,16,419,"[240,480]",Elevado,-7.0,"[-10,10]",Estável,220,Alentejo,ÉVORA,0705,130707.58,52428,3569,2852,2176,1966,1803,3769,5945,8797,12366,40.11,9.46,6.73,4.55
03-12-2020,FAFE,796,57,1656,"[960,Max]",Extremamente Elevado,-498.0,"[Min,-30]",Fortemente decrescente,796,Norte,BRAGA,0307,21908.11,48060,3044,2455,1679,1403,1208,2611,4290,6745,9789,219.37,44.68,30.79,19.58
03-12-2020,FARO,185,13,303,"[240,480]",Elevado,-61.0,"[Min,-30]",Fortemente decrescente,185,Algarve,FARO,0805,20256.79,61015,3847,3364,2604,2055,1601,3656,6260,9624,13471,301.2,66.5,47.51,30.9
03-12-2020,FELGUEIRAS,785,56,1391,"[960,Max]",Extremamente Elevado,-543.0,"[Min,-30]",Fortemente decrescente,785,Norte,PORTO,1303,11573.75,56422,2951,2302,1601,1316,973,2289,3890,6192,9143,487.49,79.0,53.5,33.61
03-12-2020,FERREIRA DO ALENTEJO,5,0,64,"[0,240]",Moderado,-89.0,"[Min,-30]",Fortemente decrescente,5,Alentejo,BEJA,0208,64820.68,7845,515,414,372,343,345,688,1060,1474,1989,12.1,3.07,2.27,1.64
03-12-2020,FERREIRA DO ZÊZERE,12,1,151,"[0,240]",Moderado,-63.0,"[Min,-30]",Fortemente decrescente,12,Lisboa e Vale do Tejo,SANTARÉM,1411,19038.03,7959,470,370,416,465,456,921,1337,1707,2177,41.81,11.44,8.97,7.02
03-12-2020,FIGUEIRA DA FOZ,412,29,701,"[480,960]",Muito Elevado,-75.0,"[Min,-30]",Fortemente decrescente,412,Centro,COIMBRA,0605,37905.26,58747,4032,3597,2887,2495,2043,4538,7425,11022,15054,154.98,39.72,29.08,19.59
03-12-2020,FIGUEIRA DE CASTELO RODRIGO,25,2,448,"[240,480]",Elevado,-358.0,"[Min,-30]",Fortemente decrescente,25,Centro,GUARDA,0904,50857.46,5584,347,352,290,352,391,743,1033,1385,1732,10.98,3.41,2.72,2.03
03-12-2020,FIGUEIRÓ DOS VINHOS,13,1,233,"[0,240]",Moderado,53.0,"[30,Max]",Fortemente crescente,13,Centro,LEIRIA,1008,17344.0,5568,402,386,322,309,351,660,982,1368,1770,32.1,10.21,7.89,5.66
03-12-2020,FORNOS DE ALGODRES,4,0,88,"[0,240]",Moderado,-67.0,"[Min,-30]",Fortemente decrescente,4,Centro,GUARDA,0905,13145.05,4528,261,218,247,256,232,488,735,953,1214,34.45,9.24,7.25,5.59
03-12-2020,FREIXO DE ESPADA À CINTA,71,5,2153,"[960,Max]",Extremamente Elevado,-1000.0,"[Min,-30]",Fortemente decrescente,71,Norte,BRAGANÇA,0404,24414.29,3298,211,177,231,196,189,385,616,793,1004,13.51,4.11,3.25,2.52
03-12-2020,FRONTEIRA,12,1,403,"[240,480]",Elevado,201.0,"[30,Max]",Fortemente crescente,12,Alentejo,PORTALEGRE,1208,24859.58,2974,213,182,149,156,168,324,473,655,868,11.96,3.49,2.63,1.9
03-12-2020,FUNCHAL,84,6,81,"[0,240]",Moderado,-15.0,"[-30,-10]",Decrescente,84,Madeira,MADEIRA,3103,7616.2,104024,6382,5086,3643,2821,1990,4811,8454,13540,19922,1365.86,261.58,177.78,111.0
03-12-2020,FUNDÃO,125,9,472,"[240,480]",Elevado,-177.0,"[Min,-30]",Fortemente decrescente,125,Centro,CASTELO BRANCO,0504,70019.79,26495,1781,1464,1432,1357,1643,3000,4432,5896,7677,37.84,10.96,8.42,6.33
03-12-2020,GAVIÃO,63,5,1931,"[960,Max]",Extremamente Elevado,460.0,"[30,Max]",Fortemente crescente,63,Alentejo,PORTALEGRE,1209,29459.45,3263,189,186,222,263,293,556,778,964,1153,11.08,3.91,3.27,2.64
03-12-2020,GÓIS,7,1,184,"[0,240]",Moderado,26.0,"[10,30]",Crescente,7,Centro,COIMBRA,0606,26330.19,3805,235,199,240,233,244,477,717,916,1151,14.45,4.37,3.48,2.72
03-12-2020,GOLEGÃ,25,2,468,"[240,480]",Elevado,93.0,"[30,Max]",Fortemente crescente,25,Lisboa e Vale do Tejo,SANTARÉM,1412,8431.67,5339,356,299,281,243,255,498,779,1078,1434,63.32,17.01,12.78,9.24
03-12-2020,GONDOMAR,1434,102,864,"[480,960]",Muito Elevado,-331.0,"[Min,-30]",Fortemente decrescente,1434,Norte,PORTO,1304,13191.76,165985,10555,8755,6222,4450,3364,7814,14036,22791,33346,1258.22,252.77,172.76,106.4
03-12-2020,GOUVEIA,60,4,484,"[480,960]",Muito Elevado,113.0,"[30,Max]",Fortemente crescente,60,Centro,GUARDA,0906,30061.17,12387,871,931,780,783,810,1593,2373,3304,4175,41.21,13.89,10.99,7.89
03-12-2020,GRÂNDOLA,52,4,355,"[240,480]",Elevado,54.0,"[30,Max]",Fortemente crescente,52,Alentejo,SETÚBAL,1505,82593.66,14639,834,834,708,688,672,1360,2068,2902,3736,17.72,4.52,3.51,2.5
03-12-2020,GUARDA,270,19,693,"[480,960]",Muito Elevado,49.0,"[30,Max]",Fortemente crescente,270,Centro,GUARDA,0907,71209.58,38969,2477,2041,1686,1415,1474,2889,4575,6616,9093,54.72,12.77,9.29,6.42
03-12-2020,GUIMARÃES,2763,197,1814,"[960,Max]",Extremamente Elevado,-477.0,"[Min,-30]",Fortemente decrescente,2763,Norte,BRAGA,0308,24099.96,152309,9394,7074,4809,3877,2948,6825,11634,18708,28102,631.99,116.61,77.63,48.27
03-12-2020,HORTA,3,0,21,"[0,240]",Moderado,14.0,"[10,30]",Crescente,3,Açores,AÇORES,4701,17305.53,14521,818,658,468,352,302,654,1122,1780,2598,83.91,15.01,10.29,6.48
03-12-2020,IDANHA-A-NOVA,17,1,211,"[0,240]",Moderado,-25.0,"[-30,-10]",Decrescente,17,Centro,CASTELO BRANCO,0505,141633.51,8043,518,490,519,672,974,1646,2165,2655,3173,5.68,2.24,1.87,1.53
03-12-2020,ÍLHAVO,239,17,618,"[480,960]",Muito Elevado,-20.0,"[-30,-10]",Decrescente,239,Centro,AVEIRO,0110,7347.55,38699,2227,1943,1444,1193,850,2043,3487,5430,7657,526.66,104.21,73.9,47.46
03-12-2020,LAGOA (FARO),69,5,303,"[240,480]",Elevado,-40.0,"[Min,-30]",Fortemente decrescente,69,Algarve,FARO,0806,8825.45,22762,1314,1168,919,749,670,1419,2338,3506,4820,257.93,54.62,39.73,26.49
03-12-2020,LAGOA,13,1,88,"[0,240]",Moderado,-109.0,"[Min,-30]",Fortemente decrescente,13,Açores,AÇORES,4201,4559.32,14721,536,458,349,238,235,473,822,1280,1816,322.9,39.83,28.08,18.03
03-12-2020,LAGOS,104,7,342,"[240,480]",Elevado,65.0,"[30,Max]",Fortemente crescente,104,Algarve,FARO,0807,21299.27,30374,1744,1434,1247,1053,1029,2082,3329,4763,6507,142.61,30.55,22.36,15.63
03-12-2020,LAJES DAS FLORES,0,0,0,"[0,240]",Moderado,0.0,"[-10,10]",Estável,0,Açores,AÇORES,4801,7004.79,1463,88,53,62,46,54,100,162,215,303,20.89,4.33,3.07,2.31
03-12-2020,LAJES DO PICO,0,0,0,"[0,240]",Moderado,0.0,"[-10,10]",Estável,0,Açores,AÇORES,4601,15531.09,4490,304,231,223,159,162,321,544,775,1079,28.91,6.95,4.99,3.5
03-12-2020,LAMEGO,193,14,775,"[480,960]",Muito Elevado,124.0,"[30,Max]",Fortemente crescente,193,Norte,VISEU,1805,16542.11,24895,1639,1284,1124,898,783,1681,2805,4089,5728,150.5,34.63,24.72,16.96
03-12-2020,LEIRIA,456,33,364,"[240,480]",Elevado,-4.0,"[-10,10]",Estável,456,Centro,LEIRIA,1009,56508.83,125267,7389,6366,5090,3902,3159,7061,12151,18517,25906,221.68,45.84,32.77,21.5
03-12-2020,LISBOA,2833,202,556,"[480,960]",Muito Elevado,-80.0,"[Min,-30]",Fortemente decrescente,2834,Lisboa e Vale do Tejo,LISBOA,1106,10005.43,509515,33197,33340,27706,23037,26770,49807,77513,110853,144050,5092.6,1439.78,1107.98,774.74
03-12-2020,LOULÉ,142,10,207,"[0,240]",Moderado,-49.0,"[Min,-30]",Fortemente decrescente,142,Algarve,FARO,0808,76366.91,68697,3890,3350,2780,2358,2251,4609,7389,10739,14629,89.96,19.16,14.06,9.68
03-12-2020,LOURES,1111,79,520,"[480,960]",Muito Elevado,-104.0,"[Min,-30]",Fortemente decrescente,1111,Lisboa e Vale do Tejo,LISBOA,1107,16723.99,213687,12746,12794,9644,6669,5033,11702,21346,34140,46886,1277.73,280.35,204.14,127.64
03-12-2020,LOURINHÃ,48,3,186,"[0,240]",Moderado,35.0,"[30,Max]",Fortemente crescente,48,Lisboa e Vale do Tejo,LISBOA,1108,14717.2,25855,1584,1243,992,842,645,1487,2479,3722,5306,175.68,36.05,25.29,16.84
03-12-2020,LOUSÃ,79,6,460,"[240,480]",Elevado,-59.0,"[Min,-30]",Fortemente decrescente,79,Centro,COIMBRA,0607,13840.01,17158,946,866,658,528,450,978,1636,2502,3448,123.97,24.91,18.08,11.82
03-12-2020,LOUSADA,716,51,1531,"[960,Max]",Extremamente Elevado,-884.0,"[Min,-30]",Fortemente decrescente,716,Norte,PORTO,1305,9608.01,46755,2289,1698,1176,853,621,1474,2650,4348,6637,486.63,69.08,45.25,27.58
03-12-2020,MAÇÃO,21,1,335,"[240,480]",Elevado,32.0,"[30,Max]",Fortemente crescente,21,Lisboa e Vale do Tejo,SANTARÉM,1413,39997.98,6267,386,362,390,440,657,1097,1487,1849,2235,15.67,5.59,4.62,3.72
03-12-2020,MACEDO DE CAVALEIROS,141,10,971,"[960,Max]",Extremamente Elevado,62.0,"[30,Max]",Fortemente crescente,141,Norte,BRAGANÇA,0405,69914.08,14516,1082,889,878,823,938,1761,2639,3528,4610,20.76,6.59,5.05,3.77
03-12-2020,MACHICO,7,0,35,"[0,240]",Moderado,-15.0,"[-30,-10]",Decrescente,7,Madeira,MADEIRA,3104,6825.1,19981,1197,860,662,455,331,786,1448,2308,3505,292.76,51.36,33.82,21.22
03-12-2020,MADALENA,1,0,17,"[0,240]",Moderado,17.0,"[10,30]",Crescente,1,Açores,AÇORES,4602,14712.33,5895,334,256,173,190,179,369,542,798,1132,40.07,7.69,5.42,3.68
03-12-2020,MAFRA,300,21,354,"[240,480]",Elevado,-118.0,"[Min,-30]",Fortemente decrescente,300,Lisboa e Vale do Tejo,LISBOA,1109,29165.5,84816,3613,3334,2839,2089,1899,3988,6827,10161,13774,290.81,47.23,34.84,23.41
03-12-2020,MAIA,1028,73,740,"[480,960]",Muito Elevado,-273.0,"[Min,-30]",Fortemente decrescente,1028,Norte,PORTO,1306,8293.94,138971,7801,6617,4512,3339,2631,5970,10482,17099,24900,1675.56,300.22,206.16,126.38
03-12-2020,MANGUALDE,43,3,232,"[0,240]",Moderado,-184.0,"[Min,-30]",Fortemente decrescente,43,Centro,VISEU,1806,21925.56,18510,1198,1128,885,852,743,1595,2480,3608,4806,84.42,21.92,16.46,11.31
03-12-2020,MANTEIGAS,18,1,599,"[480,960]",Muito Elevado,-764.0,"[Min,-30]",Fortemente decrescente,18,Centro,GUARDA,0908,12197.55,3007,258,197,159,167,146,313,472,669,927,24.65,7.6,5.48,3.87
03-12-2020,MARCO DE CANAVESES,480,34,932,"[480,960]",Muito Elevado,-439.0,"[Min,-30]",Fortemente decrescente,480,Norte,PORTO,1307,20188.98,51496,2678,2060,1488,1265,1023,2288,3776,5836,8514,255.07,42.17,28.91,18.7
03-12-2020,MARINHA GRANDE,125,9,325,"[240,480]",Elevado,-5.0,"[-10,10]",Estável,125,Centro,LEIRIA,1010,18725.19,38508,2365,2302,1638,1359,1058,2417,4055,6357,8722,205.65,46.58,33.95,21.66
03-12-2020,MARVÃO,42,3,1398,"[960,Max]",Extremamente Elevado,699.0,"[30,Max]",Fortemente crescente,42,Alentejo,PORTALEGRE,1210,15489.9,3005,198,185,142,197,237,434,576,761,959,19.4,6.19,4.91,3.72
03-12-2020,MATOSINHOS,1289,92,735,"[480,960]",Muito Elevado,-212.0,"[Min,-30]",Fortemente decrescente,1289,Norte,PORTO,1308,6241.97,175357,11850,9977,7023,5024,3884,8908,15931,25908,37758,2809.31,604.9,415.06,255.22
03-12-2020,MEALHADA,76,5,382,"[240,480]",Elevado,-150.0,"[Min,-30]",Fortemente decrescente,76,Centro,AVEIRO,0111,11065.66,19914,1163,1039,810,828,831,1659,2469,3508,4671,179.96,42.21,31.7,22.31
03-12-2020,MÊDA,12,1,262,"[240,480]",Elevado,-130.0,"[Min,-30]",Fortemente decrescente,12,Centro,GUARDA,0909,28604.92,4587,343,306,290,288,443,731,1021,1327,1670,16.04,5.84,4.64,3.57
03-12-2020,MELGAÇO,26,2,321,"[240,480]",Elevado,-62.0,"[Min,-30]",Fortemente decrescente,26,Norte,VIANA DO CASTELO,1603,23824.58,8093,507,567,578,614,675,1289,1867,2434,2941,33.97,12.34,10.22,7.84
03-12-2020,MÉRTOLA,16,1,261,"[240,480]",Elevado,163.0,"[30,Max]",Fortemente crescente,16,Alentejo,BEJA,0209,129287.34,6142,400,390,378,423,600,1023,1401,1791,2191,4.75,1.69,1.39,1.08
03-12-2020,MESÃO FRIO,10,1,252,"[240,480]",Elevado,-76.0,"[Min,-30]",Fortemente decrescente,10,Norte,VILA REAL,1704,2664.87,3964,265,205,168,157,120,277,445,650,915,148.74,34.33,24.39,16.7
03-12-2020,MIRA,56,4,473,"[240,480]",Elevado,-51.0,"[Min,-30]",Fortemente decrescente,56,Centro,COIMBRA,0608,12403.38,11832,727,729,659,550,466,1016,1675,2404,3131,95.4,25.24,19.38,13.5
03-12-2020,MIRANDA DO CORVO,122,9,960,"[960,Max]",Extremamente Elevado,-338.0,"[Min,-30]",Fortemente decrescente,122,Centro,COIMBRA,0609,12637.79,12708,706,659,568,498,404,902,1470,2129,2835,100.55,22.43,16.85,11.63
03-12-2020,MIRANDA DO DOURO,61,4,893,"[480,960]",Muito Elevado,176.0,"[30,Max]",Fortemente crescente,61,Norte,BRAGANÇA,0406,48718.31,6830,482,429,442,463,470,933,1375,1804,2286,14.02,4.69,3.7,2.82
03-12-2020,MIRANDELA,136,10,625,"[480,960]",Muito Elevado,92.0,"[30,Max]",Fortemente crescente,136,Norte,BRAGANÇA,0407,65895.67,21754,1640,1315,1204,1078,947,2025,3229,4544,6184,33.01,9.38,6.9,4.9
03-12-2020,MOGADOURO,25,2,298,"[240,480]",Elevado,-214.0,"[Min,-30]",Fortemente decrescente,25,Norte,BRAGANÇA,0408,76064.93,8392,589,529,576,630,655,1285,1861,2390,2979,11.03,3.92,3.14,2.45
03-12-2020,MOIMENTA DA BEIRA,16,1,164,"[0,240]",Moderado,20.0,"[10,30]",Crescente,16,Norte,VISEU,1807,21996.9,9736,576,514,471,416,461,877,1348,1862,2438,44.26,11.08,8.46,6.13
03-12-2020,MOITA,280,20,435,"[240,480]",Elevado,27.0,"[10,30]",Crescente,280,Lisboa e Vale do Tejo,SETÚBAL,1506,5525.98,64407,4226,3646,2623,1801,1425,3226,5849,9495,13721,1165.53,248.3,171.82,105.85
03-12-2020,MONÇÃO,73,5,409,"[240,480]",Elevado,-39.0,"[Min,-30]",Fortemente decrescente,73,Norte,VIANA DO CASTELO,1604,21130.85,17869,1161,1105,1031,1006,972,1978,3009,4114,5275,84.56,24.96,19.47,14.24
03-12-2020,MONCHIQUE,13,1,256,"[240,480]",Elevado,-99.0,"[Min,-30]",Fortemente decrescente,13,Algarve,FARO,0809,39530.43,5077,353,384,321,355,392,747,1068,1452,1805,12.84,4.57,3.67,2.7
03-12-2020,MONDIM DE BASTO,141,10,2030,"[960,Max]",Extremamente Elevado,490.0,"[30,Max]",Fortemente crescente,141,Norte,VILA REAL,1705,17207.52,6946,395,300,314,284,283,567,881,1181,1576,40.36,9.16,6.86,5.12
03-12-2020,MONFORTE,4,0,134,"[0,240]",Moderado,-135.0,"[Min,-30]",Fortemente decrescente,4,Alentejo,PORTALEGRE,1211,42024.82,2975,139,115,117,192,168,360,477,592,731,7.08,1.74,1.41,1.14
03-12-2020,MONTALEGRE,42,3,467,"[240,480]",Elevado,-78.0,"[Min,-30]",Fortemente decrescente,42,Norte,VILA REAL,1706,80545.71,8997,699,628,595,603,730,1333,1928,2556,3255,11.17,4.04,3.17,2.39
03-12-2020,MONTEMOR-O-NOVO,67,5,428,"[240,480]",Elevado,76.0,"[30,Max]",Fortemente crescente,67,Alentejo,ÉVORA,0706,123296.65,15647,991,953,868,878,971,1849,2717,3670,4661,12.69,3.78,2.98,2.2
03-12-2020,MONTEMOR-O-VELHO,115,8,456,"[240,480]",Elevado,0.0,"[-10,10]",Estável,115,Centro,COIMBRA,0610,22896.23,25224,1496,1397,1217,1057,988,2045,3262,4659,6155,110.17,26.88,20.35,14.25
03-12-2020,MONTIJO,225,16,391,"[240,480]",Elevado,-1.0,"[-10,10]",Estável,225,Lisboa e Vale do Tejo,SETÚBAL,1507,34861.64,57614,2771,2441,1990,1554,1109,2663,4653,7094,9865,165.26,28.3,20.35,13.35
03-12-2020,MORA,7,0,169,"[0,240]",Moderado,-387.0,"[Min,-30]",Fortemente decrescente,7,Alentejo,ÉVORA,0707,44395.02,4138,336,275,252,238,257,495,747,1022,1358,9.32,3.06,2.3,1.68
03-12-2020,MORTÁGUA,45,3,511,"[480,960]",Muito Elevado,182.0,"[30,Max]",Fortemente crescente,45,Centro,VISEU,1808,25117.82,8803,638,584,535,499,460,959,1494,2078,2716,35.05,10.81,8.27,5.95
03-12-2020,MOURA,5,0,36,"[0,240]",Moderado,-22.0,"[-30,-10]",Decrescente,5,Alentejo,BEJA,0210,95845.55,13718,817,656,665,542,461,1003,1668,2324,3141,14.31,3.28,2.42,1.74
03-12-2020,MOURÃO,17,1,694,"[480,960]",Muito Elevado,367.0,"[30,Max]",Fortemente crescente,17,Alentejo,ÉVORA,0708,27862.98,2450,139,108,80,104,109,213,293,401,540,8.79,1.94,1.44,1.05
03-12-2020,MURÇA,40,3,732,"[480,960]",Muito Elevado,-73.0,"[Min,-30]",Fortemente decrescente,40,Norte,VILA REAL,1707,18937.11,5463,384,341,307,306,319,625,932,1273,1657,28.85,8.75,6.72,4.92
03-12-2020,MURTOSA,67,5,652,"[480,960]",Muito Elevado,-301.0,"[Min,-30]",Fortemente decrescente,67,Centro,AVEIRO,0112,7308.78,10279,509,473,403,353,409,762,1165,1638,2147,140.63,29.37,22.41,15.94
03-12-2020,NAZARÉ,32,2,226,"[0,240]",Moderado,-247.0,"[Min,-30]",Fortemente decrescente,32,Lisboa e Vale do Tejo,LEIRIA,1011,8243.43,14165,967,903,670,420,396,816,1486,2389,3356,171.84,40.71,28.98,18.03
03-12-2020,NELAS,44,3,339,"[240,480]",Elevado,169.0,"[30,Max]",Fortemente crescente,44,Centro,VISEU,1809,12571.48,12974,924,787,668,604,583,1187,1855,2642,3566,103.21,28.37,21.02,14.76
03-12-2020,NISA,64,5,1056,"[960,Max]",Extremamente Elevado,248.0,"[30,Max]",Fortemente crescente,64,Alentejo,PORTALEGRE,1212,57567.84,6061,405,389,355,483,478,961,1316,1705,2110,10.53,3.67,2.96,2.29
03-12-2020,NORDESTE,2,0,41,"[0,240]",Moderado,20.0,"[10,30]",Crescente,2,Açores,AÇORES,4202,10146.8,4862,246,180,124,161,162,323,447,627,873,47.92,8.6,6.18,4.41
03-12-2020,ÓBIDOS,20,1,169,"[0,240]",Moderado,-59.0,"[Min,-30]",Fortemente decrescente,20,Lisboa e Vale do Tejo,LEIRIA,1012,14155.44,11850,743,650,574,452,436,888,1462,2112,2855,83.72,20.17,14.92,10.33
03-12-2020,ODEMIRA,109,8,441,"[240,480]",Elevado,137.0,"[30,Max]",Fortemente crescente,109,Alentejo,BEJA,0211,172060.15,24717,1475,1317,1225,1397,1349,2746,3971,5288,6763,14.37,3.93,3.07,2.31
03-12-2020,ODIVELAS,726,52,449,"[240,480]",Elevado,-80.0,"[Min,-30]",Fortemente decrescente,726,Lisboa e Vale do Tejo,LISBOA,1116,2654.36,161774,9562,9038,6952,4641,3812,8453,15405,24443,34005,6095.48,1281.27,920.99,580.44
03-12-2020,OEIRAS,633,45,357,"[240,480]",Elevado,-45.0,"[Min,-30]",Fortemente decrescente,633,Lisboa e Vale do Tejo,LISBOA,1110,4588.31,177408,11580,11575,8566,6211,5855,12066,20632,32207,43787,3866.78,954.38,701.98,449.69
03-12-2020,OLEIROS,17,1,340,"[240,480]",Elevado,-340.0,"[Min,-30]",Fortemente decrescente,17,Centro,CASTELO BRANCO,0506,47109.31,5003,384,341,366,397,487,884,1250,1591,1975,10.62,4.19,3.38,2.65
03-12-2020,OLHÃO,76,5,171,"[0,240]",Moderado,-5.0,"[-10,10]",Estável,76,Algarve,FARO,0810,13086.38,44405,2455,2309,1689,1342,1268,2610,4299,6608,9063,339.33,69.26,50.5,32.85
03-12-2020,OLIVEIRA DE AZEMÉIS,611,44,926,"[480,960]",Muito Elevado,-393.0,"[Min,-30]",Fortemente decrescente,611,Norte,AVEIRO,0113,16110.41,66011,4155,3614,2794,2183,1738,3921,6715,10329,14484,409.75,89.91,64.12,41.68
03-12-2020,OLIVEIRA DE FRADES,12,1,121,"[0,240]",Moderado,-282.0,"[Min,-30]",Fortemente decrescente,12,Centro,VISEU,1810,14534.62,9936,553,475,438,359,415,774,1212,1687,2240,68.36,15.41,11.61,8.34
03-12-2020,OLIVEIRA DO BAIRRO,154,11,634,"[480,960]",Muito Elevado,-70.0,"[Min,-30]",Fortemente decrescente,154,Centro,AVEIRO,0114,8731.99,24277,1327,1182,999,786,810,1596,2595,3777,5104,278.02,58.45,43.25,29.72
03-12-2020,OLIVEIRA DO HOSPITAL,47,3,244,"[240,480]",Elevado,99.0,"[30,Max]",Fortemente crescente,47,Centro,COIMBRA,0611,23451.66,19253,1161,1097,962,924,960,1884,2846,3943,5104,82.1,21.76,16.81,12.14
03-12-2020,OURÉM,168,12,381,"[240,480]",Elevado,-171.0,"[Min,-30]",Fortemente decrescente,168,Lisboa e Vale do Tejo,SANTARÉM,1421,41668.03,44044,2463,2069,1899,1817,1603,3420,5319,7388,9851,105.7,23.64,17.73,12.77
03-12-2020,OURIQUE,6,0,130,"[0,240]",Moderado,65.0,"[30,Max]",Fortemente crescente,6,Alentejo,BEJA,0212,66331.36,4607,313,287,284,268,227,495,779,1066,1379,6.95,2.08,1.61,1.17
03-12-2020,OVAR,473,34,872,"[480,960]",Muito Elevado,-142.0,"[Min,-30]",Fortemente decrescente,473,Centro,AVEIRO,0115,14770.25,54260,3294,2709,1994,1636,1234,2870,4864,7573,10867,367.37,73.57,51.27,32.93
03-12-2020,PAÇOS DE FERREIRA,628,45,1107,"[960,Max]",Extremamente Elevado,-878.0,"[Min,-30]",Fortemente decrescente,628,Norte,PORTO,1309,7099.29,56728,2903,2193,1518,1135,664,1799,3317,5510,8413,799.1,118.51,77.62,46.72
03-12-2020,PALMELA,198,14,308,"[240,480]",Elevado,-48.0,"[Min,-30]",Fortemente decrescente,198,Lisboa e Vale do Tejo,SETÚBAL,1508,46512.01,64269,3402,3244,2635,1846,1391,3237,5872,9116,12518,138.18,26.91,19.6,12.62
03-12-2020,PAMPILHOSA DA SERRA,32,2,793,"[480,960]",Muito Elevado,198.0,"[30,Max]",Fortemente crescente,32,Centro,COIMBRA,0612,39646.24,4037,238,254,295,339,423,762,1057,1311,1549,10.18,3.91,3.31,2.67
03-12-2020,PAREDES,926,66,1076,"[960,Max]",Extremamente Elevado,-477.0,"[Min,-30]",Fortemente decrescente,926,Norte,PORTO,1310,15675.69,86067,4272,3532,2412,1717,1258,2975,5387,8919,13191,549.04,84.15,56.9,34.36
03-12-2020,PAREDES DE COURA,20,1,234,"[0,240]",Moderado,-47.0,"[Min,-30]",Fortemente decrescente,20,Norte,VIANA DO CASTELO,1605,13818.59,8535,466,528,407,465,515,980,1387,1915,2381,61.76,17.23,13.86,10.04
03-12-2020,PEDRÓGÃO GRANDE,4,0,117,"[0,240]",Moderado,58.0,"[30,Max]",Fortemente crescente,4,Centro,LEIRIA,1013,12874.75,3410,175,173,196,221,252,473,669,842,1017,26.49,7.9,6.54,5.2
03-12-2020,PENACOVA,88,6,643,"[480,960]",Muito Elevado,88.0,"[30,Max]",Fortemente crescente,88,Centro,COIMBRA,0613,21673.23,13694,968,923,745,621,703,1324,2069,2992,3960,63.18,18.27,13.81,9.55
03-12-2020,PENAFIEL,803,57,1151,"[960,Max]",Extremamente Elevado,-709.0,"[Min,-30]",Fortemente decrescente,803,Norte,PORTO,1311,21224.27,69772,3648,2823,2032,1663,1230,2893,4925,7748,11396,328.74,53.69,36.51,23.2
03-12-2020,PENALVA DO CASTELO,34,2,478,"[240,480]",Elevado,14.0,"[10,30]",Crescente,34,Centro,VISEU,1811,13433.92,7115,449,457,413,391,426,817,1230,1687,2136,52.96,15.9,12.56,9.16
03-12-2020,PENAMACOR,14,1,294,"[240,480]",Elevado,-127.0,"[Min,-30]",Fortemente decrescente,14,Centro,CASTELO BRANCO,0507,56370.69,4755,262,248,273,451,633,1084,1357,1605,1867,8.44,3.31,2.85,2.41
03-12-2020,PENEDONO,10,1,386,"[240,480]",Elevado,-77.0,"[Min,-30]",Fortemente decrescente,10,Norte,VISEU,1812,13370.75,2591,172,113,129,156,138,294,423,536,708,19.38,5.3,4.01,3.16
03-12-2020,PENELA,22,2,408,"[240,480]",Elevado,-129.0,"[Min,-30]",Fortemente decrescente,22,Centro,COIMBRA,0614,13480.0,5397,314,324,274,359,344,703,977,1301,1615,40.04,11.98,9.65,7.25
03-12-2020,PENICHE,102,7,385,"[240,480]",Elevado,-94.0,"[Min,-30]",Fortemente decrescente,102,Lisboa e Vale do Tejo,LEIRIA,1014,7754.98,26501,1746,1504,1203,926,707,1633,2836,4340,6086,341.73,78.48,55.96,36.57
03-12-2020,PESO DA RÉGUA,46,3,292,"[240,480]",Elevado,13.0,"[10,30]",Crescente,46,Norte,VILA REAL,1708,9486.01,15773,1076,843,650,659,455,1114,1764,2607,3683,166.28,38.83,27.48,18.6
03-12-2020,PINHEL,21,2,247,"[240,480]",Elevado,153.0,"[30,Max]",Fortemente crescente,21,Centro,GUARDA,0910,48452.12,8511,577,566,551,538,689,1227,1778,2344,2921,17.57,6.03,4.84,3.67
03-12-2020,POMBAL,174,12,338,"[240,480]",Elevado,-255.0,"[Min,-30]",Fortemente decrescente,174,Centro,LEIRIA,1015,62600.28,51461,3187,2791,2494,2328,2027,4355,6849,9640,12827,82.21,20.49,15.4,10.94
03-12-2020,PONTA DELGADA,123,9,181,"[0,240]",Moderado,-47.0,"[Min,-30]",Fortemente decrescente,123,Açores,AÇORES,4203,23298.65,67935,3108,2435,1726,1133,902,2035,3761,6196,9304,291.58,39.93,26.59,16.14
03-12-2020,PONTA DO SOL,3,0,35,"[0,240]",Moderado,0.0,"[-10,10]",Estável,3,Madeira,MADEIRA,3105,4622.03,8593,319,283,347,208,221,429,776,1059,1378,185.92,29.81,22.91,16.79
03-12-2020,PONTE DA BARCA,59,4,528,"[480,960]",Muito Elevado,-18.0,"[-30,-10]",Decrescente,59,Norte,VIANA DO CASTELO,1606,18211.37,11180,635,576,517,554,490,1044,1561,2137,2772,61.39,15.22,11.73,8.57
03-12-2020,PONTE DE LIMA,265,19,641,"[480,960]",Muito Elevado,-177.0,"[Min,-30]",Fortemente decrescente,265,Norte,VIANA DO CASTELO,1607,32025.46,41315,2321,2022,1720,1596,1462,3058,4778,6800,9121,129.01,28.48,21.23,14.92
03-12-2020,PONTE DE SOR,13,1,87,"[0,240]",Moderado,-73.0,"[Min,-30]",Fortemente decrescente,13,Alentejo,PORTALEGRE,1213,83971.16,14994,939,800,716,739,831,1570,2286,3086,4025,17.86,4.79,3.68,2.72
03-12-2020,PORTALEGRE,266,19,1200,"[960,Max]",Extremamente Elevado,-338.0,"[Min,-30]",Fortemente decrescente,266,Alentejo,PORTALEGRE,1214,44713.64,22172,1577,1351,1137,993,984,1977,3114,4465,6042,49.59,13.51,9.99,6.96
03-12-2020,PORTEL,2,0,34,"[0,240]",Moderado,34.0,"[30,Max]",Fortemente crescente,2,Alentejo,ÉVORA,0709,60100.57,5828,336,358,283,331,305,636,919,1277,1613,9.7,2.68,2.12,1.53
03-12-2020,PORTIMÃO,182,13,328,"[240,480]",Elevado,-81.0,"[Min,-30]",Fortemente decrescente,182,Algarve,FARO,0811,18206.29,55483,3182,2927,2116,1582,1400,2982,5098,8025,11207,304.75,61.56,44.08,28.0
03-12-2020,PORTO,1657,118,765,"[480,960]",Muito Elevado,-250.0,"[Min,-30]",Fortemente decrescente,1656,Norte,PORTO,1312,4142.02,216606,15790,15193,11280,9409,10044,19453,30733,45926,61716,5229.5,1490.0,1108.79,741.98
03-12-2020,PORTO DE MÓS,54,4,232,"[0,240]",Moderado,-60.0,"[Min,-30]",Fortemente decrescente,54,Centro,LEIRIA,1016,26183.41,23275,1355,1210,1034,888,872,1760,2794,4004,5359,88.89,20.47,15.29,10.67
03-12-2020,PORTO MONIZ,2,0,85,"[0,240]",Moderado,42.0,"[30,Max]",Fortemente crescente,2,Madeira,MADEIRA,3106,8293.38,2342,143,130,95,98,120,218,313,443,586,28.24,7.07,5.34,3.77
03-12-2020,PORTO SANTO,0,0,0,"[0,240]",Moderado,0.0,"[-10,10]",Estável,0,Madeira,MADEIRA,3201,4300.7,5202,240,157,134,110,68,178,312,469,709,120.95,16.48,10.9,7.25
03-12-2020,PÓVOA DE LANHOSO,349,25,1623,"[960,Max]",Extremamente Elevado,-219.0,"[Min,-30]",Fortemente decrescente,349,Norte,BRAGA,0309,13465.29,21499,1175,909,732,673,624,1297,2029,2938,4113,159.67,30.55,21.82,15.07
03-12-2020,PÓVOA DE VARZIM,1017,73,1620,"[960,Max]",Extremamente Elevado,-342.0,"[Min,-30]",Fortemente decrescente,1017,Norte,PORTO,1313,8220.59,62784,3712,3120,2134,1594,1305,2899,5033,8153,11865,763.7,144.33,99.17,61.22
03-12-2020,POVOAÇÃO,34,2,574,"[480,960]",Muito Elevado,304.0,"[30,Max]",Fortemente crescente,34,Açores,AÇORES,4204,10640.77,5927,293,212,191,144,134,278,469,681,974,55.7,9.15,6.4,4.41
03-12-2020,VILA DA PRAIA DA VITÓRIA,35,2,164,"[0,240]",Moderado,-10.0,"[-10,10]",Estável,35,Açores,AÇORES,4302,16127.06,21317,1133,789,619,436,336,772,1391,2180,3313,132.18,20.54,13.52,8.63
03-12-2020,PROENÇA-A-NOVA,13,1,178,"[0,240]",Moderado,-192.0,"[Min,-30]",Fortemente decrescente,13,Centro,CASTELO BRANCO,0508,39539.96,7298,508,465,389,400,560,960,1349,1814,2322,18.46,5.87,4.59,3.41
03-12-2020,REDONDO,14,1,220,"[0,240]",Moderado,-79.0,"[Min,-30]",Fortemente decrescente,14,Alentejo,ÉVORA,0710,36950.87,6353,349,325,288,288,354,642,930,1255,1604,17.19,4.34,3.4,2.52
03-12-2020,REGUENGOS DE MONSARAZ,38,3,379,"[240,480]",Elevado,-260.0,"[Min,-30]",Fortemente decrescente,38,Alentejo,ÉVORA,0711,46399.72,10015,602,511,455,462,473,935,1390,1901,2503,21.58,5.39,4.1,3.0
03-12-2020,RESENDE,43,3,424,"[240,480]",Elevado,-99.0,"[Min,-30]",Fortemente decrescente,43,Norte,VISEU,1813,12334.93,10137,560,493,448,433,422,855,1303,1796,2356,82.18,19.1,14.56,10.56
03-12-2020,RIBEIRA BRAVA,1,0,8,"[0,240]",Moderado,-16.0,"[-30,-10]",Decrescente,1,Madeira,MADEIRA,3107,6544.88,12435,648,500,411,311,287,598,1009,1509,2157,189.99,32.96,23.06,15.42
03-12-2020,RIBEIRA DE PENA,6,0,100,"[0,240]",Moderado,-133.0,"[Min,-30]",Fortemente decrescente,6,Norte,VILA REAL,1709,21745.98,6016,371,301,290,310,368,678,968,1269,1640,27.66,7.54,5.84,4.45
03-12-2020,RIBEIRA GRANDE,98,7,299,"[240,480]",Elevado,165.0,"[30,Max]",Fortemente crescente,98,Açores,AÇORES,4205,18015.13,32811,1163,689,512,345,253,598,1110,1799,2962,182.13,16.44,9.99,6.16
03-12-2020,RIO MAIOR,144,10,707,"[480,960]",Muito Elevado,285.0,"[30,Max]",Fortemente crescente,144,Lisboa e Vale do Tejo,SANTARÉM,1414,27276.45,20379,1251,1144,941,795,648,1443,2384,3528,4779,74.71,17.52,12.93,8.74
03-12-2020,SABROSA,17,1,287,"[240,480]",Elevado,-17.0,"[-30,-10]",Decrescente,17,Norte,VILA REAL,1710,15692.45,5918,393,314,304,302,350,652,956,1270,1663,37.71,10.6,8.09,6.09
03-12-2020,SABUGAL,65,5,614,"[480,960]",Muito Elevado,-255.0,"[Min,-30]",Fortemente decrescente,65,Centro,GUARDA,0911,82269.82,10585,724,707,694,796,1009,1805,2499,3206,3930,12.87,4.78,3.9,3.04
03-12-2020,SALVATERRA DE MAGOS,45,3,211,"[0,240]",Moderado,-160.0,"[Min,-30]",Fortemente decrescente,45,Lisboa e Vale do Tejo,SANTARÉM,1415,24393.2,21295,1275,1181,1060,799,772,1571,2631,3812,5087,87.3,20.85,15.63,10.79
03-12-2020,SANTA COMBA DÃO,25,2,239,"[0,240]",Moderado,48.0,"[30,Max]",Fortemente crescente,25,Centro,VISEU,1814,11194.77,10452,732,684,569,538,464,1002,1571,2255,2987,93.36,26.68,20.14,14.03
03-12-2020,SANTA CRUZ,36,3,80,"[0,240]",Moderado,-24.0,"[-30,-10]",Decrescente,36,Madeira,MADEIRA,3108,8150.28,45281,1817,1301,974,716,523,1239,2213,3514,5331,555.6,65.41,43.12,27.15
03-12-2020,SANTA CRUZ DA GRACIOSA,3,0,71,"[0,240]",Moderado,23.0,"[10,30]",Crescente,3,Açores,AÇORES,4401,6065.78,4208,228,180,163,124,145,269,432,612,840,69.37,13.85,10.09,7.12
03-12-2020,SANTA CRUZ DAS FLORES,0,0,0,"[0,240]",Moderado,-92.0,"[Min,-30]",Fortemente decrescente,0,Açores,AÇORES,4802,7091.44,2165,125,98,74,56,51,107,181,279,404,30.53,5.7,3.93,2.55
03-12-2020,SANTA MARIA DA FEIRA,1711,122,1234,"[960,Max]",Extremamente Elevado,-341.0,"[Min,-30]",Fortemente decrescente,1711,Norte,AVEIRO,0109,21587.65,138636,8182,6743,4771,3856,3079,6935,11706,18449,26631,642.19,123.36,85.46,54.22
03-12-2020,SANTA MARTA DE PENAGUIÃO,28,2,424,"[240,480]",Elevado,-243.0,"[Min,-30]",Fortemente decrescente,28,Norte,VILA REAL,1711,6928.13,6599,483,373,337,316,317,633,970,1343,1826,95.25,26.36,19.39,14.0
03-12-2020,SANTANA,4,0,60,"[0,240]",Moderado,15.0,"[10,30]",Crescente,4,Madeira,MADEIRA,3109,9547.3,6711,418,353,343,282,277,559,902,1255,1673,70.29,17.52,13.15,9.45
03-12-2020,SANTARÉM,228,16,397,"[240,480]",Elevado,-106.0,"[Min,-30]",Fortemente decrescente,228,Lisboa e Vale do Tejo,SANTARÉM,1416,55253.58,57421,3654,3441,2760,2466,2206,4672,7432,10873,14527,103.92,26.29,19.68,13.45
03-12-2020,SANTIAGO DO CACÉM,41,3,142,"[0,240]",Moderado,0.0,"[-10,10]",Estável,41,Alentejo,SETÚBAL,1509,105969.29,28791,2144,1689,1472,1295,1215,2510,3982,5671,7815,27.17,7.37,5.35,3.76
03-12-2020,SANTO TIRSO,768,55,1128,"[960,Max]",Extremamente Elevado,-637.0,"[Min,-30]",Fortemente decrescente,768,Norte,PORTO,1314,13655.52,68055,4911,3935,2761,2257,1810,4067,6828,10763,15674,498.35,114.78,78.82,50.0
03-12-2020,SÃO BRÁS DE ALPORTEL,11,1,106,"[0,240]",Moderado,-38.0,"[Min,-30]",Fortemente decrescente,11,Algarve,FARO,0812,15336.92,10416,596,468,467,404,401,805,1272,1740,2336,67.91,15.23,11.35,8.29
03-12-2020,SÃO JOÃO DA MADEIRA,222,16,1011,"[960,Max]",Extremamente Elevado,-496.0,"[Min,-30]",Fortemente decrescente,222,Norte,AVEIRO,0116,794.3,21958,1347,1069,796,601,593,1194,1990,3059,4406,2765.49,554.91,385.26,250.63
03-12-2020,SÃO JOÃO DA PESQUEIRA,11,1,154,"[0,240]",Moderado,-183.0,"[Min,-30]",Fortemente decrescente,11,Norte,VISEU,1815,26610.85,7125,417,330,294,328,328,656,950,1280,1697,26.77,6.38,4.81,3.57
03-12-2020,SÃO PEDRO DO SUL,46,3,299,"[240,480]",Elevado,-129.0,"[Min,-30]",Fortemente decrescente,46,Centro,VISEU,1816,34895.09,15403,990,962,861,759,909,1668,2529,3491,4481,44.14,12.84,10.0,7.25
03-12-2020,SÃO ROQUE DO PICO,0,0,0,"[0,240]",Moderado,-31.0,"[Min,-30]",Fortemente decrescente,0,Açores,AÇORES,4603,14236.1,3266,199,141,93,96,113,209,302,443,642,22.94,4.51,3.11,2.12
03-12-2020,SÃO VICENTE,2,0,39,"[0,240]",Moderado,20.0,"[10,30]",Crescente,2,Madeira,MADEIRA,3110,7883.71,5143,272,264,266,225,280,505,771,1035,1307,65.23,16.58,13.13,9.78
03-12-2020,SARDOAL,19,1,508,"[480,960]",Muito Elevado,-321.0,"[Min,-30]",Fortemente decrescente,19,Lisboa e Vale do Tejo,SANTARÉM,1417,9214.72,3741,227,178,148,165,248,413,561,739,966,40.6,10.48,8.02,6.09
03-12-2020,SÁTÃO,78,6,674,"[480,960]",Muito Elevado,-155.0,"[Min,-30]",Fortemente decrescente,78,Centro,VISEU,1817,20194.11,11580,765,671,515,465,476,941,1456,2127,2892,57.34,14.32,10.53,7.21
03-12-2020,SEIA,170,12,765,"[480,960]",Muito Elevado,72.0,"[30,Max]",Fortemente crescente,170,Centro,GUARDA,0912,43568.83,22234,1807,1589,1238,1122,721,1843,3081,4670,6477,51.03,14.87,10.72,7.07
03-12-2020,SEIXAL,763,55,455,"[240,480]",Elevado,-94.0,"[Min,-30]",Fortemente decrescente,764,Lisboa e Vale do Tejo,SETÚBAL,1510,9545.17,167752,10586,9270,6661,4391,2930,7321,13982,23252,33838,1757.49,354.51,243.6,146.49
03-12-2020,SERNANCELHE,4,0,74,"[0,240]",Moderado,18.0,"[10,30]",Crescente,4,Norte,VISEU,1818,22861.22,5396,305,293,286,273,260,533,819,1112,1417,23.6,6.2,4.86,3.58
03-12-2020,SERPA,69,5,482,"[480,960]",Muito Elevado,35.0,"[30,Max]",Fortemente crescente,69,Alentejo,BEJA,0213,110563.34,14304,903,761,719,697,626,1323,2042,2803,3706,12.94,3.35,2.54,1.85
03-12-2020,SERTÃ,31,2,213,"[0,240]",Moderado,110.0,"[30,Max]",Fortemente crescente,31,Centro,CASTELO BRANCO,0509,44673.17,14577,870,779,790,767,1020,1787,2577,3356,4226,32.63,9.46,7.51,5.77
03-12-2020,SESIMBRA,178,13,343,"[240,480]",Elevado,-45.0,"[Min,-30]",Fortemente decrescente,178,Lisboa e Vale do Tejo,SETÚBAL,1511,19571.75,51858,2400,2321,1853,1257,1083,2340,4193,6514,8914,264.96,45.54,33.28,21.42
03-12-2020,SETÚBAL,538,38,467,"[240,480]",Elevado,-36.0,"[Min,-30]",Fortemente decrescente,538,Lisboa e Vale do Tejo,SETÚBAL,1512,23032.5,115126,7425,6929,5075,3775,2655,6430,11505,18434,25859,499.83,112.27,80.03,49.95
03-12-2020,SEVER DO VOUGA,38,3,335,"[240,480]",Elevado,-115.0,"[Min,-30]",Fortemente decrescente,38,Centro,AVEIRO,0117,12987.56,11331,766,637,568,540,567,1107,1675,2312,3078,87.24,23.7,17.8,12.9
03-12-2020,SILVES,77,6,213,"[0,240]",Moderado,34.0,"[30,Max]",Fortemente crescente,77,Algarve,FARO,0813,68006.23,36226,2137,1869,1610,1423,1600,3023,4633,6502,8639,53.27,12.7,9.56,6.81
03-12-2020,SINES,58,4,423,"[240,480]",Elevado,-138.0,"[Min,-30]",Fortemente decrescente,58,Alentejo,SETÚBAL,1513,20330.17,13715,888,791,551,416,268,684,1235,2026,2914,67.46,14.33,9.97,6.07
03-12-2020,SINTRA,1800,129,460,"[240,480]",Elevado,-69.0,"[Min,-30]",Fortemente decrescente,1802,Lisboa e Vale do Tejo,LISBOA,1111,31922.73,391402,20490,18316,13545,9137,7284,16421,29966,48282,68772,1226.08,215.43,151.25,93.87
03-12-2020,SOBRAL DE MONTE AGRAÇO,42,3,394,"[240,480]",Elevado,-47.0,"[Min,-30]",Fortemente decrescente,42,Lisboa e Vale do Tejo,LISBOA,1112,5210.32,10651,564,507,352,272,212,484,836,1343,1907,204.43,36.6,25.78,16.05
03-12-2020,SOURE,96,7,561,"[480,960]",Muito Elevado,146.0,"[30,Max]",Fortemente crescente,96,Centro,COIMBRA,0615,26506.07,17120,1173,1142,1004,883,987,1870,2874,4016,5189,64.59,19.58,15.15,10.84
03-12-2020,SOUSEL,3,0,68,"[0,240]",Moderado,0.0,"[-10,10]",Estável,3,Alentejo,PORTALEGRE,1215,27932.18,4412,261,274,208,302,292,594,802,1076,1337,15.8,4.79,3.85,2.87
03-12-2020,TÁBUA,18,1,158,"[0,240]",Moderado,-71.0,"[Min,-30]",Fortemente decrescente,18,Centro,COIMBRA,0616,19978.58,11368,729,584,524,430,464,894,1418,2002,2731,56.9,13.67,10.02,7.1
03-12-2020,TABUAÇO,5,0,83,"[0,240]",Moderado,-132.0,"[Min,-30]",Fortemente decrescente,5,Norte,VISEU,1819,13385.67,6033,372,314,217,282,363,645,862,1176,1548,45.07,11.56,8.79,6.44
03-12-2020,TAROUCA,39,3,500,"[480,960]",Muito Elevado,-115.0,"[Min,-30]",Fortemente decrescente,39,Norte,VISEU,1820,10008.49,7804,405,335,313,277,324,601,914,1249,1654,77.98,16.53,12.48,9.13
03-12-2020,TAVIRA,43,3,175,"[0,240]",Moderado,-66.0,"[Min,-30]",Fortemente decrescente,43,Algarve,FARO,0814,60696.7,24530,1493,1415,1252,1066,1277,2343,3595,5010,6503,40.41,10.71,8.25,5.92
03-12-2020,TERRAS DE BOURO,29,2,456,"[240,480]",Elevado,63.0,"[30,Max]",Fortemente crescente,29,Norte,BRAGA,0310,27746.07,6361,391,372,296,319,340,659,955,1327,1718,22.93,6.19,4.78,3.44
03-12-2020,TOMAR,94,7,256,"[240,480]",Elevado,-65.0,"[Min,-30]",Fortemente decrescente,94,Lisboa e Vale do Tejo,SANTARÉM,1418,35120.44,36748,2403,2189,1868,1853,1822,3675,5543,7732,10135,104.64,28.86,22.02,15.78
03-12-2020,TONDELA,54,4,205,"[0,240]",Moderado,-30.0,"[-30,-10]",Decrescente,54,Centro,VISEU,1821,37121.73,26357,1768,1722,1518,1475,1417,2892,4410,6132,7900,71.0,21.28,16.52,11.88
03-12-2020,TORRE DE MONCORVO,57,4,741,"[480,960]",Muito Elevado,195.0,"[30,Max]",Fortemente crescente,57,Norte,BRAGANÇA,0409,53155.67,7695,556,478,488,551,719,1270,1758,2236,2792,14.48,5.25,4.21,3.31
03-12-2020,TORRES NOVAS,112,8,321,"[240,480]",Elevado,-94.0,"[Min,-30]",Fortemente decrescente,112,Lisboa e Vale do Tejo,SANTARÉM,1419,26999.68,34933,2324,1979,1738,1406,1475,2881,4619,6598,8922,129.38,33.04,24.44,17.11
03-12-2020,TORRES VEDRAS,404,29,514,"[480,960]",Muito Elevado,24.0,"[10,30]",Crescente,404,Lisboa e Vale do Tejo,LISBOA,1113,40714.89,78530,4513,3945,3447,2628,2104,4732,8179,12124,16637,192.88,40.86,29.78,20.09
03-12-2020,TRANCOSO,26,2,293,"[240,480]",Elevado,-135.0,"[Min,-30]",Fortemente decrescente,26,Centro,GUARDA,0913,36152.47,8875,581,557,542,586,496,1082,1624,2181,2762,24.55,7.64,6.03,4.49
03-12-2020,TROFA,710,51,1848,"[960,Max]",Extremamente Elevado,-112.0,"[Min,-30]",Fortemente decrescente,710,Norte,PORTO,1318,7201.76,38418,2336,1894,1231,939,684,1623,2854,4748,7084,533.44,98.36,65.93,39.63
03-12-2020,VAGOS,71,5,312,"[240,480]",Elevado,-264.0,"[Min,-30]",Fortemente decrescente,71,Centro,AVEIRO,0118,16491.5,22740,1320,1205,922,784,724,1508,2430,3635,4955,137.89,30.04,22.04,14.73
03-12-2020,VALE DE CAMBRA,185,13,867,"[480,960]",Muito Elevado,-343.0,"[Min,-30]",Fortemente decrescente,185,Norte,AVEIRO,0119,14733.47,21327,1491,1363,1005,831,798,1629,2634,3997,5488,144.76,37.25,27.13,17.88
03-12-2020,VALENÇA,128,9,963,"[960,Max]",Extremamente Elevado,-452.0,"[Min,-30]",Fortemente decrescente,128,Norte,VIANA DO CASTELO,1608,11712.86,13290,867,791,582,582,503,1085,1667,2458,3325,113.46,28.39,20.99,14.23
03-12-2020,VALONGO,907,65,931,"[480,960]",Muito Elevado,-355.0,"[Min,-30]",Fortemente decrescente,907,Norte,PORTO,1315,7512.45,97444,5629,4696,3207,2462,1829,4291,7498,12194,17823,1297.18,237.26,162.33,99.81
03-12-2020,VALPAÇOS,161,12,1087,"[960,Max]",Extremamente Elevado,203.0,"[30,Max]",Fortemente crescente,161,Norte,VILA REAL,1712,54873.93,14818,1217,1118,999,928,997,1925,2924,4042,5259,27.0,9.58,7.37,5.33
03-12-2020,VELAS,1,0,20,"[0,240]",Moderado,-19.0,"[-30,-10]",Decrescente,1,Açores,AÇORES,4502,11738.38,5093,278,208,166,153,113,266,432,640,918,43.39,7.82,5.45,3.68
03-12-2020,VENDAS NOVAS,5,0,44,"[0,240]",Moderado,-9.0,"[-10,10]",Estável,5,Alentejo,ÉVORA,0712,22238.88,11255,677,768,655,501,532,1033,1688,2456,3133,50.61,14.09,11.04,7.59
03-12-2020,VIANA DO ALENTEJO,4,0,78,"[0,240]",Moderado,-155.0,"[Min,-30]",Fortemente decrescente,4,Alentejo,ÉVORA,0713,39367.29,5145,245,208,235,210,214,424,659,867,1112,13.07,2.82,2.2,1.67
03-12-2020,VIANA DO CASTELO,510,36,604,"[480,960]",Muito Elevado,29.0,"[10,30]",Crescente,510,Norte,VIANA DO CASTELO,1609,31902.01,84417,5470,4433,3591,3061,2982,6043,9634,14067,19537,264.61,61.24,44.09,30.2
03-12-2020,VIDIGUEIRA,7,0,127,"[0,240]",Moderado,36.0,"[30,Max]",Fortemente crescente,7,Alentejo,BEJA,0214,31661.09,5510,300,248,215,233,275,508,723,971,1271,17.4,4.01,3.07,2.28
03-12-2020,VIEIRA DO MINHO,145,10,1224,"[960,Max]",Extremamente Elevado,-212.0,"[Min,-30]",Fortemente decrescente,145,Norte,BRAGA,0311,21644.35,11842,703,594,525,548,482,1030,1555,2149,2852,54.71,13.18,9.93,7.18
03-12-2020,VILA DE REI,1,0,30,"[0,240]",Moderado,-30.0,"[-30,-10]",Decrescente,1,Centro,CASTELO BRANCO,0510,19154.6,3323,169,128,172,247,302,549,721,849,1018,17.35,5.31,4.43,3.76
03-12-2020,VILA DO BISPO,20,1,388,"[240,480]",Elevado,-78.0,"[Min,-30]",Fortemente decrescente,20,Algarve,FARO,0815,17906.06,5154,302,302,314,232,233,465,779,1081,1383,28.78,7.72,6.04,4.35
03-12-2020,VILA DO CONDE,1105,79,1383,"[960,Max]",Extremamente Elevado,-424.0,"[Min,-30]",Fortemente decrescente,1105,Norte,PORTO,1316,14902.77,79899,4726,3875,2819,2070,1743,3813,6632,10507,15233,536.13,102.21,70.5,44.5
03-12-2020,VILA DO PORTO,3,0,53,"[0,240]",Moderado,-18.0,"[-30,-10]",Decrescente,3,Açores,AÇORES,4101,9688.74,5616,274,212,135,96,123,219,354,566,840,57.96,8.67,5.84,3.65
03-12-2020,VILA FLOR,8,1,132,"[0,240]",Moderado,-67.0,"[Min,-30]",Fortemente decrescente,8,Norte,BRAGANÇA,0410,26581.14,6044,429,362,422,294,331,625,1047,1409,1838,22.74,6.91,5.3,3.94
03-12-2020,VILA FRANCA DE XIRA,635,45,447,"[240,480]",Elevado,-112.0,"[Min,-30]",Fortemente decrescente,634,Lisboa e Vale do Tejo,LISBOA,1114,31819.39,141957,8501,6852,4869,3425,2472,5897,10766,17618,26119,446.14,82.09,55.37,33.84
03-12-2020,VILA FRANCA DO CAMPO,10,1,90,"[0,240]",Moderado,27.0,"[10,30]",Crescente,10,Açores,AÇORES,4206,7796.82,11051,450,344,248,217,154,371,619,963,1413,141.73,18.12,12.35,7.94
03-12-2020,VILA NOVA DA BARQUINHA,15,1,201,"[0,240]",Moderado,-80.0,"[Min,-30]",Fortemente decrescente,15,Lisboa e Vale do Tejo,SANTARÉM,1420,4952.97,7461,415,406,392,364,338,702,1094,1500,1915,150.64,38.66,30.28,22.09
03-12-2020,VILA NOVA DE CERVEIRA,25,2,281,"[240,480]",Elevado,-134.0,"[Min,-30]",Fortemente decrescente,25,Norte,VIANA DO CASTELO,1610,10846.66,8910,531,444,410,384,334,718,1128,1572,2103,82.14,19.39,14.49,10.4
03-12-2020,VILA NOVA DE FAMALICÃO,2356,168,1789,"[960,Max]",Extremamente Elevado,-317.0,"[Min,-30]",Fortemente decrescente,2356,Norte,BRAGA,0312,20159.26,131676,7817,6164,4202,3282,2749,6031,10233,16397,24214,653.19,120.12,81.34,50.76
03-12-2020,VILA NOVA DE FOZ CÔA,27,2,415,"[240,480]",Elevado,-108.0,"[Min,-30]",Fortemente decrescente,27,Centro,GUARDA,0914,39815.18,6503,442,385,390,398,429,827,1217,1602,2044,16.33,5.13,4.02,3.06
03-12-2020,VILA NOVA DE GAIA,2704,193,900,"[480,960]",Muito Elevado,-201.0,"[Min,-30]",Fortemente decrescente,2705,Norte,PORTO,1317,16846.43,300472,18349,15568,10972,8224,6281,14505,25477,41045,59394,1783.64,352.57,243.65,151.23
03-12-2020,VILA NOVA DE PAIVA,28,2,597,"[480,960]",Muito Elevado,-192.0,"[Min,-30]",Fortemente decrescente,28,Centro,VISEU,1822,17553.28,4687,289,272,233,217,241,458,691,963,1252,26.7,7.13,5.49,3.94
03-12-2020,VILA NOVA DE POIARES,27,2,389,"[240,480]",Elevado,-144.0,"[Min,-30]",Fortemente decrescente,27,Centro,COIMBRA,0617,8445.3,6939,380,284,262,235,182,417,679,963,1343,82.17,15.9,11.4,8.04
03-12-2020,VILA POUCA DE AGUIAR,114,8,953,"[480,960]",Muito Elevado,134.0,"[30,Max]",Fortemente crescente,114,Norte,VILA REAL,1713,43706.62,11961,860,817,733,601,627,1228,1961,2778,3638,27.37,8.32,6.36,4.49
03-12-2020,VILA REAL,261,19,522,"[480,960]",Muito Elevado,-132.0,"[Min,-30]",Fortemente decrescente,261,Norte,VILA REAL,1714,37880.28,49962,3025,2498,2065,1579,1466,3045,5110,7608,10633,131.9,28.07,20.08,13.49
03-12-2020,VILA REAL DE SANTO ANTÓNIO,20,1,107,"[0,240]",Moderado,-10.0,"[-10,10]",Estável,20,Algarve,FARO,0816,6125.0,18749,1172,1069,811,569,586,1155,1966,3035,4207,306.11,68.69,49.55,32.1
03-12-2020,VILA VELHA DE RÓDÃO,0,0,0,"[0,240]",Moderado,0.0,"[-10,10]",Estável,0,Centro,CASTELO BRANCO,0511,32991.16,3144,209,229,180,283,306,589,769,998,1207,9.53,3.66,3.03,2.33
03-12-2020,VILA VERDE,443,32,944,"[480,960]",Muito Elevado,-69.0,"[Min,-30]",Fortemente decrescente,443,Norte,BRAGA,0313,22866.52,46911,2365,2063,1667,1494,1437,2931,4598,6661,9026,205.15,39.47,29.13,20.11
03-12-2020,VILA VIÇOSA,8,1,104,"[0,240]",Moderado,-92.0,"[Min,-30]",Fortemente decrescente,8,Alentejo,ÉVORA,0714,19485.89,7656,487,379,342,345,324,669,1011,1390,1877,39.29,9.63,7.13,5.19
03-12-2020,VIMIOSO,32,2,795,"[480,960]",Muito Elevado,99.0,"[30,Max]",Fortemente crescente,32,Norte,BRAGANÇA,0411,48158.51,4023,274,230,261,293,335,628,889,1119,1393,8.35,2.89,2.32,1.85
03-12-2020,VINHAIS,27,2,349,"[240,480]",Elevado,-25.0,"[-30,-10]",Decrescente,27,Norte,BRAGANÇA,0412,69475.09,7746,599,577,636,641,815,1456,2092,2669,3268,11.15,4.7,3.84,3.01
03-12-2020,VISEU,429,31,441,"[240,480]",Elevado,-16.0,"[-30,-10]",Decrescente,429,Centro,VISEU,1823,50710.14,97249,5769,5038,4140,3158,2710,5868,10008,15046,20815,191.77,41.05,29.67,19.74
03-12-2020,VIZELA,260,19,1088,"[960,Max]",Extremamente Elevado,-849.0,"[Min,-30]",Fortemente decrescente,260,Norte,BRAGA,0314,2469.83,23897,1258,928,655,509,371,880,1535,2463,3721,967.49,150.65,99.72,62.15
03-12-2020,VOUZELA,24,2,250,"[240,480]",Elevado,-51.0,"[Min,-30]",Fortemente decrescente,24,Centro,VISEU,1824,19369.46,9619,626,605,554,532,507,1039,1593,2198,2824,49.66,14.58,11.35,8.22
09-12-2020,ABRANTES,69,5,196,"[0,240]",Moderado,-191.0,"[Min,-30)",Fortemente decrescente,69,Lisboa e Vale do Tejo,SANTARÉM,1401,71469.08,35130,2473,2213,1730,1748,2021,3769,5499,7712,10185,49.15,14.25,10.79,7.69
09-12-2020,ÁGUEDA,282,20,612,"[480,960]",Muito Elevado,-35.0,"[Min,-30)",Fortemente decrescente,282,Centro,AVEIRO,0101,33527.44,46075,3237,2713,2090,1635,1496,3131,5221,7934,11171,137.43,33.32,23.66,15.57
09-12-2020,AGUIAR DA BEIRA,33,2,709,"[480,960]",Muito Elevado,430.0,"[30,Max)",Fortemente crescente,33,Centro,GUARDA,0901,20676.57,4652,304,281,235,239,148,387,622,903,1207,22.5,5.84,4.37,3.01
09-12-2020,ALANDROAL,18,1,361,"[240,480]",Elevado,40.0,"[30,Max)",Fortemente crescente,18,Alentejo,ÉVORA,0701,54267.81,4992,307,256,296,299,377,676,972,1228,1535,9.2,2.83,2.26,1.79
09-12-2020,ALBERGARIA-A-VELHA,157,11,650,"[480,960]",Muito Elevado,0.0,"[-10,10)",Estável,157,Centro,AVEIRO,0102,15882.5,24144,1550,1298,996,687,680,1367,2363,3661,5211,152.02,32.81,23.05,14.88
09-12-2020,ALBUFEIRA,98,7,236,"[0,240]",Moderado,-48.0,"[Min,-30)",Fortemente decrescente,98,Algarve,FARO,0801,14066.42,41528,2067,1717,1425,985,858,1843,3268,4985,7052,295.24,50.14,35.44,23.23
09-12-2020,ALCÁCER DO SAL,47,3,403,"[240,480]",Elevado,26.0,"[10,30)",Crescente,47,Alentejo,SETÚBAL,1501,149987.3,11659,884,814,623,623,602,1225,1848,2662,3546,7.77,2.36,1.77,1.23
09-12-2020,ALCANENA,41,3,320,"[240,480]",Elevado,-531.0,"[Min,-30)",Fortemente decrescente,41,Lisboa e Vale do Tejo,SANTARÉM,1402,12732.86,12809,891,744,628,536,588,1124,1752,2496,3387,100.6,26.6,19.6,13.76
09-12-2020,ALCOBAÇA,103,7,192,"[0,240]",Moderado,-131.0,"[Min,-30)",Fortemente decrescente,103,Lisboa e Vale do Tejo,LEIRIA,1001,40814.09,53555,3420,2927,2466,2059,1676,3735,6201,9128,12548,131.22,30.74,22.36,15.19
09-12-2020,ALCOCHETE,89,6,450,"[240,480]",Elevado,30.0,"[30,Max)",Fortemente crescente,89,Lisboa e Vale do Tejo,SETÚBAL,1502,12836.48,19787,857,834,691,476,447,923,1614,2448,3305,154.15,25.75,19.07,12.57
09-12-2020,ALCOUTIM,1,0,46,"[0,240]",Moderado,46.0,"[30,Max)",Fortemente crescente,1,Algarve,FARO,0802,57536.33,2159,191,188,163,190,267,457,620,808,999,3.75,1.74,1.4,1.08
09-12-2020,ALENQUER,296,21,672,"[480,960]",Muito Elevado,119.0,"[30,Max)",Fortemente crescente,296,Lisboa e Vale do Tejo,LISBOA,1101,30421.92,44052,2298,2062,1629,1330,1155,2485,4114,6176,8474,144.8,27.85,20.3,13.52
09-12-2020,ALFÂNDEGA DA FÉ,31,2,681,"[480,960]",Muito Elevado,-88.0,"[Min,-30)",Fortemente decrescente,31,Norte,BRAGANÇA,0401,32194.64,4550,325,277,301,274,325,599,900,1177,1502,14.13,4.67,3.66,2.8
09-12-2020,ALIJÓ,44,3,414,"[240,480]",Elevado,-85.0,"[Min,-30)",Fortemente decrescente,44,Norte,VILA REAL,1701,29759.89,10625,766,687,635,542,666,1208,1843,2530,3296,35.7,11.08,8.5,6.19
09-12-2020,ALJEZUR,5,0,89,"[0,240]",Moderado,18.0,"[10,30)",Crescente,5,Algarve,FARO,0803,32349.95,5594,316,336,335,320,410,730,1065,1401,1717,17.29,5.31,4.33,3.29
09-12-2020,ALJUSTREL,1,0,12,"[0,240]",Moderado,-134.0,"[Min,-30)",Fortemente decrescente,1,Alentejo,BEJA,0201,45847.41,8247,635,521,443,347,358,705,1148,1669,2304,17.99,5.03,3.64,2.5
09-12-2020,ALMADA,925,66,547,"[480,960]",Muito Elevado,-127.0,"[Min,-30)",Fortemente decrescente,925,Lisboa e Vale do Tejo,SETÚBAL,1503,7000.89,169039,10469,9777,7876,6144,5111,11255,19131,28908,39377,2414.5,562.45,412.91,273.26
09-12-2020,ALMEIDA,16,1,274,"[240,480]",Elevado,-17.0,"[-30,-10)",Decrescente,16,Centro,GUARDA,0902,51798.46,5830,441,419,396,458,393,851,1247,1666,2107,11.26,4.07,3.22,2.41
09-12-2020,ALMEIRIM,58,4,257,"[240,480]",Elevado,0.0,"[-10,10)",Estável,58,Lisboa e Vale do Tejo,SANTARÉM,1403,22212.05,22546,1342,1353,1106,866,843,1709,2815,4168,5510,101.5,24.81,18.76,12.67
09-12-2020,ALMODÔVAR,8,1,119,"[0,240]",Moderado,45.0,"[30,Max)",Fortemente crescente,8,Alentejo,BEJA,0202,77788.03,6725,414,443,396,373,328,701,1097,1540,1954,8.65,2.51,1.98,1.41
09-12-2020,ALPIARÇA,3,0,42,"[0,240]",Moderado,-85.0,"[Min,-30)",Fortemente decrescente,3,Lisboa e Vale do Tejo,SANTARÉM,1404,9536.33,7059,515,486,363,333,274,607,970,1456,1971,74.02,20.67,15.27,10.17
09-12-2020,ALTER DO CHÃO,10,1,316,"[240,480]",Elevado,95.0,"[30,Max)",Fortemente crescente,10,Alentejo,PORTALEGRE,1201,36206.62,3165,201,163,136,208,187,395,531,694,895,8.74,2.47,1.92,1.47
09-12-2020,ALVAIÁZERE,11,1,167,"[0,240]",Moderado,16.0,"[10,30)",Crescente,11,Centro,LEIRIA,1002,16047.76,6597,419,389,346,406,539,945,1291,1680,2099,41.11,13.08,10.47,8.04
09-12-2020,ALVITO,1,0,40,"[0,240]",Moderado,0.0,"[-10,10)",Estável,1,Alentejo,BEJA,0203,26485.32,2477,145,110,105,111,89,200,305,415,560,9.35,2.11,1.57,1.15
09-12-2020,AMADORA,733,52,398,"[240,480]",Elevado,-50.0,"[Min,-30)",Fortemente decrescente,733,Lisboa e Vale do Tejo,LISBOA,1115,2378.47,184106,11186,10936,8780,6460,5890,12350,21130,32066,43252,7742.05,1818.84,1348.44,888.56
09-12-2020,AMARANTE,456,33,857,"[480,960]",Muito Elevado,-196.0,"[Min,-30)",Fortemente decrescente,456,Norte,PORTO,1301,30133.15,53193,3086,2413,1812,1643,1311,2954,4766,7179,10265,176.53,34.07,23.82,15.82
09-12-2020,AMARES,137,10,756,"[480,960]",Muito Elevado,-364.0,"[Min,-30)",Fortemente decrescente,137,Norte,BRAGA,0301,8195.41,18129,1001,829,622,489,524,1013,1635,2464,3465,221.22,42.28,30.07,19.95
09-12-2020,ANADIA,222,16,814,"[480,960]",Muito Elevado,62.0,"[30,Max)",Fortemente crescente,222,Centro,AVEIRO,0103,21663.48,27258,1931,1698,1376,1208,1262,2470,3846,5544,7475,125.83,34.51,25.59,17.75
09-12-2020,ANGRA DO HEROÍSMO,101,7,299,"[240,480]",Elevado,136.0,"[30,Max)",Fortemente crescente,101,Açores,AÇORES,4301,23899.66,33807,2006,1473,1122,768,635,1403,2525,3998,6004,141.45,25.12,16.73,10.56
09-12-2020,ANSIÃO,52,4,432,"[240,480]",Elevado,25.0,"[10,30)",Crescente,52,Centro,LEIRIA,1003,17609.42,12039,727,709,646,694,530,1224,1870,2579,3306,68.37,18.77,14.65,10.62
09-12-2020,ARCOS DE VALDEVEZ,95,7,454,"[240,480]",Elevado,29.0,"[10,30)",Crescente,95,Norte,VIANA DO CASTELO,1601,44759.64,20926,1329,1338,1282,1343,1515,2858,4140,5478,6807,46.75,15.21,12.24,9.25
09-12-2020,ARGANIL,16,1,145,"[0,240]",Moderado,-336.0,"[Min,-30)",Fortemente decrescente,16,Centro,COIMBRA,0601,33283.93,11014,672,648,612,559,596,1155,1767,2415,3087,33.09,9.27,7.26,5.31
09-12-2020,ARMAMAR,91,6,1577,"[960,Max]",Extremamente Elevado,35.0,"[30,Max)",Fortemente crescente,91,Norte,VISEU,1801,11723.73,5769,357,305,309,285,310,595,904,1209,1566,49.21,13.36,10.31,7.71
09-12-2020,AROUCA,130,9,627,"[480,960]",Muito Elevado,-154.0,"[Min,-30)",Fortemente decrescente,130,Norte,AVEIRO,0104,32910.52,20720,1306,1047,753,683,683,1366,2119,3166,4472,62.96,13.59,9.62,6.44
09-12-2020,ARRAIOLOS,8,1,115,"[0,240]",Moderado,57.0,"[30,Max)",Fortemente crescente,8,Alentejo,ÉVORA,0702,68374.55,6928,435,384,283,367,480,847,1130,1514,1949,10.13,2.85,2.21,1.65
09-12-2020,ARRONCHES,5,0,177,"[0,240]",Moderado,0.0,"[-10,10)",Estável,5,Alentejo,PORTALEGRE,1202,31464.72,2820,155,142,162,187,179,366,528,670,825,8.96,2.62,2.13,1.68
09-12-2020,ARRUDA DOS VINHOS,36,3,234,"[0,240]",Moderado,-20.0,"[-30,-10)",Decrescente,36,Lisboa e Vale do Tejo,LISBOA,1102,7795.93,15412,738,738,562,509,438,947,1509,2247,2985,197.69,38.29,28.82,19.36
09-12-2020,AVEIRO,381,27,484,"[480,960]",Muito Elevado,-71.0,"[Min,-30)",Fortemente decrescente,381,Centro,AVEIRO,0105,19757.57,78734,4520,4004,3050,2250,2103,4353,7403,11407,15927,398.49,80.61,57.73,37.47
09-12-2020,AVIS,12,1,283,"[240,480]",Elevado,-24.0,"[-30,-10)",Decrescente,12,Alentejo,PORTALEGRE,1203,60596.51,4247,315,225,206,251,273,524,730,955,1270,7.01,2.1,1.58,1.2
09-12-2020,AZAMBUJA,135,10,594,"[480,960]",Muito Elevado,-88.0,"[Min,-30)",Fortemente decrescente,135,Lisboa e Vale do Tejo,LISBOA,1103,26265.65,22716,1322,1171,1070,798,618,1416,2486,3657,4979,86.48,18.96,13.92,9.46
09-12-2020,BAIÃO,175,12,933,"[480,960]",Muito Elevado,101.0,"[30,Max)",Fortemente crescente,175,Norte,PORTO,1302,17452.83,18748,1070,862,714,686,725,1411,2125,2987,4057,107.42,23.25,17.11,12.18
09-12-2020,BARCELOS,1400,100,1205,"[960,Max]",Extremamente Elevado,-188.0,"[Min,-30)",Fortemente decrescente,1400,Norte,BRAGA,0302,37890.14,116187,6721,5325,3619,2991,2562,5553,9172,14497,21218,306.64,56.0,38.26,24.21
09-12-2020,BARRANCOS,5,0,306,"[240,480]",Elevado,122.0,"[30,Max)",Fortemente crescente,5,Alentejo,BEJA,0204,16841.73,1634,90,65,65,94,61,155,220,285,375,9.7,2.23,1.69,1.31
09-12-2020,BARREIRO,377,27,502,"[480,960]",Muito Elevado,24.0,"[10,30)",Crescente,377,Lisboa e Vale do Tejo,SETÚBAL,1504,3639.07,75147,5194,5565,4459,3105,1767,4872,9331,14896,20090,2065.05,552.07,409.34,256.42
09-12-2020,BATALHA,56,4,351,"[240,480]",Elevado,0.0,"[-10,10)",Estável,56,Centro,LEIRIA,1004,10341.6,15963,873,762,649,529,549,1078,1727,2489,3362,154.35,32.51,24.07,16.7
09-12-2020,BEJA,23,2,68,"[0,240]",Moderado,-51.0,"[Min,-30)",Fortemente decrescente,23,Alentejo,BEJA,0205,114647.55,33579,2005,1840,1386,1272,1039,2311,3697,5537,7542,29.29,6.58,4.83,3.22
09-12-2020,BELMONTE,36,3,563,"[480,960]",Muito Elevado,-500.0,"[Min,-30)",Fortemente decrescente,36,Centro,CASTELO BRANCO,0501,11875.91,6398,444,321,325,310,355,665,990,1311,1755,53.87,14.78,11.04,8.34
09-12-2020,BENAVENTE,41,3,134,"[0,240]",Moderado,-128.0,"[Min,-30)",Fortemente decrescente,41,Lisboa e Vale do Tejo,SANTARÉM,1405,52138.39,30602,1468,1376,1141,876,643,1519,2660,4036,5504,58.69,10.56,7.74,5.1
09-12-2020,BOMBARRAL,17,1,135,"[0,240]",Moderado,-112.0,"[Min,-30)",Fortemente decrescente,17,Lisboa e Vale do Tejo,LEIRIA,1005,9128.55,12558,875,714,561,491,429,920,1481,2195,3070,137.56,33.63,24.04,16.22
09-12-2020,BORBA,14,1,208,"[0,240]",Moderado,0.0,"[-10,10)",Estável,14,Alentejo,ÉVORA,0703,14518.65,6736,430,375,279,436,392,828,1107,1482,1912,46.39,13.17,10.21,7.62
09-12-2020,BOTICAS,33,2,660,"[480,960]",Muito Elevado,120.0,"[30,Max)",Fortemente crescente,33,Norte,VILA REAL,1702,32195.66,4998,347,306,311,305,380,685,996,1302,1649,15.52,5.12,4.04,3.09
09-12-2020,BRAGA,1746,125,956,"[480,960]",Muito Elevado,-182.0,"[Min,-30)",Fortemente decrescente,1746,Norte,BRAGA,0303,18339.95,182679,10029,7963,5241,4320,3671,7991,13232,21195,31224,996.07,170.25,115.57,72.15
09-12-2020,BRAGANÇA,221,16,658,"[480,960]",Muito Elevado,-30.0,"[-30,-10)",Decrescente,221,Norte,BRAGANÇA,0402,117357.27,33607,2402,1855,1652,1393,1163,2556,4208,6063,8465,28.64,7.21,5.17,3.59
09-12-2020,CABECEIRAS DE BASTO,92,7,589,"[480,960]",Muito Elevado,-116.0,"[Min,-30)",Fortemente decrescente,92,Norte,BRAGA,0304,24182.16,15628,774,594,544,575,574,1149,1693,2287,3061,64.63,12.66,9.46,7.0
09-12-2020,CADAVAL,24,2,176,"[0,240]",Moderado,-96.0,"[Min,-30)",Fortemente decrescente,24,Lisboa e Vale do Tejo,LISBOA,1104,17489.3,13673,813,796,756,621,625,1246,2002,2798,3611,78.18,20.65,16.0,11.45
09-12-2020,CALDAS DA RAINHA,146,10,281,"[240,480]",Elevado,-21.0,"[-30,-10)",Decrescente,146,Lisboa e Vale do Tejo,LEIRIA,1006,25569.47,51912,3035,2684,2186,1899,1705,3604,5790,8474,11509,203.03,45.01,33.14,22.64
09-12-2020,CALHETA,7,0,64,"[0,240]",Moderado,18.0,"[10,30)",Crescente,7,Madeira,MADEIRA,3101,11150.43,10867,576,497,507,399,415,814,1321,1818,2394,97.46,21.47,16.3,11.85
09-12-2020,CALHETA (AÇORES),1,0,31,"[0,240]",Moderado,0.0,"[-10,10)",Estável,1,Açores,AÇORES,4501,12626.4,3184,215,159,141,139,122,261,402,561,776,25.22,6.15,4.44,3.18
09-12-2020,CÂMARA DE LOBOS,50,4,148,"[0,240]",Moderado,20.0,"[10,30)",Crescente,50,Madeira,MADEIRA,3102,5216.67,33675,1396,1059,834,545,381,926,1760,2819,4215,645.49,80.79,54.03,33.74
09-12-2020,CAMINHA,73,5,460,"[240,480]",Elevado,-277.0,"[Min,-30)",Fortemente decrescente,73,Norte,VIANA DO CASTELO,1602,13652.14,15877,1046,944,818,646,656,1302,2120,3064,4110,116.3,30.11,22.44,15.53
09-12-2020,CAMPO MAIOR,20,1,254,"[240,480]",Elevado,25.0,"[10,30)",Crescente,20,Alentejo,PORTALEGRE,1204,24720.16,7874,471,364,351,279,327,606,957,1321,1792,31.85,7.25,5.34,3.87
09-12-2020,CANTANHEDE,162,12,463,"[240,480]",Elevado,-49.0,"[Min,-30)",Fortemente decrescente,162,Centro,COIMBRA,0602,39088.02,35011,2346,2096,1880,1709,1451,3160,5040,7136,9482,89.57,24.26,18.26,12.89
09-12-2020,CARRAZEDA DE ANSIÃES,3,0,53,"[0,240]",Moderado,-71.0,"[Min,-30)",Fortemente decrescente,3,Norte,BRAGANÇA,0403,27924.09,5666,424,389,391,312,465,777,1168,1557,1981,20.29,7.09,5.58,4.18
09-12-2020,CARREGAL DO SAL,23,2,248,"[240,480]",Elevado,-32.0,"[Min,-30)",Fortemente decrescente,23,Centro,VISEU,1802,11689.21,9271,587,562,486,462,376,838,1324,1886,2473,79.31,21.16,16.13,11.33
09-12-2020,CARTAXO,85,6,356,"[240,480]",Elevado,-109.0,"[Min,-30)",Fortemente decrescente,85,Lisboa e Vale do Tejo,SANTARÉM,1406,15817.28,23843,1415,1376,1142,861,632,1493,2635,4011,5426,150.74,34.3,25.36,16.66
09-12-2020,CASCAIS,869,62,407,"[240,480]",Elevado,-98.0,"[Min,-30)",Fortemente decrescente,869,Lisboa e Vale do Tejo,LISBOA,1105,9740.17,213608,12151,11444,8680,6469,5248,11717,20397,31841,43992,2193.1,451.66,326.91,209.41
09-12-2020,CASTANHEIRA DE PÊRA,8,1,306,"[240,480]",Elevado,38.0,"[30,Max)",Fortemente crescente,8,Centro,LEIRIA,1007,6677.45,2614,233,195,157,190,187,377,534,729,962,39.15,14.41,10.92,8.0
09-12-2020,CASTELO BRANCO,314,22,604,"[480,960]",Muito Elevado,127.0,"[30,Max)",Fortemente crescente,314,Centro,CASTELO BRANCO,0502,143819.15,51987,3528,3042,2499,2229,2225,4454,6953,9995,13523,36.15,9.4,6.95,4.83
09-12-2020,CASTELO DE PAIVA,62,4,401,"[240,480]",Elevado,-570.0,"[Min,-30)",Fortemente decrescente,62,Norte,AVEIRO,0106,11500.53,15454,881,697,545,420,431,851,1396,2093,2974,134.37,25.86,18.2,12.14
09-12-2020,CASTELO DE VIDE,18,1,617,"[480,960]",Muito Elevado,69.0,"[30,Max)",Fortemente crescente,18,Alentejo,PORTALEGRE,1205,26491.24,2919,204,173,179,147,170,317,496,669,873,11.02,3.3,2.53,1.87
09-12-2020,CASTRO DAIRE,52,4,376,"[240,480]",Elevado,65.0,"[30,Max)",Fortemente crescente,52,Centro,VISEU,1803,37904.13,13823,942,857,765,732,773,1505,2270,3127,4069,36.47,10.74,8.25,5.99
09-12-2020,CASTRO MARIM,15,1,241,"[240,480]",Elevado,64.0,"[30,Max)",Fortemente crescente,15,Algarve,FARO,0804,30084.37,6237,370,345,334,322,344,666,1000,1345,1715,20.73,5.7,4.47,3.32
09-12-2020,CASTRO VERDE,13,1,187,"[0,240]",Moderado,-44.0,"[Min,-30)",Fortemente decrescente,13,Alentejo,BEJA,0206,56944.23,6949,437,347,303,275,227,502,805,1152,1589,12.2,2.79,2.02,1.41
09-12-2020,CELORICO DA BEIRA,25,2,361,"[240,480]",Elevado,-837.0,"[Min,-30)",Fortemente decrescente,25,Centro,GUARDA,0903,24721.63,6928,430,416,363,369,535,904,1267,1683,2113,28.02,8.55,6.81,5.12
09-12-2020,CELORICO DE BASTO,107,8,562,"[480,960]",Muito Elevado,-205.0,"[Min,-30)",Fortemente decrescente,107,Norte,BRAGA,0305,18107.02,19040,1001,802,668,728,729,1457,2125,2927,3928,105.15,21.69,16.17,11.74
09-12-2020,CHAMUSCA,64,5,696,"[480,960]",Muito Elevado,43.0,"[30,Max)",Fortemente crescente,64,Lisboa e Vale do Tejo,SANTARÉM,1407,74600.54,9197,629,583,553,465,579,1044,1597,2180,2809,12.33,3.77,2.92,2.14
09-12-2020,CHAVES,820,59,2084,"[960,Max]",Extremamente Elevado,379.0,"[30,Max)",Fortemente crescente,820,Norte,VILA REAL,1703,59122.95,39343,2676,2429,1991,1886,1918,3804,5795,8224,10900,66.54,18.44,13.91,9.8
09-12-2020,CINFÃES,104,7,570,"[480,960]",Muito Elevado,-537.0,"[Min,-30)",Fortemente decrescente,104,Norte,VISEU,1804,23928.76,18244,1067,902,779,734,758,1492,2271,3173,4240,76.24,17.72,13.26,9.49
09-12-2020,COIMBRA,584,42,435,"[240,480]",Elevado,-61.0,"[Min,-30)",Fortemente decrescente,584,Centro,COIMBRA,0603,31939.94,134166,9489,8734,6353,5139,5074,10213,16566,25300,34789,420.06,108.92,79.21,51.87
09-12-2020,CONDEIXA-A-NOVA,95,7,536,"[480,960]",Muito Elevado,23.0,"[10,30)",Crescente,95,Centro,COIMBRA,0604,13867.47,17733,871,809,717,583,490,1073,1790,2599,3470,127.88,25.02,18.74,12.91
09-12-2020,CONSTÂNCIA,3,0,74,"[0,240]",Moderado,-248.0,"[Min,-30)",Fortemente decrescente,3,Lisboa e Vale do Tejo,SANTARÉM,1408,8036.58,4030,211,183,187,148,155,303,490,673,884,50.14,11.0,8.37,6.1
09-12-2020,CORUCHE,42,3,240,"[240,480]",Elevado,-223.0,"[Min,-30)",Fortemente decrescente,42,Lisboa e Vale do Tejo,SANTARÉM,1409,111572.03,17471,1294,1090,1095,1096,1019,2115,3210,4300,5594,15.66,5.01,3.85,2.88
09-12-2020,CORVO,0,0,0,"[0,240]",Moderado,0.0,"[-10,10)",Estável,0,Açores,AÇORES,4901,1711.45,464,22,21,11,13,19,32,43,64,86,27.12,5.03,3.74,2.51
09-12-2020,COVILHÃ,240,17,513,"[480,960]",Muito Elevado,-154.0,"[Min,-30)",Fortemente decrescente,240,Centro,CASTELO BRANCO,0503,55560.06,46787,3533,2998,2365,2111,2193,4304,6669,9667,13200,84.21,23.76,17.4,12.0
09-12-2020,CRATO,46,3,1470,"[960,Max]",Extremamente Elevado,-351.0,"[Min,-30)",Fortemente decrescente,46,Alentejo,PORTALEGRE,1206,39806.88,3129,229,258,163,182,228,410,573,831,1060,7.86,2.66,2.09,1.44
09-12-2020,CUBA,14,1,305,"[240,480]",Elevado,65.0,"[30,Max)",Fortemente crescente,14,Alentejo,BEJA,0207,17208.72,4595,255,233,206,190,143,333,539,772,1027,26.7,5.97,4.49,3.13
09-12-2020,ELVAS,38,3,185,"[0,240]",Moderado,-43.0,"[Min,-30)",Fortemente decrescente,38,Alentejo,PORTALEGRE,1207,63128.86,20528,1057,1145,902,852,810,1662,2564,3709,4766,32.52,7.55,5.88,4.06
09-12-2020,ENTRONCAMENTO,52,4,241,"[240,480]",Elevado,-56.0,"[Min,-30)",Fortemente decrescente,52,Lisboa e Vale do Tejo,SANTARÉM,1410,1372.81,21558,1066,930,868,695,592,1287,2155,3085,4151,1570.14,302.33,224.69,156.96
09-12-2020,ESPINHO,311,22,1054,"[960,Max]",Extremamente Elevado,-3.0,"[-10,10)",Estável,311,Norte,AVEIRO,0107,2105.68,29516,2205,1993,1430,1177,960,2137,3567,5560,7765,1401.52,368.71,264.01,169.37
09-12-2020,ESPOSENDE,460,33,1346,"[960,Max]",Extremamente Elevado,275.0,"[30,Max)",Fortemente crescente,460,Norte,BRAGA,0306,9540.98,34177,1831,1522,1095,894,723,1617,2712,4234,6065,358.21,63.57,44.38,28.42
09-12-2020,ESTARREJA,125,9,481,"[480,960]",Muito Elevado,-112.0,"[Min,-30)",Fortemente decrescente,125,Centro,AVEIRO,0108,10817.33,26006,1503,1399,1106,953,728,1681,2787,4186,5689,240.42,52.59,38.7,25.76
09-12-2020,ESTREMOZ,21,2,165,"[0,240]",Moderado,-40.0,"[Min,-30)",Fortemente decrescente,21,Alentejo,ÉVORA,0704,51379.95,12728,789,613,697,786,877,1663,2360,2973,3762,24.77,7.32,5.79,4.59
09-12-2020,ÉVORA,256,18,488,"[480,960]",Muito Elevado,-7.0,"[-10,10)",Estável,256,Alentejo,ÉVORA,0705,130707.58,52428,3569,2852,2176,1966,1803,3769,5945,8797,12366,40.11,9.46,6.73,4.55
09-12-2020,FAFE,504,36,1049,"[960,Max]",Extremamente Elevado,-498.0,"[Min,-30)",Fortemente decrescente,504,Norte,BRAGA,0307,21908.11,48060,3044,2455,1679,1403,1208,2611,4290,6745,9789,219.37,44.68,30.79,19.58
09-12-2020,FARO,102,7,167,"[0,240]",Moderado,-61.0,"[Min,-30)",Fortemente decrescente,102,Algarve,FARO,0805,20256.79,61015,3847,3364,2604,2055,1601,3656,6260,9624,13471,301.2,66.5,47.51,30.9
09-12-2020,FELGUEIRAS,680,49,1205,"[960,Max]",Extremamente Elevado,-543.0,"[Min,-30)",Fortemente decrescente,680,Norte,PORTO,1303,11573.75,56422,2951,2302,1601,1316,973,2289,3890,6192,9143,487.49,79.0,53.5,33.61
09-12-2020,FERREIRA DO ALENTEJO,5,0,64,"[0,240]",Moderado,-89.0,"[Min,-30)",Fortemente decrescente,5,Alentejo,BEJA,0208,64820.68,7845,515,414,372,343,345,688,1060,1474,1989,12.1,3.07,2.27,1.64
09-12-2020,FERREIRA DO ZÊZERE,3,0,38,"[0,240]",Moderado,-63.0,"[Min,-30)",Fortemente decrescente,3,Lisboa e Vale do Tejo,SANTARÉM,1411,19038.03,7959,470,370,416,465,456,921,1337,1707,2177,41.81,11.44,8.97,7.02
09-12-2020,FIGUEIRA DA FOZ,291,21,495,"[480,960]",Muito Elevado,-75.0,"[Min,-30)",Fortemente decrescente,291,Centro,COIMBRA,0605,37905.26,58747,4032,3597,2887,2495,2043,4538,7425,11022,15054,154.98,39.72,29.08,19.59
09-12-2020,FIGUEIRA DE CASTELO RODRIGO,48,3,860,"[480,960]",Muito Elevado,-358.0,"[Min,-30)",Fortemente decrescente,48,Centro,GUARDA,0904,50857.46,5584,347,352,290,352,391,743,1033,1385,1732,10.98,3.41,2.72,2.03
09-12-2020,FIGUEIRÓ DOS VINHOS,22,2,395,"[240,480]",Elevado,53.0,"[30,Max)",Fortemente crescente,22,Centro,LEIRIA,1008,17344.0,5568,402,386,322,309,351,660,982,1368,1770,32.1,10.21,7.89,5.66
09-12-2020,FORNOS DE ALGODRES,8,1,177,"[0,240]",Moderado,-67.0,"[Min,-30)",Fortemente decrescente,8,Centro,GUARDA,0905,13145.05,4528,261,218,247,256,232,488,735,953,1214,34.45,9.24,7.25,5.59
09-12-2020,FREIXO DE ESPADA À CINTA,23,2,697,"[480,960]",Muito Elevado,-1000.0,"[Min,-30)",Fortemente decrescente,23,Norte,BRAGANÇA,0404,24414.29,3298,211,177,231,196,189,385,616,793,1004,13.51,4.11,3.25,2.52
09-12-2020,FRONTEIRA,10,1,336,"[240,480]",Elevado,201.0,"[30,Max)",Fortemente crescente,10,Alentejo,PORTALEGRE,1208,24859.58,2974,213,182,149,156,168,324,473,655,868,11.96,3.49,2.63,1.9
09-12-2020,FUNCHAL,68,5,65,"[0,240]",Moderado,-15.0,"[-30,-10)",Decrescente,68,Madeira,MADEIRA,3103,7616.2,104024,6382,5086,3643,2821,1990,4811,8454,13540,19922,1365.86,261.58,177.78,111.0
09-12-2020,FUNDÃO,123,9,464,"[240,480]",Elevado,-177.0,"[Min,-30)",Fortemente decrescente,123,Centro,CASTELO BRANCO,0504,70019.79,26495,1781,1464,1432,1357,1643,3000,4432,5896,7677,37.84,10.96,8.42,6.33
09-12-2020,GAVIÃO,40,3,1226,"[960,Max]",Extremamente Elevado,460.0,"[30,Max)",Fortemente crescente,40,Alentejo,PORTALEGRE,1209,29459.45,3263,189,186,222,263,293,556,778,964,1153,11.08,3.91,3.27,2.64
09-12-2020,GÓIS,8,1,210,"[0,240]",Moderado,26.0,"[10,30)",Crescente,8,Centro,COIMBRA,0606,26330.19,3805,235,199,240,233,244,477,717,916,1151,14.45,4.37,3.48,2.72
09-12-2020,GOLEGÃ,21,1,393,"[240,480]",Elevado,93.0,"[30,Max)",Fortemente crescente,21,Lisboa e Vale do Tejo,SANTARÉM,1412,8431.67,5339,356,299,281,243,255,498,779,1078,1434,63.32,17.01,12.78,9.24
09-12-2020,GONDOMAR,1142,82,688,"[480,960]",Muito Elevado,-331.0,"[Min,-30)",Fortemente decrescente,1142,Norte,PORTO,1304,13191.76,165985,10555,8755,6222,4450,3364,7814,14036,22791,33346,1258.22,252.77,172.76,106.4
09-12-2020,GOUVEIA,56,4,452,"[240,480]",Elevado,113.0,"[30,Max)",Fortemente crescente,56,Centro,GUARDA,0906,30061.17,12387,871,931,780,783,810,1593,2373,3304,4175,41.21,13.89,10.99,7.89
09-12-2020,GRÂNDOLA,63,4,430,"[240,480]",Elevado,54.0,"[30,Max)",Fortemente crescente,63,Alentejo,SETÚBAL,1505,82593.66,14639,834,834,708,688,672,1360,2068,2902,3736,17.72,4.52,3.51,2.5
09-12-2020,GUARDA,251,18,644,"[480,960]",Muito Elevado,49.0,"[30,Max)",Fortemente crescente,251,Centro,GUARDA,0907,71209.58,38969,2477,2041,1686,1415,1474,2889,4575,6616,9093,54.72,12.77,9.29,6.42
09-12-2020,GUIMARÃES,2041,146,1340,"[960,Max]",Extremamente Elevado,-477.0,"[Min,-30)",Fortemente decrescente,2041,Norte,BRAGA,0308,24099.96,152309,9394,7074,4809,3877,2948,6825,11634,18708,28102,631.99,116.61,77.63,48.27
09-12-2020,HORTA,2,0,14,"[0,240]",Moderado,14.0,"[10,30)",Crescente,2,Açores,AÇORES,4701,17305.53,14521,818,658,468,352,302,654,1122,1780,2598,83.91,15.01,10.29,6.48
09-12-2020,IDANHA-A-NOVA,14,1,174,"[0,240]",Moderado,-25.0,"[-30,-10)",Decrescente,14,Centro,CASTELO BRANCO,0505,141633.51,8043,518,490,519,672,974,1646,2165,2655,3173,5.68,2.24,1.87,1.53
09-12-2020,ÍLHAVO,215,15,556,"[480,960]",Muito Elevado,-20.0,"[-30,-10)",Decrescente,215,Centro,AVEIRO,0110,7347.55,38699,2227,1943,1444,1193,850,2043,3487,5430,7657,526.66,104.21,73.9,47.46
09-12-2020,LAGOA (FARO),42,3,185,"[0,240]",Moderado,-40.0,"[Min,-30)",Fortemente decrescente,42,Algarve,FARO,0806,8825.45,22762,1314,1168,919,749,670,1419,2338,3506,4820,257.93,54.62,39.73,26.49
09-12-2020,LAGOA,9,1,61,"[0,240]",Moderado,-109.0,"[Min,-30)",Fortemente decrescente,9,Açores,AÇORES,4201,4559.32,14721,536,458,349,238,235,473,822,1280,1816,322.9,39.83,28.08,18.03
09-12-2020,LAGOS,89,6,293,"[240,480]",Elevado,65.0,"[30,Max)",Fortemente crescente,89,Algarve,FARO,0807,21299.27,30374,1744,1434,1247,1053,1029,2082,3329,4763,6507,142.61,30.55,22.36,15.63
09-12-2020,LAJES DAS FLORES,0,0,0,"[0,20]",Extremamente Elevado,0.0,"[-10,10)",Estável,0,Açores,AÇORES,4801,7004.79,1463,88,53,62,46,54,100,162,215,303,20.89,4.33,3.07,2.31
09-12-2020,LAJES DO PICO,1,0,22,"[0,240]",Moderado,0.0,"[-10,10)",Estável,1,Açores,AÇORES,4601,15531.09,4490,304,231,223,159,162,321,544,775,1079,28.91,6.95,4.99,3.5
09-12-2020,LAMEGO,229,16,920,"[480,960]",Muito Elevado,124.0,"[30,Max)",Fortemente crescente,229,Norte,VISEU,1805,16542.11,24895,1639,1284,1124,898,783,1681,2805,4089,5728,150.5,34.63,24.72,16.96
09-12-2020,LEIRIA,509,36,406,"[240,480]",Elevado,-4.0,"[-10,10)",Estável,509,Centro,LEIRIA,1009,56508.83,125267,7389,6366,5090,3902,3159,7061,12151,18517,25906,221.68,45.84,32.77,21.5
09-12-2020,LISBOA,2700,193,530,"[480,960]",Muito Elevado,-80.0,"[Min,-30)",Fortemente decrescente,2700,Lisboa e Vale do Tejo,LISBOA,1106,10005.43,509515,33197,33340,27706,23037,26770,49807,77513,110853,144050,5092.6,1439.78,1107.98,774.74
09-12-2020,LOULÉ,150,11,218,"[0,240]",Moderado,-49.0,"[Min,-30)",Fortemente decrescente,150,Algarve,FARO,0808,76366.91,68697,3890,3350,2780,2358,2251,4609,7389,10739,14629,89.96,19.16,14.06,9.68
09-12-2020,LOURES,1026,73,480,"[480,960]",Muito Elevado,-104.0,"[Min,-30)",Fortemente decrescente,1026,Lisboa e Vale do Tejo,LISBOA,1107,16723.99,213687,12746,12794,9644,6669,5033,11702,21346,34140,46886,1277.73,280.35,204.14,127.64
09-12-2020,LOURINHÃ,56,4,217,"[0,240]",Moderado,35.0,"[30,Max)",Fortemente crescente,56,Lisboa e Vale do Tejo,LISBOA,1108,14717.2,25855,1584,1243,992,842,645,1487,2479,3722,5306,175.68,36.05,25.29,16.84
09-12-2020,LOUSÃ,81,6,472,"[240,480]",Elevado,-59.0,"[Min,-30)",Fortemente decrescente,81,Centro,COIMBRA,0607,13840.01,17158,946,866,658,528,450,978,1636,2502,3448,123.97,24.91,18.08,11.82
09-12-2020,LOUSADA,456,33,975,"[960,Max]",Extremamente Elevado,-884.0,"[Min,-30)",Fortemente decrescente,456,Norte,PORTO,1305,9608.01,46755,2289,1698,1176,853,621,1474,2650,4348,6637,486.63,69.08,45.25,27.58
09-12-2020,MAÇÃO,15,1,239,"[0,240]",Moderado,32.0,"[30,Max)",Fortemente crescente,15,Lisboa e Vale do Tejo,SANTARÉM,1413,39997.98,6267,386,362,390,440,657,1097,1487,1849,2235,15.67,5.59,4.62,3.72
09-12-2020,MACEDO DE CAVALEIROS,74,5,510,"[480,960]",Muito Elevado,62.0,"[30,Max)",Fortemente crescente,74,Norte,BRAGANÇA,0405,69914.08,14516,1082,889,878,823,938,1761,2639,3528,4610,20.76,6.59,5.05,3.77
09-12-2020,MACHICO,17,1,85,"[0,240]",Moderado,-15.0,"[-30,-10)",Decrescente,17,Madeira,MADEIRA,3104,6825.1,19981,1197,860,662,455,331,786,1448,2308,3505,292.76,51.36,33.82,21.22
09-12-2020,MADALENA,1,0,17,"[0,240]",Moderado,17.0,"[10,30)",Crescente,1,Açores,AÇORES,4602,14712.33,5895,334,256,173,190,179,369,542,798,1132,40.07,7.69,5.42,3.68
09-12-2020,MAFRA,268,19,316,"[240,480]",Elevado,-118.0,"[Min,-30)",Fortemente decrescente,268,Lisboa e Vale do Tejo,LISBOA,1109,29165.5,84816,3613,3334,2839,2089,1899,3988,6827,10161,13774,290.81,47.23,34.84,23.41
09-12-2020,MAIA,903,65,650,"[480,960]",Muito Elevado,-273.0,"[Min,-30)",Fortemente decrescente,903,Norte,PORTO,1306,8293.94,138971,7801,6617,4512,3339,2631,5970,10482,17099,24900,1675.56,300.22,206.16,126.38
09-12-2020,MANGUALDE,36,3,194,"[0,240]",Moderado,-184.0,"[Min,-30)",Fortemente decrescente,36,Centro,VISEU,1806,21925.56,18510,1198,1128,885,852,743,1595,2480,3608,4806,84.42,21.92,16.46,11.31
09-12-2020,MANTEIGAS,9,1,299,"[240,480]",Elevado,-764.0,"[Min,-30)",Fortemente decrescente,9,Centro,GUARDA,0908,12197.55,3007,258,197,159,167,146,313,472,669,927,24.65,7.6,5.48,3.87
09-12-2020,MARCO DE CANAVESES,372,27,722,"[480,960]",Muito Elevado,-439.0,"[Min,-30)",Fortemente decrescente,372,Norte,PORTO,1307,20188.98,51496,2678,2060,1488,1265,1023,2288,3776,5836,8514,255.07,42.17,28.91,18.7
09-12-2020,MARINHA GRANDE,114,8,296,"[240,480]",Elevado,-5.0,"[-10,10)",Estável,114,Centro,LEIRIA,1010,18725.19,38508,2365,2302,1638,1359,1058,2417,4055,6357,8722,205.65,46.58,33.95,21.66
09-12-2020,MARVÃO,63,5,2097,"[960,Max]",Extremamente Elevado,699.0,"[30,Max)",Fortemente crescente,63,Alentejo,PORTALEGRE,1210,15489.9,3005,198,185,142,197,237,434,576,761,959,19.4,6.19,4.91,3.72
09-12-2020,MATOSINHOS,1145,82,653,"[480,960]",Muito Elevado,-212.0,"[Min,-30)",Fortemente decrescente,1145,Norte,PORTO,1308,6241.97,175357,11850,9977,7023,5024,3884,8908,15931,25908,37758,2809.31,604.9,415.06,255.22
09-12-2020,MEALHADA,84,6,422,"[240,480]",Elevado,-150.0,"[Min,-30)",Fortemente decrescente,84,Centro,AVEIRO,0111,11065.66,19914,1163,1039,810,828,831,1659,2469,3508,4671,179.96,42.21,31.7,22.31
09-12-2020,MÊDA,9,1,196,"[0,240]",Moderado,-130.0,"[Min,-30)",Fortemente decrescente,9,Centro,GUARDA,0909,28604.92,4587,343,306,290,288,443,731,1021,1327,1670,16.04,5.84,4.64,3.57
09-12-2020,MELGAÇO,14,1,173,"[0,240]",Moderado,-62.0,"[Min,-30)",Fortemente decrescente,14,Norte,VIANA DO CASTELO,1603,23824.58,8093,507,567,578,614,675,1289,1867,2434,2941,33.97,12.34,10.22,7.84
09-12-2020,MÉRTOLA,18,1,293,"[240,480]",Elevado,163.0,"[30,Max)",Fortemente crescente,18,Alentejo,BEJA,0209,129287.34,6142,400,390,378,423,600,1023,1401,1791,2191,4.75,1.69,1.39,1.08
09-12-2020,MESÃO FRIO,13,1,328,"[240,480]",Elevado,-76.0,"[Min,-30)",Fortemente decrescente,13,Norte,VILA REAL,1704,2664.87,3964,265,205,168,157,120,277,445,650,915,148.74,34.33,24.39,16.7
09-12-2020,MIRA,45,3,380,"[240,480]",Elevado,-51.0,"[Min,-30)",Fortemente decrescente,45,Centro,COIMBRA,0608,12403.38,11832,727,729,659,550,466,1016,1675,2404,3131,95.4,25.24,19.38,13.5
09-12-2020,MIRANDA DO CORVO,111,8,873,"[480,960]",Muito Elevado,-338.0,"[Min,-30)",Fortemente decrescente,111,Centro,COIMBRA,0609,12637.79,12708,706,659,568,498,404,902,1470,2129,2835,100.55,22.43,16.85,11.63
09-12-2020,MIRANDA DO DOURO,39,3,571,"[480,960]",Muito Elevado,176.0,"[30,Max)",Fortemente crescente,39,Norte,BRAGANÇA,0406,48718.31,6830,482,429,442,463,470,933,1375,1804,2286,14.02,4.69,3.7,2.82
09-12-2020,MIRANDELA,102,7,469,"[240,480]",Elevado,92.0,"[30,Max)",Fortemente crescente,102,Norte,BRAGANÇA,0407,65895.67,21754,1640,1315,1204,1078,947,2025,3229,4544,6184,33.01,9.38,6.9,4.9
09-12-2020,MOGADOURO,17,1,203,"[0,240]",Moderado,-214.0,"[Min,-30)",Fortemente decrescente,17,Norte,BRAGANÇA,0408,76064.93,8392,589,529,576,630,655,1285,1861,2390,2979,11.03,3.92,3.14,2.45
09-12-2020,MOIMENTA DA BEIRA,10,1,103,"[0,240]",Moderado,20.0,"[10,30)",Crescente,10,Norte,VISEU,1807,21996.9,9736,576,514,471,416,461,877,1348,1862,2438,44.26,11.08,8.46,6.13
09-12-2020,MOITA,329,24,511,"[480,960]",Muito Elevado,27.0,"[10,30)",Crescente,329,Lisboa e Vale do Tejo,SETÚBAL,1506,5525.98,64407,4226,3646,2623,1801,1425,3226,5849,9495,13721,1165.53,248.3,171.82,105.85
09-12-2020,MONÇÃO,69,5,386,"[240,480]",Elevado,-39.0,"[Min,-30)",Fortemente decrescente,69,Norte,VIANA DO CASTELO,1604,21130.85,17869,1161,1105,1031,1006,972,1978,3009,4114,5275,84.56,24.96,19.47,14.24
09-12-2020,MONCHIQUE,5,0,98,"[0,240]",Moderado,-99.0,"[Min,-30)",Fortemente decrescente,5,Algarve,FARO,0809,39530.43,5077,353,384,321,355,392,747,1068,1452,1805,12.84,4.57,3.67,2.7
09-12-2020,MONDIM DE BASTO,185,13,2663,"[960,Max]",Extremamente Elevado,490.0,"[30,Max)",Fortemente crescente,185,Norte,VILA REAL,1705,17207.52,6946,395,300,314,284,283,567,881,1181,1576,40.36,9.16,6.86,5.12
09-12-2020,MONFORTE,10,1,336,"[240,480]",Elevado,-135.0,"[Min,-30)",Fortemente decrescente,10,Alentejo,PORTALEGRE,1211,42024.82,2975,139,115,117,192,168,360,477,592,731,7.08,1.74,1.41,1.14
09-12-2020,MONTALEGRE,44,3,489,"[480,960]",Muito Elevado,-78.0,"[Min,-30)",Fortemente decrescente,44,Norte,VILA REAL,1706,80545.71,8997,699,628,595,603,730,1333,1928,2556,3255,11.17,4.04,3.17,2.39
09-12-2020,MONTEMOR-O-NOVO,117,8,748,"[480,960]",Muito Elevado,76.0,"[30,Max)",Fortemente crescente,117,Alentejo,ÉVORA,0706,123296.65,15647,991,953,868,878,971,1849,2717,3670,4661,12.69,3.78,2.98,2.2
09-12-2020,MONTEMOR-O-VELHO,90,6,357,"[240,480]",Elevado,0.0,"[-10,10)",Estável,90,Centro,COIMBRA,0610,22896.23,25224,1496,1397,1217,1057,988,2045,3262,4659,6155,110.17,26.88,20.35,14.25
09-12-2020,MONTIJO,299,21,519,"[480,960]",Muito Elevado,-1.0,"[-10,10)",Estável,299,Lisboa e Vale do Tejo,SETÚBAL,1507,34861.64,57614,2771,2441,1990,1554,1109,2663,4653,7094,9865,165.26,28.3,20.35,13.35
09-12-2020,MORA,2,0,48,"[0,240]",Moderado,-387.0,"[Min,-30)",Fortemente decrescente,2,Alentejo,ÉVORA,0707,44395.02,4138,336,275,252,238,257,495,747,1022,1358,9.32,3.06,2.3,1.68
09-12-2020,MORTÁGUA,78,6,886,"[480,960]",Muito Elevado,182.0,"[30,Max)",Fortemente crescente,78,Centro,VISEU,1808,25117.82,8803,638,584,535,499,460,959,1494,2078,2716,35.05,10.81,8.27,5.95
09-12-2020,MOURA,5,0,36,"[0,240]",Moderado,-22.0,"[-30,-10)",Decrescente,5,Alentejo,BEJA,0210,95845.55,13718,817,656,665,542,461,1003,1668,2324,3141,14.31,3.28,2.42,1.74
09-12-2020,MOURÃO,30,2,1224,"[960,Max]",Extremamente Elevado,367.0,"[30,Max)",Fortemente crescente,30,Alentejo,ÉVORA,0708,27862.98,2450,139,108,80,104,109,213,293,401,540,8.79,1.94,1.44,1.05
09-12-2020,MURÇA,26,2,476,"[240,480]",Elevado,-73.0,"[Min,-30)",Fortemente decrescente,26,Norte,VILA REAL,1707,18937.11,5463,384,341,307,306,319,625,932,1273,1657,28.85,8.75,6.72,4.92
09-12-2020,MURTOSA,62,4,603,"[480,960]",Muito Elevado,-301.0,"[Min,-30)",Fortemente decrescente,62,Centro,AVEIRO,0112,7308.78,10279,509,473,403,353,409,762,1165,1638,2147,140.63,29.37,22.41,15.94
09-12-2020,NAZARÉ,18,1,127,"[0,240]",Moderado,-247.0,"[Min,-30)",Fortemente decrescente,18,Lisboa e Vale do Tejo,LEIRIA,1011,8243.43,14165,967,903,670,420,396,816,1486,2389,3356,171.84,40.71,28.98,18.03
09-12-2020,NELAS,74,5,570,"[480,960]",Muito Elevado,169.0,"[30,Max)",Fortemente crescente,74,Centro,VISEU,1809,12571.48,12974,924,787,668,604,583,1187,1855,2642,3566,103.21,28.37,21.02,14.76
09-12-2020,NISA,74,5,1221,"[960,Max]",Extremamente Elevado,248.0,"[30,Max)",Fortemente crescente,74,Alentejo,PORTALEGRE,1212,57567.84,6061,405,389,355,483,478,961,1316,1705,2110,10.53,3.67,2.96,2.29
09-12-2020,NORDESTE,4,0,82,"[0,240]",Moderado,20.0,"[10,30)",Crescente,4,Açores,AÇORES,4202,10146.8,4862,246,180,124,161,162,323,447,627,873,47.92,8.6,6.18,4.41
09-12-2020,ÓBIDOS,23,2,194,"[0,240]",Moderado,-59.0,"[Min,-30)",Fortemente decrescente,23,Lisboa e Vale do Tejo,LEIRIA,1012,14155.44,11850,743,650,574,452,436,888,1462,2112,2855,83.72,20.17,14.92,10.33
09-12-2020,ODEMIRA,116,8,469,"[240,480]",Elevado,137.0,"[30,Max)",Fortemente crescente,116,Alentejo,BEJA,0211,172060.15,24717,1475,1317,1225,1397,1349,2746,3971,5288,6763,14.37,3.93,3.07,2.31
09-12-2020,ODIVELAS,725,52,448,"[240,480]",Elevado,-80.0,"[Min,-30)",Fortemente decrescente,725,Lisboa e Vale do Tejo,LISBOA,1116,2654.36,161774,9562,9038,6952,4641,3812,8453,15405,24443,34005,6095.48,1281.27,920.99,580.44
09-12-2020,OEIRAS,564,40,318,"[240,480]",Elevado,-45.0,"[Min,-30)",Fortemente decrescente,564,Lisboa e Vale do Tejo,LISBOA,1110,4588.31,177408,11580,11575,8566,6211,5855,12066,20632,32207,43787,3866.78,954.38,701.98,449.69
09-12-2020,OLEIROS,12,1,240,"[240,480]",Elevado,-340.0,"[Min,-30)",Fortemente decrescente,12,Centro,CASTELO BRANCO,0506,47109.31,5003,384,341,366,397,487,884,1250,1591,1975,10.62,4.19,3.38,2.65
09-12-2020,OLHÃO,58,4,131,"[0,240]",Moderado,-5.0,"[-10,10)",Estável,58,Algarve,FARO,0810,13086.38,44405,2455,2309,1689,1342,1268,2610,4299,6608,9063,339.33,69.26,50.5,32.85
09-12-2020,OLIVEIRA DE AZEMÉIS,587,42,889,"[480,960]",Muito Elevado,-393.0,"[Min,-30)",Fortemente decrescente,587,Norte,AVEIRO,0113,16110.41,66011,4155,3614,2794,2183,1738,3921,6715,10329,14484,409.75,89.91,64.12,41.68
09-12-2020,OLIVEIRA DE FRADES,11,1,111,"[0,240]",Moderado,-282.0,"[Min,-30)",Fortemente decrescente,11,Centro,VISEU,1810,14534.62,9936,553,475,438,359,415,774,1212,1687,2240,68.36,15.41,11.61,8.34
09-12-2020,OLIVEIRA DO BAIRRO,131,9,540,"[480,960]",Muito Elevado,-70.0,"[Min,-30)",Fortemente decrescente,131,Centro,AVEIRO,0114,8731.99,24277,1327,1182,999,786,810,1596,2595,3777,5104,278.02,58.45,43.25,29.72
09-12-2020,OLIVEIRA DO HOSPITAL,82,6,426,"[240,480]",Elevado,99.0,"[30,Max)",Fortemente crescente,82,Centro,COIMBRA,0611,23451.66,19253,1161,1097,962,924,960,1884,2846,3943,5104,82.1,21.76,16.81,12.14
09-12-2020,OURÉM,119,8,270,"[240,480]",Elevado,-171.0,"[Min,-30)",Fortemente decrescente,119,Lisboa e Vale do Tejo,SANTARÉM,1421,41668.03,44044,2463,2069,1899,1817,1603,3420,5319,7388,9851,105.7,23.64,17.73,12.77
09-12-2020,OURIQUE,6,0,130,"[0,240]",Moderado,65.0,"[30,Max)",Fortemente crescente,6,Alentejo,BEJA,0212,66331.36,4607,313,287,284,268,227,495,779,1066,1379,6.95,2.08,1.61,1.17
09-12-2020,OVAR,376,27,693,"[480,960]",Muito Elevado,-142.0,"[Min,-30)",Fortemente decrescente,376,Centro,AVEIRO,0115,14770.25,54260,3294,2709,1994,1636,1234,2870,4864,7573,10867,367.37,73.57,51.27,32.93
09-12-2020,PAÇOS DE FERREIRA,399,28,703,"[480,960]",Muito Elevado,-878.0,"[Min,-30)",Fortemente decrescente,399,Norte,PORTO,1309,7099.29,56728,2903,2193,1518,1135,664,1799,3317,5510,8413,799.1,118.51,77.62,46.72
09-12-2020,PALMELA,215,15,335,"[240,480]",Elevado,-48.0,"[Min,-30)",Fortemente decrescente,215,Lisboa e Vale do Tejo,SETÚBAL,1508,46512.01,64269,3402,3244,2635,1846,1391,3237,5872,9116,12518,138.18,26.91,19.6,12.62
09-12-2020,PAMPILHOSA DA SERRA,17,1,421,"[240,480]",Elevado,198.0,"[30,Max)",Fortemente crescente,17,Centro,COIMBRA,0612,39646.24,4037,238,254,295,339,423,762,1057,1311,1549,10.18,3.91,3.31,2.67
09-12-2020,PAREDES,667,48,775,"[480,960]",Muito Elevado,-477.0,"[Min,-30)",Fortemente decrescente,667,Norte,PORTO,1310,15675.69,86067,4272,3532,2412,1717,1258,2975,5387,8919,13191,549.04,84.15,56.9,34.36
09-12-2020,PAREDES DE COURA,17,1,199,"[0,240]",Moderado,-47.0,"[Min,-30)",Fortemente decrescente,17,Norte,VIANA DO CASTELO,1605,13818.59,8535,466,528,407,465,515,980,1387,1915,2381,61.76,17.23,13.86,10.04
09-12-2020,PEDRÓGÃO GRANDE,4,0,117,"[0,240]",Moderado,58.0,"[30,Max)",Fortemente crescente,4,Centro,LEIRIA,1013,12874.75,3410,175,173,196,221,252,473,669,842,1017,26.49,7.9,6.54,5.2
09-12-2020,PENACOVA,94,7,686,"[480,960]",Muito Elevado,88.0,"[30,Max)",Fortemente crescente,94,Centro,COIMBRA,0613,21673.23,13694,968,923,745,621,703,1324,2069,2992,3960,63.18,18.27,13.81,9.55
09-12-2020,PENAFIEL,542,39,777,"[480,960]",Muito Elevado,-709.0,"[Min,-30)",Fortemente decrescente,542,Norte,PORTO,1311,21224.27,69772,3648,2823,2032,1663,1230,2893,4925,7748,11396,328.74,53.69,36.51,23.2
09-12-2020,PENALVA DO CASTELO,24,2,337,"[240,480]",Elevado,14.0,"[10,30)",Crescente,24,Centro,VISEU,1811,13433.92,7115,449,457,413,391,426,817,1230,1687,2136,52.96,15.9,12.56,9.16
09-12-2020,PENAMACOR,30,2,631,"[480,960]",Muito Elevado,-127.0,"[Min,-30)",Fortemente decrescente,30,Centro,CASTELO BRANCO,0507,56370.69,4755,262,248,273,451,633,1084,1357,1605,1867,8.44,3.31,2.85,2.41
09-12-2020,PENEDONO,1,0,39,"[0,240]",Moderado,-77.0,"[Min,-30)",Fortemente decrescente,1,Norte,VISEU,1812,13370.75,2591,172,113,129,156,138,294,423,536,708,19.38,5.3,4.01,3.16
09-12-2020,PENELA,14,1,259,"[240,480]",Elevado,-129.0,"[Min,-30)",Fortemente decrescente,14,Centro,COIMBRA,0614,13480.0,5397,314,324,274,359,344,703,977,1301,1615,40.04,11.98,9.65,7.25
09-12-2020,PENICHE,112,8,423,"[240,480]",Elevado,-94.0,"[Min,-30)",Fortemente decrescente,112,Lisboa e Vale do Tejo,LEIRIA,1014,7754.98,26501,1746,1504,1203,926,707,1633,2836,4340,6086,341.73,78.48,55.96,36.57
09-12-2020,PESO DA RÉGUA,43,3,273,"[240,480]",Elevado,13.0,"[10,30)",Crescente,43,Norte,VILA REAL,1708,9486.01,15773,1076,843,650,659,455,1114,1764,2607,3683,166.28,38.83,27.48,18.6
09-12-2020,PINHEL,91,6,1069,"[960,Max]",Extremamente Elevado,153.0,"[30,Max)",Fortemente crescente,91,Centro,GUARDA,0910,48452.12,8511,577,566,551,538,689,1227,1778,2344,2921,17.57,6.03,4.84,3.67
09-12-2020,POMBAL,146,10,284,"[240,480]",Elevado,-255.0,"[Min,-30)",Fortemente decrescente,146,Centro,LEIRIA,1015,62600.28,51461,3187,2791,2494,2328,2027,4355,6849,9640,12827,82.21,20.49,15.4,10.94
09-12-2020,PONTA DELGADA,90,6,132,"[0,240]",Moderado,-47.0,"[Min,-30)",Fortemente decrescente,90,Açores,AÇORES,4203,23298.65,67935,3108,2435,1726,1133,902,2035,3761,6196,9304,291.58,39.93,26.59,16.14
09-12-2020,PONTA DO SOL,3,0,35,"[0,240]",Moderado,0.0,"[-10,10)",Estável,3,Madeira,MADEIRA,3105,4622.03,8593,319,283,347,208,221,429,776,1059,1378,185.92,29.81,22.91,16.79
09-12-2020,PONTE DA BARCA,55,4,492,"[480,960]",Muito Elevado,-18.0,"[-30,-10)",Decrescente,55,Norte,VIANA DO CASTELO,1606,18211.37,11180,635,576,517,554,490,1044,1561,2137,2772,61.39,15.22,11.73,8.57
09-12-2020,PONTE DE LIMA,251,18,608,"[480,960]",Muito Elevado,-177.0,"[Min,-30)",Fortemente decrescente,251,Norte,VIANA DO CASTELO,1607,32025.46,41315,2321,2022,1720,1596,1462,3058,4778,6800,9121,129.01,28.48,21.23,14.92
09-12-2020,PONTE DE SOR,18,1,120,"[0,240]",Moderado,-73.0,"[Min,-30)",Fortemente decrescente,18,Alentejo,PORTALEGRE,1213,83971.16,14994,939,800,716,739,831,1570,2286,3086,4025,17.86,4.79,3.68,2.72
09-12-2020,PORTALEGRE,212,15,956,"[480,960]",Muito Elevado,-338.0,"[Min,-30)",Fortemente decrescente,212,Alentejo,PORTALEGRE,1214,44713.64,22172,1577,1351,1137,993,984,1977,3114,4465,6042,49.59,13.51,9.99,6.96
09-12-2020,PORTEL,2,0,34,"[0,240]",Moderado,34.0,"[30,Max)",Fortemente crescente,2,Alentejo,ÉVORA,0709,60100.57,5828,336,358,283,331,305,636,919,1277,1613,9.7,2.68,2.12,1.53
09-12-2020,PORTIMÃO,190,14,342,"[240,480]",Elevado,-81.0,"[Min,-30)",Fortemente decrescente,190,Algarve,FARO,0811,18206.29,55483,3182,2927,2116,1582,1400,2982,5098,8025,11207,304.75,61.56,44.08,28.0
09-12-2020,PORTO,1473,105,680,"[480,960]",Muito Elevado,-250.0,"[Min,-30)",Fortemente decrescente,1473,Norte,PORTO,1312,4142.02,216606,15790,15193,11280,9409,10044,19453,30733,45926,61716,5229.5,1490.0,1108.79,741.98
09-12-2020,PORTO DE MÓS,80,6,344,"[240,480]",Elevado,-60.0,"[Min,-30)",Fortemente decrescente,80,Centro,LEIRIA,1016,26183.41,23275,1355,1210,1034,888,872,1760,2794,4004,5359,88.89,20.47,15.29,10.67
09-12-2020,PORTO MONIZ,1,0,43,"[0,240]",Moderado,42.0,"[30,Max)",Fortemente crescente,1,Madeira,MADEIRA,3106,8293.38,2342,143,130,95,98,120,218,313,443,586,28.24,7.07,5.34,3.77
09-12-2020,PORTO SANTO,0,0,0,"[0,240]",Moderado,0.0,"[-10,10)",Estável,0,Madeira,MADEIRA,3201,4300.7,5202,240,157,134,110,68,178,312,469,709,120.95,16.48,10.9,7.25
09-12-2020,PÓVOA DE LANHOSO,259,19,1205,"[960,Max]",Extremamente Elevado,-219.0,"[Min,-30)",Fortemente decrescente,259,Norte,BRAGA,0309,13465.29,21499,1175,909,732,673,624,1297,2029,2938,4113,159.67,30.55,21.82,15.07
09-12-2020,PÓVOA DE VARZIM,775,55,1234,"[960,Max]",Extremamente Elevado,-342.0,"[Min,-30)",Fortemente decrescente,775,Norte,PORTO,1313,8220.59,62784,3712,3120,2134,1594,1305,2899,5033,8153,11865,763.7,144.33,99.17,61.22
09-12-2020,POVOAÇÃO,22,2,371,"[240,480]",Elevado,304.0,"[30,Max)",Fortemente crescente,22,Açores,AÇORES,4204,10640.77,5927,293,212,191,144,134,278,469,681,974,55.7,9.15,6.4,4.41
09-12-2020,VILA DA PRAIA DA VITÓRIA,26,2,122,"[0,240]",Moderado,-10.0,"[-10,10)",Estável,26,Açores,AÇORES,4302,16127.06,21317,1133,789,619,436,336,772,1391,2180,3313,132.18,20.54,13.52,8.63
09-12-2020,PROENÇA-A-NOVA,12,1,164,"[0,240]",Moderado,-192.0,"[Min,-30)",Fortemente decrescente,12,Centro,CASTELO BRANCO,0508,39539.96,7298,508,465,389,400,560,960,1349,1814,2322,18.46,5.87,4.59,3.41
09-12-2020,REDONDO,5,0,79,"[0,240]",Moderado,-79.0,"[Min,-30)",Fortemente decrescente,5,Alentejo,ÉVORA,0710,36950.87,6353,349,325,288,288,354,642,930,1255,1604,17.19,4.34,3.4,2.52
09-12-2020,REGUENGOS DE MONSARAZ,32,2,320,"[240,480]",Elevado,-260.0,"[Min,-30)",Fortemente decrescente,32,Alentejo,ÉVORA,0711,46399.72,10015,602,511,455,462,473,935,1390,1901,2503,21.58,5.39,4.1,3.0
09-12-2020,RESENDE,58,4,572,"[480,960]",Muito Elevado,-99.0,"[Min,-30)",Fortemente decrescente,58,Norte,VISEU,1813,12334.93,10137,560,493,448,433,422,855,1303,1796,2356,82.18,19.1,14.56,10.56
09-12-2020,RIBEIRA BRAVA,0,0,0,"[0,240]",Moderado,-16.0,"[-30,-10)",Decrescente,0,Madeira,MADEIRA,3107,6544.88,12435,648,500,411,311,287,598,1009,1509,2157,189.99,32.96,23.06,15.42
09-12-2020,RIBEIRA DE PENA,11,1,183,"[0,240]",Moderado,-133.0,"[Min,-30)",Fortemente decrescente,11,Norte,VILA REAL,1709,21745.98,6016,371,301,290,310,368,678,968,1269,1640,27.66,7.54,5.84,4.45
09-12-2020,RIBEIRA GRANDE,109,8,332,"[240,480]",Elevado,165.0,"[30,Max)",Fortemente crescente,109,Açores,AÇORES,4205,18015.13,32811,1163,689,512,345,253,598,1110,1799,2962,182.13,16.44,9.99,6.16
09-12-2020,RIO MAIOR,137,10,672,"[480,960]",Muito Elevado,285.0,"[30,Max)",Fortemente crescente,137,Lisboa e Vale do Tejo,SANTARÉM,1414,27276.45,20379,1251,1144,941,795,648,1443,2384,3528,4779,74.71,17.52,12.93,8.74
09-12-2020,SABROSA,9,1,152,"[0,240]",Moderado,-17.0,"[-30,-10)",Decrescente,9,Norte,VILA REAL,1710,15692.45,5918,393,314,304,302,350,652,956,1270,1663,37.71,10.6,8.09,6.09
09-12-2020,SABUGAL,45,3,425,"[240,480]",Elevado,-255.0,"[Min,-30)",Fortemente decrescente,45,Centro,GUARDA,0911,82269.82,10585,724,707,694,796,1009,1805,2499,3206,3930,12.87,4.78,3.9,3.04
09-12-2020,SALVATERRA DE MAGOS,48,3,225,"[0,240]",Moderado,-160.0,"[Min,-30)",Fortemente decrescente,48,Lisboa e Vale do Tejo,SANTARÉM,1415,24393.2,21295,1275,1181,1060,799,772,1571,2631,3812,5087,87.3,20.85,15.63,10.79
09-12-2020,SANTA COMBA DÃO,20,1,191,"[0,240]",Moderado,48.0,"[30,Max)",Fortemente crescente,20,Centro,VISEU,1814,11194.77,10452,732,684,569,538,464,1002,1571,2255,2987,93.36,26.68,20.14,14.03
09-12-2020,SANTA CRUZ,41,3,91,"[0,240]",Moderado,-24.0,"[-30,-10)",Decrescente,41,Madeira,MADEIRA,3108,8150.28,45281,1817,1301,974,716,523,1239,2213,3514,5331,555.6,65.41,43.12,27.15
09-12-2020,SANTA CRUZ DA GRACIOSA,2,0,48,"[0,240]",Moderado,23.0,"[10,30)",Crescente,2,Açores,AÇORES,4401,6065.78,4208,228,180,163,124,145,269,432,612,840,69.37,13.85,10.09,7.12
09-12-2020,SANTA CRUZ DAS FLORES,0,0,0,"[0,240]",Moderado,-92.0,"[Min,-30)",Fortemente decrescente,0,Açores,AÇORES,4802,7091.44,2165,125,98,74,56,51,107,181,279,404,30.53,5.7,3.93,2.55
09-12-2020,SANTA MARIA DA FEIRA,1318,94,951,"[480,960]",Muito Elevado,-341.0,"[Min,-30)",Fortemente decrescente,1318,Norte,AVEIRO,0109,21587.65,138636,8182,6743,4771,3856,3079,6935,11706,18449,26631,642.19,123.36,85.46,54.22
09-12-2020,SANTA MARTA DE PENAGUIÃO,42,3,636,"[480,960]",Muito Elevado,-243.0,"[Min,-30)",Fortemente decrescente,42,Norte,VILA REAL,1711,6928.13,6599,483,373,337,316,317,633,970,1343,1826,95.25,26.36,19.39,14.0
09-12-2020,SANTANA,4,0,60,"[0,240]",Moderado,15.0,"[10,30)",Crescente,4,Madeira,MADEIRA,3109,9547.3,6711,418,353,343,282,277,559,902,1255,1673,70.29,17.52,13.15,9.45
09-12-2020,SANTARÉM,213,15,371,"[240,480]",Elevado,-106.0,"[Min,-30)",Fortemente decrescente,213,Lisboa e Vale do Tejo,SANTARÉM,1416,55253.58,57421,3654,3441,2760,2466,2206,4672,7432,10873,14527,103.92,26.29,19.68,13.45
09-12-2020,SANTIAGO DO CACÉM,39,3,135,"[0,240]",Moderado,0.0,"[-10,10)",Estável,39,Alentejo,SETÚBAL,1509,105969.29,28791,2144,1689,1472,1295,1215,2510,3982,5671,7815,27.17,7.37,5.35,3.76
09-12-2020,SANTO TIRSO,522,37,767,"[480,960]",Muito Elevado,-637.0,"[Min,-30)",Fortemente decrescente,522,Norte,PORTO,1314,13655.52,68055,4911,3935,2761,2257,1810,4067,6828,10763,15674,498.35,114.78,78.82,50.0
09-12-2020,SÃO BRÁS DE ALPORTEL,12,1,115,"[0,240]",Moderado,-38.0,"[Min,-30)",Fortemente decrescente,12,Algarve,FARO,0812,15336.92,10416,596,468,467,404,401,805,1272,1740,2336,67.91,15.23,11.35,8.29
09-12-2020,SÃO JOÃO DA MADEIRA,189,14,861,"[480,960]",Muito Elevado,-496.0,"[Min,-30)",Fortemente decrescente,189,Norte,AVEIRO,0116,794.3,21958,1347,1069,796,601,593,1194,1990,3059,4406,2765.49,554.91,385.26,250.63
09-12-2020,SÃO JOÃO DA PESQUEIRA,21,2,295,"[240,480]",Elevado,-183.0,"[Min,-30)",Fortemente decrescente,21,Norte,VISEU,1815,26610.85,7125,417,330,294,328,328,656,950,1280,1697,26.77,6.38,4.81,3.57
09-12-2020,SÃO PEDRO DO SUL,42,3,273,"[240,480]",Elevado,-129.0,"[Min,-30)",Fortemente decrescente,42,Centro,VISEU,1816,34895.09,15403,990,962,861,759,909,1668,2529,3491,4481,44.14,12.84,10.0,7.25
09-12-2020,SÃO ROQUE DO PICO,1,0,31,"[0,240]",Moderado,-31.0,"[Min,-30)",Fortemente decrescente,1,Açores,AÇORES,4603,14236.1,3266,199,141,93,96,113,209,302,443,642,22.94,4.51,3.11,2.12
09-12-2020,SÃO VICENTE,1,0,19,"[0,240]",Moderado,20.0,"[10,30)",Crescente,1,Madeira,MADEIRA,3110,7883.71,5143,272,264,266,225,280,505,771,1035,1307,65.23,16.58,13.13,9.78
09-12-2020,SARDOAL,7,0,187,"[0,240]",Moderado,-321.0,"[Min,-30)",Fortemente decrescente,7,Lisboa e Vale do Tejo,SANTARÉM,1417,9214.72,3741,227,178,148,165,248,413,561,739,966,40.6,10.48,8.02,6.09
09-12-2020,SÁTÃO,43,3,371,"[240,480]",Elevado,-155.0,"[Min,-30)",Fortemente decrescente,43,Centro,VISEU,1817,20194.11,11580,765,671,515,465,476,941,1456,2127,2892,57.34,14.32,10.53,7.21
09-12-2020,SEIA,145,10,652,"[480,960]",Muito Elevado,72.0,"[30,Max)",Fortemente crescente,145,Centro,GUARDA,0912,43568.83,22234,1807,1589,1238,1122,721,1843,3081,4670,6477,51.03,14.87,10.72,7.07
09-12-2020,SEIXAL,683,49,407,"[240,480]",Elevado,-94.0,"[Min,-30)",Fortemente decrescente,683,Lisboa e Vale do Tejo,SETÚBAL,1510,9545.17,167752,10586,9270,6661,4391,2930,7321,13982,23252,33838,1757.49,354.51,243.6,146.49
09-12-2020,SERNANCELHE,5,0,93,"[0,240]",Moderado,18.0,"[10,30)",Crescente,5,Norte,VISEU,1818,22861.22,5396,305,293,286,273,260,533,819,1112,1417,23.6,6.2,4.86,3.58
09-12-2020,SERPA,51,4,357,"[240,480]",Elevado,35.0,"[30,Max)",Fortemente crescente,51,Alentejo,BEJA,0213,110563.34,14304,903,761,719,697,626,1323,2042,2803,3706,12.94,3.35,2.54,1.85
09-12-2020,SERTÃ,39,3,268,"[240,480]",Elevado,110.0,"[30,Max)",Fortemente crescente,39,Centro,CASTELO BRANCO,0509,44673.17,14577,870,779,790,767,1020,1787,2577,3356,4226,32.63,9.46,7.51,5.77
09-12-2020,SESIMBRA,153,11,295,"[240,480]",Elevado,-45.0,"[Min,-30)",Fortemente decrescente,153,Lisboa e Vale do Tejo,SETÚBAL,1511,19571.75,51858,2400,2321,1853,1257,1083,2340,4193,6514,8914,264.96,45.54,33.28,21.42
09-12-2020,SETÚBAL,451,32,392,"[240,480]",Elevado,-36.0,"[Min,-30)",Fortemente decrescente,451,Lisboa e Vale do Tejo,SETÚBAL,1512,23032.5,115126,7425,6929,5075,3775,2655,6430,11505,18434,25859,499.83,112.27,80.03,49.95
09-12-2020,SEVER DO VOUGA,26,2,229,"[0,240]",Moderado,-115.0,"[Min,-30)",Fortemente decrescente,26,Centro,AVEIRO,0117,12987.56,11331,766,637,568,540,567,1107,1675,2312,3078,87.24,23.7,17.8,12.9
09-12-2020,SILVES,87,6,240,"[240,480]",Elevado,34.0,"[30,Max)",Fortemente crescente,87,Algarve,FARO,0813,68006.23,36226,2137,1869,1610,1423,1600,3023,4633,6502,8639,53.27,12.7,9.56,6.81
09-12-2020,SINES,26,2,190,"[0,240]",Moderado,-138.0,"[Min,-30)",Fortemente decrescente,26,Alentejo,SETÚBAL,1513,20330.17,13715,888,791,551,416,268,684,1235,2026,2914,67.46,14.33,9.97,6.07
09-12-2020,SINTRA,1785,127,456,"[240,480]",Elevado,-69.0,"[Min,-30)",Fortemente decrescente,1785,Lisboa e Vale do Tejo,LISBOA,1111,31922.73,391402,20490,18316,13545,9137,7284,16421,29966,48282,68772,1226.08,215.43,151.25,93.87
09-12-2020,SOBRAL DE MONTE AGRAÇO,34,2,319,"[240,480]",Elevado,-47.0,"[Min,-30)",Fortemente decrescente,34,Lisboa e Vale do Tejo,LISBOA,1112,5210.32,10651,564,507,352,272,212,484,836,1343,1907,204.43,36.6,25.78,16.05
09-12-2020,SOURE,101,7,590,"[480,960]",Muito Elevado,146.0,"[30,Max)",Fortemente crescente,101,Centro,COIMBRA,0615,26506.07,17120,1173,1142,1004,883,987,1870,2874,4016,5189,64.59,19.58,15.15,10.84
09-12-2020,SOUSEL,1,0,23,"[0,240]",Moderado,0.0,"[-10,10)",Estável,1,Alentejo,PORTALEGRE,1215,27932.18,4412,261,274,208,302,292,594,802,1076,1337,15.8,4.79,3.85,2.87
09-12-2020,TÁBUA,13,1,114,"[0,240]",Moderado,-71.0,"[Min,-30)",Fortemente decrescente,13,Centro,COIMBRA,0616,19978.58,11368,729,584,524,430,464,894,1418,2002,2731,56.9,13.67,10.02,7.1
09-12-2020,TABUAÇO,54,4,895,"[480,960]",Muito Elevado,-132.0,"[Min,-30)",Fortemente decrescente,54,Norte,VISEU,1819,13385.67,6033,372,314,217,282,363,645,862,1176,1548,45.07,11.56,8.79,6.44
09-12-2020,TAROUCA,29,2,372,"[240,480]",Elevado,-115.0,"[Min,-30)",Fortemente decrescente,29,Norte,VISEU,1820,10008.49,7804,405,335,313,277,324,601,914,1249,1654,77.98,16.53,12.48,9.13
09-12-2020,TAVIRA,24,2,98,"[0,240]",Moderado,-66.0,"[Min,-30)",Fortemente decrescente,24,Algarve,FARO,0814,60696.7,24530,1493,1415,1252,1066,1277,2343,3595,5010,6503,40.41,10.71,8.25,5.92
09-12-2020,TERRAS DE BOURO,40,3,629,"[480,960]",Muito Elevado,63.0,"[30,Max)",Fortemente crescente,40,Norte,BRAGA,0310,27746.07,6361,391,372,296,319,340,659,955,1327,1718,22.93,6.19,4.78,3.44
09-12-2020,TOMAR,87,6,237,"[0,240]",Moderado,-65.0,"[Min,-30)",Fortemente decrescente,87,Lisboa e Vale do Tejo,SANTARÉM,1418,35120.44,36748,2403,2189,1868,1853,1822,3675,5543,7732,10135,104.64,28.86,22.02,15.78
09-12-2020,TONDELA,73,5,277,"[240,480]",Elevado,-30.0,"[-30,-10)",Decrescente,73,Centro,VISEU,1821,37121.73,26357,1768,1722,1518,1475,1417,2892,4410,6132,7900,71.0,21.28,16.52,11.88
09-12-2020,TORRE DE MONCORVO,55,4,715,"[480,960]",Muito Elevado,195.0,"[30,Max)",Fortemente crescente,55,Norte,BRAGANÇA,0409,53155.67,7695,556,478,488,551,719,1270,1758,2236,2792,14.48,5.25,4.21,3.31
09-12-2020,TORRES NOVAS,105,8,301,"[240,480]",Elevado,-94.0,"[Min,-30)",Fortemente decrescente,105,Lisboa e Vale do Tejo,SANTARÉM,1419,26999.68,34933,2324,1979,1738,1406,1475,2881,4619,6598,8922,129.38,33.04,24.44,17.11
09-12-2020,TORRES VEDRAS,388,28,494,"[480,960]",Muito Elevado,24.0,"[10,30)",Crescente,388,Lisboa e Vale do Tejo,LISBOA,1113,40714.89,78530,4513,3945,3447,2628,2104,4732,8179,12124,16637,192.88,40.86,29.78,20.09
09-12-2020,TRANCOSO,26,2,293,"[240,480]",Elevado,-135.0,"[Min,-30)",Fortemente decrescente,26,Centro,GUARDA,0913,36152.47,8875,581,557,542,586,496,1082,1624,2181,2762,24.55,7.64,6.03,4.49
09-12-2020,TROFA,621,44,1616,"[960,Max]",Extremamente Elevado,-112.0,"[Min,-30)",Fortemente decrescente,621,Norte,PORTO,1318,7201.76,38418,2336,1894,1231,939,684,1623,2854,4748,7084,533.44,98.36,65.93,39.63
09-12-2020,VAGOS,79,6,347,"[240,480]",Elevado,-264.0,"[Min,-30)",Fortemente decrescente,79,Centro,AVEIRO,0118,16491.5,22740,1320,1205,922,784,724,1508,2430,3635,4955,137.89,30.04,22.04,14.73
09-12-2020,VALE DE CAMBRA,121,9,567,"[480,960]",Muito Elevado,-343.0,"[Min,-30)",Fortemente decrescente,121,Norte,AVEIRO,0119,14733.47,21327,1491,1363,1005,831,798,1629,2634,3997,5488,144.76,37.25,27.13,17.88
09-12-2020,VALENÇA,83,6,625,"[480,960]",Muito Elevado,-452.0,"[Min,-30)",Fortemente decrescente,83,Norte,VIANA DO CASTELO,1608,11712.86,13290,867,791,582,582,503,1085,1667,2458,3325,113.46,28.39,20.99,14.23
09-12-2020,VALONGO,789,56,810,"[480,960]",Muito Elevado,-355.0,"[Min,-30)",Fortemente decrescente,789,Norte,PORTO,1315,7512.45,97444,5629,4696,3207,2462,1829,4291,7498,12194,17823,1297.18,237.26,162.33,99.81
09-12-2020,VALPAÇOS,163,12,1100,"[960,Max]",Extremamente Elevado,203.0,"[30,Max)",Fortemente crescente,163,Norte,VILA REAL,1712,54873.93,14818,1217,1118,999,928,997,1925,2924,4042,5259,27.0,9.58,7.37,5.33
09-12-2020,VELAS,0,0,0,"[0,240]",Moderado,-19.0,"[-30,-10)",Decrescente,0,Açores,AÇORES,4502,11738.38,5093,278,208,166,153,113,266,432,640,918,43.39,7.82,5.45,3.68
09-12-2020,VENDAS NOVAS,10,1,89,"[0,240]",Moderado,-9.0,"[-10,10)",Estável,10,Alentejo,ÉVORA,0712,22238.88,11255,677,768,655,501,532,1033,1688,2456,3133,50.61,14.09,11.04,7.59
09-12-2020,VIANA DO ALENTEJO,10,1,194,"[0,240]",Moderado,-155.0,"[Min,-30)",Fortemente decrescente,10,Alentejo,ÉVORA,0713,39367.29,5145,245,208,235,210,214,424,659,867,1112,13.07,2.82,2.2,1.67
09-12-2020,VIANA DO CASTELO,442,32,524,"[480,960]",Muito Elevado,29.0,"[10,30)",Crescente,442,Norte,VIANA DO CASTELO,1609,31902.01,84417,5470,4433,3591,3061,2982,6043,9634,14067,19537,264.61,61.24,44.09,30.2
09-12-2020,VIDIGUEIRA,5,0,91,"[0,240]",Moderado,36.0,"[30,Max)",Fortemente crescente,5,Alentejo,BEJA,0214,31661.09,5510,300,248,215,233,275,508,723,971,1271,17.4,4.01,3.07,2.28
09-12-2020,VIEIRA DO MINHO,150,11,1267,"[960,Max]",Extremamente Elevado,-212.0,"[Min,-30)",Fortemente decrescente,150,Norte,BRAGA,0311,21644.35,11842,703,594,525,548,482,1030,1555,2149,2852,54.71,13.18,9.93,7.18
09-12-2020,VILA DE REI,3,0,90,"[0,240]",Moderado,-30.0,"[-30,-10)",Decrescente,3,Centro,CASTELO BRANCO,0510,19154.6,3323,169,128,172,247,302,549,721,849,1018,17.35,5.31,4.43,3.76
09-12-2020,VILA DO BISPO,9,1,175,"[0,240]",Moderado,-78.0,"[Min,-30)",Fortemente decrescente,9,Algarve,FARO,0815,17906.06,5154,302,302,314,232,233,465,779,1081,1383,28.78,7.72,6.04,4.35
09-12-2020,VILA DO CONDE,860,61,1076,"[960,Max]",Extremamente Elevado,-424.0,"[Min,-30)",Fortemente decrescente,860,Norte,PORTO,1316,14902.77,79899,4726,3875,2819,2070,1743,3813,6632,10507,15233,536.13,102.21,70.5,44.5
09-12-2020,VILA DO PORTO,1,0,18,"[0,240]",Moderado,-18.0,"[-30,-10)",Decrescente,1,Açores,AÇORES,4101,9688.74,5616,274,212,135,96,123,219,354,566,840,57.96,8.67,5.84,3.65
09-12-2020,VILA FLOR,6,0,99,"[0,240]",Moderado,-67.0,"[Min,-30)",Fortemente decrescente,6,Norte,BRAGANÇA,0410,26581.14,6044,429,362,422,294,331,625,1047,1409,1838,22.74,6.91,5.3,3.94
09-12-2020,VILA FRANCA DE XIRA,556,40,392,"[240,480]",Elevado,-112.0,"[Min,-30)",Fortemente decrescente,556,Lisboa e Vale do Tejo,LISBOA,1114,31819.39,141957,8501,6852,4869,3425,2472,5897,10766,17618,26119,446.14,82.09,55.37,33.84
09-12-2020,VILA FRANCA DO CAMPO,25,2,226,"[0,240]",Moderado,27.0,"[10,30)",Crescente,25,Açores,AÇORES,4206,7796.82,11051,450,344,248,217,154,371,619,963,1413,141.73,18.12,12.35,7.94
09-12-2020,VILA NOVA DA BARQUINHA,14,1,188,"[0,240]",Moderado,-80.0,"[Min,-30)",Fortemente decrescente,14,Lisboa e Vale do Tejo,SANTARÉM,1420,4952.97,7461,415,406,392,364,338,702,1094,1500,1915,150.64,38.66,30.28,22.09
09-12-2020,VILA NOVA DE CERVEIRA,15,1,168,"[0,240]",Moderado,-134.0,"[Min,-30)",Fortemente decrescente,15,Norte,VIANA DO CASTELO,1610,10846.66,8910,531,444,410,384,334,718,1128,1572,2103,82.14,19.39,14.49,10.4
09-12-2020,VILA NOVA DE FAMALICÃO,1875,134,1424,"[960,Max]",Extremamente Elevado,-317.0,"[Min,-30)",Fortemente decrescente,1875,Norte,BRAGA,0312,20159.26,131676,7817,6164,4202,3282,2749,6031,10233,16397,24214,653.19,120.12,81.34,50.76
09-12-2020,VILA NOVA DE FOZ CÔA,19,1,292,"[240,480]",Elevado,-108.0,"[Min,-30)",Fortemente decrescente,19,Centro,GUARDA,0914,39815.18,6503,442,385,390,398,429,827,1217,1602,2044,16.33,5.13,4.02,3.06
09-12-2020,VILA NOVA DE GAIA,2326,166,774,"[480,960]",Muito Elevado,-201.0,"[Min,-30)",Fortemente decrescente,2326,Norte,PORTO,1317,16846.43,300472,18349,15568,10972,8224,6281,14505,25477,41045,59394,1783.64,352.57,243.65,151.23
09-12-2020,VILA NOVA DE PAIVA,17,1,363,"[240,480]",Elevado,-192.0,"[Min,-30)",Fortemente decrescente,17,Centro,VISEU,1822,17553.28,4687,289,272,233,217,241,458,691,963,1252,26.7,7.13,5.49,3.94
09-12-2020,VILA NOVA DE POIARES,19,1,274,"[240,480]",Elevado,-144.0,"[Min,-30)",Fortemente decrescente,19,Centro,COIMBRA,0617,8445.3,6939,380,284,262,235,182,417,679,963,1343,82.17,15.9,11.4,8.04
09-12-2020,VILA POUCA DE AGUIAR,176,13,1471,"[960,Max]",Extremamente Elevado,134.0,"[30,Max)",Fortemente crescente,176,Norte,VILA REAL,1713,43706.62,11961,860,817,733,601,627,1228,1961,2778,3638,27.37,8.32,6.36,4.49
09-12-2020,VILA REAL,262,19,524,"[480,960]",Muito Elevado,-132.0,"[Min,-30)",Fortemente decrescente,262,Norte,VILA REAL,1714,37880.28,49962,3025,2498,2065,1579,1466,3045,5110,7608,10633,131.9,28.07,20.08,13.49
09-12-2020,VILA REAL DE SANTO ANTÓNIO,19,1,101,"[0,240]",Moderado,-10.0,"[-10,10)",Estável,19,Algarve,FARO,0816,6125.0,18749,1172,1069,811,569,586,1155,1966,3035,4207,306.11,68.69,49.55,32.1
09-12-2020,VILA VELHA DE RÓDÃO,5,0,159,"[0,240]",Moderado,0.0,"[-10,10)",Estável,5,Centro,CASTELO BRANCO,0511,32991.16,3144,209,229,180,283,306,589,769,998,1207,9.53,3.66,3.03,2.33
09-12-2020,VILA VERDE,345,25,735,"[480,960]",Muito Elevado,-69.0,"[Min,-30)",Fortemente decrescente,345,Norte,BRAGA,0313,22866.52,46911,2365,2063,1667,1494,1437,2931,4598,6661,9026,205.15,39.47,29.13,20.11
09-12-2020,VILA VIÇOSA,15,1,196,"[0,240]",Moderado,-92.0,"[Min,-30)",Fortemente decrescente,15,Alentejo,ÉVORA,0714,19485.89,7656,487,379,342,345,324,669,1011,1390,1877,39.29,9.63,7.13,5.19
09-12-2020,VIMIOSO,56,4,1392,"[960,Max]",Extremamente Elevado,99.0,"[30,Max)",Fortemente crescente,56,Norte,BRAGANÇA,0411,48158.51,4023,274,230,261,293,335,628,889,1119,1393,8.35,2.89,2.32,1.85
09-12-2020,VINHAIS,30,2,387,"[240,480]",Elevado,-25.0,"[-30,-10)",Decrescente,30,Norte,BRAGANÇA,0412,69475.09,7746,599,577,636,641,815,1456,2092,2669,3268,11.15,4.7,3.84,3.01
09-12-2020,VISEU,426,30,438,"[240,480]",Elevado,-16.0,"[-30,-10)",Decrescente,426,Centro,VISEU,1823,50710.14,97249,5769,5038,4140,3158,2710,5868,10008,15046,20815,191.77,41.05,29.67,19.74
09-12-2020,VIZELA,158,11,661,"[480,960]",Muito Elevado,-849.0,"[Min,-30)",Fortemente decrescente,158,Norte,BRAGA,0314,2469.83,23897,1258,928,655,509,371,880,1535,2463,3721,967.49,150.65,99.72,62.15
09-12-2020,VOUZELA,15,1,156,"[0,240]",Moderado,-51.0,"[Min,-30)",Fortemente decrescente,15,Centro,VISEU,1824,19369.46,9619,626,605,554,532,507,1039,1593,2198,2824,49.66,14.58,11.35,8.22
18-12-2020,ABRANTES,94,7,268,"[240,480]",Elevado,,,,94,Lisboa e Vale do Tejo,SANTARÉM,1401,71469.08,35130,2473,2213,1730,1748,2021,3769,5499,7712,10185,49.15,14.25,10.79,7.69
18-12-2020,ÁGUEDA,238,17,517,"[480,960]",Muito Elevado,,,,238,Centro,AVEIRO,0101,33527.44,46075,3237,2713,2090,1635,1496,3131,5221,7934,11171,137.43,33.32,23.66,15.57
18-12-2020,AGUIAR DA BEIRA,50,4,1075,"[960,Max]",Extremamente Elevado,,,,50,Centro,GUARDA,0901,20676.57,4652,304,281,235,239,148,387,622,903,1207,22.5,5.84,4.37,3.01
18-12-2020,ALANDROAL,18,1,361,"[240,480]",Elevado,,,,18,Alentejo,ÉVORA,0701,54267.81,4992,307,256,296,299,377,676,972,1228,1535,9.2,2.83,2.26,1.79
18-12-2020,ALBERGARIA-A-VELHA,125,9,518,"[480,960]",Muito Elevado,,,,125,Centro,AVEIRO,0102,15882.5,24144,1550,1298,996,687,680,1367,2363,3661,5211,152.02,32.81,23.05,14.88
18-12-2020,ALBUFEIRA,82,6,197,"[0,240]",Moderado,,,,82,Algarve,FARO,0801,14066.42,41528,2067,1717,1425,985,858,1843,3268,4985,7052,295.24,50.14,35.44,23.23
18-12-2020,ALCÁCER DO SAL,40,3,343,"[240,480]",Elevado,,,,40,Alentejo,SETÚBAL,1501,149987.3,11659,884,814,623,623,602,1225,1848,2662,3546,7.77,2.36,1.77,1.23
18-12-2020,ALCANENA,34,2,265,"[240,480]",Elevado,,,,34,Lisboa e Vale do Tejo,SANTARÉM,1402,12732.86,12809,891,744,628,536,588,1124,1752,2496,3387,100.6,26.6,19.6,13.76
18-12-2020,ALCOBAÇA,86,6,161,"[0,240]",Moderado,,,,86,Lisboa e Vale do Tejo,LEIRIA,1001,40814.09,53555,3420,2927,2466,2059,1676,3735,6201,9128,12548,131.22,30.74,22.36,15.19
18-12-2020,ALCOCHETE,93,7,470,"[240,480]",Elevado,,,,93,Lisboa e Vale do Tejo,SETÚBAL,1502,12836.48,19787,857,834,691,476,447,923,1614,2448,3305,154.15,25.75,19.07,12.57
18-12-2020,ALCOUTIM,0,0,0,"[0,240]",Moderado,,,,0,Algarve,FARO,0802,57536.33,2159,191,188,163,190,267,457,620,808,999,3.75,1.74,1.4,1.08
18-12-2020,ALENQUER,328,23,745,"[480,960]",Muito Elevado,,,,328,Lisboa e Vale do Tejo,LISBOA,1101,30421.92,44052,2298,2062,1629,1330,1155,2485,4114,6176,8474,144.8,27.85,20.3,13.52
18-12-2020,ALFÂNDEGA DA FÉ,30,2,659,"[480,960]",Muito Elevado,,,,30,Norte,BRAGANÇA,0401,32194.64,4550,325,277,301,274,325,599,900,1177,1502,14.13,4.67,3.66,2.8
18-12-2020,ALIJÓ,33,2,311,"[240,480]",Elevado,,,,33,Norte,VILA REAL,1701,29759.89,10625,766,687,635,542,666,1208,1843,2530,3296,35.7,11.08,8.5,6.19
18-12-2020,ALJEZUR,7,0,125,"[0,240]",Moderado,,,,7,Algarve,FARO,0803,32349.95,5594,316,336,335,320,410,730,1065,1401,1717,17.29,5.31,4.33,3.29
18-12-2020,ALJUSTREL,1,0,12,"[0,240]",Moderado,,,,1,Alentejo,BEJA,0201,45847.41,8247,635,521,443,347,358,705,1148,1669,2304,17.99,5.03,3.64,2.5
18-12-2020,ALMADA,962,69,569,"[480,960]",Muito Elevado,,,,962,Lisboa e Vale do Tejo,SETÚBAL,1503,7000.89,169039,10469,9777,7876,6144,5111,11255,19131,28908,39377,2414.5,562.45,412.91,273.26
18-12-2020,ALMEIDA,35,2,600,"[480,960]",Muito Elevado,,,,35,Centro,GUARDA,0902,51798.46,5830,441,419,396,458,393,851,1247,1666,2107,11.26,4.07,3.22,2.41
18-12-2020,ALMEIRIM,53,4,235,"[0,240]",Moderado,,,,53,Lisboa e Vale do Tejo,SANTARÉM,1403,22212.05,22546,1342,1353,1106,866,843,1709,2815,4168,5510,101.5,24.81,18.76,12.67
18-12-2020,ALMODÔVAR,11,1,164,"[0,240]",Moderado,,,,11,Alentejo,BEJA,0202,77788.03,6725,414,443,396,373,328,701,1097,1540,1954,8.65,2.51,1.98,1.41
18-12-2020,ALPIARÇA,8,1,113,"[0,240]",Moderado,,,,8,Lisboa e Vale do Tejo,SANTARÉM,1404,9536.33,7059,515,486,363,333,274,607,970,1456,1971,74.02,20.67,15.27,10.17
18-12-2020,ALTER DO CHÃO,35,3,1106,"[960,Max]",Extremamente Elevado,,,,35,Alentejo,PORTALEGRE,1201,36206.62,3165,201,163,136,208,187,395,531,694,895,8.74,2.47,1.92,1.47
18-12-2020,ALVAIÁZERE,10,1,152,"[0,240]",Moderado,,,,10,Centro,LEIRIA,1002,16047.76,6597,419,389,346,406,539,945,1291,1680,2099,41.11,13.08,10.47,8.04
18-12-2020,ALVITO,5,0,202,"[0,240]",Moderado,,,,5,Alentejo,BEJA,0203,26485.32,2477,145,110,105,111,89,200,305,415,560,9.35,2.11,1.57,1.15
18-12-2020,AMADORA,709,51,385,"[240,480]",Elevado,,,,709,Lisboa e Vale do Tejo,LISBOA,1115,2378.47,184106,11186,10936,8780,6460,5890,12350,21130,32066,43252,7742.05,1818.84,1348.44,888.56
18-12-2020,AMARANTE,498,36,936,"[480,960]",Muito Elevado,,,,498,Norte,PORTO,1301,30133.15,53193,3086,2413,1812,1643,1311,2954,4766,7179,10265,176.53,34.07,23.82,15.82
18-12-2020,AMARES,124,9,684,"[480,960]",Muito Elevado,,,,124,Norte,BRAGA,0301,8195.41,18129,1001,829,622,489,524,1013,1635,2464,3465,221.22,42.28,30.07,19.95
18-12-2020,ANADIA,195,14,715,"[480,960]",Muito Elevado,,,,195,Centro,AVEIRO,0103,21663.48,27258,1931,1698,1376,1208,1262,2470,3846,5544,7475,125.83,34.51,25.59,17.75
18-12-2020,ANGRA DO HEROÍSMO,100,7,296,"[240,480]",Elevado,,,,100,Açores,AÇORES,4301,23899.66,33807,2006,1473,1122,768,635,1403,2525,3998,6004,141.45,25.12,16.73,10.56
18-12-2020,ANSIÃO,59,4,490,"[480,960]",Muito Elevado,,,,59,Centro,LEIRIA,1003,17609.42,12039,727,709,646,694,530,1224,1870,2579,3306,68.37,18.77,14.65,10.62
18-12-2020,ARCOS DE VALDEVEZ,36,3,172,"[0,240]",Moderado,,,,36,Norte,VIANA DO CASTELO,1601,44759.64,20926,1329,1338,1282,1343,1515,2858,4140,5478,6807,46.75,15.21,12.24,9.25
18-12-2020,ARGANIL,12,1,109,"[0,240]",Moderado,,,,12,Centro,COIMBRA,0601,33283.93,11014,672,648,612,559,596,1155,1767,2415,3087,33.09,9.27,7.26,5.31
18-12-2020,ARMAMAR,65,5,1127,"[960,Max]",Extremamente Elevado,,,,65,Norte,VISEU,1801,11723.73,5769,357,305,309,285,310,595,904,1209,1566,49.21,13.36,10.31,7.71
18-12-2020,AROUCA,117,8,565,"[480,960]",Muito Elevado,,,,117,Norte,AVEIRO,0104,32910.52,20720,1306,1047,753,683,683,1366,2119,3166,4472,62.96,13.59,9.62,6.44
18-12-2020,ARRAIOLOS,12,1,173,"[0,240]",Moderado,,,,12,Alentejo,ÉVORA,0702,68374.55,6928,435,384,283,367,480,847,1130,1514,1949,10.13,2.85,2.21,1.65
18-12-2020,ARRONCHES,2,0,71,"[0,240]",Moderado,,,,2,Alentejo,PORTALEGRE,1202,31464.72,2820,155,142,162,187,179,366,528,670,825,8.96,2.62,2.13,1.68
18-12-2020,ARRUDA DOS VINHOS,44,3,285,"[240,480]",Elevado,,,,44,Lisboa e Vale do Tejo,LISBOA,1102,7795.93,15412,738,738,562,509,438,947,1509,2247,2985,197.69,38.29,28.82,19.36
18-12-2020,AVEIRO,337,24,428,"[240,480]",Elevado,,,,337,Centro,AVEIRO,0105,19757.57,78734,4520,4004,3050,2250,2103,4353,7403,11407,15927,398.49,80.61,57.73,37.47
18-12-2020,AVIS,10,1,235,"[0,240]",Moderado,,,,10,Alentejo,PORTALEGRE,1203,60596.51,4247,315,225,206,251,273,524,730,955,1270,7.01,2.1,1.58,1.2
18-12-2020,AZAMBUJA,129,9,568,"[480,960]",Muito Elevado,,,,129,Lisboa e Vale do Tejo,LISBOA,1103,26265.65,22716,1322,1171,1070,798,618,1416,2486,3657,4979,86.48,18.96,13.92,9.46
18-12-2020,BAIÃO,142,10,757,"[480,960]",Muito Elevado,,,,142,Norte,PORTO,1302,17452.83,18748,1070,862,714,686,725,1411,2125,2987,4057,107.42,23.25,17.11,12.18
18-12-2020,BARCELOS,1214,87,1045,"[960,Max]",Extremamente Elevado,,,,1214,Norte,BRAGA,0302,37890.14,116187,6721,5325,3619,2991,2562,5553,9172,14497,21218,306.64,56.0,38.26,24.21
18-12-2020,BARRANCOS,0,0,0,"[0,240]",Moderado,,,,0,Alentejo,BEJA,0204,16841.73,1634,90,65,65,94,61,155,220,285,375,9.7,2.23,1.69,1.31
18-12-2020,BARREIRO,456,33,607,"[480,960]",Muito Elevado,,,,456,Lisboa e Vale do Tejo,SETÚBAL,1504,3639.07,75147,5194,5565,4459,3105,1767,4872,9331,14896,20090,2065.05,552.07,409.34,256.42
18-12-2020,BATALHA,60,4,376,"[240,480]",Elevado,,,,60,Centro,LEIRIA,1004,10341.6,15963,873,762,649,529,549,1078,1727,2489,3362,154.35,32.51,24.07,16.7
18-12-2020,BEJA,22,2,66,"[0,240]",Moderado,,,,22,Alentejo,BEJA,0205,114647.55,33579,2005,1840,1386,1272,1039,2311,3697,5537,7542,29.29,6.58,4.83,3.22
18-12-2020,BELMONTE,21,1,328,"[240,480]",Elevado,,,,21,Centro,CASTELO BRANCO,0501,11875.91,6398,444,321,325,310,355,665,990,1311,1755,53.87,14.78,11.04,8.34
18-12-2020,BENAVENTE,55,4,180,"[0,240]",Moderado,,,,55,Lisboa e Vale do Tejo,SANTARÉM,1405,52138.39,30602,1468,1376,1141,876,643,1519,2660,4036,5504,58.69,10.56,7.74,5.1
18-12-2020,BOMBARRAL,28,2,223,"[0,240]",Moderado,,,,28,Lisboa e Vale do Tejo,LEIRIA,1005,9128.55,12558,875,714,561,491,429,920,1481,2195,3070,137.56,33.63,24.04,16.22
18-12-2020,BORBA,11,1,163,"[0,240]",Moderado,,,,11,Alentejo,ÉVORA,0703,14518.65,6736,430,375,279,436,392,828,1107,1482,1912,46.39,13.17,10.21,7.62
18-12-2020,BOTICAS,27,2,540,"[480,960]",Muito Elevado,,,,27,Norte,VILA REAL,1702,32195.66,4998,347,306,311,305,380,685,996,1302,1649,15.52,5.12,4.04,3.09
18-12-2020,BRAGA,1441,103,789,"[480,960]",Muito Elevado,,,,1441,Norte,BRAGA,0303,18339.95,182679,10029,7963,5241,4320,3671,7991,13232,21195,31224,996.07,170.25,115.57,72.15
18-12-2020,BRAGANÇA,354,25,1053,"[960,Max]",Extremamente Elevado,,,,354,Norte,BRAGANÇA,0402,117357.27,33607,2402,1855,1652,1393,1163,2556,4208,6063,8465,28.64,7.21,5.17,3.59
18-12-2020,CABECEIRAS DE BASTO,58,4,371,"[240,480]",Elevado,,,,58,Norte,BRAGA,0304,24182.16,15628,774,594,544,575,574,1149,1693,2287,3061,64.63,12.66,9.46,7.0
18-12-2020,CADAVAL,13,1,95,"[0,240]",Moderado,,,,13,Lisboa e Vale do Tejo,LISBOA,1104,17489.3,13673,813,796,756,621,625,1246,2002,2798,3611,78.18,20.65,16.0,11.45
18-12-2020,CALDAS DA RAINHA,178,13,343,"[240,480]",Elevado,,,,178,Lisboa e Vale do Tejo,LEIRIA,1006,25569.47,51912,3035,2684,2186,1899,1705,3604,5790,8474,11509,203.03,45.01,33.14,22.64
18-12-2020,CALHETA,5,0,46,"[0,240]",Moderado,,,,5,Madeira,MADEIRA,3101,11150.43,10867,576,497,507,399,415,814,1321,1818,2394,97.46,21.47,16.3,11.85
18-12-2020,CALHETA (AÇORES),1,0,31,"[0,240]",Moderado,,,,1,Açores,AÇORES,4501,12626.4,3184,215,159,141,139,122,261,402,561,776,25.22,6.15,4.44,3.18
18-12-2020,CÂMARA DE LOBOS,35,3,104,"[0,240]",Moderado,,,,35,Madeira,MADEIRA,3102,5216.67,33675,1396,1059,834,545,381,926,1760,2819,4215,645.49,80.79,54.03,33.74
18-12-2020,CAMINHA,78,6,491,"[480,960]",Muito Elevado,,,,78,Norte,VIANA DO CASTELO,1602,13652.14,15877,1046,944,818,646,656,1302,2120,3064,4110,116.3,30.11,22.44,15.53
18-12-2020,CAMPO MAIOR,19,1,241,"[240,480]",Elevado,,,,19,Alentejo,PORTALEGRE,1204,24720.16,7874,471,364,351,279,327,606,957,1321,1792,31.85,7.25,5.34,3.87
18-12-2020,CANTANHEDE,139,10,397,"[240,480]",Elevado,,,,139,Centro,COIMBRA,0602,39088.02,35011,2346,2096,1880,1709,1451,3160,5040,7136,9482,89.57,24.26,18.26,12.89
18-12-2020,CARRAZEDA DE ANSIÃES,1,0,18,"[0,240]",Moderado,,,,1,Norte,BRAGANÇA,0403,27924.09,5666,424,389,391,312,465,777,1168,1557,1981,20.29,7.09,5.58,4.18
18-12-2020,CARREGAL DO SAL,30,2,324,"[240,480]",Elevado,,,,30,Centro,VISEU,1802,11689.21,9271,587,562,486,462,376,838,1324,1886,2473,79.31,21.16,16.13,11.33
18-12-2020,CARTAXO,59,4,247,"[240,480]",Elevado,,,,59,Lisboa e Vale do Tejo,SANTARÉM,1406,15817.28,23843,1415,1376,1142,861,632,1493,2635,4011,5426,150.74,34.3,25.36,16.66
18-12-2020,CASCAIS,852,61,399,"[240,480]",Elevado,,,,852,Lisboa e Vale do Tejo,LISBOA,1105,9740.17,213608,12151,11444,8680,6469,5248,11717,20397,31841,43992,2193.1,451.66,326.91,209.41
18-12-2020,CASTANHEIRA DE PÊRA,12,1,459,"[240,480]",Elevado,,,,12,Centro,LEIRIA,1007,6677.45,2614,233,195,157,190,187,377,534,729,962,39.15,14.41,10.92,8.0
18-12-2020,CASTELO BRANCO,259,18,498,"[480,960]",Muito Elevado,,,,259,Centro,CASTELO BRANCO,0502,143819.15,51987,3528,3042,2499,2229,2225,4454,6953,9995,13523,36.15,9.4,6.95,4.83
18-12-2020,CASTELO DE PAIVA,59,4,382,"[240,480]",Elevado,,,,59,Norte,AVEIRO,0106,11500.53,15454,881,697,545,420,431,851,1396,2093,2974,134.37,25.86,18.2,12.14
18-12-2020,CASTELO DE VIDE,69,5,2364,"[960,Max]",Extremamente Elevado,,,,69,Alentejo,PORTALEGRE,1205,26491.24,2919,204,173,179,147,170,317,496,669,873,11.02,3.3,2.53,1.87
18-12-2020,CASTRO DAIRE,57,4,412,"[240,480]",Elevado,,,,57,Centro,VISEU,1803,37904.13,13823,942,857,765,732,773,1505,2270,3127,4069,36.47,10.74,8.25,5.99
18-12-2020,CASTRO MARIM,13,1,208,"[0,240]",Moderado,,,,13,Algarve,FARO,0804,30084.37,6237,370,345,334,322,344,666,1000,1345,1715,20.73,5.7,4.47,3.32
18-12-2020,CASTRO VERDE,12,1,173,"[0,240]",Moderado,,,,12,Alentejo,BEJA,0206,56944.23,6949,437,347,303,275,227,502,805,1152,1589,12.2,2.79,2.02,1.41
18-12-2020,CELORICO DA BEIRA,20,1,289,"[240,480]",Elevado,,,,20,Centro,GUARDA,0903,24721.63,6928,430,416,363,369,535,904,1267,1683,2113,28.02,8.55,6.81,5.12
18-12-2020,CELORICO DE BASTO,68,5,357,"[240,480]",Elevado,,,,68,Norte,BRAGA,0305,18107.02,19040,1001,802,668,728,729,1457,2125,2927,3928,105.15,21.69,16.17,11.74
18-12-2020,CHAMUSCA,55,4,598,"[480,960]",Muito Elevado,,,,55,Lisboa e Vale do Tejo,SANTARÉM,1407,74600.54,9197,629,583,553,465,579,1044,1597,2180,2809,12.33,3.77,2.92,2.14
18-12-2020,CHAVES,773,55,1965,"[960,Max]",Extremamente Elevado,,,,773,Norte,VILA REAL,1703,59122.95,39343,2676,2429,1991,1886,1918,3804,5795,8224,10900,66.54,18.44,13.91,9.8
18-12-2020,CINFÃES,116,8,636,"[480,960]",Muito Elevado,,,,116,Norte,VISEU,1804,23928.76,18244,1067,902,779,734,758,1492,2271,3173,4240,76.24,17.72,13.26,9.49
18-12-2020,COIMBRA,585,42,436,"[240,480]",Elevado,,,,585,Centro,COIMBRA,0603,31939.94,134166,9489,8734,6353,5139,5074,10213,16566,25300,34789,420.06,108.92,79.21,51.87
18-12-2020,CONDEIXA-A-NOVA,71,5,400,"[240,480]",Elevado,,,,71,Centro,COIMBRA,0604,13867.47,17733,871,809,717,583,490,1073,1790,2599,3470,127.88,25.02,18.74,12.91
18-12-2020,CONSTÂNCIA,7,1,174,"[0,240]",Moderado,,,,7,Lisboa e Vale do Tejo,SANTARÉM,1408,8036.58,4030,211,183,187,148,155,303,490,673,884,50.14,11.0,8.37,6.1
18-12-2020,CORUCHE,29,2,166,"[0,240]",Moderado,,,,29,Lisboa e Vale do Tejo,SANTARÉM,1409,111572.03,17471,1294,1090,1095,1096,1019,2115,3210,4300,5594,15.66,5.01,3.85,2.88
18-12-2020,CORVO,0,0,0,"[0,240]",Moderado,,,,0,Açores,AÇORES,4901,1711.45,464,22,21,11,13,19,32,43,64,86,27.12,5.03,3.74,2.51
18-12-2020,COVILHÃ,205,15,438,"[240,480]",Elevado,,,,205,Centro,CASTELO BRANCO,0503,55560.06,46787,3533,2998,2365,2111,2193,4304,6669,9667,13200,84.21,23.76,17.4,12.0
18-12-2020,CRATO,46,3,1470,"[960,Max]",Extremamente Elevado,,,,46,Alentejo,PORTALEGRE,1206,39806.88,3129,229,258,163,182,228,410,573,831,1060,7.86,2.66,2.09,1.44
18-12-2020,CUBA,10,1,218,"[0,240]",Moderado,,,,10,Alentejo,BEJA,0207,17208.72,4595,255,233,206,190,143,333,539,772,1027,26.7,5.97,4.49,3.13
18-12-2020,ELVAS,55,4,268,"[240,480]",Elevado,,,,55,Alentejo,PORTALEGRE,1207,63128.86,20528,1057,1145,902,852,810,1662,2564,3709,4766,32.52,7.55,5.88,4.06
18-12-2020,ENTRONCAMENTO,42,3,195,"[0,240]",Moderado,,,,42,Lisboa e Vale do Tejo,SANTARÉM,1410,1372.81,21558,1066,930,868,695,592,1287,2155,3085,4151,1570.14,302.33,224.69,156.96
18-12-2020,ESPINHO,197,14,667,"[480,960]",Muito Elevado,,,,197,Norte,AVEIRO,0107,2105.68,29516,2205,1993,1430,1177,960,2137,3567,5560,7765,1401.52,368.71,264.01,169.37
18-12-2020,ESPOSENDE,418,30,1223,"[960,Max]",Extremamente Elevado,,,,418,Norte,BRAGA,0306,9540.98,34177,1831,1522,1095,894,723,1617,2712,4234,6065,358.21,63.57,44.38,28.42
18-12-2020,ESTARREJA,130,9,500,"[480,960]",Muito Elevado,,,,130,Centro,AVEIRO,0108,10817.33,26006,1503,1399,1106,953,728,1681,2787,4186,5689,240.42,52.59,38.7,25.76
18-12-2020,ESTREMOZ,20,1,157,"[0,240]",Moderado,,,,20,Alentejo,ÉVORA,0704,51379.95,12728,789,613,697,786,877,1663,2360,2973,3762,24.77,7.32,5.79,4.59
18-12-2020,ÉVORA,318,23,607,"[480,960]",Muito Elevado,,,,318,Alentejo,ÉVORA,0705,130707.58,52428,3569,2852,2176,1966,1803,3769,5945,8797,12366,40.11,9.46,6.73,4.55
18-12-2020,FAFE,288,21,599,"[480,960]",Muito Elevado,,,,288,Norte,BRAGA,0307,21908.11,48060,3044,2455,1679,1403,1208,2611,4290,6745,9789,219.37,44.68,30.79,19.58
18-12-2020,FARO,157,11,257,"[240,480]",Elevado,,,,157,Algarve,FARO,0805,20256.79,61015,3847,3364,2604,2055,1601,3656,6260,9624,13471,301.2,66.5,47.51,30.9
18-12-2020,FELGUEIRAS,465,33,824,"[480,960]",Muito Elevado,,,,465,Norte,PORTO,1303,11573.75,56422,2951,2302,1601,1316,973,2289,3890,6192,9143,487.49,79.0,53.5,33.61
18-12-2020,FERREIRA DO ALENTEJO,6,0,76,"[0,240]",Moderado,,,,6,Alentejo,BEJA,0208,64820.68,7845,515,414,372,343,345,688,1060,1474,1989,12.1,3.07,2.27,1.64
18-12-2020,FERREIRA DO ZÊZERE,4,0,50,"[0,240]",Moderado,,,,4,Lisboa e Vale do Tejo,SANTARÉM,1411,19038.03,7959,470,370,416,465,456,921,1337,1707,2177,41.81,11.44,8.97,7.02
18-12-2020,FIGUEIRA DA FOZ,239,17,407,"[240,480]",Elevado,,,,239,Centro,COIMBRA,0605,37905.26,58747,4032,3597,2887,2495,2043,4538,7425,11022,15054,154.98,39.72,29.08,19.59
18-12-2020,FIGUEIRA DE CASTELO RODRIGO,39,3,698,"[480,960]",Muito Elevado,,,,39,Centro,GUARDA,0904,50857.46,5584,347,352,290,352,391,743,1033,1385,1732,10.98,3.41,2.72,2.03
18-12-2020,FIGUEIRÓ DOS VINHOS,32,2,575,"[480,960]",Muito Elevado,,,,32,Centro,LEIRIA,1008,17344.0,5568,402,386,322,309,351,660,982,1368,1770,32.1,10.21,7.89,5.66
18-12-2020,FORNOS DE ALGODRES,8,1,177,"[0,240]",Moderado,,,,8,Centro,GUARDA,0905,13145.05,4528,261,218,247,256,232,488,735,953,1214,34.45,9.24,7.25,5.59
18-12-2020,FREIXO DE ESPADA À CINTA,16,1,485,"[480,960]",Muito Elevado,,,,16,Norte,BRAGANÇA,0404,24414.29,3298,211,177,231,196,189,385,616,793,1004,13.51,4.11,3.25,2.52
18-12-2020,FRONTEIRA,3,0,101,"[0,240]",Moderado,,,,3,Alentejo,PORTALEGRE,1208,24859.58,2974,213,182,149,156,168,324,473,655,868,11.96,3.49,2.63,1.9
18-12-2020,FUNCHAL,105,8,101,"[0,240]",Moderado,,,,105,Madeira,MADEIRA,3103,7616.2,104024,6382,5086,3643,2821,1990,4811,8454,13540,19922,1365.86,261.58,177.78,111.0
18-12-2020,FUNDÃO,78,6,294,"[240,480]",Elevado,,,,78,Centro,CASTELO BRANCO,0504,70019.79,26495,1781,1464,1432,1357,1643,3000,4432,5896,7677,37.84,10.96,8.42,6.33
18-12-2020,GAVIÃO,49,4,1502,"[960,Max]",Extremamente Elevado,,,,49,Alentejo,PORTALEGRE,1209,29459.45,3263,189,186,222,263,293,556,778,964,1153,11.08,3.91,3.27,2.64
18-12-2020,GÓIS,7,1,184,"[0,240]",Moderado,,,,7,Centro,COIMBRA,0606,26330.19,3805,235,199,240,233,244,477,717,916,1151,14.45,4.37,3.48,2.72
18-12-2020,GOLEGÃ,14,1,262,"[240,480]",Elevado,,,,14,Lisboa e Vale do Tejo,SANTARÉM,1412,8431.67,5339,356,299,281,243,255,498,779,1078,1434,63.32,17.01,12.78,9.24
18-12-2020,GONDOMAR,1029,74,620,"[480,960]",Muito Elevado,,,,1029,Norte,PORTO,1304,13191.76,165985,10555,8755,6222,4450,3364,7814,14036,22791,33346,1258.22,252.77,172.76,106.4
18-12-2020,GOUVEIA,56,4,452,"[240,480]",Elevado,,,,56,Centro,GUARDA,0906,30061.17,12387,871,931,780,783,810,1593,2373,3304,4175,41.21,13.89,10.99,7.89
18-12-2020,GRÂNDOLA,83,6,567,"[480,960]",Muito Elevado,,,,83,Alentejo,SETÚBAL,1505,82593.66,14639,834,834,708,688,672,1360,2068,2902,3736,17.72,4.52,3.51,2.5
18-12-2020,GUARDA,229,16,588,"[480,960]",Muito Elevado,,,,229,Centro,GUARDA,0907,71209.58,38969,2477,2041,1686,1415,1474,2889,4575,6616,9093,54.72,12.77,9.29,6.42
18-12-2020,GUIMARÃES,1519,108,997,"[960,Max]",Extremamente Elevado,,,,1519,Norte,BRAGA,0308,24099.96,152309,9394,7074,4809,3877,2948,6825,11634,18708,28102,631.99,116.61,77.63,48.27
18-12-2020,HORTA,1,0,7,"[0,240]",Moderado,,,,1,Açores,AÇORES,4701,17305.53,14521,818,658,468,352,302,654,1122,1780,2598,83.91,15.01,10.29,6.48
18-12-2020,IDANHA-A-NOVA,47,3,584,"[480,960]",Muito Elevado,,,,47,Centro,CASTELO BRANCO,0505,141633.51,8043,518,490,519,672,974,1646,2165,2655,3173,5.68,2.24,1.87,1.53
18-12-2020,ÍLHAVO,213,15,550,"[480,960]",Muito Elevado,,,,213,Centro,AVEIRO,0110,7347.55,38699,2227,1943,1444,1193,850,2043,3487,5430,7657,526.66,104.21,73.9,47.46
18-12-2020,LAGOA (FARO),25,2,110,"[0,240]",Moderado,,,,25,Algarve,FARO,0806,8825.45,22762,1314,1168,919,749,670,1419,2338,3506,4820,257.93,54.62,39.73,26.49
18-12-2020,LAGOA,22,2,149,"[0,240]",Moderado,,,,22,Açores,AÇORES,4201,4559.32,14721,536,458,349,238,235,473,822,1280,1816,322.9,39.83,28.08,18.03
18-12-2020,LAGOS,55,4,181,"[0,240]",Moderado,,,,55,Algarve,FARO,0807,21299.27,30374,1744,1434,1247,1053,1029,2082,3329,4763,6507,142.61,30.55,22.36,15.63
18-12-2020,LAJES DAS FLORES,0,0,0,"[0,240]",Moderado,,,,0,Açores,AÇORES,4801,7004.79,1463,88,53,62,46,54,100,162,215,303,20.89,4.33,3.07,2.31
18-12-2020,LAJES DO PICO,1,0,22,"[0,240]",Moderado,,,,1,Açores,AÇORES,4601,15531.09,4490,304,231,223,159,162,321,544,775,1079,28.91,6.95,4.99,3.5
18-12-2020,LAMEGO,219,16,880,"[480,960]",Muito Elevado,,,,219,Norte,VISEU,1805,16542.11,24895,1639,1284,1124,898,783,1681,2805,4089,5728,150.5,34.63,24.72,16.96
18-12-2020,LEIRIA,585,42,467,"[240,480]",Elevado,,,,585,Centro,LEIRIA,1009,56508.83,125267,7389,6366,5090,3902,3159,7061,12151,18517,25906,221.68,45.84,32.77,21.5
18-12-2020,LISBOA,2639,189,518,"[480,960]",Muito Elevado,,,,2639,Lisboa e Vale do Tejo,LISBOA,1106,10005.43,509515,33197,33340,27706,23037,26770,49807,77513,110853,144050,5092.6,1439.78,1107.98,774.74
18-12-2020,LOULÉ,168,12,245,"[240,480]",Elevado,,,,168,Algarve,FARO,0808,76366.91,68697,3890,3350,2780,2358,2251,4609,7389,10739,14629,89.96,19.16,14.06,9.68
18-12-2020,LOURES,716,51,335,"[240,480]",Elevado,,,,716,Lisboa e Vale do Tejo,LISBOA,1107,16723.99,213687,12746,12794,9644,6669,5033,11702,21346,34140,46886,1277.73,280.35,204.14,127.64
18-12-2020,LOURINHÃ,98,7,379,"[240,480]",Elevado,,,,98,Lisboa e Vale do Tejo,LISBOA,1108,14717.2,25855,1584,1243,992,842,645,1487,2479,3722,5306,175.68,36.05,25.29,16.84
18-12-2020,LOUSÃ,46,3,268,"[240,480]",Elevado,,,,46,Centro,COIMBRA,0607,13840.01,17158,946,866,658,528,450,978,1636,2502,3448,123.97,24.91,18.08,11.82
18-12-2020,LOUSADA,297,21,635,"[480,960]",Muito Elevado,,,,297,Norte,PORTO,1305,9608.01,46755,2289,1698,1176,853,621,1474,2650,4348,6637,486.63,69.08,45.25,27.58
18-12-2020,MAÇÃO,6,0,96,"[0,240]",Moderado,,,,6,Lisboa e Vale do Tejo,SANTARÉM,1413,39997.98,6267,386,362,390,440,657,1097,1487,1849,2235,15.67,5.59,4.62,3.72
18-12-2020,MACEDO DE CAVALEIROS,50,4,344,"[240,480]",Elevado,,,,50,Norte,BRAGANÇA,0405,69914.08,14516,1082,889,878,823,938,1761,2639,3528,4610,20.76,6.59,5.05,3.77
18-12-2020,MACHICO,21,1,105,"[0,240]",Moderado,,,,21,Madeira,MADEIRA,3104,6825.1,19981,1197,860,662,455,331,786,1448,2308,3505,292.76,51.36,33.82,21.22
18-12-2020,MADALENA,0,0,0,"[0,240]",Moderado,,,,0,Açores,AÇORES,4602,14712.33,5895,334,256,173,190,179,369,542,798,1132,40.07,7.69,5.42,3.68
18-12-2020,MAFRA,299,21,353,"[240,480]",Elevado,,,,299,Lisboa e Vale do Tejo,LISBOA,1109,29165.5,84816,3613,3334,2839,2089,1899,3988,6827,10161,13774,290.81,47.23,34.84,23.41
18-12-2020,MAIA,820,59,590,"[480,960]",Muito Elevado,,,,820,Norte,PORTO,1306,8293.94,138971,7801,6617,4512,3339,2631,5970,10482,17099,24900,1675.56,300.22,206.16,126.38
18-12-2020,MANGUALDE,44,3,238,"[0,240]",Moderado,,,,44,Centro,VISEU,1806,21925.56,18510,1198,1128,885,852,743,1595,2480,3608,4806,84.42,21.92,16.46,11.31
18-12-2020,MANTEIGAS,11,1,366,"[240,480]",Elevado,,,,11,Centro,GUARDA,0908,12197.55,3007,258,197,159,167,146,313,472,669,927,24.65,7.6,5.48,3.87
18-12-2020,MARCO DE CANAVESES,404,29,785,"[480,960]",Muito Elevado,,,,404,Norte,PORTO,1307,20188.98,51496,2678,2060,1488,1265,1023,2288,3776,5836,8514,255.07,42.17,28.91,18.7
18-12-2020,MARINHA GRANDE,118,8,306,"[240,480]",Elevado,,,,118,Centro,LEIRIA,1010,18725.19,38508,2365,2302,1638,1359,1058,2417,4055,6357,8722,205.65,46.58,33.95,21.66
18-12-2020,MARVÃO,86,6,2862,"[960,Max]",Extremamente Elevado,,,,86,Alentejo,PORTALEGRE,1210,15489.9,3005,198,185,142,197,237,434,576,761,959,19.4,6.19,4.91,3.72
18-12-2020,MATOSINHOS,1001,72,571,"[480,960]",Muito Elevado,,,,1001,Norte,PORTO,1308,6241.97,175357,11850,9977,7023,5024,3884,8908,15931,25908,37758,2809.31,604.9,415.06,255.22
18-12-2020,MEALHADA,115,8,577,"[480,960]",Muito Elevado,,,,115,Centro,AVEIRO,0111,11065.66,19914,1163,1039,810,828,831,1659,2469,3508,4671,179.96,42.21,31.7,22.31
18-12-2020,MÊDA,5,0,109,"[0,240]",Moderado,,,,5,Centro,GUARDA,0909,28604.92,4587,343,306,290,288,443,731,1021,1327,1670,16.04,5.84,4.64,3.57
18-12-2020,MELGAÇO,11,1,136,"[0,240]",Moderado,,,,11,Norte,VIANA DO CASTELO,1603,23824.58,8093,507,567,578,614,675,1289,1867,2434,2941,33.97,12.34,10.22,7.84
18-12-2020,MÉRTOLA,45,3,733,"[480,960]",Muito Elevado,,,,45,Alentejo,BEJA,0209,129287.34,6142,400,390,378,423,600,1023,1401,1791,2191,4.75,1.69,1.39,1.08
18-12-2020,MESÃO FRIO,25,2,630,"[480,960]",Muito Elevado,,,,25,Norte,VILA REAL,1704,2664.87,3964,265,205,168,157,120,277,445,650,915,148.74,34.33,24.39,16.7
18-12-2020,MIRA,37,3,313,"[240,480]",Elevado,,,,37,Centro,COIMBRA,0608,12403.38,11832,727,729,659,550,466,1016,1675,2404,3131,95.4,25.24,19.38,13.5
18-12-2020,MIRANDA DO CORVO,84,6,661,"[480,960]",Muito Elevado,,,,84,Centro,COIMBRA,0609,12637.79,12708,706,659,568,498,404,902,1470,2129,2835,100.55,22.43,16.85,11.63
18-12-2020,MIRANDA DO DOURO,50,4,732,"[480,960]",Muito Elevado,,,,50,Norte,BRAGANÇA,0406,48718.31,6830,482,429,442,463,470,933,1375,1804,2286,14.02,4.69,3.7,2.82
18-12-2020,MIRANDELA,87,6,400,"[240,480]",Elevado,,,,87,Norte,BRAGANÇA,0407,65895.67,21754,1640,1315,1204,1078,947,2025,3229,4544,6184,33.01,9.38,6.9,4.9
18-12-2020,MOGADOURO,23,2,274,"[240,480]",Elevado,,,,23,Norte,BRAGANÇA,0408,76064.93,8392,589,529,576,630,655,1285,1861,2390,2979,11.03,3.92,3.14,2.45
18-12-2020,MOIMENTA DA BEIRA,31,2,318,"[240,480]",Elevado,,,,31,Norte,VISEU,1807,21996.9,9736,576,514,471,416,461,877,1348,1862,2438,44.26,11.08,8.46,6.13
18-12-2020,MOITA,420,30,652,"[480,960]",Muito Elevado,,,,420,Lisboa e Vale do Tejo,SETÚBAL,1506,5525.98,64407,4226,3646,2623,1801,1425,3226,5849,9495,13721,1165.53,248.3,171.82,105.85
18-12-2020,MONÇÃO,91,6,509,"[480,960]",Muito Elevado,,,,91,Norte,VIANA DO CASTELO,1604,21130.85,17869,1161,1105,1031,1006,972,1978,3009,4114,5275,84.56,24.96,19.47,14.24
18-12-2020,MONCHIQUE,7,1,138,"[0,240]",Moderado,,,,7,Algarve,FARO,0809,39530.43,5077,353,384,321,355,392,747,1068,1452,1805,12.84,4.57,3.67,2.7
18-12-2020,MONDIM DE BASTO,120,9,1728,"[960,Max]",Extremamente Elevado,,,,120,Norte,VILA REAL,1705,17207.52,6946,395,300,314,284,283,567,881,1181,1576,40.36,9.16,6.86,5.12
18-12-2020,MONFORTE,37,3,1244,"[960,Max]",Extremamente Elevado,,,,37,Alentejo,PORTALEGRE,1211,42024.82,2975,139,115,117,192,168,360,477,592,731,7.08,1.74,1.41,1.14
18-12-2020,MONTALEGRE,52,4,578,"[480,960]",Muito Elevado,,,,52,Norte,VILA REAL,1706,80545.71,8997,699,628,595,603,730,1333,1928,2556,3255,11.17,4.04,3.17,2.39
18-12-2020,MONTEMOR-O-NOVO,117,8,748,"[480,960]",Muito Elevado,,,,117,Alentejo,ÉVORA,0706,123296.65,15647,991,953,868,878,971,1849,2717,3670,4661,12.69,3.78,2.98,2.2
18-12-2020,MONTEMOR-O-VELHO,85,6,337,"[240,480]",Elevado,,,,85,Centro,COIMBRA,0610,22896.23,25224,1496,1397,1217,1057,988,2045,3262,4659,6155,110.17,26.88,20.35,14.25
18-12-2020,MONTIJO,363,26,630,"[480,960]",Muito Elevado,,,,363,Lisboa e Vale do Tejo,SETÚBAL,1507,34861.64,57614,2771,2441,1990,1554,1109,2663,4653,7094,9865,165.26,28.3,20.35,13.35
18-12-2020,MORA,8,1,193,"[0,240]",Moderado,,,,8,Alentejo,ÉVORA,0707,44395.02,4138,336,275,252,238,257,495,747,1022,1358,9.32,3.06,2.3,1.68
18-12-2020,MORTÁGUA,118,8,1340,"[960,Max]",Extremamente Elevado,,,,118,Centro,VISEU,1808,25117.82,8803,638,584,535,499,460,959,1494,2078,2716,35.05,10.81,8.27,5.95
18-12-2020,MOURA,8,1,58,"[0,240]",Moderado,,,,8,Alentejo,BEJA,0210,95845.55,13718,817,656,665,542,461,1003,1668,2324,3141,14.31,3.28,2.42,1.74
18-12-2020,MOURÃO,44,3,1796,"[960,Max]",Extremamente Elevado,,,,44,Alentejo,ÉVORA,0708,27862.98,2450,139,108,80,104,109,213,293,401,540,8.79,1.94,1.44,1.05
18-12-2020,MURÇA,29,2,530,"[480,960]",Muito Elevado,,,,29,Norte,VILA REAL,1707,18937.11,5463,384,341,307,306,319,625,932,1273,1657,28.85,8.75,6.72,4.92
18-12-2020,MURTOSA,75,5,730,"[480,960]",Muito Elevado,,,,75,Centro,AVEIRO,0112,7308.78,10279,509,473,403,353,409,762,1165,1638,2147,140.63,29.37,22.41,15.94
18-12-2020,NAZARÉ,19,1,134,"[0,240]",Moderado,,,,19,Lisboa e Vale do Tejo,LEIRIA,1011,8243.43,14165,967,903,670,420,396,816,1486,2389,3356,171.84,40.71,28.98,18.03
18-12-2020,NELAS,111,8,856,"[480,960]",Muito Elevado,,,,111,Centro,VISEU,1809,12571.48,12974,924,787,668,604,583,1187,1855,2642,3566,103.21,28.37,21.02,14.76
18-12-2020,NISA,27,2,445,"[240,480]",Elevado,,,,27,Alentejo,PORTALEGRE,1212,57567.84,6061,405,389,355,483,478,961,1316,1705,2110,10.53,3.67,2.96,2.29
18-12-2020,NORDESTE,3,0,62,"[0,240]",Moderado,,,,3,Açores,AÇORES,4202,10146.8,4862,246,180,124,161,162,323,447,627,873,47.92,8.6,6.18,4.41
18-12-2020,ÓBIDOS,31,2,262,"[240,480]",Elevado,,,,31,Lisboa e Vale do Tejo,LEIRIA,1012,14155.44,11850,743,650,574,452,436,888,1462,2112,2855,83.72,20.17,14.92,10.33
18-12-2020,ODEMIRA,106,8,429,"[240,480]",Elevado,,,,106,Alentejo,BEJA,0211,172060.15,24717,1475,1317,1225,1397,1349,2746,3971,5288,6763,14.37,3.93,3.07,2.31
18-12-2020,ODIVELAS,688,49,425,"[240,480]",Elevado,,,,688,Lisboa e Vale do Tejo,LISBOA,1116,2654.36,161774,9562,9038,6952,4641,3812,8453,15405,24443,34005,6095.48,1281.27,920.99,580.44
18-12-2020,OEIRAS,564,40,318,"[240,480]",Elevado,,,,564,Lisboa e Vale do Tejo,LISBOA,1110,4588.31,177408,11580,11575,8566,6211,5855,12066,20632,32207,43787,3866.78,954.38,701.98,449.69
18-12-2020,OLEIROS,2,0,40,"[0,240]",Moderado,,,,2,Centro,CASTELO BRANCO,0506,47109.31,5003,384,341,366,397,487,884,1250,1591,1975,10.62,4.19,3.38,2.65
18-12-2020,OLHÃO,70,5,158,"[0,240]",Moderado,,,,70,Algarve,FARO,0810,13086.38,44405,2455,2309,1689,1342,1268,2610,4299,6608,9063,339.33,69.26,50.5,32.85
18-12-2020,OLIVEIRA DE AZEMÉIS,648,46,981,"[960,Max]",Extremamente Elevado,,,,648,Norte,AVEIRO,0113,16110.41,66011,4155,3614,2794,2183,1738,3921,6715,10329,14484,409.75,89.91,64.12,41.68
18-12-2020,OLIVEIRA DE FRADES,18,1,181,"[0,240]",Moderado,,,,18,Centro,VISEU,1810,14534.62,9936,553,475,438,359,415,774,1212,1687,2240,68.36,15.41,11.61,8.34
18-12-2020,OLIVEIRA DO BAIRRO,76,5,313,"[240,480]",Elevado,,,,76,Centro,AVEIRO,0114,8731.99,24277,1327,1182,999,786,810,1596,2595,3777,5104,278.02,58.45,43.25,29.72
18-12-2020,OLIVEIRA DO HOSPITAL,117,8,608,"[480,960]",Muito Elevado,,,,117,Centro,COIMBRA,0611,23451.66,19253,1161,1097,962,924,960,1884,2846,3943,5104,82.1,21.76,16.81,12.14
18-12-2020,OURÉM,124,9,282,"[240,480]",Elevado,,,,124,Lisboa e Vale do Tejo,SANTARÉM,1421,41668.03,44044,2463,2069,1899,1817,1603,3420,5319,7388,9851,105.7,23.64,17.73,12.77
18-12-2020,OURIQUE,2,0,43,"[0,240]",Moderado,,,,2,Alentejo,BEJA,0212,66331.36,4607,313,287,284,268,227,495,779,1066,1379,6.95,2.08,1.61,1.17
18-12-2020,OVAR,279,20,514,"[480,960]",Muito Elevado,,,,279,Centro,AVEIRO,0115,14770.25,54260,3294,2709,1994,1636,1234,2870,4864,7573,10867,367.37,73.57,51.27,32.93
18-12-2020,PAÇOS DE FERREIRA,288,21,508,"[480,960]",Muito Elevado,,,,288,Norte,PORTO,1309,7099.29,56728,2903,2193,1518,1135,664,1799,3317,5510,8413,799.1,118.51,77.62,46.72
18-12-2020,PALMELA,278,20,433,"[240,480]",Elevado,,,,278,Lisboa e Vale do Tejo,SETÚBAL,1508,46512.01,64269,3402,3244,2635,1846,1391,3237,5872,9116,12518,138.18,26.91,19.6,12.62
18-12-2020,PAMPILHOSA DA SERRA,9,1,223,"[0,240]",Moderado,,,,9,Centro,COIMBRA,0612,39646.24,4037,238,254,295,339,423,762,1057,1311,1549,10.18,3.91,3.31,2.67
18-12-2020,PAREDES,581,41,675,"[480,960]",Muito Elevado,,,,581,Norte,PORTO,1310,15675.69,86067,4272,3532,2412,1717,1258,2975,5387,8919,13191,549.04,84.15,56.9,34.36
18-12-2020,PAREDES DE COURA,14,1,164,"[0,240]",Moderado,,,,14,Norte,VIANA DO CASTELO,1605,13818.59,8535,466,528,407,465,515,980,1387,1915,2381,61.76,17.23,13.86,10.04
18-12-2020,PEDRÓGÃO GRANDE,5,0,147,"[0,240]",Moderado,,,,5,Centro,LEIRIA,1013,12874.75,3410,175,173,196,221,252,473,669,842,1017,26.49,7.9,6.54,5.2
18-12-2020,PENACOVA,73,5,533,"[480,960]",Muito Elevado,,,,73,Centro,COIMBRA,0613,21673.23,13694,968,923,745,621,703,1324,2069,2992,3960,63.18,18.27,13.81,9.55
18-12-2020,PENAFIEL,402,29,576,"[480,960]",Muito Elevado,,,,402,Norte,PORTO,1311,21224.27,69772,3648,2823,2032,1663,1230,2893,4925,7748,11396,328.74,53.69,36.51,23.2
18-12-2020,PENALVA DO CASTELO,13,1,183,"[0,240]",Moderado,,,,13,Centro,VISEU,1811,13433.92,7115,449,457,413,391,426,817,1230,1687,2136,52.96,15.9,12.56,9.16
18-12-2020,PENAMACOR,80,6,1682,"[960,Max]",Extremamente Elevado,,,,80,Centro,CASTELO BRANCO,0507,56370.69,4755,262,248,273,451,633,1084,1357,1605,1867,8.44,3.31,2.85,2.41
18-12-2020,PENEDONO,9,1,347,"[240,480]",Elevado,,,,9,Norte,VISEU,1812,13370.75,2591,172,113,129,156,138,294,423,536,708,19.38,5.3,4.01,3.16
18-12-2020,PENELA,19,1,352,"[240,480]",Elevado,,,,19,Centro,COIMBRA,0614,13480.0,5397,314,324,274,359,344,703,977,1301,1615,40.04,11.98,9.65,7.25
18-12-2020,PENICHE,107,8,404,"[240,480]",Elevado,,,,107,Lisboa e Vale do Tejo,LEIRIA,1014,7754.98,26501,1746,1504,1203,926,707,1633,2836,4340,6086,341.73,78.48,55.96,36.57
18-12-2020,PESO DA RÉGUA,99,7,627,"[480,960]",Muito Elevado,,,,99,Norte,VILA REAL,1708,9486.01,15773,1076,843,650,659,455,1114,1764,2607,3683,166.28,38.83,27.48,18.6
18-12-2020,PINHEL,131,9,1539,"[960,Max]",Extremamente Elevado,,,,131,Centro,GUARDA,0910,48452.12,8511,577,566,551,538,689,1227,1778,2344,2921,17.57,6.03,4.84,3.67
18-12-2020,POMBAL,177,13,344,"[240,480]",Elevado,,,,177,Centro,LEIRIA,1015,62600.28,51461,3187,2791,2494,2328,2027,4355,6849,9640,12827,82.21,20.49,15.4,10.94
18-12-2020,PONTA DELGADA,69,5,102,"[0,240]",Moderado,,,,69,Açores,AÇORES,4203,23298.65,67935,3108,2435,1726,1133,902,2035,3761,6196,9304,291.58,39.93,26.59,16.14
18-12-2020,PONTA DO SOL,3,0,35,"[0,240]",Moderado,,,,3,Madeira,MADEIRA,3105,4622.03,8593,319,283,347,208,221,429,776,1059,1378,185.92,29.81,22.91,16.79
18-12-2020,PONTE DA BARCA,74,5,662,"[480,960]",Muito Elevado,,,,74,Norte,VIANA DO CASTELO,1606,18211.37,11180,635,576,517,554,490,1044,1561,2137,2772,61.39,15.22,11.73,8.57
18-12-2020,PONTE DE LIMA,227,16,549,"[480,960]",Muito Elevado,,,,227,Norte,VIANA DO CASTELO,1607,32025.46,41315,2321,2022,1720,1596,1462,3058,4778,6800,9121,129.01,28.48,21.23,14.92
18-12-2020,PONTE DE SOR,30,2,200,"[0,240]",Moderado,,,,30,Alentejo,PORTALEGRE,1213,83971.16,14994,939,800,716,739,831,1570,2286,3086,4025,17.86,4.79,3.68,2.72
18-12-2020,PORTALEGRE,193,14,870,"[480,960]",Muito Elevado,,,,193,Alentejo,PORTALEGRE,1214,44713.64,22172,1577,1351,1137,993,984,1977,3114,4465,6042,49.59,13.51,9.99,6.96
18-12-2020,PORTEL,5,0,86,"[0,240]",Moderado,,,,5,Alentejo,ÉVORA,0709,60100.57,5828,336,358,283,331,305,636,919,1277,1613,9.7,2.68,2.12,1.53
18-12-2020,PORTIMÃO,137,10,247,"[240,480]",Elevado,,,,137,Algarve,FARO,0811,18206.29,55483,3182,2927,2116,1582,1400,2982,5098,8025,11207,304.75,61.56,44.08,28.0
18-12-2020,PORTO,1352,97,624,"[480,960]",Muito Elevado,,,,1352,Norte,PORTO,1312,4142.02,216606,15790,15193,11280,9409,10044,19453,30733,45926,61716,5229.5,1490.0,1108.79,741.98
18-12-2020,PORTO DE MÓS,143,10,614,"[480,960]",Muito Elevado,,,,143,Centro,LEIRIA,1016,26183.41,23275,1355,1210,1034,888,872,1760,2794,4004,5359,88.89,20.47,15.29,10.67
18-12-2020,PORTO MONIZ,1,0,43,"[0,240]",Moderado,,,,1,Madeira,MADEIRA,3106,8293.38,2342,143,130,95,98,120,218,313,443,586,28.24,7.07,5.34,3.77
18-12-2020,PORTO SANTO,1,0,19,"[0,240]",Moderado,,,,1,Madeira,MADEIRA,3201,4300.7,5202,240,157,134,110,68,178,312,469,709,120.95,16.48,10.9,7.25
18-12-2020,PÓVOA DE LANHOSO,241,17,1121,"[960,Max]",Extremamente Elevado,,,,241,Norte,BRAGA,0309,13465.29,21499,1175,909,732,673,624,1297,2029,2938,4113,159.67,30.55,21.82,15.07
18-12-2020,PÓVOA DE VARZIM,715,51,1139,"[960,Max]",Extremamente Elevado,,,,715,Norte,PORTO,1313,8220.59,62784,3712,3120,2134,1594,1305,2899,5033,8153,11865,763.7,144.33,99.17,61.22
18-12-2020,POVOAÇÃO,4,0,67,"[0,240]",Moderado,,,,4,Açores,AÇORES,4204,10640.77,5927,293,212,191,144,134,278,469,681,974,55.7,9.15,6.4,4.41
18-12-2020,VILA DA PRAIA DA VITÓRIA,25,2,117,"[0,240]",Moderado,,,,25,Açores,AÇORES,4302,16127.06,21317,1133,789,619,436,336,772,1391,2180,3313,132.18,20.54,13.52,8.63
18-12-2020,PROENÇA-A-NOVA,11,1,151,"[0,240]",Moderado,,,,11,Centro,CASTELO BRANCO,0508,39539.96,7298,508,465,389,400,560,960,1349,1814,2322,18.46,5.87,4.59,3.41
18-12-2020,REDONDO,5,0,79,"[0,240]",Moderado,,,,5,Alentejo,ÉVORA,0710,36950.87,6353,349,325,288,288,354,642,930,1255,1604,17.19,4.34,3.4,2.52
18-12-2020,REGUENGOS DE MONSARAZ,24,2,240,"[240,480]",Elevado,,,,24,Alentejo,ÉVORA,0711,46399.72,10015,602,511,455,462,473,935,1390,1901,2503,21.58,5.39,4.1,3.0
18-12-2020,RESENDE,56,4,552,"[480,960]",Muito Elevado,,,,56,Norte,VISEU,1813,12334.93,10137,560,493,448,433,422,855,1303,1796,2356,82.18,19.1,14.56,10.56
18-12-2020,RIBEIRA BRAVA,5,0,40,"[0,240]",Moderado,,,,5,Madeira,MADEIRA,3107,6544.88,12435,648,500,411,311,287,598,1009,1509,2157,189.99,32.96,23.06,15.42
18-12-2020,RIBEIRA DE PENA,15,1,249,"[240,480]",Elevado,,,,15,Norte,VILA REAL,1709,21745.98,6016,371,301,290,310,368,678,968,1269,1640,27.66,7.54,5.84,4.45
18-12-2020,RIBEIRA GRANDE,149,11,454,"[240,480]",Elevado,,,,149,Açores,AÇORES,4205,18015.13,32811,1163,689,512,345,253,598,1110,1799,2962,182.13,16.44,9.99,6.16
18-12-2020,RIO MAIOR,84,6,412,"[240,480]",Elevado,,,,84,Lisboa e Vale do Tejo,SANTARÉM,1414,27276.45,20379,1251,1144,941,795,648,1443,2384,3528,4779,74.71,17.52,12.93,8.74
18-12-2020,SABROSA,20,1,337,"[240,480]",Elevado,,,,20,Norte,VILA REAL,1710,15692.45,5918,393,314,304,302,350,652,956,1270,1663,37.71,10.6,8.09,6.09
18-12-2020,SABUGAL,76,5,718,"[480,960]",Muito Elevado,,,,76,Centro,GUARDA,0911,82269.82,10585,724,707,694,796,1009,1805,2499,3206,3930,12.87,4.78,3.9,3.04
18-12-2020,SALVATERRA DE MAGOS,74,5,347,"[240,480]",Elevado,,,,74,Lisboa e Vale do Tejo,SANTARÉM,1415,24393.2,21295,1275,1181,1060,799,772,1571,2631,3812,5087,87.3,20.85,15.63,10.79
18-12-2020,SANTA COMBA DÃO,28,2,268,"[240,480]",Elevado,,,,28,Centro,VISEU,1814,11194.77,10452,732,684,569,538,464,1002,1571,2255,2987,93.36,26.68,20.14,14.03
18-12-2020,SANTA CRUZ,51,4,113,"[0,240]",Moderado,,,,51,Madeira,MADEIRA,3108,8150.28,45281,1817,1301,974,716,523,1239,2213,3514,5331,555.6,65.41,43.12,27.15
18-12-2020,SANTA CRUZ DA GRACIOSA,1,0,24,"[0,240]",Moderado,,,,1,Açores,AÇORES,4401,6065.78,4208,228,180,163,124,145,269,432,612,840,69.37,13.85,10.09,7.12
18-12-2020,SANTA CRUZ DAS FLORES,0,0,0,"[0,240]",Moderado,,,,0,Açores,AÇORES,4802,7091.44,2165,125,98,74,56,51,107,181,279,404,30.53,5.7,3.93,2.55
18-12-2020,SANTA MARIA DA FEIRA,1036,74,747,"[480,960]",Muito Elevado,,,,1036,Norte,AVEIRO,0109,21587.65,138636,8182,6743,4771,3856,3079,6935,11706,18449,26631,642.19,123.36,85.46,54.22
18-12-2020,SANTA MARTA DE PENAGUIÃO,69,5,1045,"[960,Max]",Extremamente Elevado,,,,69,Norte,VILA REAL,1711,6928.13,6599,483,373,337,316,317,633,970,1343,1826,95.25,26.36,19.39,14.0
18-12-2020,SANTANA,3,0,45,"[0,240]",Moderado,,,,3,Madeira,MADEIRA,3109,9547.3,6711,418,353,343,282,277,559,902,1255,1673,70.29,17.52,13.15,9.45
18-12-2020,SANTARÉM,251,18,437,"[240,480]",Elevado,,,,251,Lisboa e Vale do Tejo,SANTARÉM,1416,55253.58,57421,3654,3441,2760,2466,2206,4672,7432,10873,14527,103.92,26.29,19.68,13.45
18-12-2020,SANTIAGO DO CACÉM,31,2,108,"[0,240]",Moderado,,,,31,Alentejo,SETÚBAL,1509,105969.29,28791,2144,1689,1472,1295,1215,2510,3982,5671,7815,27.17,7.37,5.35,3.76
18-12-2020,SANTO TIRSO,451,32,663,"[480,960]",Muito Elevado,,,,451,Norte,PORTO,1314,13655.52,68055,4911,3935,2761,2257,1810,4067,6828,10763,15674,498.35,114.78,78.82,50.0
18-12-2020,SÃO BRÁS DE ALPORTEL,19,1,182,"[0,240]",Moderado,,,,19,Algarve,FARO,0812,15336.92,10416,596,468,467,404,401,805,1272,1740,2336,67.91,15.23,11.35,8.29
18-12-2020,SÃO JOÃO DA MADEIRA,189,14,861,"[480,960]",Muito Elevado,,,,189,Norte,AVEIRO,0116,794.3,21958,1347,1069,796,601,593,1194,1990,3059,4406,2765.49,554.91,385.26,250.63
18-12-2020,SÃO JOÃO DA PESQUEIRA,29,2,407,"[240,480]",Elevado,,,,29,Norte,VISEU,1815,26610.85,7125,417,330,294,328,328,656,950,1280,1697,26.77,6.38,4.81,3.57
18-12-2020,SÃO PEDRO DO SUL,62,4,403,"[240,480]",Elevado,,,,62,Centro,VISEU,1816,34895.09,15403,990,962,861,759,909,1668,2529,3491,4481,44.14,12.84,10.0,7.25
18-12-2020,SÃO ROQUE DO PICO,1,0,31,"[0,240]",Moderado,,,,1,Açores,AÇORES,4603,14236.1,3266,199,141,93,96,113,209,302,443,642,22.94,4.51,3.11,2.12
18-12-2020,SÃO VICENTE,4,0,78,"[0,240]",Moderado,,,,4,Madeira,MADEIRA,3110,7883.71,5143,272,264,266,225,280,505,771,1035,1307,65.23,16.58,13.13,9.78
18-12-2020,SARDOAL,7,0,187,"[0,240]",Moderado,,,,7,Lisboa e Vale do Tejo,SANTARÉM,1417,9214.72,3741,227,178,148,165,248,413,561,739,966,40.6,10.48,8.02,6.09
18-12-2020,SÁTÃO,42,3,363,"[240,480]",Elevado,,,,42,Centro,VISEU,1817,20194.11,11580,765,671,515,465,476,941,1456,2127,2892,57.34,14.32,10.53,7.21
18-12-2020,SEIA,139,10,625,"[480,960]",Muito Elevado,,,,139,Centro,GUARDA,0912,43568.83,22234,1807,1589,1238,1122,721,1843,3081,4670,6477,51.03,14.87,10.72,7.07
18-12-2020,SEIXAL,758,54,452,"[240,480]",Elevado,,,,758,Lisboa e Vale do Tejo,SETÚBAL,1510,9545.17,167752,10586,9270,6661,4391,2930,7321,13982,23252,33838,1757.49,354.51,243.6,146.49
18-12-2020,SERNANCELHE,32,2,593,"[480,960]",Muito Elevado,,,,32,Norte,VISEU,1818,22861.22,5396,305,293,286,273,260,533,819,1112,1417,23.6,6.2,4.86,3.58
18-12-2020,SERPA,92,7,643,"[480,960]",Muito Elevado,,,,92,Alentejo,BEJA,0213,110563.34,14304,903,761,719,697,626,1323,2042,2803,3706,12.94,3.35,2.54,1.85
18-12-2020,SERTÃ,24,2,165,"[0,240]",Moderado,,,,24,Centro,CASTELO BRANCO,0509,44673.17,14577,870,779,790,767,1020,1787,2577,3356,4226,32.63,9.46,7.51,5.77
18-12-2020,SESIMBRA,208,15,401,"[240,480]",Elevado,,,,208,Lisboa e Vale do Tejo,SETÚBAL,1511,19571.75,51858,2400,2321,1853,1257,1083,2340,4193,6514,8914,264.96,45.54,33.28,21.42
18-12-2020,SETÚBAL,448,32,389,"[240,480]",Elevado,,,,448,Lisboa e Vale do Tejo,SETÚBAL,1512,23032.5,115126,7425,6929,5075,3775,2655,6430,11505,18434,25859,499.83,112.27,80.03,49.95
18-12-2020,SEVER DO VOUGA,45,3,397,"[240,480]",Elevado,,,,45,Centro,AVEIRO,0117,12987.56,11331,766,637,568,540,567,1107,1675,2312,3078,87.24,23.7,17.8,12.9
18-12-2020,SILVES,67,5,185,"[0,240]",Moderado,,,,67,Algarve,FARO,0813,68006.23,36226,2137,1869,1610,1423,1600,3023,4633,6502,8639,53.27,12.7,9.56,6.81
18-12-2020,SINES,18,1,131,"[0,240]",Moderado,,,,18,Alentejo,SETÚBAL,1513,20330.17,13715,888,791,551,416,268,684,1235,2026,2914,67.46,14.33,9.97,6.07
18-12-2020,SINTRA,1570,112,401,"[240,480]",Elevado,,,,1570,Lisboa e Vale do Tejo,LISBOA,1111,31922.73,391402,20490,18316,13545,9137,7284,16421,29966,48282,68772,1226.08,215.43,151.25,93.87
18-12-2020,SOBRAL DE MONTE AGRAÇO,30,2,282,"[240,480]",Elevado,,,,30,Lisboa e Vale do Tejo,LISBOA,1112,5210.32,10651,564,507,352,272,212,484,836,1343,1907,204.43,36.6,25.78,16.05
18-12-2020,SOURE,76,5,444,"[240,480]",Elevado,,,,76,Centro,COIMBRA,0615,26506.07,17120,1173,1142,1004,883,987,1870,2874,4016,5189,64.59,19.58,15.15,10.84
18-12-2020,SOUSEL,2,0,45,"[0,240]",Moderado,,,,2,Alentejo,PORTALEGRE,1215,27932.18,4412,261,274,208,302,292,594,802,1076,1337,15.8,4.79,3.85,2.87
18-12-2020,TÁBUA,24,2,211,"[0,240]",Moderado,,,,24,Centro,COIMBRA,0616,19978.58,11368,729,584,524,430,464,894,1418,2002,2731,56.9,13.67,10.02,7.1
18-12-2020,TABUAÇO,87,6,1442,"[960,Max]",Extremamente Elevado,,,,87,Norte,VISEU,1819,13385.67,6033,372,314,217,282,363,645,862,1176,1548,45.07,11.56,8.79,6.44
18-12-2020,TAROUCA,29,2,372,"[240,480]",Elevado,,,,29,Norte,VISEU,1820,10008.49,7804,405,335,313,277,324,601,914,1249,1654,77.98,16.53,12.48,9.13
18-12-2020,TAVIRA,16,1,65,"[0,240]",Moderado,,,,16,Algarve,FARO,0814,60696.7,24530,1493,1415,1252,1066,1277,2343,3595,5010,6503,40.41,10.71,8.25,5.92
18-12-2020,TERRAS DE BOURO,48,3,755,"[480,960]",Muito Elevado,,,,48,Norte,BRAGA,0310,27746.07,6361,391,372,296,319,340,659,955,1327,1718,22.93,6.19,4.78,3.44
18-12-2020,TOMAR,75,5,204,"[0,240]",Moderado,,,,75,Lisboa e Vale do Tejo,SANTARÉM,1418,35120.44,36748,2403,2189,1868,1853,1822,3675,5543,7732,10135,104.64,28.86,22.02,15.78
18-12-2020,TONDELA,81,6,307,"[240,480]",Elevado,,,,81,Centro,VISEU,1821,37121.73,26357,1768,1722,1518,1475,1417,2892,4410,6132,7900,71.0,21.28,16.52,11.88
18-12-2020,TORRE DE MONCORVO,49,4,637,"[480,960]",Muito Elevado,,,,49,Norte,BRAGANÇA,0409,53155.67,7695,556,478,488,551,719,1270,1758,2236,2792,14.48,5.25,4.21,3.31
18-12-2020,TORRES NOVAS,109,8,312,"[240,480]",Elevado,,,,109,Lisboa e Vale do Tejo,SANTARÉM,1419,26999.68,34933,2324,1979,1738,1406,1475,2881,4619,6598,8922,129.38,33.04,24.44,17.11
18-12-2020,TORRES VEDRAS,328,23,418,"[240,480]",Elevado,,,,328,Lisboa e Vale do Tejo,LISBOA,1113,40714.89,78530,4513,3945,3447,2628,2104,4732,8179,12124,16637,192.88,40.86,29.78,20.09
18-12-2020,TRANCOSO,25,2,282,"[240,480]",Elevado,,,,25,Centro,GUARDA,0913,36152.47,8875,581,557,542,586,496,1082,1624,2181,2762,24.55,7.64,6.03,4.49
18-12-2020,TROFA,480,34,1249,"[960,Max]",Extremamente Elevado,,,,480,Norte,PORTO,1318,7201.76,38418,2336,1894,1231,939,684,1623,2854,4748,7084,533.44,98.36,65.93,39.63
18-12-2020,VAGOS,96,7,422,"[240,480]",Elevado,,,,96,Centro,AVEIRO,0118,16491.5,22740,1320,1205,922,784,724,1508,2430,3635,4955,137.89,30.04,22.04,14.73
18-12-2020,VALE DE CAMBRA,83,6,389,"[240,480]",Elevado,,,,83,Norte,AVEIRO,0119,14733.47,21327,1491,1363,1005,831,798,1629,2634,3997,5488,144.76,37.25,27.13,17.88
18-12-2020,VALENÇA,51,4,384,"[240,480]",Elevado,,,,51,Norte,VIANA DO CASTELO,1608,11712.86,13290,867,791,582,582,503,1085,1667,2458,3325,113.46,28.39,20.99,14.23
18-12-2020,VALONGO,623,44,639,"[480,960]",Muito Elevado,,,,623,Norte,PORTO,1315,7512.45,97444,5629,4696,3207,2462,1829,4291,7498,12194,17823,1297.18,237.26,162.33,99.81
18-12-2020,VALPAÇOS,152,11,1026,"[960,Max]",Extremamente Elevado,,,,152,Norte,VILA REAL,1712,54873.93,14818,1217,1118,999,928,997,1925,2924,4042,5259,27.0,9.58,7.37,5.33
18-12-2020,VELAS,1,0,20,"[0,240]",Moderado,,,,1,Açores,AÇORES,4502,11738.38,5093,278,208,166,153,113,266,432,640,918,43.39,7.82,5.45,3.68
18-12-2020,VENDAS NOVAS,41,3,364,"[240,480]",Elevado,,,,41,Alentejo,ÉVORA,0712,22238.88,11255,677,768,655,501,532,1033,1688,2456,3133,50.61,14.09,11.04,7.59
18-12-2020,VIANA DO ALENTEJO,11,1,213,"[0,240]",Moderado,,,,11,Alentejo,ÉVORA,0713,39367.29,5145,245,208,235,210,214,424,659,867,1112,13.07,2.82,2.2,1.67
18-12-2020,VIANA DO CASTELO,367,26,435,"[240,480]",Elevado,,,,367,Norte,VIANA DO CASTELO,1609,31902.01,84417,5470,4433,3591,3061,2982,6043,9634,14067,19537,264.61,61.24,44.09,30.2
18-12-2020,VIDIGUEIRA,6,0,109,"[0,240]",Moderado,,,,6,Alentejo,BEJA,0214,31661.09,5510,300,248,215,233,275,508,723,971,1271,17.4,4.01,3.07,2.28
18-12-2020,VIEIRA DO MINHO,125,9,1056,"[960,Max]",Extremamente Elevado,,,,125,Norte,BRAGA,0311,21644.35,11842,703,594,525,548,482,1030,1555,2149,2852,54.71,13.18,9.93,7.18
18-12-2020,VILA DE REI,6,0,181,"[0,240]",Moderado,,,,6,Centro,CASTELO BRANCO,0510,19154.6,3323,169,128,172,247,302,549,721,849,1018,17.35,5.31,4.43,3.76
18-12-2020,VILA DO BISPO,3,0,58,"[0,240]",Moderado,,,,3,Algarve,FARO,0815,17906.06,5154,302,302,314,232,233,465,779,1081,1383,28.78,7.72,6.04,4.35
18-12-2020,VILA DO CONDE,776,55,971,"[960,Max]",Extremamente Elevado,,,,776,Norte,PORTO,1316,14902.77,79899,4726,3875,2819,2070,1743,3813,6632,10507,15233,536.13,102.21,70.5,44.5
18-12-2020,VILA DO PORTO,0,0,0,"[0,240]",Moderado,,,,0,Açores,AÇORES,4101,9688.74,5616,274,212,135,96,123,219,354,566,840,57.96,8.67,5.84,3.65
18-12-2020,VILA FLOR,16,1,265,"[240,480]",Elevado,,,,16,Norte,BRAGANÇA,0410,26581.14,6044,429,362,422,294,331,625,1047,1409,1838,22.74,6.91,5.3,3.94
18-12-2020,VILA FRANCA DE XIRA,510,36,359,"[240,480]",Elevado,,,,510,Lisboa e Vale do Tejo,LISBOA,1114,31819.39,141957,8501,6852,4869,3425,2472,5897,10766,17618,26119,446.14,82.09,55.37,33.84
18-12-2020,VILA FRANCA DO CAMPO,50,4,452,"[240,480]",Elevado,,,,50,Açores,AÇORES,4206,7796.82,11051,450,344,248,217,154,371,619,963,1413,141.73,18.12,12.35,7.94
18-12-2020,VILA NOVA DA BARQUINHA,17,1,228,"[0,240]",Moderado,,,,17,Lisboa e Vale do Tejo,SANTARÉM,1420,4952.97,7461,415,406,392,364,338,702,1094,1500,1915,150.64,38.66,30.28,22.09
18-12-2020,VILA NOVA DE CERVEIRA,14,1,157,"[0,240]",Moderado,,,,14,Norte,VIANA DO CASTELO,1610,10846.66,8910,531,444,410,384,334,718,1128,1572,2103,82.14,19.39,14.49,10.4
18-12-2020,VILA NOVA DE FAMALICÃO,1533,109,1164,"[960,Max]",Extremamente Elevado,,,,1533,Norte,BRAGA,0312,20159.26,131676,7817,6164,4202,3282,2749,6031,10233,16397,24214,653.19,120.12,81.34,50.76
18-12-2020,VILA NOVA DE FOZ CÔA,8,1,123,"[0,240]",Moderado,,,,8,Centro,GUARDA,0914,39815.18,6503,442,385,390,398,429,827,1217,1602,2044,16.33,5.13,4.02,3.06
18-12-2020,VILA NOVA DE GAIA,1842,132,613,"[480,960]",Muito Elevado,,,,1842,Norte,PORTO,1317,16846.43,300472,18349,15568,10972,8224,6281,14505,25477,41045,59394,1783.64,352.57,243.65,151.23
18-12-2020,VILA NOVA DE PAIVA,6,0,128,"[0,240]",Moderado,,,,6,Centro,VISEU,1822,17553.28,4687,289,272,233,217,241,458,691,963,1252,26.7,7.13,5.49,3.94
18-12-2020,VILA NOVA DE POIARES,13,1,187,"[0,240]",Moderado,,,,13,Centro,COIMBRA,0617,8445.3,6939,380,284,262,235,182,417,679,963,1343,82.17,15.9,11.4,8.04
18-12-2020,VILA POUCA DE AGUIAR,164,12,1371,"[960,Max]",Extremamente Elevado,,,,164,Norte,VILA REAL,1713,43706.62,11961,860,817,733,601,627,1228,1961,2778,3638,27.37,8.32,6.36,4.49
18-12-2020,VILA REAL,299,21,598,"[480,960]",Muito Elevado,,,,299,Norte,VILA REAL,1714,37880.28,49962,3025,2498,2065,1579,1466,3045,5110,7608,10633,131.9,28.07,20.08,13.49
18-12-2020,VILA REAL DE SANTO ANTÓNIO,28,2,149,"[0,240]",Moderado,,,,28,Algarve,FARO,0816,6125.0,18749,1172,1069,811,569,586,1155,1966,3035,4207,306.11,68.69,49.55,32.1
18-12-2020,VILA VELHA DE RÓDÃO,8,1,254,"[240,480]",Elevado,,,,8,Centro,CASTELO BRANCO,0511,32991.16,3144,209,229,180,283,306,589,769,998,1207,9.53,3.66,3.03,2.33
18-12-2020,VILA VERDE,350,25,746,"[480,960]",Muito Elevado,,,,350,Norte,BRAGA,0313,22866.52,46911,2365,2063,1667,1494,1437,2931,4598,6661,9026,205.15,39.47,29.13,20.11
18-12-2020,VILA VIÇOSA,15,1,196,"[0,240]",Moderado,,,,15,Alentejo,ÉVORA,0714,19485.89,7656,487,379,342,345,324,669,1011,1390,1877,39.29,9.63,7.13,5.19
18-12-2020,VIMIOSO,117,8,2908,"[960,Max]",Extremamente Elevado,,,,117,Norte,BRAGANÇA,0411,48158.51,4023,274,230,261,293,335,628,889,1119,1393,8.35,2.89,2.32,1.85
18-12-2020,VINHAIS,31,2,400,"[240,480]",Elevado,,,,31,Norte,BRAGANÇA,0412,69475.09,7746,599,577,636,641,815,1456,2092,2669,3268,11.15,4.7,3.84,3.01
18-12-2020,VISEU,488,35,502,"[480,960]",Muito Elevado,,,,488,Centro,VISEU,1823,50710.14,97249,5769,5038,4140,3158,2710,5868,10008,15046,20815,191.77,41.05,29.67,19.74
18-12-2020,VIZELA,93,7,389,"[240,480]",Elevado,,,,93,Norte,BRAGA,0314,2469.83,23897,1258,928,655,509,371,880,1535,2463,3721,967.49,150.65,99.72,62.15
18-12-2020,VOUZELA,26,2,270,"[240,480]",Elevado,,,,26,Centro,VISEU,1824,19369.46,9619,626,605,554,532,507,1039,1593,2198,2824,49.66,14.58,11.35,8.22
21-12-2020,ABRANTES,100,7,285,"[240,480]",Elevado,,,,100,Lisboa e Vale do Tejo,SANTARÉM,1401,71469.08,35130,2473,2213,1730,1748,2021,3769,5499,7712,10185,49.15,14.25,10.79,7.69
21-12-2020,ÁGUEDA,255,18,553,"[480,960]",Muito Elevado,,,,255,Centro,AVEIRO,0101,33527.44,46075,3237,2713,2090,1635,1496,3131,5221,7934,11171,137.43,33.32,23.66,15.57
21-12-2020,AGUIAR DA BEIRA,25,2,537,"[480,960]",Muito Elevado,,,,25,Centro,GUARDA,0901,20676.57,4652,304,281,235,239,148,387,622,903,1207,22.5,5.84,4.37,3.01
21-12-2020,ALANDROAL,18,1,361,"[240,480]",Elevado,,,,18,Alentejo,ÉVORA,0701,54267.81,4992,307,256,296,299,377,676,972,1228,1535,9.2,2.83,2.26,1.79
21-12-2020,ALBERGARIA-A-VELHA,100,7,414,"[240,480]",Elevado,,,,100,Centro,AVEIRO,0102,15882.5,24144,1550,1298,996,687,680,1367,2363,3661,5211,152.02,32.81,23.05,14.88
21-12-2020,ALBUFEIRA,77,5,185,"[0,240]",Moderado,,,,77,Algarve,FARO,0801,14066.42,41528,2067,1717,1425,985,858,1843,3268,4985,7052,295.24,50.14,35.44,23.23
21-12-2020,ALCÁCER DO SAL,21,1,180,"[0,240]",Moderado,,,,21,Alentejo,SETÚBAL,1501,149987.3,11659,884,814,623,623,602,1225,1848,2662,3546,7.77,2.36,1.77,1.23
21-12-2020,ALCANENA,29,2,226,"[0,240]",Moderado,,,,29,Lisboa e Vale do Tejo,SANTARÉM,1402,12732.86,12809,891,744,628,536,588,1124,1752,2496,3387,100.6,26.6,19.6,13.76
21-12-2020,ALCOBAÇA,118,8,220,"[0,240]",Moderado,,,,118,Lisboa e Vale do Tejo,LEIRIA,1001,40814.09,53555,3420,2927,2466,2059,1676,3735,6201,9128,12548,131.22,30.74,22.36,15.19
21-12-2020,ALCOCHETE,105,8,531,"[480,960]",Muito Elevado,,,,105,Lisboa e Vale do Tejo,SETÚBAL,1502,12836.48,19787,857,834,691,476,447,923,1614,2448,3305,154.15,25.75,19.07,12.57
21-12-2020,ALCOUTIM,0,0,0,"[0,240]",Moderado,,,,0,Algarve,FARO,0802,57536.33,2159,191,188,163,190,267,457,620,808,999,3.75,1.74,1.4,1.08
21-12-2020,ALENQUER,325,23,738,"[480,960]",Muito Elevado,,,,325,Lisboa e Vale do Tejo,LISBOA,1101,30421.92,44052,2298,2062,1629,1330,1155,2485,4114,6176,8474,144.8,27.85,20.3,13.52
21-12-2020,ALFÂNDEGA DA FÉ,62,4,1363,"[960,Max]",Extremamente Elevado,,,,62,Norte,BRAGANÇA,0401,32194.64,4550,325,277,301,274,325,599,900,1177,1502,14.13,4.67,3.66,2.8
21-12-2020,ALIJÓ,45,3,424,"[240,480]",Elevado,,,,45,Norte,VILA REAL,1701,29759.89,10625,766,687,635,542,666,1208,1843,2530,3296,35.7,11.08,8.5,6.19
21-12-2020,ALJEZUR,8,1,143,"[0,240]",Moderado,,,,8,Algarve,FARO,0803,32349.95,5594,316,336,335,320,410,730,1065,1401,1717,17.29,5.31,4.33,3.29
21-12-2020,ALJUSTREL,3,0,36,"[0,240]",Moderado,,,,3,Alentejo,BEJA,0201,45847.41,8247,635,521,443,347,358,705,1148,1669,2304,17.99,5.03,3.64,2.5
21-12-2020,ALMADA,908,65,537,"[480,960]",Muito Elevado,,,,908,Lisboa e Vale do Tejo,SETÚBAL,1503,7000.89,169039,10469,9777,7876,6144,5111,11255,19131,28908,39377,2414.5,562.45,412.91,273.26
21-12-2020,ALMEIDA,36,3,617,"[480,960]",Muito Elevado,,,,36,Centro,GUARDA,0902,51798.46,5830,441,419,396,458,393,851,1247,1666,2107,11.26,4.07,3.22,2.41
21-12-2020,ALMEIRIM,55,4,244,"[240,480]",Elevado,,,,55,Lisboa e Vale do Tejo,SANTARÉM,1403,22212.05,22546,1342,1353,1106,866,843,1709,2815,4168,5510,101.5,24.81,18.76,12.67
21-12-2020,ALMODÔVAR,6,0,89,"[0,240]",Moderado,,,,6,Alentejo,BEJA,0202,77788.03,6725,414,443,396,373,328,701,1097,1540,1954,8.65,2.51,1.98,1.41
21-12-2020,ALPIARÇA,9,1,127,"[0,240]",Moderado,,,,9,Lisboa e Vale do Tejo,SANTARÉM,1404,9536.33,7059,515,486,363,333,274,607,970,1456,1971,74.02,20.67,15.27,10.17
21-12-2020,ALTER DO CHÃO,38,3,1201,"[960,Max]",Extremamente Elevado,,,,38,Alentejo,PORTALEGRE,1201,36206.62,3165,201,163,136,208,187,395,531,694,895,8.74,2.47,1.92,1.47
21-12-2020,ALVAIÁZERE,12,1,182,"[0,240]",Moderado,,,,12,Centro,LEIRIA,1002,16047.76,6597,419,389,346,406,539,945,1291,1680,2099,41.11,13.08,10.47,8.04
21-12-2020,ALVITO,4,0,161,"[0,240]",Moderado,,,,4,Alentejo,BEJA,0203,26485.32,2477,145,110,105,111,89,200,305,415,560,9.35,2.11,1.57,1.15
21-12-2020,AMADORA,731,52,397,"[240,480]",Elevado,,,,731,Lisboa e Vale do Tejo,LISBOA,1115,2378.47,184106,11186,10936,8780,6460,5890,12350,21130,32066,43252,7742.05,1818.84,1348.44,888.56
21-12-2020,AMARANTE,638,46,1199,"[960,Max]",Extremamente Elevado,,,,638,Norte,PORTO,1301,30133.15,53193,3086,2413,1812,1643,1311,2954,4766,7179,10265,176.53,34.07,23.82,15.82
21-12-2020,AMARES,115,8,634,"[480,960]",Muito Elevado,,,,115,Norte,BRAGA,0301,8195.41,18129,1001,829,622,489,524,1013,1635,2464,3465,221.22,42.28,30.07,19.95
21-12-2020,ANADIA,168,12,616,"[480,960]",Muito Elevado,,,,168,Centro,AVEIRO,0103,21663.48,27258,1931,1698,1376,1208,1262,2470,3846,5544,7475,125.83,34.51,25.59,17.75
21-12-2020,ANGRA DO HEROÍSMO,76,5,225,"[0,240]",Moderado,,,,76,Açores,AÇORES,4301,23899.66,33807,2006,1473,1122,768,635,1403,2525,3998,6004,141.45,25.12,16.73,10.56
21-12-2020,ANSIÃO,64,5,532,"[480,960]",Muito Elevado,,,,64,Centro,LEIRIA,1003,17609.42,12039,727,709,646,694,530,1224,1870,2579,3306,68.37,18.77,14.65,10.62
21-12-2020,ARCOS DE VALDEVEZ,43,3,205,"[0,240]",Moderado,,,,43,Norte,VIANA DO CASTELO,1601,44759.64,20926,1329,1338,1282,1343,1515,2858,4140,5478,6807,46.75,15.21,12.24,9.25
21-12-2020,ARGANIL,22,2,200,"[0,240]",Moderado,,,,22,Centro,COIMBRA,0601,33283.93,11014,672,648,612,559,596,1155,1767,2415,3087,33.09,9.27,7.26,5.31
21-12-2020,ARMAMAR,80,6,1387,"[960,Max]",Extremamente Elevado,,,,80,Norte,VISEU,1801,11723.73,5769,357,305,309,285,310,595,904,1209,1566,49.21,13.36,10.31,7.71
21-12-2020,AROUCA,121,9,584,"[480,960]",Muito Elevado,,,,121,Norte,AVEIRO,0104,32910.52,20720,1306,1047,753,683,683,1366,2119,3166,4472,62.96,13.59,9.62,6.44
21-12-2020,ARRAIOLOS,17,1,245,"[240,480]",Elevado,,,,17,Alentejo,ÉVORA,0702,68374.55,6928,435,384,283,367,480,847,1130,1514,1949,10.13,2.85,2.21,1.65
21-12-2020,ARRONCHES,1,0,35,"[0,240]",Moderado,,,,1,Alentejo,PORTALEGRE,1202,31464.72,2820,155,142,162,187,179,366,528,670,825,8.96,2.62,2.13,1.68
21-12-2020,ARRUDA DOS VINHOS,48,3,311,"[240,480]",Elevado,,,,48,Lisboa e Vale do Tejo,LISBOA,1102,7795.93,15412,738,738,562,509,438,947,1509,2247,2985,197.69,38.29,28.82,19.36
21-12-2020,AVEIRO,283,20,359,"[240,480]",Elevado,,,,283,Centro,AVEIRO,0105,19757.57,78734,4520,4004,3050,2250,2103,4353,7403,11407,15927,398.49,80.61,57.73,37.47
21-12-2020,AVIS,13,1,306,"[240,480]",Elevado,,,,13,Alentejo,PORTALEGRE,1203,60596.51,4247,315,225,206,251,273,524,730,955,1270,7.01,2.1,1.58,1.2
21-12-2020,AZAMBUJA,108,8,475,"[240,480]",Elevado,,,,108,Lisboa e Vale do Tejo,LISBOA,1103,26265.65,22716,1322,1171,1070,798,618,1416,2486,3657,4979,86.48,18.96,13.92,9.46
21-12-2020,BAIÃO,112,8,597,"[480,960]",Muito Elevado,,,,112,Norte,PORTO,1302,17452.83,18748,1070,862,714,686,725,1411,2125,2987,4057,107.42,23.25,17.11,12.18
21-12-2020,BARCELOS,1160,83,998,"[960,Max]",Extremamente Elevado,,,,1160,Norte,BRAGA,0302,37890.14,116187,6721,5325,3619,2991,2562,5553,9172,14497,21218,306.64,56.0,38.26,24.21
21-12-2020,BARRANCOS,0,0,0,"[0,240]",Moderado,,,,0,Alentejo,BEJA,0204,16841.73,1634,90,65,65,94,61,155,220,285,375,9.7,2.23,1.69,1.31
21-12-2020,BARREIRO,485,35,645,"[480,960]",Muito Elevado,,,,485,Lisboa e Vale do Tejo,SETÚBAL,1504,3639.07,75147,5194,5565,4459,3105,1767,4872,9331,14896,20090,2065.05,552.07,409.34,256.42
21-12-2020,BATALHA,56,4,351,"[240,480]",Elevado,,,,56,Centro,LEIRIA,1004,10341.6,15963,873,762,649,529,549,1078,1727,2489,3362,154.35,32.51,24.07,16.7
21-12-2020,BEJA,89,6,265,"[240,480]",Elevado,,,,89,Alentejo,BEJA,0205,114647.55,33579,2005,1840,1386,1272,1039,2311,3697,5537,7542,29.29,6.58,4.83,3.22
21-12-2020,BELMONTE,11,1,172,"[0,240]",Moderado,,,,11,Centro,CASTELO BRANCO,0501,11875.91,6398,444,321,325,310,355,665,990,1311,1755,53.87,14.78,11.04,8.34
21-12-2020,BENAVENTE,84,6,274,"[240,480]",Elevado,,,,84,Lisboa e Vale do Tejo,SANTARÉM,1405,52138.39,30602,1468,1376,1141,876,643,1519,2660,4036,5504,58.69,10.56,7.74,5.1
21-12-2020,BOMBARRAL,28,2,223,"[0,240]",Moderado,,,,28,Lisboa e Vale do Tejo,LEIRIA,1005,9128.55,12558,875,714,561,491,429,920,1481,2195,3070,137.56,33.63,24.04,16.22
21-12-2020,BORBA,6,0,89,"[0,240]",Moderado,,,,6,Alentejo,ÉVORA,0703,14518.65,6736,430,375,279,436,392,828,1107,1482,1912,46.39,13.17,10.21,7.62
21-12-2020,BOTICAS,31,2,620,"[480,960]",Muito Elevado,,,,31,Norte,VILA REAL,1702,32195.66,4998,347,306,311,305,380,685,996,1302,1649,15.52,5.12,4.04,3.09
21-12-2020,BRAGA,1233,88,675,"[480,960]",Muito Elevado,,,,1233,Norte,BRAGA,0303,18339.95,182679,10029,7963,5241,4320,3671,7991,13232,21195,31224,996.07,170.25,115.57,72.15
21-12-2020,BRAGANÇA,394,28,1172,"[960,Max]",Extremamente Elevado,,,,394,Norte,BRAGANÇA,0402,117357.27,33607,2402,1855,1652,1393,1163,2556,4208,6063,8465,28.64,7.21,5.17,3.59
21-12-2020,CABECEIRAS DE BASTO,48,3,307,"[240,480]",Elevado,,,,48,Norte,BRAGA,0304,24182.16,15628,774,594,544,575,574,1149,1693,2287,3061,64.63,12.66,9.46,7.0
21-12-2020,CADAVAL,27,2,197,"[0,240]",Moderado,,,,27,Lisboa e Vale do Tejo,LISBOA,1104,17489.3,13673,813,796,756,621,625,1246,2002,2798,3611,78.18,20.65,16.0,11.45
21-12-2020,CALDAS DA RAINHA,205,15,395,"[240,480]",Elevado,,,,205,Lisboa e Vale do Tejo,LEIRIA,1006,25569.47,51912,3035,2684,2186,1899,1705,3604,5790,8474,11509,203.03,45.01,33.14,22.64
21-12-2020,CALHETA,2,0,18,"[0,240]",Moderado,,,,2,Madeira,MADEIRA,3101,11150.43,10867,576,497,507,399,415,814,1321,1818,2394,97.46,21.47,16.3,11.85
21-12-2020,CALHETA (AÇORES),2,0,63,"[0,240]",Moderado,,,,2,Açores,AÇORES,4501,12626.4,3184,215,159,141,139,122,261,402,561,776,25.22,6.15,4.44,3.18
21-12-2020,CÂMARA DE LOBOS,45,3,134,"[0,240]",Moderado,,,,45,Madeira,MADEIRA,3102,5216.67,33675,1396,1059,834,545,381,926,1760,2819,4215,645.49,80.79,54.03,33.74
21-12-2020,CAMINHA,90,6,567,"[480,960]",Muito Elevado,,,,90,Norte,VIANA DO CASTELO,1602,13652.14,15877,1046,944,818,646,656,1302,2120,3064,4110,116.3,30.11,22.44,15.53
21-12-2020,CAMPO MAIOR,9,1,114,"[0,240]",Moderado,,,,9,Alentejo,PORTALEGRE,1204,24720.16,7874,471,364,351,279,327,606,957,1321,1792,31.85,7.25,5.34,3.87
21-12-2020,CANTANHEDE,144,10,411,"[240,480]",Elevado,,,,144,Centro,COIMBRA,0602,39088.02,35011,2346,2096,1880,1709,1451,3160,5040,7136,9482,89.57,24.26,18.26,12.89
21-12-2020,CARRAZEDA DE ANSIÃES,3,0,53,"[0,240]",Moderado,,,,3,Norte,BRAGANÇA,0403,27924.09,5666,424,389,391,312,465,777,1168,1557,1981,20.29,7.09,5.58,4.18
21-12-2020,CARREGAL DO SAL,23,2,248,"[240,480]",Elevado,,,,23,Centro,VISEU,1802,11689.21,9271,587,562,486,462,376,838,1324,1886,2473,79.31,21.16,16.13,11.33
21-12-2020,CARTAXO,47,3,197,"[0,240]",Moderado,,,,47,Lisboa e Vale do Tejo,SANTARÉM,1406,15817.28,23843,1415,1376,1142,861,632,1493,2635,4011,5426,150.74,34.3,25.36,16.66
21-12-2020,CASCAIS,790,56,370,"[240,480]",Elevado,,,,790,Lisboa e Vale do Tejo,LISBOA,1105,9740.17,213608,12151,11444,8680,6469,5248,11717,20397,31841,43992,2193.1,451.66,326.91,209.41
21-12-2020,CASTANHEIRA DE PÊRA,17,1,650,"[480,960]",Muito Elevado,,,,17,Centro,LEIRIA,1007,6677.45,2614,233,195,157,190,187,377,534,729,962,39.15,14.41,10.92,8.0
21-12-2020,CASTELO BRANCO,276,20,531,"[480,960]",Muito Elevado,,,,276,Centro,CASTELO BRANCO,0502,143819.15,51987,3528,3042,2499,2229,2225,4454,6953,9995,13523,36.15,9.4,6.95,4.83
21-12-2020,CASTELO DE PAIVA,53,4,343,"[240,480]",Elevado,,,,53,Norte,AVEIRO,0106,11500.53,15454,881,697,545,420,431,851,1396,2093,2974,134.37,25.86,18.2,12.14
21-12-2020,CASTELO DE VIDE,70,5,2398,"[960,Max]",Extremamente Elevado,,,,70,Alentejo,PORTALEGRE,1205,26491.24,2919,204,173,179,147,170,317,496,669,873,11.02,3.3,2.53,1.87
21-12-2020,CASTRO DAIRE,63,5,456,"[240,480]",Elevado,,,,63,Centro,VISEU,1803,37904.13,13823,942,857,765,732,773,1505,2270,3127,4069,36.47,10.74,8.25,5.99
21-12-2020,CASTRO MARIM,2,0,32,"[0,240]",Moderado,,,,2,Algarve,FARO,0804,30084.37,6237,370,345,334,322,344,666,1000,1345,1715,20.73,5.7,4.47,3.32
21-12-2020,CASTRO VERDE,13,1,187,"[0,240]",Moderado,,,,13,Alentejo,BEJA,0206,56944.23,6949,437,347,303,275,227,502,805,1152,1589,12.2,2.79,2.02,1.41
21-12-2020,CELORICO DA BEIRA,28,2,404,"[240,480]",Elevado,,,,28,Centro,GUARDA,0903,24721.63,6928,430,416,363,369,535,904,1267,1683,2113,28.02,8.55,6.81,5.12
21-12-2020,CELORICO DE BASTO,112,8,588,"[480,960]",Muito Elevado,,,,112,Norte,BRAGA,0305,18107.02,19040,1001,802,668,728,729,1457,2125,2927,3928,105.15,21.69,16.17,11.74
21-12-2020,CHAMUSCA,24,2,261,"[240,480]",Elevado,,,,24,Lisboa e Vale do Tejo,SANTARÉM,1407,74600.54,9197,629,583,553,465,579,1044,1597,2180,2809,12.33,3.77,2.92,2.14
21-12-2020,CHAVES,582,42,1479,"[960,Max]",Extremamente Elevado,,,,582,Norte,VILA REAL,1703,59122.95,39343,2676,2429,1991,1886,1918,3804,5795,8224,10900,66.54,18.44,13.91,9.8
21-12-2020,CINFÃES,101,7,554,"[480,960]",Muito Elevado,,,,101,Norte,VISEU,1804,23928.76,18244,1067,902,779,734,758,1492,2271,3173,4240,76.24,17.72,13.26,9.49
21-12-2020,COIMBRA,653,47,487,"[480,960]",Muito Elevado,,,,653,Centro,COIMBRA,0603,31939.94,134166,9489,8734,6353,5139,5074,10213,16566,25300,34789,420.06,108.92,79.21,51.87
21-12-2020,CONDEIXA-A-NOVA,103,7,581,"[480,960]",Muito Elevado,,,,103,Centro,COIMBRA,0604,13867.47,17733,871,809,717,583,490,1073,1790,2599,3470,127.88,25.02,18.74,12.91
21-12-2020,CONSTÂNCIA,10,1,248,"[240,480]",Elevado,,,,10,Lisboa e Vale do Tejo,SANTARÉM,1408,8036.58,4030,211,183,187,148,155,303,490,673,884,50.14,11.0,8.37,6.1
21-12-2020,CORUCHE,36,3,206,"[0,240]",Moderado,,,,36,Lisboa e Vale do Tejo,SANTARÉM,1409,111572.03,17471,1294,1090,1095,1096,1019,2115,3210,4300,5594,15.66,5.01,3.85,2.88
21-12-2020,CORVO,0,0,0,"[0,240]",Moderado,,,,0,Açores,AÇORES,4901,1711.45,464,22,21,11,13,19,32,43,64,86,27.12,5.03,3.74,2.51
21-12-2020,COVILHÃ,154,11,329,"[240,480]",Elevado,,,,154,Centro,CASTELO BRANCO,0503,55560.06,46787,3533,2998,2365,2111,2193,4304,6669,9667,13200,84.21,23.76,17.4,12.0
21-12-2020,CRATO,35,3,1119,"[960,Max]",Extremamente Elevado,,,,35,Alentejo,PORTALEGRE,1206,39806.88,3129,229,258,163,182,228,410,573,831,1060,7.86,2.66,2.09,1.44
21-12-2020,CUBA,15,1,326,"[240,480]",Elevado,,,,15,Alentejo,BEJA,0207,17208.72,4595,255,233,206,190,143,333,539,772,1027,26.7,5.97,4.49,3.13
21-12-2020,ELVAS,120,9,585,"[480,960]",Muito Elevado,,,,120,Alentejo,PORTALEGRE,1207,63128.86,20528,1057,1145,902,852,810,1662,2564,3709,4766,32.52,7.55,5.88,4.06
21-12-2020,ENTRONCAMENTO,39,3,181,"[0,240]",Moderado,,,,39,Lisboa e Vale do Tejo,SANTARÉM,1410,1372.81,21558,1066,930,868,695,592,1287,2155,3085,4151,1570.14,302.33,224.69,156.96
21-12-2020,ESPINHO,163,12,552,"[480,960]",Muito Elevado,,,,163,Norte,AVEIRO,0107,2105.68,29516,2205,1993,1430,1177,960,2137,3567,5560,7765,1401.52,368.71,264.01,169.37
21-12-2020,ESPOSENDE,410,29,1200,"[960,Max]",Extremamente Elevado,,,,410,Norte,BRAGA,0306,9540.98,34177,1831,1522,1095,894,723,1617,2712,4234,6065,358.21,63.57,44.38,28.42
21-12-2020,ESTARREJA,110,8,423,"[240,480]",Elevado,,,,110,Centro,AVEIRO,0108,10817.33,26006,1503,1399,1106,953,728,1681,2787,4186,5689,240.42,52.59,38.7,25.76
21-12-2020,ESTREMOZ,54,4,424,"[240,480]",Elevado,,,,54,Alentejo,ÉVORA,0704,51379.95,12728,789,613,697,786,877,1663,2360,2973,3762,24.77,7.32,5.79,4.59
21-12-2020,ÉVORA,394,28,752,"[480,960]",Muito Elevado,,,,394,Alentejo,ÉVORA,0705,130707.58,52428,3569,2852,2176,1966,1803,3769,5945,8797,12366,40.11,9.46,6.73,4.55
21-12-2020,FAFE,193,14,402,"[240,480]",Elevado,,,,193,Norte,BRAGA,0307,21908.11,48060,3044,2455,1679,1403,1208,2611,4290,6745,9789,219.37,44.68,30.79,19.58
21-12-2020,FARO,190,14,311,"[240,480]",Elevado,,,,190,Algarve,FARO,0805,20256.79,61015,3847,3364,2604,2055,1601,3656,6260,9624,13471,301.2,66.5,47.51,30.9
21-12-2020,FELGUEIRAS,299,21,530,"[480,960]",Muito Elevado,,,,299,Norte,PORTO,1303,11573.75,56422,2951,2302,1601,1316,973,2289,3890,6192,9143,487.49,79.0,53.5,33.61
21-12-2020,FERREIRA DO ALENTEJO,8,1,102,"[0,240]",Moderado,,,,8,Alentejo,BEJA,0208,64820.68,7845,515,414,372,343,345,688,1060,1474,1989,12.1,3.07,2.27,1.64
21-12-2020,FERREIRA DO ZÊZERE,9,1,113,"[0,240]",Moderado,,,,9,Lisboa e Vale do Tejo,SANTARÉM,1411,19038.03,7959,470,370,416,465,456,921,1337,1707,2177,41.81,11.44,8.97,7.02
21-12-2020,FIGUEIRA DA FOZ,234,17,398,"[240,480]",Elevado,,,,234,Centro,COIMBRA,0605,37905.26,58747,4032,3597,2887,2495,2043,4538,7425,11022,15054,154.98,39.72,29.08,19.59
21-12-2020,FIGUEIRA DE CASTELO RODRIGO,15,1,269,"[240,480]",Elevado,,,,15,Centro,GUARDA,0904,50857.46,5584,347,352,290,352,391,743,1033,1385,1732,10.98,3.41,2.72,2.03
21-12-2020,FIGUEIRÓ DOS VINHOS,66,5,1185,"[960,Max]",Extremamente Elevado,,,,66,Centro,LEIRIA,1008,17344.0,5568,402,386,322,309,351,660,982,1368,1770,32.1,10.21,7.89,5.66
21-12-2020,FORNOS DE ALGODRES,8,1,177,"[0,240]",Moderado,,,,8,Centro,GUARDA,0905,13145.05,4528,261,218,247,256,232,488,735,953,1214,34.45,9.24,7.25,5.59
21-12-2020,FREIXO DE ESPADA À CINTA,12,1,364,"[240,480]",Elevado,,,,12,Norte,BRAGANÇA,0404,24414.29,3298,211,177,231,196,189,385,616,793,1004,13.51,4.11,3.25,2.52
21-12-2020,FRONTEIRA,7,0,235,"[0,240]",Moderado,,,,7,Alentejo,PORTALEGRE,1208,24859.58,2974,213,182,149,156,168,324,473,655,868,11.96,3.49,2.63,1.9
21-12-2020,FUNCHAL,134,10,129,"[0,240]",Moderado,,,,134,Madeira,MADEIRA,3103,7616.2,104024,6382,5086,3643,2821,1990,4811,8454,13540,19922,1365.86,261.58,177.78,111.0
21-12-2020,FUNDÃO,72,5,272,"[240,480]",Elevado,,,,72,Centro,CASTELO BRANCO,0504,70019.79,26495,1781,1464,1432,1357,1643,3000,4432,5896,7677,37.84,10.96,8.42,6.33
21-12-2020,GAVIÃO,60,4,1839,"[960,Max]",Extremamente Elevado,,,,60,Alentejo,PORTALEGRE,1209,29459.45,3263,189,186,222,263,293,556,778,964,1153,11.08,3.91,3.27,2.64
21-12-2020,GÓIS,3,0,79,"[0,240]",Moderado,,,,3,Centro,COIMBRA,0606,26330.19,3805,235,199,240,233,244,477,717,916,1151,14.45,4.37,3.48,2.72
21-12-2020,GOLEGÃ,11,1,206,"[0,240]",Moderado,,,,11,Lisboa e Vale do Tejo,SANTARÉM,1412,8431.67,5339,356,299,281,243,255,498,779,1078,1434,63.32,17.01,12.78,9.24
21-12-2020,GONDOMAR,946,68,570,"[480,960]",Muito Elevado,,,,946,Norte,PORTO,1304,13191.76,165985,10555,8755,6222,4450,3364,7814,14036,22791,33346,1258.22,252.77,172.76,106.4
21-12-2020,GOUVEIA,54,4,436,"[240,480]",Elevado,,,,54,Centro,GUARDA,0906,30061.17,12387,871,931,780,783,810,1593,2373,3304,4175,41.21,13.89,10.99,7.89
21-12-2020,GRÂNDOLA,80,6,546,"[480,960]",Muito Elevado,,,,80,Alentejo,SETÚBAL,1505,82593.66,14639,834,834,708,688,672,1360,2068,2902,3736,17.72,4.52,3.51,2.5
21-12-2020,GUARDA,312,22,801,"[480,960]",Muito Elevado,,,,312,Centro,GUARDA,0907,71209.58,38969,2477,2041,1686,1415,1474,2889,4575,6616,9093,54.72,12.77,9.29,6.42
21-12-2020,GUIMARÃES,1144,82,751,"[480,960]",Muito Elevado,,,,1144,Norte,BRAGA,0308,24099.96,152309,9394,7074,4809,3877,2948,6825,11634,18708,28102,631.99,116.61,77.63,48.27
21-12-2020,HORTA,4,0,28,"[0,240]",Moderado,,,,4,Açores,AÇORES,4701,17305.53,14521,818,658,468,352,302,654,1122,1780,2598,83.91,15.01,10.29,6.48
21-12-2020,IDANHA-A-NOVA,92,7,1144,"[960,Max]",Extremamente Elevado,,,,92,Centro,CASTELO BRANCO,0505,141633.51,8043,518,490,519,672,974,1646,2165,2655,3173,5.68,2.24,1.87,1.53
21-12-2020,ÍLHAVO,230,16,594,"[480,960]",Muito Elevado,,,,230,Centro,AVEIRO,0110,7347.55,38699,2227,1943,1444,1193,850,2043,3487,5430,7657,526.66,104.21,73.9,47.46
21-12-2020,LAGOA (FARO),17,1,75,"[0,240]",Moderado,,,,17,Algarve,FARO,0806,8825.45,22762,1314,1168,919,749,670,1419,2338,3506,4820,257.93,54.62,39.73,26.49
21-12-2020,LAGOA,28,2,190,"[0,240]",Moderado,,,,28,Açores,AÇORES,4201,4559.32,14721,536,458,349,238,235,473,822,1280,1816,322.9,39.83,28.08,18.03
21-12-2020,LAGOS,61,4,201,"[0,240]",Moderado,,,,61,Algarve,FARO,0807,21299.27,30374,1744,1434,1247,1053,1029,2082,3329,4763,6507,142.61,30.55,22.36,15.63
21-12-2020,LAJES DAS FLORES,0,0,0,"[0,20]",Moderado,,,,0,Açores,AÇORES,4801,7004.79,1463,88,53,62,46,54,100,162,215,303,20.89,4.33,3.07,2.31
21-12-2020,LAJES DO PICO,0,0,0,"[0,240]",Moderado,,,,0,Açores,AÇORES,4601,15531.09,4490,304,231,223,159,162,321,544,775,1079,28.91,6.95,4.99,3.5
21-12-2020,LAMEGO,196,14,787,"[480,960]",Muito Elevado,,,,196,Norte,VISEU,1805,16542.11,24895,1639,1284,1124,898,783,1681,2805,4089,5728,150.5,34.63,24.72,16.96
21-12-2020,LEIRIA,725,52,579,"[480,960]",Muito Elevado,,,,725,Centro,LEIRIA,1009,56508.83,125267,7389,6366,5090,3902,3159,7061,12151,18517,25906,221.68,45.84,32.77,21.5
21-12-2020,LISBOA,2593,185,509,"[480,960]",Muito Elevado,,,,2593,Lisboa e Vale do Tejo,LISBOA,1106,10005.43,509515,33197,33340,27706,23037,26770,49807,77513,110853,144050,5092.6,1439.78,1107.98,774.74
21-12-2020,LOULÉ,149,11,217,"[0,240]",Moderado,,,,149,Algarve,FARO,0808,76366.91,68697,3890,3350,2780,2358,2251,4609,7389,10739,14629,89.96,19.16,14.06,9.68
21-12-2020,LOURES,1004,72,470,"[240,480]",Elevado,,,,1004,Lisboa e Vale do Tejo,LISBOA,1107,16723.99,213687,12746,12794,9644,6669,5033,11702,21346,34140,46886,1277.73,280.35,204.14,127.64
21-12-2020,LOURINHÃ,120,9,464,"[240,480]",Elevado,,,,120,Lisboa e Vale do Tejo,LISBOA,1108,14717.2,25855,1584,1243,992,842,645,1487,2479,3722,5306,175.68,36.05,25.29,16.84
21-12-2020,LOUSÃ,45,3,262,"[240,480]",Elevado,,,,45,Centro,COIMBRA,0607,13840.01,17158,946,866,658,528,450,978,1636,2502,3448,123.97,24.91,18.08,11.82
21-12-2020,LOUSADA,196,14,419,"[240,480]",Elevado,,,,196,Norte,PORTO,1305,9608.01,46755,2289,1698,1176,853,621,1474,2650,4348,6637,486.63,69.08,45.25,27.58
21-12-2020,MAÇÃO,7,1,112,"[0,240]",Moderado,,,,7,Lisboa e Vale do Tejo,SANTARÉM,1413,39997.98,6267,386,362,390,440,657,1097,1487,1849,2235,15.67,5.59,4.62,3.72
21-12-2020,MACEDO DE CAVALEIROS,101,7,696,"[480,960]",Muito Elevado,,,,101,Norte,BRAGANÇA,0405,69914.08,14516,1082,889,878,823,938,1761,2639,3528,4610,20.76,6.59,5.05,3.77
21-12-2020,MACHICO,41,3,205,"[0,240]",Moderado,,,,41,Madeira,MADEIRA,3104,6825.1,19981,1197,860,662,455,331,786,1448,2308,3505,292.76,51.36,33.82,21.22
21-12-2020,MADALENA,2,0,34,"[0,240]",Moderado,,,,2,Açores,AÇORES,4602,14712.33,5895,334,256,173,190,179,369,542,798,1132,40.07,7.69,5.42,3.68
21-12-2020,MAFRA,305,22,360,"[240,480]",Elevado,,,,305,Lisboa e Vale do Tejo,LISBOA,1109,29165.5,84816,3613,3334,2839,2089,1899,3988,6827,10161,13774,290.81,47.23,34.84,23.41
21-12-2020,MAIA,702,50,505,"[480,960]",Muito Elevado,,,,702,Norte,PORTO,1306,8293.94,138971,7801,6617,4512,3339,2631,5970,10482,17099,24900,1675.56,300.22,206.16,126.38
21-12-2020,MANGUALDE,100,7,540,"[480,960]",Muito Elevado,,,,100,Centro,VISEU,1806,21925.56,18510,1198,1128,885,852,743,1595,2480,3608,4806,84.42,21.92,16.46,11.31
21-12-2020,MANTEIGAS,23,2,765,"[480,960]",Muito Elevado,,,,23,Centro,GUARDA,0908,12197.55,3007,258,197,159,167,146,313,472,669,927,24.65,7.6,5.48,3.87
21-12-2020,MARCO DE CANAVESES,363,26,705,"[480,960]",Muito Elevado,,,,363,Norte,PORTO,1307,20188.98,51496,2678,2060,1488,1265,1023,2288,3776,5836,8514,255.07,42.17,28.91,18.7
21-12-2020,MARINHA GRANDE,123,9,319,"[240,480]",Elevado,,,,123,Centro,LEIRIA,1010,18725.19,38508,2365,2302,1638,1359,1058,2417,4055,6357,8722,205.65,46.58,33.95,21.66
21-12-2020,MARVÃO,72,5,2396,"[960,Max]",Extremamente Elevado,,,,72,Alentejo,PORTALEGRE,1210,15489.9,3005,198,185,142,197,237,434,576,761,959,19.4,6.19,4.91,3.72
21-12-2020,MATOSINHOS,879,63,501,"[480,960]",Muito Elevado,,,,879,Norte,PORTO,1308,6241.97,175357,11850,9977,7023,5024,3884,8908,15931,25908,37758,2809.31,604.9,415.06,255.22
21-12-2020,MEALHADA,122,9,613,"[480,960]",Muito Elevado,,,,122,Centro,AVEIRO,0111,11065.66,19914,1163,1039,810,828,831,1659,2469,3508,4671,179.96,42.21,31.7,22.31
21-12-2020,MÊDA,5,0,109,"[0,240]",Moderado,,,,5,Centro,GUARDA,0909,28604.92,4587,343,306,290,288,443,731,1021,1327,1670,16.04,5.84,4.64,3.57
21-12-2020,MELGAÇO,13,1,161,"[0,240]",Moderado,,,,13,Norte,VIANA DO CASTELO,1603,23824.58,8093,507,567,578,614,675,1289,1867,2434,2941,33.97,12.34,10.22,7.84
21-12-2020,MÉRTOLA,49,4,798,"[480,960]",Muito Elevado,,,,49,Alentejo,BEJA,0209,129287.34,6142,400,390,378,423,600,1023,1401,1791,2191,4.75,1.69,1.39,1.08
21-12-2020,MESÃO FRIO,25,2,631,"[480,960]",Muito Elevado,,,,25,Norte,VILA REAL,1704,2664.87,3964,265,205,168,157,120,277,445,650,915,148.74,34.33,24.39,16.7
21-12-2020,MIRA,38,3,321,"[240,480]",Elevado,,,,38,Centro,COIMBRA,0608,12403.38,11832,727,729,659,550,466,1016,1675,2404,3131,95.4,25.24,19.38,13.5
21-12-2020,MIRANDA DO CORVO,82,6,645,"[480,960]",Muito Elevado,,,,82,Centro,COIMBRA,0609,12637.79,12708,706,659,568,498,404,902,1470,2129,2835,100.55,22.43,16.85,11.63
21-12-2020,MIRANDA DO DOURO,62,4,908,"[480,960]",Muito Elevado,,,,62,Norte,BRAGANÇA,0406,48718.31,6830,482,429,442,463,470,933,1375,1804,2286,14.02,4.69,3.7,2.82
21-12-2020,MIRANDELA,94,7,432,"[240,480]",Elevado,,,,94,Norte,BRAGANÇA,0407,65895.67,21754,1640,1315,1204,1078,947,2025,3229,4544,6184,33.01,9.38,6.9,4.9
21-12-2020,MOGADOURO,34,2,405,"[240,480]",Elevado,,,,34,Norte,BRAGANÇA,0408,76064.93,8392,589,529,576,630,655,1285,1861,2390,2979,11.03,3.92,3.14,2.45
21-12-2020,MOIMENTA DA BEIRA,20,1,205,"[0,240]",Moderado,,,,20,Norte,VISEU,1807,21996.9,9736,576,514,471,416,461,877,1348,1862,2438,44.26,11.08,8.46,6.13
21-12-2020,MOITA,418,30,649,"[480,960]",Muito Elevado,,,,418,Lisboa e Vale do Tejo,SETÚBAL,1506,5525.98,64407,4226,3646,2623,1801,1425,3226,5849,9495,13721,1165.53,248.3,171.82,105.85
21-12-2020,MONÇÃO,103,7,576,"[480,960]",Muito Elevado,,,,103,Norte,VIANA DO CASTELO,1604,21130.85,17869,1161,1105,1031,1006,972,1978,3009,4114,5275,84.56,24.96,19.47,14.24
21-12-2020,MONCHIQUE,6,0,118,"[0,240]",Moderado,,,,6,Algarve,FARO,0809,39530.43,5077,353,384,321,355,392,747,1068,1452,1805,12.84,4.57,3.67,2.7
21-12-2020,MONDIM DE BASTO,101,7,1454,"[960,Max]",Extremamente Elevado,,,,101,Norte,VILA REAL,1705,17207.52,6946,395,300,314,284,283,567,881,1181,1576,40.36,9.16,6.86,5.12
21-12-2020,MONFORTE,39,3,1311,"[960,Max]",Extremamente Elevado,,,,39,Alentejo,PORTALEGRE,1211,42024.82,2975,139,115,117,192,168,360,477,592,731,7.08,1.74,1.41,1.14
21-12-2020,MONTALEGRE,85,6,945,"[480,960]",Muito Elevado,,,,85,Norte,VILA REAL,1706,80545.71,8997,699,628,595,603,730,1333,1928,2556,3255,11.17,4.04,3.17,2.39
21-12-2020,MONTEMOR-O-NOVO,102,7,652,"[480,960]",Muito Elevado,,,,102,Alentejo,ÉVORA,0706,123296.65,15647,991,953,868,878,971,1849,2717,3670,4661,12.69,3.78,2.98,2.2
21-12-2020,MONTEMOR-O-VELHO,111,8,440,"[240,480]",Elevado,,,,111,Centro,COIMBRA,0610,22896.23,25224,1496,1397,1217,1057,988,2045,3262,4659,6155,110.17,26.88,20.35,14.25
21-12-2020,MONTIJO,266,19,462,"[240,480]",Elevado,,,,266,Lisboa e Vale do Tejo,SETÚBAL,1507,34861.64,57614,2771,2441,1990,1554,1109,2663,4653,7094,9865,165.26,28.3,20.35,13.35
21-12-2020,MORA,73,5,1764,"[960,Max]",Extremamente Elevado,,,,73,Alentejo,ÉVORA,0707,44395.02,4138,336,275,252,238,257,495,747,1022,1358,9.32,3.06,2.3,1.68
21-12-2020,MORTÁGUA,101,7,1147,"[960,Max]",Extremamente Elevado,,,,101,Centro,VISEU,1808,25117.82,8803,638,584,535,499,460,959,1494,2078,2716,35.05,10.81,8.27,5.95
21-12-2020,MOURA,10,1,73,"[0,240]",Moderado,,,,10,Alentejo,BEJA,0210,95845.55,13718,817,656,665,542,461,1003,1668,2324,3141,14.31,3.28,2.42,1.74
21-12-2020,MOURÃO,56,4,2286,"[960,Max]",Extremamente Elevado,,,,56,Alentejo,ÉVORA,0708,27862.98,2450,139,108,80,104,109,213,293,401,540,8.79,1.94,1.44,1.05
21-12-2020,MURÇA,21,1,384,"[240,480]",Elevado,,,,21,Norte,VILA REAL,1707,18937.11,5463,384,341,307,306,319,625,932,1273,1657,28.85,8.75,6.72,4.92
21-12-2020,MURTOSA,72,5,700,"[480,960]",Muito Elevado,,,,72,Centro,AVEIRO,0112,7308.78,10279,509,473,403,353,409,762,1165,1638,2147,140.63,29.37,22.41,15.94
21-12-2020,NAZARÉ,17,1,120,"[0,240]",Moderado,,,,17,Lisboa e Vale do Tejo,LEIRIA,1011,8243.43,14165,967,903,670,420,396,816,1486,2389,3356,171.84,40.71,28.98,18.03
21-12-2020,NELAS,74,5,570,"[480,960]",Muito Elevado,,,,74,Centro,VISEU,1809,12571.48,12974,924,787,668,604,583,1187,1855,2642,3566,103.21,28.37,21.02,14.76
21-12-2020,NISA,39,3,643,"[480,960]",Muito Elevado,,,,39,Alentejo,PORTALEGRE,1212,57567.84,6061,405,389,355,483,478,961,1316,1705,2110,10.53,3.67,2.96,2.29
21-12-2020,NORDESTE,0,0,0,"[0,240]",Moderado,,,,0,Açores,AÇORES,4202,10146.8,4862,246,180,124,161,162,323,447,627,873,47.92,8.6,6.18,4.41
21-12-2020,ÓBIDOS,39,3,329,"[240,480]",Elevado,,,,39,Lisboa e Vale do Tejo,LEIRIA,1012,14155.44,11850,743,650,574,452,436,888,1462,2112,2855,83.72,20.17,14.92,10.33
21-12-2020,ODEMIRA,120,9,485,"[480,960]",Muito Elevado,,,,120,Alentejo,BEJA,0211,172060.15,24717,1475,1317,1225,1397,1349,2746,3971,5288,6763,14.37,3.93,3.07,2.31
21-12-2020,ODIVELAS,613,44,379,"[240,480]",Elevado,,,,613,Lisboa e Vale do Tejo,LISBOA,1116,2654.36,161774,9562,9038,6952,4641,3812,8453,15405,24443,34005,6095.48,1281.27,920.99,580.44
21-12-2020,OEIRAS,649,46,366,"[240,480]",Elevado,,,,649,Lisboa e Vale do Tejo,LISBOA,1110,4588.31,177408,11580,11575,8566,6211,5855,12066,20632,32207,43787,3866.78,954.38,701.98,449.69
21-12-2020,OLEIROS,5,0,100,"[0,240]",Moderado,,,,5,Centro,CASTELO BRANCO,0506,47109.31,5003,384,341,366,397,487,884,1250,1591,1975,10.62,4.19,3.38,2.65
21-12-2020,OLHÃO,90,6,203,"[0,240]",Moderado,,,,90,Algarve,FARO,0810,13086.38,44405,2455,2309,1689,1342,1268,2610,4299,6608,9063,339.33,69.26,50.5,32.85
21-12-2020,OLIVEIRA DE AZEMÉIS,413,30,626,"[480,960]",Muito Elevado,,,,413,Norte,AVEIRO,0113,16110.41,66011,4155,3614,2794,2183,1738,3921,6715,10329,14484,409.75,89.91,64.12,41.68
21-12-2020,OLIVEIRA DE FRADES,20,1,201,"[0,240]",Moderado,,,,20,Centro,VISEU,1810,14534.62,9936,553,475,438,359,415,774,1212,1687,2240,68.36,15.41,11.61,8.34
21-12-2020,OLIVEIRA DO BAIRRO,89,6,367,"[240,480]",Elevado,,,,89,Centro,AVEIRO,0114,8731.99,24277,1327,1182,999,786,810,1596,2595,3777,5104,278.02,58.45,43.25,29.72
21-12-2020,OLIVEIRA DO HOSPITAL,153,11,795,"[480,960]",Muito Elevado,,,,153,Centro,COIMBRA,0611,23451.66,19253,1161,1097,962,924,960,1884,2846,3943,5104,82.1,21.76,16.81,12.14
21-12-2020,OURÉM,129,9,293,"[240,480]",Elevado,,,,129,Lisboa e Vale do Tejo,SANTARÉM,1421,41668.03,44044,2463,2069,1899,1817,1603,3420,5319,7388,9851,105.7,23.64,17.73,12.77
21-12-2020,OURIQUE,1,0,22,"[0,240]",Moderado,,,,1,Alentejo,BEJA,0212,66331.36,4607,313,287,284,268,227,495,779,1066,1379,6.95,2.08,1.61,1.17
21-12-2020,OVAR,238,17,439,"[240,480]",Elevado,,,,238,Centro,AVEIRO,0115,14770.25,54260,3294,2709,1994,1636,1234,2870,4864,7573,10867,367.37,73.57,51.27,32.93
21-12-2020,PAÇOS DE FERREIRA,224,16,395,"[240,480]",Elevado,,,,224,Norte,PORTO,1309,7099.29,56728,2903,2193,1518,1135,664,1799,3317,5510,8413,799.1,118.51,77.62,46.72
21-12-2020,PALMELA,249,18,387,"[240,480]",Elevado,,,,249,Lisboa e Vale do Tejo,SETÚBAL,1508,46512.01,64269,3402,3244,2635,1846,1391,3237,5872,9116,12518,138.18,26.91,19.6,12.62
21-12-2020,PAMPILHOSA DA SERRA,14,1,347,"[240,480]",Elevado,,,,14,Centro,COIMBRA,0612,39646.24,4037,238,254,295,339,423,762,1057,1311,1549,10.18,3.91,3.31,2.67
21-12-2020,PAREDES,511,37,594,"[480,960]",Muito Elevado,,,,511,Norte,PORTO,1310,15675.69,86067,4272,3532,2412,1717,1258,2975,5387,8919,13191,549.04,84.15,56.9,34.36
21-12-2020,PAREDES DE COURA,12,1,141,"[0,240]",Moderado,,,,12,Norte,VIANA DO CASTELO,1605,13818.59,8535,466,528,407,465,515,980,1387,1915,2381,61.76,17.23,13.86,10.04
21-12-2020,PEDRÓGÃO GRANDE,14,1,411,"[240,480]",Elevado,,,,14,Centro,LEIRIA,1013,12874.75,3410,175,173,196,221,252,473,669,842,1017,26.49,7.9,6.54,5.2
21-12-2020,PENACOVA,73,5,533,"[480,960]",Muito Elevado,,,,73,Centro,COIMBRA,0613,21673.23,13694,968,923,745,621,703,1324,2069,2992,3960,63.18,18.27,13.81,9.55
21-12-2020,PENAFIEL,354,25,507,"[480,960]",Muito Elevado,,,,354,Norte,PORTO,1311,21224.27,69772,3648,2823,2032,1663,1230,2893,4925,7748,11396,328.74,53.69,36.51,23.2
21-12-2020,PENALVA DO CASTELO,10,1,141,"[0,240]",Moderado,,,,10,Centro,VISEU,1811,13433.92,7115,449,457,413,391,426,817,1230,1687,2136,52.96,15.9,12.56,9.16
21-12-2020,PENAMACOR,98,7,2061,"[960,Max]",Extremamente Elevado,,,,98,Centro,CASTELO BRANCO,0507,56370.69,4755,262,248,273,451,633,1084,1357,1605,1867,8.44,3.31,2.85,2.41
21-12-2020,PENEDONO,14,1,540,"[480,960]",Muito Elevado,,,,14,Norte,VISEU,1812,13370.75,2591,172,113,129,156,138,294,423,536,708,19.38,5.3,4.01,3.16
21-12-2020,PENELA,20,1,371,"[240,480]",Elevado,,,,20,Centro,COIMBRA,0614,13480.0,5397,314,324,274,359,344,703,977,1301,1615,40.04,11.98,9.65,7.25
21-12-2020,PENICHE,111,8,419,"[240,480]",Elevado,,,,111,Lisboa e Vale do Tejo,LEIRIA,1014,7754.98,26501,1746,1504,1203,926,707,1633,2836,4340,6086,341.73,78.48,55.96,36.57
21-12-2020,PESO DA RÉGUA,133,9,843,"[480,960]",Muito Elevado,,,,133,Norte,VILA REAL,1708,9486.01,15773,1076,843,650,659,455,1114,1764,2607,3683,166.28,38.83,27.48,18.6
21-12-2020,PINHEL,92,7,1081,"[960,Max]",Extremamente Elevado,,,,92,Centro,GUARDA,0910,48452.12,8511,577,566,551,538,689,1227,1778,2344,2921,17.57,6.03,4.84,3.67
21-12-2020,POMBAL,183,13,356,"[240,480]",Elevado,,,,183,Centro,LEIRIA,1015,62600.28,51461,3187,2791,2494,2328,2027,4355,6849,9640,12827,82.21,20.49,15.4,10.94
21-12-2020,PONTA DELGADA,59,4,87,"[0,240]",Moderado,,,,59,Açores,AÇORES,4203,23298.65,67935,3108,2435,1726,1133,902,2035,3761,6196,9304,291.58,39.93,26.59,16.14
21-12-2020,PONTA DO SOL,1,0,12,"[0,240]",Moderado,,,,1,Madeira,MADEIRA,3105,4622.03,8593,319,283,347,208,221,429,776,1059,1378,185.92,29.81,22.91,16.79
21-12-2020,PONTE DA BARCA,102,7,912,"[480,960]",Muito Elevado,,,,102,Norte,VIANA DO CASTELO,1606,18211.37,11180,635,576,517,554,490,1044,1561,2137,2772,61.39,15.22,11.73,8.57
21-12-2020,PONTE DE LIMA,198,14,479,"[240,480]",Elevado,,,,198,Norte,VIANA DO CASTELO,1607,32025.46,41315,2321,2022,1720,1596,1462,3058,4778,6800,9121,129.01,28.48,21.23,14.92
21-12-2020,PONTE DE SOR,26,2,173,"[0,240]",Moderado,,,,26,Alentejo,PORTALEGRE,1213,83971.16,14994,939,800,716,739,831,1570,2286,3086,4025,17.86,4.79,3.68,2.72
21-12-2020,PORTALEGRE,196,14,884,"[480,960]",Muito Elevado,,,,196,Alentejo,PORTALEGRE,1214,44713.64,22172,1577,1351,1137,993,984,1977,3114,4465,6042,49.59,13.51,9.99,6.96
21-12-2020,PORTEL,12,1,206,"[0,240]",Moderado,,,,12,Alentejo,ÉVORA,0709,60100.57,5828,336,358,283,331,305,636,919,1277,1613,9.7,2.68,2.12,1.53
21-12-2020,PORTIMÃO,99,7,178,"[0,240]",Moderado,,,,99,Algarve,FARO,0811,18206.29,55483,3182,2927,2116,1582,1400,2982,5098,8025,11207,304.75,61.56,44.08,28.0
21-12-2020,PORTO,1144,82,528,"[480,960]",Muito Elevado,,,,1144,Norte,PORTO,1312,4142.02,216606,15790,15193,11280,9409,10044,19453,30733,45926,61716,5229.5,1490.0,1108.79,741.98
21-12-2020,PORTO DE MÓS,165,12,709,"[480,960]",Muito Elevado,,,,165,Centro,LEIRIA,1016,26183.41,23275,1355,1210,1034,888,872,1760,2794,4004,5359,88.89,20.47,15.29,10.67
21-12-2020,PORTO MONIZ,1,0,43,"[0,240]",Moderado,,,,1,Madeira,MADEIRA,3106,8293.38,2342,143,130,95,98,120,218,313,443,586,28.24,7.07,5.34,3.77
21-12-2020,PORTO SANTO,1,0,19,"[0,240]",Moderado,,,,1,Madeira,MADEIRA,3201,4300.7,5202,240,157,134,110,68,178,312,469,709,120.95,16.48,10.9,7.25
21-12-2020,PÓVOA DE LANHOSO,205,15,954,"[480,960]",Muito Elevado,,,,205,Norte,BRAGA,0309,13465.29,21499,1175,909,732,673,624,1297,2029,2938,4113,159.67,30.55,21.82,15.07
21-12-2020,PÓVOA DE VARZIM,593,42,945,"[480,960]",Muito Elevado,,,,593,Norte,PORTO,1313,8220.59,62784,3712,3120,2134,1594,1305,2899,5033,8153,11865,763.7,144.33,99.17,61.22
21-12-2020,POVOAÇÃO,5,0,84,"[0,240]",Moderado,,,,5,Açores,AÇORES,4204,10640.77,5927,293,212,191,144,134,278,469,681,974,55.7,9.15,6.4,4.41
21-12-2020,VILA DA PRAIA DA VITÓRIA,24,2,113,"[0,240]",Moderado,,,,24,Açores,AÇORES,4302,16127.06,21317,1133,789,619,436,336,772,1391,2180,3313,132.18,20.54,13.52,8.63
21-12-2020,PROENÇA-A-NOVA,9,1,123,"[0,240]",Moderado,,,,9,Centro,CASTELO BRANCO,0508,39539.96,7298,508,465,389,400,560,960,1349,1814,2322,18.46,5.87,4.59,3.41
21-12-2020,REDONDO,7,0,110,"[0,240]",Moderado,,,,7,Alentejo,ÉVORA,0710,36950.87,6353,349,325,288,288,354,642,930,1255,1604,17.19,4.34,3.4,2.52
21-12-2020,REGUENGOS DE MONSARAZ,10,1,100,"[0,240]",Moderado,,,,10,Alentejo,ÉVORA,0711,46399.72,10015,602,511,455,462,473,935,1390,1901,2503,21.58,5.39,4.1,3.0
21-12-2020,RESENDE,48,3,474,"[240,480]",Elevado,,,,48,Norte,VISEU,1813,12334.93,10137,560,493,448,433,422,855,1303,1796,2356,82.18,19.1,14.56,10.56
21-12-2020,RIBEIRA BRAVA,9,1,72,"[0,240]",Moderado,,,,9,Madeira,MADEIRA,3107,6544.88,12435,648,500,411,311,287,598,1009,1509,2157,189.99,32.96,23.06,15.42
21-12-2020,RIBEIRA DE PENA,28,2,465,"[240,480]",Elevado,,,,28,Norte,VILA REAL,1709,21745.98,6016,371,301,290,310,368,678,968,1269,1640,27.66,7.54,5.84,4.45
21-12-2020,RIBEIRA GRANDE,144,10,439,"[240,480]",Elevado,,,,144,Açores,AÇORES,4205,18015.13,32811,1163,689,512,345,253,598,1110,1799,2962,182.13,16.44,9.99,6.16
21-12-2020,RIO MAIOR,107,8,525,"[480,960]",Muito Elevado,,,,107,Lisboa e Vale do Tejo,SANTARÉM,1414,27276.45,20379,1251,1144,941,795,648,1443,2384,3528,4779,74.71,17.52,12.93,8.74
21-12-2020,SABROSA,20,1,338,"[240,480]",Elevado,,,,20,Norte,VILA REAL,1710,15692.45,5918,393,314,304,302,350,652,956,1270,1663,37.71,10.6,8.09,6.09
21-12-2020,SABUGAL,92,7,869,"[480,960]",Muito Elevado,,,,92,Centro,GUARDA,0911,82269.82,10585,724,707,694,796,1009,1805,2499,3206,3930,12.87,4.78,3.9,3.04
21-12-2020,SALVATERRA DE MAGOS,69,5,324,"[240,480]",Elevado,,,,69,Lisboa e Vale do Tejo,SANTARÉM,1415,24393.2,21295,1275,1181,1060,799,772,1571,2631,3812,5087,87.3,20.85,15.63,10.79
21-12-2020,SANTA COMBA DÃO,37,3,354,"[240,480]",Elevado,,,,37,Centro,VISEU,1814,11194.77,10452,732,684,569,538,464,1002,1571,2255,2987,93.36,26.68,20.14,14.03
21-12-2020,SANTA CRUZ,59,4,130,"[0,240]",Moderado,,,,59,Madeira,MADEIRA,3108,8150.28,45281,1817,1301,974,716,523,1239,2213,3514,5331,555.6,65.41,43.12,27.15
21-12-2020,SANTA CRUZ DA GRACIOSA,1,0,24,"[0,240]",Moderado,,,,1,Açores,AÇORES,4401,6065.78,4208,228,180,163,124,145,269,432,612,840,69.37,13.85,10.09,7.12
21-12-2020,SANTA CRUZ DAS FLORES,0,0,0,"[0,240]",Moderado,,,,0,Açores,AÇORES,4802,7091.44,2165,125,98,74,56,51,107,181,279,404,30.53,5.7,3.93,2.55
21-12-2020,SANTA MARIA DA FEIRA,871,62,628,"[480,960]",Muito Elevado,,,,871,Norte,AVEIRO,0109,21587.65,138636,8182,6743,4771,3856,3079,6935,11706,18449,26631,642.19,123.36,85.46,54.22
21-12-2020,SANTA MARTA DE PENAGUIÃO,42,3,636,"[480,960]",Muito Elevado,,,,42,Norte,VILA REAL,1711,6928.13,6599,483,373,337,316,317,633,970,1343,1826,95.25,26.36,19.39,14.0
21-12-2020,SANTANA,6,0,89,"[0,240]",Moderado,,,,6,Madeira,MADEIRA,3109,9547.3,6711,418,353,343,282,277,559,902,1255,1673,70.29,17.52,13.15,9.45
21-12-2020,SANTARÉM,289,21,503,"[480,960]",Muito Elevado,,,,289,Lisboa e Vale do Tejo,SANTARÉM,1416,55253.58,57421,3654,3441,2760,2466,2206,4672,7432,10873,14527,103.92,26.29,19.68,13.45
21-12-2020,SANTIAGO DO CACÉM,27,2,94,"[0,240]",Moderado,,,,27,Alentejo,SETÚBAL,1509,105969.29,28791,2144,1689,1472,1295,1215,2510,3982,5671,7815,27.17,7.37,5.35,3.76
21-12-2020,SANTO TIRSO,408,29,600,"[480,960]",Muito Elevado,,,,408,Norte,PORTO,1314,13655.52,68055,4911,3935,2761,2257,1810,4067,6828,10763,15674,498.35,114.78,78.82,50.0
21-12-2020,SÃO BRÁS DE ALPORTEL,35,2,336,"[240,480]",Elevado,,,,35,Algarve,FARO,0812,15336.92,10416,596,468,467,404,401,805,1272,1740,2336,67.91,15.23,11.35,8.29
21-12-2020,SÃO JOÃO DA MADEIRA,158,11,720,"[480,960]",Muito Elevado,,,,158,Norte,AVEIRO,0116,794.3,21958,1347,1069,796,601,593,1194,1990,3059,4406,2765.49,554.91,385.26,250.63
21-12-2020,SÃO JOÃO DA PESQUEIRA,26,2,365,"[240,480]",Elevado,,,,26,Norte,VISEU,1815,26610.85,7125,417,330,294,328,328,656,950,1280,1697,26.77,6.38,4.81,3.57
21-12-2020,SÃO PEDRO DO SUL,88,6,571,"[480,960]",Muito Elevado,,,,88,Centro,VISEU,1816,34895.09,15403,990,962,861,759,909,1668,2529,3491,4481,44.14,12.84,10.0,7.25
21-12-2020,SÃO ROQUE DO PICO,0,0,0,"[0,240]",Moderado,,,,0,Açores,AÇORES,4603,14236.1,3266,199,141,93,96,113,209,302,443,642,22.94,4.51,3.11,2.12
21-12-2020,SÃO VICENTE,5,0,97,"[0,240]",Moderado,,,,5,Madeira,MADEIRA,3110,7883.71,5143,272,264,266,225,280,505,771,1035,1307,65.23,16.58,13.13,9.78
21-12-2020,SARDOAL,8,1,214,"[0,240]",Moderado,,,,8,Lisboa e Vale do Tejo,SANTARÉM,1417,9214.72,3741,227,178,148,165,248,413,561,739,966,40.6,10.48,8.02,6.09
21-12-2020,SÁTÃO,41,3,354,"[240,480]",Elevado,,,,41,Centro,VISEU,1817,20194.11,11580,765,671,515,465,476,941,1456,2127,2892,57.34,14.32,10.53,7.21
21-12-2020,SEIA,135,10,607,"[480,960]",Muito Elevado,,,,135,Centro,GUARDA,0912,43568.83,22234,1807,1589,1238,1122,721,1843,3081,4670,6477,51.03,14.87,10.72,7.07
21-12-2020,SEIXAL,763,55,455,"[240,480]",Elevado,,,,763,Lisboa e Vale do Tejo,SETÚBAL,1510,9545.17,167752,10586,9270,6661,4391,2930,7321,13982,23252,33838,1757.49,354.51,243.6,146.49
21-12-2020,SERNANCELHE,34,2,630,"[480,960]",Muito Elevado,,,,34,Norte,VISEU,1818,22861.22,5396,305,293,286,273,260,533,819,1112,1417,23.6,6.2,4.86,3.58
21-12-2020,SERPA,108,8,755,"[480,960]",Muito Elevado,,,,108,Alentejo,BEJA,0213,110563.34,14304,903,761,719,697,626,1323,2042,2803,3706,12.94,3.35,2.54,1.85
21-12-2020,SERTÃ,35,2,240,"[240,480]",Elevado,,,,35,Centro,CASTELO BRANCO,0509,44673.17,14577,870,779,790,767,1020,1787,2577,3356,4226,32.63,9.46,7.51,5.77
21-12-2020,SESIMBRA,216,15,417,"[240,480]",Elevado,,,,216,Lisboa e Vale do Tejo,SETÚBAL,1511,19571.75,51858,2400,2321,1853,1257,1083,2340,4193,6514,8914,264.96,45.54,33.28,21.42
21-12-2020,SETÚBAL,456,33,396,"[240,480]",Elevado,,,,456,Lisboa e Vale do Tejo,SETÚBAL,1512,23032.5,115126,7425,6929,5075,3775,2655,6430,11505,18434,25859,499.83,112.27,80.03,49.95
21-12-2020,SEVER DO VOUGA,51,4,450,"[240,480]",Elevado,,,,51,Centro,AVEIRO,0117,12987.56,11331,766,637,568,540,567,1107,1675,2312,3078,87.24,23.7,17.8,12.9
21-12-2020,SILVES,70,5,193,"[0,240]",Moderado,,,,70,Algarve,FARO,0813,68006.23,36226,2137,1869,1610,1423,1600,3023,4633,6502,8639,53.27,12.7,9.56,6.81
21-12-2020,SINES,10,1,73,"[0,240]",Moderado,,,,10,Alentejo,SETÚBAL,1513,20330.17,13715,888,791,551,416,268,684,1235,2026,2914,67.46,14.33,9.97,6.07
21-12-2020,SINTRA,1523,109,389,"[240,480]",Elevado,,,,1523,Lisboa e Vale do Tejo,LISBOA,1111,31922.73,391402,20490,18316,13545,9137,7284,16421,29966,48282,68772,1226.08,215.43,151.25,93.87
21-12-2020,SOBRAL DE MONTE AGRAÇO,23,2,216,"[0,240]",Moderado,,,,23,Lisboa e Vale do Tejo,LISBOA,1112,5210.32,10651,564,507,352,272,212,484,836,1343,1907,204.43,36.6,25.78,16.05
21-12-2020,SOURE,57,4,333,"[240,480]",Elevado,,,,57,Centro,COIMBRA,0615,26506.07,17120,1173,1142,1004,883,987,1870,2874,4016,5189,64.59,19.58,15.15,10.84
21-12-2020,SOUSEL,16,1,363,"[240,480]",Elevado,,,,16,Alentejo,PORTALEGRE,1215,27932.18,4412,261,274,208,302,292,594,802,1076,1337,15.8,4.79,3.85,2.87
21-12-2020,TÁBUA,51,4,449,"[240,480]",Elevado,,,,51,Centro,COIMBRA,0616,19978.58,11368,729,584,524,430,464,894,1418,2002,2731,56.9,13.67,10.02,7.1
21-12-2020,TABUAÇO,113,8,1873,"[960,Max]",Extremamente Elevado,,,,113,Norte,VISEU,1819,13385.67,6033,372,314,217,282,363,645,862,1176,1548,45.07,11.56,8.79,6.44
21-12-2020,TAROUCA,30,2,384,"[240,480]",Elevado,,,,30,Norte,VISEU,1820,10008.49,7804,405,335,313,277,324,601,914,1249,1654,77.98,16.53,12.48,9.13
21-12-2020,TAVIRA,24,2,98,"[0,240]",Moderado,,,,24,Algarve,FARO,0814,60696.7,24530,1493,1415,1252,1066,1277,2343,3595,5010,6503,40.41,10.71,8.25,5.92
21-12-2020,TERRAS DE BOURO,55,4,865,"[480,960]",Muito Elevado,,,,55,Norte,BRAGA,0310,27746.07,6361,391,372,296,319,340,659,955,1327,1718,22.93,6.19,4.78,3.44
21-12-2020,TOMAR,65,5,177,"[0,240]",Moderado,,,,65,Lisboa e Vale do Tejo,SANTARÉM,1418,35120.44,36748,2403,2189,1868,1853,1822,3675,5543,7732,10135,104.64,28.86,22.02,15.78
21-12-2020,TONDELA,63,4,239,"[0,240]",Moderado,,,,63,Centro,VISEU,1821,37121.73,26357,1768,1722,1518,1475,1417,2892,4410,6132,7900,71.0,21.28,16.52,11.88
21-12-2020,TORRE DE MONCORVO,16,1,208,"[0,240]",Moderado,,,,16,Norte,BRAGANÇA,0409,53155.67,7695,556,478,488,551,719,1270,1758,2236,2792,14.48,5.25,4.21,3.31
21-12-2020,TORRES NOVAS,123,9,352,"[240,480]",Elevado,,,,123,Lisboa e Vale do Tejo,SANTARÉM,1419,26999.68,34933,2324,1979,1738,1406,1475,2881,4619,6598,8922,129.38,33.04,24.44,17.11
21-12-2020,TORRES VEDRAS,275,20,350,"[240,480]",Elevado,,,,275,Lisboa e Vale do Tejo,LISBOA,1113,40714.89,78530,4513,3945,3447,2628,2104,4732,8179,12124,16637,192.88,40.86,29.78,20.09
21-12-2020,TRANCOSO,17,1,192,"[0,240]",Moderado,,,,17,Centro,GUARDA,0913,36152.47,8875,581,557,542,586,496,1082,1624,2181,2762,24.55,7.64,6.03,4.49
21-12-2020,TROFA,405,29,1054,"[960,Max]",Extremamente Elevado,,,,405,Norte,PORTO,1318,7201.76,38418,2336,1894,1231,939,684,1623,2854,4748,7084,533.44,98.36,65.93,39.63
21-12-2020,VAGOS,94,7,413,"[240,480]",Elevado,,,,94,Centro,AVEIRO,0118,16491.5,22740,1320,1205,922,784,724,1508,2430,3635,4955,137.89,30.04,22.04,14.73
21-12-2020,VALE DE CAMBRA,67,5,314,"[240,480]",Elevado,,,,67,Norte,AVEIRO,0119,14733.47,21327,1491,1363,1005,831,798,1629,2634,3997,5488,144.76,37.25,27.13,17.88
21-12-2020,VALENÇA,38,3,286,"[240,480]",Elevado,,,,38,Norte,VIANA DO CASTELO,1608,11712.86,13290,867,791,582,582,503,1085,1667,2458,3325,113.46,28.39,20.99,14.23
21-12-2020,VALONGO,502,36,515,"[480,960]",Muito Elevado,,,,502,Norte,PORTO,1315,7512.45,97444,5629,4696,3207,2462,1829,4291,7498,12194,17823,1297.18,237.26,162.33,99.81
21-12-2020,VALPAÇOS,171,12,1154,"[960,Max]",Extremamente Elevado,,,,171,Norte,VILA REAL,1712,54873.93,14818,1217,1118,999,928,997,1925,2924,4042,5259,27.0,9.58,7.37,5.33
21-12-2020,VELAS,3,0,59,"[0,240]",Moderado,,,,3,Açores,AÇORES,4502,11738.38,5093,278,208,166,153,113,266,432,640,918,43.39,7.82,5.45,3.68
21-12-2020,VENDAS NOVAS,72,5,640,"[480,960]",Muito Elevado,,,,72,Alentejo,ÉVORA,0712,22238.88,11255,677,768,655,501,532,1033,1688,2456,3133,50.61,14.09,11.04,7.59
21-12-2020,VIANA DO ALENTEJO,28,2,544,"[480,960]",Muito Elevado,,,,28,Alentejo,ÉVORA,0713,39367.29,5145,245,208,235,210,214,424,659,867,1112,13.07,2.82,2.2,1.67
21-12-2020,VIANA DO CASTELO,352,25,417,"[240,480]",Elevado,,,,352,Norte,VIANA DO CASTELO,1609,31902.01,84417,5470,4433,3591,3061,2982,6043,9634,14067,19537,264.61,61.24,44.09,30.2
21-12-2020,VIDIGUEIRA,46,3,835,"[480,960]",Muito Elevado,,,,46,Alentejo,BEJA,0214,31661.09,5510,300,248,215,233,275,508,723,971,1271,17.4,4.01,3.07,2.28
21-12-2020,VIEIRA DO MINHO,93,7,785,"[480,960]",Muito Elevado,,,,93,Norte,BRAGA,0311,21644.35,11842,703,594,525,548,482,1030,1555,2149,2852,54.71,13.18,9.93,7.18
21-12-2020,VILA DE REI,8,1,241,"[240,480]",Elevado,,,,8,Centro,CASTELO BRANCO,0510,19154.6,3323,169,128,172,247,302,549,721,849,1018,17.35,5.31,4.43,3.76
21-12-2020,VILA DO BISPO,2,0,39,"[0,240]",Moderado,,,,2,Algarve,FARO,0815,17906.06,5154,302,302,314,232,233,465,779,1081,1383,28.78,7.72,6.04,4.35
21-12-2020,VILA DO CONDE,698,50,874,"[480,960]",Muito Elevado,,,,698,Norte,PORTO,1316,14902.77,79899,4726,3875,2819,2070,1743,3813,6632,10507,15233,536.13,102.21,70.5,44.5
21-12-2020,VILA DO PORTO,1,0,18,"[0,240]",Moderado,,,,1,Açores,AÇORES,4101,9688.74,5616,274,212,135,96,123,219,354,566,840,57.96,8.67,5.84,3.65
21-12-2020,VILA FLOR,34,2,563,"[480,960]",Muito Elevado,,,,34,Norte,BRAGANÇA,0410,26581.14,6044,429,362,422,294,331,625,1047,1409,1838,22.74,6.91,5.3,3.94
21-12-2020,VILA FRANCA DE XIRA,488,35,344,"[240,480]",Elevado,,,,488,Lisboa e Vale do Tejo,LISBOA,1114,31819.39,141957,8501,6852,4869,3425,2472,5897,10766,17618,26119,446.14,82.09,55.37,33.84
21-12-2020,VILA FRANCA DO CAMPO,60,4,543,"[480,960]",Muito Elevado,,,,60,Açores,AÇORES,4206,7796.82,11051,450,344,248,217,154,371,619,963,1413,141.73,18.12,12.35,7.94
21-12-2020,VILA NOVA DA BARQUINHA,17,1,228,"[0,240]",Moderado,,,,17,Lisboa e Vale do Tejo,SANTARÉM,1420,4952.97,7461,415,406,392,364,338,702,1094,1500,1915,150.64,38.66,30.28,22.09
21-12-2020,VILA NOVA DE CERVEIRA,23,2,258,"[240,480]",Elevado,,,,23,Norte,VIANA DO CASTELO,1610,10846.66,8910,531,444,410,384,334,718,1128,1572,2103,82.14,19.39,14.49,10.4
21-12-2020,VILA NOVA DE FAMALICÃO,1181,84,897,"[480,960]",Muito Elevado,,,,1181,Norte,BRAGA,0312,20159.26,131676,7817,6164,4202,3282,2749,6031,10233,16397,24214,653.19,120.12,81.34,50.76
21-12-2020,VILA NOVA DE FOZ CÔA,6,0,92,"[0,240]",Moderado,,,,6,Centro,GUARDA,0914,39815.18,6503,442,385,390,398,429,827,1217,1602,2044,16.33,5.13,4.02,3.06
21-12-2020,VILA NOVA DE GAIA,1574,112,524,"[480,960]",Muito Elevado,,,,1574,Norte,PORTO,1317,16846.43,300472,18349,15568,10972,8224,6281,14505,25477,41045,59394,1783.64,352.57,243.65,151.23
21-12-2020,VILA NOVA DE PAIVA,0,0,0,"[0,240]",Moderado,,,,0,Centro,VISEU,1822,17553.28,4687,289,272,233,217,241,458,691,963,1252,26.7,7.13,5.49,3.94
21-12-2020,VILA NOVA DE POIARES,14,1,202,"[0,240]",Moderado,,,,14,Centro,COIMBRA,0617,8445.3,6939,380,284,262,235,182,417,679,963,1343,82.17,15.9,11.4,8.04
21-12-2020,VILA POUCA DE AGUIAR,129,9,1079,"[960,Max]",Extremamente Elevado,,,,129,Norte,VILA REAL,1713,43706.62,11961,860,817,733,601,627,1228,1961,2778,3638,27.37,8.32,6.36,4.49
21-12-2020,VILA REAL,363,26,727,"[480,960]",Muito Elevado,,,,363,Norte,VILA REAL,1714,37880.28,49962,3025,2498,2065,1579,1466,3045,5110,7608,10633,131.9,28.07,20.08,13.49
21-12-2020,VILA REAL DE SANTO ANTÓNIO,42,3,224,"[0,240]",Moderado,,,,42,Algarve,FARO,0816,6125.0,18749,1172,1069,811,569,586,1155,1966,3035,4207,306.11,68.69,49.55,32.1
21-12-2020,VILA VELHA DE RÓDÃO,7,1,223,"[0,240]",Moderado,,,,7,Centro,CASTELO BRANCO,0511,32991.16,3144,209,229,180,283,306,589,769,998,1207,9.53,3.66,3.03,2.33
21-12-2020,VILA VERDE,343,24,731,"[480,960]",Muito Elevado,,,,343,Norte,BRAGA,0313,22866.52,46911,2365,2063,1667,1494,1437,2931,4598,6661,9026,205.15,39.47,29.13,20.11
21-12-2020,VILA VIÇOSA,9,1,118,"[0,240]",Moderado,,,,9,Alentejo,ÉVORA,0714,19485.89,7656,487,379,342,345,324,669,1011,1390,1877,39.29,9.63,7.13,5.19
21-12-2020,VIMIOSO,129,9,3207,"[960,Max]",Extremamente Elevado,,,,129,Norte,BRAGANÇA,0411,48158.51,4023,274,230,261,293,335,628,889,1119,1393,8.35,2.89,2.32,1.85
21-12-2020,VINHAIS,28,2,361,"[240,480]",Elevado,,,,28,Norte,BRAGANÇA,0412,69475.09,7746,599,577,636,641,815,1456,2092,2669,3268,11.15,4.7,3.84,3.01
21-12-2020,VISEU,530,38,545,"[480,960]",Muito Elevado,,,,530,Centro,VISEU,1823,50710.14,97249,5769,5038,4140,3158,2710,5868,10008,15046,20815,191.77,41.05,29.67,19.74
21-12-2020,VIZELA,82,6,343,"[240,480]",Elevado,,,,82,Norte,BRAGA,0314,2469.83,23897,1258,928,655,509,371,880,1535,2463,3721,967.49,150.65,99.72,62.15
21-12-2020,VOUZELA,34,2,353,"[240,480]",Elevado,,,,34,Centro,VISEU,1824,19369.46,9619,626,605,554,532,507,1039,1593,2198,2824,49.66,14.58,11.35,8.22
28-12-2020,ABRANTES,74,5,211,"[0,240]",Moderado,,,,74,Lisboa e Vale do Tejo,SANTARÉM,1401,71469.08,35130,2473,2213,1730,1748,2021,3769,5499,7712,10185,49.15,14.25,10.79,7.69
28-12-2020,ÁGUEDA,208,15,451,"[240,480]",Elevado,,,,208,Centro,AVEIRO,0101,33527.44,46075,3237,2713,2090,1635,1496,3131,5221,7934,11171,137.43,33.32,23.66,15.57
28-12-2020,AGUIAR DA BEIRA,19,1,408,"[240,480]",Elevado,,,,19,Centro,GUARDA,0901,20676.57,4652,304,281,235,239,148,387,622,903,1207,22.5,5.84,4.37,3.01
28-12-2020,ALANDROAL,36,3,721,"[480,960]",Muito Elevado,,,,36,Alentejo,ÉVORA,0701,54267.81,4992,307,256,296,299,377,676,972,1228,1535,9.2,2.83,2.26,1.79
28-12-2020,ALBERGARIA-A-VELHA,85,6,352,"[240,480]",Elevado,,,,85,Centro,AVEIRO,0102,15882.5,24144,1550,1298,996,687,680,1367,2363,3661,5211,152.02,32.81,23.05,14.88
28-12-2020,ALBUFEIRA,118,8,284,"[240,480]",Elevado,,,,118,Algarve,FARO,0801,14066.42,41528,2067,1717,1425,985,858,1843,3268,4985,7052,295.24,50.14,35.44,23.23
28-12-2020,ALCÁCER DO SAL,34,2,292,"[240,480]",Elevado,,,,34,Alentejo,SETÚBAL,1501,149987.3,11659,884,814,623,623,602,1225,1848,2662,3546,7.77,2.36,1.77,1.23
28-12-2020,ALCANENA,36,3,281,"[240,480]",Elevado,,,,36,Lisboa e Vale do Tejo,SANTARÉM,1402,12732.86,12809,891,744,628,536,588,1124,1752,2496,3387,100.6,26.6,19.6,13.76
28-12-2020,ALCOBAÇA,141,10,263,"[240,480]",Elevado,,,,141,Lisboa e Vale do Tejo,LEIRIA,1001,40814.09,53555,3420,2927,2466,2059,1676,3735,6201,9128,12548,131.22,30.74,22.36,15.19
28-12-2020,ALCOCHETE,136,10,687,"[480,960]",Muito Elevado,,,,136,Lisboa e Vale do Tejo,SETÚBAL,1502,12836.48,19787,857,834,691,476,447,923,1614,2448,3305,154.15,25.75,19.07,12.57
28-12-2020,ALCOUTIM,0,0,0,"[0,240]",Moderado,,,,0,Algarve,FARO,0802,57536.33,2159,191,188,163,190,267,457,620,808,999,3.75,1.74,1.4,1.08
28-12-2020,ALENQUER,222,16,504,"[480,960]",Muito Elevado,,,,222,Lisboa e Vale do Tejo,LISBOA,1101,30421.92,44052,2298,2062,1629,1330,1155,2485,4114,6176,8474,144.8,27.85,20.3,13.52
28-12-2020,ALFÂNDEGA DA FÉ,56,4,1231,"[960,Max]",Extremamente Elevado,,,,56,Norte,BRAGANÇA,0401,32194.64,4550,325,277,301,274,325,599,900,1177,1502,14.13,4.67,3.66,2.8
28-12-2020,ALIJÓ,34,2,320,"[240,480]",Elevado,,,,34,Norte,VILA REAL,1701,29759.89,10625,766,687,635,542,666,1208,1843,2530,3296,35.7,11.08,8.5,6.19
28-12-2020,ALJEZUR,8,1,143,"[0,240]",Moderado,,,,8,Algarve,FARO,0803,32349.95,5594,316,336,335,320,410,730,1065,1401,1717,17.29,5.31,4.33,3.29
28-12-2020,ALJUSTREL,3,0,36,"[0,240]",Moderado,,,,3,Alentejo,BEJA,0201,45847.41,8247,635,521,443,347,358,705,1148,1669,2304,17.99,5.03,3.64,2.5
28-12-2020,ALMADA,723,52,428,"[240,480]",Elevado,,,,723,Lisboa e Vale do Tejo,SETÚBAL,1503,7000.89,169039,10469,9777,7876,6144,5111,11255,19131,28908,39377,2414.5,562.45,412.91,273.26
28-12-2020,ALMEIDA,7,0,120,"[0,240]",Moderado,,,,7,Centro,GUARDA,0902,51798.46,5830,441,419,396,458,393,851,1247,1666,2107,11.26,4.07,3.22,2.41
28-12-2020,ALMEIRIM,44,3,195,"[0,240]",Moderado,,,,44,Lisboa e Vale do Tejo,SANTARÉM,1403,22212.05,22546,1342,1353,1106,866,843,1709,2815,4168,5510,101.5,24.81,18.76,12.67
28-12-2020,ALMODÔVAR,4,0,59,"[0,240]",Moderado,,,,4,Alentejo,BEJA,0202,77788.03,6725,414,443,396,373,328,701,1097,1540,1954,8.65,2.51,1.98,1.41
28-12-2020,ALPIARÇA,13,1,184,"[0,240]",Moderado,,,,13,Lisboa e Vale do Tejo,SANTARÉM,1404,9536.33,7059,515,486,363,333,274,607,970,1456,1971,74.02,20.67,15.27,10.17
28-12-2020,ALTER DO CHÃO,15,1,474,"[240,480]",Elevado,,,,15,Alentejo,PORTALEGRE,1201,36206.62,3165,201,163,136,208,187,395,531,694,895,8.74,2.47,1.92,1.47
28-12-2020,ALVAIÁZERE,20,1,303,"[240,480]",Elevado,,,,20,Centro,LEIRIA,1002,16047.76,6597,419,389,346,406,539,945,1291,1680,2099,41.11,13.08,10.47,8.04
28-12-2020,ALVITO,3,0,121,"[0,240]",Moderado,,,,3,Alentejo,BEJA,0203,26485.32,2477,145,110,105,111,89,200,305,415,560,9.35,2.11,1.57,1.15
28-12-2020,AMADORA,707,50,384,"[240,480]",Elevado,,,,707,Lisboa e Vale do Tejo,LISBOA,1115,2378.47,184106,11186,10936,8780,6460,5890,12350,21130,32066,43252,7742.05,1818.84,1348.44,888.56
28-12-2020,AMARANTE,330,24,620,"[480,960]",Muito Elevado,,,,330,Norte,PORTO,1301,30133.15,53193,3086,2413,1812,1643,1311,2954,4766,7179,10265,176.53,34.07,23.82,15.82
28-12-2020,AMARES,88,6,485,"[480,960]",Muito Elevado,,,,88,Norte,BRAGA,0301,8195.41,18129,1001,829,622,489,524,1013,1635,2464,3465,221.22,42.28,30.07,19.95
28-12-2020,ANADIA,188,13,690,"[480,960]",Muito Elevado,,,,188,Centro,AVEIRO,0103,21663.48,27258,1931,1698,1376,1208,1262,2470,3846,5544,7475,125.83,34.51,25.59,17.75
28-12-2020,ANGRA DO HEROÍSMO,48,3,142,"[0,240]",Moderado,,,,48,Açores,AÇORES,4301,23899.66,33807,2006,1473,1122,768,635,1403,2525,3998,6004,141.45,25.12,16.73,10.56
28-12-2020,ANSIÃO,81,6,673,"[480,960]",Muito Elevado,,,,81,Centro,LEIRIA,1003,17609.42,12039,727,709,646,694,530,1224,1870,2579,3306,68.37,18.77,14.65,10.62
28-12-2020,ARCOS DE VALDEVEZ,75,5,358,"[240,480]",Elevado,,,,75,Norte,VIANA DO CASTELO,1601,44759.64,20926,1329,1338,1282,1343,1515,2858,4140,5478,6807,46.75,15.21,12.24,9.25
28-12-2020,ARGANIL,37,3,336,"[240,480]",Elevado,,,,37,Centro,COIMBRA,0601,33283.93,11014,672,648,612,559,596,1155,1767,2415,3087,33.09,9.27,7.26,5.31
28-12-2020,ARMAMAR,76,5,1317,"[960,Max]",Extremamente Elevado,,,,76,Norte,VISEU,1801,11723.73,5769,357,305,309,285,310,595,904,1209,1566,49.21,13.36,10.31,7.71
28-12-2020,AROUCA,111,8,536,"[480,960]",Muito Elevado,,,,111,Norte,AVEIRO,0104,32910.52,20720,1306,1047,753,683,683,1366,2119,3166,4472,62.96,13.59,9.62,6.44
28-12-2020,ARRAIOLOS,32,2,462,"[240,480]",Elevado,,,,32,Alentejo,ÉVORA,0702,68374.55,6928,435,384,283,367,480,847,1130,1514,1949,10.13,2.85,2.21,1.65
28-12-2020,ARRONCHES,0,0,0,"[0,240]",Moderado,,,,0,Alentejo,PORTALEGRE,1202,31464.72,2820,155,142,162,187,179,366,528,670,825,8.96,2.62,2.13,1.68
28-12-2020,ARRUDA DOS VINHOS,81,6,526,"[480,960]",Muito Elevado,,,,81,Lisboa e Vale do Tejo,LISBOA,1102,7795.93,15412,738,738,562,509,438,947,1509,2247,2985,197.69,38.29,28.82,19.36
28-12-2020,AVEIRO,234,17,297,"[240,480]",Elevado,,,,234,Centro,AVEIRO,0105,19757.57,78734,4520,4004,3050,2250,2103,4353,7403,11407,15927,398.49,80.61,57.73,37.47
28-12-2020,AVIS,25,2,589,"[480,960]",Muito Elevado,,,,25,Alentejo,PORTALEGRE,1203,60596.51,4247,315,225,206,251,273,524,730,955,1270,7.01,2.1,1.58,1.2
28-12-2020,AZAMBUJA,90,6,396,"[240,480]",Elevado,,,,90,Lisboa e Vale do Tejo,LISBOA,1103,26265.65,22716,1322,1171,1070,798,618,1416,2486,3657,4979,86.48,18.96,13.92,9.46
28-12-2020,BAIÃO,64,5,341,"[240,480]",Elevado,,,,64,Norte,PORTO,1302,17452.83,18748,1070,862,714,686,725,1411,2125,2987,4057,107.42,23.25,17.11,12.18
28-12-2020,BARCELOS,1149,82,989,"[960,Max]",Extremamente Elevado,,,,1149,Norte,BRAGA,0302,37890.14,116187,6721,5325,3619,2991,2562,5553,9172,14497,21218,306.64,56.0,38.26,24.21
28-12-2020,BARRANCOS,0,0,0,"[0,240]",Moderado,,,,0,Alentejo,BEJA,0204,16841.73,1634,90,65,65,94,61,155,220,285,375,9.7,2.23,1.69,1.31
28-12-2020,BARREIRO,417,30,555,"[480,960]",Muito Elevado,,,,417,Lisboa e Vale do Tejo,SETÚBAL,1504,3639.07,75147,5194,5565,4459,3105,1767,4872,9331,14896,20090,2065.05,552.07,409.34,256.42
28-12-2020,BATALHA,52,4,326,"[240,480]",Elevado,,,,52,Centro,LEIRIA,1004,10341.6,15963,873,762,649,529,549,1078,1727,2489,3362,154.35,32.51,24.07,16.7
28-12-2020,BEJA,143,10,426,"[240,480]",Elevado,,,,143,Alentejo,BEJA,0205,114647.55,33579,2005,1840,1386,1272,1039,2311,3697,5537,7542,29.29,6.58,4.83,3.22
28-12-2020,BELMONTE,9,1,141,"[0,240]",Moderado,,,,9,Centro,CASTELO BRANCO,0501,11875.91,6398,444,321,325,310,355,665,990,1311,1755,53.87,14.78,11.04,8.34
28-12-2020,BENAVENTE,98,7,320,"[240,480]",Elevado,,,,98,Lisboa e Vale do Tejo,SANTARÉM,1405,52138.39,30602,1468,1376,1141,876,643,1519,2660,4036,5504,58.69,10.56,7.74,5.1
28-12-2020,BOMBARRAL,26,2,207,"[0,240]",Moderado,,,,26,Lisboa e Vale do Tejo,LEIRIA,1005,9128.55,12558,875,714,561,491,429,920,1481,2195,3070,137.56,33.63,24.04,16.22
28-12-2020,BORBA,16,1,238,"[0,240]",Moderado,,,,16,Alentejo,ÉVORA,0703,14518.65,6736,430,375,279,436,392,828,1107,1482,1912,46.39,13.17,10.21,7.62
28-12-2020,BOTICAS,25,2,500,"[480,960]",Muito Elevado,,,,25,Norte,VILA REAL,1702,32195.66,4998,347,306,311,305,380,685,996,1302,1649,15.52,5.12,4.04,3.09
28-12-2020,BRAGA,1155,82,632,"[480,960]",Muito Elevado,,,,1155,Norte,BRAGA,0303,18339.95,182679,10029,7963,5241,4320,3671,7991,13232,21195,31224,996.07,170.25,115.57,72.15
28-12-2020,BRAGANÇA,258,18,768,"[480,960]",Muito Elevado,,,,258,Norte,BRAGANÇA,0402,117357.27,33607,2402,1855,1652,1393,1163,2556,4208,6063,8465,28.64,7.21,5.17,3.59
28-12-2020,CABECEIRAS DE BASTO,43,3,275,"[240,480]",Elevado,,,,43,Norte,BRAGA,0304,24182.16,15628,774,594,544,575,574,1149,1693,2287,3061,64.63,12.66,9.46,7.0
28-12-2020,CADAVAL,25,2,183,"[0,240]",Moderado,,,,25,Lisboa e Vale do Tejo,LISBOA,1104,17489.3,13673,813,796,756,621,625,1246,2002,2798,3611,78.18,20.65,16.0,11.45
28-12-2020,CALDAS DA RAINHA,235,17,453,"[240,480]",Elevado,,,,235,Lisboa e Vale do Tejo,LEIRIA,1006,25569.47,51912,3035,2684,2186,1899,1705,3604,5790,8474,11509,203.03,45.01,33.14,22.64
28-12-2020,CALHETA,4,0,37,"[0,240]",Moderado,,,,4,Madeira,MADEIRA,3101,11150.43,10867,576,497,507,399,415,814,1321,1818,2394,97.46,21.47,16.3,11.85
28-12-2020,CALHETA (AÇORES),3,0,94,"[0,240]",Moderado,,,,3,Açores,AÇORES,4501,12626.4,3184,215,159,141,139,122,261,402,561,776,25.22,6.15,4.44,3.18
28-12-2020,CÂMARA DE LOBOS,92,7,273,"[240,480]",Elevado,,,,92,Madeira,MADEIRA,3102,5216.67,33675,1396,1059,834,545,381,926,1760,2819,4215,645.49,80.79,54.03,33.74
28-12-2020,CAMINHA,87,6,548,"[480,960]",Muito Elevado,,,,87,Norte,VIANA DO CASTELO,1602,13652.14,15877,1046,944,818,646,656,1302,2120,3064,4110,116.3,30.11,22.44,15.53
28-12-2020,CAMPO MAIOR,5,0,64,"[0,240]",Moderado,,,,5,Alentejo,PORTALEGRE,1204,24720.16,7874,471,364,351,279,327,606,957,1321,1792,31.85,7.25,5.34,3.87
28-12-2020,CANTANHEDE,167,12,477,"[240,480]",Elevado,,,,167,Centro,COIMBRA,0602,39088.02,35011,2346,2096,1880,1709,1451,3160,5040,7136,9482,89.57,24.26,18.26,12.89
28-12-2020,CARRAZEDA DE ANSIÃES,5,0,88,"[0,240]",Moderado,,,,5,Norte,BRAGANÇA,0403,27924.09,5666,424,389,391,312,465,777,1168,1557,1981,20.29,7.09,5.58,4.18
28-12-2020,CARREGAL DO SAL,27,2,291,"[240,480]",Elevado,,,,27,Centro,VISEU,1802,11689.21,9271,587,562,486,462,376,838,1324,1886,2473,79.31,21.16,16.13,11.33
28-12-2020,CARTAXO,55,4,231,"[0,240]",Moderado,,,,55,Lisboa e Vale do Tejo,SANTARÉM,1406,15817.28,23843,1415,1376,1142,861,632,1493,2635,4011,5426,150.74,34.3,25.36,16.66
28-12-2020,CASCAIS,675,48,316,"[240,480]",Elevado,,,,675,Lisboa e Vale do Tejo,LISBOA,1105,9740.17,213608,12151,11444,8680,6469,5248,11717,20397,31841,43992,2193.1,451.66,326.91,209.41
28-12-2020,CASTANHEIRA DE PÊRA,15,1,574,"[480,960]",Muito Elevado,,,,15,Centro,LEIRIA,1007,6677.45,2614,233,195,157,190,187,377,534,729,962,39.15,14.41,10.92,8.0
28-12-2020,CASTELO BRANCO,291,21,560,"[480,960]",Muito Elevado,,,,291,Centro,CASTELO BRANCO,0502,143819.15,51987,3528,3042,2499,2229,2225,4454,6953,9995,13523,36.15,9.4,6.95,4.83
28-12-2020,CASTELO DE PAIVA,54,4,349,"[240,480]",Elevado,,,,54,Norte,AVEIRO,0106,11500.53,15454,881,697,545,420,431,851,1396,2093,2974,134.37,25.86,18.2,12.14
28-12-2020,CASTELO DE VIDE,15,1,514,"[480,960]",Muito Elevado,,,,15,Alentejo,PORTALEGRE,1205,26491.24,2919,204,173,179,147,170,317,496,669,873,11.02,3.3,2.53,1.87
28-12-2020,CASTRO DAIRE,71,5,514,"[480,960]",Muito Elevado,,,,71,Centro,VISEU,1803,37904.13,13823,942,857,765,732,773,1505,2270,3127,4069,36.47,10.74,8.25,5.99
28-12-2020,CASTRO MARIM,4,0,64,"[0,240]",Moderado,,,,4,Algarve,FARO,0804,30084.37,6237,370,345,334,322,344,666,1000,1345,1715,20.73,5.7,4.47,3.32
28-12-2020,CASTRO VERDE,10,1,144,"[0,240]",Moderado,,,,10,Alentejo,BEJA,0206,56944.23,6949,437,347,303,275,227,502,805,1152,1589,12.2,2.79,2.02,1.41
28-12-2020,CELORICO DA BEIRA,44,3,635,"[480,960]",Muito Elevado,,,,44,Centro,GUARDA,0903,24721.63,6928,430,416,363,369,535,904,1267,1683,2113,28.02,8.55,6.81,5.12
28-12-2020,CELORICO DE BASTO,67,5,352,"[240,480]",Elevado,,,,67,Norte,BRAGA,0305,18107.02,19040,1001,802,668,728,729,1457,2125,2927,3928,105.15,21.69,16.17,11.74
28-12-2020,CHAMUSCA,11,1,120,"[0,240]",Moderado,,,,11,Lisboa e Vale do Tejo,SANTARÉM,1407,74600.54,9197,629,583,553,465,579,1044,1597,2180,2809,12.33,3.77,2.92,2.14
28-12-2020,CHAVES,348,25,885,"[480,960]",Muito Elevado,,,,348,Norte,VILA REAL,1703,59122.95,39343,2676,2429,1991,1886,1918,3804,5795,8224,10900,66.54,18.44,13.91,9.8
28-12-2020,CINFÃES,57,4,312,"[240,480]",Elevado,,,,57,Norte,VISEU,1804,23928.76,18244,1067,902,779,734,758,1492,2271,3173,4240,76.24,17.72,13.26,9.49
28-12-2020,COIMBRA,594,42,443,"[240,480]",Elevado,,,,594,Centro,COIMBRA,0603,31939.94,134166,9489,8734,6353,5139,5074,10213,16566,25300,34789,420.06,108.92,79.21,51.87
28-12-2020,CONDEIXA-A-NOVA,107,8,603,"[480,960]",Muito Elevado,,,,107,Centro,COIMBRA,0604,13867.47,17733,871,809,717,583,490,1073,1790,2599,3470,127.88,25.02,18.74,12.91
28-12-2020,CONSTÂNCIA,11,1,273,"[240,480]",Elevado,,,,11,Lisboa e Vale do Tejo,SANTARÉM,1408,8036.58,4030,211,183,187,148,155,303,490,673,884,50.14,11.0,8.37,6.1
28-12-2020,CORUCHE,38,3,218,"[0,240]",Moderado,,,,38,Lisboa e Vale do Tejo,SANTARÉM,1409,111572.03,17471,1294,1090,1095,1096,1019,2115,3210,4300,5594,15.66,5.01,3.85,2.88
28-12-2020,CORVO,0,0,0,"[0,240]",Moderado,,,,0,Açores,AÇORES,4901,1711.45,464,22,21,11,13,19,32,43,64,86,27.12,5.03,3.74,2.51
28-12-2020,COVILHÃ,153,11,327,"[240,480]",Elevado,,,,153,Centro,CASTELO BRANCO,0503,55560.06,46787,3533,2998,2365,2111,2193,4304,6669,9667,13200,84.21,23.76,17.4,12.0
28-12-2020,CRATO,32,2,1023,"[960,Max]",Extremamente Elevado,,,,32,Alentejo,PORTALEGRE,1206,39806.88,3129,229,258,163,182,228,410,573,831,1060,7.86,2.66,2.09,1.44
28-12-2020,CUBA,16,1,348,"[240,480]",Elevado,,,,16,Alentejo,BEJA,0207,17208.72,4595,255,233,206,190,143,333,539,772,1027,26.7,5.97,4.49,3.13
28-12-2020,ELVAS,178,13,867,"[480,960]",Muito Elevado,,,,178,Alentejo,PORTALEGRE,1207,63128.86,20528,1057,1145,902,852,810,1662,2564,3709,4766,32.52,7.55,5.88,4.06
28-12-2020,ENTRONCAMENTO,56,4,260,"[240,480]",Elevado,,,,56,Lisboa e Vale do Tejo,SANTARÉM,1410,1372.81,21558,1066,930,868,695,592,1287,2155,3085,4151,1570.14,302.33,224.69,156.96
28-12-2020,ESPINHO,131,9,444,"[240,480]",Elevado,,,,131,Norte,AVEIRO,0107,2105.68,29516,2205,1993,1430,1177,960,2137,3567,5560,7765,1401.52,368.71,264.01,169.37
28-12-2020,ESPOSENDE,354,25,1036,"[960,Max]",Extremamente Elevado,,,,354,Norte,BRAGA,0306,9540.98,34177,1831,1522,1095,894,723,1617,2712,4234,6065,358.21,63.57,44.38,28.42
28-12-2020,ESTARREJA,98,7,377,"[240,480]",Elevado,,,,98,Centro,AVEIRO,0108,10817.33,26006,1503,1399,1106,953,728,1681,2787,4186,5689,240.42,52.59,38.7,25.76
28-12-2020,ESTREMOZ,80,6,629,"[480,960]",Muito Elevado,,,,80,Alentejo,ÉVORA,0704,51379.95,12728,789,613,697,786,877,1663,2360,2973,3762,24.77,7.32,5.79,4.59
28-12-2020,ÉVORA,459,33,875,"[480,960]",Muito Elevado,,,,459,Alentejo,ÉVORA,0705,130707.58,52428,3569,2852,2176,1966,1803,3769,5945,8797,12366,40.11,9.46,6.73,4.55
28-12-2020,FAFE,198,14,412,"[240,480]",Elevado,,,,198,Norte,BRAGA,0307,21908.11,48060,3044,2455,1679,1403,1208,2611,4290,6745,9789,219.37,44.68,30.79,19.58
28-12-2020,FARO,191,14,313,"[240,480]",Elevado,,,,191,Algarve,FARO,0805,20256.79,61015,3847,3364,2604,2055,1601,3656,6260,9624,13471,301.2,66.5,47.51,30.9
28-12-2020,FELGUEIRAS,280,20,496,"[480,960]",Muito Elevado,,,,280,Norte,PORTO,1303,11573.75,56422,2951,2302,1601,1316,973,2289,3890,6192,9143,487.49,79.0,53.5,33.61
28-12-2020,FERREIRA DO ALENTEJO,7,0,89,"[0,240]",Moderado,,,,7,Alentejo,BEJA,0208,64820.68,7845,515,414,372,343,345,688,1060,1474,1989,12.1,3.07,2.27,1.64
28-12-2020,FERREIRA DO ZÊZERE,14,1,176,"[0,240]",Moderado,,,,14,Lisboa e Vale do Tejo,SANTARÉM,1411,19038.03,7959,470,370,416,465,456,921,1337,1707,2177,41.81,11.44,8.97,7.02
28-12-2020,FIGUEIRA DA FOZ,213,15,363,"[240,480]",Elevado,,,,213,Centro,COIMBRA,0605,37905.26,58747,4032,3597,2887,2495,2043,4538,7425,11022,15054,154.98,39.72,29.08,19.59
28-12-2020,FIGUEIRA DE CASTELO RODRIGO,10,1,179,"[0,240]",Moderado,,,,10,Centro,GUARDA,0904,50857.46,5584,347,352,290,352,391,743,1033,1385,1732,10.98,3.41,2.72,2.03
28-12-2020,FIGUEIRÓ DOS VINHOS,75,5,1347,"[960,Max]",Extremamente Elevado,,,,75,Centro,LEIRIA,1008,17344.0,5568,402,386,322,309,351,660,982,1368,1770,32.1,10.21,7.89,5.66
28-12-2020,FORNOS DE ALGODRES,9,1,199,"[0,240]",Moderado,,,,9,Centro,GUARDA,0905,13145.05,4528,261,218,247,256,232,488,735,953,1214,34.45,9.24,7.25,5.59
28-12-2020,FREIXO DE ESPADA À CINTA,7,0,212,"[0,240]",Moderado,,,,7,Norte,BRAGANÇA,0404,24414.29,3298,211,177,231,196,189,385,616,793,1004,13.51,4.11,3.25,2.52
28-12-2020,FRONTEIRA,14,1,471,"[240,480]",Elevado,,,,14,Alentejo,PORTALEGRE,1208,24859.58,2974,213,182,149,156,168,324,473,655,868,11.96,3.49,2.63,1.9
28-12-2020,FUNCHAL,169,12,162,"[0,240]",Moderado,,,,169,Madeira,MADEIRA,3103,7616.2,104024,6382,5086,3643,2821,1990,4811,8454,13540,19922,1365.86,261.58,177.78,111.0
28-12-2020,FUNDÃO,69,5,260,"[240,480]",Elevado,,,,69,Centro,CASTELO BRANCO,0504,70019.79,26495,1781,1464,1432,1357,1643,3000,4432,5896,7677,37.84,10.96,8.42,6.33
28-12-2020,GAVIÃO,41,3,1257,"[960,Max]",Extremamente Elevado,,,,41,Alentejo,PORTALEGRE,1209,29459.45,3263,189,186,222,263,293,556,778,964,1153,11.08,3.91,3.27,2.64
28-12-2020,GÓIS,5,0,131,"[0,240]",Moderado,,,,5,Centro,COIMBRA,0606,26330.19,3805,235,199,240,233,244,477,717,916,1151,14.45,4.37,3.48,2.72
28-12-2020,GOLEGÃ,20,1,375,"[240,480]",Elevado,,,,20,Lisboa e Vale do Tejo,SANTARÉM,1412,8431.67,5339,356,299,281,243,255,498,779,1078,1434,63.32,17.01,12.78,9.24
28-12-2020,GONDOMAR,871,62,525,"[480,960]",Muito Elevado,,,,871,Norte,PORTO,1304,13191.76,165985,10555,8755,6222,4450,3364,7814,14036,22791,33346,1258.22,252.77,172.76,106.4
28-12-2020,GOUVEIA,40,3,323,"[240,480]",Elevado,,,,40,Centro,GUARDA,0906,30061.17,12387,871,931,780,783,810,1593,2373,3304,4175,41.21,13.89,10.99,7.89
28-12-2020,GRÂNDOLA,48,3,328,"[240,480]",Elevado,,,,48,Alentejo,SETÚBAL,1505,82593.66,14639,834,834,708,688,672,1360,2068,2902,3736,17.72,4.52,3.51,2.5
28-12-2020,GUARDA,344,25,883,"[480,960]",Muito Elevado,,,,344,Centro,GUARDA,0907,71209.58,38969,2477,2041,1686,1415,1474,2889,4575,6616,9093,54.72,12.77,9.29,6.42
28-12-2020,GUIMARÃES,911,65,598,"[480,960]",Muito Elevado,,,,911,Norte,BRAGA,0308,24099.96,152309,9394,7074,4809,3877,2948,6825,11634,18708,28102,631.99,116.61,77.63,48.27
28-12-2020,HORTA,3,0,21,"[0,240]",Moderado,,,,3,Açores,AÇORES,4701,17305.53,14521,818,658,468,352,302,654,1122,1780,2598,83.91,15.01,10.29,6.48
28-12-2020,IDANHA-A-NOVA,79,6,982,"[960,Max]",Extremamente Elevado,,,,79,Centro,CASTELO BRANCO,0505,141633.51,8043,518,490,519,672,974,1646,2165,2655,3173,5.68,2.24,1.87,1.53
28-12-2020,ÍLHAVO,186,13,481,"[480,960]",Muito Elevado,,,,186,Centro,AVEIRO,0110,7347.55,38699,2227,1943,1444,1193,850,2043,3487,5430,7657,526.66,104.21,73.9,47.46
28-12-2020,LAGOA (FARO),16,1,70,"[0,240]",Moderado,,,,16,Algarve,FARO,0806,8825.45,22762,1314,1168,919,749,670,1419,2338,3506,4820,257.93,54.62,39.73,26.49
28-12-2020,LAGOA,30,2,204,"[0,240]",Moderado,,,,30,Açores,AÇORES,4201,4559.32,14721,536,458,349,238,235,473,822,1280,1816,322.9,39.83,28.08,18.03
28-12-2020,LAGOS,54,4,178,"[0,240]",Moderado,,,,54,Algarve,FARO,0807,21299.27,30374,1744,1434,1247,1053,1029,2082,3329,4763,6507,142.61,30.55,22.36,15.63
28-12-2020,LAJES DAS FLORES,0,0,0,"[0,240]",Moderado,,,,0,Açores,AÇORES,4801,7004.79,1463,88,53,62,46,54,100,162,215,303,20.89,4.33,3.07,2.31
28-12-2020,LAJES DO PICO,0,0,0,"[0,240]",Moderado,,,,0,Açores,AÇORES,4601,15531.09,4490,304,231,223,159,162,321,544,775,1079,28.91,6.95,4.99,3.5
28-12-2020,LAMEGO,158,11,635,"[480,960]",Muito Elevado,,,,158,Norte,VISEU,1805,16542.11,24895,1639,1284,1124,898,783,1681,2805,4089,5728,150.5,34.63,24.72,16.96
28-12-2020,LEIRIA,668,48,533,"[480,960]",Muito Elevado,,,,668,Centro,LEIRIA,1009,56508.83,125267,7389,6366,5090,3902,3159,7061,12151,18517,25906,221.68,45.84,32.77,21.5
28-12-2020,LISBOA,2252,161,442,"[240,480]",Elevado,,,,2252,Lisboa e Vale do Tejo,LISBOA,1106,10005.43,509515,33197,33340,27706,23037,26770,49807,77513,110853,144050,5092.6,1439.78,1107.98,774.74
28-12-2020,LOULÉ,170,12,247,"[240,480]",Elevado,,,,170,Algarve,FARO,0808,76366.91,68697,3890,3350,2780,2358,2251,4609,7389,10739,14629,89.96,19.16,14.06,9.68
28-12-2020,LOURES,970,69,454,"[240,480]",Elevado,,,,970,Lisboa e Vale do Tejo,LISBOA,1107,16723.99,213687,12746,12794,9644,6669,5033,11702,21346,34140,46886,1277.73,280.35,204.14,127.64
28-12-2020,LOURINHÃ,85,6,329,"[240,480]",Elevado,,,,85,Lisboa e Vale do Tejo,LISBOA,1108,14717.2,25855,1584,1243,992,842,645,1487,2479,3722,5306,175.68,36.05,25.29,16.84
28-12-2020,LOUSÃ,55,4,321,"[240,480]",Elevado,,,,55,Centro,COIMBRA,0607,13840.01,17158,946,866,658,528,450,978,1636,2502,3448,123.97,24.91,18.08,11.82
28-12-2020,LOUSADA,149,11,319,"[240,480]",Elevado,,,,149,Norte,PORTO,1305,9608.01,46755,2289,1698,1176,853,621,1474,2650,4348,6637,486.63,69.08,45.25,27.58
28-12-2020,MAÇÃO,61,4,973,"[960,Max]",Extremamente Elevado,,,,61,Lisboa e Vale do Tejo,SANTARÉM,1413,39997.98,6267,386,362,390,440,657,1097,1487,1849,2235,15.67,5.59,4.62,3.72
28-12-2020,MACEDO DE CAVALEIROS,211,15,1454,"[960,Max]",Extremamente Elevado,,,,211,Norte,BRAGANÇA,0405,69914.08,14516,1082,889,878,823,938,1761,2639,3528,4610,20.76,6.59,5.05,3.77
28-12-2020,MACHICO,63,4,315,"[240,480]",Elevado,,,,63,Madeira,MADEIRA,3104,6825.1,19981,1197,860,662,455,331,786,1448,2308,3505,292.76,51.36,33.82,21.22
28-12-2020,MADALENA,3,0,51,"[0,240]",Moderado,,,,3,Açores,AÇORES,4602,14712.33,5895,334,256,173,190,179,369,542,798,1132,40.07,7.69,5.42,3.68
28-12-2020,MAFRA,247,18,291,"[240,480]",Elevado,,,,247,Lisboa e Vale do Tejo,LISBOA,1109,29165.5,84816,3613,3334,2839,2089,1899,3988,6827,10161,13774,290.81,47.23,34.84,23.41
28-12-2020,MAIA,588,42,423,"[240,480]",Elevado,,,,588,Norte,PORTO,1306,8293.94,138971,7801,6617,4512,3339,2631,5970,10482,17099,24900,1675.56,300.22,206.16,126.38
28-12-2020,MANGUALDE,210,15,1135,"[960,Max]",Extremamente Elevado,,,,210,Centro,VISEU,1806,21925.56,18510,1198,1128,885,852,743,1595,2480,3608,4806,84.42,21.92,16.46,11.31
28-12-2020,MANTEIGAS,28,2,931,"[480,960]",Muito Elevado,,,,28,Centro,GUARDA,0908,12197.55,3007,258,197,159,167,146,313,472,669,927,24.65,7.6,5.48,3.87
28-12-2020,MARCO DE CANAVESES,261,19,507,"[480,960]",Muito Elevado,,,,261,Norte,PORTO,1307,20188.98,51496,2678,2060,1488,1265,1023,2288,3776,5836,8514,255.07,42.17,28.91,18.7
28-12-2020,MARINHA GRANDE,127,9,330,"[240,480]",Elevado,,,,127,Centro,LEIRIA,1010,18725.19,38508,2365,2302,1638,1359,1058,2417,4055,6357,8722,205.65,46.58,33.95,21.66
28-12-2020,MARVÃO,38,3,1265,"[960,Max]",Extremamente Elevado,,,,38,Alentejo,PORTALEGRE,1210,15489.9,3005,198,185,142,197,237,434,576,761,959,19.4,6.19,4.91,3.72
28-12-2020,MATOSINHOS,812,58,463,"[240,480]",Elevado,,,,812,Norte,PORTO,1308,6241.97,175357,11850,9977,7023,5024,3884,8908,15931,25908,37758,2809.31,604.9,415.06,255.22
28-12-2020,MEALHADA,133,10,668,"[480,960]",Muito Elevado,,,,133,Centro,AVEIRO,0111,11065.66,19914,1163,1039,810,828,831,1659,2469,3508,4671,179.96,42.21,31.7,22.31
28-12-2020,MÊDA,13,1,283,"[240,480]",Elevado,,,,13,Centro,GUARDA,0909,28604.92,4587,343,306,290,288,443,731,1021,1327,1670,16.04,5.84,4.64,3.57
28-12-2020,MELGAÇO,16,1,198,"[0,240]",Moderado,,,,16,Norte,VIANA DO CASTELO,1603,23824.58,8093,507,567,578,614,675,1289,1867,2434,2941,33.97,12.34,10.22,7.84
28-12-2020,MÉRTOLA,48,3,782,"[480,960]",Muito Elevado,,,,48,Alentejo,BEJA,0209,129287.34,6142,400,390,378,423,600,1023,1401,1791,2191,4.75,1.69,1.39,1.08
28-12-2020,MESÃO FRIO,22,2,555,"[480,960]",Muito Elevado,,,,22,Norte,VILA REAL,1704,2664.87,3964,265,205,168,157,120,277,445,650,915,148.74,34.33,24.39,16.7
28-12-2020,MIRA,41,3,347,"[240,480]",Elevado,,,,41,Centro,COIMBRA,0608,12403.38,11832,727,729,659,550,466,1016,1675,2404,3131,95.4,25.24,19.38,13.5
28-12-2020,MIRANDA DO CORVO,69,5,543,"[480,960]",Muito Elevado,,,,69,Centro,COIMBRA,0609,12637.79,12708,706,659,568,498,404,902,1470,2129,2835,100.55,22.43,16.85,11.63
28-12-2020,MIRANDA DO DOURO,59,4,864,"[480,960]",Muito Elevado,,,,59,Norte,BRAGANÇA,0406,48718.31,6830,482,429,442,463,470,933,1375,1804,2286,14.02,4.69,3.7,2.82
28-12-2020,MIRANDELA,79,6,363,"[240,480]",Elevado,,,,79,Norte,BRAGANÇA,0407,65895.67,21754,1640,1315,1204,1078,947,2025,3229,4544,6184,33.01,9.38,6.9,4.9
28-12-2020,MOGADOURO,40,3,477,"[240,480]",Elevado,,,,40,Norte,BRAGANÇA,0408,76064.93,8392,589,529,576,630,655,1285,1861,2390,2979,11.03,3.92,3.14,2.45
28-12-2020,MOIMENTA DA BEIRA,37,3,380,"[240,480]",Elevado,,,,37,Norte,VISEU,1807,21996.9,9736,576,514,471,416,461,877,1348,1862,2438,44.26,11.08,8.46,6.13
28-12-2020,MOITA,322,23,500,"[480,960]",Muito Elevado,,,,322,Lisboa e Vale do Tejo,SETÚBAL,1506,5525.98,64407,4226,3646,2623,1801,1425,3226,5849,9495,13721,1165.53,248.3,171.82,105.85
28-12-2020,MONÇÃO,80,6,448,"[240,480]",Elevado,,,,80,Norte,VIANA DO CASTELO,1604,21130.85,17869,1161,1105,1031,1006,972,1978,3009,4114,5275,84.56,24.96,19.47,14.24
28-12-2020,MONCHIQUE,6,0,118,"[0,240]",Moderado,,,,6,Algarve,FARO,0809,39530.43,5077,353,384,321,355,392,747,1068,1452,1805,12.84,4.57,3.67,2.7
28-12-2020,MONDIM DE BASTO,21,1,302,"[240,480]",Elevado,,,,21,Norte,VILA REAL,1705,17207.52,6946,395,300,314,284,283,567,881,1181,1576,40.36,9.16,6.86,5.12
28-12-2020,MONFORTE,13,1,437,"[240,480]",Elevado,,,,13,Alentejo,PORTALEGRE,1211,42024.82,2975,139,115,117,192,168,360,477,592,731,7.08,1.74,1.41,1.14
28-12-2020,MONTALEGRE,111,8,1234,"[960,Max]",Extremamente Elevado,,,,111,Norte,VILA REAL,1706,80545.71,8997,699,628,595,603,730,1333,1928,2556,3255,11.17,4.04,3.17,2.39
28-12-2020,MONTEMOR-O-NOVO,51,4,326,"[240,480]",Elevado,,,,51,Alentejo,ÉVORA,0706,123296.65,15647,991,953,868,878,971,1849,2717,3670,4661,12.69,3.78,2.98,2.2
28-12-2020,MONTEMOR-O-VELHO,129,9,511,"[480,960]",Muito Elevado,,,,129,Centro,COIMBRA,0610,22896.23,25224,1496,1397,1217,1057,988,2045,3262,4659,6155,110.17,26.88,20.35,14.25
28-12-2020,MONTIJO,243,17,422,"[240,480]",Elevado,,,,243,Lisboa e Vale do Tejo,SETÚBAL,1507,34861.64,57614,2771,2441,1990,1554,1109,2663,4653,7094,9865,165.26,28.3,20.35,13.35
28-12-2020,MORA,111,8,2682,"[960,Max]",Extremamente Elevado,,,,111,Alentejo,ÉVORA,0707,44395.02,4138,336,275,252,238,257,495,747,1022,1358,9.32,3.06,2.3,1.68
28-12-2020,MORTÁGUA,80,6,909,"[480,960]",Muito Elevado,,,,80,Centro,VISEU,1808,25117.82,8803,638,584,535,499,460,959,1494,2078,2716,35.05,10.81,8.27,5.95
28-12-2020,MOURA,14,1,102,"[0,240]",Moderado,,,,14,Alentejo,BEJA,0210,95845.55,13718,817,656,665,542,461,1003,1668,2324,3141,14.31,3.28,2.42,1.74
28-12-2020,MOURÃO,83,6,3388,"[960,Max]",Extremamente Elevado,,,,83,Alentejo,ÉVORA,0708,27862.98,2450,139,108,80,104,109,213,293,401,540,8.79,1.94,1.44,1.05
28-12-2020,MURÇA,17,1,311,"[240,480]",Elevado,,,,17,Norte,VILA REAL,1707,18937.11,5463,384,341,307,306,319,625,932,1273,1657,28.85,8.75,6.72,4.92
28-12-2020,MURTOSA,52,4,506,"[480,960]",Muito Elevado,,,,52,Centro,AVEIRO,0112,7308.78,10279,509,473,403,353,409,762,1165,1638,2147,140.63,29.37,22.41,15.94
28-12-2020,NAZARÉ,16,1,113,"[0,240]",Moderado,,,,16,Lisboa e Vale do Tejo,LEIRIA,1011,8243.43,14165,967,903,670,420,396,816,1486,2389,3356,171.84,40.71,28.98,18.03
28-12-2020,NELAS,56,4,432,"[240,480]",Elevado,,,,56,Centro,VISEU,1809,12571.48,12974,924,787,668,604,583,1187,1855,2642,3566,103.21,28.37,21.02,14.76
28-12-2020,NISA,110,8,1815,"[960,Max]",Extremamente Elevado,,,,110,Alentejo,PORTALEGRE,1212,57567.84,6061,405,389,355,483,478,961,1316,1705,2110,10.53,3.67,2.96,2.29
28-12-2020,NORDESTE,0,0,0,"[0,240]",Moderado,,,,0,Açores,AÇORES,4202,10146.8,4862,246,180,124,161,162,323,447,627,873,47.92,8.6,6.18,4.41
28-12-2020,ÓBIDOS,43,3,363,"[240,480]",Elevado,,,,43,Lisboa e Vale do Tejo,LEIRIA,1012,14155.44,11850,743,650,574,452,436,888,1462,2112,2855,83.72,20.17,14.92,10.33
28-12-2020,ODEMIRA,93,7,376,"[240,480]",Elevado,,,,93,Alentejo,BEJA,0211,172060.15,24717,1475,1317,1225,1397,1349,2746,3971,5288,6763,14.37,3.93,3.07,2.31
28-12-2020,ODIVELAS,552,39,341,"[240,480]",Elevado,,,,552,Lisboa e Vale do Tejo,LISBOA,1116,2654.36,161774,9562,9038,6952,4641,3812,8453,15405,24443,34005,6095.48,1281.27,920.99,580.44
28-12-2020,OEIRAS,653,47,368,"[240,480]",Elevado,,,,653,Lisboa e Vale do Tejo,LISBOA,1110,4588.31,177408,11580,11575,8566,6211,5855,12066,20632,32207,43787,3866.78,954.38,701.98,449.69
28-12-2020,OLEIROS,16,1,320,"[240,480]",Elevado,,,,16,Centro,CASTELO BRANCO,0506,47109.31,5003,384,341,366,397,487,884,1250,1591,1975,10.62,4.19,3.38,2.65
28-12-2020,OLHÃO,77,5,173,"[0,240]",Moderado,,,,77,Algarve,FARO,0810,13086.38,44405,2455,2309,1689,1342,1268,2610,4299,6608,9063,339.33,69.26,50.5,32.85
28-12-2020,OLIVEIRA DE AZEMÉIS,353,25,535,"[480,960]",Muito Elevado,,,,353,Norte,AVEIRO,0113,16110.41,66011,4155,3614,2794,2183,1738,3921,6715,10329,14484,409.75,89.91,64.12,41.68
28-12-2020,OLIVEIRA DE FRADES,25,2,252,"[240,480]",Elevado,,,,25,Centro,VISEU,1810,14534.62,9936,553,475,438,359,415,774,1212,1687,2240,68.36,15.41,11.61,8.34
28-12-2020,OLIVEIRA DO BAIRRO,88,6,362,"[240,480]",Elevado,,,,88,Centro,AVEIRO,0114,8731.99,24277,1327,1182,999,786,810,1596,2595,3777,5104,278.02,58.45,43.25,29.72
28-12-2020,OLIVEIRA DO HOSPITAL,186,13,966,"[960,Max]",Extremamente Elevado,,,,186,Centro,COIMBRA,0611,23451.66,19253,1161,1097,962,924,960,1884,2846,3943,5104,82.1,21.76,16.81,12.14
28-12-2020,OURÉM,125,9,284,"[240,480]",Elevado,,,,125,Lisboa e Vale do Tejo,SANTARÉM,1421,41668.03,44044,2463,2069,1899,1817,1603,3420,5319,7388,9851,105.7,23.64,17.73,12.77
28-12-2020,OURIQUE,7,1,152,"[0,240]",Moderado,,,,7,Alentejo,BEJA,0212,66331.36,4607,313,287,284,268,227,495,779,1066,1379,6.95,2.08,1.61,1.17
28-12-2020,OVAR,282,20,520,"[480,960]",Muito Elevado,,,,282,Centro,AVEIRO,0115,14770.25,54260,3294,2709,1994,1636,1234,2870,4864,7573,10867,367.37,73.57,51.27,32.93
28-12-2020,PAÇOS DE FERREIRA,200,14,353,"[240,480]",Elevado,,,,200,Norte,PORTO,1309,7099.29,56728,2903,2193,1518,1135,664,1799,3317,5510,8413,799.1,118.51,77.62,46.72
28-12-2020,PALMELA,217,16,338,"[240,480]",Elevado,,,,217,Lisboa e Vale do Tejo,SETÚBAL,1508,46512.01,64269,3402,3244,2635,1846,1391,3237,5872,9116,12518,138.18,26.91,19.6,12.62
28-12-2020,PAMPILHOSA DA SERRA,8,1,198,"[0,240]",Moderado,,,,8,Centro,COIMBRA,0612,39646.24,4037,238,254,295,339,423,762,1057,1311,1549,10.18,3.91,3.31,2.67
28-12-2020,PAREDES,389,28,452,"[240,480]",Elevado,,,,389,Norte,PORTO,1310,15675.69,86067,4272,3532,2412,1717,1258,2975,5387,8919,13191,549.04,84.15,56.9,34.36
28-12-2020,PAREDES DE COURA,13,1,152,"[0,240]",Moderado,,,,13,Norte,VIANA DO CASTELO,1605,13818.59,8535,466,528,407,465,515,980,1387,1915,2381,61.76,17.23,13.86,10.04
28-12-2020,PEDRÓGÃO GRANDE,18,1,528,"[480,960]",Muito Elevado,,,,18,Centro,LEIRIA,1013,12874.75,3410,175,173,196,221,252,473,669,842,1017,26.49,7.9,6.54,5.2
28-12-2020,PENACOVA,42,3,307,"[240,480]",Elevado,,,,42,Centro,COIMBRA,0613,21673.23,13694,968,923,745,621,703,1324,2069,2992,3960,63.18,18.27,13.81,9.55
28-12-2020,PENAFIEL,301,21,431,"[240,480]",Elevado,,,,301,Norte,PORTO,1311,21224.27,69772,3648,2823,2032,1663,1230,2893,4925,7748,11396,328.74,53.69,36.51,23.2
28-12-2020,PENALVA DO CASTELO,18,1,253,"[240,480]",Elevado,,,,18,Centro,VISEU,1811,13433.92,7115,449,457,413,391,426,817,1230,1687,2136,52.96,15.9,12.56,9.16
28-12-2020,PENAMACOR,48,3,1009,"[960,Max]",Extremamente Elevado,,,,48,Centro,CASTELO BRANCO,0507,56370.69,4755,262,248,273,451,633,1084,1357,1605,1867,8.44,3.31,2.85,2.41
28-12-2020,PENEDONO,14,1,540,"[480,960]",Muito Elevado,,,,14,Norte,VISEU,1812,13370.75,2591,172,113,129,156,138,294,423,536,708,19.38,5.3,4.01,3.16
28-12-2020,PENELA,17,1,315,"[240,480]",Elevado,,,,17,Centro,COIMBRA,0614,13480.0,5397,314,324,274,359,344,703,977,1301,1615,40.04,11.98,9.65,7.25
28-12-2020,PENICHE,100,7,377,"[240,480]",Elevado,,,,100,Lisboa e Vale do Tejo,LEIRIA,1014,7754.98,26501,1746,1504,1203,926,707,1633,2836,4340,6086,341.73,78.48,55.96,36.57
28-12-2020,PESO DA RÉGUA,154,11,976,"[960,Max]",Extremamente Elevado,,,,154,Norte,VILA REAL,1708,9486.01,15773,1076,843,650,659,455,1114,1764,2607,3683,166.28,38.83,27.48,18.6
28-12-2020,PINHEL,70,5,822,"[480,960]",Muito Elevado,,,,70,Centro,GUARDA,0910,48452.12,8511,577,566,551,538,689,1227,1778,2344,2921,17.57,6.03,4.84,3.67
28-12-2020,POMBAL,166,12,323,"[240,480]",Elevado,,,,166,Centro,LEIRIA,1015,62600.28,51461,3187,2791,2494,2328,2027,4355,6849,9640,12827,82.21,20.49,15.4,10.94
28-12-2020,PONTA DELGADA,64,5,94,"[0,240]",Moderado,,,,64,Açores,AÇORES,4203,23298.65,67935,3108,2435,1726,1133,902,2035,3761,6196,9304,291.58,39.93,26.59,16.14
28-12-2020,PONTA DO SOL,7,0,81,"[0,240]",Moderado,,,,7,Madeira,MADEIRA,3105,4622.03,8593,319,283,347,208,221,429,776,1059,1378,185.92,29.81,22.91,16.79
28-12-2020,PONTE DA BARCA,130,9,1163,"[960,Max]",Extremamente Elevado,,,,130,Norte,VIANA DO CASTELO,1606,18211.37,11180,635,576,517,554,490,1044,1561,2137,2772,61.39,15.22,11.73,8.57
28-12-2020,PONTE DE LIMA,154,11,373,"[240,480]",Elevado,,,,154,Norte,VIANA DO CASTELO,1607,32025.46,41315,2321,2022,1720,1596,1462,3058,4778,6800,9121,129.01,28.48,21.23,14.92
28-12-2020,PONTE DE SOR,22,2,147,"[0,240]",Moderado,,,,22,Alentejo,PORTALEGRE,1213,83971.16,14994,939,800,716,739,831,1570,2286,3086,4025,17.86,4.79,3.68,2.72
28-12-2020,PORTALEGRE,111,8,501,"[480,960]",Muito Elevado,,,,111,Alentejo,PORTALEGRE,1214,44713.64,22172,1577,1351,1137,993,984,1977,3114,4465,6042,49.59,13.51,9.99,6.96
28-12-2020,PORTEL,18,1,309,"[240,480]",Elevado,,,,18,Alentejo,ÉVORA,0709,60100.57,5828,336,358,283,331,305,636,919,1277,1613,9.7,2.68,2.12,1.53
28-12-2020,PORTIMÃO,89,6,160,"[0,240]",Moderado,,,,89,Algarve,FARO,0811,18206.29,55483,3182,2927,2116,1582,1400,2982,5098,8025,11207,304.75,61.56,44.08,28.0
28-12-2020,PORTO,1018,73,470,"[240,480]",Elevado,,,,1018,Norte,PORTO,1312,4142.02,216606,15790,15193,11280,9409,10044,19453,30733,45926,61716,5229.5,1490.0,1108.79,741.98
28-12-2020,PORTO DE MÓS,156,11,670,"[480,960]",Muito Elevado,,,,156,Centro,LEIRIA,1016,26183.41,23275,1355,1210,1034,888,872,1760,2794,4004,5359,88.89,20.47,15.29,10.67
28-12-2020,PORTO MONIZ,2,0,85,"[0,240]",Moderado,,,,2,Madeira,MADEIRA,3106,8293.38,2342,143,130,95,98,120,218,313,443,586,28.24,7.07,5.34,3.77
28-12-2020,PORTO SANTO,1,0,19,"[0,240]",Moderado,,,,1,Madeira,MADEIRA,3201,4300.7,5202,240,157,134,110,68,178,312,469,709,120.95,16.48,10.9,7.25
28-12-2020,PÓVOA DE LANHOSO,164,12,763,"[480,960]",Muito Elevado,,,,164,Norte,BRAGA,0309,13465.29,21499,1175,909,732,673,624,1297,2029,2938,4113,159.67,30.55,21.82,15.07
28-12-2020,PÓVOA DE VARZIM,560,40,892,"[480,960]",Muito Elevado,,,,560,Norte,PORTO,1313,8220.59,62784,3712,3120,2134,1594,1305,2899,5033,8153,11865,763.7,144.33,99.17,61.22
28-12-2020,POVOAÇÃO,1,0,17,"[0,240]",Moderado,,,,1,Açores,AÇORES,4204,10640.77,5927,293,212,191,144,134,278,469,681,974,55.7,9.15,6.4,4.41
28-12-2020,VILA DA PRAIA DA VITÓRIA,11,1,52,"[0,240]",Moderado,,,,11,Açores,AÇORES,4302,16127.06,21317,1133,789,619,436,336,772,1391,2180,3313,132.18,20.54,13.52,8.63
28-12-2020,PROENÇA-A-NOVA,5,0,69,"[0,240]",Moderado,,,,5,Centro,CASTELO BRANCO,0508,39539.96,7298,508,465,389,400,560,960,1349,1814,2322,18.46,5.87,4.59,3.41
28-12-2020,REDONDO,11,1,173,"[0,240]",Moderado,,,,11,Alentejo,ÉVORA,0710,36950.87,6353,349,325,288,288,354,642,930,1255,1604,17.19,4.34,3.4,2.52
28-12-2020,REGUENGOS DE MONSARAZ,13,1,130,"[0,240]",Moderado,,,,13,Alentejo,ÉVORA,0711,46399.72,10015,602,511,455,462,473,935,1390,1901,2503,21.58,5.39,4.1,3.0
28-12-2020,RESENDE,19,1,187,"[0,240]",Moderado,,,,19,Norte,VISEU,1813,12334.93,10137,560,493,448,433,422,855,1303,1796,2356,82.18,19.1,14.56,10.56
28-12-2020,RIBEIRA BRAVA,14,1,113,"[0,240]",Moderado,,,,14,Madeira,MADEIRA,3107,6544.88,12435,648,500,411,311,287,598,1009,1509,2157,189.99,32.96,23.06,15.42
28-12-2020,RIBEIRA DE PENA,45,3,748,"[480,960]",Muito Elevado,,,,45,Norte,VILA REAL,1709,21745.98,6016,371,301,290,310,368,678,968,1269,1640,27.66,7.54,5.84,4.45
28-12-2020,RIBEIRA GRANDE,93,7,283,"[240,480]",Elevado,,,,93,Açores,AÇORES,4205,18015.13,32811,1163,689,512,345,253,598,1110,1799,2962,182.13,16.44,9.99,6.16
28-12-2020,RIO MAIOR,159,11,780,"[480,960]",Muito Elevado,,,,159,Lisboa e Vale do Tejo,SANTARÉM,1414,27276.45,20379,1251,1144,941,795,648,1443,2384,3528,4779,74.71,17.52,12.93,8.74
28-12-2020,SABROSA,21,2,355,"[240,480]",Elevado,,,,21,Norte,VILA REAL,1710,15692.45,5918,393,314,304,302,350,652,956,1270,1663,37.71,10.6,8.09,6.09
28-12-2020,SABUGAL,53,4,501,"[480,960]",Muito Elevado,,,,53,Centro,GUARDA,0911,82269.82,10585,724,707,694,796,1009,1805,2499,3206,3930,12.87,4.78,3.9,3.04
28-12-2020,SALVATERRA DE MAGOS,70,5,329,"[240,480]",Elevado,,,,70,Lisboa e Vale do Tejo,SANTARÉM,1415,24393.2,21295,1275,1181,1060,799,772,1571,2631,3812,5087,87.3,20.85,15.63,10.79
28-12-2020,SANTA COMBA DÃO,37,3,354,"[240,480]",Elevado,,,,37,Centro,VISEU,1814,11194.77,10452,732,684,569,538,464,1002,1571,2255,2987,93.36,26.68,20.14,14.03
28-12-2020,SANTA CRUZ,57,4,126,"[0,240]",Moderado,,,,57,Madeira,MADEIRA,3108,8150.28,45281,1817,1301,974,716,523,1239,2213,3514,5331,555.6,65.41,43.12,27.15
28-12-2020,SANTA CRUZ DA GRACIOSA,1,0,24,"[0,240]",Moderado,,,,1,Açores,AÇORES,4401,6065.78,4208,228,180,163,124,145,269,432,612,840,69.37,13.85,10.09,7.12
28-12-2020,SANTA CRUZ DAS FLORES,0,0,0,"[0,240]",Moderado,,,,0,Açores,AÇORES,4802,7091.44,2165,125,98,74,56,51,107,181,279,404,30.53,5.7,3.93,2.55
28-12-2020,SANTA MARIA DA FEIRA,792,57,571,"[480,960]",Muito Elevado,,,,792,Norte,AVEIRO,0109,21587.65,138636,8182,6743,4771,3856,3079,6935,11706,18449,26631,642.19,123.36,85.46,54.22
28-12-2020,SANTA MARTA DE PENAGUIÃO,48,3,727,"[480,960]",Muito Elevado,,,,48,Norte,VILA REAL,1711,6928.13,6599,483,373,337,316,317,633,970,1343,1826,95.25,26.36,19.39,14.0
28-12-2020,SANTANA,12,1,179,"[0,240]",Moderado,,,,12,Madeira,MADEIRA,3109,9547.3,6711,418,353,343,282,277,559,902,1255,1673,70.29,17.52,13.15,9.45
28-12-2020,SANTARÉM,247,18,430,"[240,480]",Elevado,,,,247,Lisboa e Vale do Tejo,SANTARÉM,1416,55253.58,57421,3654,3441,2760,2466,2206,4672,7432,10873,14527,103.92,26.29,19.68,13.45
28-12-2020,SANTIAGO DO CACÉM,39,3,135,"[0,240]",Moderado,,,,39,Alentejo,SETÚBAL,1509,105969.29,28791,2144,1689,1472,1295,1215,2510,3982,5671,7815,27.17,7.37,5.35,3.76
28-12-2020,SANTO TIRSO,353,25,519,"[480,960]",Muito Elevado,,,,353,Norte,PORTO,1314,13655.52,68055,4911,3935,2761,2257,1810,4067,6828,10763,15674,498.35,114.78,78.82,50.0
28-12-2020,SÃO BRÁS DE ALPORTEL,46,3,442,"[240,480]",Elevado,,,,46,Algarve,FARO,0812,15336.92,10416,596,468,467,404,401,805,1272,1740,2336,67.91,15.23,11.35,8.29
28-12-2020,SÃO JOÃO DA MADEIRA,121,9,551,"[480,960]",Muito Elevado,,,,121,Norte,AVEIRO,0116,794.3,21958,1347,1069,796,601,593,1194,1990,3059,4406,2765.49,554.91,385.26,250.63
28-12-2020,SÃO JOÃO DA PESQUEIRA,17,1,239,"[0,240]",Moderado,,,,17,Norte,VISEU,1815,26610.85,7125,417,330,294,328,328,656,950,1280,1697,26.77,6.38,4.81,3.57
28-12-2020,SÃO PEDRO DO SUL,77,6,500,"[480,960]",Muito Elevado,,,,77,Centro,VISEU,1816,34895.09,15403,990,962,861,759,909,1668,2529,3491,4481,44.14,12.84,10.0,7.25
28-12-2020,SÃO ROQUE DO PICO,0,0,0,"[0,240]",Moderado,,,,0,Açores,AÇORES,4603,14236.1,3266,199,141,93,96,113,209,302,443,642,22.94,4.51,3.11,2.12
28-12-2020,SÃO VICENTE,4,0,78,"[0,240]",Moderado,,,,4,Madeira,MADEIRA,3110,7883.71,5143,272,264,266,225,280,505,771,1035,1307,65.23,16.58,13.13,9.78
28-12-2020,SARDOAL,5,0,134,"[0,240]",Moderado,,,,5,Lisboa e Vale do Tejo,SANTARÉM,1417,9214.72,3741,227,178,148,165,248,413,561,739,966,40.6,10.48,8.02,6.09
28-12-2020,SÁTÃO,35,2,302,"[240,480]",Elevado,,,,35,Centro,VISEU,1817,20194.11,11580,765,671,515,465,476,941,1456,2127,2892,57.34,14.32,10.53,7.21
28-12-2020,SEIA,95,7,427,"[240,480]",Elevado,,,,95,Centro,GUARDA,0912,43568.83,22234,1807,1589,1238,1122,721,1843,3081,4670,6477,51.03,14.87,10.72,7.07
28-12-2020,SEIXAL,688,49,410,"[240,480]",Elevado,,,,688,Lisboa e Vale do Tejo,SETÚBAL,1510,9545.17,167752,10586,9270,6661,4391,2930,7321,13982,23252,33838,1757.49,354.51,243.6,146.49
28-12-2020,SERNANCELHE,20,1,371,"[240,480]",Elevado,,,,20,Norte,VISEU,1818,22861.22,5396,305,293,286,273,260,533,819,1112,1417,23.6,6.2,4.86,3.58
28-12-2020,SERPA,24,2,168,"[0,240]",Moderado,,,,24,Alentejo,BEJA,0213,110563.34,14304,903,761,719,697,626,1323,2042,2803,3706,12.94,3.35,2.54,1.85
28-12-2020,SERTÃ,65,5,446,"[240,480]",Elevado,,,,65,Centro,CASTELO BRANCO,0509,44673.17,14577,870,779,790,767,1020,1787,2577,3356,4226,32.63,9.46,7.51,5.77
28-12-2020,SESIMBRA,216,15,417,"[240,480]",Elevado,,,,216,Lisboa e Vale do Tejo,SETÚBAL,1511,19571.75,51858,2400,2321,1853,1257,1083,2340,4193,6514,8914,264.96,45.54,33.28,21.42
28-12-2020,SETÚBAL,469,33,407,"[240,480]",Elevado,,,,469,Lisboa e Vale do Tejo,SETÚBAL,1512,23032.5,115126,7425,6929,5075,3775,2655,6430,11505,18434,25859,499.83,112.27,80.03,49.95
28-12-2020,SEVER DO VOUGA,41,3,362,"[240,480]",Elevado,,,,41,Centro,AVEIRO,0117,12987.56,11331,766,637,568,540,567,1107,1675,2312,3078,87.24,23.7,17.8,12.9
28-12-2020,SILVES,96,7,265,"[240,480]",Elevado,,,,96,Algarve,FARO,0813,68006.23,36226,2137,1869,1610,1423,1600,3023,4633,6502,8639,53.27,12.7,9.56,6.81
28-12-2020,SINES,6,0,44,"[0,240]",Moderado,,,,6,Alentejo,SETÚBAL,1513,20330.17,13715,888,791,551,416,268,684,1235,2026,2914,67.46,14.33,9.97,6.07
28-12-2020,SINTRA,1241,89,317,"[240,480]",Elevado,,,,1241,Lisboa e Vale do Tejo,LISBOA,1111,31922.73,391402,20490,18316,13545,9137,7284,16421,29966,48282,68772,1226.08,215.43,151.25,93.87
28-12-2020,SOBRAL DE MONTE AGRAÇO,44,3,413,"[240,480]",Elevado,,,,44,Lisboa e Vale do Tejo,LISBOA,1112,5210.32,10651,564,507,352,272,212,484,836,1343,1907,204.43,36.6,25.78,16.05
28-12-2020,SOURE,77,6,450,"[240,480]",Elevado,,,,77,Centro,COIMBRA,0615,26506.07,17120,1173,1142,1004,883,987,1870,2874,4016,5189,64.59,19.58,15.15,10.84
28-12-2020,SOUSEL,32,2,725,"[480,960]",Muito Elevado,,,,32,Alentejo,PORTALEGRE,1215,27932.18,4412,261,274,208,302,292,594,802,1076,1337,15.8,4.79,3.85,2.87
28-12-2020,TÁBUA,96,7,844,"[480,960]",Muito Elevado,,,,96,Centro,COIMBRA,0616,19978.58,11368,729,584,524,430,464,894,1418,2002,2731,56.9,13.67,10.02,7.1
28-12-2020,TABUAÇO,88,6,1459,"[960,Max]",Extremamente Elevado,,,,88,Norte,VISEU,1819,13385.67,6033,372,314,217,282,363,645,862,1176,1548,45.07,11.56,8.79,6.44
28-12-2020,TAROUCA,31,2,397,"[240,480]",Elevado,,,,31,Norte,VISEU,1820,10008.49,7804,405,335,313,277,324,601,914,1249,1654,77.98,16.53,12.48,9.13
28-12-2020,TAVIRA,78,6,318,"[240,480]",Elevado,,,,78,Algarve,FARO,0814,60696.7,24530,1493,1415,1252,1066,1277,2343,3595,5010,6503,40.41,10.71,8.25,5.92
28-12-2020,TERRAS DE BOURO,37,3,582,"[480,960]",Muito Elevado,,,,37,Norte,BRAGA,0310,27746.07,6361,391,372,296,319,340,659,955,1327,1718,22.93,6.19,4.78,3.44
28-12-2020,TOMAR,85,6,231,"[0,240]",Moderado,,,,85,Lisboa e Vale do Tejo,SANTARÉM,1418,35120.44,36748,2403,2189,1868,1853,1822,3675,5543,7732,10135,104.64,28.86,22.02,15.78
28-12-2020,TONDELA,62,4,235,"[0,240]",Moderado,,,,62,Centro,VISEU,1821,37121.73,26357,1768,1722,1518,1475,1417,2892,4410,6132,7900,71.0,21.28,16.52,11.88
28-12-2020,TORRE DE MONCORVO,10,1,130,"[0,240]",Moderado,,,,10,Norte,BRAGANÇA,0409,53155.67,7695,556,478,488,551,719,1270,1758,2236,2792,14.48,5.25,4.21,3.31
28-12-2020,TORRES NOVAS,177,13,507,"[480,960]",Muito Elevado,,,,177,Lisboa e Vale do Tejo,SANTARÉM,1419,26999.68,34933,2324,1979,1738,1406,1475,2881,4619,6598,8922,129.38,33.04,24.44,17.11
28-12-2020,TORRES VEDRAS,262,19,334,"[240,480]",Elevado,,,,262,Lisboa e Vale do Tejo,LISBOA,1113,40714.89,78530,4513,3945,3447,2628,2104,4732,8179,12124,16637,192.88,40.86,29.78,20.09
28-12-2020,TRANCOSO,17,1,192,"[0,240]",Moderado,,,,17,Centro,GUARDA,0913,36152.47,8875,581,557,542,586,496,1082,1624,2181,2762,24.55,7.64,6.03,4.49
28-12-2020,TROFA,275,20,716,"[480,960]",Muito Elevado,,,,275,Norte,PORTO,1318,7201.76,38418,2336,1894,1231,939,684,1623,2854,4748,7084,533.44,98.36,65.93,39.63
28-12-2020,VAGOS,109,8,479,"[240,480]",Elevado,,,,109,Centro,AVEIRO,0118,16491.5,22740,1320,1205,922,784,724,1508,2430,3635,4955,137.89,30.04,22.04,14.73
28-12-2020,VALE DE CAMBRA,44,3,206,"[0,240]",Moderado,,,,44,Norte,AVEIRO,0119,14733.47,21327,1491,1363,1005,831,798,1629,2634,3997,5488,144.76,37.25,27.13,17.88
28-12-2020,VALENÇA,33,2,248,"[240,480]",Elevado,,,,33,Norte,VIANA DO CASTELO,1608,11712.86,13290,867,791,582,582,503,1085,1667,2458,3325,113.46,28.39,20.99,14.23
28-12-2020,VALONGO,460,33,472,"[240,480]",Elevado,,,,460,Norte,PORTO,1315,7512.45,97444,5629,4696,3207,2462,1829,4291,7498,12194,17823,1297.18,237.26,162.33,99.81
28-12-2020,VALPAÇOS,154,11,1039,"[960,Max]",Extremamente Elevado,,,,154,Norte,VILA REAL,1712,54873.93,14818,1217,1118,999,928,997,1925,2924,4042,5259,27.0,9.58,7.37,5.33
28-12-2020,VELAS,2,0,39,"[0,240]",Moderado,,,,2,Açores,AÇORES,4502,11738.38,5093,278,208,166,153,113,266,432,640,918,43.39,7.82,5.45,3.68
28-12-2020,VENDAS NOVAS,92,7,817,"[480,960]",Muito Elevado,,,,92,Alentejo,ÉVORA,0712,22238.88,11255,677,768,655,501,532,1033,1688,2456,3133,50.61,14.09,11.04,7.59
28-12-2020,VIANA DO ALENTEJO,83,6,1613,"[960,Max]",Extremamente Elevado,,,,83,Alentejo,ÉVORA,0713,39367.29,5145,245,208,235,210,214,424,659,867,1112,13.07,2.82,2.2,1.67
28-12-2020,VIANA DO CASTELO,341,24,404,"[240,480]",Elevado,,,,341,Norte,VIANA DO CASTELO,1609,31902.01,84417,5470,4433,3591,3061,2982,6043,9634,14067,19537,264.61,61.24,44.09,30.2
28-12-2020,VIDIGUEIRA,107,8,1942,"[960,Max]",Extremamente Elevado,,,,107,Alentejo,BEJA,0214,31661.09,5510,300,248,215,233,275,508,723,971,1271,17.4,4.01,3.07,2.28
28-12-2020,VIEIRA DO MINHO,62,4,524,"[480,960]",Muito Elevado,,,,62,Norte,BRAGA,0311,21644.35,11842,703,594,525,548,482,1030,1555,2149,2852,54.71,13.18,9.93,7.18
28-12-2020,VILA DE REI,10,1,301,"[240,480]",Elevado,,,,10,Centro,CASTELO BRANCO,0510,19154.6,3323,169,128,172,247,302,549,721,849,1018,17.35,5.31,4.43,3.76
28-12-2020,VILA DO BISPO,3,0,58,"[0,240]",Moderado,,,,3,Algarve,FARO,0815,17906.06,5154,302,302,314,232,233,465,779,1081,1383,28.78,7.72,6.04,4.35
28-12-2020,VILA DO CONDE,732,52,916,"[480,960]",Muito Elevado,,,,732,Norte,PORTO,1316,14902.77,79899,4726,3875,2819,2070,1743,3813,6632,10507,15233,536.13,102.21,70.5,44.5
28-12-2020,VILA DO PORTO,1,0,18,"[0,240]",Moderado,,,,1,Açores,AÇORES,4101,9688.74,5616,274,212,135,96,123,219,354,566,840,57.96,8.67,5.84,3.65
28-12-2020,VILA FLOR,28,2,463,"[240,480]",Elevado,,,,28,Norte,BRAGANÇA,0410,26581.14,6044,429,362,422,294,331,625,1047,1409,1838,22.74,6.91,5.3,3.94
28-12-2020,VILA FRANCA DE XIRA,481,34,339,"[240,480]",Elevado,,,,481,Lisboa e Vale do Tejo,LISBOA,1114,31819.39,141957,8501,6852,4869,3425,2472,5897,10766,17618,26119,446.14,82.09,55.37,33.84
28-12-2020,VILA FRANCA DO CAMPO,81,6,733,"[480,960]",Muito Elevado,,,,81,Açores,AÇORES,4206,7796.82,11051,450,344,248,217,154,371,619,963,1413,141.73,18.12,12.35,7.94
28-12-2020,VILA NOVA DA BARQUINHA,12,1,161,"[0,240]",Moderado,,,,12,Lisboa e Vale do Tejo,SANTARÉM,1420,4952.97,7461,415,406,392,364,338,702,1094,1500,1915,150.64,38.66,30.28,22.09
28-12-2020,VILA NOVA DE CERVEIRA,24,2,269,"[240,480]",Elevado,,,,24,Norte,VIANA DO CASTELO,1610,10846.66,8910,531,444,410,384,334,718,1128,1572,2103,82.14,19.39,14.49,10.4
28-12-2020,VILA NOVA DE FAMALICÃO,855,61,649,"[480,960]",Muito Elevado,,,,855,Norte,BRAGA,0312,20159.26,131676,7817,6164,4202,3282,2749,6031,10233,16397,24214,653.19,120.12,81.34,50.76
28-12-2020,VILA NOVA DE FOZ CÔA,6,0,92,"[0,240]",Moderado,,,,6,Centro,GUARDA,0914,39815.18,6503,442,385,390,398,429,827,1217,1602,2044,16.33,5.13,4.02,3.06
28-12-2020,VILA NOVA DE GAIA,1349,96,449,"[240,480]",Elevado,,,,1349,Norte,PORTO,1317,16846.43,300472,18349,15568,10972,8224,6281,14505,25477,41045,59394,1783.64,352.57,243.65,151.23
28-12-2020,VILA NOVA DE PAIVA,18,1,384,"[240,480]",Elevado,,,,18,Centro,VISEU,1822,17553.28,4687,289,272,233,217,241,458,691,963,1252,26.7,7.13,5.49,3.94
28-12-2020,VILA NOVA DE POIARES,51,4,735,"[480,960]",Muito Elevado,,,,51,Centro,COIMBRA,0617,8445.3,6939,380,284,262,235,182,417,679,963,1343,82.17,15.9,11.4,8.04
28-12-2020,VILA POUCA DE AGUIAR,99,7,828,"[480,960]",Muito Elevado,,,,99,Norte,VILA REAL,1713,43706.62,11961,860,817,733,601,627,1228,1961,2778,3638,27.37,8.32,6.36,4.49
28-12-2020,VILA REAL,386,28,773,"[480,960]",Muito Elevado,,,,386,Norte,VILA REAL,1714,37880.28,49962,3025,2498,2065,1579,1466,3045,5110,7608,10633,131.9,28.07,20.08,13.49
28-12-2020,VILA REAL DE SANTO ANTÓNIO,54,4,288,"[240,480]",Elevado,,,,54,Algarve,FARO,0816,6125.0,18749,1172,1069,811,569,586,1155,1966,3035,4207,306.11,68.69,49.55,32.1
28-12-2020,VILA VELHA DE RÓDÃO,11,1,350,"[240,480]",Elevado,,,,11,Centro,CASTELO BRANCO,0511,32991.16,3144,209,229,180,283,306,589,769,998,1207,9.53,3.66,3.03,2.33
28-12-2020,VILA VERDE,311,22,663,"[480,960]",Muito Elevado,,,,311,Norte,BRAGA,0313,22866.52,46911,2365,2063,1667,1494,1437,2931,4598,6661,9026,205.15,39.47,29.13,20.11
28-12-2020,VILA VIÇOSA,13,1,170,"[0,240]",Moderado,,,,13,Alentejo,ÉVORA,0714,19485.89,7656,487,379,342,345,324,669,1011,1390,1877,39.29,9.63,7.13,5.19
28-12-2020,VIMIOSO,41,3,1019,"[960,Max]",Extremamente Elevado,,,,41,Norte,BRAGANÇA,0411,48158.51,4023,274,230,261,293,335,628,889,1119,1393,8.35,2.89,2.32,1.85
28-12-2020,VINHAIS,18,1,232,"[0,240]",Moderado,,,,18,Norte,BRAGANÇA,0412,69475.09,7746,599,577,636,641,815,1456,2092,2669,3268,11.15,4.7,3.84,3.01
28-12-2020,VISEU,470,34,483,"[480,960]",Muito Elevado,,,,470,Centro,VISEU,1823,50710.14,97249,5769,5038,4140,3158,2710,5868,10008,15046,20815,191.77,41.05,29.67,19.74
28-12-2020,VIZELA,76,5,318,"[240,480]",Elevado,,,,76,Norte,BRAGA,0314,2469.83,23897,1258,928,655,509,371,880,1535,2463,3721,967.49,150.65,99.72,62.15
28-12-2020,VOUZELA,32,2,333,"[240,480]",Elevado,,,,32,Centro,VISEU,1824,19369.46,9619,626,605,554,532,507,1039,1593,2198,2824,49.66,14.58,11.35,8.22
06-01-2021,ABRANTES,100,7,285,"[240,480]",Elevado,,,,100,Lisboa e Vale do Tejo,SANTARÉM,1401,71469.08,35130,2473,2213,1730,1748,2021,3769,5499,7712,10185,49.15,14.25,10.79,7.69
06-01-2021,ÁGUEDA,327,23,710,"[480,960]",Muito Elevado,,,,327,Centro,AVEIRO,0101,33527.44,46075,3237,2713,2090,1635,1496,3131,5221,7934,11171,137.43,33.32,23.66,15.57
06-01-2021,AGUIAR DA BEIRA,63,4,1354,"[960,Max]",Extremamente Elevado,,,,63,Centro,GUARDA,0901,20676.57,4652,304,281,235,239,148,387,622,903,1207,22.5,5.84,4.37,3.01
06-01-2021,ALANDROAL,28,2,561,"[480,960]",Muito Elevado,,,,28,Alentejo,ÉVORA,0701,54267.81,4992,307,256,296,299,377,676,972,1228,1535,9.2,2.83,2.26,1.79
06-01-2021,ALBERGARIA-A-VELHA,133,10,551,"[480,960]",Muito Elevado,,,,133,Centro,AVEIRO,0102,15882.5,24144,1550,1298,996,687,680,1367,2363,3661,5211,152.02,32.81,23.05,14.88
06-01-2021,ALBUFEIRA,210,15,506,"[480,960]",Muito Elevado,,,,210,Algarve,FARO,0801,14066.42,41528,2067,1717,1425,985,858,1843,3268,4985,7052,295.24,50.14,35.44,23.23
06-01-2021,ALCÁCER DO SAL,113,8,969,"[960,Max]",Extremamente Elevado,,,,113,Alentejo,SETÚBAL,1501,149987.3,11659,884,814,623,623,602,1225,1848,2662,3546,7.77,2.36,1.77,1.23
06-01-2021,ALCANENA,62,4,484,"[480,960]",Muito Elevado,,,,62,Lisboa e Vale do Tejo,SANTARÉM,1402,12732.86,12809,891,744,628,536,588,1124,1752,2496,3387,100.6,26.6,19.6,13.76
06-01-2021,ALCOBAÇA,313,22,584,"[480,960]",Muito Elevado,,,,313,Lisboa e Vale do Tejo,LEIRIA,1001,40814.09,53555,3420,2927,2466,2059,1676,3735,6201,9128,12548,131.22,30.74,22.36,15.19
06-01-2021,ALCOCHETE,202,14,1021,"[960,Max]",Extremamente Elevado,,,,202,Lisboa e Vale do Tejo,SETÚBAL,1502,12836.48,19787,857,834,691,476,447,923,1614,2448,3305,154.15,25.75,19.07,12.57
06-01-2021,ALCOUTIM,5,0,232,"[0,240]",Moderado,,,,5,Algarve,FARO,0802,57536.33,2159,191,188,163,190,267,457,620,808,999,3.75,1.74,1.4,1.08
06-01-2021,ALENQUER,167,12,379,"[240,480]",Elevado,,,,167,Lisboa e Vale do Tejo,LISBOA,1101,30421.92,44052,2298,2062,1629,1330,1155,2485,4114,6176,8474,144.8,27.85,20.3,13.52
06-01-2021,ALFÂNDEGA DA FÉ,31,2,681,"[480,960]",Muito Elevado,,,,31,Norte,BRAGANÇA,0401,32194.64,4550,325,277,301,274,325,599,900,1177,1502,14.13,4.67,3.66,2.8
06-01-2021,ALIJÓ,56,4,527,"[480,960]",Muito Elevado,,,,56,Norte,VILA REAL,1701,29759.89,10625,766,687,635,542,666,1208,1843,2530,3296,35.7,11.08,8.5,6.19
06-01-2021,ALJEZUR,10,1,179,"[0,240]",Moderado,,,,10,Algarve,FARO,0803,32349.95,5594,316,336,335,320,410,730,1065,1401,1717,17.29,5.31,4.33,3.29
06-01-2021,ALJUSTREL,24,2,291,"[240,480]",Elevado,,,,24,Alentejo,BEJA,0201,45847.41,8247,635,521,443,347,358,705,1148,1669,2304,17.99,5.03,3.64,2.5
06-01-2021,ALMADA,996,71,589,"[480,960]",Muito Elevado,,,,996,Lisboa e Vale do Tejo,SETÚBAL,1503,7000.89,169039,10469,9777,7876,6144,5111,11255,19131,28908,39377,2414.5,562.45,412.91,273.26
06-01-2021,ALMEIDA,10,1,172,"[0,240]",Moderado,,,,10,Centro,GUARDA,0902,51798.46,5830,441,419,396,458,393,851,1247,1666,2107,11.26,4.07,3.22,2.41
06-01-2021,ALMEIRIM,73,5,324,"[240,480]",Elevado,,,,73,Lisboa e Vale do Tejo,SANTARÉM,1403,22212.05,22546,1342,1353,1106,866,843,1709,2815,4168,5510,101.5,24.81,18.76,12.67
06-01-2021,ALMODÔVAR,42,3,625,"[480,960]",Muito Elevado,,,,42,Alentejo,BEJA,0202,77788.03,6725,414,443,396,373,328,701,1097,1540,1954,8.65,2.51,1.98,1.41
06-01-2021,ALPIARÇA,55,4,779,"[480,960]",Muito Elevado,,,,55,Lisboa e Vale do Tejo,SANTARÉM,1404,9536.33,7059,515,486,363,333,274,607,970,1456,1971,74.02,20.67,15.27,10.17
06-01-2021,ALTER DO CHÃO,30,2,948,"[480,960]",Muito Elevado,,,,30,Alentejo,PORTALEGRE,1201,36206.62,3165,201,163,136,208,187,395,531,694,895,8.74,2.47,1.92,1.47
06-01-2021,ALVAIÁZERE,56,4,849,"[480,960]",Muito Elevado,,,,56,Centro,LEIRIA,1002,16047.76,6597,419,389,346,406,539,945,1291,1680,2099,41.11,13.08,10.47,8.04
06-01-2021,ALVITO,14,1,565,"[480,960]",Muito Elevado,,,,14,Alentejo,BEJA,0203,26485.32,2477,145,110,105,111,89,200,305,415,560,9.35,2.11,1.57,1.15
06-01-2021,AMADORA,987,70,536,"[480,960]",Muito Elevado,,,,987,Lisboa e Vale do Tejo,LISBOA,1115,2378.47,184106,11186,10936,8780,6460,5890,12350,21130,32066,43252,7742.05,1818.84,1348.44,888.56
06-01-2021,AMARANTE,376,27,707,"[480,960]",Muito Elevado,,,,376,Norte,PORTO,1301,30133.15,53193,3086,2413,1812,1643,1311,2954,4766,7179,10265,176.53,34.07,23.82,15.82
06-01-2021,AMARES,122,9,673,"[480,960]",Muito Elevado,,,,122,Norte,BRAGA,0301,8195.41,18129,1001,829,622,489,524,1013,1635,2464,3465,221.22,42.28,30.07,19.95
06-01-2021,ANADIA,291,21,1068,"[960,Max]",Extremamente Elevado,,,,291,Centro,AVEIRO,0103,21663.48,27258,1931,1698,1376,1208,1262,2470,3846,5544,7475,125.83,34.51,25.59,17.75
06-01-2021,ANGRA DO HEROÍSMO,25,2,74,"[0,240]",Moderado,,,,25,Açores,AÇORES,4301,23899.66,33807,2006,1473,1122,768,635,1403,2525,3998,6004,141.45,25.12,16.73,10.56
06-01-2021,ANSIÃO,125,9,1038,"[960,Max]",Extremamente Elevado,,,,125,Centro,LEIRIA,1003,17609.42,12039,727,709,646,694,530,1224,1870,2579,3306,68.37,18.77,14.65,10.62
06-01-2021,ARCOS DE VALDEVEZ,142,10,679,"[480,960]",Muito Elevado,,,,142,Norte,VIANA DO CASTELO,1601,44759.64,20926,1329,1338,1282,1343,1515,2858,4140,5478,6807,46.75,15.21,12.24,9.25
06-01-2021,ARGANIL,102,7,926,"[480,960]",Muito Elevado,,,,102,Centro,COIMBRA,0601,33283.93,11014,672,648,612,559,596,1155,1767,2415,3087,33.09,9.27,7.26,5.31
06-01-2021,ARMAMAR,68,5,1179,"[960,Max]",Extremamente Elevado,,,,68,Norte,VISEU,1801,11723.73,5769,357,305,309,285,310,595,904,1209,1566,49.21,13.36,10.31,7.71
06-01-2021,AROUCA,136,10,656,"[480,960]",Muito Elevado,,,,136,Norte,AVEIRO,0104,32910.52,20720,1306,1047,753,683,683,1366,2119,3166,4472,62.96,13.59,9.62,6.44
06-01-2021,ARRAIOLOS,53,4,765,"[480,960]",Muito Elevado,,,,53,Alentejo,ÉVORA,0702,68374.55,6928,435,384,283,367,480,847,1130,1514,1949,10.13,2.85,2.21,1.65
06-01-2021,ARRONCHES,3,0,106,"[0,240]",Moderado,,,,3,Alentejo,PORTALEGRE,1202,31464.72,2820,155,142,162,187,179,366,528,670,825,8.96,2.62,2.13,1.68
06-01-2021,ARRUDA DOS VINHOS,124,9,805,"[480,960]",Muito Elevado,,,,124,Lisboa e Vale do Tejo,LISBOA,1102,7795.93,15412,738,738,562,509,438,947,1509,2247,2985,197.69,38.29,28.82,19.36
06-01-2021,AVEIRO,374,27,475,"[240,480]",Elevado,,,,374,Centro,AVEIRO,0105,19757.57,78734,4520,4004,3050,2250,2103,4353,7403,11407,15927,398.49,80.61,57.73,37.47
06-01-2021,AVIS,23,2,542,"[480,960]",Muito Elevado,,,,23,Alentejo,PORTALEGRE,1203,60596.51,4247,315,225,206,251,273,524,730,955,1270,7.01,2.1,1.58,1.2
06-01-2021,AZAMBUJA,76,5,335,"[240,480]",Elevado,,,,76,Lisboa e Vale do Tejo,LISBOA,1103,26265.65,22716,1322,1171,1070,798,618,1416,2486,3657,4979,86.48,18.96,13.92,9.46
06-01-2021,BAIÃO,81,6,432,"[240,480]",Elevado,,,,81,Norte,PORTO,1302,17452.83,18748,1070,862,714,686,725,1411,2125,2987,4057,107.42,23.25,17.11,12.18
06-01-2021,BARCELOS,1257,90,1082,"[960,Max]",Extremamente Elevado,,,,1257,Norte,BRAGA,0302,37890.14,116187,6721,5325,3619,2991,2562,5553,9172,14497,21218,306.64,56.0,38.26,24.21
06-01-2021,BARRANCOS,1,0,61,"[0,240]",Moderado,,,,1,Alentejo,BEJA,0204,16841.73,1634,90,65,65,94,61,155,220,285,375,9.7,2.23,1.69,1.31
06-01-2021,BARREIRO,399,29,531,"[480,960]",Muito Elevado,,,,399,Lisboa e Vale do Tejo,SETÚBAL,1504,3639.07,75147,5194,5565,4459,3105,1767,4872,9331,14896,20090,2065.05,552.07,409.34,256.42
06-01-2021,BATALHA,96,7,601,"[480,960]",Muito Elevado,,,,96,Centro,LEIRIA,1004,10341.6,15963,873,762,649,529,549,1078,1727,2489,3362,154.35,32.51,24.07,16.7
06-01-2021,BEJA,246,18,733,"[480,960]",Muito Elevado,,,,246,Alentejo,BEJA,0205,114647.55,33579,2005,1840,1386,1272,1039,2311,3697,5537,7542,29.29,6.58,4.83,3.22
06-01-2021,BELMONTE,26,2,406,"[240,480]",Elevado,,,,26,Centro,CASTELO BRANCO,0501,11875.91,6398,444,321,325,310,355,665,990,1311,1755,53.87,14.78,11.04,8.34
06-01-2021,BENAVENTE,183,13,598,"[480,960]",Muito Elevado,,,,183,Lisboa e Vale do Tejo,SANTARÉM,1405,52138.39,30602,1468,1376,1141,876,643,1519,2660,4036,5504,58.69,10.56,7.74,5.1
06-01-2021,BOMBARRAL,43,3,342,"[240,480]",Elevado,,,,43,Lisboa e Vale do Tejo,LEIRIA,1005,9128.55,12558,875,714,561,491,429,920,1481,2195,3070,137.56,33.63,24.04,16.22
06-01-2021,BORBA,84,6,1247,"[960,Max]",Extremamente Elevado,,,,84,Alentejo,ÉVORA,0703,14518.65,6736,430,375,279,436,392,828,1107,1482,1912,46.39,13.17,10.21,7.62
06-01-2021,BOTICAS,58,4,1160,"[960,Max]",Extremamente Elevado,,,,58,Norte,VILA REAL,1702,32195.66,4998,347,306,311,305,380,685,996,1302,1649,15.52,5.12,4.04,3.09
06-01-2021,BRAGA,1370,98,750,"[480,960]",Muito Elevado,,,,1370,Norte,BRAGA,0303,18339.95,182679,10029,7963,5241,4320,3671,7991,13232,21195,31224,996.07,170.25,115.57,72.15
06-01-2021,BRAGANÇA,230,16,684,"[480,960]",Muito Elevado,,,,230,Norte,BRAGANÇA,0402,117357.27,33607,2402,1855,1652,1393,1163,2556,4208,6063,8465,28.64,7.21,5.17,3.59
06-01-2021,CABECEIRAS DE BASTO,81,6,518,"[480,960]",Muito Elevado,,,,81,Norte,BRAGA,0304,24182.16,15628,774,594,544,575,574,1149,1693,2287,3061,64.63,12.66,9.46,7.0
06-01-2021,CADAVAL,37,3,271,"[240,480]",Elevado,,,,37,Lisboa e Vale do Tejo,LISBOA,1104,17489.3,13673,813,796,756,621,625,1246,2002,2798,3611,78.18,20.65,16.0,11.45
06-01-2021,CALDAS DA RAINHA,283,20,545,"[480,960]",Muito Elevado,,,,283,Lisboa e Vale do Tejo,LEIRIA,1006,25569.47,51912,3035,2684,2186,1899,1705,3604,5790,8474,11509,203.03,45.01,33.14,22.64
06-01-2021,CALHETA,22,2,202,"[0,240]",Moderado,,,,22,Madeira,MADEIRA,3101,11150.43,10867,576,497,507,399,415,814,1321,1818,2394,97.46,21.47,16.3,11.85
06-01-2021,CALHETA (AÇORES),4,0,126,"[0,240]",Moderado,,,,4,Açores,AÇORES,4501,12626.4,3184,215,159,141,139,122,261,402,561,776,25.22,6.15,4.44,3.18
06-01-2021,CÂMARA DE LOBOS,143,10,425,"[240,480]",Elevado,,,,143,Madeira,MADEIRA,3102,5216.67,33675,1396,1059,834,545,381,926,1760,2819,4215,645.49,80.79,54.03,33.74
06-01-2021,CAMINHA,119,9,750,"[480,960]",Muito Elevado,,,,119,Norte,VIANA DO CASTELO,1602,13652.14,15877,1046,944,818,646,656,1302,2120,3064,4110,116.3,30.11,22.44,15.53
06-01-2021,CAMPO MAIOR,35,3,445,"[240,480]",Elevado,,,,35,Alentejo,PORTALEGRE,1204,24720.16,7874,471,364,351,279,327,606,957,1321,1792,31.85,7.25,5.34,3.87
06-01-2021,CANTANHEDE,286,20,817,"[480,960]",Muito Elevado,,,,286,Centro,COIMBRA,0602,39088.02,35011,2346,2096,1880,1709,1451,3160,5040,7136,9482,89.57,24.26,18.26,12.89
06-01-2021,CARRAZEDA DE ANSIÃES,5,0,88,"[0,240]",Moderado,,,,5,Norte,BRAGANÇA,0403,27924.09,5666,424,389,391,312,465,777,1168,1557,1981,20.29,7.09,5.58,4.18
06-01-2021,CARREGAL DO SAL,83,6,895,"[480,960]",Muito Elevado,,,,83,Centro,VISEU,1802,11689.21,9271,587,562,486,462,376,838,1324,1886,2473,79.31,21.16,16.13,11.33
06-01-2021,CARTAXO,79,6,331,"[240,480]",Elevado,,,,79,Lisboa e Vale do Tejo,SANTARÉM,1406,15817.28,23843,1415,1376,1142,861,632,1493,2635,4011,5426,150.74,34.3,25.36,16.66
06-01-2021,CASCAIS,1070,76,501,"[480,960]",Muito Elevado,,,,1070,Lisboa e Vale do Tejo,LISBOA,1105,9740.17,213608,12151,11444,8680,6469,5248,11717,20397,31841,43992,2193.1,451.66,326.91,209.41
06-01-2021,CASTANHEIRA DE PÊRA,4,0,153,"[0,240]",Moderado,,,,4,Centro,LEIRIA,1007,6677.45,2614,233,195,157,190,187,377,534,729,962,39.15,14.41,10.92,8.0
06-01-2021,CASTELO BRANCO,297,21,571,"[480,960]",Muito Elevado,,,,297,Centro,CASTELO BRANCO,0502,143819.15,51987,3528,3042,2499,2229,2225,4454,6953,9995,13523,36.15,9.4,6.95,4.83
06-01-2021,CASTELO DE PAIVA,58,4,375,"[240,480]",Elevado,,,,58,Norte,AVEIRO,0106,11500.53,15454,881,697,545,420,431,851,1396,2093,2974,134.37,25.86,18.2,12.14
06-01-2021,CASTELO DE VIDE,1,0,34,"[0,240]",Moderado,,,,1,Alentejo,PORTALEGRE,1205,26491.24,2919,204,173,179,147,170,317,496,669,873,11.02,3.3,2.53,1.87
06-01-2021,CASTRO DAIRE,96,7,694,"[480,960]",Muito Elevado,,,,96,Centro,VISEU,1803,37904.13,13823,942,857,765,732,773,1505,2270,3127,4069,36.47,10.74,8.25,5.99
06-01-2021,CASTRO MARIM,15,1,241,"[240,480]",Elevado,,,,15,Algarve,FARO,0804,30084.37,6237,370,345,334,322,344,666,1000,1345,1715,20.73,5.7,4.47,3.32
06-01-2021,CASTRO VERDE,21,1,302,"[240,480]",Elevado,,,,21,Alentejo,BEJA,0206,56944.23,6949,437,347,303,275,227,502,805,1152,1589,12.2,2.79,2.02,1.41
06-01-2021,CELORICO DA BEIRA,69,5,996,"[960,Max]",Extremamente Elevado,,,,69,Centro,GUARDA,0903,24721.63,6928,430,416,363,369,535,904,1267,1683,2113,28.02,8.55,6.81,5.12
06-01-2021,CELORICO DE BASTO,113,8,593,"[480,960]",Muito Elevado,,,,113,Norte,BRAGA,0305,18107.02,19040,1001,802,668,728,729,1457,2125,2927,3928,105.15,21.69,16.17,11.74
06-01-2021,CHAMUSCA,33,2,359,"[240,480]",Elevado,,,,33,Lisboa e Vale do Tejo,SANTARÉM,1407,74600.54,9197,629,583,553,465,579,1044,1597,2180,2809,12.33,3.77,2.92,2.14
06-01-2021,CHAVES,336,24,854,"[480,960]",Muito Elevado,,,,336,Norte,VILA REAL,1703,59122.95,39343,2676,2429,1991,1886,1918,3804,5795,8224,10900,66.54,18.44,13.91,9.8
06-01-2021,CINFÃES,86,6,471,"[240,480]",Elevado,,,,86,Norte,VISEU,1804,23928.76,18244,1067,902,779,734,758,1492,2271,3173,4240,76.24,17.72,13.26,9.49
06-01-2021,COIMBRA,755,54,563,"[480,960]",Muito Elevado,,,,755,Centro,COIMBRA,0603,31939.94,134166,9489,8734,6353,5139,5074,10213,16566,25300,34789,420.06,108.92,79.21,51.87
06-01-2021,CONDEIXA-A-NOVA,103,7,581,"[480,960]",Muito Elevado,,,,103,Centro,COIMBRA,0604,13867.47,17733,871,809,717,583,490,1073,1790,2599,3470,127.88,25.02,18.74,12.91
06-01-2021,CONSTÂNCIA,21,1,521,"[480,960]",Muito Elevado,,,,21,Lisboa e Vale do Tejo,SANTARÉM,1408,8036.58,4030,211,183,187,148,155,303,490,673,884,50.14,11.0,8.37,6.1
06-01-2021,CORUCHE,37,3,212,"[0,240]",Moderado,,,,37,Lisboa e Vale do Tejo,SANTARÉM,1409,111572.03,17471,1294,1090,1095,1096,1019,2115,3210,4300,5594,15.66,5.01,3.85,2.88
06-01-2021,CORVO,0,0,0,"[0,240]",Moderado,,,,0,Açores,AÇORES,4901,1711.45,464,22,21,11,13,19,32,43,64,86,27.12,5.03,3.74,2.51
06-01-2021,COVILHÃ,209,15,447,"[240,480]",Elevado,,,,209,Centro,CASTELO BRANCO,0503,55560.06,46787,3533,2998,2365,2111,2193,4304,6669,9667,13200,84.21,23.76,17.4,12.0
06-01-2021,CRATO,41,3,1310,"[960,Max]",Extremamente Elevado,,,,41,Alentejo,PORTALEGRE,1206,39806.88,3129,229,258,163,182,228,410,573,831,1060,7.86,2.66,2.09,1.44
06-01-2021,CUBA,55,4,1197,"[960,Max]",Extremamente Elevado,,,,55,Alentejo,BEJA,0207,17208.72,4595,255,233,206,190,143,333,539,772,1027,26.7,5.97,4.49,3.13
06-01-2021,ELVAS,256,18,1247,"[960,Max]",Extremamente Elevado,,,,256,Alentejo,PORTALEGRE,1207,63128.86,20528,1057,1145,902,852,810,1662,2564,3709,4766,32.52,7.55,5.88,4.06
06-01-2021,ENTRONCAMENTO,121,9,561,"[480,960]",Muito Elevado,,,,121,Lisboa e Vale do Tejo,SANTARÉM,1410,1372.81,21558,1066,930,868,695,592,1287,2155,3085,4151,1570.14,302.33,224.69,156.96
06-01-2021,ESPINHO,124,9,420,"[240,480]",Elevado,,,,124,Norte,AVEIRO,0107,2105.68,29516,2205,1993,1430,1177,960,2137,3567,5560,7765,1401.52,368.71,264.01,169.37
06-01-2021,ESPOSENDE,434,31,1270,"[960,Max]",Extremamente Elevado,,,,434,Norte,BRAGA,0306,9540.98,34177,1831,1522,1095,894,723,1617,2712,4234,6065,358.21,63.57,44.38,28.42
06-01-2021,ESTARREJA,164,12,631,"[480,960]",Muito Elevado,,,,164,Centro,AVEIRO,0108,10817.33,26006,1503,1399,1106,953,728,1681,2787,4186,5689,240.42,52.59,38.7,25.76
06-01-2021,ESTREMOZ,85,6,668,"[480,960]",Muito Elevado,,,,85,Alentejo,ÉVORA,0704,51379.95,12728,789,613,697,786,877,1663,2360,2973,3762,24.77,7.32,5.79,4.59
06-01-2021,ÉVORA,434,31,828,"[480,960]",Muito Elevado,,,,434,Alentejo,ÉVORA,0705,130707.58,52428,3569,2852,2176,1966,1803,3769,5945,8797,12366,40.11,9.46,6.73,4.55
06-01-2021,FAFE,291,21,605,"[480,960]",Muito Elevado,,,,291,Norte,BRAGA,0307,21908.11,48060,3044,2455,1679,1403,1208,2611,4290,6745,9789,219.37,44.68,30.79,19.58
06-01-2021,FARO,299,21,490,"[480,960]",Muito Elevado,,,,299,Algarve,FARO,0805,20256.79,61015,3847,3364,2604,2055,1601,3656,6260,9624,13471,301.2,66.5,47.51,30.9
06-01-2021,FELGUEIRAS,347,25,615,"[480,960]",Muito Elevado,,,,347,Norte,PORTO,1303,11573.75,56422,2951,2302,1601,1316,973,2289,3890,6192,9143,487.49,79.0,53.5,33.61
06-01-2021,FERREIRA DO ALENTEJO,17,1,217,"[0,240]",Moderado,,,,17,Alentejo,BEJA,0208,64820.68,7845,515,414,372,343,345,688,1060,1474,1989,12.1,3.07,2.27,1.64
06-01-2021,FERREIRA DO ZÊZERE,90,6,1131,"[960,Max]",Extremamente Elevado,,,,90,Lisboa e Vale do Tejo,SANTARÉM,1411,19038.03,7959,470,370,416,465,456,921,1337,1707,2177,41.81,11.44,8.97,7.02
06-01-2021,FIGUEIRA DA FOZ,157,11,267,"[240,480]",Elevado,,,,157,Centro,COIMBRA,0605,37905.26,58747,4032,3597,2887,2495,2043,4538,7425,11022,15054,154.98,39.72,29.08,19.59
06-01-2021,FIGUEIRA DE CASTELO RODRIGO,34,2,609,"[480,960]",Muito Elevado,,,,34,Centro,GUARDA,0904,50857.46,5584,347,352,290,352,391,743,1033,1385,1732,10.98,3.41,2.72,2.03
06-01-2021,FIGUEIRÓ DOS VINHOS,87,6,1562,"[960,Max]",Extremamente Elevado,,,,87,Centro,LEIRIA,1008,17344.0,5568,402,386,322,309,351,660,982,1368,1770,32.1,10.21,7.89,5.66
06-01-2021,FORNOS DE ALGODRES,113,8,2496,"[960,Max]",Extremamente Elevado,,,,113,Centro,GUARDA,0905,13145.05,4528,261,218,247,256,232,488,735,953,1214,34.45,9.24,7.25,5.59
06-01-2021,FREIXO DE ESPADA À CINTA,4,0,121,"[0,240]",Moderado,,,,4,Norte,BRAGANÇA,0404,24414.29,3298,211,177,231,196,189,385,616,793,1004,13.51,4.11,3.25,2.52
06-01-2021,FRONTEIRA,15,1,504,"[480,960]",Muito Elevado,,,,15,Alentejo,PORTALEGRE,1208,24859.58,2974,213,182,149,156,168,324,473,655,868,11.96,3.49,2.63,1.9
06-01-2021,FUNCHAL,182,13,175,"[0,240]",Moderado,,,,182,Madeira,MADEIRA,3103,7616.2,104024,6382,5086,3643,2821,1990,4811,8454,13540,19922,1365.86,261.58,177.78,111.0
06-01-2021,FUNDÃO,196,14,740,"[480,960]",Muito Elevado,,,,196,Centro,CASTELO BRANCO,0504,70019.79,26495,1781,1464,1432,1357,1643,3000,4432,5896,7677,37.84,10.96,8.42,6.33
06-01-2021,GAVIÃO,40,3,1226,"[960,Max]",Extremamente Elevado,,,,40,Alentejo,PORTALEGRE,1209,29459.45,3263,189,186,222,263,293,556,778,964,1153,11.08,3.91,3.27,2.64
06-01-2021,GÓIS,19,1,499,"[480,960]",Muito Elevado,,,,19,Centro,COIMBRA,0606,26330.19,3805,235,199,240,233,244,477,717,916,1151,14.45,4.37,3.48,2.72
06-01-2021,GOLEGÃ,20,1,375,"[240,480]",Elevado,,,,20,Lisboa e Vale do Tejo,SANTARÉM,1412,8431.67,5339,356,299,281,243,255,498,779,1078,1434,63.32,17.01,12.78,9.24
06-01-2021,GONDOMAR,1147,82,691,"[480,960]",Muito Elevado,,,,1147,Norte,PORTO,1304,13191.76,165985,10555,8755,6222,4450,3364,7814,14036,22791,33346,1258.22,252.77,172.76,106.4
06-01-2021,GOUVEIA,46,3,371,"[240,480]",Elevado,,,,46,Centro,GUARDA,0906,30061.17,12387,871,931,780,783,810,1593,2373,3304,4175,41.21,13.89,10.99,7.89
06-01-2021,GRÂNDOLA,56,4,383,"[240,480]",Elevado,,,,56,Alentejo,SETÚBAL,1505,82593.66,14639,834,834,708,688,672,1360,2068,2902,3736,17.72,4.52,3.51,2.5
06-01-2021,GUARDA,399,29,1024,"[960,Max]",Extremamente Elevado,,,,399,Centro,GUARDA,0907,71209.58,38969,2477,2041,1686,1415,1474,2889,4575,6616,9093,54.72,12.77,9.29,6.42
06-01-2021,GUIMARÃES,1314,94,863,"[480,960]",Muito Elevado,,,,1314,Norte,BRAGA,0308,24099.96,152309,9394,7074,4809,3877,2948,6825,11634,18708,28102,631.99,116.61,77.63,48.27
06-01-2021,HORTA,6,0,41,"[0,240]",Moderado,,,,6,Açores,AÇORES,4701,17305.53,14521,818,658,468,352,302,654,1122,1780,2598,83.91,15.01,10.29,6.48
06-01-2021,IDANHA-A-NOVA,97,7,1206,"[960,Max]",Extremamente Elevado,,,,97,Centro,CASTELO BRANCO,0505,141633.51,8043,518,490,519,672,974,1646,2165,2655,3173,5.68,2.24,1.87,1.53
06-01-2021,ÍLHAVO,250,18,646,"[480,960]",Muito Elevado,,,,250,Centro,AVEIRO,0110,7347.55,38699,2227,1943,1444,1193,850,2043,3487,5430,7657,526.66,104.21,73.9,47.46
06-01-2021,LAGOA (FARO),45,3,198,"[0,240]",Moderado,,,,45,Algarve,FARO,0806,8825.45,22762,1314,1168,919,749,670,1419,2338,3506,4820,257.93,54.62,39.73,26.49
06-01-2021,LAGOA,66,5,448,"[240,480]",Elevado,,,,66,Açores,AÇORES,4201,4559.32,14721,536,458,349,238,235,473,822,1280,1816,322.9,39.83,28.08,18.03
06-01-2021,LAGOS,140,10,461,"[240,480]",Elevado,,,,140,Algarve,FARO,0807,21299.27,30374,1744,1434,1247,1053,1029,2082,3329,4763,6507,142.61,30.55,22.36,15.63
06-01-2021,LAJES DAS FLORES,0,0,0,"[0,240]",Moderado,,,,0,Açores,AÇORES,4801,7004.79,1463,88,53,62,46,54,100,162,215,303,20.89,4.33,3.07,2.31
06-01-2021,LAJES DO PICO,0,0,0,"[0,240]",Moderado,,,,0,Açores,AÇORES,4601,15531.09,4490,304,231,223,159,162,321,544,775,1079,28.91,6.95,4.99,3.5
06-01-2021,LAMEGO,258,18,1036,"[960,Max]",Extremamente Elevado,,,,258,Norte,VISEU,1805,16542.11,24895,1639,1284,1124,898,783,1681,2805,4089,5728,150.5,34.63,24.72,16.96
06-01-2021,LEIRIA,770,55,615,"[480,960]",Muito Elevado,,,,770,Centro,LEIRIA,1009,56508.83,125267,7389,6366,5090,3902,3159,7061,12151,18517,25906,221.68,45.84,32.77,21.5
06-01-2021,LISBOA,3327,238,653,"[480,960]",Muito Elevado,,,,3327,Lisboa e Vale do Tejo,LISBOA,1106,10005.43,509515,33197,33340,27706,23037,26770,49807,77513,110853,144050,5092.6,1439.78,1107.98,774.74
06-01-2021,LOULÉ,297,21,432,"[240,480]",Elevado,,,,297,Algarve,FARO,0808,76366.91,68697,3890,3350,2780,2358,2251,4609,7389,10739,14629,89.96,19.16,14.06,9.68
06-01-2021,LOURES,1440,103,674,"[480,960]",Muito Elevado,,,,1440,Lisboa e Vale do Tejo,LISBOA,1107,16723.99,213687,12746,12794,9644,6669,5033,11702,21346,34140,46886,1277.73,280.35,204.14,127.64
06-01-2021,LOURINHÃ,87,6,336,"[240,480]",Elevado,,,,87,Lisboa e Vale do Tejo,LISBOA,1108,14717.2,25855,1584,1243,992,842,645,1487,2479,3722,5306,175.68,36.05,25.29,16.84
06-01-2021,LOUSÃ,54,4,315,"[240,480]",Elevado,,,,54,Centro,COIMBRA,0607,13840.01,17158,946,866,658,528,450,978,1636,2502,3448,123.97,24.91,18.08,11.82
06-01-2021,LOUSADA,208,15,445,"[240,480]",Elevado,,,,208,Norte,PORTO,1305,9608.01,46755,2289,1698,1176,853,621,1474,2650,4348,6637,486.63,69.08,45.25,27.58
06-01-2021,MAÇÃO,121,9,1931,"[960,Max]",Extremamente Elevado,,,,121,Lisboa e Vale do Tejo,SANTARÉM,1413,39997.98,6267,386,362,390,440,657,1097,1487,1849,2235,15.67,5.59,4.62,3.72
06-01-2021,MACEDO DE CAVALEIROS,218,16,1502,"[960,Max]",Extremamente Elevado,,,,218,Norte,BRAGANÇA,0405,69914.08,14516,1082,889,878,823,938,1761,2639,3528,4610,20.76,6.59,5.05,3.77
06-01-2021,MACHICO,32,2,160,"[0,240]",Moderado,,,,32,Madeira,MADEIRA,3104,6825.1,19981,1197,860,662,455,331,786,1448,2308,3505,292.76,51.36,33.82,21.22
06-01-2021,MADALENA,2,0,34,"[0,240]",Moderado,,,,2,Açores,AÇORES,4602,14712.33,5895,334,256,173,190,179,369,542,798,1132,40.07,7.69,5.42,3.68
06-01-2021,MAFRA,472,34,556,"[480,960]",Muito Elevado,,,,472,Lisboa e Vale do Tejo,LISBOA,1109,29165.5,84816,3613,3334,2839,2089,1899,3988,6827,10161,13774,290.81,47.23,34.84,23.41
06-01-2021,MAIA,662,47,476,"[240,480]",Elevado,,,,662,Norte,PORTO,1306,8293.94,138971,7801,6617,4512,3339,2631,5970,10482,17099,24900,1675.56,300.22,206.16,126.38
06-01-2021,MANGUALDE,309,22,1669,"[960,Max]",Extremamente Elevado,,,,309,Centro,VISEU,1806,21925.56,18510,1198,1128,885,852,743,1595,2480,3608,4806,84.42,21.92,16.46,11.31
06-01-2021,MANTEIGAS,7,1,233,"[0,240]",Moderado,,,,7,Centro,GUARDA,0908,12197.55,3007,258,197,159,167,146,313,472,669,927,24.65,7.6,5.48,3.87
06-01-2021,MARCO DE CANAVESES,317,23,616,"[480,960]",Muito Elevado,,,,317,Norte,PORTO,1307,20188.98,51496,2678,2060,1488,1265,1023,2288,3776,5836,8514,255.07,42.17,28.91,18.7
06-01-2021,MARINHA GRANDE,206,15,535,"[480,960]",Muito Elevado,,,,206,Centro,LEIRIA,1010,18725.19,38508,2365,2302,1638,1359,1058,2417,4055,6357,8722,205.65,46.58,33.95,21.66
06-01-2021,MARVÃO,23,2,765,"[480,960]",Muito Elevado,,,,23,Alentejo,PORTALEGRE,1210,15489.9,3005,198,185,142,197,237,434,576,761,959,19.4,6.19,4.91,3.72
06-01-2021,MATOSINHOS,964,69,550,"[480,960]",Muito Elevado,,,,964,Norte,PORTO,1308,6241.97,175357,11850,9977,7023,5024,3884,8908,15931,25908,37758,2809.31,604.9,415.06,255.22
06-01-2021,MEALHADA,138,10,693,"[480,960]",Muito Elevado,,,,138,Centro,AVEIRO,0111,11065.66,19914,1163,1039,810,828,831,1659,2469,3508,4671,179.96,42.21,31.7,22.31
06-01-2021,MÊDA,141,10,3074,"[960,Max]",Extremamente Elevado,,,,141,Centro,GUARDA,0909,28604.92,4587,343,306,290,288,443,731,1021,1327,1670,16.04,5.84,4.64,3.57
06-01-2021,MELGAÇO,50,4,618,"[480,960]",Muito Elevado,,,,50,Norte,VIANA DO CASTELO,1603,23824.58,8093,507,567,578,614,675,1289,1867,2434,2941,33.97,12.34,10.22,7.84
06-01-2021,MÉRTOLA,94,7,1530,"[960,Max]",Extremamente Elevado,,,,94,Alentejo,BEJA,0209,129287.34,6142,400,390,378,423,600,1023,1401,1791,2191,4.75,1.69,1.39,1.08
06-01-2021,MESÃO FRIO,10,1,252,"[240,480]",Elevado,,,,10,Norte,VILA REAL,1704,2664.87,3964,265,205,168,157,120,277,445,650,915,148.74,34.33,24.39,16.7
06-01-2021,MIRA,59,4,499,"[480,960]",Muito Elevado,,,,59,Centro,COIMBRA,0608,12403.38,11832,727,729,659,550,466,1016,1675,2404,3131,95.4,25.24,19.38,13.5
06-01-2021,MIRANDA DO CORVO,111,8,873,"[480,960]",Muito Elevado,,,,111,Centro,COIMBRA,0609,12637.79,12708,706,659,568,498,404,902,1470,2129,2835,100.55,22.43,16.85,11.63
06-01-2021,MIRANDA DO DOURO,170,12,2489,"[960,Max]",Extremamente Elevado,,,,170,Norte,BRAGANÇA,0406,48718.31,6830,482,429,442,463,470,933,1375,1804,2286,14.02,4.69,3.7,2.82
06-01-2021,MIRANDELA,80,6,368,"[240,480]",Elevado,,,,80,Norte,BRAGANÇA,0407,65895.67,21754,1640,1315,1204,1078,947,2025,3229,4544,6184,33.01,9.38,6.9,4.9
06-01-2021,MOGADOURO,86,6,1025,"[960,Max]",Extremamente Elevado,,,,86,Norte,BRAGANÇA,0408,76064.93,8392,589,529,576,630,655,1285,1861,2390,2979,11.03,3.92,3.14,2.45
06-01-2021,MOIMENTA DA BEIRA,128,9,1315,"[960,Max]",Extremamente Elevado,,,,128,Norte,VISEU,1807,21996.9,9736,576,514,471,416,461,877,1348,1862,2438,44.26,11.08,8.46,6.13
06-01-2021,MOITA,396,28,615,"[480,960]",Muito Elevado,,,,396,Lisboa e Vale do Tejo,SETÚBAL,1506,5525.98,64407,4226,3646,2623,1801,1425,3226,5849,9495,13721,1165.53,248.3,171.82,105.85
06-01-2021,MONÇÃO,54,4,302,"[240,480]",Elevado,,,,54,Norte,VIANA DO CASTELO,1604,21130.85,17869,1161,1105,1031,1006,972,1978,3009,4114,5275,84.56,24.96,19.47,14.24
06-01-2021,MONCHIQUE,5,0,98,"[0,240]",Moderado,,,,5,Algarve,FARO,0809,39530.43,5077,353,384,321,355,392,747,1068,1452,1805,12.84,4.57,3.67,2.7
06-01-2021,MONDIM DE BASTO,45,3,648,"[480,960]",Muito Elevado,,,,45,Norte,VILA REAL,1705,17207.52,6946,395,300,314,284,283,567,881,1181,1576,40.36,9.16,6.86,5.12
06-01-2021,MONFORTE,10,1,336,"[240,480]",Elevado,,,,10,Alentejo,PORTALEGRE,1211,42024.82,2975,139,115,117,192,168,360,477,592,731,7.08,1.74,1.41,1.14
06-01-2021,MONTALEGRE,148,11,1645,"[960,Max]",Extremamente Elevado,,,,148,Norte,VILA REAL,1706,80545.71,8997,699,628,595,603,730,1333,1928,2556,3255,11.17,4.04,3.17,2.39
06-01-2021,MONTEMOR-O-NOVO,120,9,767,"[480,960]",Muito Elevado,,,,120,Alentejo,ÉVORA,0706,123296.65,15647,991,953,868,878,971,1849,2717,3670,4661,12.69,3.78,2.98,2.2
06-01-2021,MONTEMOR-O-VELHO,95,7,377,"[240,480]",Elevado,,,,95,Centro,COIMBRA,0610,22896.23,25224,1496,1397,1217,1057,988,2045,3262,4659,6155,110.17,26.88,20.35,14.25
06-01-2021,MONTIJO,284,20,493,"[480,960]",Muito Elevado,,,,284,Lisboa e Vale do Tejo,SETÚBAL,1507,34861.64,57614,2771,2441,1990,1554,1109,2663,4653,7094,9865,165.26,28.3,20.35,13.35
06-01-2021,MORA,98,7,2368,"[960,Max]",Extremamente Elevado,,,,98,Alentejo,ÉVORA,0707,44395.02,4138,336,275,252,238,257,495,747,1022,1358,9.32,3.06,2.3,1.68
06-01-2021,MORTÁGUA,49,4,557,"[480,960]",Muito Elevado,,,,49,Centro,VISEU,1808,25117.82,8803,638,584,535,499,460,959,1494,2078,2716,35.05,10.81,8.27,5.95
06-01-2021,MOURA,40,3,292,"[240,480]",Elevado,,,,40,Alentejo,BEJA,0210,95845.55,13718,817,656,665,542,461,1003,1668,2324,3141,14.31,3.28,2.42,1.74
06-01-2021,MOURÃO,82,6,3347,"[960,Max]",Extremamente Elevado,,,,82,Alentejo,ÉVORA,0708,27862.98,2450,139,108,80,104,109,213,293,401,540,8.79,1.94,1.44,1.05
06-01-2021,MURÇA,31,2,567,"[480,960]",Muito Elevado,,,,31,Norte,VILA REAL,1707,18937.11,5463,384,341,307,306,319,625,932,1273,1657,28.85,8.75,6.72,4.92
06-01-2021,MURTOSA,154,11,1498,"[960,Max]",Extremamente Elevado,,,,154,Centro,AVEIRO,0112,7308.78,10279,509,473,403,353,409,762,1165,1638,2147,140.63,29.37,22.41,15.94
06-01-2021,NAZARÉ,45,3,318,"[240,480]",Elevado,,,,45,Lisboa e Vale do Tejo,LEIRIA,1011,8243.43,14165,967,903,670,420,396,816,1486,2389,3356,171.84,40.71,28.98,18.03
06-01-2021,NELAS,101,7,778,"[480,960]",Muito Elevado,,,,101,Centro,VISEU,1809,12571.48,12974,924,787,668,604,583,1187,1855,2642,3566,103.21,28.37,21.02,14.76
06-01-2021,NISA,72,5,1188,"[960,Max]",Extremamente Elevado,,,,72,Alentejo,PORTALEGRE,1212,57567.84,6061,405,389,355,483,478,961,1316,1705,2110,10.53,3.67,2.96,2.29
06-01-2021,NORDESTE,3,0,62,"[0,240]",Moderado,,,,3,Açores,AÇORES,4202,10146.8,4862,246,180,124,161,162,323,447,627,873,47.92,8.6,6.18,4.41
06-01-2021,ÓBIDOS,79,6,667,"[480,960]",Muito Elevado,,,,79,Lisboa e Vale do Tejo,LEIRIA,1012,14155.44,11850,743,650,574,452,436,888,1462,2112,2855,83.72,20.17,14.92,10.33
06-01-2021,ODEMIRA,57,4,231,"[0,240]",Moderado,,,,57,Alentejo,BEJA,0211,172060.15,24717,1475,1317,1225,1397,1349,2746,3971,5288,6763,14.37,3.93,3.07,2.31
06-01-2021,ODIVELAS,946,68,585,"[480,960]",Muito Elevado,,,,946,Lisboa e Vale do Tejo,LISBOA,1116,2654.36,161774,9562,9038,6952,4641,3812,8453,15405,24443,34005,6095.48,1281.27,920.99,580.44
06-01-2021,OEIRAS,1013,72,571,"[480,960]",Muito Elevado,,,,1013,Lisboa e Vale do Tejo,LISBOA,1110,4588.31,177408,11580,11575,8566,6211,5855,12066,20632,32207,43787,3866.78,954.38,701.98,449.69
06-01-2021,OLEIROS,13,1,260,"[240,480]",Elevado,,,,13,Centro,CASTELO BRANCO,0506,47109.31,5003,384,341,366,397,487,884,1250,1591,1975,10.62,4.19,3.38,2.65
06-01-2021,OLHÃO,188,13,423,"[240,480]",Elevado,,,,188,Algarve,FARO,0810,13086.38,44405,2455,2309,1689,1342,1268,2610,4299,6608,9063,339.33,69.26,50.5,32.85
06-01-2021,OLIVEIRA DE AZEMÉIS,476,34,721,"[480,960]",Muito Elevado,,,,476,Norte,AVEIRO,0113,16110.41,66011,4155,3614,2794,2183,1738,3921,6715,10329,14484,409.75,89.91,64.12,41.68
06-01-2021,OLIVEIRA DE FRADES,68,5,684,"[480,960]",Muito Elevado,,,,68,Centro,VISEU,1810,14534.62,9936,553,475,438,359,415,774,1212,1687,2240,68.36,15.41,11.61,8.34
06-01-2021,OLIVEIRA DO BAIRRO,134,10,552,"[480,960]",Muito Elevado,,,,134,Centro,AVEIRO,0114,8731.99,24277,1327,1182,999,786,810,1596,2595,3777,5104,278.02,58.45,43.25,29.72
06-01-2021,OLIVEIRA DO HOSPITAL,212,15,1101,"[960,Max]",Extremamente Elevado,,,,212,Centro,COIMBRA,0611,23451.66,19253,1161,1097,962,924,960,1884,2846,3943,5104,82.1,21.76,16.81,12.14
06-01-2021,OURÉM,305,22,692,"[480,960]",Muito Elevado,,,,305,Lisboa e Vale do Tejo,SANTARÉM,1421,41668.03,44044,2463,2069,1899,1817,1603,3420,5319,7388,9851,105.7,23.64,17.73,12.77
06-01-2021,OURIQUE,29,2,629,"[480,960]",Muito Elevado,,,,29,Alentejo,BEJA,0212,66331.36,4607,313,287,284,268,227,495,779,1066,1379,6.95,2.08,1.61,1.17
06-01-2021,OVAR,455,33,839,"[480,960]",Muito Elevado,,,,455,Centro,AVEIRO,0115,14770.25,54260,3294,2709,1994,1636,1234,2870,4864,7573,10867,367.37,73.57,51.27,32.93
06-01-2021,PAÇOS DE FERREIRA,222,16,391,"[240,480]",Elevado,,,,222,Norte,PORTO,1309,7099.29,56728,2903,2193,1518,1135,664,1799,3317,5510,8413,799.1,118.51,77.62,46.72
06-01-2021,PALMELA,404,29,629,"[480,960]",Muito Elevado,,,,404,Lisboa e Vale do Tejo,SETÚBAL,1508,46512.01,64269,3402,3244,2635,1846,1391,3237,5872,9116,12518,138.18,26.91,19.6,12.62
06-01-2021,PAMPILHOSA DA SERRA,4,0,99,"[0,240]",Moderado,,,,4,Centro,COIMBRA,0612,39646.24,4037,238,254,295,339,423,762,1057,1311,1549,10.18,3.91,3.31,2.67
06-01-2021,PAREDES,402,29,467,"[240,480]",Elevado,,,,402,Norte,PORTO,1310,15675.69,86067,4272,3532,2412,1717,1258,2975,5387,8919,13191,549.04,84.15,56.9,34.36
06-01-2021,PAREDES DE COURA,32,2,375,"[240,480]",Elevado,,,,32,Norte,VIANA DO CASTELO,1605,13818.59,8535,466,528,407,465,515,980,1387,1915,2381,61.76,17.23,13.86,10.04
06-01-2021,PEDRÓGÃO GRANDE,32,2,938,"[480,960]",Muito Elevado,,,,32,Centro,LEIRIA,1013,12874.75,3410,175,173,196,221,252,473,669,842,1017,26.49,7.9,6.54,5.2
06-01-2021,PENACOVA,66,5,482,"[480,960]",Muito Elevado,,,,66,Centro,COIMBRA,0613,21673.23,13694,968,923,745,621,703,1324,2069,2992,3960,63.18,18.27,13.81,9.55
06-01-2021,PENAFIEL,304,22,436,"[240,480]",Elevado,,,,304,Norte,PORTO,1311,21224.27,69772,3648,2823,2032,1663,1230,2893,4925,7748,11396,328.74,53.69,36.51,23.2
06-01-2021,PENALVA DO CASTELO,58,4,815,"[480,960]",Muito Elevado,,,,58,Centro,VISEU,1811,13433.92,7115,449,457,413,391,426,817,1230,1687,2136,52.96,15.9,12.56,9.16
06-01-2021,PENAMACOR,64,5,1346,"[960,Max]",Extremamente Elevado,,,,64,Centro,CASTELO BRANCO,0507,56370.69,4755,262,248,273,451,633,1084,1357,1605,1867,8.44,3.31,2.85,2.41
06-01-2021,PENEDONO,10,1,386,"[240,480]",Elevado,,,,10,Norte,VISEU,1812,13370.75,2591,172,113,129,156,138,294,423,536,708,19.38,5.3,4.01,3.16
06-01-2021,PENELA,33,2,611,"[480,960]",Muito Elevado,,,,33,Centro,COIMBRA,0614,13480.0,5397,314,324,274,359,344,703,977,1301,1615,40.04,11.98,9.65,7.25
06-01-2021,PENICHE,181,13,683,"[480,960]",Muito Elevado,,,,181,Lisboa e Vale do Tejo,LEIRIA,1014,7754.98,26501,1746,1504,1203,926,707,1633,2836,4340,6086,341.73,78.48,55.96,36.57
06-01-2021,PESO DA RÉGUA,195,14,1236,"[960,Max]",Extremamente Elevado,,,,195,Norte,VILA REAL,1708,9486.01,15773,1076,843,650,659,455,1114,1764,2607,3683,166.28,38.83,27.48,18.6
06-01-2021,PINHEL,165,12,1939,"[960,Max]",Extremamente Elevado,,,,165,Centro,GUARDA,0910,48452.12,8511,577,566,551,538,689,1227,1778,2344,2921,17.57,6.03,4.84,3.67
06-01-2021,POMBAL,269,19,523,"[480,960]",Muito Elevado,,,,269,Centro,LEIRIA,1015,62600.28,51461,3187,2791,2494,2328,2027,4355,6849,9640,12827,82.21,20.49,15.4,10.94
06-01-2021,PONTA DELGADA,117,8,172,"[0,240]",Moderado,,,,117,Açores,AÇORES,4203,23298.65,67935,3108,2435,1726,1133,902,2035,3761,6196,9304,291.58,39.93,26.59,16.14
06-01-2021,PONTA DO SOL,14,1,163,"[0,240]",Moderado,,,,14,Madeira,MADEIRA,3105,4622.03,8593,319,283,347,208,221,429,776,1059,1378,185.92,29.81,22.91,16.79
06-01-2021,PONTE DA BARCA,115,8,1029,"[960,Max]",Extremamente Elevado,,,,115,Norte,VIANA DO CASTELO,1606,18211.37,11180,635,576,517,554,490,1044,1561,2137,2772,61.39,15.22,11.73,8.57
06-01-2021,PONTE DE LIMA,150,11,363,"[240,480]",Elevado,,,,150,Norte,VIANA DO CASTELO,1607,32025.46,41315,2321,2022,1720,1596,1462,3058,4778,6800,9121,129.01,28.48,21.23,14.92
06-01-2021,PONTE DE SOR,44,3,293,"[240,480]",Elevado,,,,44,Alentejo,PORTALEGRE,1213,83971.16,14994,939,800,716,739,831,1570,2286,3086,4025,17.86,4.79,3.68,2.72
06-01-2021,PORTALEGRE,84,6,379,"[240,480]",Elevado,,,,84,Alentejo,PORTALEGRE,1214,44713.64,22172,1577,1351,1137,993,984,1977,3114,4465,6042,49.59,13.51,9.99,6.96
06-01-2021,PORTEL,62,4,1064,"[960,Max]",Extremamente Elevado,,,,62,Alentejo,ÉVORA,0709,60100.57,5828,336,358,283,331,305,636,919,1277,1613,9.7,2.68,2.12,1.53
06-01-2021,PORTIMÃO,139,10,251,"[240,480]",Elevado,,,,139,Algarve,FARO,0811,18206.29,55483,3182,2927,2116,1582,1400,2982,5098,8025,11207,304.75,61.56,44.08,28.0
06-01-2021,PORTO,1250,89,577,"[480,960]",Muito Elevado,,,,1250,Norte,PORTO,1312,4142.02,216606,15790,15193,11280,9409,10044,19453,30733,45926,61716,5229.5,1490.0,1108.79,741.98
06-01-2021,PORTO DE MÓS,178,13,765,"[480,960]",Muito Elevado,,,,178,Centro,LEIRIA,1016,26183.41,23275,1355,1210,1034,888,872,1760,2794,4004,5359,88.89,20.47,15.29,10.67
06-01-2021,PORTO MONIZ,4,0,171,"[0,240]",Moderado,,,,4,Madeira,MADEIRA,3106,8293.38,2342,143,130,95,98,120,218,313,443,586,28.24,7.07,5.34,3.77
06-01-2021,PORTO SANTO,0,0,0,"[0,240]",Moderado,,,,0,Madeira,MADEIRA,3201,4300.7,5202,240,157,134,110,68,178,312,469,709,120.95,16.48,10.9,7.25
06-01-2021,PÓVOA DE LANHOSO,215,15,1000,"[960,Max]",Extremamente Elevado,,,,215,Norte,BRAGA,0309,13465.29,21499,1175,909,732,673,624,1297,2029,2938,4113,159.67,30.55,21.82,15.07
06-01-2021,PÓVOA DE VARZIM,655,47,1043,"[960,Max]",Extremamente Elevado,,,,655,Norte,PORTO,1313,8220.59,62784,3712,3120,2134,1594,1305,2899,5033,8153,11865,763.7,144.33,99.17,61.22
06-01-2021,POVOAÇÃO,2,0,34,"[0,240]",Moderado,,,,2,Açores,AÇORES,4204,10640.77,5927,293,212,191,144,134,278,469,681,974,55.7,9.15,6.4,4.41
06-01-2021,VILA DA PRAIA DA VITÓRIA,14,1,66,"[0,240]",Moderado,,,,14,Açores,AÇORES,4302,16127.06,21317,1133,789,619,436,336,772,1391,2180,3313,132.18,20.54,13.52,8.63
06-01-2021,PROENÇA-A-NOVA,6,0,82,"[0,240]",Moderado,,,,6,Centro,CASTELO BRANCO,0508,39539.96,7298,508,465,389,400,560,960,1349,1814,2322,18.46,5.87,4.59,3.41
06-01-2021,REDONDO,35,3,551,"[480,960]",Muito Elevado,,,,35,Alentejo,ÉVORA,0710,36950.87,6353,349,325,288,288,354,642,930,1255,1604,17.19,4.34,3.4,2.52
06-01-2021,REGUENGOS DE MONSARAZ,67,5,669,"[480,960]",Muito Elevado,,,,67,Alentejo,ÉVORA,0711,46399.72,10015,602,511,455,462,473,935,1390,1901,2503,21.58,5.39,4.1,3.0
06-01-2021,RESENDE,20,1,197,"[0,240]",Moderado,,,,20,Norte,VISEU,1813,12334.93,10137,560,493,448,433,422,855,1303,1796,2356,82.18,19.1,14.56,10.56
06-01-2021,RIBEIRA BRAVA,58,4,466,"[240,480]",Elevado,,,,58,Madeira,MADEIRA,3107,6544.88,12435,648,500,411,311,287,598,1009,1509,2157,189.99,32.96,23.06,15.42
06-01-2021,RIBEIRA DE PENA,57,4,947,"[480,960]",Muito Elevado,,,,57,Norte,VILA REAL,1709,21745.98,6016,371,301,290,310,368,678,968,1269,1640,27.66,7.54,5.84,4.45
06-01-2021,RIBEIRA GRANDE,135,10,411,"[240,480]",Elevado,,,,135,Açores,AÇORES,4205,18015.13,32811,1163,689,512,345,253,598,1110,1799,2962,182.13,16.44,9.99,6.16
06-01-2021,RIO MAIOR,178,13,873,"[480,960]",Muito Elevado,,,,178,Lisboa e Vale do Tejo,SANTARÉM,1414,27276.45,20379,1251,1144,941,795,648,1443,2384,3528,4779,74.71,17.52,12.93,8.74
06-01-2021,SABROSA,28,2,473,"[240,480]",Elevado,,,,28,Norte,VILA REAL,1710,15692.45,5918,393,314,304,302,350,652,956,1270,1663,37.71,10.6,8.09,6.09
06-01-2021,SABUGAL,48,3,453,"[240,480]",Elevado,,,,48,Centro,GUARDA,0911,82269.82,10585,724,707,694,796,1009,1805,2499,3206,3930,12.87,4.78,3.9,3.04
06-01-2021,SALVATERRA DE MAGOS,81,6,380,"[240,480]",Elevado,,,,81,Lisboa e Vale do Tejo,SANTARÉM,1415,24393.2,21295,1275,1181,1060,799,772,1571,2631,3812,5087,87.3,20.85,15.63,10.79
06-01-2021,SANTA COMBA DÃO,51,4,488,"[480,960]",Muito Elevado,,,,51,Centro,VISEU,1814,11194.77,10452,732,684,569,538,464,1002,1571,2255,2987,93.36,26.68,20.14,14.03
06-01-2021,SANTA CRUZ,82,6,181,"[0,240]",Moderado,,,,82,Madeira,MADEIRA,3108,8150.28,45281,1817,1301,974,716,523,1239,2213,3514,5331,555.6,65.41,43.12,27.15
06-01-2021,SANTA CRUZ DA GRACIOSA,0,0,0,"[0,240]",Moderado,,,,0,Açores,AÇORES,4401,6065.78,4208,228,180,163,124,145,269,432,612,840,69.37,13.85,10.09,7.12
06-01-2021,SANTA CRUZ DAS FLORES,0,0,0,"[0,240]",Moderado,,,,0,Açores,AÇORES,4802,7091.44,2165,125,98,74,56,51,107,181,279,404,30.53,5.7,3.93,2.55
06-01-2021,SANTA MARIA DA FEIRA,1095,78,790,"[480,960]",Muito Elevado,,,,1095,Norte,AVEIRO,0109,21587.65,138636,8182,6743,4771,3856,3079,6935,11706,18449,26631,642.19,123.36,85.46,54.22
06-01-2021,SANTA MARTA DE PENAGUIÃO,46,3,697,"[480,960]",Muito Elevado,,,,46,Norte,VILA REAL,1711,6928.13,6599,483,373,337,316,317,633,970,1343,1826,95.25,26.36,19.39,14.0
06-01-2021,SANTANA,14,1,209,"[0,240]",Moderado,,,,14,Madeira,MADEIRA,3109,9547.3,6711,418,353,343,282,277,559,902,1255,1673,70.29,17.52,13.15,9.45
06-01-2021,SANTARÉM,331,24,576,"[480,960]",Muito Elevado,,,,331,Lisboa e Vale do Tejo,SANTARÉM,1416,55253.58,57421,3654,3441,2760,2466,2206,4672,7432,10873,14527,103.92,26.29,19.68,13.45
06-01-2021,SANTIAGO DO CACÉM,52,4,181,"[0,240]",Moderado,,,,52,Alentejo,SETÚBAL,1509,105969.29,28791,2144,1689,1472,1295,1215,2510,3982,5671,7815,27.17,7.37,5.35,3.76
06-01-2021,SANTO TIRSO,564,40,829,"[480,960]",Muito Elevado,,,,564,Norte,PORTO,1314,13655.52,68055,4911,3935,2761,2257,1810,4067,6828,10763,15674,498.35,114.78,78.82,50.0
06-01-2021,SÃO BRÁS DE ALPORTEL,44,3,422,"[240,480]",Elevado,,,,44,Algarve,FARO,0812,15336.92,10416,596,468,467,404,401,805,1272,1740,2336,67.91,15.23,11.35,8.29
06-01-2021,SÃO JOÃO DA MADEIRA,133,10,606,"[480,960]",Muito Elevado,,,,133,Norte,AVEIRO,0116,794.3,21958,1347,1069,796,601,593,1194,1990,3059,4406,2765.49,554.91,385.26,250.63
06-01-2021,SÃO JOÃO DA PESQUEIRA,78,6,1095,"[960,Max]",Extremamente Elevado,,,,78,Norte,VISEU,1815,26610.85,7125,417,330,294,328,328,656,950,1280,1697,26.77,6.38,4.81,3.57
06-01-2021,SÃO PEDRO DO SUL,66,5,428,"[240,480]",Elevado,,,,66,Centro,VISEU,1816,34895.09,15403,990,962,861,759,909,1668,2529,3491,4481,44.14,12.84,10.0,7.25
06-01-2021,SÃO ROQUE DO PICO,0,0,0,"[0,240]",Moderado,,,,0,Açores,AÇORES,4603,14236.1,3266,199,141,93,96,113,209,302,443,642,22.94,4.51,3.11,2.12
06-01-2021,SÃO VICENTE,8,1,156,"[0,240]",Moderado,,,,8,Madeira,MADEIRA,3110,7883.71,5143,272,264,266,225,280,505,771,1035,1307,65.23,16.58,13.13,9.78
06-01-2021,SARDOAL,6,0,160,"[0,240]",Moderado,,,,6,Lisboa e Vale do Tejo,SANTARÉM,1417,9214.72,3741,227,178,148,165,248,413,561,739,966,40.6,10.48,8.02,6.09
06-01-2021,SÁTÃO,62,4,535,"[480,960]",Muito Elevado,,,,62,Centro,VISEU,1817,20194.11,11580,765,671,515,465,476,941,1456,2127,2892,57.34,14.32,10.53,7.21
06-01-2021,SEIA,85,6,382,"[240,480]",Elevado,,,,85,Centro,GUARDA,0912,43568.83,22234,1807,1589,1238,1122,721,1843,3081,4670,6477,51.03,14.87,10.72,7.07
06-01-2021,SEIXAL,980,70,584,"[480,960]",Muito Elevado,,,,980,Lisboa e Vale do Tejo,SETÚBAL,1510,9545.17,167752,10586,9270,6661,4391,2930,7321,13982,23252,33838,1757.49,354.51,243.6,146.49
06-01-2021,SERNANCELHE,12,1,222,"[0,240]",Moderado,,,,12,Norte,VISEU,1818,22861.22,5396,305,293,286,273,260,533,819,1112,1417,23.6,6.2,4.86,3.58
06-01-2021,SERPA,42,3,294,"[240,480]",Elevado,,,,42,Alentejo,BEJA,0213,110563.34,14304,903,761,719,697,626,1323,2042,2803,3706,12.94,3.35,2.54,1.85
06-01-2021,SERTÃ,119,8,816,"[480,960]",Muito Elevado,,,,119,Centro,CASTELO BRANCO,0509,44673.17,14577,870,779,790,767,1020,1787,2577,3356,4226,32.63,9.46,7.51,5.77
06-01-2021,SESIMBRA,265,19,511,"[480,960]",Muito Elevado,,,,265,Lisboa e Vale do Tejo,SETÚBAL,1511,19571.75,51858,2400,2321,1853,1257,1083,2340,4193,6514,8914,264.96,45.54,33.28,21.42
06-01-2021,SETÚBAL,892,64,775,"[480,960]",Muito Elevado,,,,892,Lisboa e Vale do Tejo,SETÚBAL,1512,23032.5,115126,7425,6929,5075,3775,2655,6430,11505,18434,25859,499.83,112.27,80.03,49.95
06-01-2021,SEVER DO VOUGA,91,6,803,"[480,960]",Muito Elevado,,,,91,Centro,AVEIRO,0117,12987.56,11331,766,637,568,540,567,1107,1675,2312,3078,87.24,23.7,17.8,12.9
06-01-2021,SILVES,153,11,422,"[240,480]",Elevado,,,,153,Algarve,FARO,0813,68006.23,36226,2137,1869,1610,1423,1600,3023,4633,6502,8639,53.27,12.7,9.56,6.81
06-01-2021,SINES,22,2,160,"[0,240]",Moderado,,,,22,Alentejo,SETÚBAL,1513,20330.17,13715,888,791,551,416,268,684,1235,2026,2914,67.46,14.33,9.97,6.07
06-01-2021,SINTRA,1851,132,473,"[240,480]",Elevado,,,,1851,Lisboa e Vale do Tejo,LISBOA,1111,31922.73,391402,20490,18316,13545,9137,7284,16421,29966,48282,68772,1226.08,215.43,151.25,93.87
06-01-2021,SOBRAL DE MONTE AGRAÇO,100,7,939,"[480,960]",Muito Elevado,,,,100,Lisboa e Vale do Tejo,LISBOA,1112,5210.32,10651,564,507,352,272,212,484,836,1343,1907,204.43,36.6,25.78,16.05
06-01-2021,SOURE,107,8,625,"[480,960]",Muito Elevado,,,,107,Centro,COIMBRA,0615,26506.07,17120,1173,1142,1004,883,987,1870,2874,4016,5189,64.59,19.58,15.15,10.84
06-01-2021,SOUSEL,35,2,793,"[480,960]",Muito Elevado,,,,35,Alentejo,PORTALEGRE,1215,27932.18,4412,261,274,208,302,292,594,802,1076,1337,15.8,4.79,3.85,2.87
06-01-2021,TÁBUA,135,10,1188,"[960,Max]",Extremamente Elevado,,,,135,Centro,COIMBRA,0616,19978.58,11368,729,584,524,430,464,894,1418,2002,2731,56.9,13.67,10.02,7.1
06-01-2021,TABUAÇO,87,6,1442,"[960,Max]",Extremamente Elevado,,,,87,Norte,VISEU,1819,13385.67,6033,372,314,217,282,363,645,862,1176,1548,45.07,11.56,8.79,6.44
06-01-2021,TAROUCA,54,4,692,"[480,960]",Muito Elevado,,,,54,Norte,VISEU,1820,10008.49,7804,405,335,313,277,324,601,914,1249,1654,77.98,16.53,12.48,9.13
06-01-2021,TAVIRA,392,28,1598,"[960,Max]",Extremamente Elevado,,,,392,Algarve,FARO,0814,60696.7,24530,1493,1415,1252,1066,1277,2343,3595,5010,6503,40.41,10.71,8.25,5.92
06-01-2021,TERRAS DE BOURO,54,4,849,"[480,960]",Muito Elevado,,,,54,Norte,BRAGA,0310,27746.07,6361,391,372,296,319,340,659,955,1327,1718,22.93,6.19,4.78,3.44
06-01-2021,TOMAR,238,17,648,"[480,960]",Muito Elevado,,,,238,Lisboa e Vale do Tejo,SANTARÉM,1418,35120.44,36748,2403,2189,1868,1853,1822,3675,5543,7732,10135,104.64,28.86,22.02,15.78
06-01-2021,TONDELA,136,10,516,"[480,960]",Muito Elevado,,,,136,Centro,VISEU,1821,37121.73,26357,1768,1722,1518,1475,1417,2892,4410,6132,7900,71.0,21.28,16.52,11.88
06-01-2021,TORRE DE MONCORVO,12,1,156,"[0,240]",Moderado,,,,12,Norte,BRAGANÇA,0409,53155.67,7695,556,478,488,551,719,1270,1758,2236,2792,14.48,5.25,4.21,3.31
06-01-2021,TORRES NOVAS,338,24,968,"[960,Max]",Extremamente Elevado,,,,338,Lisboa e Vale do Tejo,SANTARÉM,1419,26999.68,34933,2324,1979,1738,1406,1475,2881,4619,6598,8922,129.38,33.04,24.44,17.11
06-01-2021,TORRES VEDRAS,429,31,546,"[480,960]",Muito Elevado,,,,429,Lisboa e Vale do Tejo,LISBOA,1113,40714.89,78530,4513,3945,3447,2628,2104,4732,8179,12124,16637,192.88,40.86,29.78,20.09
06-01-2021,TRANCOSO,91,6,1025,"[960,Max]",Extremamente Elevado,,,,91,Centro,GUARDA,0913,36152.47,8875,581,557,542,586,496,1082,1624,2181,2762,24.55,7.64,6.03,4.49
06-01-2021,TROFA,235,17,612,"[480,960]",Muito Elevado,,,,235,Norte,PORTO,1318,7201.76,38418,2336,1894,1231,939,684,1623,2854,4748,7084,533.44,98.36,65.93,39.63
06-01-2021,VAGOS,94,7,413,"[240,480]",Elevado,,,,94,Centro,AVEIRO,0118,16491.5,22740,1320,1205,922,784,724,1508,2430,3635,4955,137.89,30.04,22.04,14.73
06-01-2021,VALE DE CAMBRA,95,7,445,"[240,480]",Elevado,,,,95,Norte,AVEIRO,0119,14733.47,21327,1491,1363,1005,831,798,1629,2634,3997,5488,144.76,37.25,27.13,17.88
06-01-2021,VALENÇA,50,4,376,"[240,480]",Elevado,,,,50,Norte,VIANA DO CASTELO,1608,11712.86,13290,867,791,582,582,503,1085,1667,2458,3325,113.46,28.39,20.99,14.23
06-01-2021,VALONGO,589,42,604,"[480,960]",Muito Elevado,,,,589,Norte,PORTO,1315,7512.45,97444,5629,4696,3207,2462,1829,4291,7498,12194,17823,1297.18,237.26,162.33,99.81
06-01-2021,VALPAÇOS,68,5,459,"[240,480]",Elevado,,,,68,Norte,VILA REAL,1712,54873.93,14818,1217,1118,999,928,997,1925,2924,4042,5259,27.0,9.58,7.37,5.33
06-01-2021,VELAS,4,0,79,"[0,240]",Moderado,,,,4,Açores,AÇORES,4502,11738.38,5093,278,208,166,153,113,266,432,640,918,43.39,7.82,5.45,3.68
06-01-2021,VENDAS NOVAS,136,10,1208,"[960,Max]",Extremamente Elevado,,,,136,Alentejo,ÉVORA,0712,22238.88,11255,677,768,655,501,532,1033,1688,2456,3133,50.61,14.09,11.04,7.59
06-01-2021,VIANA DO ALENTEJO,72,5,1399,"[960,Max]",Extremamente Elevado,,,,72,Alentejo,ÉVORA,0713,39367.29,5145,245,208,235,210,214,424,659,867,1112,13.07,2.82,2.2,1.67
06-01-2021,VIANA DO CASTELO,419,30,496,"[480,960]",Muito Elevado,,,,419,Norte,VIANA DO CASTELO,1609,31902.01,84417,5470,4433,3591,3061,2982,6043,9634,14067,19537,264.61,61.24,44.09,30.2
06-01-2021,VIDIGUEIRA,70,5,1270,"[960,Max]",Extremamente Elevado,,,,70,Alentejo,BEJA,0214,31661.09,5510,300,248,215,233,275,508,723,971,1271,17.4,4.01,3.07,2.28
06-01-2021,VIEIRA DO MINHO,98,7,828,"[480,960]",Muito Elevado,,,,98,Norte,BRAGA,0311,21644.35,11842,703,594,525,548,482,1030,1555,2149,2852,54.71,13.18,9.93,7.18
06-01-2021,VILA DE REI,7,1,211,"[0,240]",Moderado,,,,7,Centro,CASTELO BRANCO,0510,19154.6,3323,169,128,172,247,302,549,721,849,1018,17.35,5.31,4.43,3.76
06-01-2021,VILA DO BISPO,10,1,194,"[0,240]",Moderado,,,,10,Algarve,FARO,0815,17906.06,5154,302,302,314,232,233,465,779,1081,1383,28.78,7.72,6.04,4.35
06-01-2021,VILA DO CONDE,853,61,1068,"[960,Max]",Extremamente Elevado,,,,853,Norte,PORTO,1316,14902.77,79899,4726,3875,2819,2070,1743,3813,6632,10507,15233,536.13,102.21,70.5,44.5
06-01-2021,VILA DO PORTO,4,0,71,"[0,240]",Moderado,,,,4,Açores,AÇORES,4101,9688.74,5616,274,212,135,96,123,219,354,566,840,57.96,8.67,5.84,3.65
06-01-2021,VILA FLOR,42,3,695,"[480,960]",Muito Elevado,,,,42,Norte,BRAGANÇA,0410,26581.14,6044,429,362,422,294,331,625,1047,1409,1838,22.74,6.91,5.3,3.94
06-01-2021,VILA FRANCA DE XIRA,775,55,546,"[480,960]",Muito Elevado,,,,775,Lisboa e Vale do Tejo,LISBOA,1114,31819.39,141957,8501,6852,4869,3425,2472,5897,10766,17618,26119,446.14,82.09,55.37,33.84
06-01-2021,VILA FRANCA DO CAMPO,141,10,1276,"[960,Max]",Extremamente Elevado,,,,141,Açores,AÇORES,4206,7796.82,11051,450,344,248,217,154,371,619,963,1413,141.73,18.12,12.35,7.94
06-01-2021,VILA NOVA DA BARQUINHA,39,3,523,"[480,960]",Muito Elevado,,,,39,Lisboa e Vale do Tejo,SANTARÉM,1420,4952.97,7461,415,406,392,364,338,702,1094,1500,1915,150.64,38.66,30.28,22.09
06-01-2021,VILA NOVA DE CERVEIRA,36,3,404,"[240,480]",Elevado,,,,36,Norte,VIANA DO CASTELO,1610,10846.66,8910,531,444,410,384,334,718,1128,1572,2103,82.14,19.39,14.49,10.4
06-01-2021,VILA NOVA DE FAMALICÃO,1065,76,809,"[480,960]",Muito Elevado,,,,1065,Norte,BRAGA,0312,20159.26,131676,7817,6164,4202,3282,2749,6031,10233,16397,24214,653.19,120.12,81.34,50.76
06-01-2021,VILA NOVA DE FOZ CÔA,18,1,277,"[240,480]",Elevado,,,,18,Centro,GUARDA,0914,39815.18,6503,442,385,390,398,429,827,1217,1602,2044,16.33,5.13,4.02,3.06
06-01-2021,VILA NOVA DE GAIA,1571,112,523,"[480,960]",Muito Elevado,,,,1571,Norte,PORTO,1317,16846.43,300472,18349,15568,10972,8224,6281,14505,25477,41045,59394,1783.64,352.57,243.65,151.23
06-01-2021,VILA NOVA DE PAIVA,80,6,1707,"[960,Max]",Extremamente Elevado,,,,80,Centro,VISEU,1822,17553.28,4687,289,272,233,217,241,458,691,963,1252,26.7,7.13,5.49,3.94
06-01-2021,VILA NOVA DE POIARES,124,9,1787,"[960,Max]",Extremamente Elevado,,,,124,Centro,COIMBRA,0617,8445.3,6939,380,284,262,235,182,417,679,963,1343,82.17,15.9,11.4,8.04
06-01-2021,VILA POUCA DE AGUIAR,66,5,552,"[480,960]",Muito Elevado,,,,66,Norte,VILA REAL,1713,43706.62,11961,860,817,733,601,627,1228,1961,2778,3638,27.37,8.32,6.36,4.49
06-01-2021,VILA REAL,379,27,759,"[480,960]",Muito Elevado,,,,379,Norte,VILA REAL,1714,37880.28,49962,3025,2498,2065,1579,1466,3045,5110,7608,10633,131.9,28.07,20.08,13.49
06-01-2021,VILA REAL DE SANTO ANTÓNIO,100,7,533,"[480,960]",Muito Elevado,,,,100,Algarve,FARO,0816,6125.0,18749,1172,1069,811,569,586,1155,1966,3035,4207,306.11,68.69,49.55,32.1
06-01-2021,VILA VELHA DE RÓDÃO,12,1,382,"[240,480]",Elevado,,,,12,Centro,CASTELO BRANCO,0511,32991.16,3144,209,229,180,283,306,589,769,998,1207,9.53,3.66,3.03,2.33
06-01-2021,VILA VERDE,468,33,998,"[960,Max]",Extremamente Elevado,,,,468,Norte,BRAGA,0313,22866.52,46911,2365,2063,1667,1494,1437,2931,4598,6661,9026,205.15,39.47,29.13,20.11
06-01-2021,VILA VIÇOSA,24,2,313,"[240,480]",Elevado,,,,24,Alentejo,ÉVORA,0714,19485.89,7656,487,379,342,345,324,669,1011,1390,1877,39.29,9.63,7.13,5.19
06-01-2021,VIMIOSO,50,4,1243,"[960,Max]",Extremamente Elevado,,,,50,Norte,BRAGANÇA,0411,48158.51,4023,274,230,261,293,335,628,889,1119,1393,8.35,2.89,2.32,1.85
06-01-2021,VINHAIS,32,2,413,"[240,480]",Elevado,,,,32,Norte,BRAGANÇA,0412,69475.09,7746,599,577,636,641,815,1456,2092,2669,3268,11.15,4.7,3.84,3.01
06-01-2021,VISEU,746,53,767,"[480,960]",Muito Elevado,,,,746,Centro,VISEU,1823,50710.14,97249,5769,5038,4140,3158,2710,5868,10008,15046,20815,191.77,41.05,29.67,19.74
06-01-2021,VIZELA,121,9,506,"[480,960]",Muito Elevado,,,,121,Norte,BRAGA,0314,2469.83,23897,1258,928,655,509,371,880,1535,2463,3721,967.49,150.65,99.72,62.15
06-01-2021,VOUZELA,71,5,738,"[480,960]",Muito Elevado,,,,71,Centro,VISEU,1824,19369.46,9619,626,605,554,532,507,1039,1593,2198,2824,49.66,14.58,11.35,8.22
13-01-2021,ABRANTES,219,16,623,"[480,960]",Muito Elevado,,,,219,Lisboa e Vale do Tejo,SANTARÉM,1401,71469.08,35130,2473,2213,1730,1748,2021,3769,5499,7712,10185,49.15,14.25,10.79,7.69
13-01-2021,ÁGUEDA,559,40,1213,"[960,Max]",Extremamente Elevado,,,,559,Centro,AVEIRO,0101,33527.44,46075,3237,2713,2090,1635,1496,3131,5221,7934,11171,137.43,33.32,23.66,15.57
13-01-2021,AGUIAR DA BEIRA,191,14,4106,"[960,Max]",Extremamente Elevado,,,,191,Centro,GUARDA,0901,20676.57,4652,304,281,235,239,148,387,622,903,1207,22.5,5.84,4.37,3.01
13-01-2021,ALANDROAL,61,4,1222,"[960,Max]",Extremamente Elevado,,,,61,Alentejo,ÉVORA,0701,54267.81,4992,307,256,296,299,377,676,972,1228,1535,9.2,2.83,2.26,1.79
13-01-2021,ALBERGARIA-A-VELHA,202,14,837,"[480,960]",Muito Elevado,,,,202,Centro,AVEIRO,0102,15882.5,24144,1550,1298,996,687,680,1367,2363,3661,5211,152.02,32.81,23.05,14.88
13-01-2021,ALBUFEIRA,458,33,1103,"[960,Max]",Extremamente Elevado,,,,458,Algarve,FARO,0801,14066.42,41528,2067,1717,1425,985,858,1843,3268,4985,7052,295.24,50.14,35.44,23.23
13-01-2021,ALCÁCER DO SAL,309,22,2650,"[960,Max]",Extremamente Elevado,,,,309,Alentejo,SETÚBAL,1501,149987.3,11659,884,814,623,623,602,1225,1848,2662,3546,7.77,2.36,1.77,1.23
13-01-2021,ALCANENA,128,9,999,"[960,Max]",Extremamente Elevado,,,,128,Lisboa e Vale do Tejo,SANTARÉM,1402,12732.86,12809,891,744,628,536,588,1124,1752,2496,3387,100.6,26.6,19.6,13.76
13-01-2021,ALCOBAÇA,619,44,1156,"[960,Max]",Extremamente Elevado,,,,619,Lisboa e Vale do Tejo,LEIRIA,1001,40814.09,53555,3420,2927,2466,2059,1676,3735,6201,9128,12548,131.22,30.74,22.36,15.19
13-01-2021,ALCOCHETE,243,17,1228,"[960,Max]",Extremamente Elevado,,,,243,Lisboa e Vale do Tejo,SETÚBAL,1502,12836.48,19787,857,834,691,476,447,923,1614,2448,3305,154.15,25.75,19.07,12.57
13-01-2021,ALCOUTIM,13,1,602,"[480,960]",Muito Elevado,,,,13,Algarve,FARO,0802,57536.33,2159,191,188,163,190,267,457,620,808,999,3.75,1.74,1.4,1.08
13-01-2021,ALENQUER,314,22,713,"[480,960]",Muito Elevado,,,,314,Lisboa e Vale do Tejo,LISBOA,1101,30421.92,44052,2298,2062,1629,1330,1155,2485,4114,6176,8474,144.8,27.85,20.3,13.52
13-01-2021,ALFÂNDEGA DA FÉ,32,2,703,"[480,960]",Muito Elevado,,,,32,Norte,BRAGANÇA,0401,32194.64,4550,325,277,301,274,325,599,900,1177,1502,14.13,4.67,3.66,2.8
13-01-2021,ALIJÓ,93,7,875,"[480,960]",Muito Elevado,,,,93,Norte,VILA REAL,1701,29759.89,10625,766,687,635,542,666,1208,1843,2530,3296,35.7,11.08,8.5,6.19
13-01-2021,ALJEZUR,11,1,197,"[0,240]",Moderado,,,,11,Algarve,FARO,0803,32349.95,5594,316,336,335,320,410,730,1065,1401,1717,17.29,5.31,4.33,3.29
13-01-2021,ALJUSTREL,57,4,691,"[480,960]",Muito Elevado,,,,57,Alentejo,BEJA,0201,45847.41,8247,635,521,443,347,358,705,1148,1669,2304,17.99,5.03,3.64,2.5
13-01-2021,ALMADA,1662,119,983,"[960,Max]",Extremamente Elevado,,,,1662,Lisboa e Vale do Tejo,SETÚBAL,1503,7000.89,169039,10469,9777,7876,6144,5111,11255,19131,28908,39377,2414.5,562.45,412.91,273.26
13-01-2021,ALMEIDA,42,3,720,"[480,960]",Muito Elevado,,,,42,Centro,GUARDA,0902,51798.46,5830,441,419,396,458,393,851,1247,1666,2107,11.26,4.07,3.22,2.41
13-01-2021,ALMEIRIM,257,18,1140,"[960,Max]",Extremamente Elevado,,,,257,Lisboa e Vale do Tejo,SANTARÉM,1403,22212.05,22546,1342,1353,1106,866,843,1709,2815,4168,5510,101.5,24.81,18.76,12.67
13-01-2021,ALMODÔVAR,98,7,1457,"[960,Max]",Extremamente Elevado,,,,98,Alentejo,BEJA,0202,77788.03,6725,414,443,396,373,328,701,1097,1540,1954,8.65,2.51,1.98,1.41
13-01-2021,ALPIARÇA,60,4,850,"[480,960]",Muito Elevado,,,,60,Lisboa e Vale do Tejo,SANTARÉM,1404,9536.33,7059,515,486,363,333,274,607,970,1456,1971,74.02,20.67,15.27,10.17
13-01-2021,ALTER DO CHÃO,123,9,3886,"[960,Max]",Extremamente Elevado,,,,123,Alentejo,PORTALEGRE,1201,36206.62,3165,201,163,136,208,187,395,531,694,895,8.74,2.47,1.92,1.47
13-01-2021,ALVAIÁZERE,72,5,1091,"[960,Max]",Extremamente Elevado,,,,72,Centro,LEIRIA,1002,16047.76,6597,419,389,346,406,539,945,1291,1680,2099,41.11,13.08,10.47,8.04
13-01-2021,ALVITO,36,3,1453,"[960,Max]",Extremamente Elevado,,,,36,Alentejo,BEJA,0203,26485.32,2477,145,110,105,111,89,200,305,415,560,9.35,2.11,1.57,1.15
13-01-2021,AMADORA,1734,124,942,"[480,960]",Muito Elevado,,,,1734,Lisboa e Vale do Tejo,LISBOA,1115,2378.47,184106,11186,10936,8780,6460,5890,12350,21130,32066,43252,7742.05,1818.84,1348.44,888.56
13-01-2021,AMARANTE,525,38,987,"[960,Max]",Extremamente Elevado,,,,525,Norte,PORTO,1301,30133.15,53193,3086,2413,1812,1643,1311,2954,4766,7179,10265,176.53,34.07,23.82,15.82
13-01-2021,AMARES,169,12,932,"[480,960]",Muito Elevado,,,,169,Norte,BRAGA,0301,8195.41,18129,1001,829,622,489,524,1013,1635,2464,3465,221.22,42.28,30.07,19.95
13-01-2021,ANADIA,375,27,1376,"[960,Max]",Extremamente Elevado,,,,375,Centro,AVEIRO,0103,21663.48,27258,1931,1698,1376,1208,1262,2470,3846,5544,7475,125.83,34.51,25.59,17.75
13-01-2021,ANGRA DO HEROÍSMO,31,2,92,"[0,240]",Moderado,,,,31,Açores,AÇORES,4301,23899.66,33807,2006,1473,1122,768,635,1403,2525,3998,6004,141.45,25.12,16.73,10.56
13-01-2021,ANSIÃO,191,14,1587,"[960,Max]",Extremamente Elevado,,,,191,Centro,LEIRIA,1003,17609.42,12039,727,709,646,694,530,1224,1870,2579,3306,68.37,18.77,14.65,10.62
13-01-2021,ARCOS DE VALDEVEZ,265,19,1266,"[960,Max]",Extremamente Elevado,,,,265,Norte,VIANA DO CASTELO,1601,44759.64,20926,1329,1338,1282,1343,1515,2858,4140,5478,6807,46.75,15.21,12.24,9.25
13-01-2021,ARGANIL,172,12,1562,"[960,Max]",Extremamente Elevado,,,,172,Centro,COIMBRA,0601,33283.93,11014,672,648,612,559,596,1155,1767,2415,3087,33.09,9.27,7.26,5.31
13-01-2021,ARMAMAR,60,4,1040,"[960,Max]",Extremamente Elevado,,,,60,Norte,VISEU,1801,11723.73,5769,357,305,309,285,310,595,904,1209,1566,49.21,13.36,10.31,7.71
13-01-2021,AROUCA,238,17,1149,"[960,Max]",Extremamente Elevado,,,,238,Norte,AVEIRO,0104,32910.52,20720,1306,1047,753,683,683,1366,2119,3166,4472,62.96,13.59,9.62,6.44
13-01-2021,ARRAIOLOS,121,9,1747,"[960,Max]",Extremamente Elevado,,,,121,Alentejo,ÉVORA,0702,68374.55,6928,435,384,283,367,480,847,1130,1514,1949,10.13,2.85,2.21,1.65
13-01-2021,ARRONCHES,9,1,319,"[240,480]",Elevado,,,,9,Alentejo,PORTALEGRE,1202,31464.72,2820,155,142,162,187,179,366,528,670,825,8.96,2.62,2.13,1.68
13-01-2021,ARRUDA DOS VINHOS,165,12,1071,"[960,Max]",Extremamente Elevado,,,,165,Lisboa e Vale do Tejo,LISBOA,1102,7795.93,15412,738,738,562,509,438,947,1509,2247,2985,197.69,38.29,28.82,19.36
13-01-2021,AVEIRO,616,44,782,"[480,960]",Muito Elevado,,,,616,Centro,AVEIRO,0105,19757.57,78734,4520,4004,3050,2250,2103,4353,7403,11407,15927,398.49,80.61,57.73,37.47
13-01-2021,AVIS,26,2,612,"[480,960]",Muito Elevado,,,,26,Alentejo,PORTALEGRE,1203,60596.51,4247,315,225,206,251,273,524,730,955,1270,7.01,2.1,1.58,1.2
13-01-2021,AZAMBUJA,145,10,638,"[480,960]",Muito Elevado,,,,145,Lisboa e Vale do Tejo,LISBOA,1103,26265.65,22716,1322,1171,1070,798,618,1416,2486,3657,4979,86.48,18.96,13.92,9.46
13-01-2021,BAIÃO,122,9,651,"[480,960]",Muito Elevado,,,,122,Norte,PORTO,1302,17452.83,18748,1070,862,714,686,725,1411,2125,2987,4057,107.42,23.25,17.11,12.18
13-01-2021,BARCELOS,1528,109,1315,"[960,Max]",Extremamente Elevado,,,,1528,Norte,BRAGA,0302,37890.14,116187,6721,5325,3619,2991,2562,5553,9172,14497,21218,306.64,56.0,38.26,24.21
13-01-2021,BARRANCOS,9,1,551,"[480,960]",Muito Elevado,,,,9,Alentejo,BEJA,0204,16841.73,1634,90,65,65,94,61,155,220,285,375,9.7,2.23,1.69,1.31
13-01-2021,BARREIRO,689,49,917,"[480,960]",Muito Elevado,,,,689,Lisboa e Vale do Tejo,SETÚBAL,1504,3639.07,75147,5194,5565,4459,3105,1767,4872,9331,14896,20090,2065.05,552.07,409.34,256.42
13-01-2021,BATALHA,130,9,814,"[480,960]",Muito Elevado,,,,130,Centro,LEIRIA,1004,10341.6,15963,873,762,649,529,549,1078,1727,2489,3362,154.35,32.51,24.07,16.7
13-01-2021,BEJA,509,36,1516,"[960,Max]",Extremamente Elevado,,,,509,Alentejo,BEJA,0205,114647.55,33579,2005,1840,1386,1272,1039,2311,3697,5537,7542,29.29,6.58,4.83,3.22
13-01-2021,BELMONTE,63,5,985,"[960,Max]",Extremamente Elevado,,,,63,Centro,CASTELO BRANCO,0501,11875.91,6398,444,321,325,310,355,665,990,1311,1755,53.87,14.78,11.04,8.34
13-01-2021,BENAVENTE,355,25,1160,"[960,Max]",Extremamente Elevado,,,,355,Lisboa e Vale do Tejo,SANTARÉM,1405,52138.39,30602,1468,1376,1141,876,643,1519,2660,4036,5504,58.69,10.56,7.74,5.1
13-01-2021,BOMBARRAL,62,4,494,"[480,960]",Muito Elevado,,,,62,Lisboa e Vale do Tejo,LEIRIA,1005,9128.55,12558,875,714,561,491,429,920,1481,2195,3070,137.56,33.63,24.04,16.22
13-01-2021,BORBA,224,16,3325,"[960,Max]",Extremamente Elevado,,,,224,Alentejo,ÉVORA,0703,14518.65,6736,430,375,279,436,392,828,1107,1482,1912,46.39,13.17,10.21,7.62
13-01-2021,BOTICAS,105,8,2101,"[960,Max]",Extremamente Elevado,,,,105,Norte,VILA REAL,1702,32195.66,4998,347,306,311,305,380,685,996,1302,1649,15.52,5.12,4.04,3.09
13-01-2021,BRAGA,1905,136,1043,"[960,Max]",Extremamente Elevado,,,,1905,Norte,BRAGA,0303,18339.95,182679,10029,7963,5241,4320,3671,7991,13232,21195,31224,996.07,170.25,115.57,72.15
13-01-2021,BRAGANÇA,405,29,1205,"[960,Max]",Extremamente Elevado,,,,405,Norte,BRAGANÇA,0402,117357.27,33607,2402,1855,1652,1393,1163,2556,4208,6063,8465,28.64,7.21,5.17,3.59
13-01-2021,CABECEIRAS DE BASTO,140,10,896,"[480,960]",Muito Elevado,,,,140,Norte,BRAGA,0304,24182.16,15628,774,594,544,575,574,1149,1693,2287,3061,64.63,12.66,9.46,7.0
13-01-2021,CADAVAL,76,5,556,"[480,960]",Muito Elevado,,,,76,Lisboa e Vale do Tejo,LISBOA,1104,17489.3,13673,813,796,756,621,625,1246,2002,2798,3611,78.18,20.65,16.0,11.45
13-01-2021,CALDAS DA RAINHA,409,29,788,"[480,960]",Muito Elevado,,,,409,Lisboa e Vale do Tejo,LEIRIA,1006,25569.47,51912,3035,2684,2186,1899,1705,3604,5790,8474,11509,203.03,45.01,33.14,22.64
13-01-2021,CALHETA,19,1,175,"[0,240]",Moderado,,,,19,Madeira,MADEIRA,3101,11150.43,10867,576,497,507,399,415,814,1321,1818,2394,97.46,21.47,16.3,11.85
13-01-2021,CALHETA (AÇORES),2,0,63,"[0,240]",Moderado,,,,2,Açores,AÇORES,4501,12626.4,3184,215,159,141,139,122,261,402,561,776,25.22,6.15,4.44,3.18
13-01-2021,CÂMARA DE LOBOS,192,14,570,"[480,960]",Muito Elevado,,,,192,Madeira,MADEIRA,3102,5216.67,33675,1396,1059,834,545,381,926,1760,2819,4215,645.49,80.79,54.03,33.74
13-01-2021,CAMINHA,255,18,1606,"[960,Max]",Extremamente Elevado,,,,255,Norte,VIANA DO CASTELO,1602,13652.14,15877,1046,944,818,646,656,1302,2120,3064,4110,116.3,30.11,22.44,15.53
13-01-2021,CAMPO MAIOR,91,7,1156,"[960,Max]",Extremamente Elevado,,,,91,Alentejo,PORTALEGRE,1204,24720.16,7874,471,364,351,279,327,606,957,1321,1792,31.85,7.25,5.34,3.87
13-01-2021,CANTANHEDE,407,29,1162,"[960,Max]",Extremamente Elevado,,,,407,Centro,COIMBRA,0602,39088.02,35011,2346,2096,1880,1709,1451,3160,5040,7136,9482,89.57,24.26,18.26,12.89
13-01-2021,CARRAZEDA DE ANSIÃES,7,1,124,"[0,240]",Moderado,,,,7,Norte,BRAGANÇA,0403,27924.09,5666,424,389,391,312,465,777,1168,1557,1981,20.29,7.09,5.58,4.18
13-01-2021,CARREGAL DO SAL,120,9,1294,"[960,Max]",Extremamente Elevado,,,,120,Centro,VISEU,1802,11689.21,9271,587,562,486,462,376,838,1324,1886,2473,79.31,21.16,16.13,11.33
13-01-2021,CARTAXO,112,8,470,"[240,480]",Elevado,,,,112,Lisboa e Vale do Tejo,SANTARÉM,1406,15817.28,23843,1415,1376,1142,861,632,1493,2635,4011,5426,150.74,34.3,25.36,16.66
13-01-2021,CASCAIS,1754,125,821,"[480,960]",Muito Elevado,,,,1754,Lisboa e Vale do Tejo,LISBOA,1105,9740.17,213608,12151,11444,8680,6469,5248,11717,20397,31841,43992,2193.1,451.66,326.91,209.41
13-01-2021,CASTANHEIRA DE PÊRA,6,0,230,"[0,240]",Moderado,,,,6,Centro,LEIRIA,1007,6677.45,2614,233,195,157,190,187,377,534,729,962,39.15,14.41,10.92,8.0
13-01-2021,CASTELO BRANCO,485,35,933,"[480,960]",Muito Elevado,,,,485,Centro,CASTELO BRANCO,0502,143819.15,51987,3528,3042,2499,2229,2225,4454,6953,9995,13523,36.15,9.4,6.95,4.83
13-01-2021,CASTELO DE PAIVA,93,7,602,"[480,960]",Muito Elevado,,,,93,Norte,AVEIRO,0106,11500.53,15454,881,697,545,420,431,851,1396,2093,2974,134.37,25.86,18.2,12.14
13-01-2021,CASTELO DE VIDE,10,1,343,"[240,480]",Elevado,,,,10,Alentejo,PORTALEGRE,1205,26491.24,2919,204,173,179,147,170,317,496,669,873,11.02,3.3,2.53,1.87
13-01-2021,CASTRO DAIRE,193,14,1396,"[960,Max]",Extremamente Elevado,,,,193,Centro,VISEU,1803,37904.13,13823,942,857,765,732,773,1505,2270,3127,4069,36.47,10.74,8.25,5.99
13-01-2021,CASTRO MARIM,35,2,561,"[480,960]",Muito Elevado,,,,35,Algarve,FARO,0804,30084.37,6237,370,345,334,322,344,666,1000,1345,1715,20.73,5.7,4.47,3.32
13-01-2021,CASTRO VERDE,37,3,532,"[480,960]",Muito Elevado,,,,37,Alentejo,BEJA,0206,56944.23,6949,437,347,303,275,227,502,805,1152,1589,12.2,2.79,2.02,1.41
13-01-2021,CELORICO DA BEIRA,97,7,1400,"[960,Max]",Extremamente Elevado,,,,97,Centro,GUARDA,0903,24721.63,6928,430,416,363,369,535,904,1267,1683,2113,28.02,8.55,6.81,5.12
13-01-2021,CELORICO DE BASTO,206,15,1082,"[960,Max]",Extremamente Elevado,,,,206,Norte,BRAGA,0305,18107.02,19040,1001,802,668,728,729,1457,2125,2927,3928,105.15,21.69,16.17,11.74
13-01-2021,CHAMUSCA,57,4,620,"[480,960]",Muito Elevado,,,,57,Lisboa e Vale do Tejo,SANTARÉM,1407,74600.54,9197,629,583,553,465,579,1044,1597,2180,2809,12.33,3.77,2.92,2.14
13-01-2021,CHAVES,543,39,1380,"[960,Max]",Extremamente Elevado,,,,543,Norte,VILA REAL,1703,59122.95,39343,2676,2429,1991,1886,1918,3804,5795,8224,10900,66.54,18.44,13.91,9.8
13-01-2021,CINFÃES,119,8,652,"[480,960]",Muito Elevado,,,,119,Norte,VISEU,1804,23928.76,18244,1067,902,779,734,758,1492,2271,3173,4240,76.24,17.72,13.26,9.49
13-01-2021,COIMBRA,1391,99,1037,"[960,Max]",Extremamente Elevado,,,,1391,Centro,COIMBRA,0603,31939.94,134166,9489,8734,6353,5139,5074,10213,16566,25300,34789,420.06,108.92,79.21,51.87
13-01-2021,CONDEIXA-A-NOVA,176,13,992,"[960,Max]",Extremamente Elevado,,,,176,Centro,COIMBRA,0604,13867.47,17733,871,809,717,583,490,1073,1790,2599,3470,127.88,25.02,18.74,12.91
13-01-2021,CONSTÂNCIA,32,2,794,"[480,960]",Muito Elevado,,,,32,Lisboa e Vale do Tejo,SANTARÉM,1408,8036.58,4030,211,183,187,148,155,303,490,673,884,50.14,11.0,8.37,6.1
13-01-2021,CORUCHE,79,6,452,"[240,480]",Elevado,,,,79,Lisboa e Vale do Tejo,SANTARÉM,1409,111572.03,17471,1294,1090,1095,1096,1019,2115,3210,4300,5594,15.66,5.01,3.85,2.88
13-01-2021,CORVO,0,0,0,"[0,240]",Moderado,,,,0,Açores,AÇORES,4901,1711.45,464,22,21,11,13,19,32,43,64,86,27.12,5.03,3.74,2.51
13-01-2021,COVILHÃ,294,21,628,"[480,960]",Muito Elevado,,,,294,Centro,CASTELO BRANCO,0503,55560.06,46787,3533,2998,2365,2111,2193,4304,6669,9667,13200,84.21,23.76,17.4,12.0
13-01-2021,CRATO,47,3,1502,"[960,Max]",Extremamente Elevado,,,,47,Alentejo,PORTALEGRE,1206,39806.88,3129,229,258,163,182,228,410,573,831,1060,7.86,2.66,2.09,1.44
13-01-2021,CUBA,260,19,5658,"[960,Max]",Extremamente Elevado,,,,260,Alentejo,BEJA,0207,17208.72,4595,255,233,206,190,143,333,539,772,1027,26.7,5.97,4.49,3.13
13-01-2021,ELVAS,375,27,1827,"[960,Max]",Extremamente Elevado,,,,375,Alentejo,PORTALEGRE,1207,63128.86,20528,1057,1145,902,852,810,1662,2564,3709,4766,32.52,7.55,5.88,4.06
13-01-2021,ENTRONCAMENTO,224,16,1039,"[960,Max]",Extremamente Elevado,,,,224,Lisboa e Vale do Tejo,SANTARÉM,1410,1372.81,21558,1066,930,868,695,592,1287,2155,3085,4151,1570.14,302.33,224.69,156.96
13-01-2021,ESPINHO,179,13,606,"[480,960]",Muito Elevado,,,,179,Norte,AVEIRO,0107,2105.68,29516,2205,1993,1430,1177,960,2137,3567,5560,7765,1401.52,368.71,264.01,169.37
13-01-2021,ESPOSENDE,597,43,1747,"[960,Max]",Extremamente Elevado,,,,597,Norte,BRAGA,0306,9540.98,34177,1831,1522,1095,894,723,1617,2712,4234,6065,358.21,63.57,44.38,28.42
13-01-2021,ESTARREJA,313,22,1204,"[960,Max]",Extremamente Elevado,,,,313,Centro,AVEIRO,0108,10817.33,26006,1503,1399,1106,953,728,1681,2787,4186,5689,240.42,52.59,38.7,25.76
13-01-2021,ESTREMOZ,234,17,1838,"[960,Max]",Extremamente Elevado,,,,234,Alentejo,ÉVORA,0704,51379.95,12728,789,613,697,786,877,1663,2360,2973,3762,24.77,7.32,5.79,4.59
13-01-2021,ÉVORA,592,42,1129,"[960,Max]",Extremamente Elevado,,,,592,Alentejo,ÉVORA,0705,130707.58,52428,3569,2852,2176,1966,1803,3769,5945,8797,12366,40.11,9.46,6.73,4.55
13-01-2021,FAFE,443,32,922,"[480,960]",Muito Elevado,,,,443,Norte,BRAGA,0307,21908.11,48060,3044,2455,1679,1403,1208,2611,4290,6745,9789,219.37,44.68,30.79,19.58
13-01-2021,FARO,539,38,883,"[480,960]",Muito Elevado,,,,539,Algarve,FARO,0805,20256.79,61015,3847,3364,2604,2055,1601,3656,6260,9624,13471,301.2,66.5,47.51,30.9
13-01-2021,FELGUEIRAS,552,39,978,"[960,Max]",Extremamente Elevado,,,,552,Norte,PORTO,1303,11573.75,56422,2951,2302,1601,1316,973,2289,3890,6192,9143,487.49,79.0,53.5,33.61
13-01-2021,FERREIRA DO ALENTEJO,73,5,931,"[480,960]",Muito Elevado,,,,73,Alentejo,BEJA,0208,64820.68,7845,515,414,372,343,345,688,1060,1474,1989,12.1,3.07,2.27,1.64
13-01-2021,FERREIRA DO ZÊZERE,196,14,2463,"[960,Max]",Extremamente Elevado,,,,196,Lisboa e Vale do Tejo,SANTARÉM,1411,19038.03,7959,470,370,416,465,456,921,1337,1707,2177,41.81,11.44,8.97,7.02
13-01-2021,FIGUEIRA DA FOZ,380,27,647,"[480,960]",Muito Elevado,,,,380,Centro,COIMBRA,0605,37905.26,58747,4032,3597,2887,2495,2043,4538,7425,11022,15054,154.98,39.72,29.08,19.59
13-01-2021,FIGUEIRA DE CASTELO RODRIGO,235,17,4208,"[960,Max]",Extremamente Elevado,,,,235,Centro,GUARDA,0904,50857.46,5584,347,352,290,352,391,743,1033,1385,1732,10.98,3.41,2.72,2.03
13-01-2021,FIGUEIRÓ DOS VINHOS,123,9,2209,"[960,Max]",Extremamente Elevado,,,,123,Centro,LEIRIA,1008,17344.0,5568,402,386,322,309,351,660,982,1368,1770,32.1,10.21,7.89,5.66
13-01-2021,FORNOS DE ALGODRES,176,13,3887,"[960,Max]",Extremamente Elevado,,,,176,Centro,GUARDA,0905,13145.05,4528,261,218,247,256,232,488,735,953,1214,34.45,9.24,7.25,5.59
13-01-2021,FREIXO DE ESPADA À CINTA,7,0,212,"[0,240]",Moderado,,,,7,Norte,BRAGANÇA,0404,24414.29,3298,211,177,231,196,189,385,616,793,1004,13.51,4.11,3.25,2.52
13-01-2021,FRONTEIRA,25,2,841,"[480,960]",Muito Elevado,,,,25,Alentejo,PORTALEGRE,1208,24859.58,2974,213,182,149,156,168,324,473,655,868,11.96,3.49,2.63,1.9
13-01-2021,FUNCHAL,204,15,196,"[0,240]",Moderado,,,,204,Madeira,MADEIRA,3103,7616.2,104024,6382,5086,3643,2821,1990,4811,8454,13540,19922,1365.86,261.58,177.78,111.0
13-01-2021,FUNDÃO,344,25,1298,"[960,Max]",Extremamente Elevado,,,,344,Centro,CASTELO BRANCO,0504,70019.79,26495,1781,1464,1432,1357,1643,3000,4432,5896,7677,37.84,10.96,8.42,6.33
13-01-2021,GAVIÃO,39,3,1195,"[960,Max]",Extremamente Elevado,,,,39,Alentejo,PORTALEGRE,1209,29459.45,3263,189,186,222,263,293,556,778,964,1153,11.08,3.91,3.27,2.64
13-01-2021,GÓIS,87,6,2286,"[960,Max]",Extremamente Elevado,,,,87,Centro,COIMBRA,0606,26330.19,3805,235,199,240,233,244,477,717,916,1151,14.45,4.37,3.48,2.72
13-01-2021,GOLEGÃ,28,2,524,"[480,960]",Muito Elevado,,,,28,Lisboa e Vale do Tejo,SANTARÉM,1412,8431.67,5339,356,299,281,243,255,498,779,1078,1434,63.32,17.01,12.78,9.24
13-01-2021,GONDOMAR,1514,108,912,"[480,960]",Muito Elevado,,,,1514,Norte,PORTO,1304,13191.76,165985,10555,8755,6222,4450,3364,7814,14036,22791,33346,1258.22,252.77,172.76,106.4
13-01-2021,GOUVEIA,62,4,501,"[480,960]",Muito Elevado,,,,62,Centro,GUARDA,0906,30061.17,12387,871,931,780,783,810,1593,2373,3304,4175,41.21,13.89,10.99,7.89
13-01-2021,GRÂNDOLA,91,7,622,"[480,960]",Muito Elevado,,,,91,Alentejo,SETÚBAL,1505,82593.66,14639,834,834,708,688,672,1360,2068,2902,3736,17.72,4.52,3.51,2.5
13-01-2021,GUARDA,518,37,1329,"[960,Max]",Extremamente Elevado,,,,518,Centro,GUARDA,0907,71209.58,38969,2477,2041,1686,1415,1474,2889,4575,6616,9093,54.72,12.77,9.29,6.42
13-01-2021,GUIMARÃES,1809,129,1188,"[960,Max]",Extremamente Elevado,,,,1809,Norte,BRAGA,0308,24099.96,152309,9394,7074,4809,3877,2948,6825,11634,18708,28102,631.99,116.61,77.63,48.27
13-01-2021,HORTA,12,1,83,"[0,240]",Moderado,,,,12,Açores,AÇORES,4701,17305.53,14521,818,658,468,352,302,654,1122,1780,2598,83.91,15.01,10.29,6.48
13-01-2021,IDANHA-A-NOVA,136,10,1691,"[960,Max]",Extremamente Elevado,,,,136,Centro,CASTELO BRANCO,0505,141633.51,8043,518,490,519,672,974,1646,2165,2655,3173,5.68,2.24,1.87,1.53
13-01-2021,ÍLHAVO,368,26,951,"[480,960]",Muito Elevado,,,,368,Centro,AVEIRO,0110,7347.55,38699,2227,1943,1444,1193,850,2043,3487,5430,7657,526.66,104.21,73.9,47.46
13-01-2021,LAGOA (FARO),82,6,360,"[240,480]",Elevado,,,,82,Algarve,FARO,0806,8825.45,22762,1314,1168,919,749,670,1419,2338,3506,4820,257.93,54.62,39.73,26.49
13-01-2021,LAGOA,82,6,557,"[480,960]",Muito Elevado,,,,82,Açores,AÇORES,4201,4559.32,14721,536,458,349,238,235,473,822,1280,1816,322.9,39.83,28.08,18.03
13-01-2021,LAGOS,211,15,695,"[480,960]",Muito Elevado,,,,211,Algarve,FARO,0807,21299.27,30374,1744,1434,1247,1053,1029,2082,3329,4763,6507,142.61,30.55,22.36,15.63
13-01-2021,LAJES DAS FLORES,0,0,0,"[0,240]",Moderado,,,,0,Açores,AÇORES,4801,7004.79,1463,88,53,62,46,54,100,162,215,303,20.89,4.33,3.07,2.31
13-01-2021,LAJES DO PICO,0,0,0,"[0,240]",Moderado,,,,0,Açores,AÇORES,4601,15531.09,4490,304,231,223,159,162,321,544,775,1079,28.91,6.95,4.99,3.5
13-01-2021,LAMEGO,304,22,1221,"[960,Max]",Extremamente Elevado,,,,304,Norte,VISEU,1805,16542.11,24895,1639,1284,1124,898,783,1681,2805,4089,5728,150.5,34.63,24.72,16.96
13-01-2021,LEIRIA,1120,80,894,"[480,960]",Muito Elevado,,,,1120,Centro,LEIRIA,1009,56508.83,125267,7389,6366,5090,3902,3159,7061,12151,18517,25906,221.68,45.84,32.77,21.5
13-01-2021,LISBOA,5294,378,1039,"[960,Max]",Extremamente Elevado,,,,5294,Lisboa e Vale do Tejo,LISBOA,1106,10005.43,509515,33197,33340,27706,23037,26770,49807,77513,110853,144050,5092.6,1439.78,1107.98,774.74
13-01-2021,LOULÉ,664,47,967,"[960,Max]",Extremamente Elevado,,,,664,Algarve,FARO,0808,76366.91,68697,3890,3350,2780,2358,2251,4609,7389,10739,14629,89.96,19.16,14.06,9.68
13-01-2021,LOURES,2263,162,1059,"[960,Max]",Extremamente Elevado,,,,2263,Lisboa e Vale do Tejo,LISBOA,1107,16723.99,213687,12746,12794,9644,6669,5033,11702,21346,34140,46886,1277.73,280.35,204.14,127.64
13-01-2021,LOURINHÃ,134,10,518,"[480,960]",Muito Elevado,,,,134,Lisboa e Vale do Tejo,LISBOA,1108,14717.2,25855,1584,1243,992,842,645,1487,2479,3722,5306,175.68,36.05,25.29,16.84
13-01-2021,LOUSÃ,124,9,723,"[480,960]",Muito Elevado,,,,124,Centro,COIMBRA,0607,13840.01,17158,946,866,658,528,450,978,1636,2502,3448,123.97,24.91,18.08,11.82
13-01-2021,LOUSADA,286,20,612,"[480,960]",Muito Elevado,,,,286,Norte,PORTO,1305,9608.01,46755,2289,1698,1176,853,621,1474,2650,4348,6637,486.63,69.08,45.25,27.58
13-01-2021,MAÇÃO,142,10,2266,"[960,Max]",Extremamente Elevado,,,,142,Lisboa e Vale do Tejo,SANTARÉM,1413,39997.98,6267,386,362,390,440,657,1097,1487,1849,2235,15.67,5.59,4.62,3.72
13-01-2021,MACEDO DE CAVALEIROS,212,15,1460,"[960,Max]",Extremamente Elevado,,,,212,Norte,BRAGANÇA,0405,69914.08,14516,1082,889,878,823,938,1761,2639,3528,4610,20.76,6.59,5.05,3.77
13-01-2021,MACHICO,57,4,285,"[240,480]",Elevado,,,,57,Madeira,MADEIRA,3104,6825.1,19981,1197,860,662,455,331,786,1448,2308,3505,292.76,51.36,33.82,21.22
13-01-2021,MADALENA,1,0,17,"[0,240]",Moderado,,,,1,Açores,AÇORES,4602,14712.33,5895,334,256,173,190,179,369,542,798,1132,40.07,7.69,5.42,3.68
13-01-2021,MAFRA,944,67,1113,"[960,Max]",Extremamente Elevado,,,,944,Lisboa e Vale do Tejo,LISBOA,1109,29165.5,84816,3613,3334,2839,2089,1899,3988,6827,10161,13774,290.81,47.23,34.84,23.41
13-01-2021,MAIA,864,62,622,"[480,960]",Muito Elevado,,,,864,Norte,PORTO,1306,8293.94,138971,7801,6617,4512,3339,2631,5970,10482,17099,24900,1675.56,300.22,206.16,126.38
13-01-2021,MANGUALDE,295,21,1594,"[960,Max]",Extremamente Elevado,,,,295,Centro,VISEU,1806,21925.56,18510,1198,1128,885,852,743,1595,2480,3608,4806,84.42,21.92,16.46,11.31
13-01-2021,MANTEIGAS,10,1,333,"[240,480]",Elevado,,,,10,Centro,GUARDA,0908,12197.55,3007,258,197,159,167,146,313,472,669,927,24.65,7.6,5.48,3.87
13-01-2021,MARCO DE CANAVESES,364,26,707,"[480,960]",Muito Elevado,,,,364,Norte,PORTO,1307,20188.98,51496,2678,2060,1488,1265,1023,2288,3776,5836,8514,255.07,42.17,28.91,18.7
13-01-2021,MARINHA GRANDE,334,24,867,"[480,960]",Muito Elevado,,,,334,Centro,LEIRIA,1010,18725.19,38508,2365,2302,1638,1359,1058,2417,4055,6357,8722,205.65,46.58,33.95,21.66
13-01-2021,MARVÃO,25,2,832,"[480,960]",Muito Elevado,,,,25,Alentejo,PORTALEGRE,1210,15489.9,3005,198,185,142,197,237,434,576,761,959,19.4,6.19,4.91,3.72
13-01-2021,MATOSINHOS,1324,95,755,"[480,960]",Muito Elevado,,,,1324,Norte,PORTO,1308,6241.97,175357,11850,9977,7023,5024,3884,8908,15931,25908,37758,2809.31,604.9,415.06,255.22
13-01-2021,MEALHADA,294,21,1476,"[960,Max]",Extremamente Elevado,,,,294,Centro,AVEIRO,0111,11065.66,19914,1163,1039,810,828,831,1659,2469,3508,4671,179.96,42.21,31.7,22.31
13-01-2021,MÊDA,211,15,4600,"[960,Max]",Extremamente Elevado,,,,211,Centro,GUARDA,0909,28604.92,4587,343,306,290,288,443,731,1021,1327,1670,16.04,5.84,4.64,3.57
13-01-2021,MELGAÇO,82,6,1013,"[960,Max]",Extremamente Elevado,,,,82,Norte,VIANA DO CASTELO,1603,23824.58,8093,507,567,578,614,675,1289,1867,2434,2941,33.97,12.34,10.22,7.84
13-01-2021,MÉRTOLA,129,9,2100,"[960,Max]",Extremamente Elevado,,,,129,Alentejo,BEJA,0209,129287.34,6142,400,390,378,423,600,1023,1401,1791,2191,4.75,1.69,1.39,1.08
13-01-2021,MESÃO FRIO,25,2,631,"[480,960]",Muito Elevado,,,,25,Norte,VILA REAL,1704,2664.87,3964,265,205,168,157,120,277,445,650,915,148.74,34.33,24.39,16.7
13-01-2021,MIRA,86,6,727,"[480,960]",Muito Elevado,,,,86,Centro,COIMBRA,0608,12403.38,11832,727,729,659,550,466,1016,1675,2404,3131,95.4,25.24,19.38,13.5
13-01-2021,MIRANDA DO CORVO,176,13,1385,"[960,Max]",Extremamente Elevado,,,,176,Centro,COIMBRA,0609,12637.79,12708,706,659,568,498,404,902,1470,2129,2835,100.55,22.43,16.85,11.63
13-01-2021,MIRANDA DO DOURO,239,17,3499,"[960,Max]",Extremamente Elevado,,,,239,Norte,BRAGANÇA,0406,48718.31,6830,482,429,442,463,470,933,1375,1804,2286,14.02,4.69,3.7,2.82
13-01-2021,MIRANDELA,170,12,781,"[480,960]",Muito Elevado,,,,170,Norte,BRAGANÇA,0407,65895.67,21754,1640,1315,1204,1078,947,2025,3229,4544,6184,33.01,9.38,6.9,4.9
13-01-2021,MOGADOURO,208,15,2479,"[960,Max]",Extremamente Elevado,,,,208,Norte,BRAGANÇA,0408,76064.93,8392,589,529,576,630,655,1285,1861,2390,2979,11.03,3.92,3.14,2.45
13-01-2021,MOIMENTA DA BEIRA,234,17,2403,"[960,Max]",Extremamente Elevado,,,,234,Norte,VISEU,1807,21996.9,9736,576,514,471,416,461,877,1348,1862,2438,44.26,11.08,8.46,6.13
13-01-2021,MOITA,665,47,1032,"[960,Max]",Extremamente Elevado,,,,665,Lisboa e Vale do Tejo,SETÚBAL,1506,5525.98,64407,4226,3646,2623,1801,1425,3226,5849,9495,13721,1165.53,248.3,171.82,105.85
13-01-2021,MONÇÃO,86,6,481,"[480,960]",Muito Elevado,,,,86,Norte,VIANA DO CASTELO,1604,21130.85,17869,1161,1105,1031,1006,972,1978,3009,4114,5275,84.56,24.96,19.47,14.24
13-01-2021,MONCHIQUE,2,0,39,"[0,240]",Moderado,,,,2,Algarve,FARO,0809,39530.43,5077,353,384,321,355,392,747,1068,1452,1805,12.84,4.57,3.67,2.7
13-01-2021,MONDIM DE BASTO,63,5,907,"[480,960]",Muito Elevado,,,,63,Norte,VILA REAL,1705,17207.52,6946,395,300,314,284,283,567,881,1181,1576,40.36,9.16,6.86,5.12
13-01-2021,MONFORTE,37,3,1244,"[960,Max]",Extremamente Elevado,,,,37,Alentejo,PORTALEGRE,1211,42024.82,2975,139,115,117,192,168,360,477,592,731,7.08,1.74,1.41,1.14
13-01-2021,MONTALEGRE,141,10,1567,"[960,Max]",Extremamente Elevado,,,,141,Norte,VILA REAL,1706,80545.71,8997,699,628,595,603,730,1333,1928,2556,3255,11.17,4.04,3.17,2.39
13-01-2021,MONTEMOR-O-NOVO,176,13,1125,"[960,Max]",Extremamente Elevado,,,,176,Alentejo,ÉVORA,0706,123296.65,15647,991,953,868,878,971,1849,2717,3670,4661,12.69,3.78,2.98,2.2
13-01-2021,MONTEMOR-O-VELHO,144,10,571,"[480,960]",Muito Elevado,,,,144,Centro,COIMBRA,0610,22896.23,25224,1496,1397,1217,1057,988,2045,3262,4659,6155,110.17,26.88,20.35,14.25
13-01-2021,MONTIJO,452,32,785,"[480,960]",Muito Elevado,,,,452,Lisboa e Vale do Tejo,SETÚBAL,1507,34861.64,57614,2771,2441,1990,1554,1109,2663,4653,7094,9865,165.26,28.3,20.35,13.35
13-01-2021,MORA,96,7,2320,"[960,Max]",Extremamente Elevado,,,,96,Alentejo,ÉVORA,0707,44395.02,4138,336,275,252,238,257,495,747,1022,1358,9.32,3.06,2.3,1.68
13-01-2021,MORTÁGUA,80,6,909,"[480,960]",Muito Elevado,,,,80,Centro,VISEU,1808,25117.82,8803,638,584,535,499,460,959,1494,2078,2716,35.05,10.81,8.27,5.95
13-01-2021,MOURA,124,9,904,"[480,960]",Muito Elevado,,,,124,Alentejo,BEJA,0210,95845.55,13718,817,656,665,542,461,1003,1668,2324,3141,14.31,3.28,2.42,1.74
13-01-2021,MOURÃO,39,3,1592,"[960,Max]",Extremamente Elevado,,,,39,Alentejo,ÉVORA,0708,27862.98,2450,139,108,80,104,109,213,293,401,540,8.79,1.94,1.44,1.05
13-01-2021,MURÇA,38,3,696,"[480,960]",Muito Elevado,,,,38,Norte,VILA REAL,1707,18937.11,5463,384,341,307,306,319,625,932,1273,1657,28.85,8.75,6.72,4.92
13-01-2021,MURTOSA,249,18,2422,"[960,Max]",Extremamente Elevado,,,,249,Centro,AVEIRO,0112,7308.78,10279,509,473,403,353,409,762,1165,1638,2147,140.63,29.37,22.41,15.94
13-01-2021,NAZARÉ,78,6,551,"[480,960]",Muito Elevado,,,,78,Lisboa e Vale do Tejo,LEIRIA,1011,8243.43,14165,967,903,670,420,396,816,1486,2389,3356,171.84,40.71,28.98,18.03
13-01-2021,NELAS,180,13,1387,"[960,Max]",Extremamente Elevado,,,,180,Centro,VISEU,1809,12571.48,12974,924,787,668,604,583,1187,1855,2642,3566,103.21,28.37,21.02,14.76
13-01-2021,NISA,182,13,3003,"[960,Max]",Extremamente Elevado,,,,182,Alentejo,PORTALEGRE,1212,57567.84,6061,405,389,355,483,478,961,1316,1705,2110,10.53,3.67,2.96,2.29
13-01-2021,NORDESTE,3,0,62,"[0,240]",Moderado,,,,3,Açores,AÇORES,4202,10146.8,4862,246,180,124,161,162,323,447,627,873,47.92,8.6,6.18,4.41
13-01-2021,ÓBIDOS,106,8,895,"[480,960]",Muito Elevado,,,,106,Lisboa e Vale do Tejo,LEIRIA,1012,14155.44,11850,743,650,574,452,436,888,1462,2112,2855,83.72,20.17,14.92,10.33
13-01-2021,ODEMIRA,85,6,344,"[240,480]",Elevado,,,,85,Alentejo,BEJA,0211,172060.15,24717,1475,1317,1225,1397,1349,2746,3971,5288,6763,14.37,3.93,3.07,2.31
13-01-2021,ODIVELAS,1673,119,1034,"[960,Max]",Extremamente Elevado,,,,1673,Lisboa e Vale do Tejo,LISBOA,1116,2654.36,161774,9562,9038,6952,4641,3812,8453,15405,24443,34005,6095.48,1281.27,920.99,580.44
13-01-2021,OEIRAS,1504,107,848,"[480,960]",Muito Elevado,,,,1504,Lisboa e Vale do Tejo,LISBOA,1110,4588.31,177408,11580,11575,8566,6211,5855,12066,20632,32207,43787,3866.78,954.38,701.98,449.69
13-01-2021,OLEIROS,25,2,500,"[480,960]",Muito Elevado,,,,25,Centro,CASTELO BRANCO,0506,47109.31,5003,384,341,366,397,487,884,1250,1591,1975,10.62,4.19,3.38,2.65
13-01-2021,OLHÃO,344,25,775,"[480,960]",Muito Elevado,,,,344,Algarve,FARO,0810,13086.38,44405,2455,2309,1689,1342,1268,2610,4299,6608,9063,339.33,69.26,50.5,32.85
13-01-2021,OLIVEIRA DE AZEMÉIS,634,45,960,"[960,Max]",Extremamente Elevado,,,,634,Norte,AVEIRO,0113,16110.41,66011,4155,3614,2794,2183,1738,3921,6715,10329,14484,409.75,89.91,64.12,41.68
13-01-2021,OLIVEIRA DE FRADES,150,11,1510,"[960,Max]",Extremamente Elevado,,,,150,Centro,VISEU,1810,14534.62,9936,553,475,438,359,415,774,1212,1687,2240,68.36,15.41,11.61,8.34
13-01-2021,OLIVEIRA DO BAIRRO,247,18,1017,"[960,Max]",Extremamente Elevado,,,,247,Centro,AVEIRO,0114,8731.99,24277,1327,1182,999,786,810,1596,2595,3777,5104,278.02,58.45,43.25,29.72
13-01-2021,OLIVEIRA DO HOSPITAL,211,15,1096,"[960,Max]",Extremamente Elevado,,,,211,Centro,COIMBRA,0611,23451.66,19253,1161,1097,962,924,960,1884,2846,3943,5104,82.1,21.76,16.81,12.14
13-01-2021,OURÉM,572,41,1299,"[960,Max]",Extremamente Elevado,,,,572,Lisboa e Vale do Tejo,SANTARÉM,1421,41668.03,44044,2463,2069,1899,1817,1603,3420,5319,7388,9851,105.7,23.64,17.73,12.77
13-01-2021,OURIQUE,61,4,1324,"[960,Max]",Extremamente Elevado,,,,61,Alentejo,BEJA,0212,66331.36,4607,313,287,284,268,227,495,779,1066,1379,6.95,2.08,1.61,1.17
13-01-2021,OVAR,655,47,1207,"[960,Max]",Extremamente Elevado,,,,655,Centro,AVEIRO,0115,14770.25,54260,3294,2709,1994,1636,1234,2870,4864,7573,10867,367.37,73.57,51.27,32.93
13-01-2021,PAÇOS DE FERREIRA,292,21,515,"[480,960]",Muito Elevado,,,,292,Norte,PORTO,1309,7099.29,56728,2903,2193,1518,1135,664,1799,3317,5510,8413,799.1,118.51,77.62,46.72
13-01-2021,PALMELA,833,59,1296,"[960,Max]",Extremamente Elevado,,,,833,Lisboa e Vale do Tejo,SETÚBAL,1508,46512.01,64269,3402,3244,2635,1846,1391,3237,5872,9116,12518,138.18,26.91,19.6,12.62
13-01-2021,PAMPILHOSA DA SERRA,89,6,2205,"[960,Max]",Extremamente Elevado,,,,89,Centro,COIMBRA,0612,39646.24,4037,238,254,295,339,423,762,1057,1311,1549,10.18,3.91,3.31,2.67
13-01-2021,PAREDES,638,46,741,"[480,960]",Muito Elevado,,,,638,Norte,PORTO,1310,15675.69,86067,4272,3532,2412,1717,1258,2975,5387,8919,13191,549.04,84.15,56.9,34.36
13-01-2021,PAREDES DE COURA,66,5,773,"[480,960]",Muito Elevado,,,,66,Norte,VIANA DO CASTELO,1605,13818.59,8535,466,528,407,465,515,980,1387,1915,2381,61.76,17.23,13.86,10.04
13-01-2021,PEDRÓGÃO GRANDE,79,6,2317,"[960,Max]",Extremamente Elevado,,,,79,Centro,LEIRIA,1013,12874.75,3410,175,173,196,221,252,473,669,842,1017,26.49,7.9,6.54,5.2
13-01-2021,PENACOVA,206,15,1504,"[960,Max]",Extremamente Elevado,,,,206,Centro,COIMBRA,0613,21673.23,13694,968,923,745,621,703,1324,2069,2992,3960,63.18,18.27,13.81,9.55
13-01-2021,PENAFIEL,500,36,717,"[480,960]",Muito Elevado,,,,500,Norte,PORTO,1311,21224.27,69772,3648,2823,2032,1663,1230,2893,4925,7748,11396,328.74,53.69,36.51,23.2
13-01-2021,PENALVA DO CASTELO,155,11,2178,"[960,Max]",Extremamente Elevado,,,,155,Centro,VISEU,1811,13433.92,7115,449,457,413,391,426,817,1230,1687,2136,52.96,15.9,12.56,9.16
13-01-2021,PENAMACOR,67,5,1409,"[960,Max]",Extremamente Elevado,,,,67,Centro,CASTELO BRANCO,0507,56370.69,4755,262,248,273,451,633,1084,1357,1605,1867,8.44,3.31,2.85,2.41
13-01-2021,PENEDONO,18,1,695,"[480,960]",Muito Elevado,,,,18,Norte,VISEU,1812,13370.75,2591,172,113,129,156,138,294,423,536,708,19.38,5.3,4.01,3.16
13-01-2021,PENELA,40,3,741,"[480,960]",Muito Elevado,,,,40,Centro,COIMBRA,0614,13480.0,5397,314,324,274,359,344,703,977,1301,1615,40.04,11.98,9.65,7.25
13-01-2021,PENICHE,268,19,1011,"[960,Max]",Extremamente Elevado,,,,268,Lisboa e Vale do Tejo,LEIRIA,1014,7754.98,26501,1746,1504,1203,926,707,1633,2836,4340,6086,341.73,78.48,55.96,36.57
13-01-2021,PESO DA RÉGUA,291,21,1845,"[960,Max]",Extremamente Elevado,,,,291,Norte,VILA REAL,1708,9486.01,15773,1076,843,650,659,455,1114,1764,2607,3683,166.28,38.83,27.48,18.6
13-01-2021,PINHEL,242,17,2843,"[960,Max]",Extremamente Elevado,,,,242,Centro,GUARDA,0910,48452.12,8511,577,566,551,538,689,1227,1778,2344,2921,17.57,6.03,4.84,3.67
13-01-2021,POMBAL,626,45,1216,"[960,Max]",Extremamente Elevado,,,,626,Centro,LEIRIA,1015,62600.28,51461,3187,2791,2494,2328,2027,4355,6849,9640,12827,82.21,20.49,15.4,10.94
13-01-2021,PONTA DELGADA,177,13,261,"[240,480]",Elevado,,,,177,Açores,AÇORES,4203,23298.65,67935,3108,2435,1726,1133,902,2035,3761,6196,9304,291.58,39.93,26.59,16.14
13-01-2021,PONTA DO SOL,17,1,198,"[0,240]",Moderado,,,,17,Madeira,MADEIRA,3105,4622.03,8593,319,283,347,208,221,429,776,1059,1378,185.92,29.81,22.91,16.79
13-01-2021,PONTE DA BARCA,183,13,1637,"[960,Max]",Extremamente Elevado,,,,183,Norte,VIANA DO CASTELO,1606,18211.37,11180,635,576,517,554,490,1044,1561,2137,2772,61.39,15.22,11.73,8.57
13-01-2021,PONTE DE LIMA,373,27,903,"[480,960]",Muito Elevado,,,,373,Norte,VIANA DO CASTELO,1607,32025.46,41315,2321,2022,1720,1596,1462,3058,4778,6800,9121,129.01,28.48,21.23,14.92
13-01-2021,PONTE DE SOR,157,11,1047,"[960,Max]",Extremamente Elevado,,,,157,Alentejo,PORTALEGRE,1213,83971.16,14994,939,800,716,739,831,1570,2286,3086,4025,17.86,4.79,3.68,2.72
13-01-2021,PORTALEGRE,131,9,591,"[480,960]",Muito Elevado,,,,131,Alentejo,PORTALEGRE,1214,44713.64,22172,1577,1351,1137,993,984,1977,3114,4465,6042,49.59,13.51,9.99,6.96
13-01-2021,PORTEL,93,7,1596,"[960,Max]",Extremamente Elevado,,,,93,Alentejo,ÉVORA,0709,60100.57,5828,336,358,283,331,305,636,919,1277,1613,9.7,2.68,2.12,1.53
13-01-2021,PORTIMÃO,219,16,395,"[240,480]",Elevado,,,,219,Algarve,FARO,0811,18206.29,55483,3182,2927,2116,1582,1400,2982,5098,8025,11207,304.75,61.56,44.08,28.0
13-01-2021,PORTO,1605,115,741,"[480,960]",Muito Elevado,,,,1605,Norte,PORTO,1312,4142.02,216606,15790,15193,11280,9409,10044,19453,30733,45926,61716,5229.5,1490.0,1108.79,741.98
13-01-2021,PORTO DE MÓS,248,18,1066,"[960,Max]",Extremamente Elevado,,,,248,Centro,LEIRIA,1016,26183.41,23275,1355,1210,1034,888,872,1760,2794,4004,5359,88.89,20.47,15.29,10.67
13-01-2021,PORTO MONIZ,10,1,427,"[240,480]",Elevado,,,,10,Madeira,MADEIRA,3106,8293.38,2342,143,130,95,98,120,218,313,443,586,28.24,7.07,5.34,3.77
13-01-2021,PORTO SANTO,1,0,19,"[0,240]",Moderado,,,,1,Madeira,MADEIRA,3201,4300.7,5202,240,157,134,110,68,178,312,469,709,120.95,16.48,10.9,7.25
13-01-2021,PÓVOA DE LANHOSO,304,22,1414,"[960,Max]",Extremamente Elevado,,,,304,Norte,BRAGA,0309,13465.29,21499,1175,909,732,673,624,1297,2029,2938,4113,159.67,30.55,21.82,15.07
13-01-2021,PÓVOA DE VARZIM,919,66,1464,"[960,Max]",Extremamente Elevado,,,,919,Norte,PORTO,1313,8220.59,62784,3712,3120,2134,1594,1305,2899,5033,8153,11865,763.7,144.33,99.17,61.22
13-01-2021,POVOAÇÃO,3,0,51,"[0,240]",Moderado,,,,3,Açores,AÇORES,4204,10640.77,5927,293,212,191,144,134,278,469,681,974,55.7,9.15,6.4,4.41
13-01-2021,VILA DA PRAIA DA VITÓRIA,19,1,89,"[0,240]",Moderado,,,,19,Açores,AÇORES,4302,16127.06,21317,1133,789,619,436,336,772,1391,2180,3313,132.18,20.54,13.52,8.63
13-01-2021,PROENÇA-A-NOVA,15,1,206,"[0,240]",Moderado,,,,15,Centro,CASTELO BRANCO,0508,39539.96,7298,508,465,389,400,560,960,1349,1814,2322,18.46,5.87,4.59,3.41
13-01-2021,REDONDO,69,5,1086,"[960,Max]",Extremamente Elevado,,,,69,Alentejo,ÉVORA,0710,36950.87,6353,349,325,288,288,354,642,930,1255,1604,17.19,4.34,3.4,2.52
13-01-2021,REGUENGOS DE MONSARAZ,154,11,1538,"[960,Max]",Extremamente Elevado,,,,154,Alentejo,ÉVORA,0711,46399.72,10015,602,511,455,462,473,935,1390,1901,2503,21.58,5.39,4.1,3.0
13-01-2021,RESENDE,27,2,266,"[240,480]",Elevado,,,,27,Norte,VISEU,1813,12334.93,10137,560,493,448,433,422,855,1303,1796,2356,82.18,19.1,14.56,10.56
13-01-2021,RIBEIRA BRAVA,66,5,531,"[480,960]",Muito Elevado,,,,66,Madeira,MADEIRA,3107,6544.88,12435,648,500,411,311,287,598,1009,1509,2157,189.99,32.96,23.06,15.42
13-01-2021,RIBEIRA DE PENA,79,6,1313,"[960,Max]",Extremamente Elevado,,,,79,Norte,VILA REAL,1709,21745.98,6016,371,301,290,310,368,678,968,1269,1640,27.66,7.54,5.84,4.45
13-01-2021,RIBEIRA GRANDE,426,30,1298,"[960,Max]",Extremamente Elevado,,,,426,Açores,AÇORES,4205,18015.13,32811,1163,689,512,345,253,598,1110,1799,2962,182.13,16.44,9.99,6.16
13-01-2021,RIO MAIOR,303,22,1487,"[960,Max]",Extremamente Elevado,,,,303,Lisboa e Vale do Tejo,SANTARÉM,1414,27276.45,20379,1251,1144,941,795,648,1443,2384,3528,4779,74.71,17.52,12.93,8.74
13-01-2021,SABROSA,47,3,794,"[480,960]",Muito Elevado,,,,47,Norte,VILA REAL,1710,15692.45,5918,393,314,304,302,350,652,956,1270,1663,37.71,10.6,8.09,6.09
13-01-2021,SABUGAL,111,8,1049,"[960,Max]",Extremamente Elevado,,,,111,Centro,GUARDA,0911,82269.82,10585,724,707,694,796,1009,1805,2499,3206,3930,12.87,4.78,3.9,3.04
13-01-2021,SALVATERRA DE MAGOS,164,12,770,"[480,960]",Muito Elevado,,,,164,Lisboa e Vale do Tejo,SANTARÉM,1415,24393.2,21295,1275,1181,1060,799,772,1571,2631,3812,5087,87.3,20.85,15.63,10.79
13-01-2021,SANTA COMBA DÃO,92,7,880,"[480,960]",Muito Elevado,,,,92,Centro,VISEU,1814,11194.77,10452,732,684,569,538,464,1002,1571,2255,2987,93.36,26.68,20.14,14.03
13-01-2021,SANTA CRUZ,158,11,349,"[240,480]",Elevado,,,,158,Madeira,MADEIRA,3108,8150.28,45281,1817,1301,974,716,523,1239,2213,3514,5331,555.6,65.41,43.12,27.15
13-01-2021,SANTA CRUZ DA GRACIOSA,1,0,24,"[0,240]",Moderado,,,,1,Açores,AÇORES,4401,6065.78,4208,228,180,163,124,145,269,432,612,840,69.37,13.85,10.09,7.12
13-01-2021,SANTA CRUZ DAS FLORES,1,0,46,"[0,240]",Moderado,,,,1,Açores,AÇORES,4802,7091.44,2165,125,98,74,56,51,107,181,279,404,30.53,5.7,3.93,2.55
13-01-2021,SANTA MARIA DA FEIRA,1666,119,1202,"[960,Max]",Extremamente Elevado,,,,1666,Norte,AVEIRO,0109,21587.65,138636,8182,6743,4771,3856,3079,6935,11706,18449,26631,642.19,123.36,85.46,54.22
13-01-2021,SANTA MARTA DE PENAGUIÃO,85,6,1288,"[960,Max]",Extremamente Elevado,,,,85,Norte,VILA REAL,1711,6928.13,6599,483,373,337,316,317,633,970,1343,1826,95.25,26.36,19.39,14.0
13-01-2021,SANTANA,10,1,149,"[0,240]",Moderado,,,,10,Madeira,MADEIRA,3109,9547.3,6711,418,353,343,282,277,559,902,1255,1673,70.29,17.52,13.15,9.45
13-01-2021,SANTARÉM,595,42,1036,"[960,Max]",Extremamente Elevado,,,,595,Lisboa e Vale do Tejo,SANTARÉM,1416,55253.58,57421,3654,3441,2760,2466,2206,4672,7432,10873,14527,103.92,26.29,19.68,13.45
13-01-2021,SANTIAGO DO CACÉM,79,6,274,"[240,480]",Elevado,,,,79,Alentejo,SETÚBAL,1509,105969.29,28791,2144,1689,1472,1295,1215,2510,3982,5671,7815,27.17,7.37,5.35,3.76
13-01-2021,SANTO TIRSO,839,60,1233,"[960,Max]",Extremamente Elevado,,,,839,Norte,PORTO,1314,13655.52,68055,4911,3935,2761,2257,1810,4067,6828,10763,15674,498.35,114.78,78.82,50.0
13-01-2021,SÃO BRÁS DE ALPORTEL,52,4,499,"[480,960]",Muito Elevado,,,,52,Algarve,FARO,0812,15336.92,10416,596,468,467,404,401,805,1272,1740,2336,67.91,15.23,11.35,8.29
13-01-2021,SÃO JOÃO DA MADEIRA,205,15,934,"[480,960]",Muito Elevado,,,,205,Norte,AVEIRO,0116,794.3,21958,1347,1069,796,601,593,1194,1990,3059,4406,2765.49,554.91,385.26,250.63
13-01-2021,SÃO JOÃO DA PESQUEIRA,107,8,1502,"[960,Max]",Extremamente Elevado,,,,107,Norte,VISEU,1815,26610.85,7125,417,330,294,328,328,656,950,1280,1697,26.77,6.38,4.81,3.57
13-01-2021,SÃO PEDRO DO SUL,183,13,1188,"[960,Max]",Extremamente Elevado,,,,183,Centro,VISEU,1816,34895.09,15403,990,962,861,759,909,1668,2529,3491,4481,44.14,12.84,10.0,7.25
13-01-2021,SÃO ROQUE DO PICO,0,0,0,"[0,240]",Moderado,,,,0,Açores,AÇORES,4603,14236.1,3266,199,141,93,96,113,209,302,443,642,22.94,4.51,3.11,2.12
13-01-2021,SÃO VICENTE,7,0,136,"[0,240]",Moderado,,,,7,Madeira,MADEIRA,3110,7883.71,5143,272,264,266,225,280,505,771,1035,1307,65.23,16.58,13.13,9.78
13-01-2021,SARDOAL,11,1,294,"[240,480]",Elevado,,,,11,Lisboa e Vale do Tejo,SANTARÉM,1417,9214.72,3741,227,178,148,165,248,413,561,739,966,40.6,10.48,8.02,6.09
13-01-2021,SÁTÃO,147,10,1269,"[960,Max]",Extremamente Elevado,,,,147,Centro,VISEU,1817,20194.11,11580,765,671,515,465,476,941,1456,2127,2892,57.34,14.32,10.53,7.21
13-01-2021,SEIA,207,15,931,"[480,960]",Muito Elevado,,,,207,Centro,GUARDA,0912,43568.83,22234,1807,1589,1238,1122,721,1843,3081,4670,6477,51.03,14.87,10.72,7.07
13-01-2021,SEIXAL,1466,105,874,"[480,960]",Muito Elevado,,,,1466,Lisboa e Vale do Tejo,SETÚBAL,1510,9545.17,167752,10586,9270,6661,4391,2930,7321,13982,23252,33838,1757.49,354.51,243.6,146.49
13-01-2021,SERNANCELHE,64,5,1186,"[960,Max]",Extremamente Elevado,,,,64,Norte,VISEU,1818,22861.22,5396,305,293,286,273,260,533,819,1112,1417,23.6,6.2,4.86,3.58
13-01-2021,SERPA,70,5,489,"[480,960]",Muito Elevado,,,,70,Alentejo,BEJA,0213,110563.34,14304,903,761,719,697,626,1323,2042,2803,3706,12.94,3.35,2.54,1.85
13-01-2021,SERTÃ,174,12,1194,"[960,Max]",Extremamente Elevado,,,,174,Centro,CASTELO BRANCO,0509,44673.17,14577,870,779,790,767,1020,1787,2577,3356,4226,32.63,9.46,7.51,5.77
13-01-2021,SESIMBRA,447,32,862,"[480,960]",Muito Elevado,,,,447,Lisboa e Vale do Tejo,SETÚBAL,1511,19571.75,51858,2400,2321,1853,1257,1083,2340,4193,6514,8914,264.96,45.54,33.28,21.42
13-01-2021,SETÚBAL,1839,131,1597,"[960,Max]",Extremamente Elevado,,,,1839,Lisboa e Vale do Tejo,SETÚBAL,1512,23032.5,115126,7425,6929,5075,3775,2655,6430,11505,18434,25859,499.83,112.27,80.03,49.95
13-01-2021,SEVER DO VOUGA,152,11,1341,"[960,Max]",Extremamente Elevado,,,,152,Centro,AVEIRO,0117,12987.56,11331,766,637,568,540,567,1107,1675,2312,3078,87.24,23.7,17.8,12.9
13-01-2021,SILVES,213,15,588,"[480,960]",Muito Elevado,,,,213,Algarve,FARO,0813,68006.23,36226,2137,1869,1610,1423,1600,3023,4633,6502,8639,53.27,12.7,9.56,6.81
13-01-2021,SINES,49,3,357,"[240,480]",Elevado,,,,49,Alentejo,SETÚBAL,1513,20330.17,13715,888,791,551,416,268,684,1235,2026,2914,67.46,14.33,9.97,6.07
13-01-2021,SINTRA,3687,263,942,"[480,960]",Muito Elevado,,,,3687,Lisboa e Vale do Tejo,LISBOA,1111,31922.73,391402,20490,18316,13545,9137,7284,16421,29966,48282,68772,1226.08,215.43,151.25,93.87
13-01-2021,SOBRAL DE MONTE AGRAÇO,100,7,939,"[480,960]",Muito Elevado,,,,100,Lisboa e Vale do Tejo,LISBOA,1112,5210.32,10651,564,507,352,272,212,484,836,1343,1907,204.43,36.6,25.78,16.05
13-01-2021,SOURE,154,11,900,"[480,960]",Muito Elevado,,,,154,Centro,COIMBRA,0615,26506.07,17120,1173,1142,1004,883,987,1870,2874,4016,5189,64.59,19.58,15.15,10.84
13-01-2021,SOUSEL,36,3,816,"[480,960]",Muito Elevado,,,,36,Alentejo,PORTALEGRE,1215,27932.18,4412,261,274,208,302,292,594,802,1076,1337,15.8,4.79,3.85,2.87
13-01-2021,TÁBUA,238,17,2094,"[960,Max]",Extremamente Elevado,,,,238,Centro,COIMBRA,0616,19978.58,11368,729,584,524,430,464,894,1418,2002,2731,56.9,13.67,10.02,7.1
13-01-2021,TABUAÇO,59,4,978,"[960,Max]",Extremamente Elevado,,,,59,Norte,VISEU,1819,13385.67,6033,372,314,217,282,363,645,862,1176,1548,45.07,11.56,8.79,6.44
13-01-2021,TAROUCA,131,9,1679,"[960,Max]",Extremamente Elevado,,,,131,Norte,VISEU,1820,10008.49,7804,405,335,313,277,324,601,914,1249,1654,77.98,16.53,12.48,9.13
13-01-2021,TAVIRA,544,39,2218,"[960,Max]",Extremamente Elevado,,,,544,Algarve,FARO,0814,60696.7,24530,1493,1415,1252,1066,1277,2343,3595,5010,6503,40.41,10.71,8.25,5.92
13-01-2021,TERRAS DE BOURO,69,5,1085,"[960,Max]",Extremamente Elevado,,,,69,Norte,BRAGA,0310,27746.07,6361,391,372,296,319,340,659,955,1327,1718,22.93,6.19,4.78,3.44
13-01-2021,TOMAR,448,32,1219,"[960,Max]",Extremamente Elevado,,,,448,Lisboa e Vale do Tejo,SANTARÉM,1418,35120.44,36748,2403,2189,1868,1853,1822,3675,5543,7732,10135,104.64,28.86,22.02,15.78
13-01-2021,TONDELA,347,25,1317,"[960,Max]",Extremamente Elevado,,,,347,Centro,VISEU,1821,37121.73,26357,1768,1722,1518,1475,1417,2892,4410,6132,7900,71.0,21.28,16.52,11.88
13-01-2021,TORRE DE MONCORVO,18,1,234,"[0,240]",Moderado,,,,18,Norte,BRAGANÇA,0409,53155.67,7695,556,478,488,551,719,1270,1758,2236,2792,14.48,5.25,4.21,3.31
13-01-2021,TORRES NOVAS,424,30,1214,"[960,Max]",Extremamente Elevado,,,,424,Lisboa e Vale do Tejo,SANTARÉM,1419,26999.68,34933,2324,1979,1738,1406,1475,2881,4619,6598,8922,129.38,33.04,24.44,17.11
13-01-2021,TORRES VEDRAS,835,60,1063,"[960,Max]",Extremamente Elevado,,,,835,Lisboa e Vale do Tejo,LISBOA,1113,40714.89,78530,4513,3945,3447,2628,2104,4732,8179,12124,16637,192.88,40.86,29.78,20.09
13-01-2021,TRANCOSO,180,13,2028,"[960,Max]",Extremamente Elevado,,,,180,Centro,GUARDA,0913,36152.47,8875,581,557,542,586,496,1082,1624,2181,2762,24.55,7.64,6.03,4.49
13-01-2021,TROFA,331,24,862,"[480,960]",Muito Elevado,,,,331,Norte,PORTO,1318,7201.76,38418,2336,1894,1231,939,684,1623,2854,4748,7084,533.44,98.36,65.93,39.63
13-01-2021,VAGOS,144,10,633,"[480,960]",Muito Elevado,,,,144,Centro,AVEIRO,0118,16491.5,22740,1320,1205,922,784,724,1508,2430,3635,4955,137.89,30.04,22.04,14.73
13-01-2021,VALE DE CAMBRA,186,13,872,"[480,960]",Muito Elevado,,,,186,Norte,AVEIRO,0119,14733.47,21327,1491,1363,1005,831,798,1629,2634,3997,5488,144.76,37.25,27.13,17.88
13-01-2021,VALENÇA,107,8,805,"[480,960]",Muito Elevado,,,,107,Norte,VIANA DO CASTELO,1608,11712.86,13290,867,791,582,582,503,1085,1667,2458,3325,113.46,28.39,20.99,14.23
13-01-2021,VALONGO,820,59,842,"[480,960]",Muito Elevado,,,,820,Norte,PORTO,1315,7512.45,97444,5629,4696,3207,2462,1829,4291,7498,12194,17823,1297.18,237.26,162.33,99.81
13-01-2021,VALPAÇOS,157,11,1060,"[960,Max]",Extremamente Elevado,,,,157,Norte,VILA REAL,1712,54873.93,14818,1217,1118,999,928,997,1925,2924,4042,5259,27.0,9.58,7.37,5.33
13-01-2021,VELAS,3,0,59,"[0,240]",Moderado,,,,3,Açores,AÇORES,4502,11738.38,5093,278,208,166,153,113,266,432,640,918,43.39,7.82,5.45,3.68
13-01-2021,VENDAS NOVAS,186,13,1653,"[960,Max]",Extremamente Elevado,,,,186,Alentejo,ÉVORA,0712,22238.88,11255,677,768,655,501,532,1033,1688,2456,3133,50.61,14.09,11.04,7.59
13-01-2021,VIANA DO ALENTEJO,143,10,2779,"[960,Max]",Extremamente Elevado,,,,143,Alentejo,ÉVORA,0713,39367.29,5145,245,208,235,210,214,424,659,867,1112,13.07,2.82,2.2,1.67
13-01-2021,VIANA DO CASTELO,788,56,933,"[480,960]",Muito Elevado,,,,788,Norte,VIANA DO CASTELO,1609,31902.01,84417,5470,4433,3591,3061,2982,6043,9634,14067,19537,264.61,61.24,44.09,30.2
13-01-2021,VIDIGUEIRA,102,7,1851,"[960,Max]",Extremamente Elevado,,,,102,Alentejo,BEJA,0214,31661.09,5510,300,248,215,233,275,508,723,971,1271,17.4,4.01,3.07,2.28
13-01-2021,VIEIRA DO MINHO,117,8,988,"[960,Max]",Extremamente Elevado,,,,117,Norte,BRAGA,0311,21644.35,11842,703,594,525,548,482,1030,1555,2149,2852,54.71,13.18,9.93,7.18
13-01-2021,VILA DE REI,6,0,181,"[0,240]",Moderado,,,,6,Centro,CASTELO BRANCO,0510,19154.6,3323,169,128,172,247,302,549,721,849,1018,17.35,5.31,4.43,3.76
13-01-2021,VILA DO BISPO,12,1,233,"[0,240]",Moderado,,,,12,Algarve,FARO,0815,17906.06,5154,302,302,314,232,233,465,779,1081,1383,28.78,7.72,6.04,4.35
13-01-2021,VILA DO CONDE,1123,80,1406,"[960,Max]",Extremamente Elevado,,,,1123,Norte,PORTO,1316,14902.77,79899,4726,3875,2819,2070,1743,3813,6632,10507,15233,536.13,102.21,70.5,44.5
13-01-2021,VILA DO PORTO,5,0,89,"[0,240]",Moderado,,,,5,Açores,AÇORES,4101,9688.74,5616,274,212,135,96,123,219,354,566,840,57.96,8.67,5.84,3.65
13-01-2021,VILA FLOR,73,5,1208,"[960,Max]",Extremamente Elevado,,,,73,Norte,BRAGANÇA,0410,26581.14,6044,429,362,422,294,331,625,1047,1409,1838,22.74,6.91,5.3,3.94
13-01-2021,VILA FRANCA DE XIRA,1455,104,1025,"[960,Max]",Extremamente Elevado,,,,1455,Lisboa e Vale do Tejo,LISBOA,1114,31819.39,141957,8501,6852,4869,3425,2472,5897,10766,17618,26119,446.14,82.09,55.37,33.84
13-01-2021,VILA FRANCA DO CAMPO,131,9,1185,"[960,Max]",Extremamente Elevado,,,,131,Açores,AÇORES,4206,7796.82,11051,450,344,248,217,154,371,619,963,1413,141.73,18.12,12.35,7.94
13-01-2021,VILA NOVA DA BARQUINHA,53,4,710,"[480,960]",Muito Elevado,,,,53,Lisboa e Vale do Tejo,SANTARÉM,1420,4952.97,7461,415,406,392,364,338,702,1094,1500,1915,150.64,38.66,30.28,22.09
13-01-2021,VILA NOVA DE CERVEIRA,120,9,1347,"[960,Max]",Extremamente Elevado,,,,120,Norte,VIANA DO CASTELO,1610,10846.66,8910,531,444,410,384,334,718,1128,1572,2103,82.14,19.39,14.49,10.4
13-01-2021,VILA NOVA DE FAMALICÃO,1421,101,1079,"[960,Max]",Extremamente Elevado,,,,1421,Norte,BRAGA,0312,20159.26,131676,7817,6164,4202,3282,2749,6031,10233,16397,24214,653.19,120.12,81.34,50.76
13-01-2021,VILA NOVA DE FOZ CÔA,67,5,1030,"[960,Max]",Extremamente Elevado,,,,67,Centro,GUARDA,0914,39815.18,6503,442,385,390,398,429,827,1217,1602,2044,16.33,5.13,4.02,3.06
13-01-2021,VILA NOVA DE GAIA,1992,142,663,"[480,960]",Muito Elevado,,,,1992,Norte,PORTO,1317,16846.43,300472,18349,15568,10972,8224,6281,14505,25477,41045,59394,1783.64,352.57,243.65,151.23
13-01-2021,VILA NOVA DE PAIVA,91,7,1942,"[960,Max]",Extremamente Elevado,,,,91,Centro,VISEU,1822,17553.28,4687,289,272,233,217,241,458,691,963,1252,26.7,7.13,5.49,3.94
13-01-2021,VILA NOVA DE POIARES,224,16,3228,"[960,Max]",Extremamente Elevado,,,,224,Centro,COIMBRA,0617,8445.3,6939,380,284,262,235,182,417,679,963,1343,82.17,15.9,11.4,8.04
13-01-2021,VILA POUCA DE AGUIAR,88,6,736,"[480,960]",Muito Elevado,,,,88,Norte,VILA REAL,1713,43706.62,11961,860,817,733,601,627,1228,1961,2778,3638,27.37,8.32,6.36,4.49
13-01-2021,VILA REAL,458,33,917,"[480,960]",Muito Elevado,,,,458,Norte,VILA REAL,1714,37880.28,49962,3025,2498,2065,1579,1466,3045,5110,7608,10633,131.9,28.07,20.08,13.49
13-01-2021,VILA REAL DE SANTO ANTÓNIO,159,11,848,"[480,960]",Muito Elevado,,,,159,Algarve,FARO,0816,6125.0,18749,1172,1069,811,569,586,1155,1966,3035,4207,306.11,68.69,49.55,32.1
13-01-2021,VILA VELHA DE RÓDÃO,16,1,509,"[480,960]",Muito Elevado,,,,16,Centro,CASTELO BRANCO,0511,32991.16,3144,209,229,180,283,306,589,769,998,1207,9.53,3.66,3.03,2.33
13-01-2021,VILA VERDE,613,44,1307,"[960,Max]",Extremamente Elevado,,,,613,Norte,BRAGA,0313,22866.52,46911,2365,2063,1667,1494,1437,2931,4598,6661,9026,205.15,39.47,29.13,20.11
13-01-2021,VILA VIÇOSA,107,8,1398,"[960,Max]",Extremamente Elevado,,,,107,Alentejo,ÉVORA,0714,19485.89,7656,487,379,342,345,324,669,1011,1390,1877,39.29,9.63,7.13,5.19
13-01-2021,VIMIOSO,50,4,1243,"[960,Max]",Extremamente Elevado,,,,50,Norte,BRAGANÇA,0411,48158.51,4023,274,230,261,293,335,628,889,1119,1393,8.35,2.89,2.32,1.85
13-01-2021,VINHAIS,42,3,542,"[480,960]",Muito Elevado,,,,42,Norte,BRAGANÇA,0412,69475.09,7746,599,577,636,641,815,1456,2092,2669,3268,11.15,4.7,3.84,3.01
13-01-2021,VISEU,1182,84,1215,"[960,Max]",Extremamente Elevado,,,,1182,Centro,VISEU,1823,50710.14,97249,5769,5038,4140,3158,2710,5868,10008,15046,20815,191.77,41.05,29.67,19.74
13-01-2021,VIZELA,197,14,824,"[480,960]",Muito Elevado,,,,197,Norte,BRAGA,0314,2469.83,23897,1258,928,655,509,371,880,1535,2463,3721,967.49,150.65,99.72,62.15
13-01-2021,VOUZELA,152,11,1580,"[960,Max]",Extremamente Elevado,,,,152,Centro,VISEU,1824,19369.46,9619,626,605,554,532,507,1039,1593,2198,2824,49.66,14.58,11.35,8.22
19-01-2021,ABRANTES,306,22,871,"[480,960]",Muito Elevado,,,,306,Lisboa e Vale do Tejo,SANTARÉM,1401,71469.08,35130,2473,2213,1730,1748,2021,3769,5499,7712,10185,49.15,14.25,10.79,7.69
19-01-2021,ÁGUEDA,695,50,1508,"[960,Max]",Extremamente Elevado,,,,695,Centro,AVEIRO,0101,33527.44,46075,3237,2713,2090,1635,1496,3131,5221,7934,11171,137.43,33.32,23.66,15.57
19-01-2021,AGUIAR DA BEIRA,291,21,6255,"[960,Max]",Extremamente Elevado,,,,291,Centro,GUARDA,0901,20676.57,4652,304,281,235,239,148,387,622,903,1207,22.5,5.84,4.37,3.01
19-01-2021,ALANDROAL,95,7,1903,"[960,Max]",Extremamente Elevado,,,,95,Alentejo,ÉVORA,0701,54267.81,4992,307,256,296,299,377,676,972,1228,1535,9.2,2.83,2.26,1.79
19-01-2021,ALBERGARIA-A-VELHA,246,18,1019,"[960,Max]",Extremamente Elevado,,,,246,Centro,AVEIRO,0102,15882.5,24144,1550,1298,996,687,680,1367,2363,3661,5211,152.02,32.81,23.05,14.88
19-01-2021,ALBUFEIRA,605,43,1457,"[960,Max]",Extremamente Elevado,,,,605,Algarve,FARO,0801,14066.42,41528,2067,1717,1425,985,858,1843,3268,4985,7052,295.24,50.14,35.44,23.23
19-01-2021,ALCÁCER DO SAL,382,27,3276,"[960,Max]",Extremamente Elevado,,,,382,Alentejo,SETÚBAL,1501,149987.3,11659,884,814,623,623,602,1225,1848,2662,3546,7.77,2.36,1.77,1.23
19-01-2021,ALCANENA,201,14,1569,"[960,Max]",Extremamente Elevado,,,,201,Lisboa e Vale do Tejo,SANTARÉM,1402,12732.86,12809,891,744,628,536,588,1124,1752,2496,3387,100.6,26.6,19.6,13.76
19-01-2021,ALCOBAÇA,741,53,1384,"[960,Max]",Extremamente Elevado,,,,741,Lisboa e Vale do Tejo,LEIRIA,1001,40814.09,53555,3420,2927,2466,2059,1676,3735,6201,9128,12548,131.22,30.74,22.36,15.19
19-01-2021,ALCOCHETE,217,16,1097,"[960,Max]",Extremamente Elevado,,,,217,Lisboa e Vale do Tejo,SETÚBAL,1502,12836.48,19787,857,834,691,476,447,923,1614,2448,3305,154.15,25.75,19.07,12.57
19-01-2021,ALCOUTIM,13,1,602,"[480,960]",Muito Elevado,,,,13,Algarve,FARO,0802,57536.33,2159,191,188,163,190,267,457,620,808,999,3.75,1.74,1.4,1.08
19-01-2021,ALENQUER,455,33,1033,"[960,Max]",Extremamente Elevado,,,,455,Lisboa e Vale do Tejo,LISBOA,1101,30421.92,44052,2298,2062,1629,1330,1155,2485,4114,6176,8474,144.8,27.85,20.3,13.52
19-01-2021,ALFÂNDEGA DA FÉ,105,8,2308,"[960,Max]",Extremamente Elevado,,,,105,Norte,BRAGANÇA,0401,32194.64,4550,325,277,301,274,325,599,900,1177,1502,14.13,4.67,3.66,2.8
19-01-2021,ALIJÓ,103,7,969,"[960,Max]",Extremamente Elevado,,,,103,Norte,VILA REAL,1701,29759.89,10625,766,687,635,542,666,1208,1843,2530,3296,35.7,11.08,8.5,6.19
19-01-2021,ALJEZUR,14,1,250,"[240,480]",Elevado,,,,14,Algarve,FARO,0803,32349.95,5594,316,336,335,320,410,730,1065,1401,1717,17.29,5.31,4.33,3.29
19-01-2021,ALJUSTREL,72,5,873,"[480,960]",Muito Elevado,,,,72,Alentejo,BEJA,0201,45847.41,8247,635,521,443,347,358,705,1148,1669,2304,17.99,5.03,3.64,2.5
19-01-2021,ALMADA,2182,156,1291,"[960,Max]",Extremamente Elevado,,,,2182,Lisboa e Vale do Tejo,SETÚBAL,1503,7000.89,169039,10469,9777,7876,6144,5111,11255,19131,28908,39377,2414.5,562.45,412.91,273.26
19-01-2021,ALMEIDA,68,5,1166,"[960,Max]",Extremamente Elevado,,,,68,Centro,GUARDA,0902,51798.46,5830,441,419,396,458,393,851,1247,1666,2107,11.26,4.07,3.22,2.41
19-01-2021,ALMEIRIM,402,29,1783,"[960,Max]",Extremamente Elevado,,,,402,Lisboa e Vale do Tejo,SANTARÉM,1403,22212.05,22546,1342,1353,1106,866,843,1709,2815,4168,5510,101.5,24.81,18.76,12.67
19-01-2021,ALMODÔVAR,108,8,1606,"[960,Max]",Extremamente Elevado,,,,108,Alentejo,BEJA,0202,77788.03,6725,414,443,396,373,328,701,1097,1540,1954,8.65,2.51,1.98,1.41
19-01-2021,ALPIARÇA,48,3,680,"[480,960]",Muito Elevado,,,,48,Lisboa e Vale do Tejo,SANTARÉM,1404,9536.33,7059,515,486,363,333,274,607,970,1456,1971,74.02,20.67,15.27,10.17
19-01-2021,ALTER DO CHÃO,134,10,4234,"[960,Max]",Extremamente Elevado,,,,134,Alentejo,PORTALEGRE,1201,36206.62,3165,201,163,136,208,187,395,531,694,895,8.74,2.47,1.92,1.47
19-01-2021,ALVAIÁZERE,85,6,1288,"[960,Max]",Extremamente Elevado,,,,85,Centro,LEIRIA,1002,16047.76,6597,419,389,346,406,539,945,1291,1680,2099,41.11,13.08,10.47,8.04
19-01-2021,ALVITO,41,3,1655,"[960,Max]",Extremamente Elevado,,,,41,Alentejo,BEJA,0203,26485.32,2477,145,110,105,111,89,200,305,415,560,9.35,2.11,1.57,1.15
19-01-2021,AMADORA,2441,174,1326,"[960,Max]",Extremamente Elevado,,,,2441,Lisboa e Vale do Tejo,LISBOA,1115,2378.47,184106,11186,10936,8780,6460,5890,12350,21130,32066,43252,7742.05,1818.84,1348.44,888.56
19-01-2021,AMARANTE,583,42,1096,"[960,Max]",Extremamente Elevado,,,,583,Norte,PORTO,1301,30133.15,53193,3086,2413,1812,1643,1311,2954,4766,7179,10265,176.53,34.07,23.82,15.82
19-01-2021,AMARES,204,15,1125,"[960,Max]",Extremamente Elevado,,,,204,Norte,BRAGA,0301,8195.41,18129,1001,829,622,489,524,1013,1635,2464,3465,221.22,42.28,30.07,19.95
19-01-2021,ANADIA,401,29,1471,"[960,Max]",Extremamente Elevado,,,,401,Centro,AVEIRO,0103,21663.48,27258,1931,1698,1376,1208,1262,2470,3846,5544,7475,125.83,34.51,25.59,17.75
19-01-2021,ANGRA DO HEROÍSMO,25,2,74,"[0,240]",Moderado,,,,25,Açores,AÇORES,4301,23899.66,33807,2006,1473,1122,768,635,1403,2525,3998,6004,141.45,25.12,16.73,10.56
19-01-2021,ANSIÃO,259,18,2151,"[960,Max]",Extremamente Elevado,,,,259,Centro,LEIRIA,1003,17609.42,12039,727,709,646,694,530,1224,1870,2579,3306,68.37,18.77,14.65,10.62
19-01-2021,ARCOS DE VALDEVEZ,471,34,2251,"[960,Max]",Extremamente Elevado,,,,471,Norte,VIANA DO CASTELO,1601,44759.64,20926,1329,1338,1282,1343,1515,2858,4140,5478,6807,46.75,15.21,12.24,9.25
19-01-2021,ARGANIL,176,13,1598,"[960,Max]",Extremamente Elevado,,,,176,Centro,COIMBRA,0601,33283.93,11014,672,648,612,559,596,1155,1767,2415,3087,33.09,9.27,7.26,5.31
19-01-2021,ARMAMAR,119,9,2063,"[960,Max]",Extremamente Elevado,,,,119,Norte,VISEU,1801,11723.73,5769,357,305,309,285,310,595,904,1209,1566,49.21,13.36,10.31,7.71
19-01-2021,AROUCA,291,21,1404,"[960,Max]",Extremamente Elevado,,,,291,Norte,AVEIRO,0104,32910.52,20720,1306,1047,753,683,683,1366,2119,3166,4472,62.96,13.59,9.62,6.44
19-01-2021,ARRAIOLOS,146,10,2107,"[960,Max]",Extremamente Elevado,,,,146,Alentejo,ÉVORA,0702,68374.55,6928,435,384,283,367,480,847,1130,1514,1949,10.13,2.85,2.21,1.65
19-01-2021,ARRONCHES,55,4,1950,"[960,Max]",Extremamente Elevado,,,,55,Alentejo,PORTALEGRE,1202,31464.72,2820,155,142,162,187,179,366,528,670,825,8.96,2.62,2.13,1.68
19-01-2021,ARRUDA DOS VINHOS,259,19,1681,"[960,Max]",Extremamente Elevado,,,,259,Lisboa e Vale do Tejo,LISBOA,1102,7795.93,15412,738,738,562,509,438,947,1509,2247,2985,197.69,38.29,28.82,19.36
19-01-2021,AVEIRO,830,59,1054,"[960,Max]",Extremamente Elevado,,,,830,Centro,AVEIRO,0105,19757.57,78734,4520,4004,3050,2250,2103,4353,7403,11407,15927,398.49,80.61,57.73,37.47
19-01-2021,AVIS,31,2,730,"[480,960]",Muito Elevado,,,,31,Alentejo,PORTALEGRE,1203,60596.51,4247,315,225,206,251,273,524,730,955,1270,7.01,2.1,1.58,1.2
19-01-2021,AZAMBUJA,230,16,1013,"[960,Max]",Extremamente Elevado,,,,230,Lisboa e Vale do Tejo,LISBOA,1103,26265.65,22716,1322,1171,1070,798,618,1416,2486,3657,4979,86.48,18.96,13.92,9.46
19-01-2021,BAIÃO,184,13,981,"[960,Max]",Extremamente Elevado,,,,184,Norte,PORTO,1302,17452.83,18748,1070,862,714,686,725,1411,2125,2987,4057,107.42,23.25,17.11,12.18
19-01-2021,BARCELOS,1888,135,1625,"[960,Max]",Extremamente Elevado,,,,1888,Norte,BRAGA,0302,37890.14,116187,6721,5325,3619,2991,2562,5553,9172,14497,21218,306.64,56.0,38.26,24.21
19-01-2021,BARRANCOS,25,2,1530,"[960,Max]",Extremamente Elevado,,,,25,Alentejo,BEJA,0204,16841.73,1634,90,65,65,94,61,155,220,285,375,9.7,2.23,1.69,1.31
19-01-2021,BARREIRO,914,65,1216,"[960,Max]",Extremamente Elevado,,,,914,Lisboa e Vale do Tejo,SETÚBAL,1504,3639.07,75147,5194,5565,4459,3105,1767,4872,9331,14896,20090,2065.05,552.07,409.34,256.42
19-01-2021,BATALHA,188,13,1178,"[960,Max]",Extremamente Elevado,,,,188,Centro,LEIRIA,1004,10341.6,15963,873,762,649,529,549,1078,1727,2489,3362,154.35,32.51,24.07,16.7
19-01-2021,BEJA,564,40,1680,"[960,Max]",Extremamente Elevado,,,,564,Alentejo,BEJA,0205,114647.55,33579,2005,1840,1386,1272,1039,2311,3697,5537,7542,29.29,6.58,4.83,3.22
19-01-2021,BELMONTE,65,5,1016,"[960,Max]",Extremamente Elevado,,,,65,Centro,CASTELO BRANCO,0501,11875.91,6398,444,321,325,310,355,665,990,1311,1755,53.87,14.78,11.04,8.34
19-01-2021,BENAVENTE,503,36,1644,"[960,Max]",Extremamente Elevado,,,,503,Lisboa e Vale do Tejo,SANTARÉM,1405,52138.39,30602,1468,1376,1141,876,643,1519,2660,4036,5504,58.69,10.56,7.74,5.1
19-01-2021,BOMBARRAL,92,7,733,"[480,960]",Muito Elevado,,,,92,Lisboa e Vale do Tejo,LEIRIA,1005,9128.55,12558,875,714,561,491,429,920,1481,2195,3070,137.56,33.63,24.04,16.22
19-01-2021,BORBA,246,18,3652,"[960,Max]",Extremamente Elevado,,,,246,Alentejo,ÉVORA,0703,14518.65,6736,430,375,279,436,392,828,1107,1482,1912,46.39,13.17,10.21,7.62
19-01-2021,BOTICAS,112,8,2241,"[960,Max]",Extremamente Elevado,,,,112,Norte,VILA REAL,1702,32195.66,4998,347,306,311,305,380,685,996,1302,1649,15.52,5.12,4.04,3.09
19-01-2021,BRAGA,2181,156,1194,"[960,Max]",Extremamente Elevado,,,,2181,Norte,BRAGA,0303,18339.95,182679,10029,7963,5241,4320,3671,7991,13232,21195,31224,996.07,170.25,115.57,72.15
19-01-2021,BRAGANÇA,461,33,1372,"[960,Max]",Extremamente Elevado,,,,461,Norte,BRAGANÇA,0402,117357.27,33607,2402,1855,1652,1393,1163,2556,4208,6063,8465,28.64,7.21,5.17,3.59
19-01-2021,CABECEIRAS DE BASTO,173,12,1107,"[960,Max]",Extremamente Elevado,,,,173,Norte,BRAGA,0304,24182.16,15628,774,594,544,575,574,1149,1693,2287,3061,64.63,12.66,9.46,7.0
19-01-2021,CADAVAL,81,6,592,"[480,960]",Muito Elevado,,,,81,Lisboa e Vale do Tejo,LISBOA,1104,17489.3,13673,813,796,756,621,625,1246,2002,2798,3611,78.18,20.65,16.0,11.45
19-01-2021,CALDAS DA RAINHA,429,31,826,"[480,960]",Muito Elevado,,,,429,Lisboa e Vale do Tejo,LEIRIA,1006,25569.47,51912,3035,2684,2186,1899,1705,3604,5790,8474,11509,203.03,45.01,33.14,22.64
19-01-2021,CALHETA,15,1,138,"[0,240]",Moderado,,,,15,Madeira,MADEIRA,3101,11150.43,10867,576,497,507,399,415,814,1321,1818,2394,97.46,21.47,16.3,11.85
19-01-2021,CALHETA (AÇORES),2,0,63,"[0,240]",Moderado,,,,2,Açores,AÇORES,4501,12626.4,3184,215,159,141,139,122,261,402,561,776,25.22,6.15,4.44,3.18
19-01-2021,CÂMARA DE LOBOS,330,24,980,"[960,Max]",Extremamente Elevado,,,,330,Madeira,MADEIRA,3102,5216.67,33675,1396,1059,834,545,381,926,1760,2819,4215,645.49,80.79,54.03,33.74
19-01-2021,CAMINHA,399,28,2513,"[960,Max]",Extremamente Elevado,,,,399,Norte,VIANA DO CASTELO,1602,13652.14,15877,1046,944,818,646,656,1302,2120,3064,4110,116.3,30.11,22.44,15.53
19-01-2021,CAMPO MAIOR,146,10,1854,"[960,Max]",Extremamente Elevado,,,,146,Alentejo,PORTALEGRE,1204,24720.16,7874,471,364,351,279,327,606,957,1321,1792,31.85,7.25,5.34,3.87
19-01-2021,CANTANHEDE,473,34,1351,"[960,Max]",Extremamente Elevado,,,,473,Centro,COIMBRA,0602,39088.02,35011,2346,2096,1880,1709,1451,3160,5040,7136,9482,89.57,24.26,18.26,12.89
19-01-2021,CARRAZEDA DE ANSIÃES,9,1,159,"[0,240]",Moderado,,,,9,Norte,BRAGANÇA,0403,27924.09,5666,424,389,391,312,465,777,1168,1557,1981,20.29,7.09,5.58,4.18
19-01-2021,CARREGAL DO SAL,134,10,1445,"[960,Max]",Extremamente Elevado,,,,134,Centro,VISEU,1802,11689.21,9271,587,562,486,462,376,838,1324,1886,2473,79.31,21.16,16.13,11.33
19-01-2021,CARTAXO,169,12,709,"[480,960]",Muito Elevado,,,,169,Lisboa e Vale do Tejo,SANTARÉM,1406,15817.28,23843,1415,1376,1142,861,632,1493,2635,4011,5426,150.74,34.3,25.36,16.66
19-01-2021,CASCAIS,2326,166,1089,"[960,Max]",Extremamente Elevado,,,,2326,Lisboa e Vale do Tejo,LISBOA,1105,9740.17,213608,12151,11444,8680,6469,5248,11717,20397,31841,43992,2193.1,451.66,326.91,209.41
19-01-2021,CASTANHEIRA DE PÊRA,9,1,344,"[240,480]",Elevado,,,,9,Centro,LEIRIA,1007,6677.45,2614,233,195,157,190,187,377,534,729,962,39.15,14.41,10.92,8.0
19-01-2021,CASTELO BRANCO,677,48,1302,"[960,Max]",Extremamente Elevado,,,,677,Centro,CASTELO BRANCO,0502,143819.15,51987,3528,3042,2499,2229,2225,4454,6953,9995,13523,36.15,9.4,6.95,4.83
19-01-2021,CASTELO DE PAIVA,127,9,822,"[480,960]",Muito Elevado,,,,127,Norte,AVEIRO,0106,11500.53,15454,881,697,545,420,431,851,1396,2093,2974,134.37,25.86,18.2,12.14
19-01-2021,CASTELO DE VIDE,43,3,1473,"[960,Max]",Extremamente Elevado,,,,43,Alentejo,PORTALEGRE,1205,26491.24,2919,204,173,179,147,170,317,496,669,873,11.02,3.3,2.53,1.87
19-01-2021,CASTRO DAIRE,284,20,2055,"[960,Max]",Extremamente Elevado,,,,284,Centro,VISEU,1803,37904.13,13823,942,857,765,732,773,1505,2270,3127,4069,36.47,10.74,8.25,5.99
19-01-2021,CASTRO MARIM,73,5,1170,"[960,Max]",Extremamente Elevado,,,,73,Algarve,FARO,0804,30084.37,6237,370,345,334,322,344,666,1000,1345,1715,20.73,5.7,4.47,3.32
19-01-2021,CASTRO VERDE,32,2,460,"[240,480]",Elevado,,,,32,Alentejo,BEJA,0206,56944.23,6949,437,347,303,275,227,502,805,1152,1589,12.2,2.79,2.02,1.41
19-01-2021,CELORICO DA BEIRA,122,9,1761,"[960,Max]",Extremamente Elevado,,,,122,Centro,GUARDA,0903,24721.63,6928,430,416,363,369,535,904,1267,1683,2113,28.02,8.55,6.81,5.12
19-01-2021,CELORICO DE BASTO,303,22,1591,"[960,Max]",Extremamente Elevado,,,,303,Norte,BRAGA,0305,18107.02,19040,1001,802,668,728,729,1457,2125,2927,3928,105.15,21.69,16.17,11.74
19-01-2021,CHAMUSCA,81,6,881,"[480,960]",Muito Elevado,,,,81,Lisboa e Vale do Tejo,SANTARÉM,1407,74600.54,9197,629,583,553,465,579,1044,1597,2180,2809,12.33,3.77,2.92,2.14
19-01-2021,CHAVES,521,37,1324,"[960,Max]",Extremamente Elevado,,,,521,Norte,VILA REAL,1703,59122.95,39343,2676,2429,1991,1886,1918,3804,5795,8224,10900,66.54,18.44,13.91,9.8
19-01-2021,CINFÃES,158,11,866,"[480,960]",Muito Elevado,,,,158,Norte,VISEU,1804,23928.76,18244,1067,902,779,734,758,1492,2271,3173,4240,76.24,17.72,13.26,9.49
19-01-2021,COIMBRA,2017,144,1503,"[960,Max]",Extremamente Elevado,,,,2017,Centro,COIMBRA,0603,31939.94,134166,9489,8734,6353,5139,5074,10213,16566,25300,34789,420.06,108.92,79.21,51.87
19-01-2021,CONDEIXA-A-NOVA,220,16,1241,"[960,Max]",Extremamente Elevado,,,,220,Centro,COIMBRA,0604,13867.47,17733,871,809,717,583,490,1073,1790,2599,3470,127.88,25.02,18.74,12.91
19-01-2021,CONSTÂNCIA,42,3,1042,"[960,Max]",Extremamente Elevado,,,,42,Lisboa e Vale do Tejo,SANTARÉM,1408,8036.58,4030,211,183,187,148,155,303,490,673,884,50.14,11.0,8.37,6.1
19-01-2021,CORUCHE,162,12,927,"[480,960]",Muito Elevado,,,,162,Lisboa e Vale do Tejo,SANTARÉM,1409,111572.03,17471,1294,1090,1095,1096,1019,2115,3210,4300,5594,15.66,5.01,3.85,2.88
19-01-2021,CORVO,0,0,0,"[0,240]",Moderado,,,,0,Açores,AÇORES,4901,1711.45,464,22,21,11,13,19,32,43,64,86,27.12,5.03,3.74,2.51
19-01-2021,COVILHÃ,477,34,1020,"[960,Max]",Extremamente Elevado,,,,477,Centro,CASTELO BRANCO,0503,55560.06,46787,3533,2998,2365,2111,2193,4304,6669,9667,13200,84.21,23.76,17.4,12.0
19-01-2021,CRATO,31,2,991,"[960,Max]",Extremamente Elevado,,,,31,Alentejo,PORTALEGRE,1206,39806.88,3129,229,258,163,182,228,410,573,831,1060,7.86,2.66,2.09,1.44
19-01-2021,CUBA,286,20,6224,"[960,Max]",Extremamente Elevado,,,,286,Alentejo,BEJA,0207,17208.72,4595,255,233,206,190,143,333,539,772,1027,26.7,5.97,4.49,3.13
19-01-2021,ELVAS,386,28,1880,"[960,Max]",Extremamente Elevado,,,,386,Alentejo,PORTALEGRE,1207,63128.86,20528,1057,1145,902,852,810,1662,2564,3709,4766,32.52,7.55,5.88,4.06
19-01-2021,ENTRONCAMENTO,292,21,1354,"[960,Max]",Extremamente Elevado,,,,292,Lisboa e Vale do Tejo,SANTARÉM,1410,1372.81,21558,1066,930,868,695,592,1287,2155,3085,4151,1570.14,302.33,224.69,156.96
19-01-2021,ESPINHO,260,19,881,"[480,960]",Muito Elevado,,,,260,Norte,AVEIRO,0107,2105.68,29516,2205,1993,1430,1177,960,2137,3567,5560,7765,1401.52,368.71,264.01,169.37
19-01-2021,ESPOSENDE,651,47,1905,"[960,Max]",Extremamente Elevado,,,,651,Norte,BRAGA,0306,9540.98,34177,1831,1522,1095,894,723,1617,2712,4234,6065,358.21,63.57,44.38,28.42
19-01-2021,ESTARREJA,392,28,1507,"[960,Max]",Extremamente Elevado,,,,392,Centro,AVEIRO,0108,10817.33,26006,1503,1399,1106,953,728,1681,2787,4186,5689,240.42,52.59,38.7,25.76
19-01-2021,ESTREMOZ,317,23,2491,"[960,Max]",Extremamente Elevado,,,,317,Alentejo,ÉVORA,0704,51379.95,12728,789,613,697,786,877,1663,2360,2973,3762,24.77,7.32,5.79,4.59
19-01-2021,ÉVORA,605,43,1154,"[960,Max]",Extremamente Elevado,,,,605,Alentejo,ÉVORA,0705,130707.58,52428,3569,2852,2176,1966,1803,3769,5945,8797,12366,40.11,9.46,6.73,4.55
19-01-2021,FAFE,535,38,1113,"[960,Max]",Extremamente Elevado,,,,535,Norte,BRAGA,0307,21908.11,48060,3044,2455,1679,1403,1208,2611,4290,6745,9789,219.37,44.68,30.79,19.58
19-01-2021,FARO,706,50,1157,"[960,Max]",Extremamente Elevado,,,,706,Algarve,FARO,0805,20256.79,61015,3847,3364,2604,2055,1601,3656,6260,9624,13471,301.2,66.5,47.51,30.9
19-01-2021,FELGUEIRAS,637,46,1129,"[960,Max]",Extremamente Elevado,,,,637,Norte,PORTO,1303,11573.75,56422,2951,2302,1601,1316,973,2289,3890,6192,9143,487.49,79.0,53.5,33.61
19-01-2021,FERREIRA DO ALENTEJO,102,7,1300,"[960,Max]",Extremamente Elevado,,,,102,Alentejo,BEJA,0208,64820.68,7845,515,414,372,343,345,688,1060,1474,1989,12.1,3.07,2.27,1.64
19-01-2021,FERREIRA DO ZÊZERE,267,19,3355,"[960,Max]",Extremamente Elevado,,,,267,Lisboa e Vale do Tejo,SANTARÉM,1411,19038.03,7959,470,370,416,465,456,921,1337,1707,2177,41.81,11.44,8.97,7.02
19-01-2021,FIGUEIRA DA FOZ,519,37,883,"[480,960]",Muito Elevado,,,,519,Centro,COIMBRA,0605,37905.26,58747,4032,3597,2887,2495,2043,4538,7425,11022,15054,154.98,39.72,29.08,19.59
19-01-2021,FIGUEIRA DE CASTELO RODRIGO,309,22,5534,"[960,Max]",Extremamente Elevado,,,,309,Centro,GUARDA,0904,50857.46,5584,347,352,290,352,391,743,1033,1385,1732,10.98,3.41,2.72,2.03
19-01-2021,FIGUEIRÓ DOS VINHOS,113,8,2029,"[960,Max]",Extremamente Elevado,,,,113,Centro,LEIRIA,1008,17344.0,5568,402,386,322,309,351,660,982,1368,1770,32.1,10.21,7.89,5.66
19-01-2021,FORNOS DE ALGODRES,190,14,4196,"[960,Max]",Extremamente Elevado,,,,190,Centro,GUARDA,0905,13145.05,4528,261,218,247,256,232,488,735,953,1214,34.45,9.24,7.25,5.59
19-01-2021,FREIXO DE ESPADA À CINTA,12,1,364,"[240,480]",Elevado,,,,12,Norte,BRAGANÇA,0404,24414.29,3298,211,177,231,196,189,385,616,793,1004,13.51,4.11,3.25,2.52
19-01-2021,FRONTEIRA,42,3,1412,"[960,Max]",Extremamente Elevado,,,,42,Alentejo,PORTALEGRE,1208,24859.58,2974,213,182,149,156,168,324,473,655,868,11.96,3.49,2.63,1.9
19-01-2021,FUNCHAL,289,21,278,"[240,480]",Elevado,,,,289,Madeira,MADEIRA,3103,7616.2,104024,6382,5086,3643,2821,1990,4811,8454,13540,19922,1365.86,261.58,177.78,111.0
19-01-2021,FUNDÃO,373,27,1408,"[960,Max]",Extremamente Elevado,,,,373,Centro,CASTELO BRANCO,0504,70019.79,26495,1781,1464,1432,1357,1643,3000,4432,5896,7677,37.84,10.96,8.42,6.33
19-01-2021,GAVIÃO,35,3,1073,"[960,Max]",Extremamente Elevado,,,,35,Alentejo,PORTALEGRE,1209,29459.45,3263,189,186,222,263,293,556,778,964,1153,11.08,3.91,3.27,2.64
19-01-2021,GÓIS,130,9,3417,"[960,Max]",Extremamente Elevado,,,,130,Centro,COIMBRA,0606,26330.19,3805,235,199,240,233,244,477,717,916,1151,14.45,4.37,3.48,2.72
19-01-2021,GOLEGÃ,44,3,824,"[480,960]",Muito Elevado,,,,44,Lisboa e Vale do Tejo,SANTARÉM,1412,8431.67,5339,356,299,281,243,255,498,779,1078,1434,63.32,17.01,12.78,9.24
19-01-2021,GONDOMAR,1901,136,1145,"[960,Max]",Extremamente Elevado,,,,1901,Norte,PORTO,1304,13191.76,165985,10555,8755,6222,4450,3364,7814,14036,22791,33346,1258.22,252.77,172.76,106.4
19-01-2021,GOUVEIA,119,9,961,"[960,Max]",Extremamente Elevado,,,,119,Centro,GUARDA,0906,30061.17,12387,871,931,780,783,810,1593,2373,3304,4175,41.21,13.89,10.99,7.89
19-01-2021,GRÂNDOLA,121,9,827,"[480,960]",Muito Elevado,,,,121,Alentejo,SETÚBAL,1505,82593.66,14639,834,834,708,688,672,1360,2068,2902,3736,17.72,4.52,3.51,2.5
19-01-2021,GUARDA,608,43,1560,"[960,Max]",Extremamente Elevado,,,,608,Centro,GUARDA,0907,71209.58,38969,2477,2041,1686,1415,1474,2889,4575,6616,9093,54.72,12.77,9.29,6.42
19-01-2021,GUIMARÃES,2076,148,1363,"[960,Max]",Extremamente Elevado,,,,2076,Norte,BRAGA,0308,24099.96,152309,9394,7074,4809,3877,2948,6825,11634,18708,28102,631.99,116.61,77.63,48.27
19-01-2021,HORTA,10,1,69,"[0,240]",Moderado,,,,10,Açores,AÇORES,4701,17305.53,14521,818,658,468,352,302,654,1122,1780,2598,83.91,15.01,10.29,6.48
19-01-2021,IDANHA-A-NOVA,106,8,1318,"[960,Max]",Extremamente Elevado,,,,106,Centro,CASTELO BRANCO,0505,141633.51,8043,518,490,519,672,974,1646,2165,2655,3173,5.68,2.24,1.87,1.53
19-01-2021,ÍLHAVO,397,28,1026,"[960,Max]",Extremamente Elevado,,,,397,Centro,AVEIRO,0110,7347.55,38699,2227,1943,1444,1193,850,2043,3487,5430,7657,526.66,104.21,73.9,47.46
19-01-2021,LAGOA (FARO),124,9,545,"[480,960]",Muito Elevado,,,,124,Algarve,FARO,0806,8825.45,22762,1314,1168,919,749,670,1419,2338,3506,4820,257.93,54.62,39.73,26.49
19-01-2021,LAGOA,62,4,421,"[240,480]",Elevado,,,,62,Açores,AÇORES,4201,4559.32,14721,536,458,349,238,235,473,822,1280,1816,322.9,39.83,28.08,18.03
19-01-2021,LAGOS,223,16,734,"[480,960]",Muito Elevado,,,,223,Algarve,FARO,0807,21299.27,30374,1744,1434,1247,1053,1029,2082,3329,4763,6507,142.61,30.55,22.36,15.63
19-01-2021,LAJES DAS FLORES,2,0,137,"[0,240]",Moderado,,,,2,Açores,AÇORES,4801,7004.79,1463,88,53,62,46,54,100,162,215,303,20.89,4.33,3.07,2.31
19-01-2021,LAJES DO PICO,0,0,0,"[0,240]",Moderado,,,,0,Açores,AÇORES,4601,15531.09,4490,304,231,223,159,162,321,544,775,1079,28.91,6.95,4.99,3.5
19-01-2021,LAMEGO,378,27,1518,"[960,Max]",Extremamente Elevado,,,,378,Norte,VISEU,1805,16542.11,24895,1639,1284,1124,898,783,1681,2805,4089,5728,150.5,34.63,24.72,16.96
19-01-2021,LEIRIA,1437,103,1147,"[960,Max]",Extremamente Elevado,,,,1437,Centro,LEIRIA,1009,56508.83,125267,7389,6366,5090,3902,3159,7061,12151,18517,25906,221.68,45.84,32.77,21.5
19-01-2021,LISBOA,7154,511,1404,"[960,Max]",Extremamente Elevado,,,,7154,Lisboa e Vale do Tejo,LISBOA,1106,10005.43,509515,33197,33340,27706,23037,26770,49807,77513,110853,144050,5092.6,1439.78,1107.98,774.74
19-01-2021,LOULÉ,966,69,1406,"[960,Max]",Extremamente Elevado,,,,966,Algarve,FARO,0808,76366.91,68697,3890,3350,2780,2358,2251,4609,7389,10739,14629,89.96,19.16,14.06,9.68
19-01-2021,LOURES,3105,222,1453,"[960,Max]",Extremamente Elevado,,,,3105,Lisboa e Vale do Tejo,LISBOA,1107,16723.99,213687,12746,12794,9644,6669,5033,11702,21346,34140,46886,1277.73,280.35,204.14,127.64
19-01-2021,LOURINHÃ,195,14,754,"[480,960]",Muito Elevado,,,,195,Lisboa e Vale do Tejo,LISBOA,1108,14717.2,25855,1584,1243,992,842,645,1487,2479,3722,5306,175.68,36.05,25.29,16.84
19-01-2021,LOUSÃ,173,12,1008,"[960,Max]",Extremamente Elevado,,,,173,Centro,COIMBRA,0607,13840.01,17158,946,866,658,528,450,978,1636,2502,3448,123.97,24.91,18.08,11.82
19-01-2021,LOUSADA,326,23,697,"[480,960]",Muito Elevado,,,,326,Norte,PORTO,1305,9608.01,46755,2289,1698,1176,853,621,1474,2650,4348,6637,486.63,69.08,45.25,27.58
19-01-2021,MAÇÃO,116,8,1851,"[960,Max]",Extremamente Elevado,,,,116,Lisboa e Vale do Tejo,SANTARÉM,1413,39997.98,6267,386,362,390,440,657,1097,1487,1849,2235,15.67,5.59,4.62,3.72
19-01-2021,MACEDO DE CAVALEIROS,166,12,1144,"[960,Max]",Extremamente Elevado,,,,166,Norte,BRAGANÇA,0405,69914.08,14516,1082,889,878,823,938,1761,2639,3528,4610,20.76,6.59,5.05,3.77
19-01-2021,MACHICO,88,6,440,"[240,480]",Elevado,,,,88,Madeira,MADEIRA,3104,6825.1,19981,1197,860,662,455,331,786,1448,2308,3505,292.76,51.36,33.82,21.22
19-01-2021,MADALENA,2,0,34,"[0,240]",Moderado,,,,2,Açores,AÇORES,4602,14712.33,5895,334,256,173,190,179,369,542,798,1132,40.07,7.69,5.42,3.68
19-01-2021,MAFRA,1355,97,1598,"[960,Max]",Extremamente Elevado,,,,1355,Lisboa e Vale do Tejo,LISBOA,1109,29165.5,84816,3613,3334,2839,2089,1899,3988,6827,10161,13774,290.81,47.23,34.84,23.41
19-01-2021,MAIA,1078,77,776,"[480,960]",Muito Elevado,,,,1078,Norte,PORTO,1306,8293.94,138971,7801,6617,4512,3339,2631,5970,10482,17099,24900,1675.56,300.22,206.16,126.38
19-01-2021,MANGUALDE,321,23,1734,"[960,Max]",Extremamente Elevado,,,,321,Centro,VISEU,1806,21925.56,18510,1198,1128,885,852,743,1595,2480,3608,4806,84.42,21.92,16.46,11.31
19-01-2021,MANTEIGAS,36,3,1197,"[960,Max]",Extremamente Elevado,,,,36,Centro,GUARDA,0908,12197.55,3007,258,197,159,167,146,313,472,669,927,24.65,7.6,5.48,3.87
19-01-2021,MARCO DE CANAVESES,355,25,689,"[480,960]",Muito Elevado,,,,355,Norte,PORTO,1307,20188.98,51496,2678,2060,1488,1265,1023,2288,3776,5836,8514,255.07,42.17,28.91,18.7
19-01-2021,MARINHA GRANDE,386,28,1002,"[960,Max]",Extremamente Elevado,,,,386,Centro,LEIRIA,1010,18725.19,38508,2365,2302,1638,1359,1058,2417,4055,6357,8722,205.65,46.58,33.95,21.66
19-01-2021,MARVÃO,33,2,1098,"[960,Max]",Extremamente Elevado,,,,33,Alentejo,PORTALEGRE,1210,15489.9,3005,198,185,142,197,237,434,576,761,959,19.4,6.19,4.91,3.72
19-01-2021,MATOSINHOS,1576,113,899,"[480,960]",Muito Elevado,,,,1576,Norte,PORTO,1308,6241.97,175357,11850,9977,7023,5024,3884,8908,15931,25908,37758,2809.31,604.9,415.06,255.22
19-01-2021,MEALHADA,396,28,1989,"[960,Max]",Extremamente Elevado,,,,396,Centro,AVEIRO,0111,11065.66,19914,1163,1039,810,828,831,1659,2469,3508,4671,179.96,42.21,31.7,22.31
19-01-2021,MÊDA,136,10,2965,"[960,Max]",Extremamente Elevado,,,,136,Centro,GUARDA,0909,28604.92,4587,343,306,290,288,443,731,1021,1327,1670,16.04,5.84,4.64,3.57
19-01-2021,MELGAÇO,154,11,1903,"[960,Max]",Extremamente Elevado,,,,154,Norte,VIANA DO CASTELO,1603,23824.58,8093,507,567,578,614,675,1289,1867,2434,2941,33.97,12.34,10.22,7.84
19-01-2021,MÉRTOLA,73,5,1189,"[960,Max]",Extremamente Elevado,,,,73,Alentejo,BEJA,0209,129287.34,6142,400,390,378,423,600,1023,1401,1791,2191,4.75,1.69,1.39,1.08
19-01-2021,MESÃO FRIO,28,2,706,"[480,960]",Muito Elevado,,,,28,Norte,VILA REAL,1704,2664.87,3964,265,205,168,157,120,277,445,650,915,148.74,34.33,24.39,16.7
19-01-2021,MIRA,91,6,769,"[480,960]",Muito Elevado,,,,91,Centro,COIMBRA,0608,12403.38,11832,727,729,659,550,466,1016,1675,2404,3131,95.4,25.24,19.38,13.5
19-01-2021,MIRANDA DO CORVO,191,14,1503,"[960,Max]",Extremamente Elevado,,,,191,Centro,COIMBRA,0609,12637.79,12708,706,659,568,498,404,902,1470,2129,2835,100.55,22.43,16.85,11.63
19-01-2021,MIRANDA DO DOURO,153,11,2240,"[960,Max]",Extremamente Elevado,,,,153,Norte,BRAGANÇA,0406,48718.31,6830,482,429,442,463,470,933,1375,1804,2286,14.02,4.69,3.7,2.82
19-01-2021,MIRANDELA,244,17,1122,"[960,Max]",Extremamente Elevado,,,,244,Norte,BRAGANÇA,0407,65895.67,21754,1640,1315,1204,1078,947,2025,3229,4544,6184,33.01,9.38,6.9,4.9
19-01-2021,MOGADOURO,245,17,2919,"[960,Max]",Extremamente Elevado,,,,245,Norte,BRAGANÇA,0408,76064.93,8392,589,529,576,630,655,1285,1861,2390,2979,11.03,3.92,3.14,2.45
19-01-2021,MOIMENTA DA BEIRA,264,19,2712,"[960,Max]",Extremamente Elevado,,,,264,Norte,VISEU,1807,21996.9,9736,576,514,471,416,461,877,1348,1862,2438,44.26,11.08,8.46,6.13
19-01-2021,MOITA,871,62,1352,"[960,Max]",Extremamente Elevado,,,,871,Lisboa e Vale do Tejo,SETÚBAL,1506,5525.98,64407,4226,3646,2623,1801,1425,3226,5849,9495,13721,1165.53,248.3,171.82,105.85
19-01-2021,MONÇÃO,160,11,895,"[480,960]",Muito Elevado,,,,160,Norte,VIANA DO CASTELO,1604,21130.85,17869,1161,1105,1031,1006,972,1978,3009,4114,5275,84.56,24.96,19.47,14.24
19-01-2021,MONCHIQUE,2,0,39,"[0,240]",Moderado,,,,2,Algarve,FARO,0809,39530.43,5077,353,384,321,355,392,747,1068,1452,1805,12.84,4.57,3.67,2.7
19-01-2021,MONDIM DE BASTO,65,5,936,"[480,960]",Muito Elevado,,,,65,Norte,VILA REAL,1705,17207.52,6946,395,300,314,284,283,567,881,1181,1576,40.36,9.16,6.86,5.12
19-01-2021,MONFORTE,64,5,2151,"[960,Max]",Extremamente Elevado,,,,64,Alentejo,PORTALEGRE,1211,42024.82,2975,139,115,117,192,168,360,477,592,731,7.08,1.74,1.41,1.14
19-01-2021,MONTALEGRE,124,9,1378,"[960,Max]",Extremamente Elevado,,,,124,Norte,VILA REAL,1706,80545.71,8997,699,628,595,603,730,1333,1928,2556,3255,11.17,4.04,3.17,2.39
19-01-2021,MONTEMOR-O-NOVO,248,18,1585,"[960,Max]",Extremamente Elevado,,,,248,Alentejo,ÉVORA,0706,123296.65,15647,991,953,868,878,971,1849,2717,3670,4661,12.69,3.78,2.98,2.2
19-01-2021,MONTEMOR-O-VELHO,229,16,908,"[480,960]",Muito Elevado,,,,229,Centro,COIMBRA,0610,22896.23,25224,1496,1397,1217,1057,988,2045,3262,4659,6155,110.17,26.88,20.35,14.25
19-01-2021,MONTIJO,584,42,1014,"[960,Max]",Extremamente Elevado,,,,584,Lisboa e Vale do Tejo,SETÚBAL,1507,34861.64,57614,2771,2441,1990,1554,1109,2663,4653,7094,9865,165.26,28.3,20.35,13.35
19-01-2021,MORA,56,4,1353,"[960,Max]",Extremamente Elevado,,,,56,Alentejo,ÉVORA,0707,44395.02,4138,336,275,252,238,257,495,747,1022,1358,9.32,3.06,2.3,1.68
19-01-2021,MORTÁGUA,102,7,1159,"[960,Max]",Extremamente Elevado,,,,102,Centro,VISEU,1808,25117.82,8803,638,584,535,499,460,959,1494,2078,2716,35.05,10.81,8.27,5.95
19-01-2021,MOURA,212,15,1545,"[960,Max]",Extremamente Elevado,,,,212,Alentejo,BEJA,0210,95845.55,13718,817,656,665,542,461,1003,1668,2324,3141,14.31,3.28,2.42,1.74
19-01-2021,MOURÃO,20,1,816,"[480,960]",Muito Elevado,,,,20,Alentejo,ÉVORA,0708,27862.98,2450,139,108,80,104,109,213,293,401,540,8.79,1.94,1.44,1.05
19-01-2021,MURÇA,89,6,1629,"[960,Max]",Extremamente Elevado,,,,89,Norte,VILA REAL,1707,18937.11,5463,384,341,307,306,319,625,932,1273,1657,28.85,8.75,6.72,4.92
19-01-2021,MURTOSA,226,16,2199,"[960,Max]",Extremamente Elevado,,,,226,Centro,AVEIRO,0112,7308.78,10279,509,473,403,353,409,762,1165,1638,2147,140.63,29.37,22.41,15.94
19-01-2021,NAZARÉ,143,10,1010,"[960,Max]",Extremamente Elevado,,,,143,Lisboa e Vale do Tejo,LEIRIA,1011,8243.43,14165,967,903,670,420,396,816,1486,2389,3356,171.84,40.71,28.98,18.03
19-01-2021,NELAS,280,20,2158,"[960,Max]",Extremamente Elevado,,,,280,Centro,VISEU,1809,12571.48,12974,924,787,668,604,583,1187,1855,2642,3566,103.21,28.37,21.02,14.76
19-01-2021,NISA,152,11,2508,"[960,Max]",Extremamente Elevado,,,,152,Alentejo,PORTALEGRE,1212,57567.84,6061,405,389,355,483,478,961,1316,1705,2110,10.53,3.67,2.96,2.29
19-01-2021,NORDESTE,4,0,82,"[0,240]",Moderado,,,,4,Açores,AÇORES,4202,10146.8,4862,246,180,124,161,162,323,447,627,873,47.92,8.6,6.18,4.41
19-01-2021,ÓBIDOS,122,9,1030,"[960,Max]",Extremamente Elevado,,,,122,Lisboa e Vale do Tejo,LEIRIA,1012,14155.44,11850,743,650,574,452,436,888,1462,2112,2855,83.72,20.17,14.92,10.33
19-01-2021,ODEMIRA,109,8,441,"[240,480]",Elevado,,,,109,Alentejo,BEJA,0211,172060.15,24717,1475,1317,1225,1397,1349,2746,3971,5288,6763,14.37,3.93,3.07,2.31
19-01-2021,ODIVELAS,2368,169,1464,"[960,Max]",Extremamente Elevado,,,,2368,Lisboa e Vale do Tejo,LISBOA,1116,2654.36,161774,9562,9038,6952,4641,3812,8453,15405,24443,34005,6095.48,1281.27,920.99,580.44
19-01-2021,OEIRAS,1998,143,1126,"[960,Max]",Extremamente Elevado,,,,1998,Lisboa e Vale do Tejo,LISBOA,1110,4588.31,177408,11580,11575,8566,6211,5855,12066,20632,32207,43787,3866.78,954.38,701.98,449.69
19-01-2021,OLEIROS,31,2,620,"[480,960]",Muito Elevado,,,,31,Centro,CASTELO BRANCO,0506,47109.31,5003,384,341,366,397,487,884,1250,1591,1975,10.62,4.19,3.38,2.65
19-01-2021,OLHÃO,393,28,885,"[480,960]",Muito Elevado,,,,393,Algarve,FARO,0810,13086.38,44405,2455,2309,1689,1342,1268,2610,4299,6608,9063,339.33,69.26,50.5,32.85
19-01-2021,OLIVEIRA DE AZEMÉIS,795,57,1204,"[960,Max]",Extremamente Elevado,,,,795,Norte,AVEIRO,0113,16110.41,66011,4155,3614,2794,2183,1738,3921,6715,10329,14484,409.75,89.91,64.12,41.68
19-01-2021,OLIVEIRA DE FRADES,229,16,2305,"[960,Max]",Extremamente Elevado,,,,229,Centro,VISEU,1810,14534.62,9936,553,475,438,359,415,774,1212,1687,2240,68.36,15.41,11.61,8.34
19-01-2021,OLIVEIRA DO BAIRRO,291,21,1199,"[960,Max]",Extremamente Elevado,,,,291,Centro,AVEIRO,0114,8731.99,24277,1327,1182,999,786,810,1596,2595,3777,5104,278.02,58.45,43.25,29.72
19-01-2021,OLIVEIRA DO HOSPITAL,233,17,1210,"[960,Max]",Extremamente Elevado,,,,233,Centro,COIMBRA,0611,23451.66,19253,1161,1097,962,924,960,1884,2846,3943,5104,82.1,21.76,16.81,12.14
19-01-2021,OURÉM,791,57,1796,"[960,Max]",Extremamente Elevado,,,,791,Lisboa e Vale do Tejo,SANTARÉM,1421,41668.03,44044,2463,2069,1899,1817,1603,3420,5319,7388,9851,105.7,23.64,17.73,12.77
19-01-2021,OURIQUE,70,5,1519,"[960,Max]",Extremamente Elevado,,,,70,Alentejo,BEJA,0212,66331.36,4607,313,287,284,268,227,495,779,1066,1379,6.95,2.08,1.61,1.17
19-01-2021,OVAR,861,62,1587,"[960,Max]",Extremamente Elevado,,,,861,Centro,AVEIRO,0115,14770.25,54260,3294,2709,1994,1636,1234,2870,4864,7573,10867,367.37,73.57,51.27,32.93
19-01-2021,PAÇOS DE FERREIRA,330,24,582,"[480,960]",Muito Elevado,,,,330,Norte,PORTO,1309,7099.29,56728,2903,2193,1518,1135,664,1799,3317,5510,8413,799.1,118.51,77.62,46.72
19-01-2021,PALMELA,1109,79,1726,"[960,Max]",Extremamente Elevado,,,,1109,Lisboa e Vale do Tejo,SETÚBAL,1508,46512.01,64269,3402,3244,2635,1846,1391,3237,5872,9116,12518,138.18,26.91,19.6,12.62
19-01-2021,PAMPILHOSA DA SERRA,129,9,3195,"[960,Max]",Extremamente Elevado,,,,129,Centro,COIMBRA,0612,39646.24,4037,238,254,295,339,423,762,1057,1311,1549,10.18,3.91,3.31,2.67
19-01-2021,PAREDES,738,53,857,"[480,960]",Muito Elevado,,,,738,Norte,PORTO,1310,15675.69,86067,4272,3532,2412,1717,1258,2975,5387,8919,13191,549.04,84.15,56.9,34.36
19-01-2021,PAREDES DE COURA,161,11,1886,"[960,Max]",Extremamente Elevado,,,,161,Norte,VIANA DO CASTELO,1605,13818.59,8535,466,528,407,465,515,980,1387,1915,2381,61.76,17.23,13.86,10.04
19-01-2021,PEDRÓGÃO GRANDE,75,5,2199,"[960,Max]",Extremamente Elevado,,,,75,Centro,LEIRIA,1013,12874.75,3410,175,173,196,221,252,473,669,842,1017,26.49,7.9,6.54,5.2
19-01-2021,PENACOVA,334,24,2439,"[960,Max]",Extremamente Elevado,,,,334,Centro,COIMBRA,0613,21673.23,13694,968,923,745,621,703,1324,2069,2992,3960,63.18,18.27,13.81,9.55
19-01-2021,PENAFIEL,646,46,926,"[480,960]",Muito Elevado,,,,646,Norte,PORTO,1311,21224.27,69772,3648,2823,2032,1663,1230,2893,4925,7748,11396,328.74,53.69,36.51,23.2
19-01-2021,PENALVA DO CASTELO,269,19,3781,"[960,Max]",Extremamente Elevado,,,,269,Centro,VISEU,1811,13433.92,7115,449,457,413,391,426,817,1230,1687,2136,52.96,15.9,12.56,9.16
19-01-2021,PENAMACOR,62,4,1304,"[960,Max]",Extremamente Elevado,,,,62,Centro,CASTELO BRANCO,0507,56370.69,4755,262,248,273,451,633,1084,1357,1605,1867,8.44,3.31,2.85,2.41
19-01-2021,PENEDONO,56,4,2161,"[960,Max]",Extremamente Elevado,,,,56,Norte,VISEU,1812,13370.75,2591,172,113,129,156,138,294,423,536,708,19.38,5.3,4.01,3.16
19-01-2021,PENELA,38,3,704,"[480,960]",Muito Elevado,,,,38,Centro,COIMBRA,0614,13480.0,5397,314,324,274,359,344,703,977,1301,1615,40.04,11.98,9.65,7.25
19-01-2021,PENICHE,345,25,1302,"[960,Max]",Extremamente Elevado,,,,345,Lisboa e Vale do Tejo,LEIRIA,1014,7754.98,26501,1746,1504,1203,926,707,1633,2836,4340,6086,341.73,78.48,55.96,36.57
19-01-2021,PESO DA RÉGUA,273,20,1731,"[960,Max]",Extremamente Elevado,,,,273,Norte,VILA REAL,1708,9486.01,15773,1076,843,650,659,455,1114,1764,2607,3683,166.28,38.83,27.48,18.6
19-01-2021,PINHEL,210,15,2467,"[960,Max]",Extremamente Elevado,,,,210,Centro,GUARDA,0910,48452.12,8511,577,566,551,538,689,1227,1778,2344,2921,17.57,6.03,4.84,3.67
19-01-2021,POMBAL,870,62,1691,"[960,Max]",Extremamente Elevado,,,,870,Centro,LEIRIA,1015,62600.28,51461,3187,2791,2494,2328,2027,4355,6849,9640,12827,82.21,20.49,15.4,10.94
19-01-2021,PONTA DELGADA,175,13,258,"[240,480]",Elevado,,,,175,Açores,AÇORES,4203,23298.65,67935,3108,2435,1726,1133,902,2035,3761,6196,9304,291.58,39.93,26.59,16.14
19-01-2021,PONTA DO SOL,21,1,244,"[240,480]",Elevado,,,,21,Madeira,MADEIRA,3105,4622.03,8593,319,283,347,208,221,429,776,1059,1378,185.92,29.81,22.91,16.79
19-01-2021,PONTE DA BARCA,261,19,2335,"[960,Max]",Extremamente Elevado,,,,261,Norte,VIANA DO CASTELO,1606,18211.37,11180,635,576,517,554,490,1044,1561,2137,2772,61.39,15.22,11.73,8.57
19-01-2021,PONTE DE LIMA,675,48,1634,"[960,Max]",Extremamente Elevado,,,,675,Norte,VIANA DO CASTELO,1607,32025.46,41315,2321,2022,1720,1596,1462,3058,4778,6800,9121,129.01,28.48,21.23,14.92
19-01-2021,PONTE DE SOR,250,18,1667,"[960,Max]",Extremamente Elevado,,,,250,Alentejo,PORTALEGRE,1213,83971.16,14994,939,800,716,739,831,1570,2286,3086,4025,17.86,4.79,3.68,2.72
19-01-2021,PORTALEGRE,181,13,816,"[480,960]",Muito Elevado,,,,181,Alentejo,PORTALEGRE,1214,44713.64,22172,1577,1351,1137,993,984,1977,3114,4465,6042,49.59,13.51,9.99,6.96
19-01-2021,PORTEL,74,5,1270,"[960,Max]",Extremamente Elevado,,,,74,Alentejo,ÉVORA,0709,60100.57,5828,336,358,283,331,305,636,919,1277,1613,9.7,2.68,2.12,1.53
19-01-2021,PORTIMÃO,261,19,470,"[240,480]",Elevado,,,,261,Algarve,FARO,0811,18206.29,55483,3182,2927,2116,1582,1400,2982,5098,8025,11207,304.75,61.56,44.08,28.0
19-01-2021,PORTO,1988,142,918,"[480,960]",Muito Elevado,,,,1988,Norte,PORTO,1312,4142.02,216606,15790,15193,11280,9409,10044,19453,30733,45926,61716,5229.5,1490.0,1108.79,741.98
19-01-2021,PORTO DE MÓS,330,24,1418,"[960,Max]",Extremamente Elevado,,,,330,Centro,LEIRIA,1016,26183.41,23275,1355,1210,1034,888,872,1760,2794,4004,5359,88.89,20.47,15.29,10.67
19-01-2021,PORTO MONIZ,9,1,384,"[240,480]",Elevado,,,,9,Madeira,MADEIRA,3106,8293.38,2342,143,130,95,98,120,218,313,443,586,28.24,7.07,5.34,3.77
19-01-2021,PORTO SANTO,54,4,1038,"[960,Max]",Extremamente Elevado,,,,54,Madeira,MADEIRA,3201,4300.7,5202,240,157,134,110,68,178,312,469,709,120.95,16.48,10.9,7.25
19-01-2021,PÓVOA DE LANHOSO,372,27,1730,"[960,Max]",Extremamente Elevado,,,,372,Norte,BRAGA,0309,13465.29,21499,1175,909,732,673,624,1297,2029,2938,4113,159.67,30.55,21.82,15.07
19-01-2021,PÓVOA DE VARZIM,1003,72,1598,"[960,Max]",Extremamente Elevado,,,,1003,Norte,PORTO,1313,8220.59,62784,3712,3120,2134,1594,1305,2899,5033,8153,11865,763.7,144.33,99.17,61.22
19-01-2021,POVOAÇÃO,4,0,67,"[0,240]",Moderado,,,,4,Açores,AÇORES,4204,10640.77,5927,293,212,191,144,134,278,469,681,974,55.7,9.15,6.4,4.41
19-01-2021,VILA DA PRAIA DA VITÓRIA,23,2,108,"[0,240]",Moderado,,,,23,Açores,AÇORES,4302,16127.06,21317,1133,789,619,436,336,772,1391,2180,3313,132.18,20.54,13.52,8.63
19-01-2021,PROENÇA-A-NOVA,28,2,384,"[240,480]",Elevado,,,,28,Centro,CASTELO BRANCO,0508,39539.96,7298,508,465,389,400,560,960,1349,1814,2322,18.46,5.87,4.59,3.41
19-01-2021,REDONDO,81,6,1275,"[960,Max]",Extremamente Elevado,,,,81,Alentejo,ÉVORA,0710,36950.87,6353,349,325,288,288,354,642,930,1255,1604,17.19,4.34,3.4,2.52
19-01-2021,REGUENGOS DE MONSARAZ,200,14,1997,"[960,Max]",Extremamente Elevado,,,,200,Alentejo,ÉVORA,0711,46399.72,10015,602,511,455,462,473,935,1390,1901,2503,21.58,5.39,4.1,3.0
19-01-2021,RESENDE,35,2,345,"[240,480]",Elevado,,,,35,Norte,VISEU,1813,12334.93,10137,560,493,448,433,422,855,1303,1796,2356,82.18,19.1,14.56,10.56
19-01-2021,RIBEIRA BRAVA,46,3,370,"[240,480]",Elevado,,,,46,Madeira,MADEIRA,3107,6544.88,12435,648,500,411,311,287,598,1009,1509,2157,189.99,32.96,23.06,15.42
19-01-2021,RIBEIRA DE PENA,115,8,1912,"[960,Max]",Extremamente Elevado,,,,115,Norte,VILA REAL,1709,21745.98,6016,371,301,290,310,368,678,968,1269,1640,27.66,7.54,5.84,4.45
19-01-2021,RIBEIRA GRANDE,522,37,1591,"[960,Max]",Extremamente Elevado,,,,522,Açores,AÇORES,4205,18015.13,32811,1163,689,512,345,253,598,1110,1799,2962,182.13,16.44,9.99,6.16
19-01-2021,RIO MAIOR,357,26,1752,"[960,Max]",Extremamente Elevado,,,,357,Lisboa e Vale do Tejo,SANTARÉM,1414,27276.45,20379,1251,1144,941,795,648,1443,2384,3528,4779,74.71,17.52,12.93,8.74
19-01-2021,SABROSA,48,3,811,"[480,960]",Muito Elevado,,,,48,Norte,VILA REAL,1710,15692.45,5918,393,314,304,302,350,652,956,1270,1663,37.71,10.6,8.09,6.09
19-01-2021,SABUGAL,111,8,1049,"[960,Max]",Extremamente Elevado,,,,111,Centro,GUARDA,0911,82269.82,10585,724,707,694,796,1009,1805,2499,3206,3930,12.87,4.78,3.9,3.04
19-01-2021,SALVATERRA DE MAGOS,286,20,1343,"[960,Max]",Extremamente Elevado,,,,286,Lisboa e Vale do Tejo,SANTARÉM,1415,24393.2,21295,1275,1181,1060,799,772,1571,2631,3812,5087,87.3,20.85,15.63,10.79
19-01-2021,SANTA COMBA DÃO,129,9,1234,"[960,Max]",Extremamente Elevado,,,,129,Centro,VISEU,1814,11194.77,10452,732,684,569,538,464,1002,1571,2255,2987,93.36,26.68,20.14,14.03
19-01-2021,SANTA CRUZ,198,14,437,"[240,480]",Elevado,,,,198,Madeira,MADEIRA,3108,8150.28,45281,1817,1301,974,716,523,1239,2213,3514,5331,555.6,65.41,43.12,27.15
19-01-2021,SANTA CRUZ DA GRACIOSA,1,0,24,"[0,240]",Moderado,,,,1,Açores,AÇORES,4401,6065.78,4208,228,180,163,124,145,269,432,612,840,69.37,13.85,10.09,7.12
19-01-2021,SANTA CRUZ DAS FLORES,2,0,92,"[0,240]",Moderado,,,,2,Açores,AÇORES,4802,7091.44,2165,125,98,74,56,51,107,181,279,404,30.53,5.7,3.93,2.55
19-01-2021,SANTA MARIA DA FEIRA,2073,148,1495,"[960,Max]",Extremamente Elevado,,,,2073,Norte,AVEIRO,0109,21587.65,138636,8182,6743,4771,3856,3079,6935,11706,18449,26631,642.19,123.36,85.46,54.22
19-01-2021,SANTA MARTA DE PENAGUIÃO,102,7,1546,"[960,Max]",Extremamente Elevado,,,,102,Norte,VILA REAL,1711,6928.13,6599,483,373,337,316,317,633,970,1343,1826,95.25,26.36,19.39,14.0
19-01-2021,SANTANA,22,2,328,"[240,480]",Elevado,,,,22,Madeira,MADEIRA,3109,9547.3,6711,418,353,343,282,277,559,902,1255,1673,70.29,17.52,13.15,9.45
19-01-2021,SANTARÉM,803,57,1398,"[960,Max]",Extremamente Elevado,,,,803,Lisboa e Vale do Tejo,SANTARÉM,1416,55253.58,57421,3654,3441,2760,2466,2206,4672,7432,10873,14527,103.92,26.29,19.68,13.45
19-01-2021,SANTIAGO DO CACÉM,139,10,483,"[480,960]",Muito Elevado,,,,139,Alentejo,SETÚBAL,1509,105969.29,28791,2144,1689,1472,1295,1215,2510,3982,5671,7815,27.17,7.37,5.35,3.76
19-01-2021,SANTO TIRSO,978,70,1437,"[960,Max]",Extremamente Elevado,,,,978,Norte,PORTO,1314,13655.52,68055,4911,3935,2761,2257,1810,4067,6828,10763,15674,498.35,114.78,78.82,50.0
19-01-2021,SÃO BRÁS DE ALPORTEL,51,4,490,"[480,960]",Muito Elevado,,,,51,Algarve,FARO,0812,15336.92,10416,596,468,467,404,401,805,1272,1740,2336,67.91,15.23,11.35,8.29
19-01-2021,SÃO JOÃO DA MADEIRA,297,21,1353,"[960,Max]",Extremamente Elevado,,,,297,Norte,AVEIRO,0116,794.3,21958,1347,1069,796,601,593,1194,1990,3059,4406,2765.49,554.91,385.26,250.63
19-01-2021,SÃO JOÃO DA PESQUEIRA,154,11,2161,"[960,Max]",Extremamente Elevado,,,,154,Norte,VISEU,1815,26610.85,7125,417,330,294,328,328,656,950,1280,1697,26.77,6.38,4.81,3.57
19-01-2021,SÃO PEDRO DO SUL,317,23,2058,"[960,Max]",Extremamente Elevado,,,,317,Centro,VISEU,1816,34895.09,15403,990,962,861,759,909,1668,2529,3491,4481,44.14,12.84,10.0,7.25
19-01-2021,SÃO ROQUE DO PICO,0,0,0,"[0,240]",Moderado,,,,0,Açores,AÇORES,4603,14236.1,3266,199,141,93,96,113,209,302,443,642,22.94,4.51,3.11,2.12
19-01-2021,SÃO VICENTE,4,0,78,"[0,240]",Moderado,,,,4,Madeira,MADEIRA,3110,7883.71,5143,272,264,266,225,280,505,771,1035,1307,65.23,16.58,13.13,9.78
19-01-2021,SARDOAL,17,1,454,"[240,480]",Elevado,,,,17,Lisboa e Vale do Tejo,SANTARÉM,1417,9214.72,3741,227,178,148,165,248,413,561,739,966,40.6,10.48,8.02,6.09
19-01-2021,SÁTÃO,280,20,2418,"[960,Max]",Extremamente Elevado,,,,280,Centro,VISEU,1817,20194.11,11580,765,671,515,465,476,941,1456,2127,2892,57.34,14.32,10.53,7.21
19-01-2021,SEIA,272,19,1223,"[960,Max]",Extremamente Elevado,,,,272,Centro,GUARDA,0912,43568.83,22234,1807,1589,1238,1122,721,1843,3081,4670,6477,51.03,14.87,10.72,7.07
19-01-2021,SEIXAL,1864,133,1111,"[960,Max]",Extremamente Elevado,,,,1864,Lisboa e Vale do Tejo,SETÚBAL,1510,9545.17,167752,10586,9270,6661,4391,2930,7321,13982,23252,33838,1757.49,354.51,243.6,146.49
19-01-2021,SERNANCELHE,174,12,3225,"[960,Max]",Extremamente Elevado,,,,174,Norte,VISEU,1818,22861.22,5396,305,293,286,273,260,533,819,1112,1417,23.6,6.2,4.86,3.58
19-01-2021,SERPA,80,6,559,"[480,960]",Muito Elevado,,,,80,Alentejo,BEJA,0213,110563.34,14304,903,761,719,697,626,1323,2042,2803,3706,12.94,3.35,2.54,1.85
19-01-2021,SERTÃ,210,15,1441,"[960,Max]",Extremamente Elevado,,,,210,Centro,CASTELO BRANCO,0509,44673.17,14577,870,779,790,767,1020,1787,2577,3356,4226,32.63,9.46,7.51,5.77
19-01-2021,SESIMBRA,544,39,1049,"[960,Max]",Extremamente Elevado,,,,544,Lisboa e Vale do Tejo,SETÚBAL,1511,19571.75,51858,2400,2321,1853,1257,1083,2340,4193,6514,8914,264.96,45.54,33.28,21.42
19-01-2021,SETÚBAL,2564,183,2227,"[960,Max]",Extremamente Elevado,,,,2564,Lisboa e Vale do Tejo,SETÚBAL,1512,23032.5,115126,7425,6929,5075,3775,2655,6430,11505,18434,25859,499.83,112.27,80.03,49.95
19-01-2021,SEVER DO VOUGA,236,17,2083,"[960,Max]",Extremamente Elevado,,,,236,Centro,AVEIRO,0117,12987.56,11331,766,637,568,540,567,1107,1675,2312,3078,87.24,23.7,17.8,12.9
19-01-2021,SILVES,246,18,679,"[480,960]",Muito Elevado,,,,246,Algarve,FARO,0813,68006.23,36226,2137,1869,1610,1423,1600,3023,4633,6502,8639,53.27,12.7,9.56,6.81
19-01-2021,SINES,88,6,642,"[480,960]",Muito Elevado,,,,88,Alentejo,SETÚBAL,1513,20330.17,13715,888,791,551,416,268,684,1235,2026,2914,67.46,14.33,9.97,6.07
19-01-2021,SINTRA,5390,385,1377,"[960,Max]",Extremamente Elevado,,,,5390,Lisboa e Vale do Tejo,LISBOA,1111,31922.73,391402,20490,18316,13545,9137,7284,16421,29966,48282,68772,1226.08,215.43,151.25,93.87
19-01-2021,SOBRAL DE MONTE AGRAÇO,130,9,1221,"[960,Max]",Extremamente Elevado,,,,130,Lisboa e Vale do Tejo,LISBOA,1112,5210.32,10651,564,507,352,272,212,484,836,1343,1907,204.43,36.6,25.78,16.05
19-01-2021,SOURE,153,11,894,"[480,960]",Muito Elevado,,,,153,Centro,COIMBRA,0615,26506.07,17120,1173,1142,1004,883,987,1870,2874,4016,5189,64.59,19.58,15.15,10.84
19-01-2021,SOUSEL,35,2,793,"[480,960]",Muito Elevado,,,,35,Alentejo,PORTALEGRE,1215,27932.18,4412,261,274,208,302,292,594,802,1076,1337,15.8,4.79,3.85,2.87
19-01-2021,TÁBUA,340,24,2991,"[960,Max]",Extremamente Elevado,,,,340,Centro,COIMBRA,0616,19978.58,11368,729,584,524,430,464,894,1418,2002,2731,56.9,13.67,10.02,7.1
19-01-2021,TABUAÇO,62,4,1028,"[960,Max]",Extremamente Elevado,,,,62,Norte,VISEU,1819,13385.67,6033,372,314,217,282,363,645,862,1176,1548,45.07,11.56,8.79,6.44
19-01-2021,TAROUCA,167,12,2140,"[960,Max]",Extremamente Elevado,,,,167,Norte,VISEU,1820,10008.49,7804,405,335,313,277,324,601,914,1249,1654,77.98,16.53,12.48,9.13
19-01-2021,TAVIRA,526,38,2144,"[960,Max]",Extremamente Elevado,,,,526,Algarve,FARO,0814,60696.7,24530,1493,1415,1252,1066,1277,2343,3595,5010,6503,40.41,10.71,8.25,5.92
19-01-2021,TERRAS DE BOURO,80,6,1258,"[960,Max]",Extremamente Elevado,,,,80,Norte,BRAGA,0310,27746.07,6361,391,372,296,319,340,659,955,1327,1718,22.93,6.19,4.78,3.44
19-01-2021,TOMAR,744,53,2025,"[960,Max]",Extremamente Elevado,,,,744,Lisboa e Vale do Tejo,SANTARÉM,1418,35120.44,36748,2403,2189,1868,1853,1822,3675,5543,7732,10135,104.64,28.86,22.02,15.78
19-01-2021,TONDELA,535,38,2030,"[960,Max]",Extremamente Elevado,,,,535,Centro,VISEU,1821,37121.73,26357,1768,1722,1518,1475,1417,2892,4410,6132,7900,71.0,21.28,16.52,11.88
19-01-2021,TORRE DE MONCORVO,24,2,312,"[240,480]",Elevado,,,,24,Norte,BRAGANÇA,0409,53155.67,7695,556,478,488,551,719,1270,1758,2236,2792,14.48,5.25,4.21,3.31
19-01-2021,TORRES NOVAS,569,41,1629,"[960,Max]",Extremamente Elevado,,,,569,Lisboa e Vale do Tejo,SANTARÉM,1419,26999.68,34933,2324,1979,1738,1406,1475,2881,4619,6598,8922,129.38,33.04,24.44,17.11
19-01-2021,TORRES VEDRAS,1274,91,1622,"[960,Max]",Extremamente Elevado,,,,1274,Lisboa e Vale do Tejo,LISBOA,1113,40714.89,78530,4513,3945,3447,2628,2104,4732,8179,12124,16637,192.88,40.86,29.78,20.09
19-01-2021,TRANCOSO,201,14,2265,"[960,Max]",Extremamente Elevado,,,,201,Centro,GUARDA,0913,36152.47,8875,581,557,542,586,496,1082,1624,2181,2762,24.55,7.64,6.03,4.49
19-01-2021,TROFA,417,30,1085,"[960,Max]",Extremamente Elevado,,,,417,Norte,PORTO,1318,7201.76,38418,2336,1894,1231,939,684,1623,2854,4748,7084,533.44,98.36,65.93,39.63
19-01-2021,VAGOS,199,14,875,"[480,960]",Muito Elevado,,,,199,Centro,AVEIRO,0118,16491.5,22740,1320,1205,922,784,724,1508,2430,3635,4955,137.89,30.04,22.04,14.73
19-01-2021,VALE DE CAMBRA,275,20,1289,"[960,Max]",Extremamente Elevado,,,,275,Norte,AVEIRO,0119,14733.47,21327,1491,1363,1005,831,798,1629,2634,3997,5488,144.76,37.25,27.13,17.88
19-01-2021,VALENÇA,161,11,1211,"[960,Max]",Extremamente Elevado,,,,161,Norte,VIANA DO CASTELO,1608,11712.86,13290,867,791,582,582,503,1085,1667,2458,3325,113.46,28.39,20.99,14.23
19-01-2021,VALONGO,977,70,1003,"[960,Max]",Extremamente Elevado,,,,977,Norte,PORTO,1315,7512.45,97444,5629,4696,3207,2462,1829,4291,7498,12194,17823,1297.18,237.26,162.33,99.81
19-01-2021,VALPAÇOS,199,14,1343,"[960,Max]",Extremamente Elevado,,,,199,Norte,VILA REAL,1712,54873.93,14818,1217,1118,999,928,997,1925,2924,4042,5259,27.0,9.58,7.37,5.33
19-01-2021,VELAS,0,0,0,"[0,240]",Moderado,,,,0,Açores,AÇORES,4502,11738.38,5093,278,208,166,153,113,266,432,640,918,43.39,7.82,5.45,3.68
19-01-2021,VENDAS NOVAS,175,13,1555,"[960,Max]",Extremamente Elevado,,,,175,Alentejo,ÉVORA,0712,22238.88,11255,677,768,655,501,532,1033,1688,2456,3133,50.61,14.09,11.04,7.59
19-01-2021,VIANA DO ALENTEJO,126,9,2449,"[960,Max]",Extremamente Elevado,,,,126,Alentejo,ÉVORA,0713,39367.29,5145,245,208,235,210,214,424,659,867,1112,13.07,2.82,2.2,1.67
19-01-2021,VIANA DO CASTELO,1068,76,1265,"[960,Max]",Extremamente Elevado,,,,1068,Norte,VIANA DO CASTELO,1609,31902.01,84417,5470,4433,3591,3061,2982,6043,9634,14067,19537,264.61,61.24,44.09,30.2
19-01-2021,VIDIGUEIRA,51,4,926,"[480,960]",Muito Elevado,,,,51,Alentejo,BEJA,0214,31661.09,5510,300,248,215,233,275,508,723,971,1271,17.4,4.01,3.07,2.28
19-01-2021,VIEIRA DO MINHO,199,14,1680,"[960,Max]",Extremamente Elevado,,,,199,Norte,BRAGA,0311,21644.35,11842,703,594,525,548,482,1030,1555,2149,2852,54.71,13.18,9.93,7.18
19-01-2021,VILA DE REI,13,1,391,"[240,480]",Elevado,,,,13,Centro,CASTELO BRANCO,0510,19154.6,3323,169,128,172,247,302,549,721,849,1018,17.35,5.31,4.43,3.76
19-01-2021,VILA DO BISPO,18,1,349,"[240,480]",Elevado,,,,18,Algarve,FARO,0815,17906.06,5154,302,302,314,232,233,465,779,1081,1383,28.78,7.72,6.04,4.35
19-01-2021,VILA DO CONDE,1308,93,1637,"[960,Max]",Extremamente Elevado,,,,1308,Norte,PORTO,1316,14902.77,79899,4726,3875,2819,2070,1743,3813,6632,10507,15233,536.13,102.21,70.5,44.5
19-01-2021,VILA DO PORTO,3,0,53,"[0,240]",Moderado,,,,3,Açores,AÇORES,4101,9688.74,5616,274,212,135,96,123,219,354,566,840,57.96,8.67,5.84,3.65
19-01-2021,VILA FLOR,85,6,1406,"[960,Max]",Extremamente Elevado,,,,85,Norte,BRAGANÇA,0410,26581.14,6044,429,362,422,294,331,625,1047,1409,1838,22.74,6.91,5.3,3.94
19-01-2021,VILA FRANCA DE XIRA,2104,150,1482,"[960,Max]",Extremamente Elevado,,,,2104,Lisboa e Vale do Tejo,LISBOA,1114,31819.39,141957,8501,6852,4869,3425,2472,5897,10766,17618,26119,446.14,82.09,55.37,33.84
19-01-2021,VILA FRANCA DO CAMPO,119,9,1077,"[960,Max]",Extremamente Elevado,,,,119,Açores,AÇORES,4206,7796.82,11051,450,344,248,217,154,371,619,963,1413,141.73,18.12,12.35,7.94
19-01-2021,VILA NOVA DA BARQUINHA,53,4,710,"[480,960]",Muito Elevado,,,,53,Lisboa e Vale do Tejo,SANTARÉM,1420,4952.97,7461,415,406,392,364,338,702,1094,1500,1915,150.64,38.66,30.28,22.09
19-01-2021,VILA NOVA DE CERVEIRA,172,12,1930,"[960,Max]",Extremamente Elevado,,,,172,Norte,VIANA DO CASTELO,1610,10846.66,8910,531,444,410,384,334,718,1128,1572,2103,82.14,19.39,14.49,10.4
19-01-2021,VILA NOVA DE FAMALICÃO,1851,132,1406,"[960,Max]",Extremamente Elevado,,,,1851,Norte,BRAGA,0312,20159.26,131676,7817,6164,4202,3282,2749,6031,10233,16397,24214,653.19,120.12,81.34,50.76
19-01-2021,VILA NOVA DE FOZ CÔA,110,8,1692,"[960,Max]",Extremamente Elevado,,,,110,Centro,GUARDA,0914,39815.18,6503,442,385,390,398,429,827,1217,1602,2044,16.33,5.13,4.02,3.06
19-01-2021,VILA NOVA DE GAIA,2380,170,792,"[480,960]",Muito Elevado,,,,2380,Norte,PORTO,1317,16846.43,300472,18349,15568,10972,8224,6281,14505,25477,41045,59394,1783.64,352.57,243.65,151.23
19-01-2021,VILA NOVA DE PAIVA,122,9,2603,"[960,Max]",Extremamente Elevado,,,,122,Centro,VISEU,1822,17553.28,4687,289,272,233,217,241,458,691,963,1252,26.7,7.13,5.49,3.94
19-01-2021,VILA NOVA DE POIARES,218,16,3142,"[960,Max]",Extremamente Elevado,,,,218,Centro,COIMBRA,0617,8445.3,6939,380,284,262,235,182,417,679,963,1343,82.17,15.9,11.4,8.04
19-01-2021,VILA POUCA DE AGUIAR,104,7,869,"[480,960]",Muito Elevado,,,,104,Norte,VILA REAL,1713,43706.62,11961,860,817,733,601,627,1228,1961,2778,3638,27.37,8.32,6.36,4.49
19-01-2021,VILA REAL,548,39,1097,"[960,Max]",Extremamente Elevado,,,,548,Norte,VILA REAL,1714,37880.28,49962,3025,2498,2065,1579,1466,3045,5110,7608,10633,131.9,28.07,20.08,13.49
19-01-2021,VILA REAL DE SANTO ANTÓNIO,203,15,1083,"[960,Max]",Extremamente Elevado,,,,203,Algarve,FARO,0816,6125.0,18749,1172,1069,811,569,586,1155,1966,3035,4207,306.11,68.69,49.55,32.1
19-01-2021,VILA VELHA DE RÓDÃO,15,1,477,"[240,480]",Elevado,,,,15,Centro,CASTELO BRANCO,0511,32991.16,3144,209,229,180,283,306,589,769,998,1207,9.53,3.66,3.03,2.33
19-01-2021,VILA VERDE,719,51,1533,"[960,Max]",Extremamente Elevado,,,,719,Norte,BRAGA,0313,22866.52,46911,2365,2063,1667,1494,1437,2931,4598,6661,9026,205.15,39.47,29.13,20.11
19-01-2021,VILA VIÇOSA,144,10,1881,"[960,Max]",Extremamente Elevado,,,,144,Alentejo,ÉVORA,0714,19485.89,7656,487,379,342,345,324,669,1011,1390,1877,39.29,9.63,7.13,5.19
19-01-2021,VIMIOSO,40,3,994,"[960,Max]",Extremamente Elevado,,,,40,Norte,BRAGANÇA,0411,48158.51,4023,274,230,261,293,335,628,889,1119,1393,8.35,2.89,2.32,1.85
19-01-2021,VINHAIS,87,6,1123,"[960,Max]",Extremamente Elevado,,,,87,Norte,BRAGANÇA,0412,69475.09,7746,599,577,636,641,815,1456,2092,2669,3268,11.15,4.7,3.84,3.01
19-01-2021,VISEU,1601,114,1646,"[960,Max]",Extremamente Elevado,,,,1601,Centro,VISEU,1823,50710.14,97249,5769,5038,4140,3158,2710,5868,10008,15046,20815,191.77,41.05,29.67,19.74
19-01-2021,VIZELA,215,15,900,"[480,960]",Muito Elevado,,,,215,Norte,BRAGA,0314,2469.83,23897,1258,928,655,509,371,880,1535,2463,3721,967.49,150.65,99.72,62.15
19-01-2021,VOUZELA,301,21,3129,"[960,Max]",Extremamente Elevado,,,,301,Centro,VISEU,1824,19369.46,9619,626,605,554,532,507,1039,1593,2198,2824,49.66,14.58,11.35,8.22
27-01-2021,ABRANTES,339,24,965,"[960,Max]",Extremamente Elevado,,,,339,Lisboa e Vale do Tejo,SANTARÉM,1401,71469.08,35130,2473,2213,1730,1748,2021,3769,5499,7712,10185,49.15,14.25,10.79,7.69
27-01-2021,ÁGUEDA,798,57,1732,"[960,Max]",Extremamente Elevado,,,,798,Centro,AVEIRO,0101,33527.44,46075,3237,2713,2090,1635,1496,3131,5221,7934,11171,137.43,33.32,23.66,15.57
27-01-2021,AGUIAR DA BEIRA,296,21,6363,"[960,Max]",Extremamente Elevado,,,,296,Centro,GUARDA,0901,20676.57,4652,304,281,235,239,148,387,622,903,1207,22.5,5.84,4.37,3.01
27-01-2021,ALANDROAL,98,7,1963,"[960,Max]",Extremamente Elevado,,,,98,Alentejo,ÉVORA,0701,54267.81,4992,307,256,296,299,377,676,972,1228,1535,9.2,2.83,2.26,1.79
27-01-2021,ALBERGARIA-A-VELHA,275,20,1139,"[960,Max]",Extremamente Elevado,,,,275,Centro,AVEIRO,0102,15882.5,24144,1550,1298,996,687,680,1367,2363,3661,5211,152.02,32.81,23.05,14.88
27-01-2021,ALBUFEIRA,546,39,1315,"[960,Max]",Extremamente Elevado,,,,546,Algarve,FARO,0801,14066.42,41528,2067,1717,1425,985,858,1843,3268,4985,7052,295.24,50.14,35.44,23.23
27-01-2021,ALCÁCER DO SAL,278,20,2384,"[960,Max]",Extremamente Elevado,,,,278,Alentejo,SETÚBAL,1501,149987.3,11659,884,814,623,623,602,1225,1848,2662,3546,7.77,2.36,1.77,1.23
27-01-2021,ALCANENA,286,20,2233,"[960,Max]",Extremamente Elevado,,,,286,Lisboa e Vale do Tejo,SANTARÉM,1402,12732.86,12809,891,744,628,536,588,1124,1752,2496,3387,100.6,26.6,19.6,13.76
27-01-2021,ALCOBAÇA,760,54,1419,"[960,Max]",Extremamente Elevado,,,,760,Lisboa e Vale do Tejo,LEIRIA,1001,40814.09,53555,3420,2927,2466,2059,1676,3735,6201,9128,12548,131.22,30.74,22.36,15.19
27-01-2021,ALCOCHETE,280,20,1415,"[960,Max]",Extremamente Elevado,,,,280,Lisboa e Vale do Tejo,SETÚBAL,1502,12836.48,19787,857,834,691,476,447,923,1614,2448,3305,154.15,25.75,19.07,12.57
27-01-2021,ALCOUTIM,16,1,741,"[480,960]",Muito Elevado,,,,16,Algarve,FARO,0802,57536.33,2159,191,188,163,190,267,457,620,808,999,3.75,1.74,1.4,1.08
27-01-2021,ALENQUER,656,47,1489,"[960,Max]",Extremamente Elevado,,,,656,Lisboa e Vale do Tejo,LISBOA,1101,30421.92,44052,2298,2062,1629,1330,1155,2485,4114,6176,8474,144.8,27.85,20.3,13.52
27-01-2021,ALFÂNDEGA DA FÉ,169,12,3714,"[960,Max]",Extremamente Elevado,,,,169,Norte,BRAGANÇA,0401,32194.64,4550,325,277,301,274,325,599,900,1177,1502,14.13,4.67,3.66,2.8
27-01-2021,ALIJÓ,86,6,809,"[480,960]",Muito Elevado,,,,86,Norte,VILA REAL,1701,29759.89,10625,766,687,635,542,666,1208,1843,2530,3296,35.7,11.08,8.5,6.19
27-01-2021,ALJEZUR,11,1,197,"[0,240]",Moderado,,,,11,Algarve,FARO,0803,32349.95,5594,316,336,335,320,410,730,1065,1401,1717,17.29,5.31,4.33,3.29
27-01-2021,ALJUSTREL,150,11,1819,"[960,Max]",Extremamente Elevado,,,,150,Alentejo,BEJA,0201,45847.41,8247,635,521,443,347,358,705,1148,1669,2304,17.99,5.03,3.64,2.5
27-01-2021,ALMADA,3060,219,1810,"[960,Max]",Extremamente Elevado,,,,3060,Lisboa e Vale do Tejo,SETÚBAL,1503,7000.89,169039,10469,9777,7876,6144,5111,11255,19131,28908,39377,2414.5,562.45,412.91,273.26
27-01-2021,ALMEIDA,214,15,3671,"[960,Max]",Extremamente Elevado,,,,214,Centro,GUARDA,0902,51798.46,5830,441,419,396,458,393,851,1247,1666,2107,11.26,4.07,3.22,2.41
27-01-2021,ALMEIRIM,394,28,1748,"[960,Max]",Extremamente Elevado,,,,394,Lisboa e Vale do Tejo,SANTARÉM,1403,22212.05,22546,1342,1353,1106,866,843,1709,2815,4168,5510,101.5,24.81,18.76,12.67
27-01-2021,ALMODÔVAR,62,4,922,"[480,960]",Muito Elevado,,,,62,Alentejo,BEJA,0202,77788.03,6725,414,443,396,373,328,701,1097,1540,1954,8.65,2.51,1.98,1.41
27-01-2021,ALPIARÇA,67,5,949,"[480,960]",Muito Elevado,,,,67,Lisboa e Vale do Tejo,SANTARÉM,1404,9536.33,7059,515,486,363,333,274,607,970,1456,1971,74.02,20.67,15.27,10.17
27-01-2021,ALTER DO CHÃO,39,3,1232,"[960,Max]",Extremamente Elevado,,,,39,Alentejo,PORTALEGRE,1201,36206.62,3165,201,163,136,208,187,395,531,694,895,8.74,2.47,1.92,1.47
27-01-2021,ALVAIÁZERE,170,12,2577,"[960,Max]",Extremamente Elevado,,,,170,Centro,LEIRIA,1002,16047.76,6597,419,389,346,406,539,945,1291,1680,2099,41.11,13.08,10.47,8.04
27-01-2021,ALVITO,25,2,1009,"[960,Max]",Extremamente Elevado,,,,25,Alentejo,BEJA,0203,26485.32,2477,145,110,105,111,89,200,305,415,560,9.35,2.11,1.57,1.15
27-01-2021,AMADORA,3435,245,1866,"[960,Max]",Extremamente Elevado,,,,3435,Lisboa e Vale do Tejo,LISBOA,1115,2378.47,184106,11186,10936,8780,6460,5890,12350,21130,32066,43252,7742.05,1818.84,1348.44,888.56
27-01-2021,AMARANTE,706,50,1327,"[960,Max]",Extremamente Elevado,,,,706,Norte,PORTO,1301,30133.15,53193,3086,2413,1812,1643,1311,2954,4766,7179,10265,176.53,34.07,23.82,15.82
27-01-2021,AMARES,211,15,1164,"[960,Max]",Extremamente Elevado,,,,211,Norte,BRAGA,0301,8195.41,18129,1001,829,622,489,524,1013,1635,2464,3465,221.22,42.28,30.07,19.95
27-01-2021,ANADIA,400,29,1467,"[960,Max]",Extremamente Elevado,,,,400,Centro,AVEIRO,0103,21663.48,27258,1931,1698,1376,1208,1262,2470,3846,5544,7475,125.83,34.51,25.59,17.75
27-01-2021,ANGRA DO HEROÍSMO,29,2,86,"[0,240]",Moderado,,,,29,Açores,AÇORES,4301,23899.66,33807,2006,1473,1122,768,635,1403,2525,3998,6004,141.45,25.12,16.73,10.56
27-01-2021,ANSIÃO,332,24,2758,"[960,Max]",Extremamente Elevado,,,,332,Centro,LEIRIA,1003,17609.42,12039,727,709,646,694,530,1224,1870,2579,3306,68.37,18.77,14.65,10.62
27-01-2021,ARCOS DE VALDEVEZ,618,44,2953,"[960,Max]",Extremamente Elevado,,,,618,Norte,VIANA DO CASTELO,1601,44759.64,20926,1329,1338,1282,1343,1515,2858,4140,5478,6807,46.75,15.21,12.24,9.25
27-01-2021,ARGANIL,237,17,2152,"[960,Max]",Extremamente Elevado,,,,237,Centro,COIMBRA,0601,33283.93,11014,672,648,612,559,596,1155,1767,2415,3087,33.09,9.27,7.26,5.31
27-01-2021,ARMAMAR,156,11,2704,"[960,Max]",Extremamente Elevado,,,,156,Norte,VISEU,1801,11723.73,5769,357,305,309,285,310,595,904,1209,1566,49.21,13.36,10.31,7.71
27-01-2021,AROUCA,263,19,1269,"[960,Max]",Extremamente Elevado,,,,263,Norte,AVEIRO,0104,32910.52,20720,1306,1047,753,683,683,1366,2119,3166,4472,62.96,13.59,9.62,6.44
27-01-2021,ARRAIOLOS,127,9,1833,"[960,Max]",Extremamente Elevado,,,,127,Alentejo,ÉVORA,0702,68374.55,6928,435,384,283,367,480,847,1130,1514,1949,10.13,2.85,2.21,1.65
27-01-2021,ARRONCHES,72,5,2553,"[960,Max]",Extremamente Elevado,,,,72,Alentejo,PORTALEGRE,1202,31464.72,2820,155,142,162,187,179,366,528,670,825,8.96,2.62,2.13,1.68
27-01-2021,ARRUDA DOS VINHOS,324,23,2102,"[960,Max]",Extremamente Elevado,,,,324,Lisboa e Vale do Tejo,LISBOA,1102,7795.93,15412,738,738,562,509,438,947,1509,2247,2985,197.69,38.29,28.82,19.36
27-01-2021,AVEIRO,986,70,1252,"[960,Max]",Extremamente Elevado,,,,986,Centro,AVEIRO,0105,19757.57,78734,4520,4004,3050,2250,2103,4353,7403,11407,15927,398.49,80.61,57.73,37.47
27-01-2021,AVIS,29,2,683,"[480,960]",Muito Elevado,,,,29,Alentejo,PORTALEGRE,1203,60596.51,4247,315,225,206,251,273,524,730,955,1270,7.01,2.1,1.58,1.2
27-01-2021,AZAMBUJA,347,25,1528,"[960,Max]",Extremamente Elevado,,,,347,Lisboa e Vale do Tejo,LISBOA,1103,26265.65,22716,1322,1171,1070,798,618,1416,2486,3657,4979,86.48,18.96,13.92,9.46
27-01-2021,BAIÃO,296,21,1579,"[960,Max]",Extremamente Elevado,,,,296,Norte,PORTO,1302,17452.83,18748,1070,862,714,686,725,1411,2125,2987,4057,107.42,23.25,17.11,12.18
27-01-2021,BARCELOS,2341,167,2015,"[960,Max]",Extremamente Elevado,,,,2341,Norte,BRAGA,0302,37890.14,116187,6721,5325,3619,2991,2562,5553,9172,14497,21218,306.64,56.0,38.26,24.21
27-01-2021,BARRANCOS,27,2,1652,"[960,Max]",Extremamente Elevado,,,,27,Alentejo,BEJA,0204,16841.73,1634,90,65,65,94,61,155,220,285,375,9.7,2.23,1.69,1.31
27-01-2021,BARREIRO,1243,89,1654,"[960,Max]",Extremamente Elevado,,,,1243,Lisboa e Vale do Tejo,SETÚBAL,1504,3639.07,75147,5194,5565,4459,3105,1767,4872,9331,14896,20090,2065.05,552.07,409.34,256.42
27-01-2021,BATALHA,246,18,1541,"[960,Max]",Extremamente Elevado,,,,246,Centro,LEIRIA,1004,10341.6,15963,873,762,649,529,549,1078,1727,2489,3362,154.35,32.51,24.07,16.7
27-01-2021,BEJA,590,42,1757,"[960,Max]",Extremamente Elevado,,,,590,Alentejo,BEJA,0205,114647.55,33579,2005,1840,1386,1272,1039,2311,3697,5537,7542,29.29,6.58,4.83,3.22
27-01-2021,BELMONTE,84,6,1313,"[960,Max]",Extremamente Elevado,,,,84,Centro,CASTELO BRANCO,0501,11875.91,6398,444,321,325,310,355,665,990,1311,1755,53.87,14.78,11.04,8.34
27-01-2021,BENAVENTE,573,41,1872,"[960,Max]",Extremamente Elevado,,,,573,Lisboa e Vale do Tejo,SANTARÉM,1405,52138.39,30602,1468,1376,1141,876,643,1519,2660,4036,5504,58.69,10.56,7.74,5.1
27-01-2021,BOMBARRAL,137,10,1091,"[960,Max]",Extremamente Elevado,,,,137,Lisboa e Vale do Tejo,LEIRIA,1005,9128.55,12558,875,714,561,491,429,920,1481,2195,3070,137.56,33.63,24.04,16.22
27-01-2021,BORBA,132,9,1960,"[960,Max]",Extremamente Elevado,,,,132,Alentejo,ÉVORA,0703,14518.65,6736,430,375,279,436,392,828,1107,1482,1912,46.39,13.17,10.21,7.62
27-01-2021,BOTICAS,168,12,3361,"[960,Max]",Extremamente Elevado,,,,168,Norte,VILA REAL,1702,32195.66,4998,347,306,311,305,380,685,996,1302,1649,15.52,5.12,4.04,3.09
27-01-2021,BRAGA,2466,176,1350,"[960,Max]",Extremamente Elevado,,,,2466,Norte,BRAGA,0303,18339.95,182679,10029,7963,5241,4320,3671,7991,13232,21195,31224,996.07,170.25,115.57,72.15
27-01-2021,BRAGANÇA,498,36,1482,"[960,Max]",Extremamente Elevado,,,,498,Norte,BRAGANÇA,0402,117357.27,33607,2402,1855,1652,1393,1163,2556,4208,6063,8465,28.64,7.21,5.17,3.59
27-01-2021,CABECEIRAS DE BASTO,202,14,1293,"[960,Max]",Extremamente Elevado,,,,202,Norte,BRAGA,0304,24182.16,15628,774,594,544,575,574,1149,1693,2287,3061,64.63,12.66,9.46,7.0
27-01-2021,CADAVAL,98,7,717,"[480,960]",Muito Elevado,,,,98,Lisboa e Vale do Tejo,LISBOA,1104,17489.3,13673,813,796,756,621,625,1246,2002,2798,3611,78.18,20.65,16.0,11.45
27-01-2021,CALDAS DA RAINHA,609,43,1173,"[960,Max]",Extremamente Elevado,,,,609,Lisboa e Vale do Tejo,LEIRIA,1006,25569.47,51912,3035,2684,2186,1899,1705,3604,5790,8474,11509,203.03,45.01,33.14,22.64
27-01-2021,CALHETA,25,2,230,"[0,240]",Moderado,,,,25,Madeira,MADEIRA,3101,11150.43,10867,576,497,507,399,415,814,1321,1818,2394,97.46,21.47,16.3,11.85
27-01-2021,CALHETA (AÇORES),2,0,63,"[0,240]",Moderado,,,,2,Açores,AÇORES,4501,12626.4,3184,215,159,141,139,122,261,402,561,776,25.22,6.15,4.44,3.18
27-01-2021,CÂMARA DE LOBOS,87,6,258,"[240,480]",Elevado,,,,87,Madeira,MADEIRA,3102,5216.67,33675,1396,1059,834,545,381,926,1760,2819,4215,645.49,80.79,54.03,33.74
27-01-2021,CAMINHA,493,35,3105,"[960,Max]",Extremamente Elevado,,,,493,Norte,VIANA DO CASTELO,1602,13652.14,15877,1046,944,818,646,656,1302,2120,3064,4110,116.3,30.11,22.44,15.53
27-01-2021,CAMPO MAIOR,206,15,2616,"[960,Max]",Extremamente Elevado,,,,206,Alentejo,PORTALEGRE,1204,24720.16,7874,471,364,351,279,327,606,957,1321,1792,31.85,7.25,5.34,3.87
27-01-2021,CANTANHEDE,555,40,1585,"[960,Max]",Extremamente Elevado,,,,555,Centro,COIMBRA,0602,39088.02,35011,2346,2096,1880,1709,1451,3160,5040,7136,9482,89.57,24.26,18.26,12.89
27-01-2021,CARRAZEDA DE ANSIÃES,28,2,494,"[480,960]",Muito Elevado,,,,28,Norte,BRAGANÇA,0403,27924.09,5666,424,389,391,312,465,777,1168,1557,1981,20.29,7.09,5.58,4.18
27-01-2021,CARREGAL DO SAL,142,10,1532,"[960,Max]",Extremamente Elevado,,,,142,Centro,VISEU,1802,11689.21,9271,587,562,486,462,376,838,1324,1886,2473,79.31,21.16,16.13,11.33
27-01-2021,CARTAXO,260,19,1090,"[960,Max]",Extremamente Elevado,,,,260,Lisboa e Vale do Tejo,SANTARÉM,1406,15817.28,23843,1415,1376,1142,861,632,1493,2635,4011,5426,150.74,34.3,25.36,16.66
27-01-2021,CASCAIS,3076,220,1440,"[960,Max]",Extremamente Elevado,,,,3076,Lisboa e Vale do Tejo,LISBOA,1105,9740.17,213608,12151,11444,8680,6469,5248,11717,20397,31841,43992,2193.1,451.66,326.91,209.41
27-01-2021,CASTANHEIRA DE PÊRA,32,2,1224,"[960,Max]",Extremamente Elevado,,,,32,Centro,LEIRIA,1007,6677.45,2614,233,195,157,190,187,377,534,729,962,39.15,14.41,10.92,8.0
27-01-2021,CASTELO BRANCO,924,66,1777,"[960,Max]",Extremamente Elevado,,,,924,Centro,CASTELO BRANCO,0502,143819.15,51987,3528,3042,2499,2229,2225,4454,6953,9995,13523,36.15,9.4,6.95,4.83
27-01-2021,CASTELO DE PAIVA,159,11,1029,"[960,Max]",Extremamente Elevado,,,,159,Norte,AVEIRO,0106,11500.53,15454,881,697,545,420,431,851,1396,2093,2974,134.37,25.86,18.2,12.14
27-01-2021,CASTELO DE VIDE,194,14,6646,"[960,Max]",Extremamente Elevado,,,,194,Alentejo,PORTALEGRE,1205,26491.24,2919,204,173,179,147,170,317,496,669,873,11.02,3.3,2.53,1.87
27-01-2021,CASTRO DAIRE,332,24,2402,"[960,Max]",Extremamente Elevado,,,,332,Centro,VISEU,1803,37904.13,13823,942,857,765,732,773,1505,2270,3127,4069,36.47,10.74,8.25,5.99
27-01-2021,CASTRO MARIM,176,13,2822,"[960,Max]",Extremamente Elevado,,,,176,Algarve,FARO,0804,30084.37,6237,370,345,334,322,344,666,1000,1345,1715,20.73,5.7,4.47,3.32
27-01-2021,CASTRO VERDE,64,5,921,"[480,960]",Muito Elevado,,,,64,Alentejo,BEJA,0206,56944.23,6949,437,347,303,275,227,502,805,1152,1589,12.2,2.79,2.02,1.41
27-01-2021,CELORICO DA BEIRA,104,7,1501,"[960,Max]",Extremamente Elevado,,,,104,Centro,GUARDA,0903,24721.63,6928,430,416,363,369,535,904,1267,1683,2113,28.02,8.55,6.81,5.12
27-01-2021,CELORICO DE BASTO,351,25,1843,"[960,Max]",Extremamente Elevado,,,,351,Norte,BRAGA,0305,18107.02,19040,1001,802,668,728,729,1457,2125,2927,3928,105.15,21.69,16.17,11.74
27-01-2021,CHAMUSCA,110,8,1196,"[960,Max]",Extremamente Elevado,,,,110,Lisboa e Vale do Tejo,SANTARÉM,1407,74600.54,9197,629,583,553,465,579,1044,1597,2180,2809,12.33,3.77,2.92,2.14
27-01-2021,CHAVES,434,31,1103,"[960,Max]",Extremamente Elevado,,,,434,Norte,VILA REAL,1703,59122.95,39343,2676,2429,1991,1886,1918,3804,5795,8224,10900,66.54,18.44,13.91,9.8
27-01-2021,CINFÃES,199,14,1091,"[960,Max]",Extremamente Elevado,,,,199,Norte,VISEU,1804,23928.76,18244,1067,902,779,734,758,1492,2271,3173,4240,76.24,17.72,13.26,9.49
27-01-2021,COIMBRA,3089,221,2302,"[960,Max]",Extremamente Elevado,,,,3089,Centro,COIMBRA,0603,31939.94,134166,9489,8734,6353,5139,5074,10213,16566,25300,34789,420.06,108.92,79.21,51.87
27-01-2021,CONDEIXA-A-NOVA,336,24,1895,"[960,Max]",Extremamente Elevado,,,,336,Centro,COIMBRA,0604,13867.47,17733,871,809,717,583,490,1073,1790,2599,3470,127.88,25.02,18.74,12.91
27-01-2021,CONSTÂNCIA,43,3,1067,"[960,Max]",Extremamente Elevado,,,,43,Lisboa e Vale do Tejo,SANTARÉM,1408,8036.58,4030,211,183,187,148,155,303,490,673,884,50.14,11.0,8.37,6.1
27-01-2021,CORUCHE,247,18,1414,"[960,Max]",Extremamente Elevado,,,,247,Lisboa e Vale do Tejo,SANTARÉM,1409,111572.03,17471,1294,1090,1095,1096,1019,2115,3210,4300,5594,15.66,5.01,3.85,2.88
27-01-2021,CORVO,1,0,216,"[0,240]",Moderado,,,,1,Açores,AÇORES,4901,1711.45,464,22,21,11,13,19,32,43,64,86,27.12,5.03,3.74,2.51
27-01-2021,COVILHÃ,786,56,1680,"[960,Max]",Extremamente Elevado,,,,786,Centro,CASTELO BRANCO,0503,55560.06,46787,3533,2998,2365,2111,2193,4304,6669,9667,13200,84.21,23.76,17.4,12.0
27-01-2021,CRATO,33,2,1055,"[960,Max]",Extremamente Elevado,,,,33,Alentejo,PORTALEGRE,1206,39806.88,3129,229,258,163,182,228,410,573,831,1060,7.86,2.66,2.09,1.44
27-01-2021,CUBA,135,10,2938,"[960,Max]",Extremamente Elevado,,,,135,Alentejo,BEJA,0207,17208.72,4595,255,233,206,190,143,333,539,772,1027,26.7,5.97,4.49,3.13
27-01-2021,ELVAS,284,20,1383,"[960,Max]",Extremamente Elevado,,,,284,Alentejo,PORTALEGRE,1207,63128.86,20528,1057,1145,902,852,810,1662,2564,3709,4766,32.52,7.55,5.88,4.06
27-01-2021,ENTRONCAMENTO,250,18,1160,"[960,Max]",Extremamente Elevado,,,,250,Lisboa e Vale do Tejo,SANTARÉM,1410,1372.81,21558,1066,930,868,695,592,1287,2155,3085,4151,1570.14,302.33,224.69,156.96
27-01-2021,ESPINHO,422,30,1430,"[960,Max]",Extremamente Elevado,,,,422,Norte,AVEIRO,0107,2105.68,29516,2205,1993,1430,1177,960,2137,3567,5560,7765,1401.52,368.71,264.01,169.37
27-01-2021,ESPOSENDE,571,41,1671,"[960,Max]",Extremamente Elevado,,,,571,Norte,BRAGA,0306,9540.98,34177,1831,1522,1095,894,723,1617,2712,4234,6065,358.21,63.57,44.38,28.42
27-01-2021,ESTARREJA,395,28,1519,"[960,Max]",Extremamente Elevado,,,,395,Centro,AVEIRO,0108,10817.33,26006,1503,1399,1106,953,728,1681,2787,4186,5689,240.42,52.59,38.7,25.76
27-01-2021,ESTREMOZ,291,21,2286,"[960,Max]",Extremamente Elevado,,,,291,Alentejo,ÉVORA,0704,51379.95,12728,789,613,697,786,877,1663,2360,2973,3762,24.77,7.32,5.79,4.59
27-01-2021,ÉVORA,702,50,1339,"[960,Max]",Extremamente Elevado,,,,702,Alentejo,ÉVORA,0705,130707.58,52428,3569,2852,2176,1966,1803,3769,5945,8797,12366,40.11,9.46,6.73,4.55
27-01-2021,FAFE,654,47,1361,"[960,Max]",Extremamente Elevado,,,,654,Norte,BRAGA,0307,21908.11,48060,3044,2455,1679,1403,1208,2611,4290,6745,9789,219.37,44.68,30.79,19.58
27-01-2021,FARO,892,64,1462,"[960,Max]",Extremamente Elevado,,,,892,Algarve,FARO,0805,20256.79,61015,3847,3364,2604,2055,1601,3656,6260,9624,13471,301.2,66.5,47.51,30.9
27-01-2021,FELGUEIRAS,680,49,1205,"[960,Max]",Extremamente Elevado,,,,680,Norte,PORTO,1303,11573.75,56422,2951,2302,1601,1316,973,2289,3890,6192,9143,487.49,79.0,53.5,33.61
27-01-2021,FERREIRA DO ALENTEJO,78,6,994,"[960,Max]",Extremamente Elevado,,,,78,Alentejo,BEJA,0208,64820.68,7845,515,414,372,343,345,688,1060,1474,1989,12.1,3.07,2.27,1.64
27-01-2021,FERREIRA DO ZÊZERE,186,13,2337,"[960,Max]",Extremamente Elevado,,,,186,Lisboa e Vale do Tejo,SANTARÉM,1411,19038.03,7959,470,370,416,465,456,921,1337,1707,2177,41.81,11.44,8.97,7.02
27-01-2021,FIGUEIRA DA FOZ,593,42,1009,"[960,Max]",Extremamente Elevado,,,,593,Centro,COIMBRA,0605,37905.26,58747,4032,3597,2887,2495,2043,4538,7425,11022,15054,154.98,39.72,29.08,19.59
27-01-2021,FIGUEIRA DE CASTELO RODRIGO,180,13,3223,"[960,Max]",Extremamente Elevado,,,,180,Centro,GUARDA,0904,50857.46,5584,347,352,290,352,391,743,1033,1385,1732,10.98,3.41,2.72,2.03
27-01-2021,FIGUEIRÓ DOS VINHOS,98,7,1760,"[960,Max]",Extremamente Elevado,,,,98,Centro,LEIRIA,1008,17344.0,5568,402,386,322,309,351,660,982,1368,1770,32.1,10.21,7.89,5.66
27-01-2021,FORNOS DE ALGODRES,126,9,2783,"[960,Max]",Extremamente Elevado,,,,126,Centro,GUARDA,0905,13145.05,4528,261,218,247,256,232,488,735,953,1214,34.45,9.24,7.25,5.59
27-01-2021,FREIXO DE ESPADA À CINTA,41,3,1243,"[960,Max]",Extremamente Elevado,,,,41,Norte,BRAGANÇA,0404,24414.29,3298,211,177,231,196,189,385,616,793,1004,13.51,4.11,3.25,2.52
27-01-2021,FRONTEIRA,45,3,1513,"[960,Max]",Extremamente Elevado,,,,45,Alentejo,PORTALEGRE,1208,24859.58,2974,213,182,149,156,168,324,473,655,868,11.96,3.49,2.63,1.9
27-01-2021,FUNCHAL,388,28,373,"[240,480]",Elevado,,,,388,Madeira,MADEIRA,3103,7616.2,104024,6382,5086,3643,2821,1990,4811,8454,13540,19922,1365.86,261.58,177.78,111.0
27-01-2021,FUNDÃO,450,32,1698,"[960,Max]",Extremamente Elevado,,,,450,Centro,CASTELO BRANCO,0504,70019.79,26495,1781,1464,1432,1357,1643,3000,4432,5896,7677,37.84,10.96,8.42,6.33
27-01-2021,GAVIÃO,55,4,1686,"[960,Max]",Extremamente Elevado,,,,55,Alentejo,PORTALEGRE,1209,29459.45,3263,189,186,222,263,293,556,778,964,1153,11.08,3.91,3.27,2.64
27-01-2021,GÓIS,143,10,3758,"[960,Max]",Extremamente Elevado,,,,143,Centro,COIMBRA,0606,26330.19,3805,235,199,240,233,244,477,717,916,1151,14.45,4.37,3.48,2.72
27-01-2021,GOLEGÃ,51,4,955,"[480,960]",Muito Elevado,,,,51,Lisboa e Vale do Tejo,SANTARÉM,1412,8431.67,5339,356,299,281,243,255,498,779,1078,1434,63.32,17.01,12.78,9.24
27-01-2021,GONDOMAR,2136,153,1287,"[960,Max]",Extremamente Elevado,,,,2136,Norte,PORTO,1304,13191.76,165985,10555,8755,6222,4450,3364,7814,14036,22791,33346,1258.22,252.77,172.76,106.4
27-01-2021,GOUVEIA,182,13,1469,"[960,Max]",Extremamente Elevado,,,,182,Centro,GUARDA,0906,30061.17,12387,871,931,780,783,810,1593,2373,3304,4175,41.21,13.89,10.99,7.89
27-01-2021,GRÂNDOLA,231,17,1578,"[960,Max]",Extremamente Elevado,,,,231,Alentejo,SETÚBAL,1505,82593.66,14639,834,834,708,688,672,1360,2068,2902,3736,17.72,4.52,3.51,2.5
27-01-2021,GUARDA,706,50,1812,"[960,Max]",Extremamente Elevado,,,,706,Centro,GUARDA,0907,71209.58,38969,2477,2041,1686,1415,1474,2889,4575,6616,9093,54.72,12.77,9.29,6.42
27-01-2021,GUIMARÃES,2513,180,1650,"[960,Max]",Extremamente Elevado,,,,2513,Norte,BRAGA,0308,24099.96,152309,9394,7074,4809,3877,2948,6825,11634,18708,28102,631.99,116.61,77.63,48.27
27-01-2021,HORTA,15,1,103,"[0,240]",Moderado,,,,15,Açores,AÇORES,4701,17305.53,14521,818,658,468,352,302,654,1122,1780,2598,83.91,15.01,10.29,6.48
27-01-2021,IDANHA-A-NOVA,52,4,647,"[480,960]",Muito Elevado,,,,52,Centro,CASTELO BRANCO,0505,141633.51,8043,518,490,519,672,974,1646,2165,2655,3173,5.68,2.24,1.87,1.53
27-01-2021,ÍLHAVO,446,32,1152,"[960,Max]",Extremamente Elevado,,,,446,Centro,AVEIRO,0110,7347.55,38699,2227,1943,1444,1193,850,2043,3487,5430,7657,526.66,104.21,73.9,47.46
27-01-2021,LAGOA (FARO),125,9,549,"[480,960]",Muito Elevado,,,,125,Algarve,FARO,0806,8825.45,22762,1314,1168,919,749,670,1419,2338,3506,4820,257.93,54.62,39.73,26.49
27-01-2021,LAGOA,22,2,149,"[0,240]",Moderado,,,,22,Açores,AÇORES,4201,4559.32,14721,536,458,349,238,235,473,822,1280,1816,322.9,39.83,28.08,18.03
27-01-2021,LAGOS,264,19,869,"[480,960]",Muito Elevado,,,,264,Algarve,FARO,0807,21299.27,30374,1744,1434,1247,1053,1029,2082,3329,4763,6507,142.61,30.55,22.36,15.63
27-01-2021,LAJES DAS FLORES,3,0,205,"[0,240]",Moderado,,,,3,Açores,AÇORES,4801,7004.79,1463,88,53,62,46,54,100,162,215,303,20.89,4.33,3.07,2.31
27-01-2021,LAJES DO PICO,5,0,111,"[0,240]",Moderado,,,,5,Açores,AÇORES,4601,15531.09,4490,304,231,223,159,162,321,544,775,1079,28.91,6.95,4.99,3.5
27-01-2021,LAMEGO,440,31,1767,"[960,Max]",Extremamente Elevado,,,,440,Norte,VISEU,1805,16542.11,24895,1639,1284,1124,898,783,1681,2805,4089,5728,150.5,34.63,24.72,16.96
27-01-2021,LEIRIA,1628,116,1300,"[960,Max]",Extremamente Elevado,,,,1628,Centro,LEIRIA,1009,56508.83,125267,7389,6366,5090,3902,3159,7061,12151,18517,25906,221.68,45.84,32.77,21.5
27-01-2021,LISBOA,10012,715,1965,"[960,Max]",Extremamente Elevado,,,,10012,Lisboa e Vale do Tejo,LISBOA,1106,10005.43,509515,33197,33340,27706,23037,26770,49807,77513,110853,144050,5092.6,1439.78,1107.98,774.74
27-01-2021,LOULÉ,1092,78,1590,"[960,Max]",Extremamente Elevado,,,,1092,Algarve,FARO,0808,76366.91,68697,3890,3350,2780,2358,2251,4609,7389,10739,14629,89.96,19.16,14.06,9.68
27-01-2021,LOURES,4355,311,2038,"[960,Max]",Extremamente Elevado,,,,4355,Lisboa e Vale do Tejo,LISBOA,1107,16723.99,213687,12746,12794,9644,6669,5033,11702,21346,34140,46886,1277.73,280.35,204.14,127.64
27-01-2021,LOURINHÃ,337,24,1303,"[960,Max]",Extremamente Elevado,,,,337,Lisboa e Vale do Tejo,LISBOA,1108,14717.2,25855,1584,1243,992,842,645,1487,2479,3722,5306,175.68,36.05,25.29,16.84
27-01-2021,LOUSÃ,221,16,1288,"[960,Max]",Extremamente Elevado,,,,221,Centro,COIMBRA,0607,13840.01,17158,946,866,658,528,450,978,1636,2502,3448,123.97,24.91,18.08,11.82
27-01-2021,LOUSADA,416,30,890,"[480,960]",Muito Elevado,,,,416,Norte,PORTO,1305,9608.01,46755,2289,1698,1176,853,621,1474,2650,4348,6637,486.63,69.08,45.25,27.58
27-01-2021,MAÇÃO,73,5,1165,"[960,Max]",Extremamente Elevado,,,,73,Lisboa e Vale do Tejo,SANTARÉM,1413,39997.98,6267,386,362,390,440,657,1097,1487,1849,2235,15.67,5.59,4.62,3.72
27-01-2021,MACEDO DE CAVALEIROS,148,11,1020,"[960,Max]",Extremamente Elevado,,,,148,Norte,BRAGANÇA,0405,69914.08,14516,1082,889,878,823,938,1761,2639,3528,4610,20.76,6.59,5.05,3.77
27-01-2021,MACHICO,104,7,520,"[480,960]",Muito Elevado,,,,104,Madeira,MADEIRA,3104,6825.1,19981,1197,860,662,455,331,786,1448,2308,3505,292.76,51.36,33.82,21.22
27-01-2021,MADALENA,4,0,68,"[0,240]",Moderado,,,,4,Açores,AÇORES,4602,14712.33,5895,334,256,173,190,179,369,542,798,1132,40.07,7.69,5.42,3.68
27-01-2021,MAFRA,1782,127,2101,"[960,Max]",Extremamente Elevado,,,,1782,Lisboa e Vale do Tejo,LISBOA,1109,29165.5,84816,3613,3334,2839,2089,1899,3988,6827,10161,13774,290.81,47.23,34.84,23.41
27-01-2021,MAIA,1336,95,961,"[960,Max]",Extremamente Elevado,,,,1336,Norte,PORTO,1306,8293.94,138971,7801,6617,4512,3339,2631,5970,10482,17099,24900,1675.56,300.22,206.16,126.38
27-01-2021,MANGUALDE,342,24,1848,"[960,Max]",Extremamente Elevado,,,,342,Centro,VISEU,1806,21925.56,18510,1198,1128,885,852,743,1595,2480,3608,4806,84.42,21.92,16.46,11.31
27-01-2021,MANTEIGAS,75,5,2494,"[960,Max]",Extremamente Elevado,,,,75,Centro,GUARDA,0908,12197.55,3007,258,197,159,167,146,313,472,669,927,24.65,7.6,5.48,3.87
27-01-2021,MARCO DE CANAVESES,423,30,821,"[480,960]",Muito Elevado,,,,423,Norte,PORTO,1307,20188.98,51496,2678,2060,1488,1265,1023,2288,3776,5836,8514,255.07,42.17,28.91,18.7
27-01-2021,MARINHA GRANDE,346,25,899,"[480,960]",Muito Elevado,,,,346,Centro,LEIRIA,1010,18725.19,38508,2365,2302,1638,1359,1058,2417,4055,6357,8722,205.65,46.58,33.95,21.66
27-01-2021,MARVÃO,41,3,1364,"[960,Max]",Extremamente Elevado,,,,41,Alentejo,PORTALEGRE,1210,15489.9,3005,198,185,142,197,237,434,576,761,959,19.4,6.19,4.91,3.72
27-01-2021,MATOSINHOS,1745,125,995,"[960,Max]",Extremamente Elevado,,,,1745,Norte,PORTO,1308,6241.97,175357,11850,9977,7023,5024,3884,8908,15931,25908,37758,2809.31,604.9,415.06,255.22
27-01-2021,MEALHADA,457,33,2295,"[960,Max]",Extremamente Elevado,,,,457,Centro,AVEIRO,0111,11065.66,19914,1163,1039,810,828,831,1659,2469,3508,4671,179.96,42.21,31.7,22.31
27-01-2021,MÊDA,143,10,3118,"[960,Max]",Extremamente Elevado,,,,143,Centro,GUARDA,0909,28604.92,4587,343,306,290,288,443,731,1021,1327,1670,16.04,5.84,4.64,3.57
27-01-2021,MELGAÇO,264,19,3262,"[960,Max]",Extremamente Elevado,,,,264,Norte,VIANA DO CASTELO,1603,23824.58,8093,507,567,578,614,675,1289,1867,2434,2941,33.97,12.34,10.22,7.84
27-01-2021,MÉRTOLA,73,5,1189,"[960,Max]",Extremamente Elevado,,,,73,Alentejo,BEJA,0209,129287.34,6142,400,390,378,423,600,1023,1401,1791,2191,4.75,1.69,1.39,1.08
27-01-2021,MESÃO FRIO,26,2,656,"[480,960]",Muito Elevado,,,,26,Norte,VILA REAL,1704,2664.87,3964,265,205,168,157,120,277,445,650,915,148.74,34.33,24.39,16.7
27-01-2021,MIRA,92,7,778,"[480,960]",Muito Elevado,,,,92,Centro,COIMBRA,0608,12403.38,11832,727,729,659,550,466,1016,1675,2404,3131,95.4,25.24,19.38,13.5
27-01-2021,MIRANDA DO CORVO,256,18,2014,"[960,Max]",Extremamente Elevado,,,,256,Centro,COIMBRA,0609,12637.79,12708,706,659,568,498,404,902,1470,2129,2835,100.55,22.43,16.85,11.63
27-01-2021,MIRANDA DO DOURO,134,10,1962,"[960,Max]",Extremamente Elevado,,,,134,Norte,BRAGANÇA,0406,48718.31,6830,482,429,442,463,470,933,1375,1804,2286,14.02,4.69,3.7,2.82
27-01-2021,MIRANDELA,389,28,1788,"[960,Max]",Extremamente Elevado,,,,389,Norte,BRAGANÇA,0407,65895.67,21754,1640,1315,1204,1078,947,2025,3229,4544,6184,33.01,9.38,6.9,4.9
27-01-2021,MOGADOURO,217,16,2586,"[960,Max]",Extremamente Elevado,,,,217,Norte,BRAGANÇA,0408,76064.93,8392,589,529,576,630,655,1285,1861,2390,2979,11.03,3.92,3.14,2.45
27-01-2021,MOIMENTA DA BEIRA,283,20,2907,"[960,Max]",Extremamente Elevado,,,,283,Norte,VISEU,1807,21996.9,9736,576,514,471,416,461,877,1348,1862,2438,44.26,11.08,8.46,6.13
27-01-2021,MOITA,1035,74,1607,"[960,Max]",Extremamente Elevado,,,,1035,Lisboa e Vale do Tejo,SETÚBAL,1506,5525.98,64407,4226,3646,2623,1801,1425,3226,5849,9495,13721,1165.53,248.3,171.82,105.85
27-01-2021,MONÇÃO,278,20,1556,"[960,Max]",Extremamente Elevado,,,,278,Norte,VIANA DO CASTELO,1604,21130.85,17869,1161,1105,1031,1006,972,1978,3009,4114,5275,84.56,24.96,19.47,14.24
27-01-2021,MONCHIQUE,5,0,98,"[0,240]",Moderado,,,,5,Algarve,FARO,0809,39530.43,5077,353,384,321,355,392,747,1068,1452,1805,12.84,4.57,3.67,2.7
27-01-2021,MONDIM DE BASTO,65,5,936,"[480,960]",Muito Elevado,,,,65,Norte,VILA REAL,1705,17207.52,6946,395,300,314,284,283,567,881,1181,1576,40.36,9.16,6.86,5.12
27-01-2021,MONFORTE,44,3,1479,"[960,Max]",Extremamente Elevado,,,,44,Alentejo,PORTALEGRE,1211,42024.82,2975,139,115,117,192,168,360,477,592,731,7.08,1.74,1.41,1.14
27-01-2021,MONTALEGRE,134,10,1489,"[960,Max]",Extremamente Elevado,,,,134,Norte,VILA REAL,1706,80545.71,8997,699,628,595,603,730,1333,1928,2556,3255,11.17,4.04,3.17,2.39
27-01-2021,MONTEMOR-O-NOVO,309,22,1975,"[960,Max]",Extremamente Elevado,,,,309,Alentejo,ÉVORA,0706,123296.65,15647,991,953,868,878,971,1849,2717,3670,4661,12.69,3.78,2.98,2.2
27-01-2021,MONTEMOR-O-VELHO,402,29,1594,"[960,Max]",Extremamente Elevado,,,,402,Centro,COIMBRA,0610,22896.23,25224,1496,1397,1217,1057,988,2045,3262,4659,6155,110.17,26.88,20.35,14.25
27-01-2021,MONTIJO,690,49,1198,"[960,Max]",Extremamente Elevado,,,,690,Lisboa e Vale do Tejo,SETÚBAL,1507,34861.64,57614,2771,2441,1990,1554,1109,2663,4653,7094,9865,165.26,28.3,20.35,13.35
27-01-2021,MORA,31,2,749,"[480,960]",Muito Elevado,,,,31,Alentejo,ÉVORA,0707,44395.02,4138,336,275,252,238,257,495,747,1022,1358,9.32,3.06,2.3,1.68
27-01-2021,MORTÁGUA,89,6,1011,"[960,Max]",Extremamente Elevado,,,,89,Centro,VISEU,1808,25117.82,8803,638,584,535,499,460,959,1494,2078,2716,35.05,10.81,8.27,5.95
27-01-2021,MOURA,279,20,2034,"[960,Max]",Extremamente Elevado,,,,279,Alentejo,BEJA,0210,95845.55,13718,817,656,665,542,461,1003,1668,2324,3141,14.31,3.28,2.42,1.74
27-01-2021,MOURÃO,15,1,612,"[480,960]",Muito Elevado,,,,15,Alentejo,ÉVORA,0708,27862.98,2450,139,108,80,104,109,213,293,401,540,8.79,1.94,1.44,1.05
27-01-2021,MURÇA,119,8,2178,"[960,Max]",Extremamente Elevado,,,,119,Norte,VILA REAL,1707,18937.11,5463,384,341,307,306,319,625,932,1273,1657,28.85,8.75,6.72,4.92
27-01-2021,MURTOSA,116,8,1129,"[960,Max]",Extremamente Elevado,,,,116,Centro,AVEIRO,0112,7308.78,10279,509,473,403,353,409,762,1165,1638,2147,140.63,29.37,22.41,15.94
27-01-2021,NAZARÉ,250,18,1765,"[960,Max]",Extremamente Elevado,,,,250,Lisboa e Vale do Tejo,LEIRIA,1011,8243.43,14165,967,903,670,420,396,816,1486,2389,3356,171.84,40.71,28.98,18.03
27-01-2021,NELAS,257,18,1981,"[960,Max]",Extremamente Elevado,,,,257,Centro,VISEU,1809,12571.48,12974,924,787,668,604,583,1187,1855,2642,3566,103.21,28.37,21.02,14.76
27-01-2021,NISA,49,3,808,"[480,960]",Muito Elevado,,,,49,Alentejo,PORTALEGRE,1212,57567.84,6061,405,389,355,483,478,961,1316,1705,2110,10.53,3.67,2.96,2.29
27-01-2021,NORDESTE,1,0,21,"[0,240]",Moderado,,,,1,Açores,AÇORES,4202,10146.8,4862,246,180,124,161,162,323,447,627,873,47.92,8.6,6.18,4.41
27-01-2021,ÓBIDOS,178,13,1502,"[960,Max]",Extremamente Elevado,,,,178,Lisboa e Vale do Tejo,LEIRIA,1012,14155.44,11850,743,650,574,452,436,888,1462,2112,2855,83.72,20.17,14.92,10.33
27-01-2021,ODEMIRA,144,10,583,"[480,960]",Muito Elevado,,,,144,Alentejo,BEJA,0211,172060.15,24717,1475,1317,1225,1397,1349,2746,3971,5288,6763,14.37,3.93,3.07,2.31
27-01-2021,ODIVELAS,3240,231,2003,"[960,Max]",Extremamente Elevado,,,,3240,Lisboa e Vale do Tejo,LISBOA,1116,2654.36,161774,9562,9038,6952,4641,3812,8453,15405,24443,34005,6095.48,1281.27,920.99,580.44
27-01-2021,OEIRAS,3059,218,1724,"[960,Max]",Extremamente Elevado,,,,3059,Lisboa e Vale do Tejo,LISBOA,1110,4588.31,177408,11580,11575,8566,6211,5855,12066,20632,32207,43787,3866.78,954.38,701.98,449.69
27-01-2021,OLEIROS,25,2,500,"[480,960]",Muito Elevado,,,,25,Centro,CASTELO BRANCO,0506,47109.31,5003,384,341,366,397,487,884,1250,1591,1975,10.62,4.19,3.38,2.65
27-01-2021,OLHÃO,482,34,1085,"[960,Max]",Extremamente Elevado,,,,482,Algarve,FARO,0810,13086.38,44405,2455,2309,1689,1342,1268,2610,4299,6608,9063,339.33,69.26,50.5,32.85
27-01-2021,OLIVEIRA DE AZEMÉIS,1012,72,1533,"[960,Max]",Extremamente Elevado,,,,1012,Norte,AVEIRO,0113,16110.41,66011,4155,3614,2794,2183,1738,3921,6715,10329,14484,409.75,89.91,64.12,41.68
27-01-2021,OLIVEIRA DE FRADES,276,20,2778,"[960,Max]",Extremamente Elevado,,,,276,Centro,VISEU,1810,14534.62,9936,553,475,438,359,415,774,1212,1687,2240,68.36,15.41,11.61,8.34
27-01-2021,OLIVEIRA DO BAIRRO,298,21,1227,"[960,Max]",Extremamente Elevado,,,,298,Centro,AVEIRO,0114,8731.99,24277,1327,1182,999,786,810,1596,2595,3777,5104,278.02,58.45,43.25,29.72
27-01-2021,OLIVEIRA DO HOSPITAL,321,23,1667,"[960,Max]",Extremamente Elevado,,,,321,Centro,COIMBRA,0611,23451.66,19253,1161,1097,962,924,960,1884,2846,3943,5104,82.1,21.76,16.81,12.14
27-01-2021,OURÉM,820,59,1862,"[960,Max]",Extremamente Elevado,,,,820,Lisboa e Vale do Tejo,SANTARÉM,1421,41668.03,44044,2463,2069,1899,1817,1603,3420,5319,7388,9851,105.7,23.64,17.73,12.77
27-01-2021,OURIQUE,59,4,1281,"[960,Max]",Extremamente Elevado,,,,59,Alentejo,BEJA,0212,66331.36,4607,313,287,284,268,227,495,779,1066,1379,6.95,2.08,1.61,1.17
27-01-2021,OVAR,977,70,1801,"[960,Max]",Extremamente Elevado,,,,977,Centro,AVEIRO,0115,14770.25,54260,3294,2709,1994,1636,1234,2870,4864,7573,10867,367.37,73.57,51.27,32.93
27-01-2021,PAÇOS DE FERREIRA,379,27,668,"[480,960]",Muito Elevado,,,,379,Norte,PORTO,1309,7099.29,56728,2903,2193,1518,1135,664,1799,3317,5510,8413,799.1,118.51,77.62,46.72
27-01-2021,PALMELA,1287,92,2003,"[960,Max]",Extremamente Elevado,,,,1287,Lisboa e Vale do Tejo,SETÚBAL,1508,46512.01,64269,3402,3244,2635,1846,1391,3237,5872,9116,12518,138.18,26.91,19.6,12.62
27-01-2021,PAMPILHOSA DA SERRA,84,6,2081,"[960,Max]",Extremamente Elevado,,,,84,Centro,COIMBRA,0612,39646.24,4037,238,254,295,339,423,762,1057,1311,1549,10.18,3.91,3.31,2.67
27-01-2021,PAREDES,718,51,834,"[480,960]",Muito Elevado,,,,718,Norte,PORTO,1310,15675.69,86067,4272,3532,2412,1717,1258,2975,5387,8919,13191,549.04,84.15,56.9,34.36
27-01-2021,PAREDES DE COURA,276,20,3234,"[960,Max]",Extremamente Elevado,,,,276,Norte,VIANA DO CASTELO,1605,13818.59,8535,466,528,407,465,515,980,1387,1915,2381,61.76,17.23,13.86,10.04
27-01-2021,PEDRÓGÃO GRANDE,30,2,880,"[480,960]",Muito Elevado,,,,30,Centro,LEIRIA,1013,12874.75,3410,175,173,196,221,252,473,669,842,1017,26.49,7.9,6.54,5.2
27-01-2021,PENACOVA,396,28,2892,"[960,Max]",Extremamente Elevado,,,,396,Centro,COIMBRA,0613,21673.23,13694,968,923,745,621,703,1324,2069,2992,3960,63.18,18.27,13.81,9.55
27-01-2021,PENAFIEL,736,53,1055,"[960,Max]",Extremamente Elevado,,,,736,Norte,PORTO,1311,21224.27,69772,3648,2823,2032,1663,1230,2893,4925,7748,11396,328.74,53.69,36.51,23.2
27-01-2021,PENALVA DO CASTELO,247,18,3472,"[960,Max]",Extremamente Elevado,,,,247,Centro,VISEU,1811,13433.92,7115,449,457,413,391,426,817,1230,1687,2136,52.96,15.9,12.56,9.16
27-01-2021,PENAMACOR,83,6,1746,"[960,Max]",Extremamente Elevado,,,,83,Centro,CASTELO BRANCO,0507,56370.69,4755,262,248,273,451,633,1084,1357,1605,1867,8.44,3.31,2.85,2.41
27-01-2021,PENEDONO,194,14,7487,"[960,Max]",Extremamente Elevado,,,,194,Norte,VISEU,1812,13370.75,2591,172,113,129,156,138,294,423,536,708,19.38,5.3,4.01,3.16
27-01-2021,PENELA,91,6,1686,"[960,Max]",Extremamente Elevado,,,,91,Centro,COIMBRA,0614,13480.0,5397,314,324,274,359,344,703,977,1301,1615,40.04,11.98,9.65,7.25
27-01-2021,PENICHE,415,30,1566,"[960,Max]",Extremamente Elevado,,,,415,Lisboa e Vale do Tejo,LEIRIA,1014,7754.98,26501,1746,1504,1203,926,707,1633,2836,4340,6086,341.73,78.48,55.96,36.57
27-01-2021,PESO DA RÉGUA,224,16,1420,"[960,Max]",Extremamente Elevado,,,,224,Norte,VILA REAL,1708,9486.01,15773,1076,843,650,659,455,1114,1764,2607,3683,166.28,38.83,27.48,18.6
27-01-2021,PINHEL,194,14,2279,"[960,Max]",Extremamente Elevado,,,,194,Centro,GUARDA,0910,48452.12,8511,577,566,551,538,689,1227,1778,2344,2921,17.57,6.03,4.84,3.67
27-01-2021,POMBAL,893,64,1735,"[960,Max]",Extremamente Elevado,,,,893,Centro,LEIRIA,1015,62600.28,51461,3187,2791,2494,2328,2027,4355,6849,9640,12827,82.21,20.49,15.4,10.94
27-01-2021,PONTA DELGADA,130,9,191,"[0,240]",Moderado,,,,130,Açores,AÇORES,4203,23298.65,67935,3108,2435,1726,1133,902,2035,3761,6196,9304,291.58,39.93,26.59,16.14
27-01-2021,PONTA DO SOL,26,2,303,"[240,480]",Elevado,,,,26,Madeira,MADEIRA,3105,4622.03,8593,319,283,347,208,221,429,776,1059,1378,185.92,29.81,22.91,16.79
27-01-2021,PONTE DA BARCA,344,25,3077,"[960,Max]",Extremamente Elevado,,,,344,Norte,VIANA DO CASTELO,1606,18211.37,11180,635,576,517,554,490,1044,1561,2137,2772,61.39,15.22,11.73,8.57
27-01-2021,PONTE DE LIMA,969,69,2345,"[960,Max]",Extremamente Elevado,,,,969,Norte,VIANA DO CASTELO,1607,32025.46,41315,2321,2022,1720,1596,1462,3058,4778,6800,9121,129.01,28.48,21.23,14.92
27-01-2021,PONTE DE SOR,369,26,2461,"[960,Max]",Extremamente Elevado,,,,369,Alentejo,PORTALEGRE,1213,83971.16,14994,939,800,716,739,831,1570,2286,3086,4025,17.86,4.79,3.68,2.72
27-01-2021,PORTALEGRE,230,16,1037,"[960,Max]",Extremamente Elevado,,,,230,Alentejo,PORTALEGRE,1214,44713.64,22172,1577,1351,1137,993,984,1977,3114,4465,6042,49.59,13.51,9.99,6.96
27-01-2021,PORTEL,71,5,1218,"[960,Max]",Extremamente Elevado,,,,71,Alentejo,ÉVORA,0709,60100.57,5828,336,358,283,331,305,636,919,1277,1613,9.7,2.68,2.12,1.53
27-01-2021,PORTIMÃO,314,22,566,"[480,960]",Muito Elevado,,,,314,Algarve,FARO,0811,18206.29,55483,3182,2927,2116,1582,1400,2982,5098,8025,11207,304.75,61.56,44.08,28.0
27-01-2021,PORTO,2428,173,1121,"[960,Max]",Extremamente Elevado,,,,2428,Norte,PORTO,1312,4142.02,216606,15790,15193,11280,9409,10044,19453,30733,45926,61716,5229.5,1490.0,1108.79,741.98
27-01-2021,PORTO DE MÓS,446,32,1916,"[960,Max]",Extremamente Elevado,,,,446,Centro,LEIRIA,1016,26183.41,23275,1355,1210,1034,888,872,1760,2794,4004,5359,88.89,20.47,15.29,10.67
27-01-2021,PORTO MONIZ,3,0,128,"[0,240]",Moderado,,,,3,Madeira,MADEIRA,3106,8293.38,2342,143,130,95,98,120,218,313,443,586,28.24,7.07,5.34,3.77
27-01-2021,PORTO SANTO,36,3,692,"[480,960]",Muito Elevado,,,,36,Madeira,MADEIRA,3201,4300.7,5202,240,157,134,110,68,178,312,469,709,120.95,16.48,10.9,7.25
27-01-2021,PÓVOA DE LANHOSO,393,28,1828,"[960,Max]",Extremamente Elevado,,,,393,Norte,BRAGA,0309,13465.29,21499,1175,909,732,673,624,1297,2029,2938,4113,159.67,30.55,21.82,15.07
27-01-2021,PÓVOA DE VARZIM,1219,87,1942,"[960,Max]",Extremamente Elevado,,,,1219,Norte,PORTO,1313,8220.59,62784,3712,3120,2134,1594,1305,2899,5033,8153,11865,763.7,144.33,99.17,61.22
27-01-2021,POVOAÇÃO,7,0,118,"[0,240]",Moderado,,,,7,Açores,AÇORES,4204,10640.77,5927,293,212,191,144,134,278,469,681,974,55.7,9.15,6.4,4.41
27-01-2021,VILA DA PRAIA DA VITÓRIA,26,2,122,"[0,240]",Moderado,,,,26,Açores,AÇORES,4302,16127.06,21317,1133,789,619,436,336,772,1391,2180,3313,132.18,20.54,13.52,8.63
27-01-2021,PROENÇA-A-NOVA,33,2,452,"[240,480]",Elevado,,,,33,Centro,CASTELO BRANCO,0508,39539.96,7298,508,465,389,400,560,960,1349,1814,2322,18.46,5.87,4.59,3.41
27-01-2021,REDONDO,168,12,2644,"[960,Max]",Extremamente Elevado,,,,168,Alentejo,ÉVORA,0710,36950.87,6353,349,325,288,288,354,642,930,1255,1604,17.19,4.34,3.4,2.52
27-01-2021,REGUENGOS DE MONSARAZ,198,14,1977,"[960,Max]",Extremamente Elevado,,,,198,Alentejo,ÉVORA,0711,46399.72,10015,602,511,455,462,473,935,1390,1901,2503,21.58,5.39,4.1,3.0
27-01-2021,RESENDE,134,10,1322,"[960,Max]",Extremamente Elevado,,,,134,Norte,VISEU,1813,12334.93,10137,560,493,448,433,422,855,1303,1796,2356,82.18,19.1,14.56,10.56
27-01-2021,RIBEIRA BRAVA,47,3,378,"[240,480]",Elevado,,,,47,Madeira,MADEIRA,3107,6544.88,12435,648,500,411,311,287,598,1009,1509,2157,189.99,32.96,23.06,15.42
27-01-2021,RIBEIRA DE PENA,117,8,1945,"[960,Max]",Extremamente Elevado,,,,117,Norte,VILA REAL,1709,21745.98,6016,371,301,290,310,368,678,968,1269,1640,27.66,7.54,5.84,4.45
27-01-2021,RIBEIRA GRANDE,270,19,823,"[480,960]",Muito Elevado,,,,270,Açores,AÇORES,4205,18015.13,32811,1163,689,512,345,253,598,1110,1799,2962,182.13,16.44,9.99,6.16
27-01-2021,RIO MAIOR,532,38,2611,"[960,Max]",Extremamente Elevado,,,,532,Lisboa e Vale do Tejo,SANTARÉM,1414,27276.45,20379,1251,1144,941,795,648,1443,2384,3528,4779,74.71,17.52,12.93,8.74
27-01-2021,SABROSA,63,5,1065,"[960,Max]",Extremamente Elevado,,,,63,Norte,VILA REAL,1710,15692.45,5918,393,314,304,302,350,652,956,1270,1663,37.71,10.6,8.09,6.09
27-01-2021,SABUGAL,136,10,1285,"[960,Max]",Extremamente Elevado,,,,136,Centro,GUARDA,0911,82269.82,10585,724,707,694,796,1009,1805,2499,3206,3930,12.87,4.78,3.9,3.04
27-01-2021,SALVATERRA DE MAGOS,380,27,1784,"[960,Max]",Extremamente Elevado,,,,380,Lisboa e Vale do Tejo,SANTARÉM,1415,24393.2,21295,1275,1181,1060,799,772,1571,2631,3812,5087,87.3,20.85,15.63,10.79
27-01-2021,SANTA COMBA DÃO,130,9,1244,"[960,Max]",Extremamente Elevado,,,,130,Centro,VISEU,1814,11194.77,10452,732,684,569,538,464,1002,1571,2255,2987,93.36,26.68,20.14,14.03
27-01-2021,SANTA CRUZ,142,10,314,"[240,480]",Elevado,,,,142,Madeira,MADEIRA,3108,8150.28,45281,1817,1301,974,716,523,1239,2213,3514,5331,555.6,65.41,43.12,27.15
27-01-2021,SANTA CRUZ DA GRACIOSA,1,0,24,"[0,240]",Moderado,,,,1,Açores,AÇORES,4401,6065.78,4208,228,180,163,124,145,269,432,612,840,69.37,13.85,10.09,7.12
27-01-2021,SANTA CRUZ DAS FLORES,4,0,185,"[0,240]",Moderado,,,,4,Açores,AÇORES,4802,7091.44,2165,125,98,74,56,51,107,181,279,404,30.53,5.7,3.93,2.55
27-01-2021,SANTA MARIA DA FEIRA,2293,164,1654,"[960,Max]",Extremamente Elevado,,,,2293,Norte,AVEIRO,0109,21587.65,138636,8182,6743,4771,3856,3079,6935,11706,18449,26631,642.19,123.36,85.46,54.22
27-01-2021,SANTA MARTA DE PENAGUIÃO,73,5,1106,"[960,Max]",Extremamente Elevado,,,,73,Norte,VILA REAL,1711,6928.13,6599,483,373,337,316,317,633,970,1343,1826,95.25,26.36,19.39,14.0
27-01-2021,SANTANA,19,1,283,"[240,480]",Elevado,,,,19,Madeira,MADEIRA,3109,9547.3,6711,418,353,343,282,277,559,902,1255,1673,70.29,17.52,13.15,9.45
27-01-2021,SANTARÉM,874,62,1522,"[960,Max]",Extremamente Elevado,,,,874,Lisboa e Vale do Tejo,SANTARÉM,1416,55253.58,57421,3654,3441,2760,2466,2206,4672,7432,10873,14527,103.92,26.29,19.68,13.45
27-01-2021,SANTIAGO DO CACÉM,250,18,868,"[480,960]",Muito Elevado,,,,250,Alentejo,SETÚBAL,1509,105969.29,28791,2144,1689,1472,1295,1215,2510,3982,5671,7815,27.17,7.37,5.35,3.76
27-01-2021,SANTO TIRSO,902,64,1325,"[960,Max]",Extremamente Elevado,,,,902,Norte,PORTO,1314,13655.52,68055,4911,3935,2761,2257,1810,4067,6828,10763,15674,498.35,114.78,78.82,50.0
27-01-2021,SÃO BRÁS DE ALPORTEL,75,5,720,"[480,960]",Muito Elevado,,,,75,Algarve,FARO,0812,15336.92,10416,596,468,467,404,401,805,1272,1740,2336,67.91,15.23,11.35,8.29
27-01-2021,SÃO JOÃO DA MADEIRA,353,25,1608,"[960,Max]",Extremamente Elevado,,,,353,Norte,AVEIRO,0116,794.3,21958,1347,1069,796,601,593,1194,1990,3059,4406,2765.49,554.91,385.26,250.63
27-01-2021,SÃO JOÃO DA PESQUEIRA,257,18,3607,"[960,Max]",Extremamente Elevado,,,,257,Norte,VISEU,1815,26610.85,7125,417,330,294,328,328,656,950,1280,1697,26.77,6.38,4.81,3.57
27-01-2021,SÃO PEDRO DO SUL,342,24,2220,"[960,Max]",Extremamente Elevado,,,,342,Centro,VISEU,1816,34895.09,15403,990,962,861,759,909,1668,2529,3491,4481,44.14,12.84,10.0,7.25
27-01-2021,SÃO ROQUE DO PICO,2,0,61,"[0,240]",Moderado,,,,2,Açores,AÇORES,4603,14236.1,3266,199,141,93,96,113,209,302,443,642,22.94,4.51,3.11,2.12
27-01-2021,SÃO VICENTE,3,0,58,"[0,240]",Moderado,,,,3,Madeira,MADEIRA,3110,7883.71,5143,272,264,266,225,280,505,771,1035,1307,65.23,16.58,13.13,9.78
27-01-2021,SARDOAL,43,3,1149,"[960,Max]",Extremamente Elevado,,,,43,Lisboa e Vale do Tejo,SANTARÉM,1417,9214.72,3741,227,178,148,165,248,413,561,739,966,40.6,10.48,8.02,6.09
27-01-2021,SÁTÃO,362,26,3126,"[960,Max]",Extremamente Elevado,,,,362,Centro,VISEU,1817,20194.11,11580,765,671,515,465,476,941,1456,2127,2892,57.34,14.32,10.53,7.21
27-01-2021,SEIA,338,24,1520,"[960,Max]",Extremamente Elevado,,,,338,Centro,GUARDA,0912,43568.83,22234,1807,1589,1238,1122,721,1843,3081,4670,6477,51.03,14.87,10.72,7.07
27-01-2021,SEIXAL,2905,208,1732,"[960,Max]",Extremamente Elevado,,,,2905,Lisboa e Vale do Tejo,SETÚBAL,1510,9545.17,167752,10586,9270,6661,4391,2930,7321,13982,23252,33838,1757.49,354.51,243.6,146.49
27-01-2021,SERNANCELHE,313,22,5801,"[960,Max]",Extremamente Elevado,,,,313,Norte,VISEU,1818,22861.22,5396,305,293,286,273,260,533,819,1112,1417,23.6,6.2,4.86,3.58
27-01-2021,SERPA,91,6,636,"[480,960]",Muito Elevado,,,,91,Alentejo,BEJA,0213,110563.34,14304,903,761,719,697,626,1323,2042,2803,3706,12.94,3.35,2.54,1.85
27-01-2021,SERTÃ,126,9,864,"[480,960]",Muito Elevado,,,,126,Centro,CASTELO BRANCO,0509,44673.17,14577,870,779,790,767,1020,1787,2577,3356,4226,32.63,9.46,7.51,5.77
27-01-2021,SESIMBRA,926,66,1786,"[960,Max]",Extremamente Elevado,,,,926,Lisboa e Vale do Tejo,SETÚBAL,1511,19571.75,51858,2400,2321,1853,1257,1083,2340,4193,6514,8914,264.96,45.54,33.28,21.42
27-01-2021,SETÚBAL,2964,212,2575,"[960,Max]",Extremamente Elevado,,,,2964,Lisboa e Vale do Tejo,SETÚBAL,1512,23032.5,115126,7425,6929,5075,3775,2655,6430,11505,18434,25859,499.83,112.27,80.03,49.95
27-01-2021,SEVER DO VOUGA,277,20,2445,"[960,Max]",Extremamente Elevado,,,,277,Centro,AVEIRO,0117,12987.56,11331,766,637,568,540,567,1107,1675,2312,3078,87.24,23.7,17.8,12.9
27-01-2021,SILVES,269,19,743,"[480,960]",Muito Elevado,,,,269,Algarve,FARO,0813,68006.23,36226,2137,1869,1610,1423,1600,3023,4633,6502,8639,53.27,12.7,9.56,6.81
27-01-2021,SINES,103,7,751,"[480,960]",Muito Elevado,,,,103,Alentejo,SETÚBAL,1513,20330.17,13715,888,791,551,416,268,684,1235,2026,2914,67.46,14.33,9.97,6.07
27-01-2021,SINTRA,8145,582,2081,"[960,Max]",Extremamente Elevado,,,,8145,Lisboa e Vale do Tejo,LISBOA,1111,31922.73,391402,20490,18316,13545,9137,7284,16421,29966,48282,68772,1226.08,215.43,151.25,93.87
27-01-2021,SOBRAL DE MONTE AGRAÇO,186,13,1746,"[960,Max]",Extremamente Elevado,,,,186,Lisboa e Vale do Tejo,LISBOA,1112,5210.32,10651,564,507,352,272,212,484,836,1343,1907,204.43,36.6,25.78,16.05
27-01-2021,SOURE,189,14,1104,"[960,Max]",Extremamente Elevado,,,,189,Centro,COIMBRA,0615,26506.07,17120,1173,1142,1004,883,987,1870,2874,4016,5189,64.59,19.58,15.15,10.84
27-01-2021,SOUSEL,33,2,748,"[480,960]",Muito Elevado,,,,33,Alentejo,PORTALEGRE,1215,27932.18,4412,261,274,208,302,292,594,802,1076,1337,15.8,4.79,3.85,2.87
27-01-2021,TÁBUA,458,33,4029,"[960,Max]",Extremamente Elevado,,,,458,Centro,COIMBRA,0616,19978.58,11368,729,584,524,430,464,894,1418,2002,2731,56.9,13.67,10.02,7.1
27-01-2021,TABUAÇO,64,5,1061,"[960,Max]",Extremamente Elevado,,,,64,Norte,VISEU,1819,13385.67,6033,372,314,217,282,363,645,862,1176,1548,45.07,11.56,8.79,6.44
27-01-2021,TAROUCA,217,16,2781,"[960,Max]",Extremamente Elevado,,,,217,Norte,VISEU,1820,10008.49,7804,405,335,313,277,324,601,914,1249,1654,77.98,16.53,12.48,9.13
27-01-2021,TAVIRA,343,24,1398,"[960,Max]",Extremamente Elevado,,,,343,Algarve,FARO,0814,60696.7,24530,1493,1415,1252,1066,1277,2343,3595,5010,6503,40.41,10.71,8.25,5.92
27-01-2021,TERRAS DE BOURO,82,6,1289,"[960,Max]",Extremamente Elevado,,,,82,Norte,BRAGA,0310,27746.07,6361,391,372,296,319,340,659,955,1327,1718,22.93,6.19,4.78,3.44
27-01-2021,TOMAR,789,56,2147,"[960,Max]",Extremamente Elevado,,,,789,Lisboa e Vale do Tejo,SANTARÉM,1418,35120.44,36748,2403,2189,1868,1853,1822,3675,5543,7732,10135,104.64,28.86,22.02,15.78
27-01-2021,TONDELA,525,38,1992,"[960,Max]",Extremamente Elevado,,,,525,Centro,VISEU,1821,37121.73,26357,1768,1722,1518,1475,1417,2892,4410,6132,7900,71.0,21.28,16.52,11.88
27-01-2021,TORRE DE MONCORVO,42,3,546,"[480,960]",Muito Elevado,,,,42,Norte,BRAGANÇA,0409,53155.67,7695,556,478,488,551,719,1270,1758,2236,2792,14.48,5.25,4.21,3.31
27-01-2021,TORRES NOVAS,545,39,1560,"[960,Max]",Extremamente Elevado,,,,545,Lisboa e Vale do Tejo,SANTARÉM,1419,26999.68,34933,2324,1979,1738,1406,1475,2881,4619,6598,8922,129.38,33.04,24.44,17.11
27-01-2021,TORRES VEDRAS,1420,101,1808,"[960,Max]",Extremamente Elevado,,,,1420,Lisboa e Vale do Tejo,LISBOA,1113,40714.89,78530,4513,3945,3447,2628,2104,4732,8179,12124,16637,192.88,40.86,29.78,20.09
27-01-2021,TRANCOSO,186,13,2096,"[960,Max]",Extremamente Elevado,,,,186,Centro,GUARDA,0913,36152.47,8875,581,557,542,586,496,1082,1624,2181,2762,24.55,7.64,6.03,4.49
27-01-2021,TROFA,542,39,1411,"[960,Max]",Extremamente Elevado,,,,542,Norte,PORTO,1318,7201.76,38418,2336,1894,1231,939,684,1623,2854,4748,7084,533.44,98.36,65.93,39.63
27-01-2021,VAGOS,221,16,972,"[960,Max]",Extremamente Elevado,,,,221,Centro,AVEIRO,0118,16491.5,22740,1320,1205,922,784,724,1508,2430,3635,4955,137.89,30.04,22.04,14.73
27-01-2021,VALE DE CAMBRA,413,30,1937,"[960,Max]",Extremamente Elevado,,,,413,Norte,AVEIRO,0119,14733.47,21327,1491,1363,1005,831,798,1629,2634,3997,5488,144.76,37.25,27.13,17.88
27-01-2021,VALENÇA,240,17,1806,"[960,Max]",Extremamente Elevado,,,,240,Norte,VIANA DO CASTELO,1608,11712.86,13290,867,791,582,582,503,1085,1667,2458,3325,113.46,28.39,20.99,14.23
27-01-2021,VALONGO,1081,77,1109,"[960,Max]",Extremamente Elevado,,,,1081,Norte,PORTO,1315,7512.45,97444,5629,4696,3207,2462,1829,4291,7498,12194,17823,1297.18,237.26,162.33,99.81
27-01-2021,VALPAÇOS,221,16,1491,"[960,Max]",Extremamente Elevado,,,,221,Norte,VILA REAL,1712,54873.93,14818,1217,1118,999,928,997,1925,2924,4042,5259,27.0,9.58,7.37,5.33
27-01-2021,VELAS,0,0,0,"[0,240]",Moderado,,,,0,Açores,AÇORES,4502,11738.38,5093,278,208,166,153,113,266,432,640,918,43.39,7.82,5.45,3.68
27-01-2021,VENDAS NOVAS,135,10,1199,"[960,Max]",Extremamente Elevado,,,,135,Alentejo,ÉVORA,0712,22238.88,11255,677,768,655,501,532,1033,1688,2456,3133,50.61,14.09,11.04,7.59
27-01-2021,VIANA DO ALENTEJO,99,7,1924,"[960,Max]",Extremamente Elevado,,,,99,Alentejo,ÉVORA,0713,39367.29,5145,245,208,235,210,214,424,659,867,1112,13.07,2.82,2.2,1.67
27-01-2021,VIANA DO CASTELO,1323,94,1567,"[960,Max]",Extremamente Elevado,,,,1323,Norte,VIANA DO CASTELO,1609,31902.01,84417,5470,4433,3591,3061,2982,6043,9634,14067,19537,264.61,61.24,44.09,30.2
27-01-2021,VIDIGUEIRA,29,2,526,"[480,960]",Muito Elevado,,,,29,Alentejo,BEJA,0214,31661.09,5510,300,248,215,233,275,508,723,971,1271,17.4,4.01,3.07,2.28
27-01-2021,VIEIRA DO MINHO,242,17,2044,"[960,Max]",Extremamente Elevado,,,,242,Norte,BRAGA,0311,21644.35,11842,703,594,525,548,482,1030,1555,2149,2852,54.71,13.18,9.93,7.18
27-01-2021,VILA DE REI,27,2,813,"[480,960]",Muito Elevado,,,,27,Centro,CASTELO BRANCO,0510,19154.6,3323,169,128,172,247,302,549,721,849,1018,17.35,5.31,4.43,3.76
27-01-2021,VILA DO BISPO,19,1,369,"[240,480]",Elevado,,,,19,Algarve,FARO,0815,17906.06,5154,302,302,314,232,233,465,779,1081,1383,28.78,7.72,6.04,4.35
27-01-2021,VILA DO CONDE,1425,102,1784,"[960,Max]",Extremamente Elevado,,,,1425,Norte,PORTO,1316,14902.77,79899,4726,3875,2819,2070,1743,3813,6632,10507,15233,536.13,102.21,70.5,44.5
27-01-2021,VILA DO PORTO,4,0,71,"[0,240]",Moderado,,,,4,Açores,AÇORES,4101,9688.74,5616,274,212,135,96,123,219,354,566,840,57.96,8.67,5.84,3.65
27-01-2021,VILA FLOR,128,9,2118,"[960,Max]",Extremamente Elevado,,,,128,Norte,BRAGANÇA,0410,26581.14,6044,429,362,422,294,331,625,1047,1409,1838,22.74,6.91,5.3,3.94
27-01-2021,VILA FRANCA DE XIRA,3039,217,2141,"[960,Max]",Extremamente Elevado,,,,3039,Lisboa e Vale do Tejo,LISBOA,1114,31819.39,141957,8501,6852,4869,3425,2472,5897,10766,17618,26119,446.14,82.09,55.37,33.84
27-01-2021,VILA FRANCA DO CAMPO,74,5,670,"[480,960]",Muito Elevado,,,,74,Açores,AÇORES,4206,7796.82,11051,450,344,248,217,154,371,619,963,1413,141.73,18.12,12.35,7.94
27-01-2021,VILA NOVA DA BARQUINHA,60,4,804,"[480,960]",Muito Elevado,,,,60,Lisboa e Vale do Tejo,SANTARÉM,1420,4952.97,7461,415,406,392,364,338,702,1094,1500,1915,150.64,38.66,30.28,22.09
27-01-2021,VILA NOVA DE CERVEIRA,178,13,1998,"[960,Max]",Extremamente Elevado,,,,178,Norte,VIANA DO CASTELO,1610,10846.66,8910,531,444,410,384,334,718,1128,1572,2103,82.14,19.39,14.49,10.4
27-01-2021,VILA NOVA DE FAMALICÃO,2183,156,1658,"[960,Max]",Extremamente Elevado,,,,2183,Norte,BRAGA,0312,20159.26,131676,7817,6164,4202,3282,2749,6031,10233,16397,24214,653.19,120.12,81.34,50.76
27-01-2021,VILA NOVA DE FOZ CÔA,139,10,2137,"[960,Max]",Extremamente Elevado,,,,139,Centro,GUARDA,0914,39815.18,6503,442,385,390,398,429,827,1217,1602,2044,16.33,5.13,4.02,3.06
27-01-2021,VILA NOVA DE GAIA,3182,227,1059,"[960,Max]",Extremamente Elevado,,,,3182,Norte,PORTO,1317,16846.43,300472,18349,15568,10972,8224,6281,14505,25477,41045,59394,1783.64,352.57,243.65,151.23
27-01-2021,VILA NOVA DE PAIVA,130,9,2774,"[960,Max]",Extremamente Elevado,,,,130,Centro,VISEU,1822,17553.28,4687,289,272,233,217,241,458,691,963,1252,26.7,7.13,5.49,3.94
27-01-2021,VILA NOVA DE POIARES,102,7,1470,"[960,Max]",Extremamente Elevado,,,,102,Centro,COIMBRA,0617,8445.3,6939,380,284,262,235,182,417,679,963,1343,82.17,15.9,11.4,8.04
27-01-2021,VILA POUCA DE AGUIAR,130,9,1087,"[960,Max]",Extremamente Elevado,,,,130,Norte,VILA REAL,1713,43706.62,11961,860,817,733,601,627,1228,1961,2778,3638,27.37,8.32,6.36,4.49
27-01-2021,VILA REAL,659,47,1319,"[960,Max]",Extremamente Elevado,,,,659,Norte,VILA REAL,1714,37880.28,49962,3025,2498,2065,1579,1466,3045,5110,7608,10633,131.9,28.07,20.08,13.49
27-01-2021,VILA REAL DE SANTO ANTÓNIO,401,29,2139,"[960,Max]",Extremamente Elevado,,,,401,Algarve,FARO,0816,6125.0,18749,1172,1069,811,569,586,1155,1966,3035,4207,306.11,68.69,49.55,32.1
27-01-2021,VILA VELHA DE RÓDÃO,24,2,763,"[480,960]",Muito Elevado,,,,24,Centro,CASTELO BRANCO,0511,32991.16,3144,209,229,180,283,306,589,769,998,1207,9.53,3.66,3.03,2.33
27-01-2021,VILA VERDE,868,62,1850,"[960,Max]",Extremamente Elevado,,,,868,Norte,BRAGA,0313,22866.52,46911,2365,2063,1667,1494,1437,2931,4598,6661,9026,205.15,39.47,29.13,20.11
27-01-2021,VILA VIÇOSA,123,9,1607,"[960,Max]",Extremamente Elevado,,,,123,Alentejo,ÉVORA,0714,19485.89,7656,487,379,342,345,324,669,1011,1390,1877,39.29,9.63,7.13,5.19
27-01-2021,VIMIOSO,22,2,547,"[480,960]",Muito Elevado,,,,22,Norte,BRAGANÇA,0411,48158.51,4023,274,230,261,293,335,628,889,1119,1393,8.35,2.89,2.32,1.85
27-01-2021,VINHAIS,162,12,2091,"[960,Max]",Extremamente Elevado,,,,162,Norte,BRAGANÇA,0412,69475.09,7746,599,577,636,641,815,1456,2092,2669,3268,11.15,4.7,3.84,3.01
27-01-2021,VISEU,2208,158,2270,"[960,Max]",Extremamente Elevado,,,,2208,Centro,VISEU,1823,50710.14,97249,5769,5038,4140,3158,2710,5868,10008,15046,20815,191.77,41.05,29.67,19.74
27-01-2021,VIZELA,279,20,1168,"[960,Max]",Extremamente Elevado,,,,279,Norte,BRAGA,0314,2469.83,23897,1258,928,655,509,371,880,1535,2463,3721,967.49,150.65,99.72,62.15
27-01-2021,VOUZELA,315,23,3275,"[960,Max]",Extremamente Elevado,,,,315,Centro,VISEU,1824,19369.46,9619,626,605,554,532,507,1039,1593,2198,2824,49.66,14.58,11.35,8.22
03-02-2021,ABRANTES,385,28,1096,"[960,Max]",Extremamente Elevado,,,,385,Lisboa e Vale do Tejo,SANTARÉM,1401,71469.08,35130,2473,2213,1730,1748,2021,3769,5499,7712,10185,49.15,14.25,10.79,7.69
03-02-2021,ÁGUEDA,626,45,1359,"[960,Max]",Extremamente Elevado,,,,626,Centro,AVEIRO,0101,33527.44,46075,3237,2713,2090,1635,1496,3131,5221,7934,11171,137.43,33.32,23.66,15.57
03-02-2021,AGUIAR DA BEIRA,221,16,4751,"[960,Max]",Extremamente Elevado,,,,221,Centro,GUARDA,0901,20676.57,4652,304,281,235,239,148,387,622,903,1207,22.5,5.84,4.37,3.01
03-02-2021,ALANDROAL,92,7,1843,"[960,Max]",Extremamente Elevado,,,,92,Alentejo,ÉVORA,0701,54267.81,4992,307,256,296,299,377,676,972,1228,1535,9.2,2.83,2.26,1.79
03-02-2021,ALBERGARIA-A-VELHA,248,18,1027,"[960,Max]",Extremamente Elevado,,,,248,Centro,AVEIRO,0102,15882.5,24144,1550,1298,996,687,680,1367,2363,3661,5211,152.02,32.81,23.05,14.88
03-02-2021,ALBUFEIRA,361,26,869,"[480,960]",Muito Elevado,,,,361,Algarve,FARO,0801,14066.42,41528,2067,1717,1425,985,858,1843,3268,4985,7052,295.24,50.14,35.44,23.23
03-02-2021,ALCÁCER DO SAL,248,18,2127,"[960,Max]",Extremamente Elevado,,,,248,Alentejo,SETÚBAL,1501,149987.3,11659,884,814,623,623,602,1225,1848,2662,3546,7.77,2.36,1.77,1.23
03-02-2021,ALCANENA,264,19,2061,"[960,Max]",Extremamente Elevado,,,,264,Lisboa e Vale do Tejo,SANTARÉM,1402,12732.86,12809,891,744,628,536,588,1124,1752,2496,3387,100.6,26.6,19.6,13.76
03-02-2021,ALCOBAÇA,671,48,1253,"[960,Max]",Extremamente Elevado,,,,671,Lisboa e Vale do Tejo,LEIRIA,1001,40814.09,53555,3420,2927,2466,2059,1676,3735,6201,9128,12548,131.22,30.74,22.36,15.19
03-02-2021,ALCOCHETE,375,27,1895,"[960,Max]",Extremamente Elevado,,,,375,Lisboa e Vale do Tejo,SETÚBAL,1502,12836.48,19787,857,834,691,476,447,923,1614,2448,3305,154.15,25.75,19.07,12.57
03-02-2021,ALCOUTIM,22,2,1019,"[960,Max]",Extremamente Elevado,,,,22,Algarve,FARO,0802,57536.33,2159,191,188,163,190,267,457,620,808,999,3.75,1.74,1.4,1.08
03-02-2021,ALENQUER,780,56,1771,"[960,Max]",Extremamente Elevado,,,,780,Lisboa e Vale do Tejo,LISBOA,1101,30421.92,44052,2298,2062,1629,1330,1155,2485,4114,6176,8474,144.8,27.85,20.3,13.52
03-02-2021,ALFÂNDEGA DA FÉ,133,9,2923,"[960,Max]",Extremamente Elevado,,,,133,Norte,BRAGANÇA,0401,32194.64,4550,325,277,301,274,325,599,900,1177,1502,14.13,4.67,3.66,2.8
03-02-2021,ALIJÓ,91,6,856,"[480,960]",Muito Elevado,,,,91,Norte,VILA REAL,1701,29759.89,10625,766,687,635,542,666,1208,1843,2530,3296,35.7,11.08,8.5,6.19
03-02-2021,ALJEZUR,7,0,125,"[0,240]",Moderado,,,,7,Algarve,FARO,0803,32349.95,5594,316,336,335,320,410,730,1065,1401,1717,17.29,5.31,4.33,3.29
03-02-2021,ALJUSTREL,212,15,2571,"[960,Max]",Extremamente Elevado,,,,212,Alentejo,BEJA,0201,45847.41,8247,635,521,443,347,358,705,1148,1669,2304,17.99,5.03,3.64,2.5
03-02-2021,ALMADA,3381,241,2000,"[960,Max]",Extremamente Elevado,,,,3381,Lisboa e Vale do Tejo,SETÚBAL,1503,7000.89,169039,10469,9777,7876,6144,5111,11255,19131,28908,39377,2414.5,562.45,412.91,273.26
03-02-2021,ALMEIDA,248,18,4254,"[960,Max]",Extremamente Elevado,,,,248,Centro,GUARDA,0902,51798.46,5830,441,419,396,458,393,851,1247,1666,2107,11.26,4.07,3.22,2.41
03-02-2021,ALMEIRIM,313,22,1388,"[960,Max]",Extremamente Elevado,,,,313,Lisboa e Vale do Tejo,SANTARÉM,1403,22212.05,22546,1342,1353,1106,866,843,1709,2815,4168,5510,101.5,24.81,18.76,12.67
03-02-2021,ALMODÔVAR,40,3,595,"[480,960]",Muito Elevado,,,,40,Alentejo,BEJA,0202,77788.03,6725,414,443,396,373,328,701,1097,1540,1954,8.65,2.51,1.98,1.41
03-02-2021,ALPIARÇA,72,5,1020,"[960,Max]",Extremamente Elevado,,,,72,Lisboa e Vale do Tejo,SANTARÉM,1404,9536.33,7059,515,486,363,333,274,607,970,1456,1971,74.02,20.67,15.27,10.17
03-02-2021,ALTER DO CHÃO,24,2,758,"[480,960]",Muito Elevado,,,,24,Alentejo,PORTALEGRE,1201,36206.62,3165,201,163,136,208,187,395,531,694,895,8.74,2.47,1.92,1.47
03-02-2021,ALVAIÁZERE,203,14,3077,"[960,Max]",Extremamente Elevado,,,,203,Centro,LEIRIA,1002,16047.76,6597,419,389,346,406,539,945,1291,1680,2099,41.11,13.08,10.47,8.04
03-02-2021,ALVITO,11,1,444,"[240,480]",Elevado,,,,11,Alentejo,BEJA,0203,26485.32,2477,145,110,105,111,89,200,305,415,560,9.35,2.11,1.57,1.15
03-02-2021,AMADORA,4052,289,2201,"[960,Max]",Extremamente Elevado,,,,4052,Lisboa e Vale do Tejo,LISBOA,1115,2378.47,184106,11186,10936,8780,6460,5890,12350,21130,32066,43252,7742.05,1818.84,1348.44,888.56
03-02-2021,AMARANTE,647,46,1216,"[960,Max]",Extremamente Elevado,,,,647,Norte,PORTO,1301,30133.15,53193,3086,2413,1812,1643,1311,2954,4766,7179,10265,176.53,34.07,23.82,15.82
03-02-2021,AMARES,177,13,976,"[960,Max]",Extremamente Elevado,,,,177,Norte,BRAGA,0301,8195.41,18129,1001,829,622,489,524,1013,1635,2464,3465,221.22,42.28,30.07,19.95
03-02-2021,ANADIA,405,29,1486,"[960,Max]",Extremamente Elevado,,,,405,Centro,AVEIRO,0103,21663.48,27258,1931,1698,1376,1208,1262,2470,3846,5544,7475,125.83,34.51,25.59,17.75
03-02-2021,ANGRA DO HEROÍSMO,37,3,109,"[0,240]",Moderado,,,,37,Açores,AÇORES,4301,23899.66,33807,2006,1473,1122,768,635,1403,2525,3998,6004,141.45,25.12,16.73,10.56
03-02-2021,ANSIÃO,368,26,3057,"[960,Max]",Extremamente Elevado,,,,368,Centro,LEIRIA,1003,17609.42,12039,727,709,646,694,530,1224,1870,2579,3306,68.37,18.77,14.65,10.62
03-02-2021,ARCOS DE VALDEVEZ,490,35,2342,"[960,Max]",Extremamente Elevado,,,,490,Norte,VIANA DO CASTELO,1601,44759.64,20926,1329,1338,1282,1343,1515,2858,4140,5478,6807,46.75,15.21,12.24,9.25
03-02-2021,ARGANIL,267,19,2424,"[960,Max]",Extremamente Elevado,,,,267,Centro,COIMBRA,0601,33283.93,11014,672,648,612,559,596,1155,1767,2415,3087,33.09,9.27,7.26,5.31
03-02-2021,ARMAMAR,109,8,1889,"[960,Max]",Extremamente Elevado,,,,109,Norte,VISEU,1801,11723.73,5769,357,305,309,285,310,595,904,1209,1566,49.21,13.36,10.31,7.71
03-02-2021,AROUCA,229,16,1105,"[960,Max]",Extremamente Elevado,,,,229,Norte,AVEIRO,0104,32910.52,20720,1306,1047,753,683,683,1366,2119,3166,4472,62.96,13.59,9.62,6.44
03-02-2021,ARRAIOLOS,73,5,1054,"[960,Max]",Extremamente Elevado,,,,73,Alentejo,ÉVORA,0702,68374.55,6928,435,384,283,367,480,847,1130,1514,1949,10.13,2.85,2.21,1.65
03-02-2021,ARRONCHES,45,3,1596,"[960,Max]",Extremamente Elevado,,,,45,Alentejo,PORTALEGRE,1202,31464.72,2820,155,142,162,187,179,366,528,670,825,8.96,2.62,2.13,1.68
03-02-2021,ARRUDA DOS VINHOS,304,22,1972,"[960,Max]",Extremamente Elevado,,,,304,Lisboa e Vale do Tejo,LISBOA,1102,7795.93,15412,738,738,562,509,438,947,1509,2247,2985,197.69,38.29,28.82,19.36
03-02-2021,AVEIRO,853,61,1083,"[960,Max]",Extremamente Elevado,,,,853,Centro,AVEIRO,0105,19757.57,78734,4520,4004,3050,2250,2103,4353,7403,11407,15927,398.49,80.61,57.73,37.47
03-02-2021,AVIS,20,1,471,"[240,480]",Elevado,,,,20,Alentejo,PORTALEGRE,1203,60596.51,4247,315,225,206,251,273,524,730,955,1270,7.01,2.1,1.58,1.2
03-02-2021,AZAMBUJA,358,26,1576,"[960,Max]",Extremamente Elevado,,,,358,Lisboa e Vale do Tejo,LISBOA,1103,26265.65,22716,1322,1171,1070,798,618,1416,2486,3657,4979,86.48,18.96,13.92,9.46
03-02-2021,BAIÃO,280,20,1493,"[960,Max]",Extremamente Elevado,,,,280,Norte,PORTO,1302,17452.83,18748,1070,862,714,686,725,1411,2125,2987,4057,107.42,23.25,17.11,12.18
03-02-2021,BARCELOS,2075,148,1786,"[960,Max]",Extremamente Elevado,,,,2075,Norte,BRAGA,0302,37890.14,116187,6721,5325,3619,2991,2562,5553,9172,14497,21218,306.64,56.0,38.26,24.21
03-02-2021,BARRANCOS,15,1,918,"[480,960]",Muito Elevado,,,,15,Alentejo,BEJA,0204,16841.73,1634,90,65,65,94,61,155,220,285,375,9.7,2.23,1.69,1.31
03-02-2021,BARREIRO,1473,105,1960,"[960,Max]",Extremamente Elevado,,,,1473,Lisboa e Vale do Tejo,SETÚBAL,1504,3639.07,75147,5194,5565,4459,3105,1767,4872,9331,14896,20090,2065.05,552.07,409.34,256.42
03-02-2021,BATALHA,163,12,1021,"[960,Max]",Extremamente Elevado,,,,163,Centro,LEIRIA,1004,10341.6,15963,873,762,649,529,549,1078,1727,2489,3362,154.35,32.51,24.07,16.7
03-02-2021,BEJA,567,41,1689,"[960,Max]",Extremamente Elevado,,,,567,Alentejo,BEJA,0205,114647.55,33579,2005,1840,1386,1272,1039,2311,3697,5537,7542,29.29,6.58,4.83,3.22
03-02-2021,BELMONTE,123,9,1922,"[960,Max]",Extremamente Elevado,,,,123,Centro,CASTELO BRANCO,0501,11875.91,6398,444,321,325,310,355,665,990,1311,1755,53.87,14.78,11.04,8.34
03-02-2021,BENAVENTE,634,45,2072,"[960,Max]",Extremamente Elevado,,,,634,Lisboa e Vale do Tejo,SANTARÉM,1405,52138.39,30602,1468,1376,1141,876,643,1519,2660,4036,5504,58.69,10.56,7.74,5.1
03-02-2021,BOMBARRAL,162,12,1290,"[960,Max]",Extremamente Elevado,,,,162,Lisboa e Vale do Tejo,LEIRIA,1005,9128.55,12558,875,714,561,491,429,920,1481,2195,3070,137.56,33.63,24.04,16.22
03-02-2021,BORBA,80,6,1188,"[960,Max]",Extremamente Elevado,,,,80,Alentejo,ÉVORA,0703,14518.65,6736,430,375,279,436,392,828,1107,1482,1912,46.39,13.17,10.21,7.62
03-02-2021,BOTICAS,154,11,3081,"[960,Max]",Extremamente Elevado,,,,154,Norte,VILA REAL,1702,32195.66,4998,347,306,311,305,380,685,996,1302,1649,15.52,5.12,4.04,3.09
03-02-2021,BRAGA,2199,157,1204,"[960,Max]",Extremamente Elevado,,,,2199,Norte,BRAGA,0303,18339.95,182679,10029,7963,5241,4320,3671,7991,13232,21195,31224,996.07,170.25,115.57,72.15
03-02-2021,BRAGANÇA,530,38,1577,"[960,Max]",Extremamente Elevado,,,,530,Norte,BRAGANÇA,0402,117357.27,33607,2402,1855,1652,1393,1163,2556,4208,6063,8465,28.64,7.21,5.17,3.59
03-02-2021,CABECEIRAS DE BASTO,145,10,928,"[480,960]",Muito Elevado,,,,145,Norte,BRAGA,0304,24182.16,15628,774,594,544,575,574,1149,1693,2287,3061,64.63,12.66,9.46,7.0
03-02-2021,CADAVAL,113,8,826,"[480,960]",Muito Elevado,,,,113,Lisboa e Vale do Tejo,LISBOA,1104,17489.3,13673,813,796,756,621,625,1246,2002,2798,3611,78.18,20.65,16.0,11.45
03-02-2021,CALDAS DA RAINHA,747,53,1439,"[960,Max]",Extremamente Elevado,,,,747,Lisboa e Vale do Tejo,LEIRIA,1006,25569.47,51912,3035,2684,2186,1899,1705,3604,5790,8474,11509,203.03,45.01,33.14,22.64
03-02-2021,CALHETA,44,3,405,"[240,480]",Elevado,,,,44,Madeira,MADEIRA,3101,11150.43,10867,576,497,507,399,415,814,1321,1818,2394,97.46,21.47,16.3,11.85
03-02-2021,CALHETA (AÇORES),1,0,31,"[0,240]",Moderado,,,,1,Açores,AÇORES,4501,12626.4,3184,215,159,141,139,122,261,402,561,776,25.22,6.15,4.44,3.18
03-02-2021,CÂMARA DE LOBOS,399,29,1185,"[960,Max]",Extremamente Elevado,,,,399,Madeira,MADEIRA,3102,5216.67,33675,1396,1059,834,545,381,926,1760,2819,4215,645.49,80.79,54.03,33.74
03-02-2021,CAMINHA,398,28,2507,"[960,Max]",Extremamente Elevado,,,,398,Norte,VIANA DO CASTELO,1602,13652.14,15877,1046,944,818,646,656,1302,2120,3064,4110,116.3,30.11,22.44,15.53
03-02-2021,CAMPO MAIOR,162,12,2057,"[960,Max]",Extremamente Elevado,,,,162,Alentejo,PORTALEGRE,1204,24720.16,7874,471,364,351,279,327,606,957,1321,1792,31.85,7.25,5.34,3.87
03-02-2021,CANTANHEDE,627,45,1791,"[960,Max]",Extremamente Elevado,,,,627,Centro,COIMBRA,0602,39088.02,35011,2346,2096,1880,1709,1451,3160,5040,7136,9482,89.57,24.26,18.26,12.89
03-02-2021,CARRAZEDA DE ANSIÃES,46,3,812,"[480,960]",Muito Elevado,,,,46,Norte,BRAGANÇA,0403,27924.09,5666,424,389,391,312,465,777,1168,1557,1981,20.29,7.09,5.58,4.18
03-02-2021,CARREGAL DO SAL,138,10,1489,"[960,Max]",Extremamente Elevado,,,,138,Centro,VISEU,1802,11689.21,9271,587,562,486,462,376,838,1324,1886,2473,79.31,21.16,16.13,11.33
03-02-2021,CARTAXO,284,20,1191,"[960,Max]",Extremamente Elevado,,,,284,Lisboa e Vale do Tejo,SANTARÉM,1406,15817.28,23843,1415,1376,1142,861,632,1493,2635,4011,5426,150.74,34.3,25.36,16.66
03-02-2021,CASCAIS,3542,253,1658,"[960,Max]",Extremamente Elevado,,,,3542,Lisboa e Vale do Tejo,LISBOA,1105,9740.17,213608,12151,11444,8680,6469,5248,11717,20397,31841,43992,2193.1,451.66,326.91,209.41
03-02-2021,CASTANHEIRA DE PÊRA,55,4,2104,"[960,Max]",Extremamente Elevado,,,,55,Centro,LEIRIA,1007,6677.45,2614,233,195,157,190,187,377,534,729,962,39.15,14.41,10.92,8.0
03-02-2021,CASTELO BRANCO,748,53,1439,"[960,Max]",Extremamente Elevado,,,,748,Centro,CASTELO BRANCO,0502,143819.15,51987,3528,3042,2499,2229,2225,4454,6953,9995,13523,36.15,9.4,6.95,4.83
03-02-2021,CASTELO DE PAIVA,190,14,1229,"[960,Max]",Extremamente Elevado,,,,190,Norte,AVEIRO,0106,11500.53,15454,881,697,545,420,431,851,1396,2093,2974,134.37,25.86,18.2,12.14
03-02-2021,CASTELO DE VIDE,195,14,6680,"[960,Max]",Extremamente Elevado,,,,195,Alentejo,PORTALEGRE,1205,26491.24,2919,204,173,179,147,170,317,496,669,873,11.02,3.3,2.53,1.87
03-02-2021,CASTRO DAIRE,289,21,2091,"[960,Max]",Extremamente Elevado,,,,289,Centro,VISEU,1803,37904.13,13823,942,857,765,732,773,1505,2270,3127,4069,36.47,10.74,8.25,5.99
03-02-2021,CASTRO MARIM,157,11,2517,"[960,Max]",Extremamente Elevado,,,,157,Algarve,FARO,0804,30084.37,6237,370,345,334,322,344,666,1000,1345,1715,20.73,5.7,4.47,3.32
03-02-2021,CASTRO VERDE,91,7,1310,"[960,Max]",Extremamente Elevado,,,,91,Alentejo,BEJA,0206,56944.23,6949,437,347,303,275,227,502,805,1152,1589,12.2,2.79,2.02,1.41
03-02-2021,CELORICO DA BEIRA,86,6,1241,"[960,Max]",Extremamente Elevado,,,,86,Centro,GUARDA,0903,24721.63,6928,430,416,363,369,535,904,1267,1683,2113,28.02,8.55,6.81,5.12
03-02-2021,CELORICO DE BASTO,222,16,1166,"[960,Max]",Extremamente Elevado,,,,222,Norte,BRAGA,0305,18107.02,19040,1001,802,668,728,729,1457,2125,2927,3928,105.15,21.69,16.17,11.74
03-02-2021,CHAMUSCA,105,8,1142,"[960,Max]",Extremamente Elevado,,,,105,Lisboa e Vale do Tejo,SANTARÉM,1407,74600.54,9197,629,583,553,465,579,1044,1597,2180,2809,12.33,3.77,2.92,2.14
03-02-2021,CHAVES,356,25,905,"[480,960]",Muito Elevado,,,,356,Norte,VILA REAL,1703,59122.95,39343,2676,2429,1991,1886,1918,3804,5795,8224,10900,66.54,18.44,13.91,9.8
03-02-2021,CINFÃES,175,12,959,"[480,960]",Muito Elevado,,,,175,Norte,VISEU,1804,23928.76,18244,1067,902,779,734,758,1492,2271,3173,4240,76.24,17.72,13.26,9.49
03-02-2021,COIMBRA,3239,231,2414,"[960,Max]",Extremamente Elevado,,,,3239,Centro,COIMBRA,0603,31939.94,134166,9489,8734,6353,5139,5074,10213,16566,25300,34789,420.06,108.92,79.21,51.87
03-02-2021,CONDEIXA-A-NOVA,342,24,1929,"[960,Max]",Extremamente Elevado,,,,342,Centro,COIMBRA,0604,13867.47,17733,871,809,717,583,490,1073,1790,2599,3470,127.88,25.02,18.74,12.91
03-02-2021,CONSTÂNCIA,26,2,645,"[480,960]",Muito Elevado,,,,26,Lisboa e Vale do Tejo,SANTARÉM,1408,8036.58,4030,211,183,187,148,155,303,490,673,884,50.14,11.0,8.37,6.1
03-02-2021,CORUCHE,272,19,1557,"[960,Max]",Extremamente Elevado,,,,272,Lisboa e Vale do Tejo,SANTARÉM,1409,111572.03,17471,1294,1090,1095,1096,1019,2115,3210,4300,5594,15.66,5.01,3.85,2.88
03-02-2021,CORVO,2,0,431,"[240,480]",Elevado,,,,2,Açores,AÇORES,4901,1711.45,464,22,21,11,13,19,32,43,64,86,27.12,5.03,3.74,2.51
03-02-2021,COVILHÃ,813,58,1738,"[960,Max]",Extremamente Elevado,,,,813,Centro,CASTELO BRANCO,0503,55560.06,46787,3533,2998,2365,2111,2193,4304,6669,9667,13200,84.21,23.76,17.4,12.0
03-02-2021,CRATO,18,1,575,"[480,960]",Muito Elevado,,,,18,Alentejo,PORTALEGRE,1206,39806.88,3129,229,258,163,182,228,410,573,831,1060,7.86,2.66,2.09,1.44
03-02-2021,CUBA,98,7,2133,"[960,Max]",Extremamente Elevado,,,,98,Alentejo,BEJA,0207,17208.72,4595,255,233,206,190,143,333,539,772,1027,26.7,5.97,4.49,3.13
03-02-2021,ELVAS,277,20,1349,"[960,Max]",Extremamente Elevado,,,,277,Alentejo,PORTALEGRE,1207,63128.86,20528,1057,1145,902,852,810,1662,2564,3709,4766,32.52,7.55,5.88,4.06
03-02-2021,ENTRONCAMENTO,194,14,900,"[480,960]",Muito Elevado,,,,194,Lisboa e Vale do Tejo,SANTARÉM,1410,1372.81,21558,1066,930,868,695,592,1287,2155,3085,4151,1570.14,302.33,224.69,156.96
03-02-2021,ESPINHO,422,30,1430,"[960,Max]",Extremamente Elevado,,,,422,Norte,AVEIRO,0107,2105.68,29516,2205,1993,1430,1177,960,2137,3567,5560,7765,1401.52,368.71,264.01,169.37
03-02-2021,ESPOSENDE,481,34,1407,"[960,Max]",Extremamente Elevado,,,,481,Norte,BRAGA,0306,9540.98,34177,1831,1522,1095,894,723,1617,2712,4234,6065,358.21,63.57,44.38,28.42
03-02-2021,ESTARREJA,260,19,1000,"[960,Max]",Extremamente Elevado,,,,260,Centro,AVEIRO,0108,10817.33,26006,1503,1399,1106,953,728,1681,2787,4186,5689,240.42,52.59,38.7,25.76
03-02-2021,ESTREMOZ,287,21,2255,"[960,Max]",Extremamente Elevado,,,,287,Alentejo,ÉVORA,0704,51379.95,12728,789,613,697,786,877,1663,2360,2973,3762,24.77,7.32,5.79,4.59
03-02-2021,ÉVORA,560,40,1068,"[960,Max]",Extremamente Elevado,,,,560,Alentejo,ÉVORA,0705,130707.58,52428,3569,2852,2176,1966,1803,3769,5945,8797,12366,40.11,9.46,6.73,4.55
03-02-2021,FAFE,582,42,1211,"[960,Max]",Extremamente Elevado,,,,582,Norte,BRAGA,0307,21908.11,48060,3044,2455,1679,1403,1208,2611,4290,6745,9789,219.37,44.68,30.79,19.58
03-02-2021,FARO,803,57,1316,"[960,Max]",Extremamente Elevado,,,,803,Algarve,FARO,0805,20256.79,61015,3847,3364,2604,2055,1601,3656,6260,9624,13471,301.2,66.5,47.51,30.9
03-02-2021,FELGUEIRAS,589,42,1044,"[960,Max]",Extremamente Elevado,,,,589,Norte,PORTO,1303,11573.75,56422,2951,2302,1601,1316,973,2289,3890,6192,9143,487.49,79.0,53.5,33.61
03-02-2021,FERREIRA DO ALENTEJO,61,4,778,"[480,960]",Muito Elevado,,,,61,Alentejo,BEJA,0208,64820.68,7845,515,414,372,343,345,688,1060,1474,1989,12.1,3.07,2.27,1.64
03-02-2021,FERREIRA DO ZÊZERE,162,12,2035,"[960,Max]",Extremamente Elevado,,,,162,Lisboa e Vale do Tejo,SANTARÉM,1411,19038.03,7959,470,370,416,465,456,921,1337,1707,2177,41.81,11.44,8.97,7.02
03-02-2021,FIGUEIRA DA FOZ,620,44,1055,"[960,Max]",Extremamente Elevado,,,,620,Centro,COIMBRA,0605,37905.26,58747,4032,3597,2887,2495,2043,4538,7425,11022,15054,154.98,39.72,29.08,19.59
03-02-2021,FIGUEIRA DE CASTELO RODRIGO,121,9,2167,"[960,Max]",Extremamente Elevado,,,,121,Centro,GUARDA,0904,50857.46,5584,347,352,290,352,391,743,1033,1385,1732,10.98,3.41,2.72,2.03
03-02-2021,FIGUEIRÓ DOS VINHOS,100,7,1796,"[960,Max]",Extremamente Elevado,,,,100,Centro,LEIRIA,1008,17344.0,5568,402,386,322,309,351,660,982,1368,1770,32.1,10.21,7.89,5.66
03-02-2021,FORNOS DE ALGODRES,62,4,1369,"[960,Max]",Extremamente Elevado,,,,62,Centro,GUARDA,0905,13145.05,4528,261,218,247,256,232,488,735,953,1214,34.45,9.24,7.25,5.59
03-02-2021,FREIXO DE ESPADA À CINTA,37,3,1122,"[960,Max]",Extremamente Elevado,,,,37,Norte,BRAGANÇA,0404,24414.29,3298,211,177,231,196,189,385,616,793,1004,13.51,4.11,3.25,2.52
03-02-2021,FRONTEIRA,112,8,3766,"[960,Max]",Extremamente Elevado,,,,112,Alentejo,PORTALEGRE,1208,24859.58,2974,213,182,149,156,168,324,473,655,868,11.96,3.49,2.63,1.9
03-02-2021,FUNCHAL,524,37,504,"[480,960]",Muito Elevado,,,,524,Madeira,MADEIRA,3103,7616.2,104024,6382,5086,3643,2821,1990,4811,8454,13540,19922,1365.86,261.58,177.78,111.0
03-02-2021,FUNDÃO,509,36,1921,"[960,Max]",Extremamente Elevado,,,,509,Centro,CASTELO BRANCO,0504,70019.79,26495,1781,1464,1432,1357,1643,3000,4432,5896,7677,37.84,10.96,8.42,6.33
03-02-2021,GAVIÃO,51,4,1563,"[960,Max]",Extremamente Elevado,,,,51,Alentejo,PORTALEGRE,1209,29459.45,3263,189,186,222,263,293,556,778,964,1153,11.08,3.91,3.27,2.64
03-02-2021,GÓIS,65,5,1708,"[960,Max]",Extremamente Elevado,,,,65,Centro,COIMBRA,0606,26330.19,3805,235,199,240,233,244,477,717,916,1151,14.45,4.37,3.48,2.72
03-02-2021,GOLEGÃ,45,3,843,"[480,960]",Muito Elevado,,,,45,Lisboa e Vale do Tejo,SANTARÉM,1412,8431.67,5339,356,299,281,243,255,498,779,1078,1434,63.32,17.01,12.78,9.24
03-02-2021,GONDOMAR,1852,132,1116,"[960,Max]",Extremamente Elevado,,,,1852,Norte,PORTO,1304,13191.76,165985,10555,8755,6222,4450,3364,7814,14036,22791,33346,1258.22,252.77,172.76,106.4
03-02-2021,GOUVEIA,136,10,1098,"[960,Max]",Extremamente Elevado,,,,136,Centro,GUARDA,0906,30061.17,12387,871,931,780,783,810,1593,2373,3304,4175,41.21,13.89,10.99,7.89
03-02-2021,GRÂNDOLA,349,25,2384,"[960,Max]",Extremamente Elevado,,,,349,Alentejo,SETÚBAL,1505,82593.66,14639,834,834,708,688,672,1360,2068,2902,3736,17.72,4.52,3.51,2.5
03-02-2021,GUARDA,590,42,1514,"[960,Max]",Extremamente Elevado,,,,590,Centro,GUARDA,0907,71209.58,38969,2477,2041,1686,1415,1474,2889,4575,6616,9093,54.72,12.77,9.29,6.42
03-02-2021,GUIMARÃES,2111,151,1386,"[960,Max]",Extremamente Elevado,,,,2111,Norte,BRAGA,0308,24099.96,152309,9394,7074,4809,3877,2948,6825,11634,18708,28102,631.99,116.61,77.63,48.27
03-02-2021,HORTA,29,2,200,"[0,240]",Moderado,,,,29,Açores,AÇORES,4701,17305.53,14521,818,658,468,352,302,654,1122,1780,2598,83.91,15.01,10.29,6.48
03-02-2021,IDANHA-A-NOVA,56,4,696,"[480,960]",Muito Elevado,,,,56,Centro,CASTELO BRANCO,0505,141633.51,8043,518,490,519,672,974,1646,2165,2655,3173,5.68,2.24,1.87,1.53
03-02-2021,ÍLHAVO,462,33,1194,"[960,Max]",Extremamente Elevado,,,,462,Centro,AVEIRO,0110,7347.55,38699,2227,1943,1444,1193,850,2043,3487,5430,7657,526.66,104.21,73.9,47.46
03-02-2021,LAGOA (FARO),113,8,496,"[480,960]",Muito Elevado,,,,113,Algarve,FARO,0806,8825.45,22762,1314,1168,919,749,670,1419,2338,3506,4820,257.93,54.62,39.73,26.49
03-02-2021,LAGOA,8,1,54,"[0,240]",Moderado,,,,8,Açores,AÇORES,4201,4559.32,14721,536,458,349,238,235,473,822,1280,1816,322.9,39.83,28.08,18.03
03-02-2021,LAGOS,256,18,843,"[480,960]",Muito Elevado,,,,256,Algarve,FARO,0807,21299.27,30374,1744,1434,1247,1053,1029,2082,3329,4763,6507,142.61,30.55,22.36,15.63
03-02-2021,LAJES DAS FLORES,1,0,68,"[0,240]",Moderado,,,,1,Açores,AÇORES,4801,7004.79,1463,88,53,62,46,54,100,162,215,303,20.89,4.33,3.07,2.31
03-02-2021,LAJES DO PICO,6,0,134,"[0,240]",Moderado,,,,6,Açores,AÇORES,4601,15531.09,4490,304,231,223,159,162,321,544,775,1079,28.91,6.95,4.99,3.5
03-02-2021,LAMEGO,388,28,1559,"[960,Max]",Extremamente Elevado,,,,388,Norte,VISEU,1805,16542.11,24895,1639,1284,1124,898,783,1681,2805,4089,5728,150.5,34.63,24.72,16.96
03-02-2021,LEIRIA,1263,90,1008,"[960,Max]",Extremamente Elevado,,,,1263,Centro,LEIRIA,1009,56508.83,125267,7389,6366,5090,3902,3159,7061,12151,18517,25906,221.68,45.84,32.77,21.5
03-02-2021,LISBOA,10817,773,2123,"[960,Max]",Extremamente Elevado,,,,10817,Lisboa e Vale do Tejo,LISBOA,1106,10005.43,509515,33197,33340,27706,23037,26770,49807,77513,110853,144050,5092.6,1439.78,1107.98,774.74
03-02-2021,LOULÉ,914,65,1330,"[960,Max]",Extremamente Elevado,,,,914,Algarve,FARO,0808,76366.91,68697,3890,3350,2780,2358,2251,4609,7389,10739,14629,89.96,19.16,14.06,9.68
03-02-2021,LOURES,4714,337,2206,"[960,Max]",Extremamente Elevado,,,,4714,Lisboa e Vale do Tejo,LISBOA,1107,16723.99,213687,12746,12794,9644,6669,5033,11702,21346,34140,46886,1277.73,280.35,204.14,127.64
03-02-2021,LOURINHÃ,363,26,1404,"[960,Max]",Extremamente Elevado,,,,363,Lisboa e Vale do Tejo,LISBOA,1108,14717.2,25855,1584,1243,992,842,645,1487,2479,3722,5306,175.68,36.05,25.29,16.84
03-02-2021,LOUSÃ,180,13,1049,"[960,Max]",Extremamente Elevado,,,,180,Centro,COIMBRA,0607,13840.01,17158,946,866,658,528,450,978,1636,2502,3448,123.97,24.91,18.08,11.82
03-02-2021,LOUSADA,417,30,892,"[480,960]",Muito Elevado,,,,417,Norte,PORTO,1305,9608.01,46755,2289,1698,1176,853,621,1474,2650,4348,6637,486.63,69.08,45.25,27.58
03-02-2021,MAÇÃO,55,4,878,"[480,960]",Muito Elevado,,,,55,Lisboa e Vale do Tejo,SANTARÉM,1413,39997.98,6267,386,362,390,440,657,1097,1487,1849,2235,15.67,5.59,4.62,3.72
03-02-2021,MACEDO DE CAVALEIROS,145,10,999,"[960,Max]",Extremamente Elevado,,,,145,Norte,BRAGANÇA,0405,69914.08,14516,1082,889,878,823,938,1761,2639,3528,4610,20.76,6.59,5.05,3.77
03-02-2021,MACHICO,111,8,556,"[480,960]",Muito Elevado,,,,111,Madeira,MADEIRA,3104,6825.1,19981,1197,860,662,455,331,786,1448,2308,3505,292.76,51.36,33.82,21.22
03-02-2021,MADALENA,7,1,119,"[0,240]",Moderado,,,,7,Açores,AÇORES,4602,14712.33,5895,334,256,173,190,179,369,542,798,1132,40.07,7.69,5.42,3.68
03-02-2021,MAFRA,1863,133,2197,"[960,Max]",Extremamente Elevado,,,,1863,Lisboa e Vale do Tejo,LISBOA,1109,29165.5,84816,3613,3334,2839,2089,1899,3988,6827,10161,13774,290.81,47.23,34.84,23.41
03-02-2021,MAIA,1172,84,843,"[480,960]",Muito Elevado,,,,1172,Norte,PORTO,1306,8293.94,138971,7801,6617,4512,3339,2631,5970,10482,17099,24900,1675.56,300.22,206.16,126.38
03-02-2021,MANGUALDE,295,21,1594,"[960,Max]",Extremamente Elevado,,,,295,Centro,VISEU,1806,21925.56,18510,1198,1128,885,852,743,1595,2480,3608,4806,84.42,21.92,16.46,11.31
03-02-2021,MANTEIGAS,73,5,2428,"[960,Max]",Extremamente Elevado,,,,73,Centro,GUARDA,0908,12197.55,3007,258,197,159,167,146,313,472,669,927,24.65,7.6,5.48,3.87
03-02-2021,MARCO DE CANAVESES,412,29,800,"[480,960]",Muito Elevado,,,,412,Norte,PORTO,1307,20188.98,51496,2678,2060,1488,1265,1023,2288,3776,5836,8514,255.07,42.17,28.91,18.7
03-02-2021,MARINHA GRANDE,291,21,756,"[480,960]",Muito Elevado,,,,291,Centro,LEIRIA,1010,18725.19,38508,2365,2302,1638,1359,1058,2417,4055,6357,8722,205.65,46.58,33.95,21.66
03-02-2021,MARVÃO,39,3,1298,"[960,Max]",Extremamente Elevado,,,,39,Alentejo,PORTALEGRE,1210,15489.9,3005,198,185,142,197,237,434,576,761,959,19.4,6.19,4.91,3.72
03-02-2021,MATOSINHOS,1676,120,956,"[480,960]",Muito Elevado,,,,1676,Norte,PORTO,1308,6241.97,175357,11850,9977,7023,5024,3884,8908,15931,25908,37758,2809.31,604.9,415.06,255.22
03-02-2021,MEALHADA,419,30,2104,"[960,Max]",Extremamente Elevado,,,,419,Centro,AVEIRO,0111,11065.66,19914,1163,1039,810,828,831,1659,2469,3508,4671,179.96,42.21,31.7,22.31
03-02-2021,MÊDA,122,9,2660,"[960,Max]",Extremamente Elevado,,,,122,Centro,GUARDA,0909,28604.92,4587,343,306,290,288,443,731,1021,1327,1670,16.04,5.84,4.64,3.57
03-02-2021,MELGAÇO,207,15,2558,"[960,Max]",Extremamente Elevado,,,,207,Norte,VIANA DO CASTELO,1603,23824.58,8093,507,567,578,614,675,1289,1867,2434,2941,33.97,12.34,10.22,7.84
03-02-2021,MÉRTOLA,96,7,1563,"[960,Max]",Extremamente Elevado,,,,96,Alentejo,BEJA,0209,129287.34,6142,400,390,378,423,600,1023,1401,1791,2191,4.75,1.69,1.39,1.08
03-02-2021,MESÃO FRIO,41,3,1034,"[960,Max]",Extremamente Elevado,,,,41,Norte,VILA REAL,1704,2664.87,3964,265,205,168,157,120,277,445,650,915,148.74,34.33,24.39,16.7
03-02-2021,MIRA,112,8,947,"[480,960]",Muito Elevado,,,,112,Centro,COIMBRA,0608,12403.38,11832,727,729,659,550,466,1016,1675,2404,3131,95.4,25.24,19.38,13.5
03-02-2021,MIRANDA DO CORVO,234,17,1841,"[960,Max]",Extremamente Elevado,,,,234,Centro,COIMBRA,0609,12637.79,12708,706,659,568,498,404,902,1470,2129,2835,100.55,22.43,16.85,11.63
03-02-2021,MIRANDA DO DOURO,85,6,1245,"[960,Max]",Extremamente Elevado,,,,85,Norte,BRAGANÇA,0406,48718.31,6830,482,429,442,463,470,933,1375,1804,2286,14.02,4.69,3.7,2.82
03-02-2021,MIRANDELA,376,27,1728,"[960,Max]",Extremamente Elevado,,,,376,Norte,BRAGANÇA,0407,65895.67,21754,1640,1315,1204,1078,947,2025,3229,4544,6184,33.01,9.38,6.9,4.9
03-02-2021,MOGADOURO,121,9,1442,"[960,Max]",Extremamente Elevado,,,,121,Norte,BRAGANÇA,0408,76064.93,8392,589,529,576,630,655,1285,1861,2390,2979,11.03,3.92,3.14,2.45
03-02-2021,MOIMENTA DA BEIRA,275,20,2825,"[960,Max]",Extremamente Elevado,,,,275,Norte,VISEU,1807,21996.9,9736,576,514,471,416,461,877,1348,1862,2438,44.26,11.08,8.46,6.13
03-02-2021,MOITA,1291,92,2004,"[960,Max]",Extremamente Elevado,,,,1291,Lisboa e Vale do Tejo,SETÚBAL,1506,5525.98,64407,4226,3646,2623,1801,1425,3226,5849,9495,13721,1165.53,248.3,171.82,105.85
03-02-2021,MONÇÃO,272,19,1522,"[960,Max]",Extremamente Elevado,,,,272,Norte,VIANA DO CASTELO,1604,21130.85,17869,1161,1105,1031,1006,972,1978,3009,4114,5275,84.56,24.96,19.47,14.24
03-02-2021,MONCHIQUE,62,4,1221,"[960,Max]",Extremamente Elevado,,,,62,Algarve,FARO,0809,39530.43,5077,353,384,321,355,392,747,1068,1452,1805,12.84,4.57,3.67,2.7
03-02-2021,MONDIM DE BASTO,50,4,720,"[480,960]",Muito Elevado,,,,50,Norte,VILA REAL,1705,17207.52,6946,395,300,314,284,283,567,881,1181,1576,40.36,9.16,6.86,5.12
03-02-2021,MONFORTE,24,2,807,"[480,960]",Muito Elevado,,,,24,Alentejo,PORTALEGRE,1211,42024.82,2975,139,115,117,192,168,360,477,592,731,7.08,1.74,1.41,1.14
03-02-2021,MONTALEGRE,91,6,1011,"[960,Max]",Extremamente Elevado,,,,91,Norte,VILA REAL,1706,80545.71,8997,699,628,595,603,730,1333,1928,2556,3255,11.17,4.04,3.17,2.39
03-02-2021,MONTEMOR-O-NOVO,224,16,1432,"[960,Max]",Extremamente Elevado,,,,224,Alentejo,ÉVORA,0706,123296.65,15647,991,953,868,878,971,1849,2717,3670,4661,12.69,3.78,2.98,2.2
03-02-2021,MONTEMOR-O-VELHO,511,37,2026,"[960,Max]",Extremamente Elevado,,,,511,Centro,COIMBRA,0610,22896.23,25224,1496,1397,1217,1057,988,2045,3262,4659,6155,110.17,26.88,20.35,14.25
03-02-2021,MONTIJO,828,59,1437,"[960,Max]",Extremamente Elevado,,,,828,Lisboa e Vale do Tejo,SETÚBAL,1507,34861.64,57614,2771,2441,1990,1554,1109,2663,4653,7094,9865,165.26,28.3,20.35,13.35
03-02-2021,MORA,24,2,580,"[480,960]",Muito Elevado,,,,24,Alentejo,ÉVORA,0707,44395.02,4138,336,275,252,238,257,495,747,1022,1358,9.32,3.06,2.3,1.68
03-02-2021,MORTÁGUA,75,5,852,"[480,960]",Muito Elevado,,,,75,Centro,VISEU,1808,25117.82,8803,638,584,535,499,460,959,1494,2078,2716,35.05,10.81,8.27,5.95
03-02-2021,MOURA,318,23,2318,"[960,Max]",Extremamente Elevado,,,,318,Alentejo,BEJA,0210,95845.55,13718,817,656,665,542,461,1003,1668,2324,3141,14.31,3.28,2.42,1.74
03-02-2021,MOURÃO,13,1,531,"[480,960]",Muito Elevado,,,,13,Alentejo,ÉVORA,0708,27862.98,2450,139,108,80,104,109,213,293,401,540,8.79,1.94,1.44,1.05
03-02-2021,MURÇA,74,5,1355,"[960,Max]",Extremamente Elevado,,,,74,Norte,VILA REAL,1707,18937.11,5463,384,341,307,306,319,625,932,1273,1657,28.85,8.75,6.72,4.92
03-02-2021,MURTOSA,102,7,992,"[960,Max]",Extremamente Elevado,,,,102,Centro,AVEIRO,0112,7308.78,10279,509,473,403,353,409,762,1165,1638,2147,140.63,29.37,22.41,15.94
03-02-2021,NAZARÉ,216,15,1525,"[960,Max]",Extremamente Elevado,,,,216,Lisboa e Vale do Tejo,LEIRIA,1011,8243.43,14165,967,903,670,420,396,816,1486,2389,3356,171.84,40.71,28.98,18.03
03-02-2021,NELAS,176,13,1357,"[960,Max]",Extremamente Elevado,,,,176,Centro,VISEU,1809,12571.48,12974,924,787,668,604,583,1187,1855,2642,3566,103.21,28.37,21.02,14.76
03-02-2021,NISA,43,3,709,"[480,960]",Muito Elevado,,,,43,Alentejo,PORTALEGRE,1212,57567.84,6061,405,389,355,483,478,961,1316,1705,2110,10.53,3.67,2.96,2.29
03-02-2021,NORDESTE,4,0,82,"[0,240]",Moderado,,,,4,Açores,AÇORES,4202,10146.8,4862,246,180,124,161,162,323,447,627,873,47.92,8.6,6.18,4.41
03-02-2021,ÓBIDOS,163,12,1376,"[960,Max]",Extremamente Elevado,,,,163,Lisboa e Vale do Tejo,LEIRIA,1012,14155.44,11850,743,650,574,452,436,888,1462,2112,2855,83.72,20.17,14.92,10.33
03-02-2021,ODEMIRA,181,13,732,"[480,960]",Muito Elevado,,,,181,Alentejo,BEJA,0211,172060.15,24717,1475,1317,1225,1397,1349,2746,3971,5288,6763,14.37,3.93,3.07,2.31
03-02-2021,ODIVELAS,3745,268,2315,"[960,Max]",Extremamente Elevado,,,,3745,Lisboa e Vale do Tejo,LISBOA,1116,2654.36,161774,9562,9038,6952,4641,3812,8453,15405,24443,34005,6095.48,1281.27,920.99,580.44
03-02-2021,OEIRAS,3555,254,2004,"[960,Max]",Extremamente Elevado,,,,3555,Lisboa e Vale do Tejo,LISBOA,1110,4588.31,177408,11580,11575,8566,6211,5855,12066,20632,32207,43787,3866.78,954.38,701.98,449.69
03-02-2021,OLEIROS,37,3,740,"[480,960]",Muito Elevado,,,,37,Centro,CASTELO BRANCO,0506,47109.31,5003,384,341,366,397,487,884,1250,1591,1975,10.62,4.19,3.38,2.65
03-02-2021,OLHÃO,468,33,1054,"[960,Max]",Extremamente Elevado,,,,468,Algarve,FARO,0810,13086.38,44405,2455,2309,1689,1342,1268,2610,4299,6608,9063,339.33,69.26,50.5,32.85
03-02-2021,OLIVEIRA DE AZEMÉIS,968,69,1466,"[960,Max]",Extremamente Elevado,,,,968,Norte,AVEIRO,0113,16110.41,66011,4155,3614,2794,2183,1738,3921,6715,10329,14484,409.75,89.91,64.12,41.68
03-02-2021,OLIVEIRA DE FRADES,258,18,2597,"[960,Max]",Extremamente Elevado,,,,258,Centro,VISEU,1810,14534.62,9936,553,475,438,359,415,774,1212,1687,2240,68.36,15.41,11.61,8.34
03-02-2021,OLIVEIRA DO BAIRRO,281,20,1157,"[960,Max]",Extremamente Elevado,,,,281,Centro,AVEIRO,0114,8731.99,24277,1327,1182,999,786,810,1596,2595,3777,5104,278.02,58.45,43.25,29.72
03-02-2021,OLIVEIRA DO HOSPITAL,332,24,1724,"[960,Max]",Extremamente Elevado,,,,332,Centro,COIMBRA,0611,23451.66,19253,1161,1097,962,924,960,1884,2846,3943,5104,82.1,21.76,16.81,12.14
03-02-2021,OURÉM,651,46,1478,"[960,Max]",Extremamente Elevado,,,,651,Lisboa e Vale do Tejo,SANTARÉM,1421,41668.03,44044,2463,2069,1899,1817,1603,3420,5319,7388,9851,105.7,23.64,17.73,12.77
03-02-2021,OURIQUE,57,4,1237,"[960,Max]",Extremamente Elevado,,,,57,Alentejo,BEJA,0212,66331.36,4607,313,287,284,268,227,495,779,1066,1379,6.95,2.08,1.61,1.17
03-02-2021,OVAR,804,57,1482,"[960,Max]",Extremamente Elevado,,,,804,Centro,AVEIRO,0115,14770.25,54260,3294,2709,1994,1636,1234,2870,4864,7573,10867,367.37,73.57,51.27,32.93
03-02-2021,PAÇOS DE FERREIRA,356,25,628,"[480,960]",Muito Elevado,,,,356,Norte,PORTO,1309,7099.29,56728,2903,2193,1518,1135,664,1799,3317,5510,8413,799.1,118.51,77.62,46.72
03-02-2021,PALMELA,1523,109,2370,"[960,Max]",Extremamente Elevado,,,,1523,Lisboa e Vale do Tejo,SETÚBAL,1508,46512.01,64269,3402,3244,2635,1846,1391,3237,5872,9116,12518,138.18,26.91,19.6,12.62
03-02-2021,PAMPILHOSA DA SERRA,58,4,1437,"[960,Max]",Extremamente Elevado,,,,58,Centro,COIMBRA,0612,39646.24,4037,238,254,295,339,423,762,1057,1311,1549,10.18,3.91,3.31,2.67
03-02-2021,PAREDES,656,47,762,"[480,960]",Muito Elevado,,,,656,Norte,PORTO,1310,15675.69,86067,4272,3532,2412,1717,1258,2975,5387,8919,13191,549.04,84.15,56.9,34.36
03-02-2021,PAREDES DE COURA,219,16,2566,"[960,Max]",Extremamente Elevado,,,,219,Norte,VIANA DO CASTELO,1605,13818.59,8535,466,528,407,465,515,980,1387,1915,2381,61.76,17.23,13.86,10.04
03-02-2021,PEDRÓGÃO GRANDE,55,4,1613,"[960,Max]",Extremamente Elevado,,,,55,Centro,LEIRIA,1013,12874.75,3410,175,173,196,221,252,473,669,842,1017,26.49,7.9,6.54,5.2
03-02-2021,PENACOVA,297,21,2169,"[960,Max]",Extremamente Elevado,,,,297,Centro,COIMBRA,0613,21673.23,13694,968,923,745,621,703,1324,2069,2992,3960,63.18,18.27,13.81,9.55
03-02-2021,PENAFIEL,627,45,899,"[480,960]",Muito Elevado,,,,627,Norte,PORTO,1311,21224.27,69772,3648,2823,2032,1663,1230,2893,4925,7748,11396,328.74,53.69,36.51,23.2
03-02-2021,PENALVA DO CASTELO,113,8,1588,"[960,Max]",Extremamente Elevado,,,,113,Centro,VISEU,1811,13433.92,7115,449,457,413,391,426,817,1230,1687,2136,52.96,15.9,12.56,9.16
03-02-2021,PENAMACOR,51,4,1073,"[960,Max]",Extremamente Elevado,,,,51,Centro,CASTELO BRANCO,0507,56370.69,4755,262,248,273,451,633,1084,1357,1605,1867,8.44,3.31,2.85,2.41
03-02-2021,PENEDONO,150,11,5789,"[960,Max]",Extremamente Elevado,,,,150,Norte,VISEU,1812,13370.75,2591,172,113,129,156,138,294,423,536,708,19.38,5.3,4.01,3.16
03-02-2021,PENELA,132,9,2446,"[960,Max]",Extremamente Elevado,,,,132,Centro,COIMBRA,0614,13480.0,5397,314,324,274,359,344,703,977,1301,1615,40.04,11.98,9.65,7.25
03-02-2021,PENICHE,427,30,1611,"[960,Max]",Extremamente Elevado,,,,427,Lisboa e Vale do Tejo,LEIRIA,1014,7754.98,26501,1746,1504,1203,926,707,1633,2836,4340,6086,341.73,78.48,55.96,36.57
03-02-2021,PESO DA RÉGUA,200,14,1268,"[960,Max]",Extremamente Elevado,,,,200,Norte,VILA REAL,1708,9486.01,15773,1076,843,650,659,455,1114,1764,2607,3683,166.28,38.83,27.48,18.6
03-02-2021,PINHEL,171,12,2009,"[960,Max]",Extremamente Elevado,,,,171,Centro,GUARDA,0910,48452.12,8511,577,566,551,538,689,1227,1778,2344,2921,17.57,6.03,4.84,3.67
03-02-2021,POMBAL,761,54,1479,"[960,Max]",Extremamente Elevado,,,,761,Centro,LEIRIA,1015,62600.28,51461,3187,2791,2494,2328,2027,4355,6849,9640,12827,82.21,20.49,15.4,10.94
03-02-2021,PONTA DELGADA,83,6,122,"[0,240]",Moderado,,,,83,Açores,AÇORES,4203,23298.65,67935,3108,2435,1726,1133,902,2035,3761,6196,9304,291.58,39.93,26.59,16.14
03-02-2021,PONTA DO SOL,32,2,372,"[240,480]",Elevado,,,,32,Madeira,MADEIRA,3105,4622.03,8593,319,283,347,208,221,429,776,1059,1378,185.92,29.81,22.91,16.79
03-02-2021,PONTE DA BARCA,260,19,2326,"[960,Max]",Extremamente Elevado,,,,260,Norte,VIANA DO CASTELO,1606,18211.37,11180,635,576,517,554,490,1044,1561,2137,2772,61.39,15.22,11.73,8.57
03-02-2021,PONTE DE LIMA,895,64,2166,"[960,Max]",Extremamente Elevado,,,,895,Norte,VIANA DO CASTELO,1607,32025.46,41315,2321,2022,1720,1596,1462,3058,4778,6800,9121,129.01,28.48,21.23,14.92
03-02-2021,PONTE DE SOR,286,20,1907,"[960,Max]",Extremamente Elevado,,,,286,Alentejo,PORTALEGRE,1213,83971.16,14994,939,800,716,739,831,1570,2286,3086,4025,17.86,4.79,3.68,2.72
03-02-2021,PORTALEGRE,191,14,861,"[480,960]",Muito Elevado,,,,191,Alentejo,PORTALEGRE,1214,44713.64,22172,1577,1351,1137,993,984,1977,3114,4465,6042,49.59,13.51,9.99,6.96
03-02-2021,PORTEL,62,4,1064,"[960,Max]",Extremamente Elevado,,,,62,Alentejo,ÉVORA,0709,60100.57,5828,336,358,283,331,305,636,919,1277,1613,9.7,2.68,2.12,1.53
03-02-2021,PORTIMÃO,355,25,640,"[480,960]",Muito Elevado,,,,355,Algarve,FARO,0811,18206.29,55483,3182,2927,2116,1582,1400,2982,5098,8025,11207,304.75,61.56,44.08,28.0
03-02-2021,PORTO,2010,144,928,"[480,960]",Muito Elevado,,,,2010,Norte,PORTO,1312,4142.02,216606,15790,15193,11280,9409,10044,19453,30733,45926,61716,5229.5,1490.0,1108.79,741.98
03-02-2021,PORTO DE MÓS,346,25,1487,"[960,Max]",Extremamente Elevado,,,,346,Centro,LEIRIA,1016,26183.41,23275,1355,1210,1034,888,872,1760,2794,4004,5359,88.89,20.47,15.29,10.67
03-02-2021,PORTO MONIZ,3,0,128,"[0,240]",Moderado,,,,3,Madeira,MADEIRA,3106,8293.38,2342,143,130,95,98,120,218,313,443,586,28.24,7.07,5.34,3.77
03-02-2021,PORTO SANTO,15,1,288,"[240,480]",Elevado,,,,15,Madeira,MADEIRA,3201,4300.7,5202,240,157,134,110,68,178,312,469,709,120.95,16.48,10.9,7.25
03-02-2021,PÓVOA DE LANHOSO,323,23,1502,"[960,Max]",Extremamente Elevado,,,,323,Norte,BRAGA,0309,13465.29,21499,1175,909,732,673,624,1297,2029,2938,4113,159.67,30.55,21.82,15.07
03-02-2021,PÓVOA DE VARZIM,1186,85,1889,"[960,Max]",Extremamente Elevado,,,,1186,Norte,PORTO,1313,8220.59,62784,3712,3120,2134,1594,1305,2899,5033,8153,11865,763.7,144.33,99.17,61.22
03-02-2021,POVOAÇÃO,8,1,135,"[0,240]",Moderado,,,,8,Açores,AÇORES,4204,10640.77,5927,293,212,191,144,134,278,469,681,974,55.7,9.15,6.4,4.41
03-02-2021,VILA DA PRAIA DA VITÓRIA,25,2,117,"[0,240]",Moderado,,,,25,Açores,AÇORES,4302,16127.06,21317,1133,789,619,436,336,772,1391,2180,3313,132.18,20.54,13.52,8.63
03-02-2021,PROENÇA-A-NOVA,29,2,397,"[240,480]",Elevado,,,,29,Centro,CASTELO BRANCO,0508,39539.96,7298,508,465,389,400,560,960,1349,1814,2322,18.46,5.87,4.59,3.41
03-02-2021,REDONDO,107,8,1684,"[960,Max]",Extremamente Elevado,,,,107,Alentejo,ÉVORA,0710,36950.87,6353,349,325,288,288,354,642,930,1255,1604,17.19,4.34,3.4,2.52
03-02-2021,REGUENGOS DE MONSARAZ,170,12,1697,"[960,Max]",Extremamente Elevado,,,,170,Alentejo,ÉVORA,0711,46399.72,10015,602,511,455,462,473,935,1390,1901,2503,21.58,5.39,4.1,3.0
03-02-2021,RESENDE,209,15,2062,"[960,Max]",Extremamente Elevado,,,,209,Norte,VISEU,1813,12334.93,10137,560,493,448,433,422,855,1303,1796,2356,82.18,19.1,14.56,10.56
03-02-2021,RIBEIRA BRAVA,44,3,354,"[240,480]",Elevado,,,,44,Madeira,MADEIRA,3107,6544.88,12435,648,500,411,311,287,598,1009,1509,2157,189.99,32.96,23.06,15.42
03-02-2021,RIBEIRA DE PENA,107,8,1779,"[960,Max]",Extremamente Elevado,,,,107,Norte,VILA REAL,1709,21745.98,6016,371,301,290,310,368,678,968,1269,1640,27.66,7.54,5.84,4.45
03-02-2021,RIBEIRA GRANDE,217,15,661,"[480,960]",Muito Elevado,,,,217,Açores,AÇORES,4205,18015.13,32811,1163,689,512,345,253,598,1110,1799,2962,182.13,16.44,9.99,6.16
03-02-2021,RIO MAIOR,714,51,3504,"[960,Max]",Extremamente Elevado,,,,714,Lisboa e Vale do Tejo,SANTARÉM,1414,27276.45,20379,1251,1144,941,795,648,1443,2384,3528,4779,74.71,17.52,12.93,8.74
03-02-2021,SABROSA,72,5,1217,"[960,Max]",Extremamente Elevado,,,,72,Norte,VILA REAL,1710,15692.45,5918,393,314,304,302,350,652,956,1270,1663,37.71,10.6,8.09,6.09
03-02-2021,SABUGAL,265,19,2504,"[960,Max]",Extremamente Elevado,,,,265,Centro,GUARDA,0911,82269.82,10585,724,707,694,796,1009,1805,2499,3206,3930,12.87,4.78,3.9,3.04
03-02-2021,SALVATERRA DE MAGOS,459,33,2155,"[960,Max]",Extremamente Elevado,,,,459,Lisboa e Vale do Tejo,SANTARÉM,1415,24393.2,21295,1275,1181,1060,799,772,1571,2631,3812,5087,87.3,20.85,15.63,10.79
03-02-2021,SANTA COMBA DÃO,151,11,1445,"[960,Max]",Extremamente Elevado,,,,151,Centro,VISEU,1814,11194.77,10452,732,684,569,538,464,1002,1571,2255,2987,93.36,26.68,20.14,14.03
03-02-2021,SANTA CRUZ,343,24,757,"[480,960]",Muito Elevado,,,,343,Madeira,MADEIRA,3108,8150.28,45281,1817,1301,974,716,523,1239,2213,3514,5331,555.6,65.41,43.12,27.15
03-02-2021,SANTA CRUZ DA GRACIOSA,2,0,48,"[0,240]",Moderado,,,,2,Açores,AÇORES,4401,6065.78,4208,228,180,163,124,145,269,432,612,840,69.37,13.85,10.09,7.12
03-02-2021,SANTA CRUZ DAS FLORES,4,0,185,"[0,240]",Moderado,,,,4,Açores,AÇORES,4802,7091.44,2165,125,98,74,56,51,107,181,279,404,30.53,5.7,3.93,2.55
03-02-2021,SANTA MARIA DA FEIRA,2080,149,1500,"[960,Max]",Extremamente Elevado,,,,2080,Norte,AVEIRO,0109,21587.65,138636,8182,6743,4771,3856,3079,6935,11706,18449,26631,642.19,123.36,85.46,54.22
03-02-2021,SANTA MARTA DE PENAGUIÃO,58,4,879,"[480,960]",Muito Elevado,,,,58,Norte,VILA REAL,1711,6928.13,6599,483,373,337,316,317,633,970,1343,1826,95.25,26.36,19.39,14.0
03-02-2021,SANTANA,9,1,134,"[0,240]",Moderado,,,,9,Madeira,MADEIRA,3109,9547.3,6711,418,353,343,282,277,559,902,1255,1673,70.29,17.52,13.15,9.45
03-02-2021,SANTARÉM,873,62,1520,"[960,Max]",Extremamente Elevado,,,,873,Lisboa e Vale do Tejo,SANTARÉM,1416,55253.58,57421,3654,3441,2760,2466,2206,4672,7432,10873,14527,103.92,26.29,19.68,13.45
03-02-2021,SANTIAGO DO CACÉM,339,24,1177,"[960,Max]",Extremamente Elevado,,,,339,Alentejo,SETÚBAL,1509,105969.29,28791,2144,1689,1472,1295,1215,2510,3982,5671,7815,27.17,7.37,5.35,3.76
03-02-2021,SANTO TIRSO,749,54,1101,"[960,Max]",Extremamente Elevado,,,,749,Norte,PORTO,1314,13655.52,68055,4911,3935,2761,2257,1810,4067,6828,10763,15674,498.35,114.78,78.82,50.0
03-02-2021,SÃO BRÁS DE ALPORTEL,82,6,787,"[480,960]",Muito Elevado,,,,82,Algarve,FARO,0812,15336.92,10416,596,468,467,404,401,805,1272,1740,2336,67.91,15.23,11.35,8.29
03-02-2021,SÃO JOÃO DA MADEIRA,314,22,1430,"[960,Max]",Extremamente Elevado,,,,314,Norte,AVEIRO,0116,794.3,21958,1347,1069,796,601,593,1194,1990,3059,4406,2765.49,554.91,385.26,250.63
03-02-2021,SÃO JOÃO DA PESQUEIRA,337,24,4730,"[960,Max]",Extremamente Elevado,,,,337,Norte,VISEU,1815,26610.85,7125,417,330,294,328,328,656,950,1280,1697,26.77,6.38,4.81,3.57
03-02-2021,SÃO PEDRO DO SUL,278,20,1805,"[960,Max]",Extremamente Elevado,,,,278,Centro,VISEU,1816,34895.09,15403,990,962,861,759,909,1668,2529,3491,4481,44.14,12.84,10.0,7.25
03-02-2021,SÃO ROQUE DO PICO,2,0,61,"[0,240]",Moderado,,,,2,Açores,AÇORES,4603,14236.1,3266,199,141,93,96,113,209,302,443,642,22.94,4.51,3.11,2.12
03-02-2021,SÃO VICENTE,4,0,78,"[0,240]",Moderado,,,,4,Madeira,MADEIRA,3110,7883.71,5143,272,264,266,225,280,505,771,1035,1307,65.23,16.58,13.13,9.78
03-02-2021,SARDOAL,46,3,1230,"[960,Max]",Extremamente Elevado,,,,46,Lisboa e Vale do Tejo,SANTARÉM,1417,9214.72,3741,227,178,148,165,248,413,561,739,966,40.6,10.48,8.02,6.09
03-02-2021,SÁTÃO,330,24,2850,"[960,Max]",Extremamente Elevado,,,,330,Centro,VISEU,1817,20194.11,11580,765,671,515,465,476,941,1456,2127,2892,57.34,14.32,10.53,7.21
03-02-2021,SEIA,427,30,1920,"[960,Max]",Extremamente Elevado,,,,427,Centro,GUARDA,0912,43568.83,22234,1807,1589,1238,1122,721,1843,3081,4670,6477,51.03,14.87,10.72,7.07
03-02-2021,SEIXAL,3499,250,2086,"[960,Max]",Extremamente Elevado,,,,3499,Lisboa e Vale do Tejo,SETÚBAL,1510,9545.17,167752,10586,9270,6661,4391,2930,7321,13982,23252,33838,1757.49,354.51,243.6,146.49
03-02-2021,SERNANCELHE,209,15,3873,"[960,Max]",Extremamente Elevado,,,,209,Norte,VISEU,1818,22861.22,5396,305,293,286,273,260,533,819,1112,1417,23.6,6.2,4.86,3.58
03-02-2021,SERPA,125,9,874,"[480,960]",Muito Elevado,,,,125,Alentejo,BEJA,0213,110563.34,14304,903,761,719,697,626,1323,2042,2803,3706,12.94,3.35,2.54,1.85
03-02-2021,SERTÃ,95,7,652,"[480,960]",Muito Elevado,,,,95,Centro,CASTELO BRANCO,0509,44673.17,14577,870,779,790,767,1020,1787,2577,3356,4226,32.63,9.46,7.51,5.77
03-02-2021,SESIMBRA,1245,89,2401,"[960,Max]",Extremamente Elevado,,,,1245,Lisboa e Vale do Tejo,SETÚBAL,1511,19571.75,51858,2400,2321,1853,1257,1083,2340,4193,6514,8914,264.96,45.54,33.28,21.42
03-02-2021,SETÚBAL,3412,244,2964,"[960,Max]",Extremamente Elevado,,,,3412,Lisboa e Vale do Tejo,SETÚBAL,1512,23032.5,115126,7425,6929,5075,3775,2655,6430,11505,18434,25859,499.83,112.27,80.03,49.95
03-02-2021,SEVER DO VOUGA,214,15,1889,"[960,Max]",Extremamente Elevado,,,,214,Centro,AVEIRO,0117,12987.56,11331,766,637,568,540,567,1107,1675,2312,3078,87.24,23.7,17.8,12.9
03-02-2021,SILVES,263,19,726,"[480,960]",Muito Elevado,,,,263,Algarve,FARO,0813,68006.23,36226,2137,1869,1610,1423,1600,3023,4633,6502,8639,53.27,12.7,9.56,6.81
03-02-2021,SINES,112,8,817,"[480,960]",Muito Elevado,,,,112,Alentejo,SETÚBAL,1513,20330.17,13715,888,791,551,416,268,684,1235,2026,2914,67.46,14.33,9.97,6.07
03-02-2021,SINTRA,9276,663,2370,"[960,Max]",Extremamente Elevado,,,,9276,Lisboa e Vale do Tejo,LISBOA,1111,31922.73,391402,20490,18316,13545,9137,7284,16421,29966,48282,68772,1226.08,215.43,151.25,93.87
03-02-2021,SOBRAL DE MONTE AGRAÇO,186,13,1746,"[960,Max]",Extremamente Elevado,,,,186,Lisboa e Vale do Tejo,LISBOA,1112,5210.32,10651,564,507,352,272,212,484,836,1343,1907,204.43,36.6,25.78,16.05
03-02-2021,SOURE,229,16,1338,"[960,Max]",Extremamente Elevado,,,,229,Centro,COIMBRA,0615,26506.07,17120,1173,1142,1004,883,987,1870,2874,4016,5189,64.59,19.58,15.15,10.84
03-02-2021,SOUSEL,39,3,884,"[480,960]",Muito Elevado,,,,39,Alentejo,PORTALEGRE,1215,27932.18,4412,261,274,208,302,292,594,802,1076,1337,15.8,4.79,3.85,2.87
03-02-2021,TÁBUA,381,27,3352,"[960,Max]",Extremamente Elevado,,,,381,Centro,COIMBRA,0616,19978.58,11368,729,584,524,430,464,894,1418,2002,2731,56.9,13.67,10.02,7.1
03-02-2021,TABUAÇO,58,4,961,"[960,Max]",Extremamente Elevado,,,,58,Norte,VISEU,1819,13385.67,6033,372,314,217,282,363,645,862,1176,1548,45.07,11.56,8.79,6.44
03-02-2021,TAROUCA,176,13,2255,"[960,Max]",Extremamente Elevado,,,,176,Norte,VISEU,1820,10008.49,7804,405,335,313,277,324,601,914,1249,1654,77.98,16.53,12.48,9.13
03-02-2021,TAVIRA,224,16,913,"[480,960]",Muito Elevado,,,,224,Algarve,FARO,0814,60696.7,24530,1493,1415,1252,1066,1277,2343,3595,5010,6503,40.41,10.71,8.25,5.92
03-02-2021,TERRAS DE BOURO,69,5,1085,"[960,Max]",Extremamente Elevado,,,,69,Norte,BRAGA,0310,27746.07,6361,391,372,296,319,340,659,955,1327,1718,22.93,6.19,4.78,3.44
03-02-2021,TOMAR,606,43,1649,"[960,Max]",Extremamente Elevado,,,,606,Lisboa e Vale do Tejo,SANTARÉM,1418,35120.44,36748,2403,2189,1868,1853,1822,3675,5543,7732,10135,104.64,28.86,22.02,15.78
03-02-2021,TONDELA,472,34,1791,"[960,Max]",Extremamente Elevado,,,,472,Centro,VISEU,1821,37121.73,26357,1768,1722,1518,1475,1417,2892,4410,6132,7900,71.0,21.28,16.52,11.88
03-02-2021,TORRE DE MONCORVO,46,3,598,"[480,960]",Muito Elevado,,,,46,Norte,BRAGANÇA,0409,53155.67,7695,556,478,488,551,719,1270,1758,2236,2792,14.48,5.25,4.21,3.31
03-02-2021,TORRES NOVAS,360,26,1031,"[960,Max]",Extremamente Elevado,,,,360,Lisboa e Vale do Tejo,SANTARÉM,1419,26999.68,34933,2324,1979,1738,1406,1475,2881,4619,6598,8922,129.38,33.04,24.44,17.11
03-02-2021,TORRES VEDRAS,1250,89,1592,"[960,Max]",Extremamente Elevado,,,,1250,Lisboa e Vale do Tejo,LISBOA,1113,40714.89,78530,4513,3945,3447,2628,2104,4732,8179,12124,16637,192.88,40.86,29.78,20.09
03-02-2021,TRANCOSO,128,9,1442,"[960,Max]",Extremamente Elevado,,,,128,Centro,GUARDA,0913,36152.47,8875,581,557,542,586,496,1082,1624,2181,2762,24.55,7.64,6.03,4.49
03-02-2021,TROFA,524,37,1364,"[960,Max]",Extremamente Elevado,,,,524,Norte,PORTO,1318,7201.76,38418,2336,1894,1231,939,684,1623,2854,4748,7084,533.44,98.36,65.93,39.63
03-02-2021,VAGOS,195,14,858,"[480,960]",Muito Elevado,,,,195,Centro,AVEIRO,0118,16491.5,22740,1320,1205,922,784,724,1508,2430,3635,4955,137.89,30.04,22.04,14.73
03-02-2021,VALE DE CAMBRA,389,28,1824,"[960,Max]",Extremamente Elevado,,,,389,Norte,AVEIRO,0119,14733.47,21327,1491,1363,1005,831,798,1629,2634,3997,5488,144.76,37.25,27.13,17.88
03-02-2021,VALENÇA,224,16,1685,"[960,Max]",Extremamente Elevado,,,,224,Norte,VIANA DO CASTELO,1608,11712.86,13290,867,791,582,582,503,1085,1667,2458,3325,113.46,28.39,20.99,14.23
03-02-2021,VALONGO,872,62,895,"[480,960]",Muito Elevado,,,,872,Norte,PORTO,1315,7512.45,97444,5629,4696,3207,2462,1829,4291,7498,12194,17823,1297.18,237.26,162.33,99.81
03-02-2021,VALPAÇOS,210,15,1417,"[960,Max]",Extremamente Elevado,,,,210,Norte,VILA REAL,1712,54873.93,14818,1217,1118,999,928,997,1925,2924,4042,5259,27.0,9.58,7.37,5.33
03-02-2021,VELAS,0,0,0,"[0,240]",Moderado,,,,0,Açores,AÇORES,4502,11738.38,5093,278,208,166,153,113,266,432,640,918,43.39,7.82,5.45,3.68
03-02-2021,VENDAS NOVAS,103,7,915,"[480,960]",Muito Elevado,,,,103,Alentejo,ÉVORA,0712,22238.88,11255,677,768,655,501,532,1033,1688,2456,3133,50.61,14.09,11.04,7.59
03-02-2021,VIANA DO ALENTEJO,56,4,1088,"[960,Max]",Extremamente Elevado,,,,56,Alentejo,ÉVORA,0713,39367.29,5145,245,208,235,210,214,424,659,867,1112,13.07,2.82,2.2,1.67
03-02-2021,VIANA DO CASTELO,1143,82,1354,"[960,Max]",Extremamente Elevado,,,,1143,Norte,VIANA DO CASTELO,1609,31902.01,84417,5470,4433,3591,3061,2982,6043,9634,14067,19537,264.61,61.24,44.09,30.2
03-02-2021,VIDIGUEIRA,26,2,472,"[240,480]",Elevado,,,,26,Alentejo,BEJA,0214,31661.09,5510,300,248,215,233,275,508,723,971,1271,17.4,4.01,3.07,2.28
03-02-2021,VIEIRA DO MINHO,184,13,1554,"[960,Max]",Extremamente Elevado,,,,184,Norte,BRAGA,0311,21644.35,11842,703,594,525,548,482,1030,1555,2149,2852,54.71,13.18,9.93,7.18
03-02-2021,VILA DE REI,76,5,2287,"[960,Max]",Extremamente Elevado,,,,76,Centro,CASTELO BRANCO,0510,19154.6,3323,169,128,172,247,302,549,721,849,1018,17.35,5.31,4.43,3.76
03-02-2021,VILA DO BISPO,12,1,233,"[0,240]",Moderado,,,,12,Algarve,FARO,0815,17906.06,5154,302,302,314,232,233,465,779,1081,1383,28.78,7.72,6.04,4.35
03-02-2021,VILA DO CONDE,1300,93,1627,"[960,Max]",Extremamente Elevado,,,,1300,Norte,PORTO,1316,14902.77,79899,4726,3875,2819,2070,1743,3813,6632,10507,15233,536.13,102.21,70.5,44.5
03-02-2021,VILA DO PORTO,3,0,53,"[0,240]",Moderado,,,,3,Açores,AÇORES,4101,9688.74,5616,274,212,135,96,123,219,354,566,840,57.96,8.67,5.84,3.65
03-02-2021,VILA FLOR,152,11,2515,"[960,Max]",Extremamente Elevado,,,,152,Norte,BRAGANÇA,0410,26581.14,6044,429,362,422,294,331,625,1047,1409,1838,22.74,6.91,5.3,3.94
03-02-2021,VILA FRANCA DE XIRA,3370,241,2374,"[960,Max]",Extremamente Elevado,,,,3370,Lisboa e Vale do Tejo,LISBOA,1114,31819.39,141957,8501,6852,4869,3425,2472,5897,10766,17618,26119,446.14,82.09,55.37,33.84
03-02-2021,VILA FRANCA DO CAMPO,53,4,480,"[480,960]",Muito Elevado,,,,53,Açores,AÇORES,4206,7796.82,11051,450,344,248,217,154,371,619,963,1413,141.73,18.12,12.35,7.94
03-02-2021,VILA NOVA DA BARQUINHA,60,4,804,"[480,960]",Muito Elevado,,,,60,Lisboa e Vale do Tejo,SANTARÉM,1420,4952.97,7461,415,406,392,364,338,702,1094,1500,1915,150.64,38.66,30.28,22.09
03-02-2021,VILA NOVA DE CERVEIRA,141,10,1582,"[960,Max]",Extremamente Elevado,,,,141,Norte,VIANA DO CASTELO,1610,10846.66,8910,531,444,410,384,334,718,1128,1572,2103,82.14,19.39,14.49,10.4
03-02-2021,VILA NOVA DE FAMALICÃO,1944,139,1476,"[960,Max]",Extremamente Elevado,,,,1944,Norte,BRAGA,0312,20159.26,131676,7817,6164,4202,3282,2749,6031,10233,16397,24214,653.19,120.12,81.34,50.76
03-02-2021,VILA NOVA DE FOZ CÔA,116,8,1784,"[960,Max]",Extremamente Elevado,,,,116,Centro,GUARDA,0914,39815.18,6503,442,385,390,398,429,827,1217,1602,2044,16.33,5.13,4.02,3.06
03-02-2021,VILA NOVA DE GAIA,2933,209,976,"[960,Max]",Extremamente Elevado,,,,2933,Norte,PORTO,1317,16846.43,300472,18349,15568,10972,8224,6281,14505,25477,41045,59394,1783.64,352.57,243.65,151.23
03-02-2021,VILA NOVA DE PAIVA,100,7,2134,"[960,Max]",Extremamente Elevado,,,,100,Centro,VISEU,1822,17553.28,4687,289,272,233,217,241,458,691,963,1252,26.7,7.13,5.49,3.94
03-02-2021,VILA NOVA DE POIARES,78,6,1124,"[960,Max]",Extremamente Elevado,,,,78,Centro,COIMBRA,0617,8445.3,6939,380,284,262,235,182,417,679,963,1343,82.17,15.9,11.4,8.04
03-02-2021,VILA POUCA DE AGUIAR,108,8,903,"[480,960]",Muito Elevado,,,,108,Norte,VILA REAL,1713,43706.62,11961,860,817,733,601,627,1228,1961,2778,3638,27.37,8.32,6.36,4.49
03-02-2021,VILA REAL,578,41,1157,"[960,Max]",Extremamente Elevado,,,,578,Norte,VILA REAL,1714,37880.28,49962,3025,2498,2065,1579,1466,3045,5110,7608,10633,131.9,28.07,20.08,13.49
03-02-2021,VILA REAL DE SANTO ANTÓNIO,394,28,2101,"[960,Max]",Extremamente Elevado,,,,394,Algarve,FARO,0816,6125.0,18749,1172,1069,811,569,586,1155,1966,3035,4207,306.11,68.69,49.55,32.1
03-02-2021,VILA VELHA DE RÓDÃO,33,2,1050,"[960,Max]",Extremamente Elevado,,,,33,Centro,CASTELO BRANCO,0511,32991.16,3144,209,229,180,283,306,589,769,998,1207,9.53,3.66,3.03,2.33
03-02-2021,VILA VERDE,752,54,1603,"[960,Max]",Extremamente Elevado,,,,752,Norte,BRAGA,0313,22866.52,46911,2365,2063,1667,1494,1437,2931,4598,6661,9026,205.15,39.47,29.13,20.11
03-02-2021,VILA VIÇOSA,79,6,1032,"[960,Max]",Extremamente Elevado,,,,79,Alentejo,ÉVORA,0714,19485.89,7656,487,379,342,345,324,669,1011,1390,1877,39.29,9.63,7.13,5.19
03-02-2021,VIMIOSO,18,1,447,"[240,480]",Elevado,,,,18,Norte,BRAGANÇA,0411,48158.51,4023,274,230,261,293,335,628,889,1119,1393,8.35,2.89,2.32,1.85
03-02-2021,VINHAIS,132,9,1704,"[960,Max]",Extremamente Elevado,,,,132,Norte,BRAGANÇA,0412,69475.09,7746,599,577,636,641,815,1456,2092,2669,3268,11.15,4.7,3.84,3.01
03-02-2021,VISEU,2093,149,2152,"[960,Max]",Extremamente Elevado,,,,2093,Centro,VISEU,1823,50710.14,97249,5769,5038,4140,3158,2710,5868,10008,15046,20815,191.77,41.05,29.67,19.74
03-02-2021,VIZELA,277,20,1159,"[960,Max]",Extremamente Elevado,,,,277,Norte,BRAGA,0314,2469.83,23897,1258,928,655,509,371,880,1535,2463,3721,967.49,150.65,99.72,62.15
03-02-2021,VOUZELA,208,15,2162,"[960,Max]",Extremamente Elevado,,,,208,Centro,VISEU,1824,19369.46,9619,626,605,554,532,507,1039,1593,2198,2824,49.66,14.58,11.35,8.22
10-02-2021,ABRANTES,271,19,771,"[480,960]",Muito Elevado,,,,271,Lisboa e Vale do Tejo,SANTARÉM,1401,71469.08,35130,2473,2213,1730,1748,2021,3769,5499,7712,10185,49.15,14.25,10.79,7.69
10-02-2021,ÁGUEDA,311,22,675,"[480,960]",Muito Elevado,,,,311,Centro,AVEIRO,0101,33527.44,46075,3237,2713,2090,1635,1496,3131,5221,7934,11171,137.43,33.32,23.66,15.57
10-02-2021,AGUIAR DA BEIRA,92,7,1978,"[960,Max]",Extremamente Elevado,,,,92,Centro,GUARDA,0901,20676.57,4652,304,281,235,239,148,387,622,903,1207,22.5,5.84,4.37,3.01
10-02-2021,ALANDROAL,72,5,1442,"[960,Max]",Extremamente Elevado,,,,72,Alentejo,ÉVORA,0701,54267.81,4992,307,256,296,299,377,676,972,1228,1535,9.2,2.83,2.26,1.79
10-02-2021,ALBERGARIA-A-VELHA,164,12,679,"[480,960]",Muito Elevado,,,,164,Centro,AVEIRO,0102,15882.5,24144,1550,1298,996,687,680,1367,2363,3661,5211,152.02,32.81,23.05,14.88
10-02-2021,ALBUFEIRA,264,19,636,"[480,960]",Muito Elevado,,,,264,Algarve,FARO,0801,14066.42,41528,2067,1717,1425,985,858,1843,3268,4985,7052,295.24,50.14,35.44,23.23
10-02-2021,ALCÁCER DO SAL,174,12,1492,"[960,Max]",Extremamente Elevado,,,,174,Alentejo,SETÚBAL,1501,149987.3,11659,884,814,623,623,602,1225,1848,2662,3546,7.77,2.36,1.77,1.23
10-02-2021,ALCANENA,163,12,1273,"[960,Max]",Extremamente Elevado,,,,163,Lisboa e Vale do Tejo,SANTARÉM,1402,12732.86,12809,891,744,628,536,588,1124,1752,2496,3387,100.6,26.6,19.6,13.76
10-02-2021,ALCOBAÇA,428,31,799,"[480,960]",Muito Elevado,,,,428,Lisboa e Vale do Tejo,LEIRIA,1001,40814.09,53555,3420,2927,2466,2059,1676,3735,6201,9128,12548,131.22,30.74,22.36,15.19
10-02-2021,ALCOCHETE,265,19,1339,"[960,Max]",Extremamente Elevado,,,,265,Lisboa e Vale do Tejo,SETÚBAL,1502,12836.48,19787,857,834,691,476,447,923,1614,2448,3305,154.15,25.75,19.07,12.57
10-02-2021,ALCOUTIM,20,1,926,"[480,960]",Muito Elevado,,,,20,Algarve,FARO,0802,57536.33,2159,191,188,163,190,267,457,620,808,999,3.75,1.74,1.4,1.08
10-02-2021,ALENQUER,598,43,1357,"[960,Max]",Extremamente Elevado,,,,598,Lisboa e Vale do Tejo,LISBOA,1101,30421.92,44052,2298,2062,1629,1330,1155,2485,4114,6176,8474,144.8,27.85,20.3,13.52
10-02-2021,ALFÂNDEGA DA FÉ,88,6,1934,"[960,Max]",Extremamente Elevado,,,,88,Norte,BRAGANÇA,0401,32194.64,4550,325,277,301,274,325,599,900,1177,1502,14.13,4.67,3.66,2.8
10-02-2021,ALIJÓ,64,5,602,"[480,960]",Muito Elevado,,,,64,Norte,VILA REAL,1701,29759.89,10625,766,687,635,542,666,1208,1843,2530,3296,35.7,11.08,8.5,6.19
10-02-2021,ALJEZUR,6,0,107,"[0,240]",Moderado,,,,6,Algarve,FARO,0803,32349.95,5594,316,336,335,320,410,730,1065,1401,1717,17.29,5.31,4.33,3.29
10-02-2021,ALJUSTREL,180,13,2183,"[960,Max]",Extremamente Elevado,,,,180,Alentejo,BEJA,0201,45847.41,8247,635,521,443,347,358,705,1148,1669,2304,17.99,5.03,3.64,2.5
10-02-2021,ALMADA,2414,172,1428,"[960,Max]",Extremamente Elevado,,,,2414,Lisboa e Vale do Tejo,SETÚBAL,1503,7000.89,169039,10469,9777,7876,6144,5111,11255,19131,28908,39377,2414.5,562.45,412.91,273.26
10-02-2021,ALMEIDA,97,7,1664,"[960,Max]",Extremamente Elevado,,,,97,Centro,GUARDA,0902,51798.46,5830,441,419,396,458,393,851,1247,1666,2107,11.26,4.07,3.22,2.41
10-02-2021,ALMEIRIM,226,16,1002,"[960,Max]",Extremamente Elevado,,,,226,Lisboa e Vale do Tejo,SANTARÉM,1403,22212.05,22546,1342,1353,1106,866,843,1709,2815,4168,5510,101.5,24.81,18.76,12.67
10-02-2021,ALMODÔVAR,23,2,342,"[240,480]",Elevado,,,,23,Alentejo,BEJA,0202,77788.03,6725,414,443,396,373,328,701,1097,1540,1954,8.65,2.51,1.98,1.41
10-02-2021,ALPIARÇA,52,4,737,"[480,960]",Muito Elevado,,,,52,Lisboa e Vale do Tejo,SANTARÉM,1404,9536.33,7059,515,486,363,333,274,607,970,1456,1971,74.02,20.67,15.27,10.17
10-02-2021,ALTER DO CHÃO,13,1,411,"[240,480]",Elevado,,,,13,Alentejo,PORTALEGRE,1201,36206.62,3165,201,163,136,208,187,395,531,694,895,8.74,2.47,1.92,1.47
10-02-2021,ALVAIÁZERE,103,7,1561,"[960,Max]",Extremamente Elevado,,,,103,Centro,LEIRIA,1002,16047.76,6597,419,389,346,406,539,945,1291,1680,2099,41.11,13.08,10.47,8.04
10-02-2021,ALVITO,2,0,81,"[0,240]",Moderado,,,,2,Alentejo,BEJA,0203,26485.32,2477,145,110,105,111,89,200,305,415,560,9.35,2.11,1.57,1.15
10-02-2021,AMADORA,3032,217,1647,"[960,Max]",Extremamente Elevado,,,,3032,Lisboa e Vale do Tejo,LISBOA,1115,2378.47,184106,11186,10936,8780,6460,5890,12350,21130,32066,43252,7742.05,1818.84,1348.44,888.56
10-02-2021,AMARANTE,400,29,752,"[480,960]",Muito Elevado,,,,400,Norte,PORTO,1301,30133.15,53193,3086,2413,1812,1643,1311,2954,4766,7179,10265,176.53,34.07,23.82,15.82
10-02-2021,AMARES,101,7,557,"[480,960]",Muito Elevado,,,,101,Norte,BRAGA,0301,8195.41,18129,1001,829,622,489,524,1013,1635,2464,3465,221.22,42.28,30.07,19.95
10-02-2021,ANADIA,220,16,807,"[480,960]",Muito Elevado,,,,220,Centro,AVEIRO,0103,21663.48,27258,1931,1698,1376,1208,1262,2470,3846,5544,7475,125.83,34.51,25.59,17.75
10-02-2021,ANGRA DO HEROÍSMO,23,2,68,"[0,240]",Moderado,,,,23,Açores,AÇORES,4301,23899.66,33807,2006,1473,1122,768,635,1403,2525,3998,6004,141.45,25.12,16.73,10.56
10-02-2021,ANSIÃO,232,17,1927,"[960,Max]",Extremamente Elevado,,,,232,Centro,LEIRIA,1003,17609.42,12039,727,709,646,694,530,1224,1870,2579,3306,68.37,18.77,14.65,10.62
10-02-2021,ARCOS DE VALDEVEZ,279,20,1333,"[960,Max]",Extremamente Elevado,,,,279,Norte,VIANA DO CASTELO,1601,44759.64,20926,1329,1338,1282,1343,1515,2858,4140,5478,6807,46.75,15.21,12.24,9.25
10-02-2021,ARGANIL,143,10,1298,"[960,Max]",Extremamente Elevado,,,,143,Centro,COIMBRA,0601,33283.93,11014,672,648,612,559,596,1155,1767,2415,3087,33.09,9.27,7.26,5.31
10-02-2021,ARMAMAR,64,5,1109,"[960,Max]",Extremamente Elevado,,,,64,Norte,VISEU,1801,11723.73,5769,357,305,309,285,310,595,904,1209,1566,49.21,13.36,10.31,7.71
10-02-2021,AROUCA,136,10,656,"[480,960]",Muito Elevado,,,,136,Norte,AVEIRO,0104,32910.52,20720,1306,1047,753,683,683,1366,2119,3166,4472,62.96,13.59,9.62,6.44
10-02-2021,ARRAIOLOS,69,5,996,"[960,Max]",Extremamente Elevado,,,,69,Alentejo,ÉVORA,0702,68374.55,6928,435,384,283,367,480,847,1130,1514,1949,10.13,2.85,2.21,1.65
10-02-2021,ARRONCHES,40,3,1418,"[960,Max]",Extremamente Elevado,,,,40,Alentejo,PORTALEGRE,1202,31464.72,2820,155,142,162,187,179,366,528,670,825,8.96,2.62,2.13,1.68
10-02-2021,ARRUDA DOS VINHOS,185,13,1200,"[960,Max]",Extremamente Elevado,,,,185,Lisboa e Vale do Tejo,LISBOA,1102,7795.93,15412,738,738,562,509,438,947,1509,2247,2985,197.69,38.29,28.82,19.36
10-02-2021,AVEIRO,590,42,749,"[480,960]",Muito Elevado,,,,590,Centro,AVEIRO,0105,19757.57,78734,4520,4004,3050,2250,2103,4353,7403,11407,15927,398.49,80.61,57.73,37.47
10-02-2021,AVIS,13,1,306,"[240,480]",Elevado,,,,13,Alentejo,PORTALEGRE,1203,60596.51,4247,315,225,206,251,273,524,730,955,1270,7.01,2.1,1.58,1.2
10-02-2021,AZAMBUJA,217,15,955,"[480,960]",Muito Elevado,,,,217,Lisboa e Vale do Tejo,LISBOA,1103,26265.65,22716,1322,1171,1070,798,618,1416,2486,3657,4979,86.48,18.96,13.92,9.46
10-02-2021,BAIÃO,176,13,939,"[480,960]",Muito Elevado,,,,176,Norte,PORTO,1302,17452.83,18748,1070,862,714,686,725,1411,2125,2987,4057,107.42,23.25,17.11,12.18
10-02-2021,BARCELOS,1045,75,899,"[480,960]",Muito Elevado,,,,1045,Norte,BRAGA,0302,37890.14,116187,6721,5325,3619,2991,2562,5553,9172,14497,21218,306.64,56.0,38.26,24.21
10-02-2021,BARRANCOS,13,1,796,"[480,960]",Muito Elevado,,,,13,Alentejo,BEJA,0204,16841.73,1634,90,65,65,94,61,155,220,285,375,9.7,2.23,1.69,1.31
10-02-2021,BARREIRO,1134,81,1509,"[960,Max]",Extremamente Elevado,,,,1134,Lisboa e Vale do Tejo,SETÚBAL,1504,3639.07,75147,5194,5565,4459,3105,1767,4872,9331,14896,20090,2065.05,552.07,409.34,256.42
10-02-2021,BATALHA,85,6,532,"[480,960]",Muito Elevado,,,,85,Centro,LEIRIA,1004,10341.6,15963,873,762,649,529,549,1078,1727,2489,3362,154.35,32.51,24.07,16.7
10-02-2021,BEJA,374,27,1114,"[960,Max]",Extremamente Elevado,,,,374,Alentejo,BEJA,0205,114647.55,33579,2005,1840,1386,1272,1039,2311,3697,5537,7542,29.29,6.58,4.83,3.22
10-02-2021,BELMONTE,86,6,1344,"[960,Max]",Extremamente Elevado,,,,86,Centro,CASTELO BRANCO,0501,11875.91,6398,444,321,325,310,355,665,990,1311,1755,53.87,14.78,11.04,8.34
10-02-2021,BENAVENTE,428,31,1399,"[960,Max]",Extremamente Elevado,,,,428,Lisboa e Vale do Tejo,SANTARÉM,1405,52138.39,30602,1468,1376,1141,876,643,1519,2660,4036,5504,58.69,10.56,7.74,5.1
10-02-2021,BOMBARRAL,139,10,1107,"[960,Max]",Extremamente Elevado,,,,139,Lisboa e Vale do Tejo,LEIRIA,1005,9128.55,12558,875,714,561,491,429,920,1481,2195,3070,137.56,33.63,24.04,16.22
10-02-2021,BORBA,41,3,609,"[480,960]",Muito Elevado,,,,41,Alentejo,ÉVORA,0703,14518.65,6736,430,375,279,436,392,828,1107,1482,1912,46.39,13.17,10.21,7.62
10-02-2021,BOTICAS,91,7,1821,"[960,Max]",Extremamente Elevado,,,,91,Norte,VILA REAL,1702,32195.66,4998,347,306,311,305,380,685,996,1302,1649,15.52,5.12,4.04,3.09
10-02-2021,BRAGA,1213,87,664,"[480,960]",Muito Elevado,,,,1213,Norte,BRAGA,0303,18339.95,182679,10029,7963,5241,4320,3671,7991,13232,21195,31224,996.07,170.25,115.57,72.15
10-02-2021,BRAGANÇA,318,23,946,"[480,960]",Muito Elevado,,,,318,Norte,BRAGANÇA,0402,117357.27,33607,2402,1855,1652,1393,1163,2556,4208,6063,8465,28.64,7.21,5.17,3.59
10-02-2021,CABECEIRAS DE BASTO,58,4,371,"[240,480]",Elevado,,,,58,Norte,BRAGA,0304,24182.16,15628,774,594,544,575,574,1149,1693,2287,3061,64.63,12.66,9.46,7.0
10-02-2021,CADAVAL,75,5,549,"[480,960]",Muito Elevado,,,,75,Lisboa e Vale do Tejo,LISBOA,1104,17489.3,13673,813,796,756,621,625,1246,2002,2798,3611,78.18,20.65,16.0,11.45
10-02-2021,CALDAS DA RAINHA,535,38,1031,"[960,Max]",Extremamente Elevado,,,,535,Lisboa e Vale do Tejo,LEIRIA,1006,25569.47,51912,3035,2684,2186,1899,1705,3604,5790,8474,11509,203.03,45.01,33.14,22.64
10-02-2021,CALHETA,23,2,212,"[0,240]",Moderado,,,,23,Madeira,MADEIRA,3101,11150.43,10867,576,497,507,399,415,814,1321,1818,2394,97.46,21.47,16.3,11.85
10-02-2021,CALHETA (AÇORES),0,0,0,"[0,240]",Moderado,,,,0,Açores,AÇORES,4501,12626.4,3184,215,159,141,139,122,261,402,561,776,25.22,6.15,4.44,3.18
10-02-2021,CÂMARA DE LOBOS,413,29,1226,"[960,Max]",Extremamente Elevado,,,,413,Madeira,MADEIRA,3102,5216.67,33675,1396,1059,834,545,381,926,1760,2819,4215,645.49,80.79,54.03,33.74
10-02-2021,CAMINHA,221,16,1392,"[960,Max]",Extremamente Elevado,,,,221,Norte,VIANA DO CASTELO,1602,13652.14,15877,1046,944,818,646,656,1302,2120,3064,4110,116.3,30.11,22.44,15.53
10-02-2021,CAMPO MAIOR,93,7,1181,"[960,Max]",Extremamente Elevado,,,,93,Alentejo,PORTALEGRE,1204,24720.16,7874,471,364,351,279,327,606,957,1321,1792,31.85,7.25,5.34,3.87
10-02-2021,CANTANHEDE,477,34,1362,"[960,Max]",Extremamente Elevado,,,,477,Centro,COIMBRA,0602,39088.02,35011,2346,2096,1880,1709,1451,3160,5040,7136,9482,89.57,24.26,18.26,12.89
10-02-2021,CARRAZEDA DE ANSIÃES,42,3,741,"[480,960]",Muito Elevado,,,,42,Norte,BRAGANÇA,0403,27924.09,5666,424,389,391,312,465,777,1168,1557,1981,20.29,7.09,5.58,4.18
10-02-2021,CARREGAL DO SAL,87,6,938,"[480,960]",Muito Elevado,,,,87,Centro,VISEU,1802,11689.21,9271,587,562,486,462,376,838,1324,1886,2473,79.31,21.16,16.13,11.33
10-02-2021,CARTAXO,208,15,872,"[480,960]",Muito Elevado,,,,208,Lisboa e Vale do Tejo,SANTARÉM,1406,15817.28,23843,1415,1376,1142,861,632,1493,2635,4011,5426,150.74,34.3,25.36,16.66
10-02-2021,CASCAIS,2700,193,1264,"[960,Max]",Extremamente Elevado,,,,2700,Lisboa e Vale do Tejo,LISBOA,1105,9740.17,213608,12151,11444,8680,6469,5248,11717,20397,31841,43992,2193.1,451.66,326.91,209.41
10-02-2021,CASTANHEIRA DE PÊRA,94,7,3596,"[960,Max]",Extremamente Elevado,,,,94,Centro,LEIRIA,1007,6677.45,2614,233,195,157,190,187,377,534,729,962,39.15,14.41,10.92,8.0
10-02-2021,CASTELO BRANCO,334,24,642,"[480,960]",Muito Elevado,,,,334,Centro,CASTELO BRANCO,0502,143819.15,51987,3528,3042,2499,2229,2225,4454,6953,9995,13523,36.15,9.4,6.95,4.83
10-02-2021,CASTELO DE PAIVA,112,8,725,"[480,960]",Muito Elevado,,,,112,Norte,AVEIRO,0106,11500.53,15454,881,697,545,420,431,851,1396,2093,2974,134.37,25.86,18.2,12.14
10-02-2021,CASTELO DE VIDE,90,6,3083,"[960,Max]",Extremamente Elevado,,,,90,Alentejo,PORTALEGRE,1205,26491.24,2919,204,173,179,147,170,317,496,669,873,11.02,3.3,2.53,1.87
10-02-2021,CASTRO DAIRE,162,12,1172,"[960,Max]",Extremamente Elevado,,,,162,Centro,VISEU,1803,37904.13,13823,942,857,765,732,773,1505,2270,3127,4069,36.47,10.74,8.25,5.99
10-02-2021,CASTRO MARIM,74,5,1186,"[960,Max]",Extremamente Elevado,,,,74,Algarve,FARO,0804,30084.37,6237,370,345,334,322,344,666,1000,1345,1715,20.73,5.7,4.47,3.32
10-02-2021,CASTRO VERDE,68,5,979,"[960,Max]",Extremamente Elevado,,,,68,Alentejo,BEJA,0206,56944.23,6949,437,347,303,275,227,502,805,1152,1589,12.2,2.79,2.02,1.41
10-02-2021,CELORICO DA BEIRA,44,3,635,"[480,960]",Muito Elevado,,,,44,Centro,GUARDA,0903,24721.63,6928,430,416,363,369,535,904,1267,1683,2113,28.02,8.55,6.81,5.12
10-02-2021,CELORICO DE BASTO,91,7,478,"[240,480]",Elevado,,,,91,Norte,BRAGA,0305,18107.02,19040,1001,802,668,728,729,1457,2125,2927,3928,105.15,21.69,16.17,11.74
10-02-2021,CHAMUSCA,68,5,739,"[480,960]",Muito Elevado,,,,68,Lisboa e Vale do Tejo,SANTARÉM,1407,74600.54,9197,629,583,553,465,579,1044,1597,2180,2809,12.33,3.77,2.92,2.14
10-02-2021,CHAVES,179,13,455,"[240,480]",Elevado,,,,179,Norte,VILA REAL,1703,59122.95,39343,2676,2429,1991,1886,1918,3804,5795,8224,10900,66.54,18.44,13.91,9.8
10-02-2021,CINFÃES,122,9,669,"[480,960]",Muito Elevado,,,,122,Norte,VISEU,1804,23928.76,18244,1067,902,779,734,758,1492,2271,3173,4240,76.24,17.72,13.26,9.49
10-02-2021,COIMBRA,2118,151,1579,"[960,Max]",Extremamente Elevado,,,,2118,Centro,COIMBRA,0603,31939.94,134166,9489,8734,6353,5139,5074,10213,16566,25300,34789,420.06,108.92,79.21,51.87
10-02-2021,CONDEIXA-A-NOVA,199,14,1122,"[960,Max]",Extremamente Elevado,,,,199,Centro,COIMBRA,0604,13867.47,17733,871,809,717,583,490,1073,1790,2599,3470,127.88,25.02,18.74,12.91
10-02-2021,CONSTÂNCIA,12,1,298,"[240,480]",Elevado,,,,12,Lisboa e Vale do Tejo,SANTARÉM,1408,8036.58,4030,211,183,187,148,155,303,490,673,884,50.14,11.0,8.37,6.1
10-02-2021,CORUCHE,216,15,1236,"[960,Max]",Extremamente Elevado,,,,216,Lisboa e Vale do Tejo,SANTARÉM,1409,111572.03,17471,1294,1090,1095,1096,1019,2115,3210,4300,5594,15.66,5.01,3.85,2.88
10-02-2021,CORVO,1,0,216,"[0,240]",Moderado,,,,1,Açores,AÇORES,4901,1711.45,464,22,21,11,13,19,32,43,64,86,27.12,5.03,3.74,2.51
10-02-2021,COVILHÃ,552,39,1180,"[960,Max]",Extremamente Elevado,,,,552,Centro,CASTELO BRANCO,0503,55560.06,46787,3533,2998,2365,2111,2193,4304,6669,9667,13200,84.21,23.76,17.4,12.0
10-02-2021,CRATO,8,1,256,"[240,480]",Elevado,,,,8,Alentejo,PORTALEGRE,1206,39806.88,3129,229,258,163,182,228,410,573,831,1060,7.86,2.66,2.09,1.44
10-02-2021,CUBA,44,3,958,"[480,960]",Muito Elevado,,,,44,Alentejo,BEJA,0207,17208.72,4595,255,233,206,190,143,333,539,772,1027,26.7,5.97,4.49,3.13
10-02-2021,ELVAS,128,9,624,"[480,960]",Muito Elevado,,,,128,Alentejo,PORTALEGRE,1207,63128.86,20528,1057,1145,902,852,810,1662,2564,3709,4766,32.52,7.55,5.88,4.06
10-02-2021,ENTRONCAMENTO,108,8,501,"[480,960]",Muito Elevado,,,,108,Lisboa e Vale do Tejo,SANTARÉM,1410,1372.81,21558,1066,930,868,695,592,1287,2155,3085,4151,1570.14,302.33,224.69,156.96
10-02-2021,ESPINHO,271,19,918,"[480,960]",Muito Elevado,,,,271,Norte,AVEIRO,0107,2105.68,29516,2205,1993,1430,1177,960,2137,3567,5560,7765,1401.52,368.71,264.01,169.37
10-02-2021,ESPOSENDE,267,19,781,"[480,960]",Muito Elevado,,,,267,Norte,BRAGA,0306,9540.98,34177,1831,1522,1095,894,723,1617,2712,4234,6065,358.21,63.57,44.38,28.42
10-02-2021,ESTARREJA,166,12,638,"[480,960]",Muito Elevado,,,,166,Centro,AVEIRO,0108,10817.33,26006,1503,1399,1106,953,728,1681,2787,4186,5689,240.42,52.59,38.7,25.76
10-02-2021,ESTREMOZ,220,16,1728,"[960,Max]",Extremamente Elevado,,,,220,Alentejo,ÉVORA,0704,51379.95,12728,789,613,697,786,877,1663,2360,2973,3762,24.77,7.32,5.79,4.59
10-02-2021,ÉVORA,272,19,519,"[480,960]",Muito Elevado,,,,272,Alentejo,ÉVORA,0705,130707.58,52428,3569,2852,2176,1966,1803,3769,5945,8797,12366,40.11,9.46,6.73,4.55
10-02-2021,FAFE,347,25,722,"[480,960]",Muito Elevado,,,,347,Norte,BRAGA,0307,21908.11,48060,3044,2455,1679,1403,1208,2611,4290,6745,9789,219.37,44.68,30.79,19.58
10-02-2021,FARO,461,33,756,"[480,960]",Muito Elevado,,,,461,Algarve,FARO,0805,20256.79,61015,3847,3364,2604,2055,1601,3656,6260,9624,13471,301.2,66.5,47.51,30.9
10-02-2021,FELGUEIRAS,402,29,712,"[480,960]",Muito Elevado,,,,402,Norte,PORTO,1303,11573.75,56422,2951,2302,1601,1316,973,2289,3890,6192,9143,487.49,79.0,53.5,33.61
10-02-2021,FERREIRA DO ALENTEJO,78,6,994,"[960,Max]",Extremamente Elevado,,,,78,Alentejo,BEJA,0208,64820.68,7845,515,414,372,343,345,688,1060,1474,1989,12.1,3.07,2.27,1.64
10-02-2021,FERREIRA DO ZÊZERE,121,9,1520,"[960,Max]",Extremamente Elevado,,,,121,Lisboa e Vale do Tejo,SANTARÉM,1411,19038.03,7959,470,370,416,465,456,921,1337,1707,2177,41.81,11.44,8.97,7.02
10-02-2021,FIGUEIRA DA FOZ,449,32,764,"[480,960]",Muito Elevado,,,,449,Centro,COIMBRA,0605,37905.26,58747,4032,3597,2887,2495,2043,4538,7425,11022,15054,154.98,39.72,29.08,19.59
10-02-2021,FIGUEIRA DE CASTELO RODRIGO,42,3,752,"[480,960]",Muito Elevado,,,,42,Centro,GUARDA,0904,50857.46,5584,347,352,290,352,391,743,1033,1385,1732,10.98,3.41,2.72,2.03
10-02-2021,FIGUEIRÓ DOS VINHOS,42,3,754,"[480,960]",Muito Elevado,,,,42,Centro,LEIRIA,1008,17344.0,5568,402,386,322,309,351,660,982,1368,1770,32.1,10.21,7.89,5.66
10-02-2021,FORNOS DE ALGODRES,25,2,552,"[480,960]",Muito Elevado,,,,25,Centro,GUARDA,0905,13145.05,4528,261,218,247,256,232,488,735,953,1214,34.45,9.24,7.25,5.59
10-02-2021,FREIXO DE ESPADA À CINTA,16,1,485,"[480,960]",Muito Elevado,,,,16,Norte,BRAGANÇA,0404,24414.29,3298,211,177,231,196,189,385,616,793,1004,13.51,4.11,3.25,2.52
10-02-2021,FRONTEIRA,100,7,3362,"[960,Max]",Extremamente Elevado,,,,100,Alentejo,PORTALEGRE,1208,24859.58,2974,213,182,149,156,168,324,473,655,868,11.96,3.49,2.63,1.9
10-02-2021,FUNCHAL,591,42,568,"[480,960]",Muito Elevado,,,,591,Madeira,MADEIRA,3103,7616.2,104024,6382,5086,3643,2821,1990,4811,8454,13540,19922,1365.86,261.58,177.78,111.0
10-02-2021,FUNDÃO,325,23,1227,"[960,Max]",Extremamente Elevado,,,,325,Centro,CASTELO BRANCO,0504,70019.79,26495,1781,1464,1432,1357,1643,3000,4432,5896,7677,37.84,10.96,8.42,6.33
10-02-2021,GAVIÃO,53,4,1624,"[960,Max]",Extremamente Elevado,,,,53,Alentejo,PORTALEGRE,1209,29459.45,3263,189,186,222,263,293,556,778,964,1153,11.08,3.91,3.27,2.64
10-02-2021,GÓIS,33,2,867,"[480,960]",Muito Elevado,,,,33,Centro,COIMBRA,0606,26330.19,3805,235,199,240,233,244,477,717,916,1151,14.45,4.37,3.48,2.72
10-02-2021,GOLEGÃ,29,2,543,"[480,960]",Muito Elevado,,,,29,Lisboa e Vale do Tejo,SANTARÉM,1412,8431.67,5339,356,299,281,243,255,498,779,1078,1434,63.32,17.01,12.78,9.24
10-02-2021,GONDOMAR,954,68,575,"[480,960]",Muito Elevado,,,,954,Norte,PORTO,1304,13191.76,165985,10555,8755,6222,4450,3364,7814,14036,22791,33346,1258.22,252.77,172.76,106.4
10-02-2021,GOUVEIA,84,6,678,"[480,960]",Muito Elevado,,,,84,Centro,GUARDA,0906,30061.17,12387,871,931,780,783,810,1593,2373,3304,4175,41.21,13.89,10.99,7.89
10-02-2021,GRÂNDOLA,275,20,1879,"[960,Max]",Extremamente Elevado,,,,275,Alentejo,SETÚBAL,1505,82593.66,14639,834,834,708,688,672,1360,2068,2902,3736,17.72,4.52,3.51,2.5
10-02-2021,GUARDA,308,22,790,"[480,960]",Muito Elevado,,,,308,Centro,GUARDA,0907,71209.58,38969,2477,2041,1686,1415,1474,2889,4575,6616,9093,54.72,12.77,9.29,6.42
10-02-2021,GUIMARÃES,1048,75,688,"[480,960]",Muito Elevado,,,,1048,Norte,BRAGA,0308,24099.96,152309,9394,7074,4809,3877,2948,6825,11634,18708,28102,631.99,116.61,77.63,48.27
10-02-2021,HORTA,17,1,117,"[0,240]",Moderado,,,,17,Açores,AÇORES,4701,17305.53,14521,818,658,468,352,302,654,1122,1780,2598,83.91,15.01,10.29,6.48
10-02-2021,IDANHA-A-NOVA,34,2,423,"[240,480]",Elevado,,,,34,Centro,CASTELO BRANCO,0505,141633.51,8043,518,490,519,672,974,1646,2165,2655,3173,5.68,2.24,1.87,1.53
10-02-2021,ÍLHAVO,321,23,829,"[480,960]",Muito Elevado,,,,321,Centro,AVEIRO,0110,7347.55,38699,2227,1943,1444,1193,850,2043,3487,5430,7657,526.66,104.21,73.9,47.46
10-02-2021,LAGOA (FARO),102,7,448,"[240,480]",Elevado,,,,102,Algarve,FARO,0806,8825.45,22762,1314,1168,919,749,670,1419,2338,3506,4820,257.93,54.62,39.73,26.49
10-02-2021,LAGOA,5,0,34,"[0,240]",Moderado,,,,5,Açores,AÇORES,4201,4559.32,14721,536,458,349,238,235,473,822,1280,1816,322.9,39.83,28.08,18.03
10-02-2021,LAGOS,182,13,599,"[480,960]",Muito Elevado,,,,182,Algarve,FARO,0807,21299.27,30374,1744,1434,1247,1053,1029,2082,3329,4763,6507,142.61,30.55,22.36,15.63
10-02-2021,LAJES DAS FLORES,0,0,0,"[0,240]",Moderado,,,,0,Açores,AÇORES,4801,7004.79,1463,88,53,62,46,54,100,162,215,303,20.89,4.33,3.07,2.31
10-02-2021,LAJES DO PICO,0,0,0,"[0,240]",Moderado,,,,0,Açores,AÇORES,4601,15531.09,4490,304,231,223,159,162,321,544,775,1079,28.91,6.95,4.99,3.5
10-02-2021,LAMEGO,225,16,904,"[480,960]",Muito Elevado,,,,225,Norte,VISEU,1805,16542.11,24895,1639,1284,1124,898,783,1681,2805,4089,5728,150.5,34.63,24.72,16.96
10-02-2021,LEIRIA,696,50,556,"[480,960]",Muito Elevado,,,,696,Centro,LEIRIA,1009,56508.83,125267,7389,6366,5090,3902,3159,7061,12151,18517,25906,221.68,45.84,32.77,21.5
10-02-2021,LISBOA,7393,528,1451,"[960,Max]",Extremamente Elevado,,,,7393,Lisboa e Vale do Tejo,LISBOA,1106,10005.43,509515,33197,33340,27706,23037,26770,49807,77513,110853,144050,5092.6,1439.78,1107.98,774.74
10-02-2021,LOULÉ,557,40,811,"[480,960]",Muito Elevado,,,,557,Algarve,FARO,0808,76366.91,68697,3890,3350,2780,2358,2251,4609,7389,10739,14629,89.96,19.16,14.06,9.68
10-02-2021,LOURES,3293,235,1541,"[960,Max]",Extremamente Elevado,,,,3293,Lisboa e Vale do Tejo,LISBOA,1107,16723.99,213687,12746,12794,9644,6669,5033,11702,21346,34140,46886,1277.73,280.35,204.14,127.64
10-02-2021,LOURINHÃ,254,18,982,"[960,Max]",Extremamente Elevado,,,,254,Lisboa e Vale do Tejo,LISBOA,1108,14717.2,25855,1584,1243,992,842,645,1487,2479,3722,5306,175.68,36.05,25.29,16.84
10-02-2021,LOUSÃ,176,13,1026,"[960,Max]",Extremamente Elevado,,,,176,Centro,COIMBRA,0607,13840.01,17158,946,866,658,528,450,978,1636,2502,3448,123.97,24.91,18.08,11.82
10-02-2021,LOUSADA,284,20,607,"[480,960]",Muito Elevado,,,,284,Norte,PORTO,1305,9608.01,46755,2289,1698,1176,853,621,1474,2650,4348,6637,486.63,69.08,45.25,27.58
10-02-2021,MAÇÃO,33,2,527,"[480,960]",Muito Elevado,,,,33,Lisboa e Vale do Tejo,SANTARÉM,1413,39997.98,6267,386,362,390,440,657,1097,1487,1849,2235,15.67,5.59,4.62,3.72
10-02-2021,MACEDO DE CAVALEIROS,84,6,579,"[480,960]",Muito Elevado,,,,84,Norte,BRAGANÇA,0405,69914.08,14516,1082,889,878,823,938,1761,2639,3528,4610,20.76,6.59,5.05,3.77
10-02-2021,MACHICO,107,8,536,"[480,960]",Muito Elevado,,,,107,Madeira,MADEIRA,3104,6825.1,19981,1197,860,662,455,331,786,1448,2308,3505,292.76,51.36,33.82,21.22
10-02-2021,MADALENA,7,1,119,"[0,240]",Moderado,,,,7,Açores,AÇORES,4602,14712.33,5895,334,256,173,190,179,369,542,798,1132,40.07,7.69,5.42,3.68
10-02-2021,MAFRA,1329,95,1567,"[960,Max]",Extremamente Elevado,,,,1329,Lisboa e Vale do Tejo,LISBOA,1109,29165.5,84816,3613,3334,2839,2089,1899,3988,6827,10161,13774,290.81,47.23,34.84,23.41
10-02-2021,MAIA,636,45,458,"[240,480]",Elevado,,,,636,Norte,PORTO,1306,8293.94,138971,7801,6617,4512,3339,2631,5970,10482,17099,24900,1675.56,300.22,206.16,126.38
10-02-2021,MANGUALDE,148,11,800,"[480,960]",Muito Elevado,,,,148,Centro,VISEU,1806,21925.56,18510,1198,1128,885,852,743,1595,2480,3608,4806,84.42,21.92,16.46,11.31
10-02-2021,MANTEIGAS,51,4,1696,"[960,Max]",Extremamente Elevado,,,,51,Centro,GUARDA,0908,12197.55,3007,258,197,159,167,146,313,472,669,927,24.65,7.6,5.48,3.87
10-02-2021,MARCO DE CANAVESES,242,17,470,"[240,480]",Elevado,,,,242,Norte,PORTO,1307,20188.98,51496,2678,2060,1488,1265,1023,2288,3776,5836,8514,255.07,42.17,28.91,18.7
10-02-2021,MARINHA GRANDE,190,14,493,"[480,960]",Muito Elevado,,,,190,Centro,LEIRIA,1010,18725.19,38508,2365,2302,1638,1359,1058,2417,4055,6357,8722,205.65,46.58,33.95,21.66
10-02-2021,MARVÃO,10,1,333,"[240,480]",Elevado,,,,10,Alentejo,PORTALEGRE,1210,15489.9,3005,198,185,142,197,237,434,576,761,959,19.4,6.19,4.91,3.72
10-02-2021,MATOSINHOS,994,71,567,"[480,960]",Muito Elevado,,,,994,Norte,PORTO,1308,6241.97,175357,11850,9977,7023,5024,3884,8908,15931,25908,37758,2809.31,604.9,415.06,255.22
10-02-2021,MEALHADA,258,18,1296,"[960,Max]",Extremamente Elevado,,,,258,Centro,AVEIRO,0111,11065.66,19914,1163,1039,810,828,831,1659,2469,3508,4671,179.96,42.21,31.7,22.31
10-02-2021,MÊDA,45,3,981,"[960,Max]",Extremamente Elevado,,,,45,Centro,GUARDA,0909,28604.92,4587,343,306,290,288,443,731,1021,1327,1670,16.04,5.84,4.64,3.57
10-02-2021,MELGAÇO,93,7,1149,"[960,Max]",Extremamente Elevado,,,,93,Norte,VIANA DO CASTELO,1603,23824.58,8093,507,567,578,614,675,1289,1867,2434,2941,33.97,12.34,10.22,7.84
10-02-2021,MÉRTOLA,82,6,1335,"[960,Max]",Extremamente Elevado,,,,82,Alentejo,BEJA,0209,129287.34,6142,400,390,378,423,600,1023,1401,1791,2191,4.75,1.69,1.39,1.08
10-02-2021,MESÃO FRIO,33,2,832,"[480,960]",Muito Elevado,,,,33,Norte,VILA REAL,1704,2664.87,3964,265,205,168,157,120,277,445,650,915,148.74,34.33,24.39,16.7
10-02-2021,MIRA,86,6,727,"[480,960]",Muito Elevado,,,,86,Centro,COIMBRA,0608,12403.38,11832,727,729,659,550,466,1016,1675,2404,3131,95.4,25.24,19.38,13.5
10-02-2021,MIRANDA DO CORVO,136,10,1070,"[960,Max]",Extremamente Elevado,,,,136,Centro,COIMBRA,0609,12637.79,12708,706,659,568,498,404,902,1470,2129,2835,100.55,22.43,16.85,11.63
10-02-2021,MIRANDA DO DOURO,45,3,659,"[480,960]",Muito Elevado,,,,45,Norte,BRAGANÇA,0406,48718.31,6830,482,429,442,463,470,933,1375,1804,2286,14.02,4.69,3.7,2.82
10-02-2021,MIRANDELA,268,19,1232,"[960,Max]",Extremamente Elevado,,,,268,Norte,BRAGANÇA,0407,65895.67,21754,1640,1315,1204,1078,947,2025,3229,4544,6184,33.01,9.38,6.9,4.9
10-02-2021,MOGADOURO,54,4,643,"[480,960]",Muito Elevado,,,,54,Norte,BRAGANÇA,0408,76064.93,8392,589,529,576,630,655,1285,1861,2390,2979,11.03,3.92,3.14,2.45
10-02-2021,MOIMENTA DA BEIRA,164,12,1684,"[960,Max]",Extremamente Elevado,,,,164,Norte,VISEU,1807,21996.9,9736,576,514,471,416,461,877,1348,1862,2438,44.26,11.08,8.46,6.13
10-02-2021,MOITA,1072,77,1664,"[960,Max]",Extremamente Elevado,,,,1072,Lisboa e Vale do Tejo,SETÚBAL,1506,5525.98,64407,4226,3646,2623,1801,1425,3226,5849,9495,13721,1165.53,248.3,171.82,105.85
10-02-2021,MONÇÃO,180,13,1007,"[960,Max]",Extremamente Elevado,,,,180,Norte,VIANA DO CASTELO,1604,21130.85,17869,1161,1105,1031,1006,972,1978,3009,4114,5275,84.56,24.96,19.47,14.24
10-02-2021,MONCHIQUE,106,8,2088,"[960,Max]",Extremamente Elevado,,,,106,Algarve,FARO,0809,39530.43,5077,353,384,321,355,392,747,1068,1452,1805,12.84,4.57,3.67,2.7
10-02-2021,MONDIM DE BASTO,37,3,533,"[480,960]",Muito Elevado,,,,37,Norte,VILA REAL,1705,17207.52,6946,395,300,314,284,283,567,881,1181,1576,40.36,9.16,6.86,5.12
10-02-2021,MONFORTE,12,1,403,"[240,480]",Elevado,,,,12,Alentejo,PORTALEGRE,1211,42024.82,2975,139,115,117,192,168,360,477,592,731,7.08,1.74,1.41,1.14
10-02-2021,MONTALEGRE,60,4,667,"[480,960]",Muito Elevado,,,,60,Norte,VILA REAL,1706,80545.71,8997,699,628,595,603,730,1333,1928,2556,3255,11.17,4.04,3.17,2.39
10-02-2021,MONTEMOR-O-NOVO,91,7,582,"[480,960]",Muito Elevado,,,,91,Alentejo,ÉVORA,0706,123296.65,15647,991,953,868,878,971,1849,2717,3670,4661,12.69,3.78,2.98,2.2
10-02-2021,MONTEMOR-O-VELHO,365,26,1447,"[960,Max]",Extremamente Elevado,,,,365,Centro,COIMBRA,0610,22896.23,25224,1496,1397,1217,1057,988,2045,3262,4659,6155,110.17,26.88,20.35,14.25
10-02-2021,MONTIJO,648,46,1125,"[960,Max]",Extremamente Elevado,,,,648,Lisboa e Vale do Tejo,SETÚBAL,1507,34861.64,57614,2771,2441,1990,1554,1109,2663,4653,7094,9865,165.26,28.3,20.35,13.35
10-02-2021,MORA,13,1,314,"[240,480]",Elevado,,,,13,Alentejo,ÉVORA,0707,44395.02,4138,336,275,252,238,257,495,747,1022,1358,9.32,3.06,2.3,1.68
10-02-2021,MORTÁGUA,47,3,534,"[480,960]",Muito Elevado,,,,47,Centro,VISEU,1808,25117.82,8803,638,584,535,499,460,959,1494,2078,2716,35.05,10.81,8.27,5.95
10-02-2021,MOURA,275,20,2005,"[960,Max]",Extremamente Elevado,,,,275,Alentejo,BEJA,0210,95845.55,13718,817,656,665,542,461,1003,1668,2324,3141,14.31,3.28,2.42,1.74
10-02-2021,MOURÃO,6,0,245,"[240,480]",Elevado,,,,6,Alentejo,ÉVORA,0708,27862.98,2450,139,108,80,104,109,213,293,401,540,8.79,1.94,1.44,1.05
10-02-2021,MURÇA,45,3,824,"[480,960]",Muito Elevado,,,,45,Norte,VILA REAL,1707,18937.11,5463,384,341,307,306,319,625,932,1273,1657,28.85,8.75,6.72,4.92
10-02-2021,MURTOSA,93,7,905,"[480,960]",Muito Elevado,,,,93,Centro,AVEIRO,0112,7308.78,10279,509,473,403,353,409,762,1165,1638,2147,140.63,29.37,22.41,15.94
10-02-2021,NAZARÉ,106,8,748,"[480,960]",Muito Elevado,,,,106,Lisboa e Vale do Tejo,LEIRIA,1011,8243.43,14165,967,903,670,420,396,816,1486,2389,3356,171.84,40.71,28.98,18.03
10-02-2021,NELAS,98,7,755,"[480,960]",Muito Elevado,,,,98,Centro,VISEU,1809,12571.48,12974,924,787,668,604,583,1187,1855,2642,3566,103.21,28.37,21.02,14.76
10-02-2021,NISA,19,1,313,"[240,480]",Elevado,,,,19,Alentejo,PORTALEGRE,1212,57567.84,6061,405,389,355,483,478,961,1316,1705,2110,10.53,3.67,2.96,2.29
10-02-2021,NORDESTE,4,0,82,"[0,240]",Moderado,,,,4,Açores,AÇORES,4202,10146.8,4862,246,180,124,161,162,323,447,627,873,47.92,8.6,6.18,4.41
10-02-2021,ÓBIDOS,92,7,776,"[480,960]",Muito Elevado,,,,92,Lisboa e Vale do Tejo,LEIRIA,1012,14155.44,11850,743,650,574,452,436,888,1462,2112,2855,83.72,20.17,14.92,10.33
10-02-2021,ODEMIRA,155,11,627,"[480,960]",Muito Elevado,,,,155,Alentejo,BEJA,0211,172060.15,24717,1475,1317,1225,1397,1349,2746,3971,5288,6763,14.37,3.93,3.07,2.31
10-02-2021,ODIVELAS,2846,203,1759,"[960,Max]",Extremamente Elevado,,,,2846,Lisboa e Vale do Tejo,LISBOA,1116,2654.36,161774,9562,9038,6952,4641,3812,8453,15405,24443,34005,6095.48,1281.27,920.99,580.44
10-02-2021,OEIRAS,2643,189,1490,"[960,Max]",Extremamente Elevado,,,,2643,Lisboa e Vale do Tejo,LISBOA,1110,4588.31,177408,11580,11575,8566,6211,5855,12066,20632,32207,43787,3866.78,954.38,701.98,449.69
10-02-2021,OLEIROS,32,2,640,"[480,960]",Muito Elevado,,,,32,Centro,CASTELO BRANCO,0506,47109.31,5003,384,341,366,397,487,884,1250,1591,1975,10.62,4.19,3.38,2.65
10-02-2021,OLHÃO,279,20,628,"[480,960]",Muito Elevado,,,,279,Algarve,FARO,0810,13086.38,44405,2455,2309,1689,1342,1268,2610,4299,6608,9063,339.33,69.26,50.5,32.85
10-02-2021,OLIVEIRA DE AZEMÉIS,630,45,954,"[480,960]",Muito Elevado,,,,630,Norte,AVEIRO,0113,16110.41,66011,4155,3614,2794,2183,1738,3921,6715,10329,14484,409.75,89.91,64.12,41.68
10-02-2021,OLIVEIRA DE FRADES,142,10,1429,"[960,Max]",Extremamente Elevado,,,,142,Centro,VISEU,1810,14534.62,9936,553,475,438,359,415,774,1212,1687,2240,68.36,15.41,11.61,8.34
10-02-2021,OLIVEIRA DO BAIRRO,167,12,688,"[480,960]",Muito Elevado,,,,167,Centro,AVEIRO,0114,8731.99,24277,1327,1182,999,786,810,1596,2595,3777,5104,278.02,58.45,43.25,29.72
10-02-2021,OLIVEIRA DO HOSPITAL,201,14,1044,"[960,Max]",Extremamente Elevado,,,,201,Centro,COIMBRA,0611,23451.66,19253,1161,1097,962,924,960,1884,2846,3943,5104,82.1,21.76,16.81,12.14
10-02-2021,OURÉM,362,26,822,"[480,960]",Muito Elevado,,,,362,Lisboa e Vale do Tejo,SANTARÉM,1421,41668.03,44044,2463,2069,1899,1817,1603,3420,5319,7388,9851,105.7,23.64,17.73,12.77
10-02-2021,OURIQUE,40,3,868,"[480,960]",Muito Elevado,,,,40,Alentejo,BEJA,0212,66331.36,4607,313,287,284,268,227,495,779,1066,1379,6.95,2.08,1.61,1.17
10-02-2021,OVAR,514,37,947,"[480,960]",Muito Elevado,,,,514,Centro,AVEIRO,0115,14770.25,54260,3294,2709,1994,1636,1234,2870,4864,7573,10867,367.37,73.57,51.27,32.93
10-02-2021,PAÇOS DE FERREIRA,252,18,444,"[240,480]",Elevado,,,,252,Norte,PORTO,1309,7099.29,56728,2903,2193,1518,1135,664,1799,3317,5510,8413,799.1,118.51,77.62,46.72
10-02-2021,PALMELA,1089,78,1694,"[960,Max]",Extremamente Elevado,,,,1089,Lisboa e Vale do Tejo,SETÚBAL,1508,46512.01,64269,3402,3244,2635,1846,1391,3237,5872,9116,12518,138.18,26.91,19.6,12.62
10-02-2021,PAMPILHOSA DA SERRA,36,3,892,"[480,960]",Muito Elevado,,,,36,Centro,COIMBRA,0612,39646.24,4037,238,254,295,339,423,762,1057,1311,1549,10.18,3.91,3.31,2.67
10-02-2021,PAREDES,400,29,465,"[240,480]",Elevado,,,,400,Norte,PORTO,1310,15675.69,86067,4272,3532,2412,1717,1258,2975,5387,8919,13191,549.04,84.15,56.9,34.36
10-02-2021,PAREDES DE COURA,116,8,1359,"[960,Max]",Extremamente Elevado,,,,116,Norte,VIANA DO CASTELO,1605,13818.59,8535,466,528,407,465,515,980,1387,1915,2381,61.76,17.23,13.86,10.04
10-02-2021,PEDRÓGÃO GRANDE,39,3,1144,"[960,Max]",Extremamente Elevado,,,,39,Centro,LEIRIA,1013,12874.75,3410,175,173,196,221,252,473,669,842,1017,26.49,7.9,6.54,5.2
10-02-2021,PENACOVA,178,13,1300,"[960,Max]",Extremamente Elevado,,,,178,Centro,COIMBRA,0613,21673.23,13694,968,923,745,621,703,1324,2069,2992,3960,63.18,18.27,13.81,9.55
10-02-2021,PENAFIEL,333,24,477,"[240,480]",Elevado,,,,333,Norte,PORTO,1311,21224.27,69772,3648,2823,2032,1663,1230,2893,4925,7748,11396,328.74,53.69,36.51,23.2
10-02-2021,PENALVA DO CASTELO,41,3,576,"[480,960]",Muito Elevado,,,,41,Centro,VISEU,1811,13433.92,7115,449,457,413,391,426,817,1230,1687,2136,52.96,15.9,12.56,9.16
10-02-2021,PENAMACOR,29,2,610,"[480,960]",Muito Elevado,,,,29,Centro,CASTELO BRANCO,0507,56370.69,4755,262,248,273,451,633,1084,1357,1605,1867,8.44,3.31,2.85,2.41
10-02-2021,PENEDONO,43,3,1660,"[960,Max]",Extremamente Elevado,,,,43,Norte,VISEU,1812,13370.75,2591,172,113,129,156,138,294,423,536,708,19.38,5.3,4.01,3.16
10-02-2021,PENELA,112,8,2075,"[960,Max]",Extremamente Elevado,,,,112,Centro,COIMBRA,0614,13480.0,5397,314,324,274,359,344,703,977,1301,1615,40.04,11.98,9.65,7.25
10-02-2021,PENICHE,326,23,1230,"[960,Max]",Extremamente Elevado,,,,326,Lisboa e Vale do Tejo,LEIRIA,1014,7754.98,26501,1746,1504,1203,926,707,1633,2836,4340,6086,341.73,78.48,55.96,36.57
10-02-2021,PESO DA RÉGUA,118,8,748,"[480,960]",Muito Elevado,,,,118,Norte,VILA REAL,1708,9486.01,15773,1076,843,650,659,455,1114,1764,2607,3683,166.28,38.83,27.48,18.6
10-02-2021,PINHEL,97,7,1140,"[960,Max]",Extremamente Elevado,,,,97,Centro,GUARDA,0910,48452.12,8511,577,566,551,538,689,1227,1778,2344,2921,17.57,6.03,4.84,3.67
10-02-2021,POMBAL,450,32,874,"[480,960]",Muito Elevado,,,,450,Centro,LEIRIA,1015,62600.28,51461,3187,2791,2494,2328,2027,4355,6849,9640,12827,82.21,20.49,15.4,10.94
10-02-2021,PONTA DELGADA,43,3,63,"[0,240]",Moderado,,,,43,Açores,AÇORES,4203,23298.65,67935,3108,2435,1726,1133,902,2035,3761,6196,9304,291.58,39.93,26.59,16.14
10-02-2021,PONTA DO SOL,41,3,477,"[240,480]",Elevado,,,,41,Madeira,MADEIRA,3105,4622.03,8593,319,283,347,208,221,429,776,1059,1378,185.92,29.81,22.91,16.79
10-02-2021,PONTE DA BARCA,120,9,1073,"[960,Max]",Extremamente Elevado,,,,120,Norte,VIANA DO CASTELO,1606,18211.37,11180,635,576,517,554,490,1044,1561,2137,2772,61.39,15.22,11.73,8.57
10-02-2021,PONTE DE LIMA,530,38,1283,"[960,Max]",Extremamente Elevado,,,,530,Norte,VIANA DO CASTELO,1607,32025.46,41315,2321,2022,1720,1596,1462,3058,4778,6800,9121,129.01,28.48,21.23,14.92
10-02-2021,PONTE DE SOR,69,5,460,"[240,480]",Elevado,,,,69,Alentejo,PORTALEGRE,1213,83971.16,14994,939,800,716,739,831,1570,2286,3086,4025,17.86,4.79,3.68,2.72
10-02-2021,PORTALEGRE,79,6,356,"[240,480]",Elevado,,,,79,Alentejo,PORTALEGRE,1214,44713.64,22172,1577,1351,1137,993,984,1977,3114,4465,6042,49.59,13.51,9.99,6.96
10-02-2021,PORTEL,23,2,395,"[240,480]",Elevado,,,,23,Alentejo,ÉVORA,0709,60100.57,5828,336,358,283,331,305,636,919,1277,1613,9.7,2.68,2.12,1.53
10-02-2021,PORTIMÃO,293,21,528,"[480,960]",Muito Elevado,,,,293,Algarve,FARO,0811,18206.29,55483,3182,2927,2116,1582,1400,2982,5098,8025,11207,304.75,61.56,44.08,28.0
10-02-2021,PORTO,1083,77,500,"[480,960]",Muito Elevado,,,,1083,Norte,PORTO,1312,4142.02,216606,15790,15193,11280,9409,10044,19453,30733,45926,61716,5229.5,1490.0,1108.79,741.98
10-02-2021,PORTO DE MÓS,162,12,696,"[480,960]",Muito Elevado,,,,162,Centro,LEIRIA,1016,26183.41,23275,1355,1210,1034,888,872,1760,2794,4004,5359,88.89,20.47,15.29,10.67
10-02-2021,PORTO MONIZ,4,0,171,"[0,240]",Moderado,,,,4,Madeira,MADEIRA,3106,8293.38,2342,143,130,95,98,120,218,313,443,586,28.24,7.07,5.34,3.77
10-02-2021,PORTO SANTO,9,1,173,"[0,240]",Moderado,,,,9,Madeira,MADEIRA,3201,4300.7,5202,240,157,134,110,68,178,312,469,709,120.95,16.48,10.9,7.25
10-02-2021,PÓVOA DE LANHOSO,168,12,781,"[480,960]",Muito Elevado,,,,168,Norte,BRAGA,0309,13465.29,21499,1175,909,732,673,624,1297,2029,2938,4113,159.67,30.55,21.82,15.07
10-02-2021,PÓVOA DE VARZIM,658,47,1048,"[960,Max]",Extremamente Elevado,,,,658,Norte,PORTO,1313,8220.59,62784,3712,3120,2134,1594,1305,2899,5033,8153,11865,763.7,144.33,99.17,61.22
10-02-2021,POVOAÇÃO,3,0,51,"[0,240]",Moderado,,,,3,Açores,AÇORES,4204,10640.77,5927,293,212,191,144,134,278,469,681,974,55.7,9.15,6.4,4.41
10-02-2021,VILA DA PRAIA DA VITÓRIA,15,1,70,"[0,240]",Moderado,,,,15,Açores,AÇORES,4302,16127.06,21317,1133,789,619,436,336,772,1391,2180,3313,132.18,20.54,13.52,8.63
10-02-2021,PROENÇA-A-NOVA,19,1,260,"[240,480]",Elevado,,,,19,Centro,CASTELO BRANCO,0508,39539.96,7298,508,465,389,400,560,960,1349,1814,2322,18.46,5.87,4.59,3.41
10-02-2021,REDONDO,45,3,708,"[480,960]",Muito Elevado,,,,45,Alentejo,ÉVORA,0710,36950.87,6353,349,325,288,288,354,642,930,1255,1604,17.19,4.34,3.4,2.52
10-02-2021,REGUENGOS DE MONSARAZ,87,6,869,"[480,960]",Muito Elevado,,,,87,Alentejo,ÉVORA,0711,46399.72,10015,602,511,455,462,473,935,1390,1901,2503,21.58,5.39,4.1,3.0
10-02-2021,RESENDE,253,18,2496,"[960,Max]",Extremamente Elevado,,,,253,Norte,VISEU,1813,12334.93,10137,560,493,448,433,422,855,1303,1796,2356,82.18,19.1,14.56,10.56
10-02-2021,RIBEIRA BRAVA,42,3,338,"[240,480]",Elevado,,,,42,Madeira,MADEIRA,3107,6544.88,12435,648,500,411,311,287,598,1009,1509,2157,189.99,32.96,23.06,15.42
10-02-2021,RIBEIRA DE PENA,66,5,1097,"[960,Max]",Extremamente Elevado,,,,66,Norte,VILA REAL,1709,21745.98,6016,371,301,290,310,368,678,968,1269,1640,27.66,7.54,5.84,4.45
10-02-2021,RIBEIRA GRANDE,187,13,570,"[480,960]",Muito Elevado,,,,187,Açores,AÇORES,4205,18015.13,32811,1163,689,512,345,253,598,1110,1799,2962,182.13,16.44,9.99,6.16
10-02-2021,RIO MAIOR,535,38,2625,"[960,Max]",Extremamente Elevado,,,,535,Lisboa e Vale do Tejo,SANTARÉM,1414,27276.45,20379,1251,1144,941,795,648,1443,2384,3528,4779,74.71,17.52,12.93,8.74
10-02-2021,SABROSA,42,3,710,"[480,960]",Muito Elevado,,,,42,Norte,VILA REAL,1710,15692.45,5918,393,314,304,302,350,652,956,1270,1663,37.71,10.6,8.09,6.09
10-02-2021,SABUGAL,215,15,2031,"[960,Max]",Extremamente Elevado,,,,215,Centro,GUARDA,0911,82269.82,10585,724,707,694,796,1009,1805,2499,3206,3930,12.87,4.78,3.9,3.04
10-02-2021,SALVATERRA DE MAGOS,302,22,1418,"[960,Max]",Extremamente Elevado,,,,302,Lisboa e Vale do Tejo,SANTARÉM,1415,24393.2,21295,1275,1181,1060,799,772,1571,2631,3812,5087,87.3,20.85,15.63,10.79
10-02-2021,SANTA COMBA DÃO,114,8,1091,"[960,Max]",Extremamente Elevado,,,,114,Centro,VISEU,1814,11194.77,10452,732,684,569,538,464,1002,1571,2255,2987,93.36,26.68,20.14,14.03
10-02-2021,SANTA CRUZ,300,21,663,"[480,960]",Muito Elevado,,,,300,Madeira,MADEIRA,3108,8150.28,45281,1817,1301,974,716,523,1239,2213,3514,5331,555.6,65.41,43.12,27.15
10-02-2021,SANTA CRUZ DA GRACIOSA,1,0,24,"[0,240]",Moderado,,,,1,Açores,AÇORES,4401,6065.78,4208,228,180,163,124,145,269,432,612,840,69.37,13.85,10.09,7.12
10-02-2021,SANTA CRUZ DAS FLORES,1,0,46,"[0,240]",Moderado,,,,1,Açores,AÇORES,4802,7091.44,2165,125,98,74,56,51,107,181,279,404,30.53,5.7,3.93,2.55
10-02-2021,SANTA MARIA DA FEIRA,1239,89,894,"[480,960]",Muito Elevado,,,,1239,Norte,AVEIRO,0109,21587.65,138636,8182,6743,4771,3856,3079,6935,11706,18449,26631,642.19,123.36,85.46,54.22
10-02-2021,SANTA MARTA DE PENAGUIÃO,28,2,424,"[240,480]",Elevado,,,,28,Norte,VILA REAL,1711,6928.13,6599,483,373,337,316,317,633,970,1343,1826,95.25,26.36,19.39,14.0
10-02-2021,SANTANA,10,1,149,"[0,240]",Moderado,,,,10,Madeira,MADEIRA,3109,9547.3,6711,418,353,343,282,277,559,902,1255,1673,70.29,17.52,13.15,9.45
10-02-2021,SANTARÉM,686,49,1195,"[960,Max]",Extremamente Elevado,,,,686,Lisboa e Vale do Tejo,SANTARÉM,1416,55253.58,57421,3654,3441,2760,2466,2206,4672,7432,10873,14527,103.92,26.29,19.68,13.45
10-02-2021,SANTIAGO DO CACÉM,206,15,716,"[480,960]",Muito Elevado,,,,206,Alentejo,SETÚBAL,1509,105969.29,28791,2144,1689,1472,1295,1215,2510,3982,5671,7815,27.17,7.37,5.35,3.76
10-02-2021,SANTO TIRSO,498,36,732,"[480,960]",Muito Elevado,,,,498,Norte,PORTO,1314,13655.52,68055,4911,3935,2761,2257,1810,4067,6828,10763,15674,498.35,114.78,78.82,50.0
10-02-2021,SÃO BRÁS DE ALPORTEL,49,3,470,"[240,480]",Elevado,,,,49,Algarve,FARO,0812,15336.92,10416,596,468,467,404,401,805,1272,1740,2336,67.91,15.23,11.35,8.29
10-02-2021,SÃO JOÃO DA MADEIRA,216,15,984,"[960,Max]",Extremamente Elevado,,,,216,Norte,AVEIRO,0116,794.3,21958,1347,1069,796,601,593,1194,1990,3059,4406,2765.49,554.91,385.26,250.63
10-02-2021,SÃO JOÃO DA PESQUEIRA,216,15,3032,"[960,Max]",Extremamente Elevado,,,,216,Norte,VISEU,1815,26610.85,7125,417,330,294,328,328,656,950,1280,1697,26.77,6.38,4.81,3.57
10-02-2021,SÃO PEDRO DO SUL,203,15,1318,"[960,Max]",Extremamente Elevado,,,,203,Centro,VISEU,1816,34895.09,15403,990,962,861,759,909,1668,2529,3491,4481,44.14,12.84,10.0,7.25
10-02-2021,SÃO ROQUE DO PICO,0,0,0,"[0,240]",Moderado,,,,0,Açores,AÇORES,4603,14236.1,3266,199,141,93,96,113,209,302,443,642,22.94,4.51,3.11,2.12
10-02-2021,SÃO VICENTE,3,0,58,"[0,240]",Moderado,,,,3,Madeira,MADEIRA,3110,7883.71,5143,272,264,266,225,280,505,771,1035,1307,65.23,16.58,13.13,9.78
10-02-2021,SARDOAL,14,1,374,"[240,480]",Elevado,,,,14,Lisboa e Vale do Tejo,SANTARÉM,1417,9214.72,3741,227,178,148,165,248,413,561,739,966,40.6,10.48,8.02,6.09
10-02-2021,SÁTÃO,174,12,1503,"[960,Max]",Extremamente Elevado,,,,174,Centro,VISEU,1817,20194.11,11580,765,671,515,465,476,941,1456,2127,2892,57.34,14.32,10.53,7.21
10-02-2021,SEIA,263,19,1183,"[960,Max]",Extremamente Elevado,,,,263,Centro,GUARDA,0912,43568.83,22234,1807,1589,1238,1122,721,1843,3081,4670,6477,51.03,14.87,10.72,7.07
10-02-2021,SEIXAL,2469,176,1472,"[960,Max]",Extremamente Elevado,,,,2469,Lisboa e Vale do Tejo,SETÚBAL,1510,9545.17,167752,10586,9270,6661,4391,2930,7321,13982,23252,33838,1757.49,354.51,243.6,146.49
10-02-2021,SERNANCELHE,93,7,1723,"[960,Max]",Extremamente Elevado,,,,93,Norte,VISEU,1818,22861.22,5396,305,293,286,273,260,533,819,1112,1417,23.6,6.2,4.86,3.58
10-02-2021,SERPA,154,11,1077,"[960,Max]",Extremamente Elevado,,,,154,Alentejo,BEJA,0213,110563.34,14304,903,761,719,697,626,1323,2042,2803,3706,12.94,3.35,2.54,1.85
10-02-2021,SERTÃ,82,6,563,"[480,960]",Muito Elevado,,,,82,Centro,CASTELO BRANCO,0509,44673.17,14577,870,779,790,767,1020,1787,2577,3356,4226,32.63,9.46,7.51,5.77
10-02-2021,SESIMBRA,901,64,1737,"[960,Max]",Extremamente Elevado,,,,901,Lisboa e Vale do Tejo,SETÚBAL,1511,19571.75,51858,2400,2321,1853,1257,1083,2340,4193,6514,8914,264.96,45.54,33.28,21.42
10-02-2021,SETÚBAL,2618,187,2274,"[960,Max]",Extremamente Elevado,,,,2618,Lisboa e Vale do Tejo,SETÚBAL,1512,23032.5,115126,7425,6929,5075,3775,2655,6430,11505,18434,25859,499.83,112.27,80.03,49.95
10-02-2021,SEVER DO VOUGA,131,9,1156,"[960,Max]",Extremamente Elevado,,,,131,Centro,AVEIRO,0117,12987.56,11331,766,637,568,540,567,1107,1675,2312,3078,87.24,23.7,17.8,12.9
10-02-2021,SILVES,228,16,629,"[480,960]",Muito Elevado,,,,228,Algarve,FARO,0813,68006.23,36226,2137,1869,1610,1423,1600,3023,4633,6502,8639,53.27,12.7,9.56,6.81
10-02-2021,SINES,86,6,627,"[480,960]",Muito Elevado,,,,86,Alentejo,SETÚBAL,1513,20330.17,13715,888,791,551,416,268,684,1235,2026,2914,67.46,14.33,9.97,6.07
10-02-2021,SINTRA,6838,488,1747,"[960,Max]",Extremamente Elevado,,,,6838,Lisboa e Vale do Tejo,LISBOA,1111,31922.73,391402,20490,18316,13545,9137,7284,16421,29966,48282,68772,1226.08,215.43,151.25,93.87
10-02-2021,SOBRAL DE MONTE AGRAÇO,130,9,1221,"[960,Max]",Extremamente Elevado,,,,130,Lisboa e Vale do Tejo,LISBOA,1112,5210.32,10651,564,507,352,272,212,484,836,1343,1907,204.43,36.6,25.78,16.05
10-02-2021,SOURE,185,13,1081,"[960,Max]",Extremamente Elevado,,,,185,Centro,COIMBRA,0615,26506.07,17120,1173,1142,1004,883,987,1870,2874,4016,5189,64.59,19.58,15.15,10.84
10-02-2021,SOUSEL,42,3,952,"[480,960]",Muito Elevado,,,,42,Alentejo,PORTALEGRE,1215,27932.18,4412,261,274,208,302,292,594,802,1076,1337,15.8,4.79,3.85,2.87
10-02-2021,TÁBUA,137,10,1205,"[960,Max]",Extremamente Elevado,,,,137,Centro,COIMBRA,0616,19978.58,11368,729,584,524,430,464,894,1418,2002,2731,56.9,13.67,10.02,7.1
10-02-2021,TABUAÇO,33,2,547,"[480,960]",Muito Elevado,,,,33,Norte,VISEU,1819,13385.67,6033,372,314,217,282,363,645,862,1176,1548,45.07,11.56,8.79,6.44
10-02-2021,TAROUCA,117,8,1499,"[960,Max]",Extremamente Elevado,,,,117,Norte,VISEU,1820,10008.49,7804,405,335,313,277,324,601,914,1249,1654,77.98,16.53,12.48,9.13
10-02-2021,TAVIRA,99,7,404,"[240,480]",Elevado,,,,99,Algarve,FARO,0814,60696.7,24530,1493,1415,1252,1066,1277,2343,3595,5010,6503,40.41,10.71,8.25,5.92
10-02-2021,TERRAS DE BOURO,41,3,645,"[480,960]",Muito Elevado,,,,41,Norte,BRAGA,0310,27746.07,6361,391,372,296,319,340,659,955,1327,1718,22.93,6.19,4.78,3.44
10-02-2021,TOMAR,372,27,1012,"[960,Max]",Extremamente Elevado,,,,372,Lisboa e Vale do Tejo,SANTARÉM,1418,35120.44,36748,2403,2189,1868,1853,1822,3675,5543,7732,10135,104.64,28.86,22.02,15.78
10-02-2021,TONDELA,322,23,1222,"[960,Max]",Extremamente Elevado,,,,322,Centro,VISEU,1821,37121.73,26357,1768,1722,1518,1475,1417,2892,4410,6132,7900,71.0,21.28,16.52,11.88
10-02-2021,TORRE DE MONCORVO,26,2,338,"[240,480]",Elevado,,,,26,Norte,BRAGANÇA,0409,53155.67,7695,556,478,488,551,719,1270,1758,2236,2792,14.48,5.25,4.21,3.31
10-02-2021,TORRES NOVAS,179,13,512,"[480,960]",Muito Elevado,,,,179,Lisboa e Vale do Tejo,SANTARÉM,1419,26999.68,34933,2324,1979,1738,1406,1475,2881,4619,6598,8922,129.38,33.04,24.44,17.11
10-02-2021,TORRES VEDRAS,803,57,1023,"[960,Max]",Extremamente Elevado,,,,803,Lisboa e Vale do Tejo,LISBOA,1113,40714.89,78530,4513,3945,3447,2628,2104,4732,8179,12124,16637,192.88,40.86,29.78,20.09
10-02-2021,TRANCOSO,63,5,710,"[480,960]",Muito Elevado,,,,63,Centro,GUARDA,0913,36152.47,8875,581,557,542,586,496,1082,1624,2181,2762,24.55,7.64,6.03,4.49
10-02-2021,TROFA,288,21,750,"[480,960]",Muito Elevado,,,,288,Norte,PORTO,1318,7201.76,38418,2336,1894,1231,939,684,1623,2854,4748,7084,533.44,98.36,65.93,39.63
10-02-2021,VAGOS,114,8,501,"[480,960]",Muito Elevado,,,,114,Centro,AVEIRO,0118,16491.5,22740,1320,1205,922,784,724,1508,2430,3635,4955,137.89,30.04,22.04,14.73
10-02-2021,VALE DE CAMBRA,207,15,971,"[960,Max]",Extremamente Elevado,,,,207,Norte,AVEIRO,0119,14733.47,21327,1491,1363,1005,831,798,1629,2634,3997,5488,144.76,37.25,27.13,17.88
10-02-2021,VALENÇA,125,9,941,"[480,960]",Muito Elevado,,,,125,Norte,VIANA DO CASTELO,1608,11712.86,13290,867,791,582,582,503,1085,1667,2458,3325,113.46,28.39,20.99,14.23
10-02-2021,VALONGO,392,28,402,"[240,480]",Elevado,,,,392,Norte,PORTO,1315,7512.45,97444,5629,4696,3207,2462,1829,4291,7498,12194,17823,1297.18,237.26,162.33,99.81
10-02-2021,VALPAÇOS,136,10,918,"[480,960]",Muito Elevado,,,,136,Norte,VILA REAL,1712,54873.93,14818,1217,1118,999,928,997,1925,2924,4042,5259,27.0,9.58,7.37,5.33
10-02-2021,VELAS,3,0,59,"[0,240]",Moderado,,,,3,Açores,AÇORES,4502,11738.38,5093,278,208,166,153,113,266,432,640,918,43.39,7.82,5.45,3.68
10-02-2021,VENDAS NOVAS,65,5,578,"[480,960]",Muito Elevado,,,,65,Alentejo,ÉVORA,0712,22238.88,11255,677,768,655,501,532,1033,1688,2456,3133,50.61,14.09,11.04,7.59
10-02-2021,VIANA DO ALENTEJO,34,2,661,"[480,960]",Muito Elevado,,,,34,Alentejo,ÉVORA,0713,39367.29,5145,245,208,235,210,214,424,659,867,1112,13.07,2.82,2.2,1.67
10-02-2021,VIANA DO CASTELO,728,52,862,"[480,960]",Muito Elevado,,,,728,Norte,VIANA DO CASTELO,1609,31902.01,84417,5470,4433,3591,3061,2982,6043,9634,14067,19537,264.61,61.24,44.09,30.2
10-02-2021,VIDIGUEIRA,22,2,399,"[240,480]",Elevado,,,,22,Alentejo,BEJA,0214,31661.09,5510,300,248,215,233,275,508,723,971,1271,17.4,4.01,3.07,2.28
10-02-2021,VIEIRA DO MINHO,118,8,996,"[960,Max]",Extremamente Elevado,,,,118,Norte,BRAGA,0311,21644.35,11842,703,594,525,548,482,1030,1555,2149,2852,54.71,13.18,9.93,7.18
10-02-2021,VILA DE REI,78,6,2347,"[960,Max]",Extremamente Elevado,,,,78,Centro,CASTELO BRANCO,0510,19154.6,3323,169,128,172,247,302,549,721,849,1018,17.35,5.31,4.43,3.76
10-02-2021,VILA DO BISPO,11,1,213,"[0,240]",Moderado,,,,11,Algarve,FARO,0815,17906.06,5154,302,302,314,232,233,465,779,1081,1383,28.78,7.72,6.04,4.35
10-02-2021,VILA DO CONDE,697,50,872,"[480,960]",Muito Elevado,,,,697,Norte,PORTO,1316,14902.77,79899,4726,3875,2819,2070,1743,3813,6632,10507,15233,536.13,102.21,70.5,44.5
10-02-2021,VILA DO PORTO,4,0,71,"[0,240]",Moderado,,,,4,Açores,AÇORES,4101,9688.74,5616,274,212,135,96,123,219,354,566,840,57.96,8.67,5.84,3.65
10-02-2021,VILA FLOR,110,8,1820,"[960,Max]",Extremamente Elevado,,,,110,Norte,BRAGANÇA,0410,26581.14,6044,429,362,422,294,331,625,1047,1409,1838,22.74,6.91,5.3,3.94
10-02-2021,VILA FRANCA DE XIRA,2227,159,1569,"[960,Max]",Extremamente Elevado,,,,2227,Lisboa e Vale do Tejo,LISBOA,1114,31819.39,141957,8501,6852,4869,3425,2472,5897,10766,17618,26119,446.14,82.09,55.37,33.84
10-02-2021,VILA FRANCA DO CAMPO,22,2,199,"[0,240]",Moderado,,,,22,Açores,AÇORES,4206,7796.82,11051,450,344,248,217,154,371,619,963,1413,141.73,18.12,12.35,7.94
10-02-2021,VILA NOVA DA BARQUINHA,33,2,442,"[240,480]",Elevado,,,,33,Lisboa e Vale do Tejo,SANTARÉM,1420,4952.97,7461,415,406,392,364,338,702,1094,1500,1915,150.64,38.66,30.28,22.09
10-02-2021,VILA NOVA DE CERVEIRA,106,8,1190,"[960,Max]",Extremamente Elevado,,,,106,Norte,VIANA DO CASTELO,1610,10846.66,8910,531,444,410,384,334,718,1128,1572,2103,82.14,19.39,14.49,10.4
10-02-2021,VILA NOVA DE FAMALICÃO,1053,75,800,"[480,960]",Muito Elevado,,,,1053,Norte,BRAGA,0312,20159.26,131676,7817,6164,4202,3282,2749,6031,10233,16397,24214,653.19,120.12,81.34,50.76
10-02-2021,VILA NOVA DE FOZ CÔA,69,5,1061,"[960,Max]",Extremamente Elevado,,,,69,Centro,GUARDA,0914,39815.18,6503,442,385,390,398,429,827,1217,1602,2044,16.33,5.13,4.02,3.06
10-02-2021,VILA NOVA DE GAIA,1842,132,613,"[480,960]",Muito Elevado,,,,1842,Norte,PORTO,1317,16846.43,300472,18349,15568,10972,8224,6281,14505,25477,41045,59394,1783.64,352.57,243.65,151.23
10-02-2021,VILA NOVA DE PAIVA,46,3,981,"[960,Max]",Extremamente Elevado,,,,46,Centro,VISEU,1822,17553.28,4687,289,272,233,217,241,458,691,963,1252,26.7,7.13,5.49,3.94
10-02-2021,VILA NOVA DE POIARES,49,3,706,"[480,960]",Muito Elevado,,,,49,Centro,COIMBRA,0617,8445.3,6939,380,284,262,235,182,417,679,963,1343,82.17,15.9,11.4,8.04
10-02-2021,VILA POUCA DE AGUIAR,53,4,443,"[240,480]",Elevado,,,,53,Norte,VILA REAL,1713,43706.62,11961,860,817,733,601,627,1228,1961,2778,3638,27.37,8.32,6.36,4.49
10-02-2021,VILA REAL,348,25,697,"[480,960]",Muito Elevado,,,,348,Norte,VILA REAL,1714,37880.28,49962,3025,2498,2065,1579,1466,3045,5110,7608,10633,131.9,28.07,20.08,13.49
10-02-2021,VILA REAL DE SANTO ANTÓNIO,278,20,1483,"[960,Max]",Extremamente Elevado,,,,278,Algarve,FARO,0816,6125.0,18749,1172,1069,811,569,586,1155,1966,3035,4207,306.11,68.69,49.55,32.1
10-02-2021,VILA VELHA DE RÓDÃO,13,1,413,"[240,480]",Elevado,,,,13,Centro,CASTELO BRANCO,0511,32991.16,3144,209,229,180,283,306,589,769,998,1207,9.53,3.66,3.03,2.33
10-02-2021,VILA VERDE,383,27,816,"[480,960]",Muito Elevado,,,,383,Norte,BRAGA,0313,22866.52,46911,2365,2063,1667,1494,1437,2931,4598,6661,9026,205.15,39.47,29.13,20.11
10-02-2021,VILA VIÇOSA,51,4,666,"[480,960]",Muito Elevado,,,,51,Alentejo,ÉVORA,0714,19485.89,7656,487,379,342,345,324,669,1011,1390,1877,39.29,9.63,7.13,5.19
10-02-2021,VIMIOSO,10,1,249,"[240,480]",Elevado,,,,10,Norte,BRAGANÇA,0411,48158.51,4023,274,230,261,293,335,628,889,1119,1393,8.35,2.89,2.32,1.85
10-02-2021,VINHAIS,73,5,942,"[480,960]",Muito Elevado,,,,73,Norte,BRAGANÇA,0412,69475.09,7746,599,577,636,641,815,1456,2092,2669,3268,11.15,4.7,3.84,3.01
10-02-2021,VISEU,1285,92,1321,"[960,Max]",Extremamente Elevado,,,,1285,Centro,VISEU,1823,50710.14,97249,5769,5038,4140,3158,2710,5868,10008,15046,20815,191.77,41.05,29.67,19.74
10-02-2021,VIZELA,134,10,561,"[480,960]",Muito Elevado,,,,134,Norte,BRAGA,0314,2469.83,23897,1258,928,655,509,371,880,1535,2463,3721,967.49,150.65,99.72,62.15
10-02-2021,VOUZELA,101,7,1050,"[960,Max]",Extremamente Elevado,,,,101,Centro,VISEU,1824,19369.46,9619,626,605,554,532,507,1039,1593,2198,2824,49.66,14.58,11.35,8.22
17-02-2021,ABRANTES,92,7,262,"[240,480]",Elevado,,,,92,Lisboa e Vale do Tejo,SANTARÉM,1401,71469.08,35130,2473,2213,1730,1748,2021,3769,5499,7712,10185,49.15,14.25,10.79,7.69
17-02-2021,ÁGUEDA,147,10,319,"[240,480]",Elevado,,,,147,Centro,AVEIRO,0101,33527.44,46075,3237,2713,2090,1635,1496,3131,5221,7934,11171,137.43,33.32,23.66,15.57
17-02-2021,AGUIAR DA BEIRA,24,2,516,"[480,960]",Muito Elevado,,,,24,Centro,GUARDA,0901,20676.57,4652,304,281,235,239,148,387,622,903,1207,22.5,5.84,4.37,3.01
17-02-2021,ALANDROAL,31,2,621,"[480,960]",Muito Elevado,,,,31,Alentejo,ÉVORA,0701,54267.81,4992,307,256,296,299,377,676,972,1228,1535,9.2,2.83,2.26,1.79
17-02-2021,ALBERGARIA-A-VELHA,125,9,518,"[480,960]",Muito Elevado,,,,125,Centro,AVEIRO,0102,15882.5,24144,1550,1298,996,687,680,1367,2363,3661,5211,152.02,32.81,23.05,14.88
17-02-2021,ALBUFEIRA,185,13,445,"[240,480]",Elevado,,,,185,Algarve,FARO,0801,14066.42,41528,2067,1717,1425,985,858,1843,3268,4985,7052,295.24,50.14,35.44,23.23
17-02-2021,ALCÁCER DO SAL,95,7,815,"[480,960]",Muito Elevado,,,,95,Alentejo,SETÚBAL,1501,149987.3,11659,884,814,623,623,602,1225,1848,2662,3546,7.77,2.36,1.77,1.23
17-02-2021,ALCANENA,77,5,601,"[480,960]",Muito Elevado,,,,77,Lisboa e Vale do Tejo,SANTARÉM,1402,12732.86,12809,891,744,628,536,588,1124,1752,2496,3387,100.6,26.6,19.6,13.76
17-02-2021,ALCOBAÇA,207,15,387,"[240,480]",Elevado,,,,207,Lisboa e Vale do Tejo,LEIRIA,1001,40814.09,53555,3420,2927,2466,2059,1676,3735,6201,9128,12548,131.22,30.74,22.36,15.19
17-02-2021,ALCOCHETE,115,8,581,"[480,960]",Muito Elevado,,,,115,Lisboa e Vale do Tejo,SETÚBAL,1502,12836.48,19787,857,834,691,476,447,923,1614,2448,3305,154.15,25.75,19.07,12.57
17-02-2021,ALCOUTIM,9,1,417,"[240,480]",Elevado,,,,9,Algarve,FARO,0802,57536.33,2159,191,188,163,190,267,457,620,808,999,3.75,1.74,1.4,1.08
17-02-2021,ALENQUER,267,19,606,"[480,960]",Muito Elevado,,,,267,Lisboa e Vale do Tejo,LISBOA,1101,30421.92,44052,2298,2062,1629,1330,1155,2485,4114,6176,8474,144.8,27.85,20.3,13.52
17-02-2021,ALFÂNDEGA DA FÉ,10,1,220,"[0,240]",Moderado,,,,10,Norte,BRAGANÇA,0401,32194.64,4550,325,277,301,274,325,599,900,1177,1502,14.13,4.67,3.66,2.8
17-02-2021,ALIJÓ,35,2,329,"[240,480]",Elevado,,,,35,Norte,VILA REAL,1701,29759.89,10625,766,687,635,542,666,1208,1843,2530,3296,35.7,11.08,8.5,6.19
17-02-2021,ALJEZUR,5,0,89,"[0,240]",Moderado,,,,5,Algarve,FARO,0803,32349.95,5594,316,336,335,320,410,730,1065,1401,1717,17.29,5.31,4.33,3.29
17-02-2021,ALJUSTREL,115,8,1394,"[960,Max]",Extremamente Elevado,,,,115,Alentejo,BEJA,0201,45847.41,8247,635,521,443,347,358,705,1148,1669,2304,17.99,5.03,3.64,2.5
17-02-2021,ALMADA,1166,83,690,"[480,960]",Muito Elevado,,,,1166,Lisboa e Vale do Tejo,SETÚBAL,1503,7000.89,169039,10469,9777,7876,6144,5111,11255,19131,28908,39377,2414.5,562.45,412.91,273.26
17-02-2021,ALMEIDA,36,3,617,"[480,960]",Muito Elevado,,,,36,Centro,GUARDA,0902,51798.46,5830,441,419,396,458,393,851,1247,1666,2107,11.26,4.07,3.22,2.41
17-02-2021,ALMEIRIM,127,9,563,"[480,960]",Muito Elevado,,,,127,Lisboa e Vale do Tejo,SANTARÉM,1403,22212.05,22546,1342,1353,1106,866,843,1709,2815,4168,5510,101.5,24.81,18.76,12.67
17-02-2021,ALMODÔVAR,9,1,134,"[0,240]",Moderado,,,,9,Alentejo,BEJA,0202,77788.03,6725,414,443,396,373,328,701,1097,1540,1954,8.65,2.51,1.98,1.41
17-02-2021,ALPIARÇA,35,3,496,"[480,960]",Muito Elevado,,,,35,Lisboa e Vale do Tejo,SANTARÉM,1404,9536.33,7059,515,486,363,333,274,607,970,1456,1971,74.02,20.67,15.27,10.17
17-02-2021,ALTER DO CHÃO,2,0,63,"[0,240]",Moderado,,,,2,Alentejo,PORTALEGRE,1201,36206.62,3165,201,163,136,208,187,395,531,694,895,8.74,2.47,1.92,1.47
17-02-2021,ALVAIÁZERE,48,3,728,"[480,960]",Muito Elevado,,,,48,Centro,LEIRIA,1002,16047.76,6597,419,389,346,406,539,945,1291,1680,2099,41.11,13.08,10.47,8.04
17-02-2021,ALVITO,5,0,202,"[0,240]",Moderado,,,,5,Alentejo,BEJA,0203,26485.32,2477,145,110,105,111,89,200,305,415,560,9.35,2.11,1.57,1.15
17-02-2021,AMADORA,1386,99,753,"[480,960]",Muito Elevado,,,,1386,Lisboa e Vale do Tejo,LISBOA,1115,2378.47,184106,11186,10936,8780,6460,5890,12350,21130,32066,43252,7742.05,1818.84,1348.44,888.56
17-02-2021,AMARANTE,188,13,353,"[240,480]",Elevado,,,,188,Norte,PORTO,1301,30133.15,53193,3086,2413,1812,1643,1311,2954,4766,7179,10265,176.53,34.07,23.82,15.82
17-02-2021,AMARES,57,4,314,"[240,480]",Elevado,,,,57,Norte,BRAGA,0301,8195.41,18129,1001,829,622,489,524,1013,1635,2464,3465,221.22,42.28,30.07,19.95
17-02-2021,ANADIA,82,6,301,"[240,480]",Elevado,,,,82,Centro,AVEIRO,0103,21663.48,27258,1931,1698,1376,1208,1262,2470,3846,5544,7475,125.83,34.51,25.59,17.75
17-02-2021,ANGRA DO HEROÍSMO,4,0,12,"[0,240]",Moderado,,,,4,Açores,AÇORES,4301,23899.66,33807,2006,1473,1122,768,635,1403,2525,3998,6004,141.45,25.12,16.73,10.56
17-02-2021,ANSIÃO,88,6,731,"[480,960]",Muito Elevado,,,,88,Centro,LEIRIA,1003,17609.42,12039,727,709,646,694,530,1224,1870,2579,3306,68.37,18.77,14.65,10.62
17-02-2021,ARCOS DE VALDEVEZ,127,9,607,"[480,960]",Muito Elevado,,,,127,Norte,VIANA DO CASTELO,1601,44759.64,20926,1329,1338,1282,1343,1515,2858,4140,5478,6807,46.75,15.21,12.24,9.25
17-02-2021,ARGANIL,51,4,463,"[240,480]",Elevado,,,,51,Centro,COIMBRA,0601,33283.93,11014,672,648,612,559,596,1155,1767,2415,3087,33.09,9.27,7.26,5.31
17-02-2021,ARMAMAR,24,2,416,"[240,480]",Elevado,,,,24,Norte,VISEU,1801,11723.73,5769,357,305,309,285,310,595,904,1209,1566,49.21,13.36,10.31,7.71
17-02-2021,AROUCA,89,6,430,"[240,480]",Elevado,,,,89,Norte,AVEIRO,0104,32910.52,20720,1306,1047,753,683,683,1366,2119,3166,4472,62.96,13.59,9.62,6.44
17-02-2021,ARRAIOLOS,65,5,938,"[480,960]",Muito Elevado,,,,65,Alentejo,ÉVORA,0702,68374.55,6928,435,384,283,367,480,847,1130,1514,1949,10.13,2.85,2.21,1.65
17-02-2021,ARRONCHES,62,4,2199,"[960,Max]",Extremamente Elevado,,,,62,Alentejo,PORTALEGRE,1202,31464.72,2820,155,142,162,187,179,366,528,670,825,8.96,2.62,2.13,1.68
17-02-2021,ARRUDA DOS VINHOS,70,5,454,"[240,480]",Elevado,,,,70,Lisboa e Vale do Tejo,LISBOA,1102,7795.93,15412,738,738,562,509,438,947,1509,2247,2985,197.69,38.29,28.82,19.36
17-02-2021,AVEIRO,307,22,390,"[240,480]",Elevado,,,,307,Centro,AVEIRO,0105,19757.57,78734,4520,4004,3050,2250,2103,4353,7403,11407,15927,398.49,80.61,57.73,37.47
17-02-2021,AVIS,7,1,165,"[0,240]",Moderado,,,,7,Alentejo,PORTALEGRE,1203,60596.51,4247,315,225,206,251,273,524,730,955,1270,7.01,2.1,1.58,1.2
17-02-2021,AZAMBUJA,95,7,418,"[240,480]",Elevado,,,,95,Lisboa e Vale do Tejo,LISBOA,1103,26265.65,22716,1322,1171,1070,798,618,1416,2486,3657,4979,86.48,18.96,13.92,9.46
17-02-2021,BAIÃO,93,7,496,"[480,960]",Muito Elevado,,,,93,Norte,PORTO,1302,17452.83,18748,1070,862,714,686,725,1411,2125,2987,4057,107.42,23.25,17.11,12.18
17-02-2021,BARCELOS,431,31,371,"[240,480]",Elevado,,,,431,Norte,BRAGA,0302,37890.14,116187,6721,5325,3619,2991,2562,5553,9172,14497,21218,306.64,56.0,38.26,24.21
17-02-2021,BARRANCOS,7,0,428,"[240,480]",Elevado,,,,7,Alentejo,BEJA,0204,16841.73,1634,90,65,65,94,61,155,220,285,375,9.7,2.23,1.69,1.31
17-02-2021,BARREIRO,548,39,729,"[480,960]",Muito Elevado,,,,548,Lisboa e Vale do Tejo,SETÚBAL,1504,3639.07,75147,5194,5565,4459,3105,1767,4872,9331,14896,20090,2065.05,552.07,409.34,256.42
17-02-2021,BATALHA,51,4,319,"[240,480]",Elevado,,,,51,Centro,LEIRIA,1004,10341.6,15963,873,762,649,529,549,1078,1727,2489,3362,154.35,32.51,24.07,16.7
17-02-2021,BEJA,136,10,405,"[240,480]",Elevado,,,,136,Alentejo,BEJA,0205,114647.55,33579,2005,1840,1386,1272,1039,2311,3697,5537,7542,29.29,6.58,4.83,3.22
17-02-2021,BELMONTE,36,3,563,"[480,960]",Muito Elevado,,,,36,Centro,CASTELO BRANCO,0501,11875.91,6398,444,321,325,310,355,665,990,1311,1755,53.87,14.78,11.04,8.34
17-02-2021,BENAVENTE,171,12,559,"[480,960]",Muito Elevado,,,,171,Lisboa e Vale do Tejo,SANTARÉM,1405,52138.39,30602,1468,1376,1141,876,643,1519,2660,4036,5504,58.69,10.56,7.74,5.1
17-02-2021,BOMBARRAL,67,5,534,"[480,960]",Muito Elevado,,,,67,Lisboa e Vale do Tejo,LEIRIA,1005,9128.55,12558,875,714,561,491,429,920,1481,2195,3070,137.56,33.63,24.04,16.22
17-02-2021,BORBA,17,1,252,"[240,480]",Elevado,,,,17,Alentejo,ÉVORA,0703,14518.65,6736,430,375,279,436,392,828,1107,1482,1912,46.39,13.17,10.21,7.62
17-02-2021,BOTICAS,56,4,1120,"[960,Max]",Extremamente Elevado,,,,56,Norte,VILA REAL,1702,32195.66,4998,347,306,311,305,380,685,996,1302,1649,15.52,5.12,4.04,3.09
17-02-2021,BRAGA,515,37,282,"[240,480]",Elevado,,,,515,Norte,BRAGA,0303,18339.95,182679,10029,7963,5241,4320,3671,7991,13232,21195,31224,996.07,170.25,115.57,72.15
17-02-2021,BRAGANÇA,142,10,423,"[240,480]",Elevado,,,,142,Norte,BRAGANÇA,0402,117357.27,33607,2402,1855,1652,1393,1163,2556,4208,6063,8465,28.64,7.21,5.17,3.59
17-02-2021,CABECEIRAS DE BASTO,30,2,192,"[0,240]",Moderado,,,,30,Norte,BRAGA,0304,24182.16,15628,774,594,544,575,574,1149,1693,2287,3061,64.63,12.66,9.46,7.0
17-02-2021,CADAVAL,59,4,432,"[240,480]",Elevado,,,,59,Lisboa e Vale do Tejo,LISBOA,1104,17489.3,13673,813,796,756,621,625,1246,2002,2798,3611,78.18,20.65,16.0,11.45
17-02-2021,CALDAS DA RAINHA,259,19,499,"[480,960]",Muito Elevado,,,,259,Lisboa e Vale do Tejo,LEIRIA,1006,25569.47,51912,3035,2684,2186,1899,1705,3604,5790,8474,11509,203.03,45.01,33.14,22.64
17-02-2021,CALHETA,7,0,64,"[0,240]",Moderado,,,,7,Madeira,MADEIRA,3101,11150.43,10867,576,497,507,399,415,814,1321,1818,2394,97.46,21.47,16.3,11.85
17-02-2021,CALHETA (AÇORES),0,0,0,"[0,240]",Moderado,,,,0,Açores,AÇORES,4501,12626.4,3184,215,159,141,139,122,261,402,561,776,25.22,6.15,4.44,3.18
17-02-2021,CÂMARA DE LOBOS,319,23,947,"[480,960]",Muito Elevado,,,,319,Madeira,MADEIRA,3102,5216.67,33675,1396,1059,834,545,381,926,1760,2819,4215,645.49,80.79,54.03,33.74
17-02-2021,CAMINHA,84,6,529,"[480,960]",Muito Elevado,,,,84,Norte,VIANA DO CASTELO,1602,13652.14,15877,1046,944,818,646,656,1302,2120,3064,4110,116.3,30.11,22.44,15.53
17-02-2021,CAMPO MAIOR,28,2,356,"[240,480]",Elevado,,,,28,Alentejo,PORTALEGRE,1204,24720.16,7874,471,364,351,279,327,606,957,1321,1792,31.85,7.25,5.34,3.87
17-02-2021,CANTANHEDE,221,16,631,"[480,960]",Muito Elevado,,,,221,Centro,COIMBRA,0602,39088.02,35011,2346,2096,1880,1709,1451,3160,5040,7136,9482,89.57,24.26,18.26,12.89
17-02-2021,CARRAZEDA DE ANSIÃES,27,2,477,"[240,480]",Elevado,,,,27,Norte,BRAGANÇA,0403,27924.09,5666,424,389,391,312,465,777,1168,1557,1981,20.29,7.09,5.58,4.18
17-02-2021,CARREGAL DO SAL,41,3,442,"[240,480]",Elevado,,,,41,Centro,VISEU,1802,11689.21,9271,587,562,486,462,376,838,1324,1886,2473,79.31,21.16,16.13,11.33
17-02-2021,CARTAXO,121,9,507,"[480,960]",Muito Elevado,,,,121,Lisboa e Vale do Tejo,SANTARÉM,1406,15817.28,23843,1415,1376,1142,861,632,1493,2635,4011,5426,150.74,34.3,25.36,16.66
17-02-2021,CASCAIS,1397,100,654,"[480,960]",Muito Elevado,,,,1397,Lisboa e Vale do Tejo,LISBOA,1105,9740.17,213608,12151,11444,8680,6469,5248,11717,20397,31841,43992,2193.1,451.66,326.91,209.41
17-02-2021,CASTANHEIRA DE PÊRA,63,4,2410,"[960,Max]",Extremamente Elevado,,,,63,Centro,LEIRIA,1007,6677.45,2614,233,195,157,190,187,377,534,729,962,39.15,14.41,10.92,8.0
17-02-2021,CASTELO BRANCO,200,14,385,"[240,480]",Elevado,,,,200,Centro,CASTELO BRANCO,0502,143819.15,51987,3528,3042,2499,2229,2225,4454,6953,9995,13523,36.15,9.4,6.95,4.83
17-02-2021,CASTELO DE PAIVA,45,3,291,"[240,480]",Elevado,,,,45,Norte,AVEIRO,0106,11500.53,15454,881,697,545,420,431,851,1396,2093,2974,134.37,25.86,18.2,12.14
17-02-2021,CASTELO DE VIDE,57,4,1953,"[960,Max]",Extremamente Elevado,,,,57,Alentejo,PORTALEGRE,1205,26491.24,2919,204,173,179,147,170,317,496,669,873,11.02,3.3,2.53,1.87
17-02-2021,CASTRO DAIRE,73,5,528,"[480,960]",Muito Elevado,,,,73,Centro,VISEU,1803,37904.13,13823,942,857,765,732,773,1505,2270,3127,4069,36.47,10.74,8.25,5.99
17-02-2021,CASTRO MARIM,45,3,722,"[480,960]",Muito Elevado,,,,45,Algarve,FARO,0804,30084.37,6237,370,345,334,322,344,666,1000,1345,1715,20.73,5.7,4.47,3.32
17-02-2021,CASTRO VERDE,56,4,806,"[480,960]",Muito Elevado,,,,56,Alentejo,BEJA,0206,56944.23,6949,437,347,303,275,227,502,805,1152,1589,12.2,2.79,2.02,1.41
17-02-2021,CELORICO DA BEIRA,9,1,130,"[0,240]",Moderado,,,,9,Centro,GUARDA,0903,24721.63,6928,430,416,363,369,535,904,1267,1683,2113,28.02,8.55,6.81,5.12
17-02-2021,CELORICO DE BASTO,41,3,215,"[0,240]",Moderado,,,,41,Norte,BRAGA,0305,18107.02,19040,1001,802,668,728,729,1457,2125,2927,3928,105.15,21.69,16.17,11.74
17-02-2021,CHAMUSCA,27,2,294,"[240,480]",Elevado,,,,27,Lisboa e Vale do Tejo,SANTARÉM,1407,74600.54,9197,629,583,553,465,579,1044,1597,2180,2809,12.33,3.77,2.92,2.14
17-02-2021,CHAVES,95,7,241,"[240,480]",Elevado,,,,95,Norte,VILA REAL,1703,59122.95,39343,2676,2429,1991,1886,1918,3804,5795,8224,10900,66.54,18.44,13.91,9.8
17-02-2021,CINFÃES,66,5,362,"[240,480]",Elevado,,,,66,Norte,VISEU,1804,23928.76,18244,1067,902,779,734,758,1492,2271,3173,4240,76.24,17.72,13.26,9.49
17-02-2021,COIMBRA,1128,81,841,"[480,960]",Muito Elevado,,,,1128,Centro,COIMBRA,0603,31939.94,134166,9489,8734,6353,5139,5074,10213,16566,25300,34789,420.06,108.92,79.21,51.87
17-02-2021,CONDEIXA-A-NOVA,90,6,508,"[480,960]",Muito Elevado,,,,90,Centro,COIMBRA,0604,13867.47,17733,871,809,717,583,490,1073,1790,2599,3470,127.88,25.02,18.74,12.91
17-02-2021,CONSTÂNCIA,10,1,248,"[240,480]",Elevado,,,,10,Lisboa e Vale do Tejo,SANTARÉM,1408,8036.58,4030,211,183,187,148,155,303,490,673,884,50.14,11.0,8.37,6.1
17-02-2021,CORUCHE,87,6,498,"[480,960]",Muito Elevado,,,,87,Lisboa e Vale do Tejo,SANTARÉM,1409,111572.03,17471,1294,1090,1095,1096,1019,2115,3210,4300,5594,15.66,5.01,3.85,2.88
17-02-2021,CORVO,0,0,0,"[0,240]",Moderado,,,,0,Açores,AÇORES,4901,1711.45,464,22,21,11,13,19,32,43,64,86,27.12,5.03,3.74,2.51
17-02-2021,COVILHÃ,253,18,541,"[480,960]",Muito Elevado,,,,253,Centro,CASTELO BRANCO,0503,55560.06,46787,3533,2998,2365,2111,2193,4304,6669,9667,13200,84.21,23.76,17.4,12.0
17-02-2021,CRATO,7,1,224,"[0,240]",Moderado,,,,7,Alentejo,PORTALEGRE,1206,39806.88,3129,229,258,163,182,228,410,573,831,1060,7.86,2.66,2.09,1.44
17-02-2021,CUBA,21,1,457,"[240,480]",Elevado,,,,21,Alentejo,BEJA,0207,17208.72,4595,255,233,206,190,143,333,539,772,1027,26.7,5.97,4.49,3.13
17-02-2021,ELVAS,36,3,175,"[0,240]",Moderado,,,,36,Alentejo,PORTALEGRE,1207,63128.86,20528,1057,1145,902,852,810,1662,2564,3709,4766,32.52,7.55,5.88,4.06
17-02-2021,ENTRONCAMENTO,42,3,195,"[0,240]",Moderado,,,,42,Lisboa e Vale do Tejo,SANTARÉM,1410,1372.81,21558,1066,930,868,695,592,1287,2155,3085,4151,1570.14,302.33,224.69,156.96
17-02-2021,ESPINHO,148,11,501,"[480,960]",Muito Elevado,,,,148,Norte,AVEIRO,0107,2105.68,29516,2205,1993,1430,1177,960,2137,3567,5560,7765,1401.52,368.71,264.01,169.37
17-02-2021,ESPOSENDE,125,9,366,"[240,480]",Elevado,,,,125,Norte,BRAGA,0306,9540.98,34177,1831,1522,1095,894,723,1617,2712,4234,6065,358.21,63.57,44.38,28.42
17-02-2021,ESTARREJA,96,7,369,"[240,480]",Elevado,,,,96,Centro,AVEIRO,0108,10817.33,26006,1503,1399,1106,953,728,1681,2787,4186,5689,240.42,52.59,38.7,25.76
17-02-2021,ESTREMOZ,115,8,904,"[480,960]",Muito Elevado,,,,115,Alentejo,ÉVORA,0704,51379.95,12728,789,613,697,786,877,1663,2360,2973,3762,24.77,7.32,5.79,4.59
17-02-2021,ÉVORA,106,8,202,"[0,240]",Moderado,,,,106,Alentejo,ÉVORA,0705,130707.58,52428,3569,2852,2176,1966,1803,3769,5945,8797,12366,40.11,9.46,6.73,4.55
17-02-2021,FAFE,141,10,293,"[240,480]",Elevado,,,,141,Norte,BRAGA,0307,21908.11,48060,3044,2455,1679,1403,1208,2611,4290,6745,9789,219.37,44.68,30.79,19.58
17-02-2021,FARO,249,18,408,"[240,480]",Elevado,,,,249,Algarve,FARO,0805,20256.79,61015,3847,3364,2604,2055,1601,3656,6260,9624,13471,301.2,66.5,47.51,30.9
17-02-2021,FELGUEIRAS,211,15,374,"[240,480]",Elevado,,,,211,Norte,PORTO,1303,11573.75,56422,2951,2302,1601,1316,973,2289,3890,6192,9143,487.49,79.0,53.5,33.61
17-02-2021,FERREIRA DO ALENTEJO,89,6,1134,"[960,Max]",Extremamente Elevado,,,,89,Alentejo,BEJA,0208,64820.68,7845,515,414,372,343,345,688,1060,1474,1989,12.1,3.07,2.27,1.64
17-02-2021,FERREIRA DO ZÊZERE,23,2,289,"[240,480]",Elevado,,,,23,Lisboa e Vale do Tejo,SANTARÉM,1411,19038.03,7959,470,370,416,465,456,921,1337,1707,2177,41.81,11.44,8.97,7.02
17-02-2021,FIGUEIRA DA FOZ,265,19,451,"[240,480]",Elevado,,,,265,Centro,COIMBRA,0605,37905.26,58747,4032,3597,2887,2495,2043,4538,7425,11022,15054,154.98,39.72,29.08,19.59
17-02-2021,FIGUEIRA DE CASTELO RODRIGO,8,1,143,"[0,240]",Moderado,,,,8,Centro,GUARDA,0904,50857.46,5584,347,352,290,352,391,743,1033,1385,1732,10.98,3.41,2.72,2.03
17-02-2021,FIGUEIRÓ DOS VINHOS,13,1,233,"[0,240]",Moderado,,,,13,Centro,LEIRIA,1008,17344.0,5568,402,386,322,309,351,660,982,1368,1770,32.1,10.21,7.89,5.66
17-02-2021,FORNOS DE ALGODRES,9,1,199,"[0,240]",Moderado,,,,9,Centro,GUARDA,0905,13145.05,4528,261,218,247,256,232,488,735,953,1214,34.45,9.24,7.25,5.59
17-02-2021,FREIXO DE ESPADA À CINTA,4,0,121,"[0,240]",Moderado,,,,4,Norte,BRAGANÇA,0404,24414.29,3298,211,177,231,196,189,385,616,793,1004,13.51,4.11,3.25,2.52
17-02-2021,FRONTEIRA,8,1,269,"[240,480]",Elevado,,,,8,Alentejo,PORTALEGRE,1208,24859.58,2974,213,182,149,156,168,324,473,655,868,11.96,3.49,2.63,1.9
17-02-2021,FUNCHAL,584,42,561,"[480,960]",Muito Elevado,,,,584,Madeira,MADEIRA,3103,7616.2,104024,6382,5086,3643,2821,1990,4811,8454,13540,19922,1365.86,261.58,177.78,111.0
17-02-2021,FUNDÃO,141,10,532,"[480,960]",Muito Elevado,,,,141,Centro,CASTELO BRANCO,0504,70019.79,26495,1781,1464,1432,1357,1643,3000,4432,5896,7677,37.84,10.96,8.42,6.33
17-02-2021,GAVIÃO,36,3,1103,"[960,Max]",Extremamente Elevado,,,,36,Alentejo,PORTALEGRE,1209,29459.45,3263,189,186,222,263,293,556,778,964,1153,11.08,3.91,3.27,2.64
17-02-2021,GÓIS,16,1,420,"[240,480]",Elevado,,,,16,Centro,COIMBRA,0606,26330.19,3805,235,199,240,233,244,477,717,916,1151,14.45,4.37,3.48,2.72
17-02-2021,GOLEGÃ,14,1,262,"[240,480]",Elevado,,,,14,Lisboa e Vale do Tejo,SANTARÉM,1412,8431.67,5339,356,299,281,243,255,498,779,1078,1434,63.32,17.01,12.78,9.24
17-02-2021,GONDOMAR,407,29,245,"[240,480]",Elevado,,,,407,Norte,PORTO,1304,13191.76,165985,10555,8755,6222,4450,3364,7814,14036,22791,33346,1258.22,252.77,172.76,106.4
17-02-2021,GOUVEIA,62,4,501,"[480,960]",Muito Elevado,,,,62,Centro,GUARDA,0906,30061.17,12387,871,931,780,783,810,1593,2373,3304,4175,41.21,13.89,10.99,7.89
17-02-2021,GRÂNDOLA,134,10,915,"[480,960]",Muito Elevado,,,,134,Alentejo,SETÚBAL,1505,82593.66,14639,834,834,708,688,672,1360,2068,2902,3736,17.72,4.52,3.51,2.5
17-02-2021,GUARDA,129,9,331,"[240,480]",Elevado,,,,129,Centro,GUARDA,0907,71209.58,38969,2477,2041,1686,1415,1474,2889,4575,6616,9093,54.72,12.77,9.29,6.42
17-02-2021,GUIMARÃES,443,32,291,"[240,480]",Elevado,,,,443,Norte,BRAGA,0308,24099.96,152309,9394,7074,4809,3877,2948,6825,11634,18708,28102,631.99,116.61,77.63,48.27
17-02-2021,HORTA,3,0,21,"[0,240]",Moderado,,,,3,Açores,AÇORES,4701,17305.53,14521,818,658,468,352,302,654,1122,1780,2598,83.91,15.01,10.29,6.48
17-02-2021,IDANHA-A-NOVA,10,1,124,"[0,240]",Moderado,,,,10,Centro,CASTELO BRANCO,0505,141633.51,8043,518,490,519,672,974,1646,2165,2655,3173,5.68,2.24,1.87,1.53
17-02-2021,ÍLHAVO,182,13,470,"[240,480]",Elevado,,,,182,Centro,AVEIRO,0110,7347.55,38699,2227,1943,1444,1193,850,2043,3487,5430,7657,526.66,104.21,73.9,47.46
17-02-2021,LAGOA (FARO),57,4,250,"[240,480]",Elevado,,,,57,Algarve,FARO,0806,8825.45,22762,1314,1168,919,749,670,1419,2338,3506,4820,257.93,54.62,39.73,26.49
17-02-2021,LAGOA,3,0,20,"[0,240]",Moderado,,,,3,Açores,AÇORES,4201,4559.32,14721,536,458,349,238,235,473,822,1280,1816,322.9,39.83,28.08,18.03
17-02-2021,LAGOS,105,8,346,"[240,480]",Elevado,,,,105,Algarve,FARO,0807,21299.27,30374,1744,1434,1247,1053,1029,2082,3329,4763,6507,142.61,30.55,22.36,15.63
17-02-2021,LAJES DAS FLORES,0,0,0,"[0,240]",Moderado,,,,0,Açores,AÇORES,4801,7004.79,1463,88,53,62,46,54,100,162,215,303,20.89,4.33,3.07,2.31
17-02-2021,LAJES DO PICO,0,0,0,"[0,240]",Moderado,,,,0,Açores,AÇORES,4601,15531.09,4490,304,231,223,159,162,321,544,775,1079,28.91,6.95,4.99,3.5
17-02-2021,LAMEGO,132,9,530,"[480,960]",Muito Elevado,,,,132,Norte,VISEU,1805,16542.11,24895,1639,1284,1124,898,783,1681,2805,4089,5728,150.5,34.63,24.72,16.96
17-02-2021,LEIRIA,367,26,293,"[240,480]",Elevado,,,,367,Centro,LEIRIA,1009,56508.83,125267,7389,6366,5090,3902,3159,7061,12151,18517,25906,221.68,45.84,32.77,21.5
17-02-2021,LISBOA,3674,262,721,"[480,960]",Muito Elevado,,,,3674,Lisboa e Vale do Tejo,LISBOA,1106,10005.43,509515,33197,33340,27706,23037,26770,49807,77513,110853,144050,5092.6,1439.78,1107.98,774.74
17-02-2021,LOULÉ,272,19,396,"[240,480]",Elevado,,,,272,Algarve,FARO,0808,76366.91,68697,3890,3350,2780,2358,2251,4609,7389,10739,14629,89.96,19.16,14.06,9.68
17-02-2021,LOURES,1506,108,705,"[480,960]",Muito Elevado,,,,1506,Lisboa e Vale do Tejo,LISBOA,1107,16723.99,213687,12746,12794,9644,6669,5033,11702,21346,34140,46886,1277.73,280.35,204.14,127.64
17-02-2021,LOURINHÃ,160,11,619,"[480,960]",Muito Elevado,,,,160,Lisboa e Vale do Tejo,LISBOA,1108,14717.2,25855,1584,1243,992,842,645,1487,2479,3722,5306,175.68,36.05,25.29,16.84
17-02-2021,LOUSÃ,154,11,898,"[480,960]",Muito Elevado,,,,154,Centro,COIMBRA,0607,13840.01,17158,946,866,658,528,450,978,1636,2502,3448,123.97,24.91,18.08,11.82
17-02-2021,LOUSADA,126,9,269,"[240,480]",Elevado,,,,126,Norte,PORTO,1305,9608.01,46755,2289,1698,1176,853,621,1474,2650,4348,6637,486.63,69.08,45.25,27.58
17-02-2021,MAÇÃO,11,1,176,"[0,240]",Moderado,,,,11,Lisboa e Vale do Tejo,SANTARÉM,1413,39997.98,6267,386,362,390,440,657,1097,1487,1849,2235,15.67,5.59,4.62,3.72
17-02-2021,MACEDO DE CAVALEIROS,25,2,172,"[0,240]",Moderado,,,,25,Norte,BRAGANÇA,0405,69914.08,14516,1082,889,878,823,938,1761,2639,3528,4610,20.76,6.59,5.05,3.77
17-02-2021,MACHICO,83,6,415,"[240,480]",Elevado,,,,83,Madeira,MADEIRA,3104,6825.1,19981,1197,860,662,455,331,786,1448,2308,3505,292.76,51.36,33.82,21.22
17-02-2021,MADALENA,3,0,51,"[0,240]",Moderado,,,,3,Açores,AÇORES,4602,14712.33,5895,334,256,173,190,179,369,542,798,1132,40.07,7.69,5.42,3.68
17-02-2021,MAFRA,693,49,817,"[480,960]",Muito Elevado,,,,693,Lisboa e Vale do Tejo,LISBOA,1109,29165.5,84816,3613,3334,2839,2089,1899,3988,6827,10161,13774,290.81,47.23,34.84,23.41
17-02-2021,MAIA,261,19,188,"[0,240]",Moderado,,,,261,Norte,PORTO,1306,8293.94,138971,7801,6617,4512,3339,2631,5970,10482,17099,24900,1675.56,300.22,206.16,126.38
17-02-2021,MANGUALDE,56,4,303,"[240,480]",Elevado,,,,56,Centro,VISEU,1806,21925.56,18510,1198,1128,885,852,743,1595,2480,3608,4806,84.42,21.92,16.46,11.31
17-02-2021,MANTEIGAS,55,4,1829,"[960,Max]",Extremamente Elevado,,,,55,Centro,GUARDA,0908,12197.55,3007,258,197,159,167,146,313,472,669,927,24.65,7.6,5.48,3.87
17-02-2021,MARCO DE CANAVESES,122,9,237,"[0,240]",Moderado,,,,122,Norte,PORTO,1307,20188.98,51496,2678,2060,1488,1265,1023,2288,3776,5836,8514,255.07,42.17,28.91,18.7
17-02-2021,MARINHA GRANDE,111,8,288,"[240,480]",Elevado,,,,111,Centro,LEIRIA,1010,18725.19,38508,2365,2302,1638,1359,1058,2417,4055,6357,8722,205.65,46.58,33.95,21.66
17-02-2021,MARVÃO,3,0,100,"[0,240]",Moderado,,,,3,Alentejo,PORTALEGRE,1210,15489.9,3005,198,185,142,197,237,434,576,761,959,19.4,6.19,4.91,3.72
17-02-2021,MATOSINHOS,458,33,261,"[240,480]",Elevado,,,,458,Norte,PORTO,1308,6241.97,175357,11850,9977,7023,5024,3884,8908,15931,25908,37758,2809.31,604.9,415.06,255.22
17-02-2021,MEALHADA,123,9,618,"[480,960]",Muito Elevado,,,,123,Centro,AVEIRO,0111,11065.66,19914,1163,1039,810,828,831,1659,2469,3508,4671,179.96,42.21,31.7,22.31
17-02-2021,MÊDA,16,1,349,"[240,480]",Elevado,,,,16,Centro,GUARDA,0909,28604.92,4587,343,306,290,288,443,731,1021,1327,1670,16.04,5.84,4.64,3.57
17-02-2021,MELGAÇO,37,3,457,"[240,480]",Elevado,,,,37,Norte,VIANA DO CASTELO,1603,23824.58,8093,507,567,578,614,675,1289,1867,2434,2941,33.97,12.34,10.22,7.84
17-02-2021,MÉRTOLA,38,3,619,"[480,960]",Muito Elevado,,,,38,Alentejo,BEJA,0209,129287.34,6142,400,390,378,423,600,1023,1401,1791,2191,4.75,1.69,1.39,1.08
17-02-2021,MESÃO FRIO,10,1,252,"[240,480]",Elevado,,,,10,Norte,VILA REAL,1704,2664.87,3964,265,205,168,157,120,277,445,650,915,148.74,34.33,24.39,16.7
17-02-2021,MIRA,36,3,304,"[240,480]",Elevado,,,,36,Centro,COIMBRA,0608,12403.38,11832,727,729,659,550,466,1016,1675,2404,3131,95.4,25.24,19.38,13.5
17-02-2021,MIRANDA DO CORVO,81,6,637,"[480,960]",Muito Elevado,,,,81,Centro,COIMBRA,0609,12637.79,12708,706,659,568,498,404,902,1470,2129,2835,100.55,22.43,16.85,11.63
17-02-2021,MIRANDA DO DOURO,16,1,234,"[0,240]",Moderado,,,,16,Norte,BRAGANÇA,0406,48718.31,6830,482,429,442,463,470,933,1375,1804,2286,14.02,4.69,3.7,2.82
17-02-2021,MIRANDELA,127,9,584,"[480,960]",Muito Elevado,,,,127,Norte,BRAGANÇA,0407,65895.67,21754,1640,1315,1204,1078,947,2025,3229,4544,6184,33.01,9.38,6.9,4.9
17-02-2021,MOGADOURO,16,1,191,"[0,240]",Moderado,,,,16,Norte,BRAGANÇA,0408,76064.93,8392,589,529,576,630,655,1285,1861,2390,2979,11.03,3.92,3.14,2.45
17-02-2021,MOIMENTA DA BEIRA,79,6,811,"[480,960]",Muito Elevado,,,,79,Norte,VISEU,1807,21996.9,9736,576,514,471,416,461,877,1348,1862,2438,44.26,11.08,8.46,6.13
17-02-2021,MOITA,484,35,751,"[480,960]",Muito Elevado,,,,484,Lisboa e Vale do Tejo,SETÚBAL,1506,5525.98,64407,4226,3646,2623,1801,1425,3226,5849,9495,13721,1165.53,248.3,171.82,105.85
17-02-2021,MONÇÃO,130,9,728,"[480,960]",Muito Elevado,,,,130,Norte,VIANA DO CASTELO,1604,21130.85,17869,1161,1105,1031,1006,972,1978,3009,4114,5275,84.56,24.96,19.47,14.24
17-02-2021,MONCHIQUE,54,4,1064,"[960,Max]",Extremamente Elevado,,,,54,Algarve,FARO,0809,39530.43,5077,353,384,321,355,392,747,1068,1452,1805,12.84,4.57,3.67,2.7
17-02-2021,MONDIM DE BASTO,16,1,230,"[0,240]",Moderado,,,,16,Norte,VILA REAL,1705,17207.52,6946,395,300,314,284,283,567,881,1181,1576,40.36,9.16,6.86,5.12
17-02-2021,MONFORTE,5,0,168,"[0,240]",Moderado,,,,5,Alentejo,PORTALEGRE,1211,42024.82,2975,139,115,117,192,168,360,477,592,731,7.08,1.74,1.41,1.14
17-02-2021,MONTALEGRE,26,2,289,"[240,480]",Elevado,,,,26,Norte,VILA REAL,1706,80545.71,8997,699,628,595,603,730,1333,1928,2556,3255,11.17,4.04,3.17,2.39
17-02-2021,MONTEMOR-O-NOVO,21,1,134,"[0,240]",Moderado,,,,21,Alentejo,ÉVORA,0706,123296.65,15647,991,953,868,878,971,1849,2717,3670,4661,12.69,3.78,2.98,2.2
17-02-2021,MONTEMOR-O-VELHO,187,13,741,"[480,960]",Muito Elevado,,,,187,Centro,COIMBRA,0610,22896.23,25224,1496,1397,1217,1057,988,2045,3262,4659,6155,110.17,26.88,20.35,14.25
17-02-2021,MONTIJO,340,24,590,"[480,960]",Muito Elevado,,,,340,Lisboa e Vale do Tejo,SETÚBAL,1507,34861.64,57614,2771,2441,1990,1554,1109,2663,4653,7094,9865,165.26,28.3,20.35,13.35
17-02-2021,MORA,7,0,169,"[0,240]",Moderado,,,,7,Alentejo,ÉVORA,0707,44395.02,4138,336,275,252,238,257,495,747,1022,1358,9.32,3.06,2.3,1.68
17-02-2021,MORTÁGUA,9,1,102,"[0,240]",Moderado,,,,9,Centro,VISEU,1808,25117.82,8803,638,584,535,499,460,959,1494,2078,2716,35.05,10.81,8.27,5.95
17-02-2021,MOURA,132,9,962,"[960,Max]",Extremamente Elevado,,,,132,Alentejo,BEJA,0210,95845.55,13718,817,656,665,542,461,1003,1668,2324,3141,14.31,3.28,2.42,1.74
17-02-2021,MOURÃO,0,0,0,"[0,240]",Moderado,,,,0,Alentejo,ÉVORA,0708,27862.98,2450,139,108,80,104,109,213,293,401,540,8.79,1.94,1.44,1.05
17-02-2021,MURÇA,18,1,329,"[240,480]",Elevado,,,,18,Norte,VILA REAL,1707,18937.11,5463,384,341,307,306,319,625,932,1273,1657,28.85,8.75,6.72,4.92
17-02-2021,MURTOSA,68,5,662,"[480,960]",Muito Elevado,,,,68,Centro,AVEIRO,0112,7308.78,10279,509,473,403,353,409,762,1165,1638,2147,140.63,29.37,22.41,15.94
17-02-2021,NAZARÉ,38,3,268,"[240,480]",Elevado,,,,38,Lisboa e Vale do Tejo,LEIRIA,1011,8243.43,14165,967,903,670,420,396,816,1486,2389,3356,171.84,40.71,28.98,18.03
17-02-2021,NELAS,33,2,254,"[240,480]",Elevado,,,,33,Centro,VISEU,1809,12571.48,12974,924,787,668,604,583,1187,1855,2642,3566,103.21,28.37,21.02,14.76
17-02-2021,NISA,15,1,247,"[240,480]",Elevado,,,,15,Alentejo,PORTALEGRE,1212,57567.84,6061,405,389,355,483,478,961,1316,1705,2110,10.53,3.67,2.96,2.29
17-02-2021,NORDESTE,0,0,0,"[0,240]",Moderado,,,,0,Açores,AÇORES,4202,10146.8,4862,246,180,124,161,162,323,447,627,873,47.92,8.6,6.18,4.41
17-02-2021,ÓBIDOS,52,4,439,"[240,480]",Elevado,,,,52,Lisboa e Vale do Tejo,LEIRIA,1012,14155.44,11850,743,650,574,452,436,888,1462,2112,2855,83.72,20.17,14.92,10.33
17-02-2021,ODEMIRA,119,8,481,"[480,960]",Muito Elevado,,,,119,Alentejo,BEJA,0211,172060.15,24717,1475,1317,1225,1397,1349,2746,3971,5288,6763,14.37,3.93,3.07,2.31
17-02-2021,ODIVELAS,1365,98,844,"[480,960]",Muito Elevado,,,,1365,Lisboa e Vale do Tejo,LISBOA,1116,2654.36,161774,9562,9038,6952,4641,3812,8453,15405,24443,34005,6095.48,1281.27,920.99,580.44
17-02-2021,OEIRAS,1279,91,721,"[480,960]",Muito Elevado,,,,1279,Lisboa e Vale do Tejo,LISBOA,1110,4588.31,177408,11580,11575,8566,6211,5855,12066,20632,32207,43787,3866.78,954.38,701.98,449.69
17-02-2021,OLEIROS,11,1,220,"[0,240]",Moderado,,,,11,Centro,CASTELO BRANCO,0506,47109.31,5003,384,341,366,397,487,884,1250,1591,1975,10.62,4.19,3.38,2.65
17-02-2021,OLHÃO,142,10,320,"[240,480]",Elevado,,,,142,Algarve,FARO,0810,13086.38,44405,2455,2309,1689,1342,1268,2610,4299,6608,9063,339.33,69.26,50.5,32.85
17-02-2021,OLIVEIRA DE AZEMÉIS,369,26,559,"[480,960]",Muito Elevado,,,,369,Norte,AVEIRO,0113,16110.41,66011,4155,3614,2794,2183,1738,3921,6715,10329,14484,409.75,89.91,64.12,41.68
17-02-2021,OLIVEIRA DE FRADES,48,3,483,"[480,960]",Muito Elevado,,,,48,Centro,VISEU,1810,14534.62,9936,553,475,438,359,415,774,1212,1687,2240,68.36,15.41,11.61,8.34
17-02-2021,OLIVEIRA DO BAIRRO,85,6,350,"[240,480]",Elevado,,,,85,Centro,AVEIRO,0114,8731.99,24277,1327,1182,999,786,810,1596,2595,3777,5104,278.02,58.45,43.25,29.72
17-02-2021,OLIVEIRA DO HOSPITAL,57,4,296,"[240,480]",Elevado,,,,57,Centro,COIMBRA,0611,23451.66,19253,1161,1097,962,924,960,1884,2846,3943,5104,82.1,21.76,16.81,12.14
17-02-2021,OURÉM,135,10,307,"[240,480]",Elevado,,,,135,Lisboa e Vale do Tejo,SANTARÉM,1421,41668.03,44044,2463,2069,1899,1817,1603,3420,5319,7388,9851,105.7,23.64,17.73,12.77
17-02-2021,OURIQUE,15,1,326,"[240,480]",Elevado,,,,15,Alentejo,BEJA,0212,66331.36,4607,313,287,284,268,227,495,779,1066,1379,6.95,2.08,1.61,1.17
17-02-2021,OVAR,268,19,494,"[480,960]",Muito Elevado,,,,268,Centro,AVEIRO,0115,14770.25,54260,3294,2709,1994,1636,1234,2870,4864,7573,10867,367.37,73.57,51.27,32.93
17-02-2021,PAÇOS DE FERREIRA,132,9,233,"[0,240]",Moderado,,,,132,Norte,PORTO,1309,7099.29,56728,2903,2193,1518,1135,664,1799,3317,5510,8413,799.1,118.51,77.62,46.72
17-02-2021,PALMELA,522,37,812,"[480,960]",Muito Elevado,,,,522,Lisboa e Vale do Tejo,SETÚBAL,1508,46512.01,64269,3402,3244,2635,1846,1391,3237,5872,9116,12518,138.18,26.91,19.6,12.62
17-02-2021,PAMPILHOSA DA SERRA,18,1,446,"[240,480]",Elevado,,,,18,Centro,COIMBRA,0612,39646.24,4037,238,254,295,339,423,762,1057,1311,1549,10.18,3.91,3.31,2.67
17-02-2021,PAREDES,197,14,229,"[0,240]",Moderado,,,,197,Norte,PORTO,1310,15675.69,86067,4272,3532,2412,1717,1258,2975,5387,8919,13191,549.04,84.15,56.9,34.36
17-02-2021,PAREDES DE COURA,59,4,691,"[480,960]",Muito Elevado,,,,59,Norte,VIANA DO CASTELO,1605,13818.59,8535,466,528,407,465,515,980,1387,1915,2381,61.76,17.23,13.86,10.04
17-02-2021,PEDRÓGÃO GRANDE,7,0,205,"[0,240]",Moderado,,,,7,Centro,LEIRIA,1013,12874.75,3410,175,173,196,221,252,473,669,842,1017,26.49,7.9,6.54,5.2
17-02-2021,PENACOVA,112,8,818,"[480,960]",Muito Elevado,,,,112,Centro,COIMBRA,0613,21673.23,13694,968,923,745,621,703,1324,2069,2992,3960,63.18,18.27,13.81,9.55
17-02-2021,PENAFIEL,169,12,242,"[240,480]",Elevado,,,,169,Norte,PORTO,1311,21224.27,69772,3648,2823,2032,1663,1230,2893,4925,7748,11396,328.74,53.69,36.51,23.2
17-02-2021,PENALVA DO CASTELO,14,1,197,"[0,240]",Moderado,,,,14,Centro,VISEU,1811,13433.92,7115,449,457,413,391,426,817,1230,1687,2136,52.96,15.9,12.56,9.16
17-02-2021,PENAMACOR,16,1,336,"[240,480]",Elevado,,,,16,Centro,CASTELO BRANCO,0507,56370.69,4755,262,248,273,451,633,1084,1357,1605,1867,8.44,3.31,2.85,2.41
17-02-2021,PENEDONO,13,1,502,"[480,960]",Muito Elevado,,,,13,Norte,VISEU,1812,13370.75,2591,172,113,129,156,138,294,423,536,708,19.38,5.3,4.01,3.16
17-02-2021,PENELA,57,4,1056,"[960,Max]",Extremamente Elevado,,,,57,Centro,COIMBRA,0614,13480.0,5397,314,324,274,359,344,703,977,1301,1615,40.04,11.98,9.65,7.25
17-02-2021,PENICHE,173,12,653,"[480,960]",Muito Elevado,,,,173,Lisboa e Vale do Tejo,LEIRIA,1014,7754.98,26501,1746,1504,1203,926,707,1633,2836,4340,6086,341.73,78.48,55.96,36.57
17-02-2021,PESO DA RÉGUA,43,3,273,"[240,480]",Elevado,,,,43,Norte,VILA REAL,1708,9486.01,15773,1076,843,650,659,455,1114,1764,2607,3683,166.28,38.83,27.48,18.6
17-02-2021,PINHEL,37,3,435,"[240,480]",Elevado,,,,37,Centro,GUARDA,0910,48452.12,8511,577,566,551,538,689,1227,1778,2344,2921,17.57,6.03,4.84,3.67
17-02-2021,POMBAL,185,13,359,"[240,480]",Elevado,,,,185,Centro,LEIRIA,1015,62600.28,51461,3187,2791,2494,2328,2027,4355,6849,9640,12827,82.21,20.49,15.4,10.94
17-02-2021,PONTA DELGADA,19,1,28,"[0,240]",Moderado,,,,19,Açores,AÇORES,4203,23298.65,67935,3108,2435,1726,1133,902,2035,3761,6196,9304,291.58,39.93,26.59,16.14
17-02-2021,PONTA DO SOL,68,5,791,"[480,960]",Muito Elevado,,,,68,Madeira,MADEIRA,3105,4622.03,8593,319,283,347,208,221,429,776,1059,1378,185.92,29.81,22.91,16.79
17-02-2021,PONTE DA BARCA,68,5,608,"[480,960]",Muito Elevado,,,,68,Norte,VIANA DO CASTELO,1606,18211.37,11180,635,576,517,554,490,1044,1561,2137,2772,61.39,15.22,11.73,8.57
17-02-2021,PONTE DE LIMA,223,16,540,"[480,960]",Muito Elevado,,,,223,Norte,VIANA DO CASTELO,1607,32025.46,41315,2321,2022,1720,1596,1462,3058,4778,6800,9121,129.01,28.48,21.23,14.92
17-02-2021,PONTE DE SOR,27,2,180,"[0,240]",Moderado,,,,27,Alentejo,PORTALEGRE,1213,83971.16,14994,939,800,716,739,831,1570,2286,3086,4025,17.86,4.79,3.68,2.72
17-02-2021,PORTALEGRE,33,2,149,"[0,240]",Moderado,,,,33,Alentejo,PORTALEGRE,1214,44713.64,22172,1577,1351,1137,993,984,1977,3114,4465,6042,49.59,13.51,9.99,6.96
17-02-2021,PORTEL,6,0,103,"[0,240]",Moderado,,,,6,Alentejo,ÉVORA,0709,60100.57,5828,336,358,283,331,305,636,919,1277,1613,9.7,2.68,2.12,1.53
17-02-2021,PORTIMÃO,211,15,380,"[240,480]",Elevado,,,,211,Algarve,FARO,0811,18206.29,55483,3182,2927,2116,1582,1400,2982,5098,8025,11207,304.75,61.56,44.08,28.0
17-02-2021,PORTO,565,40,261,"[240,480]",Elevado,,,,565,Norte,PORTO,1312,4142.02,216606,15790,15193,11280,9409,10044,19453,30733,45926,61716,5229.5,1490.0,1108.79,741.98
17-02-2021,PORTO DE MÓS,68,5,292,"[240,480]",Elevado,,,,68,Centro,LEIRIA,1016,26183.41,23275,1355,1210,1034,888,872,1760,2794,4004,5359,88.89,20.47,15.29,10.67
17-02-2021,PORTO MONIZ,3,0,128,"[0,240]",Moderado,,,,3,Madeira,MADEIRA,3106,8293.38,2342,143,130,95,98,120,218,313,443,586,28.24,7.07,5.34,3.77
17-02-2021,PORTO SANTO,4,0,77,"[0,240]",Moderado,,,,4,Madeira,MADEIRA,3201,4300.7,5202,240,157,134,110,68,178,312,469,709,120.95,16.48,10.9,7.25
17-02-2021,PÓVOA DE LANHOSO,65,5,302,"[240,480]",Elevado,,,,65,Norte,BRAGA,0309,13465.29,21499,1175,909,732,673,624,1297,2029,2938,4113,159.67,30.55,21.82,15.07
17-02-2021,PÓVOA DE VARZIM,218,16,347,"[240,480]",Elevado,,,,218,Norte,PORTO,1313,8220.59,62784,3712,3120,2134,1594,1305,2899,5033,8153,11865,763.7,144.33,99.17,61.22
17-02-2021,POVOAÇÃO,0,0,0,"[0,240]",Moderado,,,,0,Açores,AÇORES,4204,10640.77,5927,293,212,191,144,134,278,469,681,974,55.7,9.15,6.4,4.41
17-02-2021,VILA DA PRAIA DA VITÓRIA,8,1,38,"[0,240]",Moderado,,,,8,Açores,AÇORES,4302,16127.06,21317,1133,789,619,436,336,772,1391,2180,3313,132.18,20.54,13.52,8.63
17-02-2021,PROENÇA-A-NOVA,13,1,178,"[0,240]",Moderado,,,,13,Centro,CASTELO BRANCO,0508,39539.96,7298,508,465,389,400,560,960,1349,1814,2322,18.46,5.87,4.59,3.41
17-02-2021,REDONDO,14,1,220,"[0,240]",Moderado,,,,14,Alentejo,ÉVORA,0710,36950.87,6353,349,325,288,288,354,642,930,1255,1604,17.19,4.34,3.4,2.52
17-02-2021,REGUENGOS DE MONSARAZ,29,2,290,"[240,480]",Elevado,,,,29,Alentejo,ÉVORA,0711,46399.72,10015,602,511,455,462,473,935,1390,1901,2503,21.58,5.39,4.1,3.0
17-02-2021,RESENDE,229,16,2259,"[960,Max]",Extremamente Elevado,,,,229,Norte,VISEU,1813,12334.93,10137,560,493,448,433,422,855,1303,1796,2356,82.18,19.1,14.56,10.56
17-02-2021,RIBEIRA BRAVA,43,3,346,"[240,480]",Elevado,,,,43,Madeira,MADEIRA,3107,6544.88,12435,648,500,411,311,287,598,1009,1509,2157,189.99,32.96,23.06,15.42
17-02-2021,RIBEIRA DE PENA,7,0,116,"[0,240]",Moderado,,,,7,Norte,VILA REAL,1709,21745.98,6016,371,301,290,310,368,678,968,1269,1640,27.66,7.54,5.84,4.45
17-02-2021,RIBEIRA GRANDE,74,5,226,"[0,240]",Moderado,,,,74,Açores,AÇORES,4205,18015.13,32811,1163,689,512,345,253,598,1110,1799,2962,182.13,16.44,9.99,6.16
17-02-2021,RIO MAIOR,283,20,1389,"[960,Max]",Extremamente Elevado,,,,283,Lisboa e Vale do Tejo,SANTARÉM,1414,27276.45,20379,1251,1144,941,795,648,1443,2384,3528,4779,74.71,17.52,12.93,8.74
17-02-2021,SABROSA,7,0,118,"[0,240]",Moderado,,,,7,Norte,VILA REAL,1710,15692.45,5918,393,314,304,302,350,652,956,1270,1663,37.71,10.6,8.09,6.09
17-02-2021,SABUGAL,67,5,633,"[480,960]",Muito Elevado,,,,67,Centro,GUARDA,0911,82269.82,10585,724,707,694,796,1009,1805,2499,3206,3930,12.87,4.78,3.9,3.04
17-02-2021,SALVATERRA DE MAGOS,111,8,521,"[480,960]",Muito Elevado,,,,111,Lisboa e Vale do Tejo,SANTARÉM,1415,24393.2,21295,1275,1181,1060,799,772,1571,2631,3812,5087,87.3,20.85,15.63,10.79
17-02-2021,SANTA COMBA DÃO,33,2,316,"[240,480]",Elevado,,,,33,Centro,VISEU,1814,11194.77,10452,732,684,569,538,464,1002,1571,2255,2987,93.36,26.68,20.14,14.03
17-02-2021,SANTA CRUZ,193,14,426,"[240,480]",Elevado,,,,193,Madeira,MADEIRA,3108,8150.28,45281,1817,1301,974,716,523,1239,2213,3514,5331,555.6,65.41,43.12,27.15
17-02-2021,SANTA CRUZ DA GRACIOSA,0,0,0,"[0,240]",Moderado,,,,0,Açores,AÇORES,4401,6065.78,4208,228,180,163,124,145,269,432,612,840,69.37,13.85,10.09,7.12
17-02-2021,SANTA CRUZ DAS FLORES,0,0,0,"[0,240]",Moderado,,,,0,Açores,AÇORES,4802,7091.44,2165,125,98,74,56,51,107,181,279,404,30.53,5.7,3.93,2.55
17-02-2021,SANTA MARIA DA FEIRA,561,40,405,"[240,480]",Elevado,,,,561,Norte,AVEIRO,0109,21587.65,138636,8182,6743,4771,3856,3079,6935,11706,18449,26631,642.19,123.36,85.46,54.22
17-02-2021,SANTA MARTA DE PENAGUIÃO,5,0,76,"[0,240]",Moderado,,,,5,Norte,VILA REAL,1711,6928.13,6599,483,373,337,316,317,633,970,1343,1826,95.25,26.36,19.39,14.0
17-02-2021,SANTANA,8,1,119,"[0,240]",Moderado,,,,8,Madeira,MADEIRA,3109,9547.3,6711,418,353,343,282,277,559,902,1255,1673,70.29,17.52,13.15,9.45
17-02-2021,SANTARÉM,404,29,704,"[480,960]",Muito Elevado,,,,404,Lisboa e Vale do Tejo,SANTARÉM,1416,55253.58,57421,3654,3441,2760,2466,2206,4672,7432,10873,14527,103.92,26.29,19.68,13.45
17-02-2021,SANTIAGO DO CACÉM,93,7,323,"[240,480]",Elevado,,,,93,Alentejo,SETÚBAL,1509,105969.29,28791,2144,1689,1472,1295,1215,2510,3982,5671,7815,27.17,7.37,5.35,3.76
17-02-2021,SANTO TIRSO,223,16,328,"[240,480]",Elevado,,,,223,Norte,PORTO,1314,13655.52,68055,4911,3935,2761,2257,1810,4067,6828,10763,15674,498.35,114.78,78.82,50.0
17-02-2021,SÃO BRÁS DE ALPORTEL,26,2,250,"[240,480]",Elevado,,,,26,Algarve,FARO,0812,15336.92,10416,596,468,467,404,401,805,1272,1740,2336,67.91,15.23,11.35,8.29
17-02-2021,SÃO JOÃO DA MADEIRA,135,10,615,"[480,960]",Muito Elevado,,,,135,Norte,AVEIRO,0116,794.3,21958,1347,1069,796,601,593,1194,1990,3059,4406,2765.49,554.91,385.26,250.63
17-02-2021,SÃO JOÃO DA PESQUEIRA,58,4,814,"[480,960]",Muito Elevado,,,,58,Norte,VISEU,1815,26610.85,7125,417,330,294,328,328,656,950,1280,1697,26.77,6.38,4.81,3.57
17-02-2021,SÃO PEDRO DO SUL,106,8,688,"[480,960]",Muito Elevado,,,,106,Centro,VISEU,1816,34895.09,15403,990,962,861,759,909,1668,2529,3491,4481,44.14,12.84,10.0,7.25
17-02-2021,SÃO ROQUE DO PICO,0,0,0,"[0,240]",Moderado,,,,0,Açores,AÇORES,4603,14236.1,3266,199,141,93,96,113,209,302,443,642,22.94,4.51,3.11,2.12
17-02-2021,SÃO VICENTE,2,0,39,"[0,240]",Moderado,,,,2,Madeira,MADEIRA,3110,7883.71,5143,272,264,266,225,280,505,771,1035,1307,65.23,16.58,13.13,9.78
17-02-2021,SARDOAL,4,0,107,"[0,240]",Moderado,,,,4,Lisboa e Vale do Tejo,SANTARÉM,1417,9214.72,3741,227,178,148,165,248,413,561,739,966,40.6,10.48,8.02,6.09
17-02-2021,SÁTÃO,55,4,475,"[240,480]",Elevado,,,,55,Centro,VISEU,1817,20194.11,11580,765,671,515,465,476,941,1456,2127,2892,57.34,14.32,10.53,7.21
17-02-2021,SEIA,118,8,531,"[480,960]",Muito Elevado,,,,118,Centro,GUARDA,0912,43568.83,22234,1807,1589,1238,1122,721,1843,3081,4670,6477,51.03,14.87,10.72,7.07
17-02-2021,SEIXAL,1107,79,660,"[480,960]",Muito Elevado,,,,1107,Lisboa e Vale do Tejo,SETÚBAL,1510,9545.17,167752,10586,9270,6661,4391,2930,7321,13982,23252,33838,1757.49,354.51,243.6,146.49
17-02-2021,SERNANCELHE,54,4,1001,"[960,Max]",Extremamente Elevado,,,,54,Norte,VISEU,1818,22861.22,5396,305,293,286,273,260,533,819,1112,1417,23.6,6.2,4.86,3.58
17-02-2021,SERPA,89,6,622,"[480,960]",Muito Elevado,,,,89,Alentejo,BEJA,0213,110563.34,14304,903,761,719,697,626,1323,2042,2803,3706,12.94,3.35,2.54,1.85
17-02-2021,SERTÃ,70,5,480,"[480,960]",Muito Elevado,,,,70,Centro,CASTELO BRANCO,0509,44673.17,14577,870,779,790,767,1020,1787,2577,3356,4226,32.63,9.46,7.51,5.77
17-02-2021,SESIMBRA,400,29,771,"[480,960]",Muito Elevado,,,,400,Lisboa e Vale do Tejo,SETÚBAL,1511,19571.75,51858,2400,2321,1853,1257,1083,2340,4193,6514,8914,264.96,45.54,33.28,21.42
17-02-2021,SETÚBAL,1235,88,1073,"[960,Max]",Extremamente Elevado,,,,1235,Lisboa e Vale do Tejo,SETÚBAL,1512,23032.5,115126,7425,6929,5075,3775,2655,6430,11505,18434,25859,499.83,112.27,80.03,49.95
17-02-2021,SEVER DO VOUGA,69,5,609,"[480,960]",Muito Elevado,,,,69,Centro,AVEIRO,0117,12987.56,11331,766,637,568,540,567,1107,1675,2312,3078,87.24,23.7,17.8,12.9
17-02-2021,SILVES,147,11,406,"[240,480]",Elevado,,,,147,Algarve,FARO,0813,68006.23,36226,2137,1869,1610,1423,1600,3023,4633,6502,8639,53.27,12.7,9.56,6.81
17-02-2021,SINES,54,4,394,"[240,480]",Elevado,,,,54,Alentejo,SETÚBAL,1513,20330.17,13715,888,791,551,416,268,684,1235,2026,2914,67.46,14.33,9.97,6.07
17-02-2021,SINTRA,3268,233,835,"[480,960]",Muito Elevado,,,,3268,Lisboa e Vale do Tejo,LISBOA,1111,31922.73,391402,20490,18316,13545,9137,7284,16421,29966,48282,68772,1226.08,215.43,151.25,93.87
17-02-2021,SOBRAL DE MONTE AGRAÇO,66,5,620,"[480,960]",Muito Elevado,,,,66,Lisboa e Vale do Tejo,LISBOA,1112,5210.32,10651,564,507,352,272,212,484,836,1343,1907,204.43,36.6,25.78,16.05
17-02-2021,SOURE,110,8,643,"[480,960]",Muito Elevado,,,,110,Centro,COIMBRA,0615,26506.07,17120,1173,1142,1004,883,987,1870,2874,4016,5189,64.59,19.58,15.15,10.84
17-02-2021,SOUSEL,38,3,861,"[480,960]",Muito Elevado,,,,38,Alentejo,PORTALEGRE,1215,27932.18,4412,261,274,208,302,292,594,802,1076,1337,15.8,4.79,3.85,2.87
17-02-2021,TÁBUA,58,4,510,"[480,960]",Muito Elevado,,,,58,Centro,COIMBRA,0616,19978.58,11368,729,584,524,430,464,894,1418,2002,2731,56.9,13.67,10.02,7.1
17-02-2021,TABUAÇO,12,1,199,"[0,240]",Moderado,,,,12,Norte,VISEU,1819,13385.67,6033,372,314,217,282,363,645,862,1176,1548,45.07,11.56,8.79,6.44
17-02-2021,TAROUCA,45,3,577,"[480,960]",Muito Elevado,,,,45,Norte,VISEU,1820,10008.49,7804,405,335,313,277,324,601,914,1249,1654,77.98,16.53,12.48,9.13
17-02-2021,TAVIRA,51,4,208,"[0,240]",Moderado,,,,51,Algarve,FARO,0814,60696.7,24530,1493,1415,1252,1066,1277,2343,3595,5010,6503,40.41,10.71,8.25,5.92
17-02-2021,TERRAS DE BOURO,23,2,362,"[240,480]",Elevado,,,,23,Norte,BRAGA,0310,27746.07,6361,391,372,296,319,340,659,955,1327,1718,22.93,6.19,4.78,3.44
17-02-2021,TOMAR,178,13,484,"[480,960]",Muito Elevado,,,,178,Lisboa e Vale do Tejo,SANTARÉM,1418,35120.44,36748,2403,2189,1868,1853,1822,3675,5543,7732,10135,104.64,28.86,22.02,15.78
17-02-2021,TONDELA,109,8,414,"[240,480]",Elevado,,,,109,Centro,VISEU,1821,37121.73,26357,1768,1722,1518,1475,1417,2892,4410,6132,7900,71.0,21.28,16.52,11.88
17-02-2021,TORRE DE MONCORVO,11,1,143,"[0,240]",Moderado,,,,11,Norte,BRAGANÇA,0409,53155.67,7695,556,478,488,551,719,1270,1758,2236,2792,14.48,5.25,4.21,3.31
17-02-2021,TORRES NOVAS,63,4,180,"[0,240]",Moderado,,,,63,Lisboa e Vale do Tejo,SANTARÉM,1419,26999.68,34933,2324,1979,1738,1406,1475,2881,4619,6598,8922,129.38,33.04,24.44,17.11
17-02-2021,TORRES VEDRAS,380,27,484,"[480,960]",Muito Elevado,,,,380,Lisboa e Vale do Tejo,LISBOA,1113,40714.89,78530,4513,3945,3447,2628,2104,4732,8179,12124,16637,192.88,40.86,29.78,20.09
17-02-2021,TRANCOSO,32,2,361,"[240,480]",Elevado,,,,32,Centro,GUARDA,0913,36152.47,8875,581,557,542,586,496,1082,1624,2181,2762,24.55,7.64,6.03,4.49
17-02-2021,TROFA,103,7,268,"[240,480]",Elevado,,,,103,Norte,PORTO,1318,7201.76,38418,2336,1894,1231,939,684,1623,2854,4748,7084,533.44,98.36,65.93,39.63
17-02-2021,VAGOS,42,3,185,"[0,240]",Moderado,,,,42,Centro,AVEIRO,0118,16491.5,22740,1320,1205,922,784,724,1508,2430,3635,4955,137.89,30.04,22.04,14.73
17-02-2021,VALE DE CAMBRA,90,6,422,"[240,480]",Elevado,,,,90,Norte,AVEIRO,0119,14733.47,21327,1491,1363,1005,831,798,1629,2634,3997,5488,144.76,37.25,27.13,17.88
17-02-2021,VALENÇA,55,4,414,"[240,480]",Elevado,,,,55,Norte,VIANA DO CASTELO,1608,11712.86,13290,867,791,582,582,503,1085,1667,2458,3325,113.46,28.39,20.99,14.23
17-02-2021,VALONGO,191,14,196,"[0,240]",Moderado,,,,191,Norte,PORTO,1315,7512.45,97444,5629,4696,3207,2462,1829,4291,7498,12194,17823,1297.18,237.26,162.33,99.81
17-02-2021,VALPAÇOS,40,3,270,"[240,480]",Elevado,,,,40,Norte,VILA REAL,1712,54873.93,14818,1217,1118,999,928,997,1925,2924,4042,5259,27.0,9.58,7.37,5.33
17-02-2021,VELAS,3,0,59,"[0,240]",Moderado,,,,3,Açores,AÇORES,4502,11738.38,5093,278,208,166,153,113,266,432,640,918,43.39,7.82,5.45,3.68
17-02-2021,VENDAS NOVAS,43,3,382,"[240,480]",Elevado,,,,43,Alentejo,ÉVORA,0712,22238.88,11255,677,768,655,501,532,1033,1688,2456,3133,50.61,14.09,11.04,7.59
17-02-2021,VIANA DO ALENTEJO,17,1,330,"[240,480]",Elevado,,,,17,Alentejo,ÉVORA,0713,39367.29,5145,245,208,235,210,214,424,659,867,1112,13.07,2.82,2.2,1.67
17-02-2021,VIANA DO CASTELO,423,30,501,"[480,960]",Muito Elevado,,,,423,Norte,VIANA DO CASTELO,1609,31902.01,84417,5470,4433,3591,3061,2982,6043,9634,14067,19537,264.61,61.24,44.09,30.2
17-02-2021,VIDIGUEIRA,14,1,254,"[240,480]",Elevado,,,,14,Alentejo,BEJA,0214,31661.09,5510,300,248,215,233,275,508,723,971,1271,17.4,4.01,3.07,2.28
17-02-2021,VIEIRA DO MINHO,53,4,448,"[240,480]",Elevado,,,,53,Norte,BRAGA,0311,21644.35,11842,703,594,525,548,482,1030,1555,2149,2852,54.71,13.18,9.93,7.18
17-02-2021,VILA DE REI,23,2,692,"[480,960]",Muito Elevado,,,,23,Centro,CASTELO BRANCO,0510,19154.6,3323,169,128,172,247,302,549,721,849,1018,17.35,5.31,4.43,3.76
17-02-2021,VILA DO BISPO,4,0,78,"[0,240]",Moderado,,,,4,Algarve,FARO,0815,17906.06,5154,302,302,314,232,233,465,779,1081,1383,28.78,7.72,6.04,4.35
17-02-2021,VILA DO CONDE,271,19,339,"[240,480]",Elevado,,,,271,Norte,PORTO,1316,14902.77,79899,4726,3875,2819,2070,1743,3813,6632,10507,15233,536.13,102.21,70.5,44.5
17-02-2021,VILA DO PORTO,3,0,53,"[0,240]",Moderado,,,,3,Açores,AÇORES,4101,9688.74,5616,274,212,135,96,123,219,354,566,840,57.96,8.67,5.84,3.65
17-02-2021,VILA FLOR,50,4,827,"[480,960]",Muito Elevado,,,,50,Norte,BRAGANÇA,0410,26581.14,6044,429,362,422,294,331,625,1047,1409,1838,22.74,6.91,5.3,3.94
17-02-2021,VILA FRANCA DE XIRA,1080,77,761,"[480,960]",Muito Elevado,,,,1080,Lisboa e Vale do Tejo,LISBOA,1114,31819.39,141957,8501,6852,4869,3425,2472,5897,10766,17618,26119,446.14,82.09,55.37,33.84
17-02-2021,VILA FRANCA DO CAMPO,1,0,9,"[0,240]",Moderado,,,,1,Açores,AÇORES,4206,7796.82,11051,450,344,248,217,154,371,619,963,1413,141.73,18.12,12.35,7.94
17-02-2021,VILA NOVA DA BARQUINHA,13,1,174,"[0,240]",Moderado,,,,13,Lisboa e Vale do Tejo,SANTARÉM,1420,4952.97,7461,415,406,392,364,338,702,1094,1500,1915,150.64,38.66,30.28,22.09
17-02-2021,VILA NOVA DE CERVEIRA,68,5,763,"[480,960]",Muito Elevado,,,,68,Norte,VIANA DO CASTELO,1610,10846.66,8910,531,444,410,384,334,718,1128,1572,2103,82.14,19.39,14.49,10.4
17-02-2021,VILA NOVA DE FAMALICÃO,495,35,376,"[240,480]",Elevado,,,,495,Norte,BRAGA,0312,20159.26,131676,7817,6164,4202,3282,2749,6031,10233,16397,24214,653.19,120.12,81.34,50.76
17-02-2021,VILA NOVA DE FOZ CÔA,30,2,461,"[240,480]",Elevado,,,,30,Centro,GUARDA,0914,39815.18,6503,442,385,390,398,429,827,1217,1602,2044,16.33,5.13,4.02,3.06
17-02-2021,VILA NOVA DE GAIA,940,67,313,"[240,480]",Elevado,,,,940,Norte,PORTO,1317,16846.43,300472,18349,15568,10972,8224,6281,14505,25477,41045,59394,1783.64,352.57,243.65,151.23
17-02-2021,VILA NOVA DE PAIVA,14,1,299,"[240,480]",Elevado,,,,14,Centro,VISEU,1822,17553.28,4687,289,272,233,217,241,458,691,963,1252,26.7,7.13,5.49,3.94
17-02-2021,VILA NOVA DE POIARES,29,2,418,"[240,480]",Elevado,,,,29,Centro,COIMBRA,0617,8445.3,6939,380,284,262,235,182,417,679,963,1343,82.17,15.9,11.4,8.04
17-02-2021,VILA POUCA DE AGUIAR,40,3,334,"[240,480]",Elevado,,,,40,Norte,VILA REAL,1713,43706.62,11961,860,817,733,601,627,1228,1961,2778,3638,27.37,8.32,6.36,4.49
17-02-2021,VILA REAL,138,10,276,"[240,480]",Elevado,,,,138,Norte,VILA REAL,1714,37880.28,49962,3025,2498,2065,1579,1466,3045,5110,7608,10633,131.9,28.07,20.08,13.49
17-02-2021,VILA REAL DE SANTO ANTÓNIO,169,12,901,"[480,960]",Muito Elevado,,,,169,Algarve,FARO,0816,6125.0,18749,1172,1069,811,569,586,1155,1966,3035,4207,306.11,68.69,49.55,32.1
17-02-2021,VILA VELHA DE RÓDÃO,3,0,95,"[0,240]",Moderado,,,,3,Centro,CASTELO BRANCO,0511,32991.16,3144,209,229,180,283,306,589,769,998,1207,9.53,3.66,3.03,2.33
17-02-2021,VILA VERDE,123,9,262,"[240,480]",Elevado,,,,123,Norte,BRAGA,0313,22866.52,46911,2365,2063,1667,1494,1437,2931,4598,6661,9026,205.15,39.47,29.13,20.11
17-02-2021,VILA VIÇOSA,39,3,509,"[480,960]",Muito Elevado,,,,39,Alentejo,ÉVORA,0714,19485.89,7656,487,379,342,345,324,669,1011,1390,1877,39.29,9.63,7.13,5.19
17-02-2021,VIMIOSO,11,1,273,"[240,480]",Elevado,,,,11,Norte,BRAGANÇA,0411,48158.51,4023,274,230,261,293,335,628,889,1119,1393,8.35,2.89,2.32,1.85
17-02-2021,VINHAIS,14,1,181,"[0,240]",Moderado,,,,14,Norte,BRAGANÇA,0412,69475.09,7746,599,577,636,641,815,1456,2092,2669,3268,11.15,4.7,3.84,3.01
17-02-2021,VISEU,553,40,569,"[480,960]",Muito Elevado,,,,553,Centro,VISEU,1823,50710.14,97249,5769,5038,4140,3158,2710,5868,10008,15046,20815,191.77,41.05,29.67,19.74
17-02-2021,VIZELA,51,4,213,"[0,240]",Moderado,,,,51,Norte,BRAGA,0314,2469.83,23897,1258,928,655,509,371,880,1535,2463,3721,967.49,150.65,99.72,62.15
17-02-2021,VOUZELA,36,3,374,"[240,480]",Elevado,,,,36,Centro,VISEU,1824,19369.46,9619,626,605,554,532,507,1039,1593,2198,2824,49.66,14.58,11.35,8.22
24-02-2021,ABRANTES,27,2,77,"[0,240]",Moderado,,,,27,Lisboa e Vale do Tejo,SANTARÉM,1401,71469.08,35130,2473,2213,1730,1748,2021,3769,5499,7712,10185,49.15,14.25,10.79,7.69
24-02-2021,ÁGUEDA,101,7,219,"[0,240]",Moderado,,,,101,Centro,AVEIRO,0101,33527.44,46075,3237,2713,2090,1635,1496,3131,5221,7934,11171,137.43,33.32,23.66,15.57
24-02-2021,AGUIAR DA BEIRA,4,0,86,"[0,240]",Moderado,,,,4,Centro,GUARDA,0901,20676.57,4652,304,281,235,239,148,387,622,903,1207,22.5,5.84,4.37,3.01
24-02-2021,ALANDROAL,8,1,160,"[0,240]",Moderado,,,,8,Alentejo,ÉVORA,0701,54267.81,4992,307,256,296,299,377,676,972,1228,1535,9.2,2.83,2.26,1.79
24-02-2021,ALBERGARIA-A-VELHA,100,7,414,"[240,480]",Elevado,,,,100,Centro,AVEIRO,0102,15882.5,24144,1550,1298,996,687,680,1367,2363,3661,5211,152.02,32.81,23.05,14.88
24-02-2021,ALBUFEIRA,86,6,207,"[0,240]",Moderado,,,,86,Algarve,FARO,0801,14066.42,41528,2067,1717,1425,985,858,1843,3268,4985,7052,295.24,50.14,35.44,23.23
24-02-2021,ALCÁCER DO SAL,38,3,326,"[240,480]",Elevado,,,,38,Alentejo,SETÚBAL,1501,149987.3,11659,884,814,623,623,602,1225,1848,2662,3546,7.77,2.36,1.77,1.23
24-02-2021,ALCANENA,35,2,273,"[240,480]",Elevado,,,,35,Lisboa e Vale do Tejo,SANTARÉM,1402,12732.86,12809,891,744,628,536,588,1124,1752,2496,3387,100.6,26.6,19.6,13.76
24-02-2021,ALCOBAÇA,69,5,129,"[0,240]",Moderado,,,,69,Lisboa e Vale do Tejo,LEIRIA,1001,40814.09,53555,3420,2927,2466,2059,1676,3735,6201,9128,12548,131.22,30.74,22.36,15.19
24-02-2021,ALCOCHETE,50,4,253,"[240,480]",Elevado,,,,50,Lisboa e Vale do Tejo,SETÚBAL,1502,12836.48,19787,857,834,691,476,447,923,1614,2448,3305,154.15,25.75,19.07,12.57
24-02-2021,ALCOUTIM,1,0,46,"[0,240]",Moderado,,,,1,Algarve,FARO,0802,57536.33,2159,191,188,163,190,267,457,620,808,999,3.75,1.74,1.4,1.08
24-02-2021,ALENQUER,148,11,336,"[240,480]",Elevado,,,,148,Lisboa e Vale do Tejo,LISBOA,1101,30421.92,44052,2298,2062,1629,1330,1155,2485,4114,6176,8474,144.8,27.85,20.3,13.52
24-02-2021,ALFÂNDEGA DA FÉ,1,0,22,"[0,240]",Moderado,,,,1,Norte,BRAGANÇA,0401,32194.64,4550,325,277,301,274,325,599,900,1177,1502,14.13,4.67,3.66,2.8
24-02-2021,ALIJÓ,25,2,235,"[0,240]",Moderado,,,,25,Norte,VILA REAL,1701,29759.89,10625,766,687,635,542,666,1208,1843,2530,3296,35.7,11.08,8.5,6.19
24-02-2021,ALJEZUR,1,0,18,"[0,240]",Moderado,,,,1,Algarve,FARO,0803,32349.95,5594,316,336,335,320,410,730,1065,1401,1717,17.29,5.31,4.33,3.29
24-02-2021,ALJUSTREL,51,4,618,"[480,960]",Muito Elevado,,,,51,Alentejo,BEJA,0201,45847.41,8247,635,521,443,347,358,705,1148,1669,2304,17.99,5.03,3.64,2.5
24-02-2021,ALMADA,563,40,333,"[240,480]",Elevado,,,,563,Lisboa e Vale do Tejo,SETÚBAL,1503,7000.89,169039,10469,9777,7876,6144,5111,11255,19131,28908,39377,2414.5,562.45,412.91,273.26
24-02-2021,ALMEIDA,20,1,343,"[240,480]",Elevado,,,,20,Centro,GUARDA,0902,51798.46,5830,441,419,396,458,393,851,1247,1666,2107,11.26,4.07,3.22,2.41
24-02-2021,ALMEIRIM,69,5,306,"[240,480]",Elevado,,,,69,Lisboa e Vale do Tejo,SANTARÉM,1403,22212.05,22546,1342,1353,1106,866,843,1709,2815,4168,5510,101.5,24.81,18.76,12.67
24-02-2021,ALMODÔVAR,4,0,59,"[0,240]",Moderado,,,,4,Alentejo,BEJA,0202,77788.03,6725,414,443,396,373,328,701,1097,1540,1954,8.65,2.51,1.98,1.41
24-02-2021,ALPIARÇA,25,2,354,"[240,480]",Elevado,,,,25,Lisboa e Vale do Tejo,SANTARÉM,1404,9536.33,7059,515,486,363,333,274,607,970,1456,1971,74.02,20.67,15.27,10.17
24-02-2021,ALTER DO CHÃO,1,0,32,"[0,240]",Moderado,,,,1,Alentejo,PORTALEGRE,1201,36206.62,3165,201,163,136,208,187,395,531,694,895,8.74,2.47,1.92,1.47
24-02-2021,ALVAIÁZERE,22,2,333,"[240,480]",Elevado,,,,22,Centro,LEIRIA,1002,16047.76,6597,419,389,346,406,539,945,1291,1680,2099,41.11,13.08,10.47,8.04
24-02-2021,ALVITO,3,0,121,"[0,240]",Moderado,,,,3,Alentejo,BEJA,0203,26485.32,2477,145,110,105,111,89,200,305,415,560,9.35,2.11,1.57,1.15
24-02-2021,AMADORA,679,49,369,"[240,480]",Elevado,,,,679,Lisboa e Vale do Tejo,LISBOA,1115,2378.47,184106,11186,10936,8780,6460,5890,12350,21130,32066,43252,7742.05,1818.84,1348.44,888.56
24-02-2021,AMARANTE,101,7,190,"[0,240]",Moderado,,,,101,Norte,PORTO,1301,30133.15,53193,3086,2413,1812,1643,1311,2954,4766,7179,10265,176.53,34.07,23.82,15.82
24-02-2021,AMARES,34,2,188,"[0,240]",Moderado,,,,34,Norte,BRAGA,0301,8195.41,18129,1001,829,622,489,524,1013,1635,2464,3465,221.22,42.28,30.07,19.95
24-02-2021,ANADIA,59,4,216,"[0,240]",Moderado,,,,59,Centro,AVEIRO,0103,21663.48,27258,1931,1698,1376,1208,1262,2470,3846,5544,7475,125.83,34.51,25.59,17.75
24-02-2021,ANGRA DO HEROÍSMO,0,0,0,"[0,240]",Moderado,,,,0,Açores,AÇORES,4301,23899.66,33807,2006,1473,1122,768,635,1403,2525,3998,6004,141.45,25.12,16.73,10.56
24-02-2021,ANSIÃO,42,3,349,"[240,480]",Elevado,,,,42,Centro,LEIRIA,1003,17609.42,12039,727,709,646,694,530,1224,1870,2579,3306,68.37,18.77,14.65,10.62
24-02-2021,ARCOS DE VALDEVEZ,41,3,196,"[0,240]",Moderado,,,,41,Norte,VIANA DO CASTELO,1601,44759.64,20926,1329,1338,1282,1343,1515,2858,4140,5478,6807,46.75,15.21,12.24,9.25
24-02-2021,ARGANIL,35,3,318,"[240,480]",Elevado,,,,35,Centro,COIMBRA,0601,33283.93,11014,672,648,612,559,596,1155,1767,2415,3087,33.09,9.27,7.26,5.31
24-02-2021,ARMAMAR,6,0,104,"[0,240]",Moderado,,,,6,Norte,VISEU,1801,11723.73,5769,357,305,309,285,310,595,904,1209,1566,49.21,13.36,10.31,7.71
24-02-2021,AROUCA,66,5,319,"[240,480]",Elevado,,,,66,Norte,AVEIRO,0104,32910.52,20720,1306,1047,753,683,683,1366,2119,3166,4472,62.96,13.59,9.62,6.44
24-02-2021,ARRAIOLOS,38,3,548,"[480,960]",Muito Elevado,,,,38,Alentejo,ÉVORA,0702,68374.55,6928,435,384,283,367,480,847,1130,1514,1949,10.13,2.85,2.21,1.65
24-02-2021,ARRONCHES,50,4,1773,"[960,Max]",Extremamente Elevado,,,,50,Alentejo,PORTALEGRE,1202,31464.72,2820,155,142,162,187,179,366,528,670,825,8.96,2.62,2.13,1.68
24-02-2021,ARRUDA DOS VINHOS,45,3,292,"[240,480]",Elevado,,,,45,Lisboa e Vale do Tejo,LISBOA,1102,7795.93,15412,738,738,562,509,438,947,1509,2247,2985,197.69,38.29,28.82,19.36
24-02-2021,AVEIRO,183,13,232,"[0,240]",Moderado,,,,183,Centro,AVEIRO,0105,19757.57,78734,4520,4004,3050,2250,2103,4353,7403,11407,15927,398.49,80.61,57.73,37.47
24-02-2021,AVIS,3,0,71,"[0,240]",Moderado,,,,3,Alentejo,PORTALEGRE,1203,60596.51,4247,315,225,206,251,273,524,730,955,1270,7.01,2.1,1.58,1.2
24-02-2021,AZAMBUJA,33,2,145,"[0,240]",Moderado,,,,33,Lisboa e Vale do Tejo,LISBOA,1103,26265.65,22716,1322,1171,1070,798,618,1416,2486,3657,4979,86.48,18.96,13.92,9.46
24-02-2021,BAIÃO,46,3,245,"[240,480]",Elevado,,,,46,Norte,PORTO,1302,17452.83,18748,1070,862,714,686,725,1411,2125,2987,4057,107.42,23.25,17.11,12.18
24-02-2021,BARCELOS,230,16,198,"[0,240]",Moderado,,,,230,Norte,BRAGA,0302,37890.14,116187,6721,5325,3619,2991,2562,5553,9172,14497,21218,306.64,56.0,38.26,24.21
24-02-2021,BARRANCOS,13,1,796,"[480,960]",Muito Elevado,,,,13,Alentejo,BEJA,0204,16841.73,1634,90,65,65,94,61,155,220,285,375,9.7,2.23,1.69,1.31
24-02-2021,BARREIRO,253,18,337,"[240,480]",Elevado,,,,253,Lisboa e Vale do Tejo,SETÚBAL,1504,3639.07,75147,5194,5565,4459,3105,1767,4872,9331,14896,20090,2065.05,552.07,409.34,256.42
24-02-2021,BATALHA,29,2,182,"[0,240]",Moderado,,,,29,Centro,LEIRIA,1004,10341.6,15963,873,762,649,529,549,1078,1727,2489,3362,154.35,32.51,24.07,16.7
24-02-2021,BEJA,58,4,173,"[0,240]",Moderado,,,,58,Alentejo,BEJA,0205,114647.55,33579,2005,1840,1386,1272,1039,2311,3697,5537,7542,29.29,6.58,4.83,3.22
24-02-2021,BELMONTE,15,1,234,"[0,240]",Moderado,,,,15,Centro,CASTELO BRANCO,0501,11875.91,6398,444,321,325,310,355,665,990,1311,1755,53.87,14.78,11.04,8.34
24-02-2021,BENAVENTE,100,7,327,"[240,480]",Elevado,,,,100,Lisboa e Vale do Tejo,SANTARÉM,1405,52138.39,30602,1468,1376,1141,876,643,1519,2660,4036,5504,58.69,10.56,7.74,5.1
24-02-2021,BOMBARRAL,59,4,470,"[240,480]",Elevado,,,,59,Lisboa e Vale do Tejo,LEIRIA,1005,9128.55,12558,875,714,561,491,429,920,1481,2195,3070,137.56,33.63,24.04,16.22
24-02-2021,BORBA,7,1,104,"[0,240]",Moderado,,,,7,Alentejo,ÉVORA,0703,14518.65,6736,430,375,279,436,392,828,1107,1482,1912,46.39,13.17,10.21,7.62
24-02-2021,BOTICAS,17,1,340,"[240,480]",Elevado,,,,17,Norte,VILA REAL,1702,32195.66,4998,347,306,311,305,380,685,996,1302,1649,15.52,5.12,4.04,3.09
24-02-2021,BRAGA,250,18,137,"[0,240]",Moderado,,,,250,Norte,BRAGA,0303,18339.95,182679,10029,7963,5241,4320,3671,7991,13232,21195,31224,996.07,170.25,115.57,72.15
24-02-2021,BRAGANÇA,69,5,205,"[0,240]",Moderado,,,,69,Norte,BRAGANÇA,0402,117357.27,33607,2402,1855,1652,1393,1163,2556,4208,6063,8465,28.64,7.21,5.17,3.59
24-02-2021,CABECEIRAS DE BASTO,19,1,122,"[0,240]",Moderado,,,,19,Norte,BRAGA,0304,24182.16,15628,774,594,544,575,574,1149,1693,2287,3061,64.63,12.66,9.46,7.0
24-02-2021,CADAVAL,46,3,336,"[240,480]",Elevado,,,,46,Lisboa e Vale do Tejo,LISBOA,1104,17489.3,13673,813,796,756,621,625,1246,2002,2798,3611,78.18,20.65,16.0,11.45
24-02-2021,CALDAS DA RAINHA,108,8,208,"[0,240]",Moderado,,,,108,Lisboa e Vale do Tejo,LEIRIA,1006,25569.47,51912,3035,2684,2186,1899,1705,3604,5790,8474,11509,203.03,45.01,33.14,22.64
24-02-2021,CALHETA,13,1,120,"[0,240]",Moderado,,,,13,Madeira,MADEIRA,3101,11150.43,10867,576,497,507,399,415,814,1321,1818,2394,97.46,21.47,16.3,11.85
24-02-2021,CALHETA (AÇORES),1,0,31,"[0,240]",Moderado,,,,1,Açores,AÇORES,4501,12626.4,3184,215,159,141,139,122,261,402,561,776,25.22,6.15,4.44,3.18
24-02-2021,CÂMARA DE LOBOS,229,16,680,"[480,960]",Muito Elevado,,,,229,Madeira,MADEIRA,3102,5216.67,33675,1396,1059,834,545,381,926,1760,2819,4215,645.49,80.79,54.03,33.74
24-02-2021,CAMINHA,36,3,227,"[0,240]",Moderado,,,,36,Norte,VIANA DO CASTELO,1602,13652.14,15877,1046,944,818,646,656,1302,2120,3064,4110,116.3,30.11,22.44,15.53
24-02-2021,CAMPO MAIOR,10,1,127,"[0,240]",Moderado,,,,10,Alentejo,PORTALEGRE,1204,24720.16,7874,471,364,351,279,327,606,957,1321,1792,31.85,7.25,5.34,3.87
24-02-2021,CANTANHEDE,102,7,291,"[240,480]",Elevado,,,,102,Centro,COIMBRA,0602,39088.02,35011,2346,2096,1880,1709,1451,3160,5040,7136,9482,89.57,24.26,18.26,12.89
24-02-2021,CARRAZEDA DE ANSIÃES,12,1,212,"[0,240]",Moderado,,,,12,Norte,BRAGANÇA,0403,27924.09,5666,424,389,391,312,465,777,1168,1557,1981,20.29,7.09,5.58,4.18
24-02-2021,CARREGAL DO SAL,17,1,183,"[0,240]",Moderado,,,,17,Centro,VISEU,1802,11689.21,9271,587,562,486,462,376,838,1324,1886,2473,79.31,21.16,16.13,11.33
24-02-2021,CARTAXO,57,4,239,"[0,240]",Moderado,,,,57,Lisboa e Vale do Tejo,SANTARÉM,1406,15817.28,23843,1415,1376,1142,861,632,1493,2635,4011,5426,150.74,34.3,25.36,16.66
24-02-2021,CASCAIS,743,53,348,"[240,480]",Elevado,,,,743,Lisboa e Vale do Tejo,LISBOA,1105,9740.17,213608,12151,11444,8680,6469,5248,11717,20397,31841,43992,2193.1,451.66,326.91,209.41
24-02-2021,CASTANHEIRA DE PÊRA,13,1,497,"[480,960]",Muito Elevado,,,,13,Centro,LEIRIA,1007,6677.45,2614,233,195,157,190,187,377,534,729,962,39.15,14.41,10.92,8.0
24-02-2021,CASTELO BRANCO,59,4,113,"[0,240]",Moderado,,,,59,Centro,CASTELO BRANCO,0502,143819.15,51987,3528,3042,2499,2229,2225,4454,6953,9995,13523,36.15,9.4,6.95,4.83
24-02-2021,CASTELO DE PAIVA,30,2,194,"[0,240]",Moderado,,,,30,Norte,AVEIRO,0106,11500.53,15454,881,697,545,420,431,851,1396,2093,2974,134.37,25.86,18.2,12.14
24-02-2021,CASTELO DE VIDE,9,1,308,"[240,480]",Elevado,,,,9,Alentejo,PORTALEGRE,1205,26491.24,2919,204,173,179,147,170,317,496,669,873,11.02,3.3,2.53,1.87
24-02-2021,CASTRO DAIRE,32,2,231,"[0,240]",Moderado,,,,32,Centro,VISEU,1803,37904.13,13823,942,857,765,732,773,1505,2270,3127,4069,36.47,10.74,8.25,5.99
24-02-2021,CASTRO MARIM,29,2,465,"[240,480]",Elevado,,,,29,Algarve,FARO,0804,30084.37,6237,370,345,334,322,344,666,1000,1345,1715,20.73,5.7,4.47,3.32
24-02-2021,CASTRO VERDE,34,2,489,"[480,960]",Muito Elevado,,,,34,Alentejo,BEJA,0206,56944.23,6949,437,347,303,275,227,502,805,1152,1589,12.2,2.79,2.02,1.41
24-02-2021,CELORICO DA BEIRA,1,0,14,"[0,240]",Moderado,,,,1,Centro,GUARDA,0903,24721.63,6928,430,416,363,369,535,904,1267,1683,2113,28.02,8.55,6.81,5.12
24-02-2021,CELORICO DE BASTO,16,1,84,"[0,240]",Moderado,,,,16,Norte,BRAGA,0305,18107.02,19040,1001,802,668,728,729,1457,2125,2927,3928,105.15,21.69,16.17,11.74
24-02-2021,CHAMUSCA,11,1,120,"[0,240]",Moderado,,,,11,Lisboa e Vale do Tejo,SANTARÉM,1407,74600.54,9197,629,583,553,465,579,1044,1597,2180,2809,12.33,3.77,2.92,2.14
24-02-2021,CHAVES,59,4,150,"[0,240]",Moderado,,,,59,Norte,VILA REAL,1703,59122.95,39343,2676,2429,1991,1886,1918,3804,5795,8224,10900,66.54,18.44,13.91,9.8
24-02-2021,CINFÃES,45,3,247,"[240,480]",Elevado,,,,45,Norte,VISEU,1804,23928.76,18244,1067,902,779,734,758,1492,2271,3173,4240,76.24,17.72,13.26,9.49
24-02-2021,COIMBRA,644,46,480,"[480,960]",Muito Elevado,,,,644,Centro,COIMBRA,0603,31939.94,134166,9489,8734,6353,5139,5074,10213,16566,25300,34789,420.06,108.92,79.21,51.87
24-02-2021,CONDEIXA-A-NOVA,38,3,214,"[0,240]",Moderado,,,,38,Centro,COIMBRA,0604,13867.47,17733,871,809,717,583,490,1073,1790,2599,3470,127.88,25.02,18.74,12.91
24-02-2021,CONSTÂNCIA,5,0,124,"[0,240]",Moderado,,,,5,Lisboa e Vale do Tejo,SANTARÉM,1408,8036.58,4030,211,183,187,148,155,303,490,673,884,50.14,11.0,8.37,6.1
24-02-2021,CORUCHE,33,2,189,"[0,240]",Moderado,,,,33,Lisboa e Vale do Tejo,SANTARÉM,1409,111572.03,17471,1294,1090,1095,1096,1019,2115,3210,4300,5594,15.66,5.01,3.85,2.88
24-02-2021,CORVO,0,0,0,"[0,240]",Moderado,,,,0,Açores,AÇORES,4901,1711.45,464,22,21,11,13,19,32,43,64,86,27.12,5.03,3.74,2.51
24-02-2021,COVILHÃ,98,7,209,"[0,240]",Moderado,,,,98,Centro,CASTELO BRANCO,0503,55560.06,46787,3533,2998,2365,2111,2193,4304,6669,9667,13200,84.21,23.76,17.4,12.0
24-02-2021,CRATO,6,0,192,"[0,240]",Moderado,,,,6,Alentejo,PORTALEGRE,1206,39806.88,3129,229,258,163,182,228,410,573,831,1060,7.86,2.66,2.09,1.44
24-02-2021,CUBA,10,1,218,"[0,240]",Moderado,,,,10,Alentejo,BEJA,0207,17208.72,4595,255,233,206,190,143,333,539,772,1027,26.7,5.97,4.49,3.13
24-02-2021,ELVAS,22,2,107,"[0,240]",Moderado,,,,22,Alentejo,PORTALEGRE,1207,63128.86,20528,1057,1145,902,852,810,1662,2564,3709,4766,32.52,7.55,5.88,4.06
24-02-2021,ENTRONCAMENTO,19,1,88,"[0,240]",Moderado,,,,19,Lisboa e Vale do Tejo,SANTARÉM,1410,1372.81,21558,1066,930,868,695,592,1287,2155,3085,4151,1570.14,302.33,224.69,156.96
24-02-2021,ESPINHO,89,6,302,"[240,480]",Elevado,,,,89,Norte,AVEIRO,0107,2105.68,29516,2205,1993,1430,1177,960,2137,3567,5560,7765,1401.52,368.71,264.01,169.37
24-02-2021,ESPOSENDE,83,6,243,"[240,480]",Elevado,,,,83,Norte,BRAGA,0306,9540.98,34177,1831,1522,1095,894,723,1617,2712,4234,6065,358.21,63.57,44.38,28.42
24-02-2021,ESTARREJA,40,3,154,"[0,240]",Moderado,,,,40,Centro,AVEIRO,0108,10817.33,26006,1503,1399,1106,953,728,1681,2787,4186,5689,240.42,52.59,38.7,25.76
24-02-2021,ESTREMOZ,46,3,361,"[240,480]",Elevado,,,,46,Alentejo,ÉVORA,0704,51379.95,12728,789,613,697,786,877,1663,2360,2973,3762,24.77,7.32,5.79,4.59
24-02-2021,ÉVORA,72,5,137,"[0,240]",Moderado,,,,72,Alentejo,ÉVORA,0705,130707.58,52428,3569,2852,2176,1966,1803,3769,5945,8797,12366,40.11,9.46,6.73,4.55
24-02-2021,FAFE,56,4,117,"[0,240]",Moderado,,,,56,Norte,BRAGA,0307,21908.11,48060,3044,2455,1679,1403,1208,2611,4290,6745,9789,219.37,44.68,30.79,19.58
24-02-2021,FARO,135,10,221,"[0,240]",Moderado,,,,135,Algarve,FARO,0805,20256.79,61015,3847,3364,2604,2055,1601,3656,6260,9624,13471,301.2,66.5,47.51,30.9
24-02-2021,FELGUEIRAS,94,7,167,"[0,240]",Moderado,,,,94,Norte,PORTO,1303,11573.75,56422,2951,2302,1601,1316,973,2289,3890,6192,9143,487.49,79.0,53.5,33.61
24-02-2021,FERREIRA DO ALENTEJO,69,5,880,"[480,960]",Muito Elevado,,,,69,Alentejo,BEJA,0208,64820.68,7845,515,414,372,343,345,688,1060,1474,1989,12.1,3.07,2.27,1.64
24-02-2021,FERREIRA DO ZÊZERE,16,1,201,"[0,240]",Moderado,,,,16,Lisboa e Vale do Tejo,SANTARÉM,1411,19038.03,7959,470,370,416,465,456,921,1337,1707,2177,41.81,11.44,8.97,7.02
24-02-2021,FIGUEIRA DA FOZ,167,12,284,"[240,480]",Elevado,,,,167,Centro,COIMBRA,0605,37905.26,58747,4032,3597,2887,2495,2043,4538,7425,11022,15054,154.98,39.72,29.08,19.59
24-02-2021,FIGUEIRA DE CASTELO RODRIGO,3,0,54,"[0,240]",Moderado,,,,3,Centro,GUARDA,0904,50857.46,5584,347,352,290,352,391,743,1033,1385,1732,10.98,3.41,2.72,2.03
24-02-2021,FIGUEIRÓ DOS VINHOS,3,0,54,"[0,240]",Moderado,,,,3,Centro,LEIRIA,1008,17344.0,5568,402,386,322,309,351,660,982,1368,1770,32.1,10.21,7.89,5.66
24-02-2021,FORNOS DE ALGODRES,1,0,22,"[0,240]",Moderado,,,,1,Centro,GUARDA,0905,13145.05,4528,261,218,247,256,232,488,735,953,1214,34.45,9.24,7.25,5.59
24-02-2021,FREIXO DE ESPADA À CINTA,4,0,121,"[0,240]",Moderado,,,,4,Norte,BRAGANÇA,0404,24414.29,3298,211,177,231,196,189,385,616,793,1004,13.51,4.11,3.25,2.52
24-02-2021,FRONTEIRA,5,0,168,"[0,240]",Moderado,,,,5,Alentejo,PORTALEGRE,1208,24859.58,2974,213,182,149,156,168,324,473,655,868,11.96,3.49,2.63,1.9
24-02-2021,FUNCHAL,498,36,479,"[240,480]",Elevado,,,,498,Madeira,MADEIRA,3103,7616.2,104024,6382,5086,3643,2821,1990,4811,8454,13540,19922,1365.86,261.58,177.78,111.0
24-02-2021,FUNDÃO,59,4,223,"[0,240]",Moderado,,,,59,Centro,CASTELO BRANCO,0504,70019.79,26495,1781,1464,1432,1357,1643,3000,4432,5896,7677,37.84,10.96,8.42,6.33
24-02-2021,GAVIÃO,4,0,123,"[0,240]",Moderado,,,,4,Alentejo,PORTALEGRE,1209,29459.45,3263,189,186,222,263,293,556,778,964,1153,11.08,3.91,3.27,2.64
24-02-2021,GÓIS,7,1,184,"[0,240]",Moderado,,,,7,Centro,COIMBRA,0606,26330.19,3805,235,199,240,233,244,477,717,916,1151,14.45,4.37,3.48,2.72
24-02-2021,GOLEGÃ,13,1,243,"[240,480]",Elevado,,,,13,Lisboa e Vale do Tejo,SANTARÉM,1412,8431.67,5339,356,299,281,243,255,498,779,1078,1434,63.32,17.01,12.78,9.24
24-02-2021,GONDOMAR,257,18,155,"[0,240]",Moderado,,,,257,Norte,PORTO,1304,13191.76,165985,10555,8755,6222,4450,3364,7814,14036,22791,33346,1258.22,252.77,172.76,106.4
24-02-2021,GOUVEIA,55,4,444,"[240,480]",Elevado,,,,55,Centro,GUARDA,0906,30061.17,12387,871,931,780,783,810,1593,2373,3304,4175,41.21,13.89,10.99,7.89
24-02-2021,GRÂNDOLA,62,4,424,"[240,480]",Elevado,,,,62,Alentejo,SETÚBAL,1505,82593.66,14639,834,834,708,688,672,1360,2068,2902,3736,17.72,4.52,3.51,2.5
24-02-2021,GUARDA,56,4,144,"[0,240]",Moderado,,,,56,Centro,GUARDA,0907,71209.58,38969,2477,2041,1686,1415,1474,2889,4575,6616,9093,54.72,12.77,9.29,6.42
24-02-2021,GUIMARÃES,206,15,135,"[0,240]",Moderado,,,,206,Norte,BRAGA,0308,24099.96,152309,9394,7074,4809,3877,2948,6825,11634,18708,28102,631.99,116.61,77.63,48.27
24-02-2021,HORTA,3,0,21,"[0,240]",Moderado,,,,3,Açores,AÇORES,4701,17305.53,14521,818,658,468,352,302,654,1122,1780,2598,83.91,15.01,10.29,6.48
24-02-2021,IDANHA-A-NOVA,4,0,50,"[0,240]",Moderado,,,,4,Centro,CASTELO BRANCO,0505,141633.51,8043,518,490,519,672,974,1646,2165,2655,3173,5.68,2.24,1.87,1.53
24-02-2021,ÍLHAVO,97,7,251,"[240,480]",Elevado,,,,97,Centro,AVEIRO,0110,7347.55,38699,2227,1943,1444,1193,850,2043,3487,5430,7657,526.66,104.21,73.9,47.46
24-02-2021,LAGOA (FARO),38,3,167,"[0,240]",Moderado,,,,38,Algarve,FARO,0806,8825.45,22762,1314,1168,919,749,670,1419,2338,3506,4820,257.93,54.62,39.73,26.49
24-02-2021,LAGOA,1,0,7,"[0,240]",Moderado,,,,1,Açores,AÇORES,4201,4559.32,14721,536,458,349,238,235,473,822,1280,1816,322.9,39.83,28.08,18.03
24-02-2021,LAGOS,55,4,181,"[0,240]",Moderado,,,,55,Algarve,FARO,0807,21299.27,30374,1744,1434,1247,1053,1029,2082,3329,4763,6507,142.61,30.55,22.36,15.63
24-02-2021,LAJES DAS FLORES,0,0,0,"[0,240]",Moderado,,,,0,Açores,AÇORES,4801,7004.79,1463,88,53,62,46,54,100,162,215,303,20.89,4.33,3.07,2.31
24-02-2021,LAJES DO PICO,1,0,22,"[0,240]",Moderado,,,,1,Açores,AÇORES,4601,15531.09,4490,304,231,223,159,162,321,544,775,1079,28.91,6.95,4.99,3.5
24-02-2021,LAMEGO,125,9,502,"[480,960]",Muito Elevado,,,,125,Norte,VISEU,1805,16542.11,24895,1639,1284,1124,898,783,1681,2805,4089,5728,150.5,34.63,24.72,16.96
24-02-2021,LEIRIA,165,12,132,"[0,240]",Moderado,,,,165,Centro,LEIRIA,1009,56508.83,125267,7389,6366,5090,3902,3159,7061,12151,18517,25906,221.68,45.84,32.77,21.5
24-02-2021,LISBOA,1977,141,388,"[240,480]",Elevado,,,,1977,Lisboa e Vale do Tejo,LISBOA,1106,10005.43,509515,33197,33340,27706,23037,26770,49807,77513,110853,144050,5092.6,1439.78,1107.98,774.74
24-02-2021,LOULÉ,116,8,169,"[0,240]",Moderado,,,,116,Algarve,FARO,0808,76366.91,68697,3890,3350,2780,2358,2251,4609,7389,10739,14629,89.96,19.16,14.06,9.68
24-02-2021,LOURES,729,52,341,"[240,480]",Elevado,,,,729,Lisboa e Vale do Tejo,LISBOA,1107,16723.99,213687,12746,12794,9644,6669,5033,11702,21346,34140,46886,1277.73,280.35,204.14,127.64
24-02-2021,LOURINHÃ,95,7,367,"[240,480]",Elevado,,,,95,Lisboa e Vale do Tejo,LISBOA,1108,14717.2,25855,1584,1243,992,842,645,1487,2479,3722,5306,175.68,36.05,25.29,16.84
24-02-2021,LOUSÃ,73,5,425,"[240,480]",Elevado,,,,73,Centro,COIMBRA,0607,13840.01,17158,946,866,658,528,450,978,1636,2502,3448,123.97,24.91,18.08,11.82
24-02-2021,LOUSADA,41,3,88,"[0,240]",Moderado,,,,41,Norte,PORTO,1305,9608.01,46755,2289,1698,1176,853,621,1474,2650,4348,6637,486.63,69.08,45.25,27.58
24-02-2021,MAÇÃO,5,0,80,"[0,240]",Moderado,,,,5,Lisboa e Vale do Tejo,SANTARÉM,1413,39997.98,6267,386,362,390,440,657,1097,1487,1849,2235,15.67,5.59,4.62,3.72
24-02-2021,MACEDO DE CAVALEIROS,16,1,110,"[0,240]",Moderado,,,,16,Norte,BRAGANÇA,0405,69914.08,14516,1082,889,878,823,938,1761,2639,3528,4610,20.76,6.59,5.05,3.77
24-02-2021,MACHICO,67,5,335,"[240,480]",Elevado,,,,67,Madeira,MADEIRA,3104,6825.1,19981,1197,860,662,455,331,786,1448,2308,3505,292.76,51.36,33.82,21.22
24-02-2021,MADALENA,5,0,85,"[0,240]",Moderado,,,,5,Açores,AÇORES,4602,14712.33,5895,334,256,173,190,179,369,542,798,1132,40.07,7.69,5.42,3.68
24-02-2021,MAFRA,378,27,446,"[240,480]",Elevado,,,,378,Lisboa e Vale do Tejo,LISBOA,1109,29165.5,84816,3613,3334,2839,2089,1899,3988,6827,10161,13774,290.81,47.23,34.84,23.41
24-02-2021,MAIA,131,9,94,"[0,240]",Moderado,,,,131,Norte,PORTO,1306,8293.94,138971,7801,6617,4512,3339,2631,5970,10482,17099,24900,1675.56,300.22,206.16,126.38
24-02-2021,MANGUALDE,25,2,135,"[0,240]",Moderado,,,,25,Centro,VISEU,1806,21925.56,18510,1198,1128,885,852,743,1595,2480,3608,4806,84.42,21.92,16.46,11.31
24-02-2021,MANTEIGAS,57,4,1896,"[960,Max]",Extremamente Elevado,,,,57,Centro,GUARDA,0908,12197.55,3007,258,197,159,167,146,313,472,669,927,24.65,7.6,5.48,3.87
24-02-2021,MARCO DE CANAVESES,82,6,159,"[0,240]",Moderado,,,,82,Norte,PORTO,1307,20188.98,51496,2678,2060,1488,1265,1023,2288,3776,5836,8514,255.07,42.17,28.91,18.7
24-02-2021,MARINHA GRANDE,70,5,182,"[0,240]",Moderado,,,,70,Centro,LEIRIA,1010,18725.19,38508,2365,2302,1638,1359,1058,2417,4055,6357,8722,205.65,46.58,33.95,21.66
24-02-2021,MARVÃO,5,0,166,"[0,240]",Moderado,,,,5,Alentejo,PORTALEGRE,1210,15489.9,3005,198,185,142,197,237,434,576,761,959,19.4,6.19,4.91,3.72
24-02-2021,MATOSINHOS,279,20,159,"[0,240]",Moderado,,,,279,Norte,PORTO,1308,6241.97,175357,11850,9977,7023,5024,3884,8908,15931,25908,37758,2809.31,604.9,415.06,255.22
24-02-2021,MEALHADA,58,4,291,"[240,480]",Elevado,,,,58,Centro,AVEIRO,0111,11065.66,19914,1163,1039,810,828,831,1659,2469,3508,4671,179.96,42.21,31.7,22.31
24-02-2021,MÊDA,6,0,131,"[0,240]",Moderado,,,,6,Centro,GUARDA,0909,28604.92,4587,343,306,290,288,443,731,1021,1327,1670,16.04,5.84,4.64,3.57
24-02-2021,MELGAÇO,18,1,222,"[0,240]",Moderado,,,,18,Norte,VIANA DO CASTELO,1603,23824.58,8093,507,567,578,614,675,1289,1867,2434,2941,33.97,12.34,10.22,7.84
24-02-2021,MÉRTOLA,23,2,374,"[240,480]",Elevado,,,,23,Alentejo,BEJA,0209,129287.34,6142,400,390,378,423,600,1023,1401,1791,2191,4.75,1.69,1.39,1.08
24-02-2021,MESÃO FRIO,1,0,25,"[0,240]",Moderado,,,,1,Norte,VILA REAL,1704,2664.87,3964,265,205,168,157,120,277,445,650,915,148.74,34.33,24.39,16.7
24-02-2021,MIRA,23,2,194,"[0,240]",Moderado,,,,23,Centro,COIMBRA,0608,12403.38,11832,727,729,659,550,466,1016,1675,2404,3131,95.4,25.24,19.38,13.5
24-02-2021,MIRANDA DO CORVO,52,4,409,"[240,480]",Elevado,,,,52,Centro,COIMBRA,0609,12637.79,12708,706,659,568,498,404,902,1470,2129,2835,100.55,22.43,16.85,11.63
24-02-2021,MIRANDA DO DOURO,3,0,44,"[0,240]",Moderado,,,,3,Norte,BRAGANÇA,0406,48718.31,6830,482,429,442,463,470,933,1375,1804,2286,14.02,4.69,3.7,2.82
24-02-2021,MIRANDELA,51,4,234,"[0,240]",Moderado,,,,51,Norte,BRAGANÇA,0407,65895.67,21754,1640,1315,1204,1078,947,2025,3229,4544,6184,33.01,9.38,6.9,4.9
24-02-2021,MOGADOURO,5,0,60,"[0,240]",Moderado,,,,5,Norte,BRAGANÇA,0408,76064.93,8392,589,529,576,630,655,1285,1861,2390,2979,11.03,3.92,3.14,2.45
24-02-2021,MOIMENTA DA BEIRA,29,2,298,"[240,480]",Elevado,,,,29,Norte,VISEU,1807,21996.9,9736,576,514,471,416,461,877,1348,1862,2438,44.26,11.08,8.46,6.13
24-02-2021,MOITA,239,17,371,"[240,480]",Elevado,,,,239,Lisboa e Vale do Tejo,SETÚBAL,1506,5525.98,64407,4226,3646,2623,1801,1425,3226,5849,9495,13721,1165.53,248.3,171.82,105.85
24-02-2021,MONÇÃO,80,6,448,"[240,480]",Elevado,,,,80,Norte,VIANA DO CASTELO,1604,21130.85,17869,1161,1105,1031,1006,972,1978,3009,4114,5275,84.56,24.96,19.47,14.24
24-02-2021,MONCHIQUE,14,1,276,"[240,480]",Elevado,,,,14,Algarve,FARO,0809,39530.43,5077,353,384,321,355,392,747,1068,1452,1805,12.84,4.57,3.67,2.7
24-02-2021,MONDIM DE BASTO,8,1,115,"[0,240]",Moderado,,,,8,Norte,VILA REAL,1705,17207.52,6946,395,300,314,284,283,567,881,1181,1576,40.36,9.16,6.86,5.12
24-02-2021,MONFORTE,10,1,336,"[240,480]",Elevado,,,,10,Alentejo,PORTALEGRE,1211,42024.82,2975,139,115,117,192,168,360,477,592,731,7.08,1.74,1.41,1.14
24-02-2021,MONTALEGRE,5,0,56,"[0,240]",Moderado,,,,5,Norte,VILA REAL,1706,80545.71,8997,699,628,595,603,730,1333,1928,2556,3255,11.17,4.04,3.17,2.39
24-02-2021,MONTEMOR-O-NOVO,14,1,89,"[0,240]",Moderado,,,,14,Alentejo,ÉVORA,0706,123296.65,15647,991,953,868,878,971,1849,2717,3670,4661,12.69,3.78,2.98,2.2
24-02-2021,MONTEMOR-O-VELHO,113,8,448,"[240,480]",Elevado,,,,113,Centro,COIMBRA,0610,22896.23,25224,1496,1397,1217,1057,988,2045,3262,4659,6155,110.17,26.88,20.35,14.25
24-02-2021,MONTIJO,224,16,389,"[240,480]",Elevado,,,,224,Lisboa e Vale do Tejo,SETÚBAL,1507,34861.64,57614,2771,2441,1990,1554,1109,2663,4653,7094,9865,165.26,28.3,20.35,13.35
24-02-2021,MORA,2,0,48,"[0,240]",Moderado,,,,2,Alentejo,ÉVORA,0707,44395.02,4138,336,275,252,238,257,495,747,1022,1358,9.32,3.06,2.3,1.68
24-02-2021,MORTÁGUA,5,0,57,"[0,240]",Moderado,,,,5,Centro,VISEU,1808,25117.82,8803,638,584,535,499,460,959,1494,2078,2716,35.05,10.81,8.27,5.95
24-02-2021,MOURA,54,4,394,"[240,480]",Elevado,,,,54,Alentejo,BEJA,0210,95845.55,13718,817,656,665,542,461,1003,1668,2324,3141,14.31,3.28,2.42,1.74
24-02-2021,MOURÃO,1,0,41,"[0,240]",Moderado,,,,1,Alentejo,ÉVORA,0708,27862.98,2450,139,108,80,104,109,213,293,401,540,8.79,1.94,1.44,1.05
24-02-2021,MURÇA,5,0,92,"[0,240]",Moderado,,,,5,Norte,VILA REAL,1707,18937.11,5463,384,341,307,306,319,625,932,1273,1657,28.85,8.75,6.72,4.92
24-02-2021,MURTOSA,42,3,409,"[240,480]",Elevado,,,,42,Centro,AVEIRO,0112,7308.78,10279,509,473,403,353,409,762,1165,1638,2147,140.63,29.37,22.41,15.94
24-02-2021,NAZARÉ,12,1,85,"[0,240]",Moderado,,,,12,Lisboa e Vale do Tejo,LEIRIA,1011,8243.43,14165,967,903,670,420,396,816,1486,2389,3356,171.84,40.71,28.98,18.03
24-02-2021,NELAS,19,1,146,"[0,240]",Moderado,,,,19,Centro,VISEU,1809,12571.48,12974,924,787,668,604,583,1187,1855,2642,3566,103.21,28.37,21.02,14.76
24-02-2021,NISA,12,1,198,"[0,240]",Moderado,,,,12,Alentejo,PORTALEGRE,1212,57567.84,6061,405,389,355,483,478,961,1316,1705,2110,10.53,3.67,2.96,2.29
24-02-2021,NORDESTE,0,0,0,"[0,240]",Moderado,,,,0,Açores,AÇORES,4202,10146.8,4862,246,180,124,161,162,323,447,627,873,47.92,8.6,6.18,4.41
24-02-2021,ÓBIDOS,25,2,211,"[0,240]",Moderado,,,,25,Lisboa e Vale do Tejo,LEIRIA,1012,14155.44,11850,743,650,574,452,436,888,1462,2112,2855,83.72,20.17,14.92,10.33
24-02-2021,ODEMIRA,74,5,299,"[240,480]",Elevado,,,,74,Alentejo,BEJA,0211,172060.15,24717,1475,1317,1225,1397,1349,2746,3971,5288,6763,14.37,3.93,3.07,2.31
24-02-2021,ODIVELAS,657,47,406,"[240,480]",Elevado,,,,657,Lisboa e Vale do Tejo,LISBOA,1116,2654.36,161774,9562,9038,6952,4641,3812,8453,15405,24443,34005,6095.48,1281.27,920.99,580.44
24-02-2021,OEIRAS,552,39,311,"[240,480]",Elevado,,,,552,Lisboa e Vale do Tejo,LISBOA,1110,4588.31,177408,11580,11575,8566,6211,5855,12066,20632,32207,43787,3866.78,954.38,701.98,449.69
24-02-2021,OLEIROS,6,0,120,"[0,240]",Moderado,,,,6,Centro,CASTELO BRANCO,0506,47109.31,5003,384,341,366,397,487,884,1250,1591,1975,10.62,4.19,3.38,2.65
24-02-2021,OLHÃO,90,6,203,"[0,240]",Moderado,,,,90,Algarve,FARO,0810,13086.38,44405,2455,2309,1689,1342,1268,2610,4299,6608,9063,339.33,69.26,50.5,32.85
24-02-2021,OLIVEIRA DE AZEMÉIS,175,12,265,"[240,480]",Elevado,,,,175,Norte,AVEIRO,0113,16110.41,66011,4155,3614,2794,2183,1738,3921,6715,10329,14484,409.75,89.91,64.12,41.68
24-02-2021,OLIVEIRA DE FRADES,11,1,111,"[0,240]",Moderado,,,,11,Centro,VISEU,1810,14534.62,9936,553,475,438,359,415,774,1212,1687,2240,68.36,15.41,11.61,8.34
24-02-2021,OLIVEIRA DO BAIRRO,56,4,231,"[0,240]",Moderado,,,,56,Centro,AVEIRO,0114,8731.99,24277,1327,1182,999,786,810,1596,2595,3777,5104,278.02,58.45,43.25,29.72
24-02-2021,OLIVEIRA DO HOSPITAL,26,2,135,"[0,240]",Moderado,,,,26,Centro,COIMBRA,0611,23451.66,19253,1161,1097,962,924,960,1884,2846,3943,5104,82.1,21.76,16.81,12.14
24-02-2021,OURÉM,62,4,141,"[0,240]",Moderado,,,,62,Lisboa e Vale do Tejo,SANTARÉM,1421,41668.03,44044,2463,2069,1899,1817,1603,3420,5319,7388,9851,105.7,23.64,17.73,12.77
24-02-2021,OURIQUE,9,1,195,"[0,240]",Moderado,,,,9,Alentejo,BEJA,0212,66331.36,4607,313,287,284,268,227,495,779,1066,1379,6.95,2.08,1.61,1.17
24-02-2021,OVAR,85,6,157,"[0,240]",Moderado,,,,85,Centro,AVEIRO,0115,14770.25,54260,3294,2709,1994,1636,1234,2870,4864,7573,10867,367.37,73.57,51.27,32.93
24-02-2021,PAÇOS DE FERREIRA,58,4,102,"[0,240]",Moderado,,,,58,Norte,PORTO,1309,7099.29,56728,2903,2193,1518,1135,664,1799,3317,5510,8413,799.1,118.51,77.62,46.72
24-02-2021,PALMELA,289,21,450,"[240,480]",Elevado,,,,289,Lisboa e Vale do Tejo,SETÚBAL,1508,46512.01,64269,3402,3244,2635,1846,1391,3237,5872,9116,12518,138.18,26.91,19.6,12.62
24-02-2021,PAMPILHOSA DA SERRA,8,1,198,"[0,240]",Moderado,,,,8,Centro,COIMBRA,0612,39646.24,4037,238,254,295,339,423,762,1057,1311,1549,10.18,3.91,3.31,2.67
24-02-2021,PAREDES,114,8,132,"[0,240]",Moderado,,,,114,Norte,PORTO,1310,15675.69,86067,4272,3532,2412,1717,1258,2975,5387,8919,13191,549.04,84.15,56.9,34.36
24-02-2021,PAREDES DE COURA,18,1,211,"[0,240]",Moderado,,,,18,Norte,VIANA DO CASTELO,1605,13818.59,8535,466,528,407,465,515,980,1387,1915,2381,61.76,17.23,13.86,10.04
24-02-2021,PEDRÓGÃO GRANDE,3,0,88,"[0,240]",Moderado,,,,3,Centro,LEIRIA,1013,12874.75,3410,175,173,196,221,252,473,669,842,1017,26.49,7.9,6.54,5.2
24-02-2021,PENACOVA,47,3,343,"[240,480]",Elevado,,,,47,Centro,COIMBRA,0613,21673.23,13694,968,923,745,621,703,1324,2069,2992,3960,63.18,18.27,13.81,9.55
24-02-2021,PENAFIEL,117,8,168,"[0,240]",Moderado,,,,117,Norte,PORTO,1311,21224.27,69772,3648,2823,2032,1663,1230,2893,4925,7748,11396,328.74,53.69,36.51,23.2
24-02-2021,PENALVA DO CASTELO,10,1,141,"[0,240]",Moderado,,,,10,Centro,VISEU,1811,13433.92,7115,449,457,413,391,426,817,1230,1687,2136,52.96,15.9,12.56,9.16
24-02-2021,PENAMACOR,20,1,421,"[240,480]",Elevado,,,,20,Centro,CASTELO BRANCO,0507,56370.69,4755,262,248,273,451,633,1084,1357,1605,1867,8.44,3.31,2.85,2.41
24-02-2021,PENEDONO,2,0,77,"[0,240]",Moderado,,,,2,Norte,VISEU,1812,13370.75,2591,172,113,129,156,138,294,423,536,708,19.38,5.3,4.01,3.16
24-02-2021,PENELA,37,3,686,"[480,960]",Muito Elevado,,,,37,Centro,COIMBRA,0614,13480.0,5397,314,324,274,359,344,703,977,1301,1615,40.04,11.98,9.65,7.25
24-02-2021,PENICHE,78,6,294,"[240,480]",Elevado,,,,78,Lisboa e Vale do Tejo,LEIRIA,1014,7754.98,26501,1746,1504,1203,926,707,1633,2836,4340,6086,341.73,78.48,55.96,36.57
24-02-2021,PESO DA RÉGUA,16,1,101,"[0,240]",Moderado,,,,16,Norte,VILA REAL,1708,9486.01,15773,1076,843,650,659,455,1114,1764,2607,3683,166.28,38.83,27.48,18.6
24-02-2021,PINHEL,9,1,106,"[0,240]",Moderado,,,,9,Centro,GUARDA,0910,48452.12,8511,577,566,551,538,689,1227,1778,2344,2921,17.57,6.03,4.84,3.67
24-02-2021,POMBAL,109,8,212,"[0,240]",Moderado,,,,109,Centro,LEIRIA,1015,62600.28,51461,3187,2791,2494,2328,2027,4355,6849,9640,12827,82.21,20.49,15.4,10.94
24-02-2021,PONTA DELGADA,11,1,16,"[0,240]",Moderado,,,,11,Açores,AÇORES,4203,23298.65,67935,3108,2435,1726,1133,902,2035,3761,6196,9304,291.58,39.93,26.59,16.14
24-02-2021,PONTA DO SOL,69,5,803,"[480,960]",Muito Elevado,,,,69,Madeira,MADEIRA,3105,4622.03,8593,319,283,347,208,221,429,776,1059,1378,185.92,29.81,22.91,16.79
24-02-2021,PONTE DA BARCA,26,2,233,"[0,240]",Moderado,,,,26,Norte,VIANA DO CASTELO,1606,18211.37,11180,635,576,517,554,490,1044,1561,2137,2772,61.39,15.22,11.73,8.57
24-02-2021,PONTE DE LIMA,81,6,196,"[0,240]",Moderado,,,,81,Norte,VIANA DO CASTELO,1607,32025.46,41315,2321,2022,1720,1596,1462,3058,4778,6800,9121,129.01,28.48,21.23,14.92
24-02-2021,PONTE DE SOR,9,1,60,"[0,240]",Moderado,,,,9,Alentejo,PORTALEGRE,1213,83971.16,14994,939,800,716,739,831,1570,2286,3086,4025,17.86,4.79,3.68,2.72
24-02-2021,PORTALEGRE,23,2,104,"[0,240]",Moderado,,,,23,Alentejo,PORTALEGRE,1214,44713.64,22172,1577,1351,1137,993,984,1977,3114,4465,6042,49.59,13.51,9.99,6.96
24-02-2021,PORTEL,3,0,51,"[0,240]",Moderado,,,,3,Alentejo,ÉVORA,0709,60100.57,5828,336,358,283,331,305,636,919,1277,1613,9.7,2.68,2.12,1.53
24-02-2021,PORTIMÃO,139,10,251,"[240,480]",Elevado,,,,139,Algarve,FARO,0811,18206.29,55483,3182,2927,2116,1582,1400,2982,5098,8025,11207,304.75,61.56,44.08,28.0
24-02-2021,PORTO,329,24,152,"[0,240]",Moderado,,,,329,Norte,PORTO,1312,4142.02,216606,15790,15193,11280,9409,10044,19453,30733,45926,61716,5229.5,1490.0,1108.79,741.98
24-02-2021,PORTO DE MÓS,44,3,189,"[0,240]",Moderado,,,,44,Centro,LEIRIA,1016,26183.41,23275,1355,1210,1034,888,872,1760,2794,4004,5359,88.89,20.47,15.29,10.67
24-02-2021,PORTO MONIZ,2,0,85,"[0,240]",Moderado,,,,2,Madeira,MADEIRA,3106,8293.38,2342,143,130,95,98,120,218,313,443,586,28.24,7.07,5.34,3.77
24-02-2021,PORTO SANTO,0,0,0,"[0,240]",Moderado,,,,0,Madeira,MADEIRA,3201,4300.7,5202,240,157,134,110,68,178,312,469,709,120.95,16.48,10.9,7.25
24-02-2021,PÓVOA DE LANHOSO,25,2,116,"[0,240]",Moderado,,,,25,Norte,BRAGA,0309,13465.29,21499,1175,909,732,673,624,1297,2029,2938,4113,159.67,30.55,21.82,15.07
24-02-2021,PÓVOA DE VARZIM,113,8,180,"[0,240]",Moderado,,,,113,Norte,PORTO,1313,8220.59,62784,3712,3120,2134,1594,1305,2899,5033,8153,11865,763.7,144.33,99.17,61.22
24-02-2021,POVOAÇÃO,0,0,0,"[0,240]",Moderado,,,,0,Açores,AÇORES,4204,10640.77,5927,293,212,191,144,134,278,469,681,974,55.7,9.15,6.4,4.41
24-02-2021,VILA DA PRAIA DA VITÓRIA,4,0,19,"[0,240]",Moderado,,,,4,Açores,AÇORES,4302,16127.06,21317,1133,789,619,436,336,772,1391,2180,3313,132.18,20.54,13.52,8.63
24-02-2021,PROENÇA-A-NOVA,18,1,247,"[240,480]",Elevado,,,,18,Centro,CASTELO BRANCO,0508,39539.96,7298,508,465,389,400,560,960,1349,1814,2322,18.46,5.87,4.59,3.41
24-02-2021,REDONDO,6,0,94,"[0,240]",Moderado,,,,6,Alentejo,ÉVORA,0710,36950.87,6353,349,325,288,288,354,642,930,1255,1604,17.19,4.34,3.4,2.52
24-02-2021,REGUENGOS DE MONSARAZ,12,1,120,"[0,240]",Moderado,,,,12,Alentejo,ÉVORA,0711,46399.72,10015,602,511,455,462,473,935,1390,1901,2503,21.58,5.39,4.1,3.0
24-02-2021,RESENDE,144,10,1421,"[960,Max]",Extremamente Elevado,,,,144,Norte,VISEU,1813,12334.93,10137,560,493,448,433,422,855,1303,1796,2356,82.18,19.1,14.56,10.56
24-02-2021,RIBEIRA BRAVA,35,2,281,"[240,480]",Elevado,,,,35,Madeira,MADEIRA,3107,6544.88,12435,648,500,411,311,287,598,1009,1509,2157,189.99,32.96,23.06,15.42
24-02-2021,RIBEIRA DE PENA,5,0,83,"[0,240]",Moderado,,,,5,Norte,VILA REAL,1709,21745.98,6016,371,301,290,310,368,678,968,1269,1640,27.66,7.54,5.84,4.45
24-02-2021,RIBEIRA GRANDE,61,4,186,"[0,240]",Moderado,,,,61,Açores,AÇORES,4205,18015.13,32811,1163,689,512,345,253,598,1110,1799,2962,182.13,16.44,9.99,6.16
24-02-2021,RIO MAIOR,161,11,790,"[480,960]",Muito Elevado,,,,161,Lisboa e Vale do Tejo,SANTARÉM,1414,27276.45,20379,1251,1144,941,795,648,1443,2384,3528,4779,74.71,17.52,12.93,8.74
24-02-2021,SABROSA,9,1,152,"[0,240]",Moderado,,,,9,Norte,VILA REAL,1710,15692.45,5918,393,314,304,302,350,652,956,1270,1663,37.71,10.6,8.09,6.09
24-02-2021,SABUGAL,18,1,170,"[0,240]",Moderado,,,,18,Centro,GUARDA,0911,82269.82,10585,724,707,694,796,1009,1805,2499,3206,3930,12.87,4.78,3.9,3.04
24-02-2021,SALVATERRA DE MAGOS,62,4,291,"[240,480]",Elevado,,,,62,Lisboa e Vale do Tejo,SANTARÉM,1415,24393.2,21295,1275,1181,1060,799,772,1571,2631,3812,5087,87.3,20.85,15.63,10.79
24-02-2021,SANTA COMBA DÃO,14,1,134,"[0,240]",Moderado,,,,14,Centro,VISEU,1814,11194.77,10452,732,684,569,538,464,1002,1571,2255,2987,93.36,26.68,20.14,14.03
24-02-2021,SANTA CRUZ,163,12,360,"[240,480]",Elevado,,,,163,Madeira,MADEIRA,3108,8150.28,45281,1817,1301,974,716,523,1239,2213,3514,5331,555.6,65.41,43.12,27.15
24-02-2021,SANTA CRUZ DA GRACIOSA,0,0,0,"[0,240]",Moderado,,,,0,Açores,AÇORES,4401,6065.78,4208,228,180,163,124,145,269,432,612,840,69.37,13.85,10.09,7.12
24-02-2021,SANTA CRUZ DAS FLORES,0,0,0,"[0,240]",Moderado,,,,0,Açores,AÇORES,4802,7091.44,2165,125,98,74,56,51,107,181,279,404,30.53,5.7,3.93,2.55
24-02-2021,SANTA MARIA DA FEIRA,291,21,210,"[0,240]",Moderado,,,,291,Norte,AVEIRO,0109,21587.65,138636,8182,6743,4771,3856,3079,6935,11706,18449,26631,642.19,123.36,85.46,54.22
24-02-2021,SANTA MARTA DE PENAGUIÃO,12,1,182,"[0,240]",Moderado,,,,12,Norte,VILA REAL,1711,6928.13,6599,483,373,337,316,317,633,970,1343,1826,95.25,26.36,19.39,14.0
24-02-2021,SANTANA,9,1,134,"[0,240]",Moderado,,,,9,Madeira,MADEIRA,3109,9547.3,6711,418,353,343,282,277,559,902,1255,1673,70.29,17.52,13.15,9.45
24-02-2021,SANTARÉM,181,13,315,"[240,480]",Elevado,,,,181,Lisboa e Vale do Tejo,SANTARÉM,1416,55253.58,57421,3654,3441,2760,2466,2206,4672,7432,10873,14527,103.92,26.29,19.68,13.45
24-02-2021,SANTIAGO DO CACÉM,69,5,240,"[240,480]",Elevado,,,,69,Alentejo,SETÚBAL,1509,105969.29,28791,2144,1689,1472,1295,1215,2510,3982,5671,7815,27.17,7.37,5.35,3.76
24-02-2021,SANTO TIRSO,105,7,154,"[0,240]",Moderado,,,,105,Norte,PORTO,1314,13655.52,68055,4911,3935,2761,2257,1810,4067,6828,10763,15674,498.35,114.78,78.82,50.0
24-02-2021,SÃO BRÁS DE ALPORTEL,15,1,144,"[0,240]",Moderado,,,,15,Algarve,FARO,0812,15336.92,10416,596,468,467,404,401,805,1272,1740,2336,67.91,15.23,11.35,8.29
24-02-2021,SÃO JOÃO DA MADEIRA,65,5,296,"[240,480]",Elevado,,,,65,Norte,AVEIRO,0116,794.3,21958,1347,1069,796,601,593,1194,1990,3059,4406,2765.49,554.91,385.26,250.63
24-02-2021,SÃO JOÃO DA PESQUEIRA,19,1,267,"[240,480]",Elevado,,,,19,Norte,VISEU,1815,26610.85,7125,417,330,294,328,328,656,950,1280,1697,26.77,6.38,4.81,3.57
24-02-2021,SÃO PEDRO DO SUL,43,3,279,"[240,480]",Elevado,,,,43,Centro,VISEU,1816,34895.09,15403,990,962,861,759,909,1668,2529,3491,4481,44.14,12.84,10.0,7.25
24-02-2021,SÃO ROQUE DO PICO,2,0,61,"[0,240]",Moderado,,,,2,Açores,AÇORES,4603,14236.1,3266,199,141,93,96,113,209,302,443,642,22.94,4.51,3.11,2.12
24-02-2021,SÃO VICENTE,4,0,78,"[0,240]",Moderado,,,,4,Madeira,MADEIRA,3110,7883.71,5143,272,264,266,225,280,505,771,1035,1307,65.23,16.58,13.13,9.78
24-02-2021,SARDOAL,5,0,134,"[0,240]",Moderado,,,,5,Lisboa e Vale do Tejo,SANTARÉM,1417,9214.72,3741,227,178,148,165,248,413,561,739,966,40.6,10.48,8.02,6.09
24-02-2021,SÁTÃO,18,1,155,"[0,240]",Moderado,,,,18,Centro,VISEU,1817,20194.11,11580,765,671,515,465,476,941,1456,2127,2892,57.34,14.32,10.53,7.21
24-02-2021,SEIA,66,5,297,"[240,480]",Elevado,,,,66,Centro,GUARDA,0912,43568.83,22234,1807,1589,1238,1122,721,1843,3081,4670,6477,51.03,14.87,10.72,7.07
24-02-2021,SEIXAL,522,37,311,"[240,480]",Elevado,,,,522,Lisboa e Vale do Tejo,SETÚBAL,1510,9545.17,167752,10586,9270,6661,4391,2930,7321,13982,23252,33838,1757.49,354.51,243.6,146.49
24-02-2021,SERNANCELHE,18,1,334,"[240,480]",Elevado,,,,18,Norte,VISEU,1818,22861.22,5396,305,293,286,273,260,533,819,1112,1417,23.6,6.2,4.86,3.58
24-02-2021,SERPA,30,2,210,"[0,240]",Moderado,,,,30,Alentejo,BEJA,0213,110563.34,14304,903,761,719,697,626,1323,2042,2803,3706,12.94,3.35,2.54,1.85
24-02-2021,SERTÃ,35,2,240,"[240,480]",Elevado,,,,35,Centro,CASTELO BRANCO,0509,44673.17,14577,870,779,790,767,1020,1787,2577,3356,4226,32.63,9.46,7.51,5.77
24-02-2021,SESIMBRA,189,13,364,"[240,480]",Elevado,,,,189,Lisboa e Vale do Tejo,SETÚBAL,1511,19571.75,51858,2400,2321,1853,1257,1083,2340,4193,6514,8914,264.96,45.54,33.28,21.42
24-02-2021,SETÚBAL,512,37,445,"[240,480]",Elevado,,,,512,Lisboa e Vale do Tejo,SETÚBAL,1512,23032.5,115126,7425,6929,5075,3775,2655,6430,11505,18434,25859,499.83,112.27,80.03,49.95
24-02-2021,SEVER DO VOUGA,31,2,274,"[240,480]",Elevado,,,,31,Centro,AVEIRO,0117,12987.56,11331,766,637,568,540,567,1107,1675,2312,3078,87.24,23.7,17.8,12.9
24-02-2021,SILVES,55,4,152,"[0,240]",Moderado,,,,55,Algarve,FARO,0813,68006.23,36226,2137,1869,1610,1423,1600,3023,4633,6502,8639,53.27,12.7,9.56,6.81
24-02-2021,SINES,37,3,270,"[240,480]",Elevado,,,,37,Alentejo,SETÚBAL,1513,20330.17,13715,888,791,551,416,268,684,1235,2026,2914,67.46,14.33,9.97,6.07
24-02-2021,SINTRA,1644,117,420,"[240,480]",Elevado,,,,1644,Lisboa e Vale do Tejo,LISBOA,1111,31922.73,391402,20490,18316,13545,9137,7284,16421,29966,48282,68772,1226.08,215.43,151.25,93.87
24-02-2021,SOBRAL DE MONTE AGRAÇO,58,4,545,"[480,960]",Muito Elevado,,,,58,Lisboa e Vale do Tejo,LISBOA,1112,5210.32,10651,564,507,352,272,212,484,836,1343,1907,204.43,36.6,25.78,16.05
24-02-2021,SOURE,64,5,374,"[240,480]",Elevado,,,,64,Centro,COIMBRA,0615,26506.07,17120,1173,1142,1004,883,987,1870,2874,4016,5189,64.59,19.58,15.15,10.84
24-02-2021,SOUSEL,18,1,408,"[240,480]",Elevado,,,,18,Alentejo,PORTALEGRE,1215,27932.18,4412,261,274,208,302,292,594,802,1076,1337,15.8,4.79,3.85,2.87
24-02-2021,TÁBUA,43,3,378,"[240,480]",Elevado,,,,43,Centro,COIMBRA,0616,19978.58,11368,729,584,524,430,464,894,1418,2002,2731,56.9,13.67,10.02,7.1
24-02-2021,TABUAÇO,5,0,83,"[0,240]",Moderado,,,,5,Norte,VISEU,1819,13385.67,6033,372,314,217,282,363,645,862,1176,1548,45.07,11.56,8.79,6.44
24-02-2021,TAROUCA,19,1,243,"[240,480]",Elevado,,,,19,Norte,VISEU,1820,10008.49,7804,405,335,313,277,324,601,914,1249,1654,77.98,16.53,12.48,9.13
24-02-2021,TAVIRA,31,2,126,"[0,240]",Moderado,,,,31,Algarve,FARO,0814,60696.7,24530,1493,1415,1252,1066,1277,2343,3595,5010,6503,40.41,10.71,8.25,5.92
24-02-2021,TERRAS DE BOURO,17,1,267,"[240,480]",Elevado,,,,17,Norte,BRAGA,0310,27746.07,6361,391,372,296,319,340,659,955,1327,1718,22.93,6.19,4.78,3.44
24-02-2021,TOMAR,102,7,278,"[240,480]",Elevado,,,,102,Lisboa e Vale do Tejo,SANTARÉM,1418,35120.44,36748,2403,2189,1868,1853,1822,3675,5543,7732,10135,104.64,28.86,22.02,15.78
24-02-2021,TONDELA,40,3,152,"[0,240]",Moderado,,,,40,Centro,VISEU,1821,37121.73,26357,1768,1722,1518,1475,1417,2892,4410,6132,7900,71.0,21.28,16.52,11.88
24-02-2021,TORRE DE MONCORVO,1,0,13,"[0,240]",Moderado,,,,1,Norte,BRAGANÇA,0409,53155.67,7695,556,478,488,551,719,1270,1758,2236,2792,14.48,5.25,4.21,3.31
24-02-2021,TORRES NOVAS,33,2,94,"[0,240]",Moderado,,,,33,Lisboa e Vale do Tejo,SANTARÉM,1419,26999.68,34933,2324,1979,1738,1406,1475,2881,4619,6598,8922,129.38,33.04,24.44,17.11
24-02-2021,TORRES VEDRAS,252,18,321,"[240,480]",Elevado,,,,252,Lisboa e Vale do Tejo,LISBOA,1113,40714.89,78530,4513,3945,3447,2628,2104,4732,8179,12124,16637,192.88,40.86,29.78,20.09
24-02-2021,TRANCOSO,20,1,225,"[0,240]",Moderado,,,,20,Centro,GUARDA,0913,36152.47,8875,581,557,542,586,496,1082,1624,2181,2762,24.55,7.64,6.03,4.49
24-02-2021,TROFA,73,5,190,"[0,240]",Moderado,,,,73,Norte,PORTO,1318,7201.76,38418,2336,1894,1231,939,684,1623,2854,4748,7084,533.44,98.36,65.93,39.63
24-02-2021,VAGOS,29,2,128,"[0,240]",Moderado,,,,29,Centro,AVEIRO,0118,16491.5,22740,1320,1205,922,784,724,1508,2430,3635,4955,137.89,30.04,22.04,14.73
24-02-2021,VALE DE CAMBRA,55,4,258,"[240,480]",Elevado,,,,55,Norte,AVEIRO,0119,14733.47,21327,1491,1363,1005,831,798,1629,2634,3997,5488,144.76,37.25,27.13,17.88
24-02-2021,VALENÇA,18,1,135,"[0,240]",Moderado,,,,18,Norte,VIANA DO CASTELO,1608,11712.86,13290,867,791,582,582,503,1085,1667,2458,3325,113.46,28.39,20.99,14.23
24-02-2021,VALONGO,138,10,142,"[0,240]",Moderado,,,,138,Norte,PORTO,1315,7512.45,97444,5629,4696,3207,2462,1829,4291,7498,12194,17823,1297.18,237.26,162.33,99.81
24-02-2021,VALPAÇOS,12,1,81,"[0,240]",Moderado,,,,12,Norte,VILA REAL,1712,54873.93,14818,1217,1118,999,928,997,1925,2924,4042,5259,27.0,9.58,7.37,5.33
24-02-2021,VELAS,0,0,0,"[0,240]",Moderado,,,,0,Açores,AÇORES,4502,11738.38,5093,278,208,166,153,113,266,432,640,918,43.39,7.82,5.45,3.68
24-02-2021,VENDAS NOVAS,21,2,187,"[0,240]",Moderado,,,,21,Alentejo,ÉVORA,0712,22238.88,11255,677,768,655,501,532,1033,1688,2456,3133,50.61,14.09,11.04,7.59
24-02-2021,VIANA DO ALENTEJO,17,1,330,"[240,480]",Elevado,,,,17,Alentejo,ÉVORA,0713,39367.29,5145,245,208,235,210,214,424,659,867,1112,13.07,2.82,2.2,1.67
24-02-2021,VIANA DO CASTELO,196,14,232,"[0,240]",Moderado,,,,196,Norte,VIANA DO CASTELO,1609,31902.01,84417,5470,4433,3591,3061,2982,6043,9634,14067,19537,264.61,61.24,44.09,30.2
24-02-2021,VIDIGUEIRA,4,0,73,"[0,240]",Moderado,,,,4,Alentejo,BEJA,0214,31661.09,5510,300,248,215,233,275,508,723,971,1271,17.4,4.01,3.07,2.28
24-02-2021,VIEIRA DO MINHO,25,2,211,"[0,240]",Moderado,,,,25,Norte,BRAGA,0311,21644.35,11842,703,594,525,548,482,1030,1555,2149,2852,54.71,13.18,9.93,7.18
24-02-2021,VILA DE REI,4,0,120,"[0,240]",Moderado,,,,4,Centro,CASTELO BRANCO,0510,19154.6,3323,169,128,172,247,302,549,721,849,1018,17.35,5.31,4.43,3.76
24-02-2021,VILA DO BISPO,3,0,58,"[0,240]",Moderado,,,,3,Algarve,FARO,0815,17906.06,5154,302,302,314,232,233,465,779,1081,1383,28.78,7.72,6.04,4.35
24-02-2021,VILA DO CONDE,201,14,252,"[240,480]",Elevado,,,,201,Norte,PORTO,1316,14902.77,79899,4726,3875,2819,2070,1743,3813,6632,10507,15233,536.13,102.21,70.5,44.5
24-02-2021,VILA DO PORTO,2,0,36,"[0,240]",Moderado,,,,2,Açores,AÇORES,4101,9688.74,5616,274,212,135,96,123,219,354,566,840,57.96,8.67,5.84,3.65
24-02-2021,VILA FLOR,19,1,314,"[240,480]",Elevado,,,,19,Norte,BRAGANÇA,0410,26581.14,6044,429,362,422,294,331,625,1047,1409,1838,22.74,6.91,5.3,3.94
24-02-2021,VILA FRANCA DE XIRA,527,38,371,"[240,480]",Elevado,,,,527,Lisboa e Vale do Tejo,LISBOA,1114,31819.39,141957,8501,6852,4869,3425,2472,5897,10766,17618,26119,446.14,82.09,55.37,33.84
24-02-2021,VILA FRANCA DO CAMPO,0,0,0,"[0,240]",Moderado,,,,0,Açores,AÇORES,4206,7796.82,11051,450,344,248,217,154,371,619,963,1413,141.73,18.12,12.35,7.94
24-02-2021,VILA NOVA DA BARQUINHA,7,1,94,"[0,240]",Moderado,,,,7,Lisboa e Vale do Tejo,SANTARÉM,1420,4952.97,7461,415,406,392,364,338,702,1094,1500,1915,150.64,38.66,30.28,22.09
24-02-2021,VILA NOVA DE CERVEIRA,50,4,561,"[480,960]",Muito Elevado,,,,50,Norte,VIANA DO CASTELO,1610,10846.66,8910,531,444,410,384,334,718,1128,1572,2103,82.14,19.39,14.49,10.4
24-02-2021,VILA NOVA DE FAMALICÃO,303,22,230,"[0,240]",Moderado,,,,303,Norte,BRAGA,0312,20159.26,131676,7817,6164,4202,3282,2749,6031,10233,16397,24214,653.19,120.12,81.34,50.76
24-02-2021,VILA NOVA DE FOZ CÔA,17,1,261,"[240,480]",Elevado,,,,17,Centro,GUARDA,0914,39815.18,6503,442,385,390,398,429,827,1217,1602,2044,16.33,5.13,4.02,3.06
24-02-2021,VILA NOVA DE GAIA,484,35,161,"[0,240]",Moderado,,,,484,Norte,PORTO,1317,16846.43,300472,18349,15568,10972,8224,6281,14505,25477,41045,59394,1783.64,352.57,243.65,151.23
24-02-2021,VILA NOVA DE PAIVA,3,0,64,"[0,240]",Moderado,,,,3,Centro,VISEU,1822,17553.28,4687,289,272,233,217,241,458,691,963,1252,26.7,7.13,5.49,3.94
24-02-2021,VILA NOVA DE POIARES,20,1,288,"[240,480]",Elevado,,,,20,Centro,COIMBRA,0617,8445.3,6939,380,284,262,235,182,417,679,963,1343,82.17,15.9,11.4,8.04
24-02-2021,VILA POUCA DE AGUIAR,30,2,251,"[240,480]",Elevado,,,,30,Norte,VILA REAL,1713,43706.62,11961,860,817,733,601,627,1228,1961,2778,3638,27.37,8.32,6.36,4.49
24-02-2021,VILA REAL,58,4,116,"[0,240]",Moderado,,,,58,Norte,VILA REAL,1714,37880.28,49962,3025,2498,2065,1579,1466,3045,5110,7608,10633,131.9,28.07,20.08,13.49
24-02-2021,VILA REAL DE SANTO ANTÓNIO,79,6,421,"[240,480]",Elevado,,,,79,Algarve,FARO,0816,6125.0,18749,1172,1069,811,569,586,1155,1966,3035,4207,306.11,68.69,49.55,32.1
24-02-2021,VILA VELHA DE RÓDÃO,0,0,0,"[0,240]",Moderado,,,,0,Centro,CASTELO BRANCO,0511,32991.16,3144,209,229,180,283,306,589,769,998,1207,9.53,3.66,3.03,2.33
24-02-2021,VILA VERDE,56,4,119,"[0,240]",Moderado,,,,56,Norte,BRAGA,0313,22866.52,46911,2365,2063,1667,1494,1437,2931,4598,6661,9026,205.15,39.47,29.13,20.11
24-02-2021,VILA VIÇOSA,14,1,183,"[0,240]",Moderado,,,,14,Alentejo,ÉVORA,0714,19485.89,7656,487,379,342,345,324,669,1011,1390,1877,39.29,9.63,7.13,5.19
24-02-2021,VIMIOSO,8,1,199,"[0,240]",Moderado,,,,8,Norte,BRAGANÇA,0411,48158.51,4023,274,230,261,293,335,628,889,1119,1393,8.35,2.89,2.32,1.85
24-02-2021,VINHAIS,5,0,65,"[0,240]",Moderado,,,,5,Norte,BRAGANÇA,0412,69475.09,7746,599,577,636,641,815,1456,2092,2669,3268,11.15,4.7,3.84,3.01
24-02-2021,VISEU,203,15,209,"[0,240]",Moderado,,,,203,Centro,VISEU,1823,50710.14,97249,5769,5038,4140,3158,2710,5868,10008,15046,20815,191.77,41.05,29.67,19.74
24-02-2021,VIZELA,15,1,63,"[0,240]",Moderado,,,,15,Norte,BRAGA,0314,2469.83,23897,1258,928,655,509,371,880,1535,2463,3721,967.49,150.65,99.72,62.15
24-02-2021,VOUZELA,12,1,125,"[0,240]",Moderado,,,,12,Centro,VISEU,1824,19369.46,9619,626,605,554,532,507,1039,1593,2198,2824,49.66,14.58,11.35,8.22
03-03-2021,ABRANTES,14,1,40,"[0,120]",Baixo a Moderado,,,,14,Lisboa e Vale do Tejo,SANTARÉM,1401,71469.08,35130,2473,2213,1730,1748,2021,3769,5499,7712,10185,49.15,14.25,10.79,7.69
03-03-2021,ÁGUEDA,60,4,130,"[120,240]",Moderado,,,,60,Centro,AVEIRO,0101,33527.44,46075,3237,2713,2090,1635,1496,3131,5221,7934,11171,137.43,33.32,23.66,15.57
03-03-2021,AGUIAR DA BEIRA,2,0,43,"[0,120]",Baixo a Moderado,,,,2,Centro,GUARDA,0901,20676.57,4652,304,281,235,239,148,387,622,903,1207,22.5,5.84,4.37,3.01
03-03-2021,ALANDROAL,4,0,80,"[0,120]",Baixo a Moderado,,,,4,Alentejo,ÉVORA,0701,54267.81,4992,307,256,296,299,377,676,972,1228,1535,9.2,2.83,2.26,1.79
03-03-2021,ALBERGARIA-A-VELHA,57,4,236,"[120,240]",Moderado,,,,57,Centro,AVEIRO,0102,15882.5,24144,1550,1298,996,687,680,1367,2363,3661,5211,152.02,32.81,23.05,14.88
03-03-2021,ALBUFEIRA,60,4,144,"[120,240]",Moderado,,,,60,Algarve,FARO,0801,14066.42,41528,2067,1717,1425,985,858,1843,3268,4985,7052,295.24,50.14,35.44,23.23
03-03-2021,ALCÁCER DO SAL,10,1,86,"[0,120]",Baixo a Moderado,,,,10,Alentejo,SETÚBAL,1501,149987.3,11659,884,814,623,623,602,1225,1848,2662,3546,7.77,2.36,1.77,1.23
03-03-2021,ALCANENA,20,1,156,"[120,240]",Moderado,,,,20,Lisboa e Vale do Tejo,SANTARÉM,1402,12732.86,12809,891,744,628,536,588,1124,1752,2496,3387,100.6,26.6,19.6,13.76
03-03-2021,ALCOBAÇA,45,3,84,"[0,120]",Baixo a Moderado,,,,45,Lisboa e Vale do Tejo,LEIRIA,1001,40814.09,53555,3420,2927,2466,2059,1676,3735,6201,9128,12548,131.22,30.74,22.36,15.19
03-03-2021,ALCOCHETE,37,3,187,"[120,240]",Moderado,,,,37,Lisboa e Vale do Tejo,SETÚBAL,1502,12836.48,19787,857,834,691,476,447,923,1614,2448,3305,154.15,25.75,19.07,12.57
03-03-2021,ALCOUTIM,2,0,93,"[0,120]",Baixo a Moderado,,,,2,Algarve,FARO,0802,57536.33,2159,191,188,163,190,267,457,620,808,999,3.75,1.74,1.4,1.08
03-03-2021,ALENQUER,118,8,268,"[240,480]",Elevado,,,,118,Lisboa e Vale do Tejo,LISBOA,1101,30421.92,44052,2298,2062,1629,1330,1155,2485,4114,6176,8474,144.8,27.85,20.3,13.52
03-03-2021,ALFÂNDEGA DA FÉ,0,0,0,"[0,120]",Baixo a Moderado,,,,0,Norte,BRAGANÇA,0401,32194.64,4550,325,277,301,274,325,599,900,1177,1502,14.13,4.67,3.66,2.8
03-03-2021,ALIJÓ,17,1,160,"[120,240]",Moderado,,,,17,Norte,VILA REAL,1701,29759.89,10625,766,687,635,542,666,1208,1843,2530,3296,35.7,11.08,8.5,6.19
03-03-2021,ALJEZUR,3,0,54,"[0,120]",Baixo a Moderado,,,,3,Algarve,FARO,0803,32349.95,5594,316,336,335,320,410,730,1065,1401,1717,17.29,5.31,4.33,3.29
03-03-2021,ALJUSTREL,18,1,218,"[120,240]",Moderado,,,,18,Alentejo,BEJA,0201,45847.41,8247,635,521,443,347,358,705,1148,1669,2304,17.99,5.03,3.64,2.5
03-03-2021,ALMADA,353,25,209,"[120,240]",Moderado,,,,353,Lisboa e Vale do Tejo,SETÚBAL,1503,7000.89,169039,10469,9777,7876,6144,5111,11255,19131,28908,39377,2414.5,562.45,412.91,273.26
03-03-2021,ALMEIDA,7,0,120,"[120,240]",Moderado,,,,7,Centro,GUARDA,0902,51798.46,5830,441,419,396,458,393,851,1247,1666,2107,11.26,4.07,3.22,2.41
03-03-2021,ALMEIRIM,55,4,244,"[240,480]",Elevado,,,,55,Lisboa e Vale do Tejo,SANTARÉM,1403,22212.05,22546,1342,1353,1106,866,843,1709,2815,4168,5510,101.5,24.81,18.76,12.67
03-03-2021,ALMODÔVAR,2,0,30,"[0,120]",Baixo a Moderado,,,,2,Alentejo,BEJA,0202,77788.03,6725,414,443,396,373,328,701,1097,1540,1954,8.65,2.51,1.98,1.41
03-03-2021,ALPIARÇA,14,1,198,"[120,240]",Moderado,,,,14,Lisboa e Vale do Tejo,SANTARÉM,1404,9536.33,7059,515,486,363,333,274,607,970,1456,1971,74.02,20.67,15.27,10.17
03-03-2021,ALTER DO CHÃO,2,0,63,"[0,120]",Baixo a Moderado,,,,2,Alentejo,PORTALEGRE,1201,36206.62,3165,201,163,136,208,187,395,531,694,895,8.74,2.47,1.92,1.47
03-03-2021,ALVAIÁZERE,2,0,30,"[0,120]",Baixo a Moderado,,,,2,Centro,LEIRIA,1002,16047.76,6597,419,389,346,406,539,945,1291,1680,2099,41.11,13.08,10.47,8.04
03-03-2021,ALVITO,0,0,0,"[0,120]",Baixo a Moderado,,,,0,Alentejo,BEJA,0203,26485.32,2477,145,110,105,111,89,200,305,415,560,9.35,2.11,1.57,1.15
03-03-2021,AMADORA,355,25,193,"[120,240]",Moderado,,,,355,Lisboa e Vale do Tejo,LISBOA,1115,2378.47,184106,11186,10936,8780,6460,5890,12350,21130,32066,43252,7742.05,1818.84,1348.44,888.56
03-03-2021,AMARANTE,62,4,117,"[0,120]",Baixo a Moderado,,,,62,Norte,PORTO,1301,30133.15,53193,3086,2413,1812,1643,1311,2954,4766,7179,10265,176.53,34.07,23.82,15.82
03-03-2021,AMARES,18,1,99,"[0,120]",Baixo a Moderado,,,,18,Norte,BRAGA,0301,8195.41,18129,1001,829,622,489,524,1013,1635,2464,3465,221.22,42.28,30.07,19.95
03-03-2021,ANADIA,36,3,132,"[120,240]",Moderado,,,,36,Centro,AVEIRO,0103,21663.48,27258,1931,1698,1376,1208,1262,2470,3846,5544,7475,125.83,34.51,25.59,17.75
03-03-2021,ANGRA DO HEROÍSMO,1,0,3,"[0,120]",Baixo a Moderado,,,,1,Açores,AÇORES,4301,23899.66,33807,2006,1473,1122,768,635,1403,2525,3998,6004,141.45,25.12,16.73,10.56
03-03-2021,ANSIÃO,14,1,116,"[0,120]",Baixo a Moderado,,,,14,Centro,LEIRIA,1003,17609.42,12039,727,709,646,694,530,1224,1870,2579,3306,68.37,18.77,14.65,10.62
03-03-2021,ARCOS DE VALDEVEZ,27,2,129,"[120,240]",Moderado,,,,27,Norte,VIANA DO CASTELO,1601,44759.64,20926,1329,1338,1282,1343,1515,2858,4140,5478,6807,46.75,15.21,12.24,9.25
03-03-2021,ARGANIL,31,2,281,"[240,480]",Elevado,,,,31,Centro,COIMBRA,0601,33283.93,11014,672,648,612,559,596,1155,1767,2415,3087,33.09,9.27,7.26,5.31
03-03-2021,ARMAMAR,4,0,69,"[0,120]",Baixo a Moderado,,,,4,Norte,VISEU,1801,11723.73,5769,357,305,309,285,310,595,904,1209,1566,49.21,13.36,10.31,7.71
03-03-2021,AROUCA,39,3,188,"[120,240]",Moderado,,,,39,Norte,AVEIRO,0104,32910.52,20720,1306,1047,753,683,683,1366,2119,3166,4472,62.96,13.59,9.62,6.44
03-03-2021,ARRAIOLOS,17,1,245,"[240,480]",Elevado,,,,17,Alentejo,ÉVORA,0702,68374.55,6928,435,384,283,367,480,847,1130,1514,1949,10.13,2.85,2.21,1.65
03-03-2021,ARRONCHES,9,1,319,"[240,480]",Elevado,,,,9,Alentejo,PORTALEGRE,1202,31464.72,2820,155,142,162,187,179,366,528,670,825,8.96,2.62,2.13,1.68
03-03-2021,ARRUDA DOS VINHOS,36,3,234,"[120,240]",Moderado,,,,36,Lisboa e Vale do Tejo,LISBOA,1102,7795.93,15412,738,738,562,509,438,947,1509,2247,2985,197.69,38.29,28.82,19.36
03-03-2021,AVEIRO,123,9,156,"[120,240]",Moderado,,,,123,Centro,AVEIRO,0105,19757.57,78734,4520,4004,3050,2250,2103,4353,7403,11407,15927,398.49,80.61,57.73,37.47
03-03-2021,AVIS,4,0,94,"[0,120]",Baixo a Moderado,,,,4,Alentejo,PORTALEGRE,1203,60596.51,4247,315,225,206,251,273,524,730,955,1270,7.01,2.1,1.58,1.2
03-03-2021,AZAMBUJA,18,1,79,"[0,120]",Baixo a Moderado,,,,18,Lisboa e Vale do Tejo,LISBOA,1103,26265.65,22716,1322,1171,1070,798,618,1416,2486,3657,4979,86.48,18.96,13.92,9.46
03-03-2021,BAIÃO,35,3,187,"[120,240]",Moderado,,,,35,Norte,PORTO,1302,17452.83,18748,1070,862,714,686,725,1411,2125,2987,4057,107.42,23.25,17.11,12.18
03-03-2021,BARCELOS,141,10,121,"[120,240]",Moderado,,,,141,Norte,BRAGA,0302,37890.14,116187,6721,5325,3619,2991,2562,5553,9172,14497,21218,306.64,56.0,38.26,24.21
03-03-2021,BARRANCOS,12,1,734,"[480,960]",Muito Elevado,,,,12,Alentejo,BEJA,0204,16841.73,1634,90,65,65,94,61,155,220,285,375,9.7,2.23,1.69,1.31
03-03-2021,BARREIRO,144,10,192,"[120,240]",Moderado,,,,144,Lisboa e Vale do Tejo,SETÚBAL,1504,3639.07,75147,5194,5565,4459,3105,1767,4872,9331,14896,20090,2065.05,552.07,409.34,256.42
03-03-2021,BATALHA,12,1,75,"[0,120]",Baixo a Moderado,,,,12,Centro,LEIRIA,1004,10341.6,15963,873,762,649,529,549,1078,1727,2489,3362,154.35,32.51,24.07,16.7
03-03-2021,BEJA,62,4,185,"[120,240]",Moderado,,,,62,Alentejo,BEJA,0205,114647.55,33579,2005,1840,1386,1272,1039,2311,3697,5537,7542,29.29,6.58,4.83,3.22
03-03-2021,BELMONTE,7,0,109,"[0,120]",Baixo a Moderado,,,,7,Centro,CASTELO BRANCO,0501,11875.91,6398,444,321,325,310,355,665,990,1311,1755,53.87,14.78,11.04,8.34
03-03-2021,BENAVENTE,57,4,186,"[120,240]",Moderado,,,,57,Lisboa e Vale do Tejo,SANTARÉM,1405,52138.39,30602,1468,1376,1141,876,643,1519,2660,4036,5504,58.69,10.56,7.74,5.1
03-03-2021,BOMBARRAL,60,4,478,"[240,480]",Elevado,,,,60,Lisboa e Vale do Tejo,LEIRIA,1005,9128.55,12558,875,714,561,491,429,920,1481,2195,3070,137.56,33.63,24.04,16.22
03-03-2021,BORBA,2,0,30,"[0,120]",Baixo a Moderado,,,,2,Alentejo,ÉVORA,0703,14518.65,6736,430,375,279,436,392,828,1107,1482,1912,46.39,13.17,10.21,7.62
03-03-2021,BOTICAS,12,1,240,"[240,480]",Elevado,,,,12,Norte,VILA REAL,1702,32195.66,4998,347,306,311,305,380,685,996,1302,1649,15.52,5.12,4.04,3.09
03-03-2021,BRAGA,144,10,79,"[0,120]",Baixo a Moderado,,,,144,Norte,BRAGA,0303,18339.95,182679,10029,7963,5241,4320,3671,7991,13232,21195,31224,996.07,170.25,115.57,72.15
03-03-2021,BRAGANÇA,16,1,48,"[0,120]",Baixo a Moderado,,,,16,Norte,BRAGANÇA,0402,117357.27,33607,2402,1855,1652,1393,1163,2556,4208,6063,8465,28.64,7.21,5.17,3.59
03-03-2021,CABECEIRAS DE BASTO,13,1,83,"[0,120]",Baixo a Moderado,,,,13,Norte,BRAGA,0304,24182.16,15628,774,594,544,575,574,1149,1693,2287,3061,64.63,12.66,9.46,7.0
03-03-2021,CADAVAL,39,3,285,"[240,480]",Elevado,,,,39,Lisboa e Vale do Tejo,LISBOA,1104,17489.3,13673,813,796,756,621,625,1246,2002,2798,3611,78.18,20.65,16.0,11.45
03-03-2021,CALDAS DA RAINHA,61,4,118,"[0,120]",Baixo a Moderado,,,,61,Lisboa e Vale do Tejo,LEIRIA,1006,25569.47,51912,3035,2684,2186,1899,1705,3604,5790,8474,11509,203.03,45.01,33.14,22.64
03-03-2021,CALHETA,9,1,83,"[0,120]",Baixo a Moderado,,,,9,Madeira,MADEIRA,3101,11150.43,10867,576,497,507,399,415,814,1321,1818,2394,97.46,21.47,16.3,11.85
03-03-2021,CALHETA (AÇORES),1,0,31,"[0,120]",Baixo a Moderado,,,,1,Açores,AÇORES,4501,12626.4,3184,215,159,141,139,122,261,402,561,776,25.22,6.15,4.44,3.18
03-03-2021,CÂMARA DE LOBOS,169,12,502,"[480,960]",Muito Elevado,,,,169,Madeira,MADEIRA,3102,5216.67,33675,1396,1059,834,545,381,926,1760,2819,4215,645.49,80.79,54.03,33.74
03-03-2021,CAMINHA,30,2,189,"[120,240]",Moderado,,,,30,Norte,VIANA DO CASTELO,1602,13652.14,15877,1046,944,818,646,656,1302,2120,3064,4110,116.3,30.11,22.44,15.53
03-03-2021,CAMPO MAIOR,7,1,89,"[0,120]",Baixo a Moderado,,,,7,Alentejo,PORTALEGRE,1204,24720.16,7874,471,364,351,279,327,606,957,1321,1792,31.85,7.25,5.34,3.87
03-03-2021,CANTANHEDE,55,4,157,"[120,240]",Moderado,,,,55,Centro,COIMBRA,0602,39088.02,35011,2346,2096,1880,1709,1451,3160,5040,7136,9482,89.57,24.26,18.26,12.89
03-03-2021,CARRAZEDA DE ANSIÃES,9,1,159,"[120,240]",Moderado,,,,9,Norte,BRAGANÇA,0403,27924.09,5666,424,389,391,312,465,777,1168,1557,1981,20.29,7.09,5.58,4.18
03-03-2021,CARREGAL DO SAL,2,0,22,"[0,120]",Baixo a Moderado,,,,2,Centro,VISEU,1802,11689.21,9271,587,562,486,462,376,838,1324,1886,2473,79.31,21.16,16.13,11.33
03-03-2021,CARTAXO,34,2,143,"[120,240]",Moderado,,,,34,Lisboa e Vale do Tejo,SANTARÉM,1406,15817.28,23843,1415,1376,1142,861,632,1493,2635,4011,5426,150.74,34.3,25.36,16.66
03-03-2021,CASCAIS,399,29,187,"[120,240]",Moderado,,,,399,Lisboa e Vale do Tejo,LISBOA,1105,9740.17,213608,12151,11444,8680,6469,5248,11717,20397,31841,43992,2193.1,451.66,326.91,209.41
03-03-2021,CASTANHEIRA DE PÊRA,13,1,497,"[480,960]",Muito Elevado,,,,13,Centro,LEIRIA,1007,6677.45,2614,233,195,157,190,187,377,534,729,962,39.15,14.41,10.92,8.0
03-03-2021,CASTELO BRANCO,20,1,38,"[0,120]",Baixo a Moderado,,,,20,Centro,CASTELO BRANCO,0502,143819.15,51987,3528,3042,2499,2229,2225,4454,6953,9995,13523,36.15,9.4,6.95,4.83
03-03-2021,CASTELO DE PAIVA,44,3,285,"[240,480]",Elevado,,,,44,Norte,AVEIRO,0106,11500.53,15454,881,697,545,420,431,851,1396,2093,2974,134.37,25.86,18.2,12.14
03-03-2021,CASTELO DE VIDE,4,0,137,"[120,240]",Moderado,,,,4,Alentejo,PORTALEGRE,1205,26491.24,2919,204,173,179,147,170,317,496,669,873,11.02,3.3,2.53,1.87
03-03-2021,CASTRO DAIRE,6,0,43,"[0,120]",Baixo a Moderado,,,,6,Centro,VISEU,1803,37904.13,13823,942,857,765,732,773,1505,2270,3127,4069,36.47,10.74,8.25,5.99
03-03-2021,CASTRO MARIM,11,1,176,"[120,240]",Moderado,,,,11,Algarve,FARO,0804,30084.37,6237,370,345,334,322,344,666,1000,1345,1715,20.73,5.7,4.47,3.32
03-03-2021,CASTRO VERDE,6,0,86,"[0,120]",Baixo a Moderado,,,,6,Alentejo,BEJA,0206,56944.23,6949,437,347,303,275,227,502,805,1152,1589,12.2,2.79,2.02,1.41
03-03-2021,CELORICO DA BEIRA,1,0,14,"[0,120]",Baixo a Moderado,,,,1,Centro,GUARDA,0903,24721.63,6928,430,416,363,369,535,904,1267,1683,2113,28.02,8.55,6.81,5.12
03-03-2021,CELORICO DE BASTO,8,1,42,"[0,120]",Baixo a Moderado,,,,8,Norte,BRAGA,0305,18107.02,19040,1001,802,668,728,729,1457,2125,2927,3928,105.15,21.69,16.17,11.74
03-03-2021,CHAMUSCA,6,0,65,"[0,120]",Baixo a Moderado,,,,6,Lisboa e Vale do Tejo,SANTARÉM,1407,74600.54,9197,629,583,553,465,579,1044,1597,2180,2809,12.33,3.77,2.92,2.14
03-03-2021,CHAVES,39,3,99,"[0,120]",Baixo a Moderado,,,,39,Norte,VILA REAL,1703,59122.95,39343,2676,2429,1991,1886,1918,3804,5795,8224,10900,66.54,18.44,13.91,9.8
03-03-2021,CINFÃES,42,3,230,"[120,240]",Moderado,,,,42,Norte,VISEU,1804,23928.76,18244,1067,902,779,734,758,1492,2271,3173,4240,76.24,17.72,13.26,9.49
03-03-2021,COIMBRA,398,28,297,"[240,480]",Elevado,,,,398,Centro,COIMBRA,0603,31939.94,134166,9489,8734,6353,5139,5074,10213,16566,25300,34789,420.06,108.92,79.21,51.87
03-03-2021,CONDEIXA-A-NOVA,32,2,180,"[120,240]",Moderado,,,,32,Centro,COIMBRA,0604,13867.47,17733,871,809,717,583,490,1073,1790,2599,3470,127.88,25.02,18.74,12.91
03-03-2021,CONSTÂNCIA,3,0,74,"[0,120]",Baixo a Moderado,,,,3,Lisboa e Vale do Tejo,SANTARÉM,1408,8036.58,4030,211,183,187,148,155,303,490,673,884,50.14,11.0,8.37,6.1
03-03-2021,CORUCHE,21,1,120,"[120,240]",Moderado,,,,21,Lisboa e Vale do Tejo,SANTARÉM,1409,111572.03,17471,1294,1090,1095,1096,1019,2115,3210,4300,5594,15.66,5.01,3.85,2.88
03-03-2021,CORVO,0,0,0,"[0,120]",Baixo a Moderado,,,,0,Açores,AÇORES,4901,1711.45,464,22,21,11,13,19,32,43,64,86,27.12,5.03,3.74,2.51
03-03-2021,COVILHÃ,51,4,109,"[0,120]",Baixo a Moderado,,,,51,Centro,CASTELO BRANCO,0503,55560.06,46787,3533,2998,2365,2111,2193,4304,6669,9667,13200,84.21,23.76,17.4,12.0
03-03-2021,CRATO,1,0,32,"[0,120]",Baixo a Moderado,,,,1,Alentejo,PORTALEGRE,1206,39806.88,3129,229,258,163,182,228,410,573,831,1060,7.86,2.66,2.09,1.44
03-03-2021,CUBA,7,0,152,"[120,240]",Moderado,,,,7,Alentejo,BEJA,0207,17208.72,4595,255,233,206,190,143,333,539,772,1027,26.7,5.97,4.49,3.13
03-03-2021,ELVAS,26,2,127,"[120,240]",Moderado,,,,26,Alentejo,PORTALEGRE,1207,63128.86,20528,1057,1145,902,852,810,1662,2564,3709,4766,32.52,7.55,5.88,4.06
03-03-2021,ENTRONCAMENTO,12,1,56,"[0,120]",Baixo a Moderado,,,,12,Lisboa e Vale do Tejo,SANTARÉM,1410,1372.81,21558,1066,930,868,695,592,1287,2155,3085,4151,1570.14,302.33,224.69,156.96
03-03-2021,ESPINHO,44,3,149,"[120,240]",Moderado,,,,44,Norte,AVEIRO,0107,2105.68,29516,2205,1993,1430,1177,960,2137,3567,5560,7765,1401.52,368.71,264.01,169.37
03-03-2021,ESPOSENDE,50,4,146,"[120,240]",Moderado,,,,50,Norte,BRAGA,0306,9540.98,34177,1831,1522,1095,894,723,1617,2712,4234,6065,358.21,63.57,44.38,28.42
03-03-2021,ESTARREJA,27,2,104,"[0,120]",Baixo a Moderado,,,,27,Centro,AVEIRO,0108,10817.33,26006,1503,1399,1106,953,728,1681,2787,4186,5689,240.42,52.59,38.7,25.76
03-03-2021,ESTREMOZ,18,1,141,"[120,240]",Moderado,,,,18,Alentejo,ÉVORA,0704,51379.95,12728,789,613,697,786,877,1663,2360,2973,3762,24.77,7.32,5.79,4.59
03-03-2021,ÉVORA,52,4,99,"[0,120]",Baixo a Moderado,,,,52,Alentejo,ÉVORA,0705,130707.58,52428,3569,2852,2176,1966,1803,3769,5945,8797,12366,40.11,9.46,6.73,4.55
03-03-2021,FAFE,38,3,79,"[0,120]",Baixo a Moderado,,,,38,Norte,BRAGA,0307,21908.11,48060,3044,2455,1679,1403,1208,2611,4290,6745,9789,219.37,44.68,30.79,19.58
03-03-2021,FARO,97,7,159,"[120,240]",Moderado,,,,97,Algarve,FARO,0805,20256.79,61015,3847,3364,2604,2055,1601,3656,6260,9624,13471,301.2,66.5,47.51,30.9
03-03-2021,FELGUEIRAS,66,5,117,"[0,120]",Baixo a Moderado,,,,66,Norte,PORTO,1303,11573.75,56422,2951,2302,1601,1316,973,2289,3890,6192,9143,487.49,79.0,53.5,33.61
03-03-2021,FERREIRA DO ALENTEJO,27,2,344,"[240,480]",Elevado,,,,27,Alentejo,BEJA,0208,64820.68,7845,515,414,372,343,345,688,1060,1474,1989,12.1,3.07,2.27,1.64
03-03-2021,FERREIRA DO ZÊZERE,15,1,188,"[120,240]",Moderado,,,,15,Lisboa e Vale do Tejo,SANTARÉM,1411,19038.03,7959,470,370,416,465,456,921,1337,1707,2177,41.81,11.44,8.97,7.02
03-03-2021,FIGUEIRA DA FOZ,116,8,197,"[120,240]",Moderado,,,,116,Centro,COIMBRA,0605,37905.26,58747,4032,3597,2887,2495,2043,4538,7425,11022,15054,154.98,39.72,29.08,19.59
03-03-2021,FIGUEIRA DE CASTELO RODRIGO,1,0,18,"[0,120]",Baixo a Moderado,,,,1,Centro,GUARDA,0904,50857.46,5584,347,352,290,352,391,743,1033,1385,1732,10.98,3.41,2.72,2.03
03-03-2021,FIGUEIRÓ DOS VINHOS,3,0,54,"[0,120]",Baixo a Moderado,,,,3,Centro,LEIRIA,1008,17344.0,5568,402,386,322,309,351,660,982,1368,1770,32.1,10.21,7.89,5.66
03-03-2021,FORNOS DE ALGODRES,0,0,0,"[0,120]",Baixo a Moderado,,,,0,Centro,GUARDA,0905,13145.05,4528,261,218,247,256,232,488,735,953,1214,34.45,9.24,7.25,5.59
03-03-2021,FREIXO DE ESPADA À CINTA,1,0,30,"[0,120]",Baixo a Moderado,,,,1,Norte,BRAGANÇA,0404,24414.29,3298,211,177,231,196,189,385,616,793,1004,13.51,4.11,3.25,2.52
03-03-2021,FRONTEIRA,3,0,101,"[0,120]",Baixo a Moderado,,,,3,Alentejo,PORTALEGRE,1208,24859.58,2974,213,182,149,156,168,324,473,655,868,11.96,3.49,2.63,1.9
03-03-2021,FUNCHAL,725,52,697,"[480,960]",Muito Elevado,,,,725,Madeira,MADEIRA,3103,7616.2,104024,6382,5086,3643,2821,1990,4811,8454,13540,19922,1365.86,261.58,177.78,111.0
03-03-2021,FUNDÃO,21,1,79,"[0,120]",Baixo a Moderado,,,,21,Centro,CASTELO BRANCO,0504,70019.79,26495,1781,1464,1432,1357,1643,3000,4432,5896,7677,37.84,10.96,8.42,6.33
03-03-2021,GAVIÃO,4,0,123,"[120,240]",Moderado,,,,4,Alentejo,PORTALEGRE,1209,29459.45,3263,189,186,222,263,293,556,778,964,1153,11.08,3.91,3.27,2.64
03-03-2021,GÓIS,7,1,184,"[120,240]",Moderado,,,,7,Centro,COIMBRA,0606,26330.19,3805,235,199,240,233,244,477,717,916,1151,14.45,4.37,3.48,2.72
03-03-2021,GOLEGÃ,9,1,169,"[120,240]",Moderado,,,,9,Lisboa e Vale do Tejo,SANTARÉM,1412,8431.67,5339,356,299,281,243,255,498,779,1078,1434,63.32,17.01,12.78,9.24
03-03-2021,GONDOMAR,176,13,106,"[0,120]",Baixo a Moderado,,,,176,Norte,PORTO,1304,13191.76,165985,10555,8755,6222,4450,3364,7814,14036,22791,33346,1258.22,252.77,172.76,106.4
03-03-2021,GOUVEIA,27,2,218,"[120,240]",Moderado,,,,27,Centro,GUARDA,0906,30061.17,12387,871,931,780,783,810,1593,2373,3304,4175,41.21,13.89,10.99,7.89
03-03-2021,GRÂNDOLA,22,2,150,"[120,240]",Moderado,,,,22,Alentejo,SETÚBAL,1505,82593.66,14639,834,834,708,688,672,1360,2068,2902,3736,17.72,4.52,3.51,2.5
03-03-2021,GUARDA,36,3,92,"[0,120]",Baixo a Moderado,,,,36,Centro,GUARDA,0907,71209.58,38969,2477,2041,1686,1415,1474,2889,4575,6616,9093,54.72,12.77,9.29,6.42
03-03-2021,GUIMARÃES,104,7,68,"[0,120]",Baixo a Moderado,,,,104,Norte,BRAGA,0308,24099.96,152309,9394,7074,4809,3877,2948,6825,11634,18708,28102,631.99,116.61,77.63,48.27
03-03-2021,HORTA,2,0,14,"[0,120]",Baixo a Moderado,,,,2,Açores,AÇORES,4701,17305.53,14521,818,658,468,352,302,654,1122,1780,2598,83.91,15.01,10.29,6.48
03-03-2021,IDANHA-A-NOVA,1,0,12,"[0,120]",Baixo a Moderado,,,,1,Centro,CASTELO BRANCO,0505,141633.51,8043,518,490,519,672,974,1646,2165,2655,3173,5.68,2.24,1.87,1.53
03-03-2021,ÍLHAVO,67,5,173,"[120,240]",Moderado,,,,67,Centro,AVEIRO,0110,7347.55,38699,2227,1943,1444,1193,850,2043,3487,5430,7657,526.66,104.21,73.9,47.46
03-03-2021,LAGOA (FARO),32,2,141,"[120,240]",Moderado,,,,32,Algarve,FARO,0806,8825.45,22762,1314,1168,919,749,670,1419,2338,3506,4820,257.93,54.62,39.73,26.49
03-03-2021,LAGOA,6,0,41,"[0,120]",Baixo a Moderado,,,,6,Açores,AÇORES,4201,4559.32,14721,536,458,349,238,235,473,822,1280,1816,322.9,39.83,28.08,18.03
03-03-2021,LAGOS,28,2,92,"[0,120]",Baixo a Moderado,,,,28,Algarve,FARO,0807,21299.27,30374,1744,1434,1247,1053,1029,2082,3329,4763,6507,142.61,30.55,22.36,15.63
03-03-2021,LAJES DAS FLORES,0,0,0,"[0,120]",Baixo a Moderado,,,,0,Açores,AÇORES,4801,7004.79,1463,88,53,62,46,54,100,162,215,303,20.89,4.33,3.07,2.31
03-03-2021,LAJES DO PICO,3,0,67,"[0,120]",Baixo a Moderado,,,,3,Açores,AÇORES,4601,15531.09,4490,304,231,223,159,162,321,544,775,1079,28.91,6.95,4.99,3.5
03-03-2021,LAMEGO,113,8,454,"[240,480]",Elevado,,,,113,Norte,VISEU,1805,16542.11,24895,1639,1284,1124,898,783,1681,2805,4089,5728,150.5,34.63,24.72,16.96
03-03-2021,LEIRIA,79,6,63,"[0,120]",Baixo a Moderado,,,,79,Centro,LEIRIA,1009,56508.83,125267,7389,6366,5090,3902,3159,7061,12151,18517,25906,221.68,45.84,32.77,21.5
03-03-2021,LISBOA,1167,83,229,"[120,240]",Moderado,,,,1167,Lisboa e Vale do Tejo,LISBOA,1106,10005.43,509515,33197,33340,27706,23037,26770,49807,77513,110853,144050,5092.6,1439.78,1107.98,774.74
03-03-2021,LOULÉ,85,6,124,"[120,240]",Moderado,,,,85,Algarve,FARO,0808,76366.91,68697,3890,3350,2780,2358,2251,4609,7389,10739,14629,89.96,19.16,14.06,9.68
03-03-2021,LOURES,474,34,222,"[120,240]",Moderado,,,,474,Lisboa e Vale do Tejo,LISBOA,1107,16723.99,213687,12746,12794,9644,6669,5033,11702,21346,34140,46886,1277.73,280.35,204.14,127.64
03-03-2021,LOURINHÃ,45,3,174,"[120,240]",Moderado,,,,45,Lisboa e Vale do Tejo,LISBOA,1108,14717.2,25855,1584,1243,992,842,645,1487,2479,3722,5306,175.68,36.05,25.29,16.84
03-03-2021,LOUSÃ,39,3,227,"[120,240]",Moderado,,,,39,Centro,COIMBRA,0607,13840.01,17158,946,866,658,528,450,978,1636,2502,3448,123.97,24.91,18.08,11.82
03-03-2021,LOUSADA,31,2,66,"[0,120]",Baixo a Moderado,,,,31,Norte,PORTO,1305,9608.01,46755,2289,1698,1176,853,621,1474,2650,4348,6637,486.63,69.08,45.25,27.58
03-03-2021,MAÇÃO,2,0,32,"[0,120]",Baixo a Moderado,,,,2,Lisboa e Vale do Tejo,SANTARÉM,1413,39997.98,6267,386,362,390,440,657,1097,1487,1849,2235,15.67,5.59,4.62,3.72
03-03-2021,MACEDO DE CAVALEIROS,21,2,145,"[120,240]",Moderado,,,,21,Norte,BRAGANÇA,0405,69914.08,14516,1082,889,878,823,938,1761,2639,3528,4610,20.76,6.59,5.05,3.77
03-03-2021,MACHICO,81,6,405,"[240,480]",Elevado,,,,81,Madeira,MADEIRA,3104,6825.1,19981,1197,860,662,455,331,786,1448,2308,3505,292.76,51.36,33.82,21.22
03-03-2021,MADALENA,7,1,119,"[0,120]",Baixo a Moderado,,,,7,Açores,AÇORES,4602,14712.33,5895,334,256,173,190,179,369,542,798,1132,40.07,7.69,5.42,3.68
03-03-2021,MAFRA,186,13,219,"[120,240]",Moderado,,,,186,Lisboa e Vale do Tejo,LISBOA,1109,29165.5,84816,3613,3334,2839,2089,1899,3988,6827,10161,13774,290.81,47.23,34.84,23.41
03-03-2021,MAIA,67,5,48,"[0,120]",Baixo a Moderado,,,,67,Norte,PORTO,1306,8293.94,138971,7801,6617,4512,3339,2631,5970,10482,17099,24900,1675.56,300.22,206.16,126.38
03-03-2021,MANGUALDE,15,1,81,"[0,120]",Baixo a Moderado,,,,15,Centro,VISEU,1806,21925.56,18510,1198,1128,885,852,743,1595,2480,3608,4806,84.42,21.92,16.46,11.31
03-03-2021,MANTEIGAS,27,2,898,"[480,960]",Muito Elevado,,,,27,Centro,GUARDA,0908,12197.55,3007,258,197,159,167,146,313,472,669,927,24.65,7.6,5.48,3.87
03-03-2021,MARCO DE CANAVESES,45,3,87,"[0,120]",Baixo a Moderado,,,,45,Norte,PORTO,1307,20188.98,51496,2678,2060,1488,1265,1023,2288,3776,5836,8514,255.07,42.17,28.91,18.7
03-03-2021,MARINHA GRANDE,25,2,65,"[0,120]",Baixo a Moderado,,,,25,Centro,LEIRIA,1010,18725.19,38508,2365,2302,1638,1359,1058,2417,4055,6357,8722,205.65,46.58,33.95,21.66
03-03-2021,MARVÃO,3,0,100,"[0,120]",Baixo a Moderado,,,,3,Alentejo,PORTALEGRE,1210,15489.9,3005,198,185,142,197,237,434,576,761,959,19.4,6.19,4.91,3.72
03-03-2021,MATOSINHOS,160,11,91,"[0,120]",Baixo a Moderado,,,,160,Norte,PORTO,1308,6241.97,175357,11850,9977,7023,5024,3884,8908,15931,25908,37758,2809.31,604.9,415.06,255.22
03-03-2021,MEALHADA,41,3,206,"[120,240]",Moderado,,,,41,Centro,AVEIRO,0111,11065.66,19914,1163,1039,810,828,831,1659,2469,3508,4671,179.96,42.21,31.7,22.31
03-03-2021,MÊDA,4,0,87,"[0,120]",Baixo a Moderado,,,,4,Centro,GUARDA,0909,28604.92,4587,343,306,290,288,443,731,1021,1327,1670,16.04,5.84,4.64,3.57
03-03-2021,MELGAÇO,14,1,173,"[120,240]",Moderado,,,,14,Norte,VIANA DO CASTELO,1603,23824.58,8093,507,567,578,614,675,1289,1867,2434,2941,33.97,12.34,10.22,7.84
03-03-2021,MÉRTOLA,8,1,130,"[120,240]",Moderado,,,,8,Alentejo,BEJA,0209,129287.34,6142,400,390,378,423,600,1023,1401,1791,2191,4.75,1.69,1.39,1.08
03-03-2021,MESÃO FRIO,0,0,0,"[0,120]",Baixo a Moderado,,,,0,Norte,VILA REAL,1704,2664.87,3964,265,205,168,157,120,277,445,650,915,148.74,34.33,24.39,16.7
03-03-2021,MIRA,8,1,68,"[0,120]",Baixo a Moderado,,,,8,Centro,COIMBRA,0608,12403.38,11832,727,729,659,550,466,1016,1675,2404,3131,95.4,25.24,19.38,13.5
03-03-2021,MIRANDA DO CORVO,25,2,197,"[120,240]",Moderado,,,,25,Centro,COIMBRA,0609,12637.79,12708,706,659,568,498,404,902,1470,2129,2835,100.55,22.43,16.85,11.63
03-03-2021,MIRANDA DO DOURO,0,0,0,"[0,120]",Baixo a Moderado,,,,0,Norte,BRAGANÇA,0406,48718.31,6830,482,429,442,463,470,933,1375,1804,2286,14.02,4.69,3.7,2.82
03-03-2021,MIRANDELA,29,2,133,"[120,240]",Moderado,,,,29,Norte,BRAGANÇA,0407,65895.67,21754,1640,1315,1204,1078,947,2025,3229,4544,6184,33.01,9.38,6.9,4.9
03-03-2021,MOGADOURO,2,0,24,"[0,120]",Baixo a Moderado,,,,2,Norte,BRAGANÇA,0408,76064.93,8392,589,529,576,630,655,1285,1861,2390,2979,11.03,3.92,3.14,2.45
03-03-2021,MOIMENTA DA BEIRA,11,1,113,"[0,120]",Baixo a Moderado,,,,11,Norte,VISEU,1807,21996.9,9736,576,514,471,416,461,877,1348,1862,2438,44.26,11.08,8.46,6.13
03-03-2021,MOITA,146,10,227,"[120,240]",Moderado,,,,146,Lisboa e Vale do Tejo,SETÚBAL,1506,5525.98,64407,4226,3646,2623,1801,1425,3226,5849,9495,13721,1165.53,248.3,171.82,105.85
03-03-2021,MONÇÃO,12,1,67,"[0,120]",Baixo a Moderado,,,,12,Norte,VIANA DO CASTELO,1604,21130.85,17869,1161,1105,1031,1006,972,1978,3009,4114,5275,84.56,24.96,19.47,14.24
03-03-2021,MONCHIQUE,11,1,217,"[120,240]",Moderado,,,,11,Algarve,FARO,0809,39530.43,5077,353,384,321,355,392,747,1068,1452,1805,12.84,4.57,3.67,2.7
03-03-2021,MONDIM DE BASTO,8,1,115,"[0,120]",Baixo a Moderado,,,,8,Norte,VILA REAL,1705,17207.52,6946,395,300,314,284,283,567,881,1181,1576,40.36,9.16,6.86,5.12
03-03-2021,MONFORTE,12,1,403,"[240,480]",Elevado,,,,12,Alentejo,PORTALEGRE,1211,42024.82,2975,139,115,117,192,168,360,477,592,731,7.08,1.74,1.41,1.14
03-03-2021,MONTALEGRE,6,0,67,"[0,120]",Baixo a Moderado,,,,6,Norte,VILA REAL,1706,80545.71,8997,699,628,595,603,730,1333,1928,2556,3255,11.17,4.04,3.17,2.39
03-03-2021,MONTEMOR-O-NOVO,7,1,45,"[0,120]",Baixo a Moderado,,,,7,Alentejo,ÉVORA,0706,123296.65,15647,991,953,868,878,971,1849,2717,3670,4661,12.69,3.78,2.98,2.2
03-03-2021,MONTEMOR-O-VELHO,60,4,238,"[120,240]",Moderado,,,,60,Centro,COIMBRA,0610,22896.23,25224,1496,1397,1217,1057,988,2045,3262,4659,6155,110.17,26.88,20.35,14.25
03-03-2021,MONTIJO,166,12,288,"[240,480]",Elevado,,,,166,Lisboa e Vale do Tejo,SETÚBAL,1507,34861.64,57614,2771,2441,1990,1554,1109,2663,4653,7094,9865,165.26,28.3,20.35,13.35
03-03-2021,MORA,0,0,0,"[0,120]",Baixo a Moderado,,,,0,Alentejo,ÉVORA,0707,44395.02,4138,336,275,252,238,257,495,747,1022,1358,9.32,3.06,2.3,1.68
03-03-2021,MORTÁGUA,4,0,45,"[0,120]",Baixo a Moderado,,,,4,Centro,VISEU,1808,25117.82,8803,638,584,535,499,460,959,1494,2078,2716,35.05,10.81,8.27,5.95
03-03-2021,MOURA,27,2,197,"[120,240]",Moderado,,,,27,Alentejo,BEJA,0210,95845.55,13718,817,656,665,542,461,1003,1668,2324,3141,14.31,3.28,2.42,1.74
03-03-2021,MOURÃO,1,0,41,"[0,120]",Baixo a Moderado,,,,1,Alentejo,ÉVORA,0708,27862.98,2450,139,108,80,104,109,213,293,401,540,8.79,1.94,1.44,1.05
03-03-2021,MURÇA,2,0,37,"[0,120]",Baixo a Moderado,,,,2,Norte,VILA REAL,1707,18937.11,5463,384,341,307,306,319,625,932,1273,1657,28.85,8.75,6.72,4.92
03-03-2021,MURTOSA,29,2,282,"[240,480]",Elevado,,,,29,Centro,AVEIRO,0112,7308.78,10279,509,473,403,353,409,762,1165,1638,2147,140.63,29.37,22.41,15.94
03-03-2021,NAZARÉ,5,0,35,"[0,120]",Baixo a Moderado,,,,5,Lisboa e Vale do Tejo,LEIRIA,1011,8243.43,14165,967,903,670,420,396,816,1486,2389,3356,171.84,40.71,28.98,18.03
03-03-2021,NELAS,20,1,154,"[120,240]",Moderado,,,,20,Centro,VISEU,1809,12571.48,12974,924,787,668,604,583,1187,1855,2642,3566,103.21,28.37,21.02,14.76
03-03-2021,NISA,4,0,66,"[0,120]",Baixo a Moderado,,,,4,Alentejo,PORTALEGRE,1212,57567.84,6061,405,389,355,483,478,961,1316,1705,2110,10.53,3.67,2.96,2.29
03-03-2021,NORDESTE,0,0,0,"[0,120]",Baixo a Moderado,,,,0,Açores,AÇORES,4202,10146.8,4862,246,180,124,161,162,323,447,627,873,47.92,8.6,6.18,4.41
03-03-2021,ÓBIDOS,10,1,84,"[0,120]",Baixo a Moderado,,,,10,Lisboa e Vale do Tejo,LEIRIA,1012,14155.44,11850,743,650,574,452,436,888,1462,2112,2855,83.72,20.17,14.92,10.33
03-03-2021,ODEMIRA,45,3,182,"[120,240]",Moderado,,,,45,Alentejo,BEJA,0211,172060.15,24717,1475,1317,1225,1397,1349,2746,3971,5288,6763,14.37,3.93,3.07,2.31
03-03-2021,ODIVELAS,372,27,230,"[120,240]",Moderado,,,,372,Lisboa e Vale do Tejo,LISBOA,1116,2654.36,161774,9562,9038,6952,4641,3812,8453,15405,24443,34005,6095.48,1281.27,920.99,580.44
03-03-2021,OEIRAS,316,23,178,"[120,240]",Moderado,,,,316,Lisboa e Vale do Tejo,LISBOA,1110,4588.31,177408,11580,11575,8566,6211,5855,12066,20632,32207,43787,3866.78,954.38,701.98,449.69
03-03-2021,OLEIROS,4,0,80,"[0,120]",Baixo a Moderado,,,,4,Centro,CASTELO BRANCO,0506,47109.31,5003,384,341,366,397,487,884,1250,1591,1975,10.62,4.19,3.38,2.65
03-03-2021,OLHÃO,53,4,119,"[0,120]",Baixo a Moderado,,,,53,Algarve,FARO,0810,13086.38,44405,2455,2309,1689,1342,1268,2610,4299,6608,9063,339.33,69.26,50.5,32.85
03-03-2021,OLIVEIRA DE AZEMÉIS,73,5,111,"[0,120]",Baixo a Moderado,,,,73,Norte,AVEIRO,0113,16110.41,66011,4155,3614,2794,2183,1738,3921,6715,10329,14484,409.75,89.91,64.12,41.68
03-03-2021,OLIVEIRA DE FRADES,2,0,20,"[0,120]",Baixo a Moderado,,,,2,Centro,VISEU,1810,14534.62,9936,553,475,438,359,415,774,1212,1687,2240,68.36,15.41,11.61,8.34
03-03-2021,OLIVEIRA DO BAIRRO,35,2,144,"[120,240]",Moderado,,,,35,Centro,AVEIRO,0114,8731.99,24277,1327,1182,999,786,810,1596,2595,3777,5104,278.02,58.45,43.25,29.72
03-03-2021,OLIVEIRA DO HOSPITAL,12,1,62,"[0,120]",Baixo a Moderado,,,,12,Centro,COIMBRA,0611,23451.66,19253,1161,1097,962,924,960,1884,2846,3943,5104,82.1,21.76,16.81,12.14
03-03-2021,OURÉM,30,2,68,"[0,120]",Baixo a Moderado,,,,30,Lisboa e Vale do Tejo,SANTARÉM,1421,41668.03,44044,2463,2069,1899,1817,1603,3420,5319,7388,9851,105.7,23.64,17.73,12.77
03-03-2021,OURIQUE,5,0,109,"[0,120]",Baixo a Moderado,,,,5,Alentejo,BEJA,0212,66331.36,4607,313,287,284,268,227,495,779,1066,1379,6.95,2.08,1.61,1.17
03-03-2021,OVAR,30,2,55,"[0,120]",Baixo a Moderado,,,,30,Centro,AVEIRO,0115,14770.25,54260,3294,2709,1994,1636,1234,2870,4864,7573,10867,367.37,73.57,51.27,32.93
03-03-2021,PAÇOS DE FERREIRA,21,1,37,"[0,120]",Baixo a Moderado,,,,21,Norte,PORTO,1309,7099.29,56728,2903,2193,1518,1135,664,1799,3317,5510,8413,799.1,118.51,77.62,46.72
03-03-2021,PALMELA,198,14,308,"[240,480]",Elevado,,,,198,Lisboa e Vale do Tejo,SETÚBAL,1508,46512.01,64269,3402,3244,2635,1846,1391,3237,5872,9116,12518,138.18,26.91,19.6,12.62
03-03-2021,PAMPILHOSA DA SERRA,3,0,74,"[0,120]",Baixo a Moderado,,,,3,Centro,COIMBRA,0612,39646.24,4037,238,254,295,339,423,762,1057,1311,1549,10.18,3.91,3.31,2.67
03-03-2021,PAREDES,60,4,70,"[0,120]",Baixo a Moderado,,,,60,Norte,PORTO,1310,15675.69,86067,4272,3532,2412,1717,1258,2975,5387,8919,13191,549.04,84.15,56.9,34.36
03-03-2021,PAREDES DE COURA,8,1,94,"[0,120]",Baixo a Moderado,,,,8,Norte,VIANA DO CASTELO,1605,13818.59,8535,466,528,407,465,515,980,1387,1915,2381,61.76,17.23,13.86,10.04
03-03-2021,PEDRÓGÃO GRANDE,1,0,29,"[0,120]",Baixo a Moderado,,,,1,Centro,LEIRIA,1013,12874.75,3410,175,173,196,221,252,473,669,842,1017,26.49,7.9,6.54,5.2
03-03-2021,PENACOVA,38,3,277,"[240,480]",Elevado,,,,38,Centro,COIMBRA,0613,21673.23,13694,968,923,745,621,703,1324,2069,2992,3960,63.18,18.27,13.81,9.55
03-03-2021,PENAFIEL,72,5,103,"[0,120]",Baixo a Moderado,,,,72,Norte,PORTO,1311,21224.27,69772,3648,2823,2032,1663,1230,2893,4925,7748,11396,328.74,53.69,36.51,23.2
03-03-2021,PENALVA DO CASTELO,3,0,42,"[0,120]",Baixo a Moderado,,,,3,Centro,VISEU,1811,13433.92,7115,449,457,413,391,426,817,1230,1687,2136,52.96,15.9,12.56,9.16
03-03-2021,PENAMACOR,13,1,273,"[240,480]",Elevado,,,,13,Centro,CASTELO BRANCO,0507,56370.69,4755,262,248,273,451,633,1084,1357,1605,1867,8.44,3.31,2.85,2.41
03-03-2021,PENEDONO,1,0,39,"[0,120]",Baixo a Moderado,,,,1,Norte,VISEU,1812,13370.75,2591,172,113,129,156,138,294,423,536,708,19.38,5.3,4.01,3.16
03-03-2021,PENELA,31,2,574,"[480,960]",Muito Elevado,,,,31,Centro,COIMBRA,0614,13480.0,5397,314,324,274,359,344,703,977,1301,1615,40.04,11.98,9.65,7.25
03-03-2021,PENICHE,40,3,151,"[120,240]",Moderado,,,,40,Lisboa e Vale do Tejo,LEIRIA,1014,7754.98,26501,1746,1504,1203,926,707,1633,2836,4340,6086,341.73,78.48,55.96,36.57
03-03-2021,PESO DA RÉGUA,16,1,101,"[0,120]",Baixo a Moderado,,,,16,Norte,VILA REAL,1708,9486.01,15773,1076,843,650,659,455,1114,1764,2607,3683,166.28,38.83,27.48,18.6
03-03-2021,PINHEL,5,0,59,"[0,120]",Baixo a Moderado,,,,5,Centro,GUARDA,0910,48452.12,8511,577,566,551,538,689,1227,1778,2344,2921,17.57,6.03,4.84,3.67
03-03-2021,POMBAL,94,7,183,"[120,240]",Moderado,,,,94,Centro,LEIRIA,1015,62600.28,51461,3187,2791,2494,2328,2027,4355,6849,9640,12827,82.21,20.49,15.4,10.94
03-03-2021,PONTA DELGADA,14,1,21,"[0,120]",Baixo a Moderado,,,,14,Açores,AÇORES,4203,23298.65,67935,3108,2435,1726,1133,902,2035,3761,6196,9304,291.58,39.93,26.59,16.14
03-03-2021,PONTA DO SOL,37,3,431,"[240,480]",Elevado,,,,37,Madeira,MADEIRA,3105,4622.03,8593,319,283,347,208,221,429,776,1059,1378,185.92,29.81,22.91,16.79
03-03-2021,PONTE DA BARCA,9,1,81,"[0,120]",Baixo a Moderado,,,,9,Norte,VIANA DO CASTELO,1606,18211.37,11180,635,576,517,554,490,1044,1561,2137,2772,61.39,15.22,11.73,8.57
03-03-2021,PONTE DE LIMA,42,3,102,"[0,120]",Baixo a Moderado,,,,42,Norte,VIANA DO CASTELO,1607,32025.46,41315,2321,2022,1720,1596,1462,3058,4778,6800,9121,129.01,28.48,21.23,14.92
03-03-2021,PONTE DE SOR,5,0,33,"[0,120]",Baixo a Moderado,,,,5,Alentejo,PORTALEGRE,1213,83971.16,14994,939,800,716,739,831,1570,2286,3086,4025,17.86,4.79,3.68,2.72
03-03-2021,PORTALEGRE,14,1,63,"[0,120]",Baixo a Moderado,,,,14,Alentejo,PORTALEGRE,1214,44713.64,22172,1577,1351,1137,993,984,1977,3114,4465,6042,49.59,13.51,9.99,6.96
03-03-2021,PORTEL,5,0,86,"[0,120]",Baixo a Moderado,,,,5,Alentejo,ÉVORA,0709,60100.57,5828,336,358,283,331,305,636,919,1277,1613,9.7,2.68,2.12,1.53
03-03-2021,PORTIMÃO,88,6,159,"[120,240]",Moderado,,,,88,Algarve,FARO,0811,18206.29,55483,3182,2927,2116,1582,1400,2982,5098,8025,11207,304.75,61.56,44.08,28.0
03-03-2021,PORTO,288,21,133,"[120,240]",Moderado,,,,288,Norte,PORTO,1312,4142.02,216606,15790,15193,11280,9409,10044,19453,30733,45926,61716,5229.5,1490.0,1108.79,741.98
03-03-2021,PORTO DE MÓS,25,2,107,"[0,120]",Baixo a Moderado,,,,25,Centro,LEIRIA,1016,26183.41,23275,1355,1210,1034,888,872,1760,2794,4004,5359,88.89,20.47,15.29,10.67
03-03-2021,PORTO MONIZ,3,0,128,"[120,240]",Moderado,,,,3,Madeira,MADEIRA,3106,8293.38,2342,143,130,95,98,120,218,313,443,586,28.24,7.07,5.34,3.77
03-03-2021,PORTO SANTO,1,0,19,"[0,120]",Baixo a Moderado,,,,1,Madeira,MADEIRA,3201,4300.7,5202,240,157,134,110,68,178,312,469,709,120.95,16.48,10.9,7.25
03-03-2021,PÓVOA DE LANHOSO,13,1,60,"[0,120]",Baixo a Moderado,,,,13,Norte,BRAGA,0309,13465.29,21499,1175,909,732,673,624,1297,2029,2938,4113,159.67,30.55,21.82,15.07
03-03-2021,PÓVOA DE VARZIM,79,6,126,"[120,240]",Moderado,,,,79,Norte,PORTO,1313,8220.59,62784,3712,3120,2134,1594,1305,2899,5033,8153,11865,763.7,144.33,99.17,61.22
03-03-2021,POVOAÇÃO,0,0,0,"[0,120]",Baixo a Moderado,,,,0,Açores,AÇORES,4204,10640.77,5927,293,212,191,144,134,278,469,681,974,55.7,9.15,6.4,4.41
03-03-2021,VILA DA PRAIA DA VITÓRIA,1,0,5,"[0,120]",Baixo a Moderado,,,,1,Açores,AÇORES,4302,16127.06,21317,1133,789,619,436,336,772,1391,2180,3313,132.18,20.54,13.52,8.63
03-03-2021,PROENÇA-A-NOVA,11,1,151,"[120,240]",Moderado,,,,11,Centro,CASTELO BRANCO,0508,39539.96,7298,508,465,389,400,560,960,1349,1814,2322,18.46,5.87,4.59,3.41
03-03-2021,REDONDO,1,0,16,"[0,120]",Baixo a Moderado,,,,1,Alentejo,ÉVORA,0710,36950.87,6353,349,325,288,288,354,642,930,1255,1604,17.19,4.34,3.4,2.52
03-03-2021,REGUENGOS DE MONSARAZ,5,0,50,"[0,120]",Baixo a Moderado,,,,5,Alentejo,ÉVORA,0711,46399.72,10015,602,511,455,462,473,935,1390,1901,2503,21.58,5.39,4.1,3.0
03-03-2021,RESENDE,96,7,947,"[480,960]",Muito Elevado,,,,96,Norte,VISEU,1813,12334.93,10137,560,493,448,433,422,855,1303,1796,2356,82.18,19.1,14.56,10.56
03-03-2021,RIBEIRA BRAVA,28,2,225,"[120,240]",Moderado,,,,28,Madeira,MADEIRA,3107,6544.88,12435,648,500,411,311,287,598,1009,1509,2157,189.99,32.96,23.06,15.42
03-03-2021,RIBEIRA DE PENA,2,0,33,"[0,120]",Baixo a Moderado,,,,2,Norte,VILA REAL,1709,21745.98,6016,371,301,290,310,368,678,968,1269,1640,27.66,7.54,5.84,4.45
03-03-2021,RIBEIRA GRANDE,74,5,226,"[120,240]",Moderado,,,,74,Açores,AÇORES,4205,18015.13,32811,1163,689,512,345,253,598,1110,1799,2962,182.13,16.44,9.99,6.16
03-03-2021,RIO MAIOR,97,7,476,"[240,480]",Elevado,,,,97,Lisboa e Vale do Tejo,SANTARÉM,1414,27276.45,20379,1251,1144,941,795,648,1443,2384,3528,4779,74.71,17.52,12.93,8.74
03-03-2021,SABROSA,8,1,135,"[120,240]",Moderado,,,,8,Norte,VILA REAL,1710,15692.45,5918,393,314,304,302,350,652,956,1270,1663,37.71,10.6,8.09,6.09
03-03-2021,SABUGAL,4,0,38,"[0,120]",Baixo a Moderado,,,,4,Centro,GUARDA,0911,82269.82,10585,724,707,694,796,1009,1805,2499,3206,3930,12.87,4.78,3.9,3.04
03-03-2021,SALVATERRA DE MAGOS,28,2,131,"[120,240]",Moderado,,,,28,Lisboa e Vale do Tejo,SANTARÉM,1415,24393.2,21295,1275,1181,1060,799,772,1571,2631,3812,5087,87.3,20.85,15.63,10.79
03-03-2021,SANTA COMBA DÃO,9,1,86,"[0,120]",Baixo a Moderado,,,,9,Centro,VISEU,1814,11194.77,10452,732,684,569,538,464,1002,1571,2255,2987,93.36,26.68,20.14,14.03
03-03-2021,SANTA CRUZ,216,15,477,"[240,480]",Elevado,,,,216,Madeira,MADEIRA,3108,8150.28,45281,1817,1301,974,716,523,1239,2213,3514,5331,555.6,65.41,43.12,27.15
03-03-2021,SANTA CRUZ DA GRACIOSA,0,0,0,"[0,120]",Baixo a Moderado,,,,0,Açores,AÇORES,4401,6065.78,4208,228,180,163,124,145,269,432,612,840,69.37,13.85,10.09,7.12
03-03-2021,SANTA CRUZ DAS FLORES,0,0,0,"[0,120]",Baixo a Moderado,,,,0,Açores,AÇORES,4802,7091.44,2165,125,98,74,56,51,107,181,279,404,30.53,5.7,3.93,2.55
03-03-2021,SANTA MARIA DA FEIRA,175,12,126,"[120,240]",Moderado,,,,175,Norte,AVEIRO,0109,21587.65,138636,8182,6743,4771,3856,3079,6935,11706,18449,26631,642.19,123.36,85.46,54.22
03-03-2021,SANTA MARTA DE PENAGUIÃO,25,2,379,"[240,480]",Elevado,,,,25,Norte,VILA REAL,1711,6928.13,6599,483,373,337,316,317,633,970,1343,1826,95.25,26.36,19.39,14.0
03-03-2021,SANTANA,7,0,104,"[0,120]",Baixo a Moderado,,,,7,Madeira,MADEIRA,3109,9547.3,6711,418,353,343,282,277,559,902,1255,1673,70.29,17.52,13.15,9.45
03-03-2021,SANTARÉM,82,6,143,"[120,240]",Moderado,,,,82,Lisboa e Vale do Tejo,SANTARÉM,1416,55253.58,57421,3654,3441,2760,2466,2206,4672,7432,10873,14527,103.92,26.29,19.68,13.45
03-03-2021,SANTIAGO DO CACÉM,40,3,139,"[120,240]",Moderado,,,,40,Alentejo,SETÚBAL,1509,105969.29,28791,2144,1689,1472,1295,1215,2510,3982,5671,7815,27.17,7.37,5.35,3.76
03-03-2021,SANTO TIRSO,56,4,82,"[0,120]",Baixo a Moderado,,,,56,Norte,PORTO,1314,13655.52,68055,4911,3935,2761,2257,1810,4067,6828,10763,15674,498.35,114.78,78.82,50.0
03-03-2021,SÃO BRÁS DE ALPORTEL,4,0,38,"[0,120]",Baixo a Moderado,,,,4,Algarve,FARO,0812,15336.92,10416,596,468,467,404,401,805,1272,1740,2336,67.91,15.23,11.35,8.29
03-03-2021,SÃO JOÃO DA MADEIRA,25,2,114,"[0,120]",Baixo a Moderado,,,,25,Norte,AVEIRO,0116,794.3,21958,1347,1069,796,601,593,1194,1990,3059,4406,2765.49,554.91,385.26,250.63
03-03-2021,SÃO JOÃO DA PESQUEIRA,8,1,112,"[0,120]",Baixo a Moderado,,,,8,Norte,VISEU,1815,26610.85,7125,417,330,294,328,328,656,950,1280,1697,26.77,6.38,4.81,3.57
03-03-2021,SÃO PEDRO DO SUL,20,1,130,"[120,240]",Moderado,,,,20,Centro,VISEU,1816,34895.09,15403,990,962,861,759,909,1668,2529,3491,4481,44.14,12.84,10.0,7.25
03-03-2021,SÃO ROQUE DO PICO,5,0,153,"[120,240]",Moderado,,,,5,Açores,AÇORES,4603,14236.1,3266,199,141,93,96,113,209,302,443,642,22.94,4.51,3.11,2.12
03-03-2021,SÃO VICENTE,3,0,58,"[0,120]",Baixo a Moderado,,,,3,Madeira,MADEIRA,3110,7883.71,5143,272,264,266,225,280,505,771,1035,1307,65.23,16.58,13.13,9.78
03-03-2021,SARDOAL,8,1,214,"[120,240]",Moderado,,,,8,Lisboa e Vale do Tejo,SANTARÉM,1417,9214.72,3741,227,178,148,165,248,413,561,739,966,40.6,10.48,8.02,6.09
03-03-2021,SÁTÃO,9,1,78,"[0,120]",Baixo a Moderado,,,,9,Centro,VISEU,1817,20194.11,11580,765,671,515,465,476,941,1456,2127,2892,57.34,14.32,10.53,7.21
03-03-2021,SEIA,32,2,144,"[120,240]",Moderado,,,,32,Centro,GUARDA,0912,43568.83,22234,1807,1589,1238,1122,721,1843,3081,4670,6477,51.03,14.87,10.72,7.07
03-03-2021,SEIXAL,285,20,170,"[120,240]",Moderado,,,,285,Lisboa e Vale do Tejo,SETÚBAL,1510,9545.17,167752,10586,9270,6661,4391,2930,7321,13982,23252,33838,1757.49,354.51,243.6,146.49
03-03-2021,SERNANCELHE,9,1,167,"[120,240]",Moderado,,,,9,Norte,VISEU,1818,22861.22,5396,305,293,286,273,260,533,819,1112,1417,23.6,6.2,4.86,3.58
03-03-2021,SERPA,50,4,350,"[240,480]",Elevado,,,,50,Alentejo,BEJA,0213,110563.34,14304,903,761,719,697,626,1323,2042,2803,3706,12.94,3.35,2.54,1.85
03-03-2021,SERTÃ,17,1,117,"[0,120]",Baixo a Moderado,,,,17,Centro,CASTELO BRANCO,0509,44673.17,14577,870,779,790,767,1020,1787,2577,3356,4226,32.63,9.46,7.51,5.77
03-03-2021,SESIMBRA,131,9,253,"[240,480]",Elevado,,,,131,Lisboa e Vale do Tejo,SETÚBAL,1511,19571.75,51858,2400,2321,1853,1257,1083,2340,4193,6514,8914,264.96,45.54,33.28,21.42
03-03-2021,SETÚBAL,266,19,231,"[120,240]",Moderado,,,,266,Lisboa e Vale do Tejo,SETÚBAL,1512,23032.5,115126,7425,6929,5075,3775,2655,6430,11505,18434,25859,499.83,112.27,80.03,49.95
03-03-2021,SEVER DO VOUGA,12,1,106,"[0,120]",Baixo a Moderado,,,,12,Centro,AVEIRO,0117,12987.56,11331,766,637,568,540,567,1107,1675,2312,3078,87.24,23.7,17.8,12.9
03-03-2021,SILVES,18,1,50,"[0,120]",Baixo a Moderado,,,,18,Algarve,FARO,0813,68006.23,36226,2137,1869,1610,1423,1600,3023,4633,6502,8639,53.27,12.7,9.56,6.81
03-03-2021,SINES,31,2,226,"[120,240]",Moderado,,,,31,Alentejo,SETÚBAL,1513,20330.17,13715,888,791,551,416,268,684,1235,2026,2914,67.46,14.33,9.97,6.07
03-03-2021,SINTRA,924,66,236,"[120,240]",Moderado,,,,924,Lisboa e Vale do Tejo,LISBOA,1111,31922.73,391402,20490,18316,13545,9137,7284,16421,29966,48282,68772,1226.08,215.43,151.25,93.87
03-03-2021,SOBRAL DE MONTE AGRAÇO,57,4,535,"[480,960]",Muito Elevado,,,,57,Lisboa e Vale do Tejo,LISBOA,1112,5210.32,10651,564,507,352,272,212,484,836,1343,1907,204.43,36.6,25.78,16.05
03-03-2021,SOURE,21,2,123,"[120,240]",Moderado,,,,21,Centro,COIMBRA,0615,26506.07,17120,1173,1142,1004,883,987,1870,2874,4016,5189,64.59,19.58,15.15,10.84
03-03-2021,SOUSEL,2,0,45,"[0,120]",Baixo a Moderado,,,,2,Alentejo,PORTALEGRE,1215,27932.18,4412,261,274,208,302,292,594,802,1076,1337,15.8,4.79,3.85,2.87
03-03-2021,TÁBUA,26,2,229,"[120,240]",Moderado,,,,26,Centro,COIMBRA,0616,19978.58,11368,729,584,524,430,464,894,1418,2002,2731,56.9,13.67,10.02,7.1
03-03-2021,TABUAÇO,2,0,33,"[0,120]",Baixo a Moderado,,,,2,Norte,VISEU,1819,13385.67,6033,372,314,217,282,363,645,862,1176,1548,45.07,11.56,8.79,6.44
03-03-2021,TAROUCA,14,1,179,"[120,240]",Moderado,,,,14,Norte,VISEU,1820,10008.49,7804,405,335,313,277,324,601,914,1249,1654,77.98,16.53,12.48,9.13
03-03-2021,TAVIRA,22,2,90,"[0,120]",Baixo a Moderado,,,,22,Algarve,FARO,0814,60696.7,24530,1493,1415,1252,1066,1277,2343,3595,5010,6503,40.41,10.71,8.25,5.92
03-03-2021,TERRAS DE BOURO,3,0,47,"[0,120]",Baixo a Moderado,,,,3,Norte,BRAGA,0310,27746.07,6361,391,372,296,319,340,659,955,1327,1718,22.93,6.19,4.78,3.44
03-03-2021,TOMAR,51,4,139,"[120,240]",Moderado,,,,51,Lisboa e Vale do Tejo,SANTARÉM,1418,35120.44,36748,2403,2189,1868,1853,1822,3675,5543,7732,10135,104.64,28.86,22.02,15.78
03-03-2021,TONDELA,17,1,64,"[0,120]",Baixo a Moderado,,,,17,Centro,VISEU,1821,37121.73,26357,1768,1722,1518,1475,1417,2892,4410,6132,7900,71.0,21.28,16.52,11.88
03-03-2021,TORRE DE MONCORVO,2,0,26,"[0,120]",Baixo a Moderado,,,,2,Norte,BRAGANÇA,0409,53155.67,7695,556,478,488,551,719,1270,1758,2236,2792,14.48,5.25,4.21,3.31
03-03-2021,TORRES NOVAS,20,1,57,"[0,120]",Baixo a Moderado,,,,20,Lisboa e Vale do Tejo,SANTARÉM,1419,26999.68,34933,2324,1979,1738,1406,1475,2881,4619,6598,8922,129.38,33.04,24.44,17.11
03-03-2021,TORRES VEDRAS,234,17,298,"[240,480]",Elevado,,,,234,Lisboa e Vale do Tejo,LISBOA,1113,40714.89,78530,4513,3945,3447,2628,2104,4732,8179,12124,16637,192.88,40.86,29.78,20.09
03-03-2021,TRANCOSO,12,1,135,"[120,240]",Moderado,,,,12,Centro,GUARDA,0913,36152.47,8875,581,557,542,586,496,1082,1624,2181,2762,24.55,7.64,6.03,4.49
03-03-2021,TROFA,59,4,154,"[120,240]",Moderado,,,,59,Norte,PORTO,1318,7201.76,38418,2336,1894,1231,939,684,1623,2854,4748,7084,533.44,98.36,65.93,39.63
03-03-2021,VAGOS,31,2,136,"[120,240]",Moderado,,,,31,Centro,AVEIRO,0118,16491.5,22740,1320,1205,922,784,724,1508,2430,3635,4955,137.89,30.04,22.04,14.73
03-03-2021,VALE DE CAMBRA,27,2,127,"[120,240]",Moderado,,,,27,Norte,AVEIRO,0119,14733.47,21327,1491,1363,1005,831,798,1629,2634,3997,5488,144.76,37.25,27.13,17.88
03-03-2021,VALENÇA,13,1,98,"[0,120]",Baixo a Moderado,,,,13,Norte,VIANA DO CASTELO,1608,11712.86,13290,867,791,582,582,503,1085,1667,2458,3325,113.46,28.39,20.99,14.23
03-03-2021,VALONGO,80,6,82,"[0,120]",Baixo a Moderado,,,,80,Norte,PORTO,1315,7512.45,97444,5629,4696,3207,2462,1829,4291,7498,12194,17823,1297.18,237.26,162.33,99.81
03-03-2021,VALPAÇOS,6,0,40,"[0,120]",Baixo a Moderado,,,,6,Norte,VILA REAL,1712,54873.93,14818,1217,1118,999,928,997,1925,2924,4042,5259,27.0,9.58,7.37,5.33
03-03-2021,VELAS,0,0,0,"[0,120]",Baixo a Moderado,,,,0,Açores,AÇORES,4502,11738.38,5093,278,208,166,153,113,266,432,640,918,43.39,7.82,5.45,3.68
03-03-2021,VENDAS NOVAS,7,0,62,"[0,120]",Baixo a Moderado,,,,7,Alentejo,ÉVORA,0712,22238.88,11255,677,768,655,501,532,1033,1688,2456,3133,50.61,14.09,11.04,7.59
03-03-2021,VIANA DO ALENTEJO,12,1,233,"[120,240]",Moderado,,,,12,Alentejo,ÉVORA,0713,39367.29,5145,245,208,235,210,214,424,659,867,1112,13.07,2.82,2.2,1.67
03-03-2021,VIANA DO CASTELO,108,8,128,"[120,240]",Moderado,,,,108,Norte,VIANA DO CASTELO,1609,31902.01,84417,5470,4433,3591,3061,2982,6043,9634,14067,19537,264.61,61.24,44.09,30.2
03-03-2021,VIDIGUEIRA,5,0,91,"[0,120]",Baixo a Moderado,,,,5,Alentejo,BEJA,0214,31661.09,5510,300,248,215,233,275,508,723,971,1271,17.4,4.01,3.07,2.28
03-03-2021,VIEIRA DO MINHO,18,1,152,"[120,240]",Moderado,,,,18,Norte,BRAGA,0311,21644.35,11842,703,594,525,548,482,1030,1555,2149,2852,54.71,13.18,9.93,7.18
03-03-2021,VILA DE REI,4,0,120,"[120,240]",Moderado,,,,4,Centro,CASTELO BRANCO,0510,19154.6,3323,169,128,172,247,302,549,721,849,1018,17.35,5.31,4.43,3.76
03-03-2021,VILA DO BISPO,3,0,58,"[0,120]",Baixo a Moderado,,,,3,Algarve,FARO,0815,17906.06,5154,302,302,314,232,233,465,779,1081,1383,28.78,7.72,6.04,4.35
03-03-2021,VILA DO CONDE,151,11,189,"[120,240]",Moderado,,,,151,Norte,PORTO,1316,14902.77,79899,4726,3875,2819,2070,1743,3813,6632,10507,15233,536.13,102.21,70.5,44.5
03-03-2021,VILA DO PORTO,2,0,36,"[0,120]",Baixo a Moderado,,,,2,Açores,AÇORES,4101,9688.74,5616,274,212,135,96,123,219,354,566,840,57.96,8.67,5.84,3.65
03-03-2021,VILA FLOR,13,1,215,"[120,240]",Moderado,,,,13,Norte,BRAGANÇA,0410,26581.14,6044,429,362,422,294,331,625,1047,1409,1838,22.74,6.91,5.3,3.94
03-03-2021,VILA FRANCA DE XIRA,302,22,213,"[120,240]",Moderado,,,,302,Lisboa e Vale do Tejo,LISBOA,1114,31819.39,141957,8501,6852,4869,3425,2472,5897,10766,17618,26119,446.14,82.09,55.37,33.84
03-03-2021,VILA FRANCA DO CAMPO,0,0,0,"[0,120]",Baixo a Moderado,,,,0,Açores,AÇORES,4206,7796.82,11051,450,344,248,217,154,371,619,963,1413,141.73,18.12,12.35,7.94
03-03-2021,VILA NOVA DA BARQUINHA,4,0,54,"[0,120]",Baixo a Moderado,,,,4,Lisboa e Vale do Tejo,SANTARÉM,1420,4952.97,7461,415,406,392,364,338,702,1094,1500,1915,150.64,38.66,30.28,22.09
03-03-2021,VILA NOVA DE CERVEIRA,36,3,404,"[240,480]",Elevado,,,,36,Norte,VIANA DO CASTELO,1610,10846.66,8910,531,444,410,384,334,718,1128,1572,2103,82.14,19.39,14.49,10.4
03-03-2021,VILA NOVA DE FAMALICÃO,180,13,137,"[120,240]",Moderado,,,,180,Norte,BRAGA,0312,20159.26,131676,7817,6164,4202,3282,2749,6031,10233,16397,24214,653.19,120.12,81.34,50.76
03-03-2021,VILA NOVA DE FOZ CÔA,11,1,169,"[120,240]",Moderado,,,,11,Centro,GUARDA,0914,39815.18,6503,442,385,390,398,429,827,1217,1602,2044,16.33,5.13,4.02,3.06
03-03-2021,VILA NOVA DE GAIA,288,21,96,"[0,120]",Baixo a Moderado,,,,288,Norte,PORTO,1317,16846.43,300472,18349,15568,10972,8224,6281,14505,25477,41045,59394,1783.64,352.57,243.65,151.23
03-03-2021,VILA NOVA DE PAIVA,1,0,21,"[0,120]",Baixo a Moderado,,,,1,Centro,VISEU,1822,17553.28,4687,289,272,233,217,241,458,691,963,1252,26.7,7.13,5.49,3.94
03-03-2021,VILA NOVA DE POIARES,14,1,202,"[120,240]",Moderado,,,,14,Centro,COIMBRA,0617,8445.3,6939,380,284,262,235,182,417,679,963,1343,82.17,15.9,11.4,8.04
03-03-2021,VILA POUCA DE AGUIAR,12,1,100,"[0,120]",Baixo a Moderado,,,,12,Norte,VILA REAL,1713,43706.62,11961,860,817,733,601,627,1228,1961,2778,3638,27.37,8.32,6.36,4.49
03-03-2021,VILA REAL,27,2,54,"[0,120]",Baixo a Moderado,,,,27,Norte,VILA REAL,1714,37880.28,49962,3025,2498,2065,1579,1466,3045,5110,7608,10633,131.9,28.07,20.08,13.49
03-03-2021,VILA REAL DE SANTO ANTÓNIO,43,3,229,"[120,240]",Moderado,,,,43,Algarve,FARO,0816,6125.0,18749,1172,1069,811,569,586,1155,1966,3035,4207,306.11,68.69,49.55,32.1
03-03-2021,VILA VELHA DE RÓDÃO,0,0,0,"[0,120]",Baixo a Moderado,,,,0,Centro,CASTELO BRANCO,0511,32991.16,3144,209,229,180,283,306,589,769,998,1207,9.53,3.66,3.03,2.33
03-03-2021,VILA VERDE,39,3,83,"[0,120]",Baixo a Moderado,,,,39,Norte,BRAGA,0313,22866.52,46911,2365,2063,1667,1494,1437,2931,4598,6661,9026,205.15,39.47,29.13,20.11
03-03-2021,VILA VIÇOSA,1,0,13,"[0,120]",Baixo a Moderado,,,,1,Alentejo,ÉVORA,0714,19485.89,7656,487,379,342,345,324,669,1011,1390,1877,39.29,9.63,7.13,5.19
03-03-2021,VIMIOSO,3,0,75,"[0,120]",Baixo a Moderado,,,,3,Norte,BRAGANÇA,0411,48158.51,4023,274,230,261,293,335,628,889,1119,1393,8.35,2.89,2.32,1.85
03-03-2021,VINHAIS,5,0,65,"[0,120]",Baixo a Moderado,,,,5,Norte,BRAGANÇA,0412,69475.09,7746,599,577,636,641,815,1456,2092,2669,3268,11.15,4.7,3.84,3.01
03-03-2021,VISEU,102,7,105,"[0,120]",Baixo a Moderado,,,,102,Centro,VISEU,1823,50710.14,97249,5769,5038,4140,3158,2710,5868,10008,15046,20815,191.77,41.05,29.67,19.74
03-03-2021,VIZELA,4,0,17,"[0,120]",Baixo a Moderado,,,,4,Norte,BRAGA,0314,2469.83,23897,1258,928,655,509,371,880,1535,2463,3721,967.49,150.65,99.72,62.15
03-03-2021,VOUZELA,5,0,52,"[0,120]",Baixo a Moderado,,,,5,Centro,VISEU,1824,19369.46,9619,626,605,554,532,507,1039,1593,2198,2824,49.66,14.58,11.35,8.22
10-03-2021,ABRANTES,9,1,26,"[0,120]",Baixo a Moderado,,,,9,Lisboa e Vale do Tejo,SANTARÉM,1401,71469.08,35130,2473,2213,1730,1748,2021,3769,5499,7712,10185,49.15,14.25,10.79,7.69
10-03-2021,ÁGUEDA,37,3,80,"[0,120]",Baixo a Moderado,,,,37,Centro,AVEIRO,0101,33527.44,46075,3237,2713,2090,1635,1496,3131,5221,7934,11171,137.43,33.32,23.66,15.57
10-03-2021,AGUIAR DA BEIRA,2,0,43,"[0,120]",Baixo a Moderado,,,,2,Centro,GUARDA,0901,20676.57,4652,304,281,235,239,148,387,622,903,1207,22.5,5.84,4.37,3.01
10-03-2021,ALANDROAL,2,0,40,"[0,120]",Baixo a Moderado,,,,2,Alentejo,ÉVORA,0701,54267.81,4992,307,256,296,299,377,676,972,1228,1535,9.2,2.83,2.26,1.79
10-03-2021,ALBERGARIA-A-VELHA,26,2,108,"[0,120]",Baixo a Moderado,,,,26,Centro,AVEIRO,0102,15882.5,24144,1550,1298,996,687,680,1367,2363,3661,5211,152.02,32.81,23.05,14.88
10-03-2021,ALBUFEIRA,43,3,104,"[0,120]",Baixo a Moderado,,,,43,Algarve,FARO,0801,14066.42,41528,2067,1717,1425,985,858,1843,3268,4985,7052,295.24,50.14,35.44,23.23
10-03-2021,ALCÁCER DO SAL,6,0,51,"[0,120]",Baixo a Moderado,,,,6,Alentejo,SETÚBAL,1501,149987.3,11659,884,814,623,623,602,1225,1848,2662,3546,7.77,2.36,1.77,1.23
10-03-2021,ALCANENA,16,1,125,"[120,240]",Moderado,,,,16,Lisboa e Vale do Tejo,SANTARÉM,1402,12732.86,12809,891,744,628,536,588,1124,1752,2496,3387,100.6,26.6,19.6,13.76
10-03-2021,ALCOBAÇA,17,1,32,"[0,120]",Baixo a Moderado,,,,17,Lisboa e Vale do Tejo,LEIRIA,1001,40814.09,53555,3420,2927,2466,2059,1676,3735,6201,9128,12548,131.22,30.74,22.36,15.19
10-03-2021,ALCOCHETE,24,2,121,"[120,240]",Moderado,,,,24,Lisboa e Vale do Tejo,SETÚBAL,1502,12836.48,19787,857,834,691,476,447,923,1614,2448,3305,154.15,25.75,19.07,12.57
10-03-2021,ALCOUTIM,2,0,93,"[0,120]",Baixo a Moderado,,,,2,Algarve,FARO,0802,57536.33,2159,191,188,163,190,267,457,620,808,999,3.75,1.74,1.4,1.08
10-03-2021,ALENQUER,86,6,195,"[120,240]",Moderado,,,,86,Lisboa e Vale do Tejo,LISBOA,1101,30421.92,44052,2298,2062,1629,1330,1155,2485,4114,6176,8474,144.8,27.85,20.3,13.52
10-03-2021,ALFÂNDEGA DA FÉ,0,0,0,"[0,120]",Baixo a Moderado,,,,0,Norte,BRAGANÇA,0401,32194.64,4550,325,277,301,274,325,599,900,1177,1502,14.13,4.67,3.66,2.8
10-03-2021,ALIJÓ,9,1,85,"[0,120]",Baixo a Moderado,,,,9,Norte,VILA REAL,1701,29759.89,10625,766,687,635,542,666,1208,1843,2530,3296,35.7,11.08,8.5,6.19
10-03-2021,ALJEZUR,6,0,107,"[0,120]",Baixo a Moderado,,,,6,Algarve,FARO,0803,32349.95,5594,316,336,335,320,410,730,1065,1401,1717,17.29,5.31,4.33,3.29
10-03-2021,ALJUSTREL,12,1,146,"[120,240]",Moderado,,,,12,Alentejo,BEJA,0201,45847.41,8247,635,521,443,347,358,705,1148,1669,2304,17.99,5.03,3.64,2.5
10-03-2021,ALMADA,225,16,133,"[120,240]",Moderado,,,,225,Lisboa e Vale do Tejo,SETÚBAL,1503,7000.89,169039,10469,9777,7876,6144,5111,11255,19131,28908,39377,2414.5,562.45,412.91,273.26
10-03-2021,ALMEIDA,2,0,34,"[0,120]",Baixo a Moderado,,,,2,Centro,GUARDA,0902,51798.46,5830,441,419,396,458,393,851,1247,1666,2107,11.26,4.07,3.22,2.41
10-03-2021,ALMEIRIM,28,2,124,"[120,240]",Moderado,,,,28,Lisboa e Vale do Tejo,SANTARÉM,1403,22212.05,22546,1342,1353,1106,866,843,1709,2815,4168,5510,101.5,24.81,18.76,12.67
10-03-2021,ALMODÔVAR,1,0,15,"[0,120]",Baixo a Moderado,,,,1,Alentejo,BEJA,0202,77788.03,6725,414,443,396,373,328,701,1097,1540,1954,8.65,2.51,1.98,1.41
10-03-2021,ALPIARÇA,8,1,113,"[0,120]",Baixo a Moderado,,,,8,Lisboa e Vale do Tejo,SANTARÉM,1404,9536.33,7059,515,486,363,333,274,607,970,1456,1971,74.02,20.67,15.27,10.17
10-03-2021,ALTER DO CHÃO,1,0,32,"[0,120]",Baixo a Moderado,,,,1,Alentejo,PORTALEGRE,1201,36206.62,3165,201,163,136,208,187,395,531,694,895,8.74,2.47,1.92,1.47
10-03-2021,ALVAIÁZERE,3,0,45,"[0,120]",Baixo a Moderado,,,,3,Centro,LEIRIA,1002,16047.76,6597,419,389,346,406,539,945,1291,1680,2099,41.11,13.08,10.47,8.04
10-03-2021,ALVITO,0,0,0,"[0,120]",Baixo a Moderado,,,,0,Alentejo,BEJA,0203,26485.32,2477,145,110,105,111,89,200,305,415,560,9.35,2.11,1.57,1.15
10-03-2021,AMADORA,274,20,149,"[120,240]",Moderado,,,,274,Lisboa e Vale do Tejo,LISBOA,1115,2378.47,184106,11186,10936,8780,6460,5890,12350,21130,32066,43252,7742.05,1818.84,1348.44,888.56
10-03-2021,AMARANTE,45,3,85,"[0,120]",Baixo a Moderado,,,,45,Norte,PORTO,1301,30133.15,53193,3086,2413,1812,1643,1311,2954,4766,7179,10265,176.53,34.07,23.82,15.82
10-03-2021,AMARES,5,0,28,"[0,120]",Baixo a Moderado,,,,5,Norte,BRAGA,0301,8195.41,18129,1001,829,622,489,524,1013,1635,2464,3465,221.22,42.28,30.07,19.95
10-03-2021,ANADIA,21,1,77,"[0,120]",Baixo a Moderado,,,,21,Centro,AVEIRO,0103,21663.48,27258,1931,1698,1376,1208,1262,2470,3846,5544,7475,125.83,34.51,25.59,17.75
10-03-2021,ANGRA DO HEROÍSMO,1,0,3,"[0,120]",Baixo a Moderado,,,,1,Açores,AÇORES,4301,23899.66,33807,2006,1473,1122,768,635,1403,2525,3998,6004,141.45,25.12,16.73,10.56
10-03-2021,ANSIÃO,3,0,25,"[0,120]",Baixo a Moderado,,,,3,Centro,LEIRIA,1003,17609.42,12039,727,709,646,694,530,1224,1870,2579,3306,68.37,18.77,14.65,10.62
10-03-2021,ARCOS DE VALDEVEZ,26,2,124,"[120,240]",Moderado,,,,26,Norte,VIANA DO CASTELO,1601,44759.64,20926,1329,1338,1282,1343,1515,2858,4140,5478,6807,46.75,15.21,12.24,9.25
10-03-2021,ARGANIL,10,1,91,"[0,120]",Baixo a Moderado,,,,10,Centro,COIMBRA,0601,33283.93,11014,672,648,612,559,596,1155,1767,2415,3087,33.09,9.27,7.26,5.31
10-03-2021,ARMAMAR,9,1,156,"[120,240]",Moderado,,,,9,Norte,VISEU,1801,11723.73,5769,357,305,309,285,310,595,904,1209,1566,49.21,13.36,10.31,7.71
10-03-2021,AROUCA,18,1,87,"[0,120]",Baixo a Moderado,,,,18,Norte,AVEIRO,0104,32910.52,20720,1306,1047,753,683,683,1366,2119,3166,4472,62.96,13.59,9.62,6.44
10-03-2021,ARRAIOLOS,3,0,43,"[0,120]",Baixo a Moderado,,,,3,Alentejo,ÉVORA,0702,68374.55,6928,435,384,283,367,480,847,1130,1514,1949,10.13,2.85,2.21,1.65
10-03-2021,ARRONCHES,4,0,142,"[120,240]",Moderado,,,,4,Alentejo,PORTALEGRE,1202,31464.72,2820,155,142,162,187,179,366,528,670,825,8.96,2.62,2.13,1.68
10-03-2021,ARRUDA DOS VINHOS,9,1,58,"[0,120]",Baixo a Moderado,,,,9,Lisboa e Vale do Tejo,LISBOA,1102,7795.93,15412,738,738,562,509,438,947,1509,2247,2985,197.69,38.29,28.82,19.36
10-03-2021,AVEIRO,70,5,89,"[0,120]",Baixo a Moderado,,,,70,Centro,AVEIRO,0105,19757.57,78734,4520,4004,3050,2250,2103,4353,7403,11407,15927,398.49,80.61,57.73,37.47
10-03-2021,AVIS,2,0,47,"[0,120]",Baixo a Moderado,,,,2,Alentejo,PORTALEGRE,1203,60596.51,4247,315,225,206,251,273,524,730,955,1270,7.01,2.1,1.58,1.2
10-03-2021,AZAMBUJA,20,1,88,"[0,120]",Baixo a Moderado,,,,20,Lisboa e Vale do Tejo,LISBOA,1103,26265.65,22716,1322,1171,1070,798,618,1416,2486,3657,4979,86.48,18.96,13.92,9.46
10-03-2021,BAIÃO,28,2,149,"[120,240]",Moderado,,,,28,Norte,PORTO,1302,17452.83,18748,1070,862,714,686,725,1411,2125,2987,4057,107.42,23.25,17.11,12.18
10-03-2021,BARCELOS,112,8,96,"[0,120]",Baixo a Moderado,,,,112,Norte,BRAGA,0302,37890.14,116187,6721,5325,3619,2991,2562,5553,9172,14497,21218,306.64,56.0,38.26,24.21
10-03-2021,BARRANCOS,1,0,61,"[0,120]",Baixo a Moderado,,,,1,Alentejo,BEJA,0204,16841.73,1634,90,65,65,94,61,155,220,285,375,9.7,2.23,1.69,1.31
10-03-2021,BARREIRO,79,6,105,"[0,120]",Baixo a Moderado,,,,79,Lisboa e Vale do Tejo,SETÚBAL,1504,3639.07,75147,5194,5565,4459,3105,1767,4872,9331,14896,20090,2065.05,552.07,409.34,256.42
10-03-2021,BATALHA,19,1,119,"[0,120]",Baixo a Moderado,,,,19,Centro,LEIRIA,1004,10341.6,15963,873,762,649,529,549,1078,1727,2489,3362,154.35,32.51,24.07,16.7
10-03-2021,BEJA,53,4,158,"[120,240]",Moderado,,,,53,Alentejo,BEJA,0205,114647.55,33579,2005,1840,1386,1272,1039,2311,3697,5537,7542,29.29,6.58,4.83,3.22
10-03-2021,BELMONTE,8,1,125,"[120,240]",Moderado,,,,8,Centro,CASTELO BRANCO,0501,11875.91,6398,444,321,325,310,355,665,990,1311,1755,53.87,14.78,11.04,8.34
10-03-2021,BENAVENTE,35,2,114,"[0,120]",Baixo a Moderado,,,,35,Lisboa e Vale do Tejo,SANTARÉM,1405,52138.39,30602,1468,1376,1141,876,643,1519,2660,4036,5504,58.69,10.56,7.74,5.1
10-03-2021,BOMBARRAL,22,2,175,"[120,240]",Moderado,,,,22,Lisboa e Vale do Tejo,LEIRIA,1005,9128.55,12558,875,714,561,491,429,920,1481,2195,3070,137.56,33.63,24.04,16.22
10-03-2021,BORBA,1,0,15,"[0,120]",Baixo a Moderado,,,,1,Alentejo,ÉVORA,0703,14518.65,6736,430,375,279,436,392,828,1107,1482,1912,46.39,13.17,10.21,7.62
10-03-2021,BOTICAS,2,0,40,"[0,120]",Baixo a Moderado,,,,2,Norte,VILA REAL,1702,32195.66,4998,347,306,311,305,380,685,996,1302,1649,15.52,5.12,4.04,3.09
10-03-2021,BRAGA,71,5,39,"[0,120]",Baixo a Moderado,,,,71,Norte,BRAGA,0303,18339.95,182679,10029,7963,5241,4320,3671,7991,13232,21195,31224,996.07,170.25,115.57,72.15
10-03-2021,BRAGANÇA,9,1,27,"[0,120]",Baixo a Moderado,,,,9,Norte,BRAGANÇA,0402,117357.27,33607,2402,1855,1652,1393,1163,2556,4208,6063,8465,28.64,7.21,5.17,3.59
10-03-2021,CABECEIRAS DE BASTO,6,0,38,"[0,120]",Baixo a Moderado,,,,6,Norte,BRAGA,0304,24182.16,15628,774,594,544,575,574,1149,1693,2287,3061,64.63,12.66,9.46,7.0
10-03-2021,CADAVAL,30,2,219,"[120,240]",Moderado,,,,30,Lisboa e Vale do Tejo,LISBOA,1104,17489.3,13673,813,796,756,621,625,1246,2002,2798,3611,78.18,20.65,16.0,11.45
10-03-2021,CALDAS DA RAINHA,45,3,87,"[0,120]",Baixo a Moderado,,,,45,Lisboa e Vale do Tejo,LEIRIA,1006,25569.47,51912,3035,2684,2186,1899,1705,3604,5790,8474,11509,203.03,45.01,33.14,22.64
10-03-2021,CALHETA,8,1,74,"[0,120]",Baixo a Moderado,,,,8,Madeira,MADEIRA,3101,11150.43,10867,576,497,507,399,415,814,1321,1818,2394,97.46,21.47,16.3,11.85
10-03-2021,CALHETA (AÇORES),0,0,0,"[0,120]",Baixo a Moderado,,,,0,Açores,AÇORES,4501,12626.4,3184,215,159,141,139,122,261,402,561,776,25.22,6.15,4.44,3.18
10-03-2021,CÂMARA DE LOBOS,190,14,564,"[480,960]",Muito Elevado,,,,190,Madeira,MADEIRA,3102,5216.67,33675,1396,1059,834,545,381,926,1760,2819,4215,645.49,80.79,54.03,33.74
10-03-2021,CAMINHA,18,1,113,"[0,120]",Baixo a Moderado,,,,18,Norte,VIANA DO CASTELO,1602,13652.14,15877,1046,944,818,646,656,1302,2120,3064,4110,116.3,30.11,22.44,15.53
10-03-2021,CAMPO MAIOR,2,0,25,"[0,120]",Baixo a Moderado,,,,2,Alentejo,PORTALEGRE,1204,24720.16,7874,471,364,351,279,327,606,957,1321,1792,31.85,7.25,5.34,3.87
10-03-2021,CANTANHEDE,17,1,49,"[0,120]",Baixo a Moderado,,,,17,Centro,COIMBRA,0602,39088.02,35011,2346,2096,1880,1709,1451,3160,5040,7136,9482,89.57,24.26,18.26,12.89
10-03-2021,CARRAZEDA DE ANSIÃES,18,1,318,"[240,480]",Elevado,,,,18,Norte,BRAGANÇA,0403,27924.09,5666,424,389,391,312,465,777,1168,1557,1981,20.29,7.09,5.58,4.18
10-03-2021,CARREGAL DO SAL,1,0,11,"[0,120]",Baixo a Moderado,,,,1,Centro,VISEU,1802,11689.21,9271,587,562,486,462,376,838,1324,1886,2473,79.31,21.16,16.13,11.33
10-03-2021,CARTAXO,14,1,59,"[0,120]",Baixo a Moderado,,,,14,Lisboa e Vale do Tejo,SANTARÉM,1406,15817.28,23843,1415,1376,1142,861,632,1493,2635,4011,5426,150.74,34.3,25.36,16.66
10-03-2021,CASCAIS,248,18,116,"[0,120]",Baixo a Moderado,,,,248,Lisboa e Vale do Tejo,LISBOA,1105,9740.17,213608,12151,11444,8680,6469,5248,11717,20397,31841,43992,2193.1,451.66,326.91,209.41
10-03-2021,CASTANHEIRA DE PÊRA,6,0,230,"[120,240]",Moderado,,,,6,Centro,LEIRIA,1007,6677.45,2614,233,195,157,190,187,377,534,729,962,39.15,14.41,10.92,8.0
10-03-2021,CASTELO BRANCO,12,1,23,"[0,120]",Baixo a Moderado,,,,12,Centro,CASTELO BRANCO,0502,143819.15,51987,3528,3042,2499,2229,2225,4454,6953,9995,13523,36.15,9.4,6.95,4.83
10-03-2021,CASTELO DE PAIVA,40,3,259,"[240,480]",Elevado,,,,40,Norte,AVEIRO,0106,11500.53,15454,881,697,545,420,431,851,1396,2093,2974,134.37,25.86,18.2,12.14
10-03-2021,CASTELO DE VIDE,3,0,103,"[0,120]",Baixo a Moderado,,,,3,Alentejo,PORTALEGRE,1205,26491.24,2919,204,173,179,147,170,317,496,669,873,11.02,3.3,2.53,1.87
10-03-2021,CASTRO DAIRE,5,0,36,"[0,120]",Baixo a Moderado,,,,5,Centro,VISEU,1803,37904.13,13823,942,857,765,732,773,1505,2270,3127,4069,36.47,10.74,8.25,5.99
10-03-2021,CASTRO MARIM,3,0,48,"[0,120]",Baixo a Moderado,,,,3,Algarve,FARO,0804,30084.37,6237,370,345,334,322,344,666,1000,1345,1715,20.73,5.7,4.47,3.32
10-03-2021,CASTRO VERDE,0,0,0,"[0,120]",Baixo a Moderado,,,,0,Alentejo,BEJA,0206,56944.23,6949,437,347,303,275,227,502,805,1152,1589,12.2,2.79,2.02,1.41
10-03-2021,CELORICO DA BEIRA,1,0,14,"[0,120]",Baixo a Moderado,,,,1,Centro,GUARDA,0903,24721.63,6928,430,416,363,369,535,904,1267,1683,2113,28.02,8.55,6.81,5.12
10-03-2021,CELORICO DE BASTO,4,0,21,"[0,120]",Baixo a Moderado,,,,4,Norte,BRAGA,0305,18107.02,19040,1001,802,668,728,729,1457,2125,2927,3928,105.15,21.69,16.17,11.74
10-03-2021,CHAMUSCA,0,0,0,"[0,120]",Baixo a Moderado,,,,0,Lisboa e Vale do Tejo,SANTARÉM,1407,74600.54,9197,629,583,553,465,579,1044,1597,2180,2809,12.33,3.77,2.92,2.14
10-03-2021,CHAVES,18,1,46,"[0,120]",Baixo a Moderado,,,,18,Norte,VILA REAL,1703,59122.95,39343,2676,2429,1991,1886,1918,3804,5795,8224,10900,66.54,18.44,13.91,9.8
10-03-2021,CINFÃES,37,3,203,"[120,240]",Moderado,,,,37,Norte,VISEU,1804,23928.76,18244,1067,902,779,734,758,1492,2271,3173,4240,76.24,17.72,13.26,9.49
10-03-2021,COIMBRA,251,18,187,"[120,240]",Moderado,,,,251,Centro,COIMBRA,0603,31939.94,134166,9489,8734,6353,5139,5074,10213,16566,25300,34789,420.06,108.92,79.21,51.87
10-03-2021,CONDEIXA-A-NOVA,27,2,152,"[120,240]",Moderado,,,,27,Centro,COIMBRA,0604,13867.47,17733,871,809,717,583,490,1073,1790,2599,3470,127.88,25.02,18.74,12.91
10-03-2021,CONSTÂNCIA,2,0,50,"[0,120]",Baixo a Moderado,,,,2,Lisboa e Vale do Tejo,SANTARÉM,1408,8036.58,4030,211,183,187,148,155,303,490,673,884,50.14,11.0,8.37,6.1
10-03-2021,CORUCHE,14,1,80,"[0,120]",Baixo a Moderado,,,,14,Lisboa e Vale do Tejo,SANTARÉM,1409,111572.03,17471,1294,1090,1095,1096,1019,2115,3210,4300,5594,15.66,5.01,3.85,2.88
10-03-2021,CORVO,0,0,0,"[0,120]",Baixo a Moderado,,,,0,Açores,AÇORES,4901,1711.45,464,22,21,11,13,19,32,43,64,86,27.12,5.03,3.74,2.51
10-03-2021,COVILHÃ,65,5,139,"[120,240]",Moderado,,,,65,Centro,CASTELO BRANCO,0503,55560.06,46787,3533,2998,2365,2111,2193,4304,6669,9667,13200,84.21,23.76,17.4,12.0
10-03-2021,CRATO,0,0,0,"[0,120]",Baixo a Moderado,,,,0,Alentejo,PORTALEGRE,1206,39806.88,3129,229,258,163,182,228,410,573,831,1060,7.86,2.66,2.09,1.44
10-03-2021,CUBA,5,0,109,"[0,120]",Baixo a Moderado,,,,5,Alentejo,BEJA,0207,17208.72,4595,255,233,206,190,143,333,539,772,1027,26.7,5.97,4.49,3.13
10-03-2021,ELVAS,18,1,88,"[0,120]",Baixo a Moderado,,,,18,Alentejo,PORTALEGRE,1207,63128.86,20528,1057,1145,902,852,810,1662,2564,3709,4766,32.52,7.55,5.88,4.06
10-03-2021,ENTRONCAMENTO,22,2,102,"[0,120]",Baixo a Moderado,,,,22,Lisboa e Vale do Tejo,SANTARÉM,1410,1372.81,21558,1066,930,868,695,592,1287,2155,3085,4151,1570.14,302.33,224.69,156.96
10-03-2021,ESPINHO,29,2,98,"[0,120]",Baixo a Moderado,,,,29,Norte,AVEIRO,0107,2105.68,29516,2205,1993,1430,1177,960,2137,3567,5560,7765,1401.52,368.71,264.01,169.37
10-03-2021,ESPOSENDE,24,2,70,"[0,120]",Baixo a Moderado,,,,24,Norte,BRAGA,0306,9540.98,34177,1831,1522,1095,894,723,1617,2712,4234,6065,358.21,63.57,44.38,28.42
10-03-2021,ESTARREJA,21,2,81,"[0,120]",Baixo a Moderado,,,,21,Centro,AVEIRO,0108,10817.33,26006,1503,1399,1106,953,728,1681,2787,4186,5689,240.42,52.59,38.7,25.76
10-03-2021,ESTREMOZ,9,1,71,"[0,120]",Baixo a Moderado,,,,9,Alentejo,ÉVORA,0704,51379.95,12728,789,613,697,786,877,1663,2360,2973,3762,24.77,7.32,5.79,4.59
10-03-2021,ÉVORA,19,1,36,"[0,120]",Baixo a Moderado,,,,19,Alentejo,ÉVORA,0705,130707.58,52428,3569,2852,2176,1966,1803,3769,5945,8797,12366,40.11,9.46,6.73,4.55
10-03-2021,FAFE,20,1,42,"[0,120]",Baixo a Moderado,,,,20,Norte,BRAGA,0307,21908.11,48060,3044,2455,1679,1403,1208,2611,4290,6745,9789,219.37,44.68,30.79,19.58
10-03-2021,FARO,85,6,139,"[120,240]",Moderado,,,,85,Algarve,FARO,0805,20256.79,61015,3847,3364,2604,2055,1601,3656,6260,9624,13471,301.2,66.5,47.51,30.9
10-03-2021,FELGUEIRAS,70,5,124,"[120,240]",Moderado,,,,70,Norte,PORTO,1303,11573.75,56422,2951,2302,1601,1316,973,2289,3890,6192,9143,487.49,79.0,53.5,33.61
10-03-2021,FERREIRA DO ALENTEJO,15,1,191,"[120,240]",Moderado,,,,15,Alentejo,BEJA,0208,64820.68,7845,515,414,372,343,345,688,1060,1474,1989,12.1,3.07,2.27,1.64
10-03-2021,FERREIRA DO ZÊZERE,5,0,63,"[0,120]",Baixo a Moderado,,,,5,Lisboa e Vale do Tejo,SANTARÉM,1411,19038.03,7959,470,370,416,465,456,921,1337,1707,2177,41.81,11.44,8.97,7.02
10-03-2021,FIGUEIRA DA FOZ,112,8,191,"[120,240]",Moderado,,,,112,Centro,COIMBRA,0605,37905.26,58747,4032,3597,2887,2495,2043,4538,7425,11022,15054,154.98,39.72,29.08,19.59
10-03-2021,FIGUEIRA DE CASTELO RODRIGO,1,0,18,"[0,120]",Baixo a Moderado,,,,1,Centro,GUARDA,0904,50857.46,5584,347,352,290,352,391,743,1033,1385,1732,10.98,3.41,2.72,2.03
10-03-2021,FIGUEIRÓ DOS VINHOS,2,0,36,"[0,120]",Baixo a Moderado,,,,2,Centro,LEIRIA,1008,17344.0,5568,402,386,322,309,351,660,982,1368,1770,32.1,10.21,7.89,5.66
10-03-2021,FORNOS DE ALGODRES,2,0,44,"[0,120]",Baixo a Moderado,,,,2,Centro,GUARDA,0905,13145.05,4528,261,218,247,256,232,488,735,953,1214,34.45,9.24,7.25,5.59
10-03-2021,FREIXO DE ESPADA À CINTA,0,0,0,"[0,120]",Baixo a Moderado,,,,0,Norte,BRAGANÇA,0404,24414.29,3298,211,177,231,196,189,385,616,793,1004,13.51,4.11,3.25,2.52
10-03-2021,FRONTEIRA,0,0,0,"[0,120]",Baixo a Moderado,,,,0,Alentejo,PORTALEGRE,1208,24859.58,2974,213,182,149,156,168,324,473,655,868,11.96,3.49,2.63,1.9
10-03-2021,FUNCHAL,1173,84,1128,"[960,Max]",Extremamente Elevado,,,,1173,Madeira,MADEIRA,3103,7616.2,104024,6382,5086,3643,2821,1990,4811,8454,13540,19922,1365.86,261.58,177.78,111.0
10-03-2021,FUNDÃO,10,1,38,"[0,120]",Baixo a Moderado,,,,10,Centro,CASTELO BRANCO,0504,70019.79,26495,1781,1464,1432,1357,1643,3000,4432,5896,7677,37.84,10.96,8.42,6.33
10-03-2021,GAVIÃO,4,0,123,"[120,240]",Moderado,,,,4,Alentejo,PORTALEGRE,1209,29459.45,3263,189,186,222,263,293,556,778,964,1153,11.08,3.91,3.27,2.64
10-03-2021,GÓIS,2,0,53,"[0,120]",Baixo a Moderado,,,,2,Centro,COIMBRA,0606,26330.19,3805,235,199,240,233,244,477,717,916,1151,14.45,4.37,3.48,2.72
10-03-2021,GOLEGÃ,6,0,112,"[0,120]",Baixo a Moderado,,,,6,Lisboa e Vale do Tejo,SANTARÉM,1412,8431.67,5339,356,299,281,243,255,498,779,1078,1434,63.32,17.01,12.78,9.24
10-03-2021,GONDOMAR,138,10,83,"[0,120]",Baixo a Moderado,,,,138,Norte,PORTO,1304,13191.76,165985,10555,8755,6222,4450,3364,7814,14036,22791,33346,1258.22,252.77,172.76,106.4
10-03-2021,GOUVEIA,11,1,89,"[0,120]",Baixo a Moderado,,,,11,Centro,GUARDA,0906,30061.17,12387,871,931,780,783,810,1593,2373,3304,4175,41.21,13.89,10.99,7.89
10-03-2021,GRÂNDOLA,7,1,48,"[0,120]",Baixo a Moderado,,,,7,Alentejo,SETÚBAL,1505,82593.66,14639,834,834,708,688,672,1360,2068,2902,3736,17.72,4.52,3.51,2.5
10-03-2021,GUARDA,18,1,46,"[0,120]",Baixo a Moderado,,,,18,Centro,GUARDA,0907,71209.58,38969,2477,2041,1686,1415,1474,2889,4575,6616,9093,54.72,12.77,9.29,6.42
10-03-2021,GUIMARÃES,75,5,49,"[0,120]",Baixo a Moderado,,,,75,Norte,BRAGA,0308,24099.96,152309,9394,7074,4809,3877,2948,6825,11634,18708,28102,631.99,116.61,77.63,48.27
10-03-2021,HORTA,0,0,0,"[0,120]",Baixo a Moderado,,,,0,Açores,AÇORES,4701,17305.53,14521,818,658,468,352,302,654,1122,1780,2598,83.91,15.01,10.29,6.48
10-03-2021,IDANHA-A-NOVA,2,0,25,"[0,120]",Baixo a Moderado,,,,2,Centro,CASTELO BRANCO,0505,141633.51,8043,518,490,519,672,974,1646,2165,2655,3173,5.68,2.24,1.87,1.53
10-03-2021,ÍLHAVO,79,6,204,"[120,240]",Moderado,,,,79,Centro,AVEIRO,0110,7347.55,38699,2227,1943,1444,1193,850,2043,3487,5430,7657,526.66,104.21,73.9,47.46
10-03-2021,LAGOA (FARO),19,1,83,"[0,120]",Baixo a Moderado,,,,19,Algarve,FARO,0806,8825.45,22762,1314,1168,919,749,670,1419,2338,3506,4820,257.93,54.62,39.73,26.49
10-03-2021,LAGOA,10,1,68,"[0,120]",Baixo a Moderado,,,,10,Açores,AÇORES,4201,4559.32,14721,536,458,349,238,235,473,822,1280,1816,322.9,39.83,28.08,18.03
10-03-2021,LAGOS,23,2,76,"[0,120]",Baixo a Moderado,,,,23,Algarve,FARO,0807,21299.27,30374,1744,1434,1247,1053,1029,2082,3329,4763,6507,142.61,30.55,22.36,15.63
10-03-2021,LAJES DAS FLORES,0,0,0,"[0,120]",Baixo a Moderado,,,,0,Açores,AÇORES,4801,7004.79,1463,88,53,62,46,54,100,162,215,303,20.89,4.33,3.07,2.31
10-03-2021,LAJES DO PICO,2,0,45,"[0,120]",Baixo a Moderado,,,,2,Açores,AÇORES,4601,15531.09,4490,304,231,223,159,162,321,544,775,1079,28.91,6.95,4.99,3.5
10-03-2021,LAMEGO,83,6,333,"[240,480]",Elevado,,,,83,Norte,VISEU,1805,16542.11,24895,1639,1284,1124,898,783,1681,2805,4089,5728,150.5,34.63,24.72,16.96
10-03-2021,LEIRIA,64,5,51,"[0,120]",Baixo a Moderado,,,,64,Centro,LEIRIA,1009,56508.83,125267,7389,6366,5090,3902,3159,7061,12151,18517,25906,221.68,45.84,32.77,21.5
10-03-2021,LISBOA,739,53,145,"[120,240]",Moderado,,,,739,Lisboa e Vale do Tejo,LISBOA,1106,10005.43,509515,33197,33340,27706,23037,26770,49807,77513,110853,144050,5092.6,1439.78,1107.98,774.74
10-03-2021,LOULÉ,78,6,114,"[0,120]",Baixo a Moderado,,,,78,Algarve,FARO,0808,76366.91,68697,3890,3350,2780,2358,2251,4609,7389,10739,14629,89.96,19.16,14.06,9.68
10-03-2021,LOURES,318,23,149,"[120,240]",Moderado,,,,318,Lisboa e Vale do Tejo,LISBOA,1107,16723.99,213687,12746,12794,9644,6669,5033,11702,21346,34140,46886,1277.73,280.35,204.14,127.64
10-03-2021,LOURINHÃ,17,1,66,"[0,120]",Baixo a Moderado,,,,17,Lisboa e Vale do Tejo,LISBOA,1108,14717.2,25855,1584,1243,992,842,645,1487,2479,3722,5306,175.68,36.05,25.29,16.84
10-03-2021,LOUSÃ,16,1,93,"[0,120]",Baixo a Moderado,,,,16,Centro,COIMBRA,0607,13840.01,17158,946,866,658,528,450,978,1636,2502,3448,123.97,24.91,18.08,11.82
10-03-2021,LOUSADA,45,3,96,"[0,120]",Baixo a Moderado,,,,45,Norte,PORTO,1305,9608.01,46755,2289,1698,1176,853,621,1474,2650,4348,6637,486.63,69.08,45.25,27.58
10-03-2021,MAÇÃO,0,0,0,"[0,120]",Baixo a Moderado,,,,0,Lisboa e Vale do Tejo,SANTARÉM,1413,39997.98,6267,386,362,390,440,657,1097,1487,1849,2235,15.67,5.59,4.62,3.72
10-03-2021,MACEDO DE CAVALEIROS,24,2,165,"[120,240]",Moderado,,,,24,Norte,BRAGANÇA,0405,69914.08,14516,1082,889,878,823,938,1761,2639,3528,4610,20.76,6.59,5.05,3.77
10-03-2021,MACHICO,82,6,410,"[240,480]",Elevado,,,,82,Madeira,MADEIRA,3104,6825.1,19981,1197,860,662,455,331,786,1448,2308,3505,292.76,51.36,33.82,21.22
10-03-2021,MADALENA,3,0,51,"[0,120]",Baixo a Moderado,,,,3,Açores,AÇORES,4602,14712.33,5895,334,256,173,190,179,369,542,798,1132,40.07,7.69,5.42,3.68
10-03-2021,MAFRA,85,6,100,"[0,120]",Baixo a Moderado,,,,85,Lisboa e Vale do Tejo,LISBOA,1109,29165.5,84816,3613,3334,2839,2089,1899,3988,6827,10161,13774,290.81,47.23,34.84,23.41
10-03-2021,MAIA,40,3,29,"[0,120]",Baixo a Moderado,,,,40,Norte,PORTO,1306,8293.94,138971,7801,6617,4512,3339,2631,5970,10482,17099,24900,1675.56,300.22,206.16,126.38
10-03-2021,MANGUALDE,15,1,81,"[0,120]",Baixo a Moderado,,,,15,Centro,VISEU,1806,21925.56,18510,1198,1128,885,852,743,1595,2480,3608,4806,84.42,21.92,16.46,11.31
10-03-2021,MANTEIGAS,6,0,200,"[120,240]",Moderado,,,,6,Centro,GUARDA,0908,12197.55,3007,258,197,159,167,146,313,472,669,927,24.65,7.6,5.48,3.87
10-03-2021,MARCO DE CANAVESES,19,1,37,"[0,120]",Baixo a Moderado,,,,19,Norte,PORTO,1307,20188.98,51496,2678,2060,1488,1265,1023,2288,3776,5836,8514,255.07,42.17,28.91,18.7
10-03-2021,MARINHA GRANDE,7,0,18,"[0,120]",Baixo a Moderado,,,,7,Centro,LEIRIA,1010,18725.19,38508,2365,2302,1638,1359,1058,2417,4055,6357,8722,205.65,46.58,33.95,21.66
10-03-2021,MARVÃO,0,0,0,"[0,120]",Baixo a Moderado,,,,0,Alentejo,PORTALEGRE,1210,15489.9,3005,198,185,142,197,237,434,576,761,959,19.4,6.19,4.91,3.72
10-03-2021,MATOSINHOS,96,7,55,"[0,120]",Baixo a Moderado,,,,96,Norte,PORTO,1308,6241.97,175357,11850,9977,7023,5024,3884,8908,15931,25908,37758,2809.31,604.9,415.06,255.22
10-03-2021,MEALHADA,24,2,121,"[120,240]",Moderado,,,,24,Centro,AVEIRO,0111,11065.66,19914,1163,1039,810,828,831,1659,2469,3508,4671,179.96,42.21,31.7,22.31
10-03-2021,MÊDA,2,0,44,"[0,120]",Baixo a Moderado,,,,2,Centro,GUARDA,0909,28604.92,4587,343,306,290,288,443,731,1021,1327,1670,16.04,5.84,4.64,3.57
10-03-2021,MELGAÇO,11,1,136,"[120,240]",Moderado,,,,11,Norte,VIANA DO CASTELO,1603,23824.58,8093,507,567,578,614,675,1289,1867,2434,2941,33.97,12.34,10.22,7.84
10-03-2021,MÉRTOLA,10,1,163,"[120,240]",Moderado,,,,10,Alentejo,BEJA,0209,129287.34,6142,400,390,378,423,600,1023,1401,1791,2191,4.75,1.69,1.39,1.08
10-03-2021,MESÃO FRIO,0,0,0,"[0,120]",Baixo a Moderado,,,,0,Norte,VILA REAL,1704,2664.87,3964,265,205,168,157,120,277,445,650,915,148.74,34.33,24.39,16.7
10-03-2021,MIRA,4,0,34,"[0,120]",Baixo a Moderado,,,,4,Centro,COIMBRA,0608,12403.38,11832,727,729,659,550,466,1016,1675,2404,3131,95.4,25.24,19.38,13.5
10-03-2021,MIRANDA DO CORVO,6,0,47,"[0,120]",Baixo a Moderado,,,,6,Centro,COIMBRA,0609,12637.79,12708,706,659,568,498,404,902,1470,2129,2835,100.55,22.43,16.85,11.63
10-03-2021,MIRANDA DO DOURO,0,0,0,"[0,120]",Baixo a Moderado,,,,0,Norte,BRAGANÇA,0406,48718.31,6830,482,429,442,463,470,933,1375,1804,2286,14.02,4.69,3.7,2.82
10-03-2021,MIRANDELA,12,1,55,"[0,120]",Baixo a Moderado,,,,12,Norte,BRAGANÇA,0407,65895.67,21754,1640,1315,1204,1078,947,2025,3229,4544,6184,33.01,9.38,6.9,4.9
10-03-2021,MOGADOURO,2,0,24,"[0,120]",Baixo a Moderado,,,,2,Norte,BRAGANÇA,0408,76064.93,8392,589,529,576,630,655,1285,1861,2390,2979,11.03,3.92,3.14,2.45
10-03-2021,MOIMENTA DA BEIRA,5,0,51,"[0,120]",Baixo a Moderado,,,,5,Norte,VISEU,1807,21996.9,9736,576,514,471,416,461,877,1348,1862,2438,44.26,11.08,8.46,6.13
10-03-2021,MOITA,92,7,143,"[120,240]",Moderado,,,,92,Lisboa e Vale do Tejo,SETÚBAL,1506,5525.98,64407,4226,3646,2623,1801,1425,3226,5849,9495,13721,1165.53,248.3,171.82,105.85
10-03-2021,MONÇÃO,8,1,45,"[0,120]",Baixo a Moderado,,,,8,Norte,VIANA DO CASTELO,1604,21130.85,17869,1161,1105,1031,1006,972,1978,3009,4114,5275,84.56,24.96,19.47,14.24
10-03-2021,MONCHIQUE,0,0,0,"[0,120]",Baixo a Moderado,,,,0,Algarve,FARO,0809,39530.43,5077,353,384,321,355,392,747,1068,1452,1805,12.84,4.57,3.67,2.7
10-03-2021,MONDIM DE BASTO,6,0,86,"[0,120]",Baixo a Moderado,,,,6,Norte,VILA REAL,1705,17207.52,6946,395,300,314,284,283,567,881,1181,1576,40.36,9.16,6.86,5.12
10-03-2021,MONFORTE,8,1,269,"[240,480]",Elevado,,,,8,Alentejo,PORTALEGRE,1211,42024.82,2975,139,115,117,192,168,360,477,592,731,7.08,1.74,1.41,1.14
10-03-2021,MONTALEGRE,3,0,33,"[0,120]",Baixo a Moderado,,,,3,Norte,VILA REAL,1706,80545.71,8997,699,628,595,603,730,1333,1928,2556,3255,11.17,4.04,3.17,2.39
10-03-2021,MONTEMOR-O-NOVO,2,0,13,"[0,120]",Baixo a Moderado,,,,2,Alentejo,ÉVORA,0706,123296.65,15647,991,953,868,878,971,1849,2717,3670,4661,12.69,3.78,2.98,2.2
10-03-2021,MONTEMOR-O-VELHO,17,1,67,"[0,120]",Baixo a Moderado,,,,17,Centro,COIMBRA,0610,22896.23,25224,1496,1397,1217,1057,988,2045,3262,4659,6155,110.17,26.88,20.35,14.25
10-03-2021,MONTIJO,166,12,288,"[240,480]",Elevado,,,,166,Lisboa e Vale do Tejo,SETÚBAL,1507,34861.64,57614,2771,2441,1990,1554,1109,2663,4653,7094,9865,165.26,28.3,20.35,13.35
10-03-2021,MORA,0,0,0,"[0,120]",Baixo a Moderado,,,,0,Alentejo,ÉVORA,0707,44395.02,4138,336,275,252,238,257,495,747,1022,1358,9.32,3.06,2.3,1.68
10-03-2021,MORTÁGUA,1,0,11,"[0,120]",Baixo a Moderado,,,,1,Centro,VISEU,1808,25117.82,8803,638,584,535,499,460,959,1494,2078,2716,35.05,10.81,8.27,5.95
10-03-2021,MOURA,18,1,131,"[120,240]",Moderado,,,,18,Alentejo,BEJA,0210,95845.55,13718,817,656,665,542,461,1003,1668,2324,3141,14.31,3.28,2.42,1.74
10-03-2021,MOURÃO,1,0,41,"[0,120]",Baixo a Moderado,,,,1,Alentejo,ÉVORA,0708,27862.98,2450,139,108,80,104,109,213,293,401,540,8.79,1.94,1.44,1.05
10-03-2021,MURÇA,1,0,18,"[0,120]",Baixo a Moderado,,,,1,Norte,VILA REAL,1707,18937.11,5463,384,341,307,306,319,625,932,1273,1657,28.85,8.75,6.72,4.92
10-03-2021,MURTOSA,8,1,78,"[0,120]",Baixo a Moderado,,,,8,Centro,AVEIRO,0112,7308.78,10279,509,473,403,353,409,762,1165,1638,2147,140.63,29.37,22.41,15.94
10-03-2021,NAZARÉ,7,0,49,"[0,120]",Baixo a Moderado,,,,7,Lisboa e Vale do Tejo,LEIRIA,1011,8243.43,14165,967,903,670,420,396,816,1486,2389,3356,171.84,40.71,28.98,18.03
10-03-2021,NELAS,7,1,54,"[0,120]",Baixo a Moderado,,,,7,Centro,VISEU,1809,12571.48,12974,924,787,668,604,583,1187,1855,2642,3566,103.21,28.37,21.02,14.76
10-03-2021,NISA,0,0,0,"[0,120]",Baixo a Moderado,,,,0,Alentejo,PORTALEGRE,1212,57567.84,6061,405,389,355,483,478,961,1316,1705,2110,10.53,3.67,2.96,2.29
10-03-2021,NORDESTE,0,0,0,"[0,120]",Baixo a Moderado,,,,0,Açores,AÇORES,4202,10146.8,4862,246,180,124,161,162,323,447,627,873,47.92,8.6,6.18,4.41
10-03-2021,ÓBIDOS,4,0,34,"[0,120]",Baixo a Moderado,,,,4,Lisboa e Vale do Tejo,LEIRIA,1012,14155.44,11850,743,650,574,452,436,888,1462,2112,2855,83.72,20.17,14.92,10.33
10-03-2021,ODEMIRA,25,2,101,"[0,120]",Baixo a Moderado,,,,25,Alentejo,BEJA,0211,172060.15,24717,1475,1317,1225,1397,1349,2746,3971,5288,6763,14.37,3.93,3.07,2.31
10-03-2021,ODIVELAS,283,20,175,"[120,240]",Moderado,,,,283,Lisboa e Vale do Tejo,LISBOA,1116,2654.36,161774,9562,9038,6952,4641,3812,8453,15405,24443,34005,6095.48,1281.27,920.99,580.44
10-03-2021,OEIRAS,195,14,110,"[0,120]",Baixo a Moderado,,,,195,Lisboa e Vale do Tejo,LISBOA,1110,4588.31,177408,11580,11575,8566,6211,5855,12066,20632,32207,43787,3866.78,954.38,701.98,449.69
10-03-2021,OLEIROS,1,0,20,"[0,120]",Baixo a Moderado,,,,1,Centro,CASTELO BRANCO,0506,47109.31,5003,384,341,366,397,487,884,1250,1591,1975,10.62,4.19,3.38,2.65
10-03-2021,OLHÃO,37,3,83,"[0,120]",Baixo a Moderado,,,,37,Algarve,FARO,0810,13086.38,44405,2455,2309,1689,1342,1268,2610,4299,6608,9063,339.33,69.26,50.5,32.85
10-03-2021,OLIVEIRA DE AZEMÉIS,25,2,38,"[0,120]",Baixo a Moderado,,,,25,Norte,AVEIRO,0113,16110.41,66011,4155,3614,2794,2183,1738,3921,6715,10329,14484,409.75,89.91,64.12,41.68
10-03-2021,OLIVEIRA DE FRADES,2,0,20,"[0,120]",Baixo a Moderado,,,,2,Centro,VISEU,1810,14534.62,9936,553,475,438,359,415,774,1212,1687,2240,68.36,15.41,11.61,8.34
10-03-2021,OLIVEIRA DO BAIRRO,19,1,78,"[0,120]",Baixo a Moderado,,,,19,Centro,AVEIRO,0114,8731.99,24277,1327,1182,999,786,810,1596,2595,3777,5104,278.02,58.45,43.25,29.72
10-03-2021,OLIVEIRA DO HOSPITAL,6,0,31,"[0,120]",Baixo a Moderado,,,,6,Centro,COIMBRA,0611,23451.66,19253,1161,1097,962,924,960,1884,2846,3943,5104,82.1,21.76,16.81,12.14
10-03-2021,OURÉM,14,1,32,"[0,120]",Baixo a Moderado,,,,14,Lisboa e Vale do Tejo,SANTARÉM,1421,41668.03,44044,2463,2069,1899,1817,1603,3420,5319,7388,9851,105.7,23.64,17.73,12.77
10-03-2021,OURIQUE,3,0,65,"[0,120]",Baixo a Moderado,,,,3,Alentejo,BEJA,0212,66331.36,4607,313,287,284,268,227,495,779,1066,1379,6.95,2.08,1.61,1.17
10-03-2021,OVAR,18,1,33,"[0,120]",Baixo a Moderado,,,,18,Centro,AVEIRO,0115,14770.25,54260,3294,2709,1994,1636,1234,2870,4864,7573,10867,367.37,73.57,51.27,32.93
10-03-2021,PAÇOS DE FERREIRA,54,4,95,"[0,120]",Baixo a Moderado,,,,54,Norte,PORTO,1309,7099.29,56728,2903,2193,1518,1135,664,1799,3317,5510,8413,799.1,118.51,77.62,46.72
10-03-2021,PALMELA,120,9,187,"[120,240]",Moderado,,,,120,Lisboa e Vale do Tejo,SETÚBAL,1508,46512.01,64269,3402,3244,2635,1846,1391,3237,5872,9116,12518,138.18,26.91,19.6,12.62
10-03-2021,PAMPILHOSA DA SERRA,3,0,74,"[0,120]",Baixo a Moderado,,,,3,Centro,COIMBRA,0612,39646.24,4037,238,254,295,339,423,762,1057,1311,1549,10.18,3.91,3.31,2.67
10-03-2021,PAREDES,41,3,48,"[0,120]",Baixo a Moderado,,,,41,Norte,PORTO,1310,15675.69,86067,4272,3532,2412,1717,1258,2975,5387,8919,13191,549.04,84.15,56.9,34.36
10-03-2021,PAREDES DE COURA,5,0,59,"[0,120]",Baixo a Moderado,,,,5,Norte,VIANA DO CASTELO,1605,13818.59,8535,466,528,407,465,515,980,1387,1915,2381,61.76,17.23,13.86,10.04
10-03-2021,PEDRÓGÃO GRANDE,0,0,0,"[0,120]",Baixo a Moderado,,,,0,Centro,LEIRIA,1013,12874.75,3410,175,173,196,221,252,473,669,842,1017,26.49,7.9,6.54,5.2
10-03-2021,PENACOVA,19,1,139,"[120,240]",Moderado,,,,19,Centro,COIMBRA,0613,21673.23,13694,968,923,745,621,703,1324,2069,2992,3960,63.18,18.27,13.81,9.55
10-03-2021,PENAFIEL,44,3,63,"[0,120]",Baixo a Moderado,,,,44,Norte,PORTO,1311,21224.27,69772,3648,2823,2032,1663,1230,2893,4925,7748,11396,328.74,53.69,36.51,23.2
10-03-2021,PENALVA DO CASTELO,0,0,0,"[0,120]",Baixo a Moderado,,,,0,Centro,VISEU,1811,13433.92,7115,449,457,413,391,426,817,1230,1687,2136,52.96,15.9,12.56,9.16
10-03-2021,PENAMACOR,3,0,63,"[0,120]",Baixo a Moderado,,,,3,Centro,CASTELO BRANCO,0507,56370.69,4755,262,248,273,451,633,1084,1357,1605,1867,8.44,3.31,2.85,2.41
10-03-2021,PENEDONO,0,0,0,"[0,120]",Baixo a Moderado,,,,0,Norte,VISEU,1812,13370.75,2591,172,113,129,156,138,294,423,536,708,19.38,5.3,4.01,3.16
10-03-2021,PENELA,21,1,389,"[240,480]",Elevado,,,,21,Centro,COIMBRA,0614,13480.0,5397,314,324,274,359,344,703,977,1301,1615,40.04,11.98,9.65,7.25
10-03-2021,PENICHE,24,2,91,"[0,120]",Baixo a Moderado,,,,24,Lisboa e Vale do Tejo,LEIRIA,1014,7754.98,26501,1746,1504,1203,926,707,1633,2836,4340,6086,341.73,78.48,55.96,36.57
10-03-2021,PESO DA RÉGUA,10,1,63,"[0,120]",Baixo a Moderado,,,,10,Norte,VILA REAL,1708,9486.01,15773,1076,843,650,659,455,1114,1764,2607,3683,166.28,38.83,27.48,18.6
10-03-2021,PINHEL,5,0,59,"[0,120]",Baixo a Moderado,,,,5,Centro,GUARDA,0910,48452.12,8511,577,566,551,538,689,1227,1778,2344,2921,17.57,6.03,4.84,3.67
10-03-2021,POMBAL,61,4,119,"[0,120]",Baixo a Moderado,,,,61,Centro,LEIRIA,1015,62600.28,51461,3187,2791,2494,2328,2027,4355,6849,9640,12827,82.21,20.49,15.4,10.94
10-03-2021,PONTA DELGADA,14,1,21,"[0,120]",Baixo a Moderado,,,,14,Açores,AÇORES,4203,23298.65,67935,3108,2435,1726,1133,902,2035,3761,6196,9304,291.58,39.93,26.59,16.14
10-03-2021,PONTA DO SOL,55,4,640,"[480,960]",Muito Elevado,,,,55,Madeira,MADEIRA,3105,4622.03,8593,319,283,347,208,221,429,776,1059,1378,185.92,29.81,22.91,16.79
10-03-2021,PONTE DA BARCA,3,0,27,"[0,120]",Baixo a Moderado,,,,3,Norte,VIANA DO CASTELO,1606,18211.37,11180,635,576,517,554,490,1044,1561,2137,2772,61.39,15.22,11.73,8.57
10-03-2021,PONTE DE LIMA,41,3,99,"[0,120]",Baixo a Moderado,,,,41,Norte,VIANA DO CASTELO,1607,32025.46,41315,2321,2022,1720,1596,1462,3058,4778,6800,9121,129.01,28.48,21.23,14.92
10-03-2021,PONTE DE SOR,5,0,33,"[0,120]",Baixo a Moderado,,,,5,Alentejo,PORTALEGRE,1213,83971.16,14994,939,800,716,739,831,1570,2286,3086,4025,17.86,4.79,3.68,2.72
10-03-2021,PORTALEGRE,8,1,36,"[0,120]",Baixo a Moderado,,,,8,Alentejo,PORTALEGRE,1214,44713.64,22172,1577,1351,1137,993,984,1977,3114,4465,6042,49.59,13.51,9.99,6.96
10-03-2021,PORTEL,5,0,86,"[0,120]",Baixo a Moderado,,,,5,Alentejo,ÉVORA,0709,60100.57,5828,336,358,283,331,305,636,919,1277,1613,9.7,2.68,2.12,1.53
10-03-2021,PORTIMÃO,56,4,101,"[0,120]",Baixo a Moderado,,,,56,Algarve,FARO,0811,18206.29,55483,3182,2927,2116,1582,1400,2982,5098,8025,11207,304.75,61.56,44.08,28.0
10-03-2021,PORTO,245,17,113,"[0,120]",Baixo a Moderado,,,,245,Norte,PORTO,1312,4142.02,216606,15790,15193,11280,9409,10044,19453,30733,45926,61716,5229.5,1490.0,1108.79,741.98
10-03-2021,PORTO DE MÓS,15,1,64,"[0,120]",Baixo a Moderado,,,,15,Centro,LEIRIA,1016,26183.41,23275,1355,1210,1034,888,872,1760,2794,4004,5359,88.89,20.47,15.29,10.67
10-03-2021,PORTO MONIZ,5,0,213,"[120,240]",Moderado,,,,5,Madeira,MADEIRA,3106,8293.38,2342,143,130,95,98,120,218,313,443,586,28.24,7.07,5.34,3.77
10-03-2021,PORTO SANTO,4,0,77,"[0,120]",Baixo a Moderado,,,,4,Madeira,MADEIRA,3201,4300.7,5202,240,157,134,110,68,178,312,469,709,120.95,16.48,10.9,7.25
10-03-2021,PÓVOA DE LANHOSO,3,0,14,"[0,120]",Baixo a Moderado,,,,3,Norte,BRAGA,0309,13465.29,21499,1175,909,732,673,624,1297,2029,2938,4113,159.67,30.55,21.82,15.07
10-03-2021,PÓVOA DE VARZIM,73,5,116,"[0,120]",Baixo a Moderado,,,,73,Norte,PORTO,1313,8220.59,62784,3712,3120,2134,1594,1305,2899,5033,8153,11865,763.7,144.33,99.17,61.22
10-03-2021,POVOAÇÃO,0,0,0,"[0,120]",Baixo a Moderado,,,,0,Açores,AÇORES,4204,10640.77,5927,293,212,191,144,134,278,469,681,974,55.7,9.15,6.4,4.41
10-03-2021,VILA DA PRAIA DA VITÓRIA,1,0,5,"[0,120]",Baixo a Moderado,,,,1,Açores,AÇORES,4302,16127.06,21317,1133,789,619,436,336,772,1391,2180,3313,132.18,20.54,13.52,8.63
10-03-2021,PROENÇA-A-NOVA,11,1,151,"[120,240]",Moderado,,,,11,Centro,CASTELO BRANCO,0508,39539.96,7298,508,465,389,400,560,960,1349,1814,2322,18.46,5.87,4.59,3.41
10-03-2021,REDONDO,0,0,0,"[0,120]",Baixo a Moderado,,,,0,Alentejo,ÉVORA,0710,36950.87,6353,349,325,288,288,354,642,930,1255,1604,17.19,4.34,3.4,2.52
10-03-2021,REGUENGOS DE MONSARAZ,6,0,60,"[0,120]",Baixo a Moderado,,,,6,Alentejo,ÉVORA,0711,46399.72,10015,602,511,455,462,473,935,1390,1901,2503,21.58,5.39,4.1,3.0
10-03-2021,RESENDE,47,3,464,"[240,480]",Elevado,,,,47,Norte,VISEU,1813,12334.93,10137,560,493,448,433,422,855,1303,1796,2356,82.18,19.1,14.56,10.56
10-03-2021,RIBEIRA BRAVA,31,2,249,"[240,480]",Elevado,,,,31,Madeira,MADEIRA,3107,6544.88,12435,648,500,411,311,287,598,1009,1509,2157,189.99,32.96,23.06,15.42
10-03-2021,RIBEIRA DE PENA,0,0,0,"[0,120]",Baixo a Moderado,,,,0,Norte,VILA REAL,1709,21745.98,6016,371,301,290,310,368,678,968,1269,1640,27.66,7.54,5.84,4.45
10-03-2021,RIBEIRA GRANDE,58,4,177,"[120,240]",Moderado,,,,58,Açores,AÇORES,4205,18015.13,32811,1163,689,512,345,253,598,1110,1799,2962,182.13,16.44,9.99,6.16
10-03-2021,RIO MAIOR,66,5,324,"[240,480]",Elevado,,,,66,Lisboa e Vale do Tejo,SANTARÉM,1414,27276.45,20379,1251,1144,941,795,648,1443,2384,3528,4779,74.71,17.52,12.93,8.74
10-03-2021,SABROSA,2,0,34,"[0,120]",Baixo a Moderado,,,,2,Norte,VILA REAL,1710,15692.45,5918,393,314,304,302,350,652,956,1270,1663,37.71,10.6,8.09,6.09
10-03-2021,SABUGAL,0,0,0,"[0,120]",Baixo a Moderado,,,,0,Centro,GUARDA,0911,82269.82,10585,724,707,694,796,1009,1805,2499,3206,3930,12.87,4.78,3.9,3.04
10-03-2021,SALVATERRA DE MAGOS,20,1,94,"[0,120]",Baixo a Moderado,,,,20,Lisboa e Vale do Tejo,SANTARÉM,1415,24393.2,21295,1275,1181,1060,799,772,1571,2631,3812,5087,87.3,20.85,15.63,10.79
10-03-2021,SANTA COMBA DÃO,4,0,38,"[0,120]",Baixo a Moderado,,,,4,Centro,VISEU,1814,11194.77,10452,732,684,569,538,464,1002,1571,2255,2987,93.36,26.68,20.14,14.03
10-03-2021,SANTA CRUZ,261,19,576,"[480,960]",Muito Elevado,,,,261,Madeira,MADEIRA,3108,8150.28,45281,1817,1301,974,716,523,1239,2213,3514,5331,555.6,65.41,43.12,27.15
10-03-2021,SANTA CRUZ DA GRACIOSA,0,0,0,"[0,120]",Baixo a Moderado,,,,0,Açores,AÇORES,4401,6065.78,4208,228,180,163,124,145,269,432,612,840,69.37,13.85,10.09,7.12
10-03-2021,SANTA CRUZ DAS FLORES,0,0,0,"[0,120]",Baixo a Moderado,,,,0,Açores,AÇORES,4802,7091.44,2165,125,98,74,56,51,107,181,279,404,30.53,5.7,3.93,2.55
10-03-2021,SANTA MARIA DA FEIRA,104,7,75,"[0,120]",Baixo a Moderado,,,,104,Norte,AVEIRO,0109,21587.65,138636,8182,6743,4771,3856,3079,6935,11706,18449,26631,642.19,123.36,85.46,54.22
10-03-2021,SANTA MARTA DE PENAGUIÃO,21,1,318,"[240,480]",Elevado,,,,21,Norte,VILA REAL,1711,6928.13,6599,483,373,337,316,317,633,970,1343,1826,95.25,26.36,19.39,14.0
10-03-2021,SANTANA,3,0,45,"[0,120]",Baixo a Moderado,,,,3,Madeira,MADEIRA,3109,9547.3,6711,418,353,343,282,277,559,902,1255,1673,70.29,17.52,13.15,9.45
10-03-2021,SANTARÉM,48,3,84,"[0,120]",Baixo a Moderado,,,,48,Lisboa e Vale do Tejo,SANTARÉM,1416,55253.58,57421,3654,3441,2760,2466,2206,4672,7432,10873,14527,103.92,26.29,19.68,13.45
10-03-2021,SANTIAGO DO CACÉM,31,2,108,"[0,120]",Baixo a Moderado,,,,31,Alentejo,SETÚBAL,1509,105969.29,28791,2144,1689,1472,1295,1215,2510,3982,5671,7815,27.17,7.37,5.35,3.76
10-03-2021,SANTO TIRSO,44,3,65,"[0,120]",Baixo a Moderado,,,,44,Norte,PORTO,1314,13655.52,68055,4911,3935,2761,2257,1810,4067,6828,10763,15674,498.35,114.78,78.82,50.0
10-03-2021,SÃO BRÁS DE ALPORTEL,3,0,29,"[0,120]",Baixo a Moderado,,,,3,Algarve,FARO,0812,15336.92,10416,596,468,467,404,401,805,1272,1740,2336,67.91,15.23,11.35,8.29
10-03-2021,SÃO JOÃO DA MADEIRA,12,1,55,"[0,120]",Baixo a Moderado,,,,12,Norte,AVEIRO,0116,794.3,21958,1347,1069,796,601,593,1194,1990,3059,4406,2765.49,554.91,385.26,250.63
10-03-2021,SÃO JOÃO DA PESQUEIRA,6,0,84,"[0,120]",Baixo a Moderado,,,,6,Norte,VISEU,1815,26610.85,7125,417,330,294,328,328,656,950,1280,1697,26.77,6.38,4.81,3.57
10-03-2021,SÃO PEDRO DO SUL,13,1,84,"[0,120]",Baixo a Moderado,,,,13,Centro,VISEU,1816,34895.09,15403,990,962,861,759,909,1668,2529,3491,4481,44.14,12.84,10.0,7.25
10-03-2021,SÃO ROQUE DO PICO,3,0,92,"[0,120]",Baixo a Moderado,,,,3,Açores,AÇORES,4603,14236.1,3266,199,141,93,96,113,209,302,443,642,22.94,4.51,3.11,2.12
10-03-2021,SÃO VICENTE,4,0,78,"[0,120]",Baixo a Moderado,,,,4,Madeira,MADEIRA,3110,7883.71,5143,272,264,266,225,280,505,771,1035,1307,65.23,16.58,13.13,9.78
10-03-2021,SARDOAL,6,0,160,"[120,240]",Moderado,,,,6,Lisboa e Vale do Tejo,SANTARÉM,1417,9214.72,3741,227,178,148,165,248,413,561,739,966,40.6,10.48,8.02,6.09
10-03-2021,SÁTÃO,9,1,78,"[0,120]",Baixo a Moderado,,,,9,Centro,VISEU,1817,20194.11,11580,765,671,515,465,476,941,1456,2127,2892,57.34,14.32,10.53,7.21
10-03-2021,SEIA,24,2,108,"[0,120]",Baixo a Moderado,,,,24,Centro,GUARDA,0912,43568.83,22234,1807,1589,1238,1122,721,1843,3081,4670,6477,51.03,14.87,10.72,7.07
10-03-2021,SEIXAL,163,12,97,"[0,120]",Baixo a Moderado,,,,163,Lisboa e Vale do Tejo,SETÚBAL,1510,9545.17,167752,10586,9270,6661,4391,2930,7321,13982,23252,33838,1757.49,354.51,243.6,146.49
10-03-2021,SERNANCELHE,2,0,37,"[0,120]",Baixo a Moderado,,,,2,Norte,VISEU,1818,22861.22,5396,305,293,286,273,260,533,819,1112,1417,23.6,6.2,4.86,3.58
10-03-2021,SERPA,74,5,517,"[480,960]",Muito Elevado,,,,74,Alentejo,BEJA,0213,110563.34,14304,903,761,719,697,626,1323,2042,2803,3706,12.94,3.35,2.54,1.85
10-03-2021,SERTÃ,8,1,55,"[0,120]",Baixo a Moderado,,,,8,Centro,CASTELO BRANCO,0509,44673.17,14577,870,779,790,767,1020,1787,2577,3356,4226,32.63,9.46,7.51,5.77
10-03-2021,SESIMBRA,97,7,187,"[120,240]",Moderado,,,,97,Lisboa e Vale do Tejo,SETÚBAL,1511,19571.75,51858,2400,2321,1853,1257,1083,2340,4193,6514,8914,264.96,45.54,33.28,21.42
10-03-2021,SETÚBAL,168,12,146,"[120,240]",Moderado,,,,168,Lisboa e Vale do Tejo,SETÚBAL,1512,23032.5,115126,7425,6929,5075,3775,2655,6430,11505,18434,25859,499.83,112.27,80.03,49.95
10-03-2021,SEVER DO VOUGA,6,0,53,"[0,120]",Baixo a Moderado,,,,6,Centro,AVEIRO,0117,12987.56,11331,766,637,568,540,567,1107,1675,2312,3078,87.24,23.7,17.8,12.9
10-03-2021,SILVES,10,1,28,"[0,120]",Baixo a Moderado,,,,10,Algarve,FARO,0813,68006.23,36226,2137,1869,1610,1423,1600,3023,4633,6502,8639,53.27,12.7,9.56,6.81
10-03-2021,SINES,21,1,153,"[120,240]",Moderado,,,,21,Alentejo,SETÚBAL,1513,20330.17,13715,888,791,551,416,268,684,1235,2026,2914,67.46,14.33,9.97,6.07
10-03-2021,SINTRA,505,36,129,"[120,240]",Moderado,,,,505,Lisboa e Vale do Tejo,LISBOA,1111,31922.73,391402,20490,18316,13545,9137,7284,16421,29966,48282,68772,1226.08,215.43,151.25,93.87
10-03-2021,SOBRAL DE MONTE AGRAÇO,24,2,225,"[120,240]",Moderado,,,,24,Lisboa e Vale do Tejo,LISBOA,1112,5210.32,10651,564,507,352,272,212,484,836,1343,1907,204.43,36.6,25.78,16.05
10-03-2021,SOURE,4,0,23,"[0,120]",Baixo a Moderado,,,,4,Centro,COIMBRA,0615,26506.07,17120,1173,1142,1004,883,987,1870,2874,4016,5189,64.59,19.58,15.15,10.84
10-03-2021,SOUSEL,0,0,0,"[0,120]",Baixo a Moderado,,,,0,Alentejo,PORTALEGRE,1215,27932.18,4412,261,274,208,302,292,594,802,1076,1337,15.8,4.79,3.85,2.87
10-03-2021,TÁBUA,9,1,79,"[0,120]",Baixo a Moderado,,,,9,Centro,COIMBRA,0616,19978.58,11368,729,584,524,430,464,894,1418,2002,2731,56.9,13.67,10.02,7.1
10-03-2021,TABUAÇO,1,0,17,"[0,120]",Baixo a Moderado,,,,1,Norte,VISEU,1819,13385.67,6033,372,314,217,282,363,645,862,1176,1548,45.07,11.56,8.79,6.44
10-03-2021,TAROUCA,9,1,115,"[0,120]",Baixo a Moderado,,,,9,Norte,VISEU,1820,10008.49,7804,405,335,313,277,324,601,914,1249,1654,77.98,16.53,12.48,9.13
10-03-2021,TAVIRA,16,1,65,"[0,120]",Baixo a Moderado,,,,16,Algarve,FARO,0814,60696.7,24530,1493,1415,1252,1066,1277,2343,3595,5010,6503,40.41,10.71,8.25,5.92
10-03-2021,TERRAS DE BOURO,0,0,0,"[0,120]",Baixo a Moderado,,,,0,Norte,BRAGA,0310,27746.07,6361,391,372,296,319,340,659,955,1327,1718,22.93,6.19,4.78,3.44
10-03-2021,TOMAR,22,2,60,"[0,120]",Baixo a Moderado,,,,22,Lisboa e Vale do Tejo,SANTARÉM,1418,35120.44,36748,2403,2189,1868,1853,1822,3675,5543,7732,10135,104.64,28.86,22.02,15.78
10-03-2021,TONDELA,8,1,30,"[0,120]",Baixo a Moderado,,,,8,Centro,VISEU,1821,37121.73,26357,1768,1722,1518,1475,1417,2892,4410,6132,7900,71.0,21.28,16.52,11.88
10-03-2021,TORRE DE MONCORVO,2,0,26,"[0,120]",Baixo a Moderado,,,,2,Norte,BRAGANÇA,0409,53155.67,7695,556,478,488,551,719,1270,1758,2236,2792,14.48,5.25,4.21,3.31
10-03-2021,TORRES NOVAS,11,1,31,"[0,120]",Baixo a Moderado,,,,11,Lisboa e Vale do Tejo,SANTARÉM,1419,26999.68,34933,2324,1979,1738,1406,1475,2881,4619,6598,8922,129.38,33.04,24.44,17.11
10-03-2021,TORRES VEDRAS,212,15,270,"[240,480]",Elevado,,,,212,Lisboa e Vale do Tejo,LISBOA,1113,40714.89,78530,4513,3945,3447,2628,2104,4732,8179,12124,16637,192.88,40.86,29.78,20.09
10-03-2021,TRANCOSO,11,1,124,"[120,240]",Moderado,,,,11,Centro,GUARDA,0913,36152.47,8875,581,557,542,586,496,1082,1624,2181,2762,24.55,7.64,6.03,4.49
10-03-2021,TROFA,33,2,86,"[0,120]",Baixo a Moderado,,,,33,Norte,PORTO,1318,7201.76,38418,2336,1894,1231,939,684,1623,2854,4748,7084,533.44,98.36,65.93,39.63
10-03-2021,VAGOS,14,1,62,"[0,120]",Baixo a Moderado,,,,14,Centro,AVEIRO,0118,16491.5,22740,1320,1205,922,784,724,1508,2430,3635,4955,137.89,30.04,22.04,14.73
10-03-2021,VALE DE CAMBRA,8,1,38,"[0,120]",Baixo a Moderado,,,,8,Norte,AVEIRO,0119,14733.47,21327,1491,1363,1005,831,798,1629,2634,3997,5488,144.76,37.25,27.13,17.88
10-03-2021,VALENÇA,5,0,38,"[0,120]",Baixo a Moderado,,,,5,Norte,VIANA DO CASTELO,1608,11712.86,13290,867,791,582,582,503,1085,1667,2458,3325,113.46,28.39,20.99,14.23
10-03-2021,VALONGO,38,3,39,"[0,120]",Baixo a Moderado,,,,38,Norte,PORTO,1315,7512.45,97444,5629,4696,3207,2462,1829,4291,7498,12194,17823,1297.18,237.26,162.33,99.81
10-03-2021,VALPAÇOS,4,0,27,"[0,120]",Baixo a Moderado,,,,4,Norte,VILA REAL,1712,54873.93,14818,1217,1118,999,928,997,1925,2924,4042,5259,27.0,9.58,7.37,5.33
10-03-2021,VELAS,0,0,0,"[0,120]",Baixo a Moderado,,,,0,Açores,AÇORES,4502,11738.38,5093,278,208,166,153,113,266,432,640,918,43.39,7.82,5.45,3.68
10-03-2021,VENDAS NOVAS,3,0,27,"[0,120]",Baixo a Moderado,,,,3,Alentejo,ÉVORA,0712,22238.88,11255,677,768,655,501,532,1033,1688,2456,3133,50.61,14.09,11.04,7.59
10-03-2021,VIANA DO ALENTEJO,4,0,78,"[0,120]",Baixo a Moderado,,,,4,Alentejo,ÉVORA,0713,39367.29,5145,245,208,235,210,214,424,659,867,1112,13.07,2.82,2.2,1.67
10-03-2021,VIANA DO CASTELO,95,7,113,"[0,120]",Baixo a Moderado,,,,95,Norte,VIANA DO CASTELO,1609,31902.01,84417,5470,4433,3591,3061,2982,6043,9634,14067,19537,264.61,61.24,44.09,30.2
10-03-2021,VIDIGUEIRA,15,1,272,"[240,480]",Elevado,,,,15,Alentejo,BEJA,0214,31661.09,5510,300,248,215,233,275,508,723,971,1271,17.4,4.01,3.07,2.28
10-03-2021,VIEIRA DO MINHO,4,0,34,"[0,120]",Baixo a Moderado,,,,4,Norte,BRAGA,0311,21644.35,11842,703,594,525,548,482,1030,1555,2149,2852,54.71,13.18,9.93,7.18
10-03-2021,VILA DE REI,2,0,60,"[0,120]",Baixo a Moderado,,,,2,Centro,CASTELO BRANCO,0510,19154.6,3323,169,128,172,247,302,549,721,849,1018,17.35,5.31,4.43,3.76
10-03-2021,VILA DO BISPO,2,0,39,"[0,120]",Baixo a Moderado,,,,2,Algarve,FARO,0815,17906.06,5154,302,302,314,232,233,465,779,1081,1383,28.78,7.72,6.04,4.35
10-03-2021,VILA DO CONDE,63,5,79,"[0,120]",Baixo a Moderado,,,,63,Norte,PORTO,1316,14902.77,79899,4726,3875,2819,2070,1743,3813,6632,10507,15233,536.13,102.21,70.5,44.5
10-03-2021,VILA DO PORTO,0,0,0,"[0,120]",Baixo a Moderado,,,,0,Açores,AÇORES,4101,9688.74,5616,274,212,135,96,123,219,354,566,840,57.96,8.67,5.84,3.65
10-03-2021,VILA FLOR,14,1,232,"[120,240]",Moderado,,,,14,Norte,BRAGANÇA,0410,26581.14,6044,429,362,422,294,331,625,1047,1409,1838,22.74,6.91,5.3,3.94
10-03-2021,VILA FRANCA DE XIRA,177,13,125,"[120,240]",Moderado,,,,177,Lisboa e Vale do Tejo,LISBOA,1114,31819.39,141957,8501,6852,4869,3425,2472,5897,10766,17618,26119,446.14,82.09,55.37,33.84
10-03-2021,VILA FRANCA DO CAMPO,0,0,0,"[0,120]",Baixo a Moderado,,,,0,Açores,AÇORES,4206,7796.82,11051,450,344,248,217,154,371,619,963,1413,141.73,18.12,12.35,7.94
10-03-2021,VILA NOVA DA BARQUINHA,3,0,40,"[0,120]",Baixo a Moderado,,,,3,Lisboa e Vale do Tejo,SANTARÉM,1420,4952.97,7461,415,406,392,364,338,702,1094,1500,1915,150.64,38.66,30.28,22.09
10-03-2021,VILA NOVA DE CERVEIRA,22,2,247,"[240,480]",Elevado,,,,22,Norte,VIANA DO CASTELO,1610,10846.66,8910,531,444,410,384,334,718,1128,1572,2103,82.14,19.39,14.49,10.4
10-03-2021,VILA NOVA DE FAMALICÃO,144,10,109,"[0,120]",Baixo a Moderado,,,,144,Norte,BRAGA,0312,20159.26,131676,7817,6164,4202,3282,2749,6031,10233,16397,24214,653.19,120.12,81.34,50.76
10-03-2021,VILA NOVA DE FOZ CÔA,3,0,46,"[0,120]",Baixo a Moderado,,,,3,Centro,GUARDA,0914,39815.18,6503,442,385,390,398,429,827,1217,1602,2044,16.33,5.13,4.02,3.06
10-03-2021,VILA NOVA DE GAIA,231,17,77,"[0,120]",Baixo a Moderado,,,,231,Norte,PORTO,1317,16846.43,300472,18349,15568,10972,8224,6281,14505,25477,41045,59394,1783.64,352.57,243.65,151.23
10-03-2021,VILA NOVA DE PAIVA,0,0,0,"[0,120]",Baixo a Moderado,,,,0,Centro,VISEU,1822,17553.28,4687,289,272,233,217,241,458,691,963,1252,26.7,7.13,5.49,3.94
10-03-2021,VILA NOVA DE POIARES,3,0,43,"[0,120]",Baixo a Moderado,,,,3,Centro,COIMBRA,0617,8445.3,6939,380,284,262,235,182,417,679,963,1343,82.17,15.9,11.4,8.04
10-03-2021,VILA POUCA DE AGUIAR,6,0,50,"[0,120]",Baixo a Moderado,,,,6,Norte,VILA REAL,1713,43706.62,11961,860,817,733,601,627,1228,1961,2778,3638,27.37,8.32,6.36,4.49
10-03-2021,VILA REAL,12,1,24,"[0,120]",Baixo a Moderado,,,,12,Norte,VILA REAL,1714,37880.28,49962,3025,2498,2065,1579,1466,3045,5110,7608,10633,131.9,28.07,20.08,13.49
10-03-2021,VILA REAL DE SANTO ANTÓNIO,11,1,59,"[0,120]",Baixo a Moderado,,,,11,Algarve,FARO,0816,6125.0,18749,1172,1069,811,569,586,1155,1966,3035,4207,306.11,68.69,49.55,32.1
10-03-2021,VILA VELHA DE RÓDÃO,0,0,0,"[0,120]",Baixo a Moderado,,,,0,Centro,CASTELO BRANCO,0511,32991.16,3144,209,229,180,283,306,589,769,998,1207,9.53,3.66,3.03,2.33
10-03-2021,VILA VERDE,26,2,55,"[0,120]",Baixo a Moderado,,,,26,Norte,BRAGA,0313,22866.52,46911,2365,2063,1667,1494,1437,2931,4598,6661,9026,205.15,39.47,29.13,20.11
10-03-2021,VILA VIÇOSA,3,0,39,"[0,120]",Baixo a Moderado,,,,3,Alentejo,ÉVORA,0714,19485.89,7656,487,379,342,345,324,669,1011,1390,1877,39.29,9.63,7.13,5.19
10-03-2021,VIMIOSO,4,0,99,"[0,120]",Baixo a Moderado,,,,4,Norte,BRAGANÇA,0411,48158.51,4023,274,230,261,293,335,628,889,1119,1393,8.35,2.89,2.32,1.85
10-03-2021,VINHAIS,3,0,39,"[0,120]",Baixo a Moderado,,,,3,Norte,BRAGANÇA,0412,69475.09,7746,599,577,636,641,815,1456,2092,2669,3268,11.15,4.7,3.84,3.01
10-03-2021,VISEU,91,7,94,"[0,120]",Baixo a Moderado,,,,91,Centro,VISEU,1823,50710.14,97249,5769,5038,4140,3158,2710,5868,10008,15046,20815,191.77,41.05,29.67,19.74
10-03-2021,VIZELA,3,0,13,"[0,120]",Baixo a Moderado,,,,3,Norte,BRAGA,0314,2469.83,23897,1258,928,655,509,371,880,1535,2463,3721,967.49,150.65,99.72,62.15
10-03-2021,VOUZELA,6,0,62,"[0,120]",Baixo a Moderado,,,,6,Centro,VISEU,1824,19369.46,9619,626,605,554,532,507,1039,1593,2198,2824,49.66,14.58,11.35,8.22
17-03-2021,ABRANTES,6,0,17,"[0,120]",Baixo a Moderado,,,,6,Lisboa e Vale do Tejo,SANTARÉM,1401,71469.08,35130,2473,2213,1730,1748,2021,3769,5499,7712,10185,49.15,14.25,10.79,7.69
17-03-2021,ÁGUEDA,28,2,61,"[0,120]",Baixo a Moderado,,,,28,Centro,AVEIRO,0101,33527.44,46075,3237,2713,2090,1635,1496,3131,5221,7934,11171,137.43,33.32,23.66,15.57
17-03-2021,AGUIAR DA BEIRA,1,0,21,"[0,120]",Baixo a Moderado,,,,1,Centro,GUARDA,0901,20676.57,4652,304,281,235,239,148,387,622,903,1207,22.5,5.84,4.37,3.01
17-03-2021,ALANDROAL,1,0,20,"[0,120]",Baixo a Moderado,,,,1,Alentejo,ÉVORA,0701,54267.81,4992,307,256,296,299,377,676,972,1228,1535,9.2,2.83,2.26,1.79
17-03-2021,ALBERGARIA-A-VELHA,15,1,62,"[0,120]",Baixo a Moderado,,,,15,Centro,AVEIRO,0102,15882.5,24144,1550,1298,996,687,680,1367,2363,3661,5211,152.02,32.81,23.05,14.88
17-03-2021,ALBUFEIRA,23,2,55,"[0,120]",Baixo a Moderado,,,,23,Algarve,FARO,0801,14066.42,41528,2067,1717,1425,985,858,1843,3268,4985,7052,295.24,50.14,35.44,23.23
17-03-2021,ALCÁCER DO SAL,8,1,69,"[0,120]",Baixo a Moderado,,,,8,Alentejo,SETÚBAL,1501,149987.3,11659,884,814,623,623,602,1225,1848,2662,3546,7.77,2.36,1.77,1.23
17-03-2021,ALCANENA,6,0,47,"[0,120]",Baixo a Moderado,,,,6,Lisboa e Vale do Tejo,SANTARÉM,1402,12732.86,12809,891,744,628,536,588,1124,1752,2496,3387,100.6,26.6,19.6,13.76
17-03-2021,ALCOBAÇA,17,1,32,"[0,120]",Baixo a Moderado,,,,17,Lisboa e Vale do Tejo,LEIRIA,1001,40814.09,53555,3420,2927,2466,2059,1676,3735,6201,9128,12548,131.22,30.74,22.36,15.19
17-03-2021,ALCOCHETE,21,1,106,"[0,120]",Baixo a Moderado,,,,21,Lisboa e Vale do Tejo,SETÚBAL,1502,12836.48,19787,857,834,691,476,447,923,1614,2448,3305,154.15,25.75,19.07,12.57
17-03-2021,ALCOUTIM,12,1,556,"[480,960]",Muito Elevado,,,,12,Algarve,FARO,0802,57536.33,2159,191,188,163,190,267,457,620,808,999,3.75,1.74,1.4,1.08
17-03-2021,ALENQUER,51,4,116,"[0,120]",Baixo a Moderado,,,,51,Lisboa e Vale do Tejo,LISBOA,1101,30421.92,44052,2298,2062,1629,1330,1155,2485,4114,6176,8474,144.8,27.85,20.3,13.52
17-03-2021,ALFÂNDEGA DA FÉ,1,0,22,"[0,120]",Baixo a Moderado,,,,1,Norte,BRAGANÇA,0401,32194.64,4550,325,277,301,274,325,599,900,1177,1502,14.13,4.67,3.66,2.8
17-03-2021,ALIJÓ,3,0,28,"[0,120]",Baixo a Moderado,,,,3,Norte,VILA REAL,1701,29759.89,10625,766,687,635,542,666,1208,1843,2530,3296,35.7,11.08,8.5,6.19
17-03-2021,ALJEZUR,4,0,72,"[0,120]",Baixo a Moderado,,,,4,Algarve,FARO,0803,32349.95,5594,316,336,335,320,410,730,1065,1401,1717,17.29,5.31,4.33,3.29
17-03-2021,ALJUSTREL,9,1,109,"[0,120]",Baixo a Moderado,,,,9,Alentejo,BEJA,0201,45847.41,8247,635,521,443,347,358,705,1148,1669,2304,17.99,5.03,3.64,2.5
17-03-2021,ALMADA,176,13,104,"[0,120]",Baixo a Moderado,,,,176,Lisboa e Vale do Tejo,SETÚBAL,1503,7000.89,169039,10469,9777,7876,6144,5111,11255,19131,28908,39377,2414.5,562.45,412.91,273.26
17-03-2021,ALMEIDA,1,0,17,"[0,120]",Baixo a Moderado,,,,1,Centro,GUARDA,0902,51798.46,5830,441,419,396,458,393,851,1247,1666,2107,11.26,4.07,3.22,2.41
17-03-2021,ALMEIRIM,17,1,75,"[0,120]",Baixo a Moderado,,,,17,Lisboa e Vale do Tejo,SANTARÉM,1403,22212.05,22546,1342,1353,1106,866,843,1709,2815,4168,5510,101.5,24.81,18.76,12.67
17-03-2021,ALMODÔVAR,1,0,15,"[0,120]",Baixo a Moderado,,,,1,Alentejo,BEJA,0202,77788.03,6725,414,443,396,373,328,701,1097,1540,1954,8.65,2.51,1.98,1.41
17-03-2021,ALPIARÇA,6,0,85,"[0,120]",Baixo a Moderado,,,,6,Lisboa e Vale do Tejo,SANTARÉM,1404,9536.33,7059,515,486,363,333,274,607,970,1456,1971,74.02,20.67,15.27,10.17
17-03-2021,ALTER DO CHÃO,0,0,0,"[0,120]",Baixo a Moderado,,,,0,Alentejo,PORTALEGRE,1201,36206.62,3165,201,163,136,208,187,395,531,694,895,8.74,2.47,1.92,1.47
17-03-2021,ALVAIÁZERE,2,0,30,"[0,120]",Baixo a Moderado,,,,2,Centro,LEIRIA,1002,16047.76,6597,419,389,346,406,539,945,1291,1680,2099,41.11,13.08,10.47,8.04
17-03-2021,ALVITO,0,0,0,"[0,120]",Baixo a Moderado,,,,0,Alentejo,BEJA,0203,26485.32,2477,145,110,105,111,89,200,305,415,560,9.35,2.11,1.57,1.15
17-03-2021,AMADORA,272,19,148,"[120,240]",Moderado,,,,272,Lisboa e Vale do Tejo,LISBOA,1115,2378.47,184106,11186,10936,8780,6460,5890,12350,21130,32066,43252,7742.05,1818.84,1348.44,888.56
17-03-2021,AMARANTE,27,2,51,"[0,120]",Baixo a Moderado,,,,27,Norte,PORTO,1301,30133.15,53193,3086,2413,1812,1643,1311,2954,4766,7179,10265,176.53,34.07,23.82,15.82
17-03-2021,AMARES,3,0,17,"[0,120]",Baixo a Moderado,,,,3,Norte,BRAGA,0301,8195.41,18129,1001,829,622,489,524,1013,1635,2464,3465,221.22,42.28,30.07,19.95
17-03-2021,ANADIA,30,2,110,"[0,120]",Baixo a Moderado,,,,30,Centro,AVEIRO,0103,21663.48,27258,1931,1698,1376,1208,1262,2470,3846,5544,7475,125.83,34.51,25.59,17.75
17-03-2021,ANGRA DO HEROÍSMO,0,0,0,"[0,120]",Baixo a Moderado,,,,0,Açores,AÇORES,4301,23899.66,33807,2006,1473,1122,768,635,1403,2525,3998,6004,141.45,25.12,16.73,10.56
17-03-2021,ANSIÃO,2,0,17,"[0,120]",Baixo a Moderado,,,,2,Centro,LEIRIA,1003,17609.42,12039,727,709,646,694,530,1224,1870,2579,3306,68.37,18.77,14.65,10.62
17-03-2021,ARCOS DE VALDEVEZ,17,1,81,"[0,120]",Baixo a Moderado,,,,17,Norte,VIANA DO CASTELO,1601,44759.64,20926,1329,1338,1282,1343,1515,2858,4140,5478,6807,46.75,15.21,12.24,9.25
17-03-2021,ARGANIL,5,0,45,"[0,120]",Baixo a Moderado,,,,5,Centro,COIMBRA,0601,33283.93,11014,672,648,612,559,596,1155,1767,2415,3087,33.09,9.27,7.26,5.31
17-03-2021,ARMAMAR,12,1,208,"[120,240]",Moderado,,,,12,Norte,VISEU,1801,11723.73,5769,357,305,309,285,310,595,904,1209,1566,49.21,13.36,10.31,7.71
17-03-2021,AROUCA,6,0,29,"[0,120]",Baixo a Moderado,,,,6,Norte,AVEIRO,0104,32910.52,20720,1306,1047,753,683,683,1366,2119,3166,4472,62.96,13.59,9.62,6.44
17-03-2021,ARRAIOLOS,3,0,43,"[0,120]",Baixo a Moderado,,,,3,Alentejo,ÉVORA,0702,68374.55,6928,435,384,283,367,480,847,1130,1514,1949,10.13,2.85,2.21,1.65
17-03-2021,ARRONCHES,4,0,142,"[120,240]",Moderado,,,,4,Alentejo,PORTALEGRE,1202,31464.72,2820,155,142,162,187,179,366,528,670,825,8.96,2.62,2.13,1.68
17-03-2021,ARRUDA DOS VINHOS,6,0,39,"[0,120]",Baixo a Moderado,,,,6,Lisboa e Vale do Tejo,LISBOA,1102,7795.93,15412,738,738,562,509,438,947,1509,2247,2985,197.69,38.29,28.82,19.36
17-03-2021,AVEIRO,44,3,56,"[0,120]",Baixo a Moderado,,,,44,Centro,AVEIRO,0105,19757.57,78734,4520,4004,3050,2250,2103,4353,7403,11407,15927,398.49,80.61,57.73,37.47
17-03-2021,AVIS,0,0,0,"[0,120]",Baixo a Moderado,,,,0,Alentejo,PORTALEGRE,1203,60596.51,4247,315,225,206,251,273,524,730,955,1270,7.01,2.1,1.58,1.2
17-03-2021,AZAMBUJA,17,1,75,"[0,120]",Baixo a Moderado,,,,17,Lisboa e Vale do Tejo,LISBOA,1103,26265.65,22716,1322,1171,1070,798,618,1416,2486,3657,4979,86.48,18.96,13.92,9.46
17-03-2021,BAIÃO,14,1,75,"[0,120]",Baixo a Moderado,,,,14,Norte,PORTO,1302,17452.83,18748,1070,862,714,686,725,1411,2125,2987,4057,107.42,23.25,17.11,12.18
17-03-2021,BARCELOS,92,7,79,"[0,120]",Baixo a Moderado,,,,92,Norte,BRAGA,0302,37890.14,116187,6721,5325,3619,2991,2562,5553,9172,14497,21218,306.64,56.0,38.26,24.21
17-03-2021,BARRANCOS,1,0,61,"[0,120]",Baixo a Moderado,,,,1,Alentejo,BEJA,0204,16841.73,1634,90,65,65,94,61,155,220,285,375,9.7,2.23,1.69,1.31
17-03-2021,BARREIRO,51,4,68,"[0,120]",Baixo a Moderado,,,,51,Lisboa e Vale do Tejo,SETÚBAL,1504,3639.07,75147,5194,5565,4459,3105,1767,4872,9331,14896,20090,2065.05,552.07,409.34,256.42
17-03-2021,BATALHA,20,1,125,"[120,240]",Moderado,,,,20,Centro,LEIRIA,1004,10341.6,15963,873,762,649,529,549,1078,1727,2489,3362,154.35,32.51,24.07,16.7
17-03-2021,BEJA,28,2,83,"[0,120]",Baixo a Moderado,,,,28,Alentejo,BEJA,0205,114647.55,33579,2005,1840,1386,1272,1039,2311,3697,5537,7542,29.29,6.58,4.83,3.22
17-03-2021,BELMONTE,15,1,234,"[120,240]",Moderado,,,,15,Centro,CASTELO BRANCO,0501,11875.91,6398,444,321,325,310,355,665,990,1311,1755,53.87,14.78,11.04,8.34
17-03-2021,BENAVENTE,36,3,118,"[0,120]",Baixo a Moderado,,,,36,Lisboa e Vale do Tejo,SANTARÉM,1405,52138.39,30602,1468,1376,1141,876,643,1519,2660,4036,5504,58.69,10.56,7.74,5.1
17-03-2021,BOMBARRAL,5,0,40,"[0,120]",Baixo a Moderado,,,,5,Lisboa e Vale do Tejo,LEIRIA,1005,9128.55,12558,875,714,561,491,429,920,1481,2195,3070,137.56,33.63,24.04,16.22
17-03-2021,BORBA,2,0,30,"[0,120]",Baixo a Moderado,,,,2,Alentejo,ÉVORA,0703,14518.65,6736,430,375,279,436,392,828,1107,1482,1912,46.39,13.17,10.21,7.62
17-03-2021,BOTICAS,1,0,20,"[0,120]",Baixo a Moderado,,,,1,Norte,VILA REAL,1702,32195.66,4998,347,306,311,305,380,685,996,1302,1649,15.52,5.12,4.04,3.09
17-03-2021,BRAGA,55,4,30,"[0,120]",Baixo a Moderado,,,,55,Norte,BRAGA,0303,18339.95,182679,10029,7963,5241,4320,3671,7991,13232,21195,31224,996.07,170.25,115.57,72.15
17-03-2021,BRAGANÇA,6,0,18,"[0,120]",Baixo a Moderado,,,,6,Norte,BRAGANÇA,0402,117357.27,33607,2402,1855,1652,1393,1163,2556,4208,6063,8465,28.64,7.21,5.17,3.59
17-03-2021,CABECEIRAS DE BASTO,0,0,0,"[0,120]",Baixo a Moderado,,,,0,Norte,BRAGA,0304,24182.16,15628,774,594,544,575,574,1149,1693,2287,3061,64.63,12.66,9.46,7.0
17-03-2021,CADAVAL,7,0,51,"[0,120]",Baixo a Moderado,,,,7,Lisboa e Vale do Tejo,LISBOA,1104,17489.3,13673,813,796,756,621,625,1246,2002,2798,3611,78.18,20.65,16.0,11.45
17-03-2021,CALDAS DA RAINHA,21,1,40,"[0,120]",Baixo a Moderado,,,,21,Lisboa e Vale do Tejo,LEIRIA,1006,25569.47,51912,3035,2684,2186,1899,1705,3604,5790,8474,11509,203.03,45.01,33.14,22.64
17-03-2021,CALHETA,5,0,46,"[0,120]",Baixo a Moderado,,,,5,Madeira,MADEIRA,3101,11150.43,10867,576,497,507,399,415,814,1321,1818,2394,97.46,21.47,16.3,11.85
17-03-2021,CALHETA (AÇORES),0,0,0,"[0,120]",Baixo a Moderado,,,,0,Açores,AÇORES,4501,12626.4,3184,215,159,141,139,122,261,402,561,776,25.22,6.15,4.44,3.18
17-03-2021,CÂMARA DE LOBOS,146,10,434,"[240,480]",Elevado,,,,146,Madeira,MADEIRA,3102,5216.67,33675,1396,1059,834,545,381,926,1760,2819,4215,645.49,80.79,54.03,33.74
17-03-2021,CAMINHA,8,1,50,"[0,120]",Baixo a Moderado,,,,8,Norte,VIANA DO CASTELO,1602,13652.14,15877,1046,944,818,646,656,1302,2120,3064,4110,116.3,30.11,22.44,15.53
17-03-2021,CAMPO MAIOR,2,0,25,"[0,120]",Baixo a Moderado,,,,2,Alentejo,PORTALEGRE,1204,24720.16,7874,471,364,351,279,327,606,957,1321,1792,31.85,7.25,5.34,3.87
17-03-2021,CANTANHEDE,24,2,69,"[0,120]",Baixo a Moderado,,,,24,Centro,COIMBRA,0602,39088.02,35011,2346,2096,1880,1709,1451,3160,5040,7136,9482,89.57,24.26,18.26,12.89
17-03-2021,CARRAZEDA DE ANSIÃES,13,1,229,"[120,240]",Moderado,,,,13,Norte,BRAGANÇA,0403,27924.09,5666,424,389,391,312,465,777,1168,1557,1981,20.29,7.09,5.58,4.18
17-03-2021,CARREGAL DO SAL,0,0,0,"[0,120]",Baixo a Moderado,,,,0,Centro,VISEU,1802,11689.21,9271,587,562,486,462,376,838,1324,1886,2473,79.31,21.16,16.13,11.33
17-03-2021,CARTAXO,11,1,46,"[0,120]",Baixo a Moderado,,,,11,Lisboa e Vale do Tejo,SANTARÉM,1406,15817.28,23843,1415,1376,1142,861,632,1493,2635,4011,5426,150.74,34.3,25.36,16.66
17-03-2021,CASCAIS,158,11,74,"[0,120]",Baixo a Moderado,,,,158,Lisboa e Vale do Tejo,LISBOA,1105,9740.17,213608,12151,11444,8680,6469,5248,11717,20397,31841,43992,2193.1,451.66,326.91,209.41
17-03-2021,CASTANHEIRA DE PÊRA,4,0,153,"[120,240]",Moderado,,,,4,Centro,LEIRIA,1007,6677.45,2614,233,195,157,190,187,377,534,729,962,39.15,14.41,10.92,8.0
17-03-2021,CASTELO BRANCO,6,0,12,"[0,120]",Baixo a Moderado,,,,6,Centro,CASTELO BRANCO,0502,143819.15,51987,3528,3042,2499,2229,2225,4454,6953,9995,13523,36.15,9.4,6.95,4.83
17-03-2021,CASTELO DE PAIVA,17,1,110,"[0,120]",Baixo a Moderado,,,,17,Norte,AVEIRO,0106,11500.53,15454,881,697,545,420,431,851,1396,2093,2974,134.37,25.86,18.2,12.14
17-03-2021,CASTELO DE VIDE,7,1,240,"[240,480]",Elevado,,,,7,Alentejo,PORTALEGRE,1205,26491.24,2919,204,173,179,147,170,317,496,669,873,11.02,3.3,2.53,1.87
17-03-2021,CASTRO DAIRE,13,1,94,"[0,120]",Baixo a Moderado,,,,13,Centro,VISEU,1803,37904.13,13823,942,857,765,732,773,1505,2270,3127,4069,36.47,10.74,8.25,5.99
17-03-2021,CASTRO MARIM,6,0,96,"[0,120]",Baixo a Moderado,,,,6,Algarve,FARO,0804,30084.37,6237,370,345,334,322,344,666,1000,1345,1715,20.73,5.7,4.47,3.32
17-03-2021,CASTRO VERDE,1,0,14,"[0,120]",Baixo a Moderado,,,,1,Alentejo,BEJA,0206,56944.23,6949,437,347,303,275,227,502,805,1152,1589,12.2,2.79,2.02,1.41
17-03-2021,CELORICO DA BEIRA,1,0,14,"[0,120]",Baixo a Moderado,,,,1,Centro,GUARDA,0903,24721.63,6928,430,416,363,369,535,904,1267,1683,2113,28.02,8.55,6.81,5.12
17-03-2021,CELORICO DE BASTO,6,0,32,"[0,120]",Baixo a Moderado,,,,6,Norte,BRAGA,0305,18107.02,19040,1001,802,668,728,729,1457,2125,2927,3928,105.15,21.69,16.17,11.74
17-03-2021,CHAMUSCA,0,0,0,"[0,120]",Baixo a Moderado,,,,0,Lisboa e Vale do Tejo,SANTARÉM,1407,74600.54,9197,629,583,553,465,579,1044,1597,2180,2809,12.33,3.77,2.92,2.14
17-03-2021,CHAVES,11,1,28,"[0,120]",Baixo a Moderado,,,,11,Norte,VILA REAL,1703,59122.95,39343,2676,2429,1991,1886,1918,3804,5795,8224,10900,66.54,18.44,13.91,9.8
17-03-2021,CINFÃES,33,2,181,"[120,240]",Moderado,,,,33,Norte,VISEU,1804,23928.76,18244,1067,902,779,734,758,1492,2271,3173,4240,76.24,17.72,13.26,9.49
17-03-2021,COIMBRA,191,14,142,"[120,240]",Moderado,,,,191,Centro,COIMBRA,0603,31939.94,134166,9489,8734,6353,5139,5074,10213,16566,25300,34789,420.06,108.92,79.21,51.87
17-03-2021,CONDEIXA-A-NOVA,16,1,90,"[0,120]",Baixo a Moderado,,,,16,Centro,COIMBRA,0604,13867.47,17733,871,809,717,583,490,1073,1790,2599,3470,127.88,25.02,18.74,12.91
17-03-2021,CONSTÂNCIA,1,0,25,"[0,120]",Baixo a Moderado,,,,1,Lisboa e Vale do Tejo,SANTARÉM,1408,8036.58,4030,211,183,187,148,155,303,490,673,884,50.14,11.0,8.37,6.1
17-03-2021,CORUCHE,4,0,23,"[0,120]",Baixo a Moderado,,,,4,Lisboa e Vale do Tejo,SANTARÉM,1409,111572.03,17471,1294,1090,1095,1096,1019,2115,3210,4300,5594,15.66,5.01,3.85,2.88
17-03-2021,CORVO,0,0,0,"[0,120]",Baixo a Moderado,,,,0,Açores,AÇORES,4901,1711.45,464,22,21,11,13,19,32,43,64,86,27.12,5.03,3.74,2.51
17-03-2021,COVILHÃ,56,4,120,"[120,240]",Moderado,,,,56,Centro,CASTELO BRANCO,0503,55560.06,46787,3533,2998,2365,2111,2193,4304,6669,9667,13200,84.21,23.76,17.4,12.0
17-03-2021,CRATO,1,0,32,"[0,120]",Baixo a Moderado,,,,1,Alentejo,PORTALEGRE,1206,39806.88,3129,229,258,163,182,228,410,573,831,1060,7.86,2.66,2.09,1.44
17-03-2021,CUBA,3,0,65,"[0,120]",Baixo a Moderado,,,,3,Alentejo,BEJA,0207,17208.72,4595,255,233,206,190,143,333,539,772,1027,26.7,5.97,4.49,3.13
17-03-2021,ELVAS,5,0,24,"[0,120]",Baixo a Moderado,,,,5,Alentejo,PORTALEGRE,1207,63128.86,20528,1057,1145,902,852,810,1662,2564,3709,4766,32.52,7.55,5.88,4.06
17-03-2021,ENTRONCAMENTO,18,1,83,"[0,120]",Baixo a Moderado,,,,18,Lisboa e Vale do Tejo,SANTARÉM,1410,1372.81,21558,1066,930,868,695,592,1287,2155,3085,4151,1570.14,302.33,224.69,156.96
17-03-2021,ESPINHO,26,2,88,"[0,120]",Baixo a Moderado,,,,26,Norte,AVEIRO,0107,2105.68,29516,2205,1993,1430,1177,960,2137,3567,5560,7765,1401.52,368.71,264.01,169.37
17-03-2021,ESPOSENDE,13,1,38,"[0,120]",Baixo a Moderado,,,,13,Norte,BRAGA,0306,9540.98,34177,1831,1522,1095,894,723,1617,2712,4234,6065,358.21,63.57,44.38,28.42
17-03-2021,ESTARREJA,10,1,38,"[0,120]",Baixo a Moderado,,,,10,Centro,AVEIRO,0108,10817.33,26006,1503,1399,1106,953,728,1681,2787,4186,5689,240.42,52.59,38.7,25.76
17-03-2021,ESTREMOZ,6,0,47,"[0,120]",Baixo a Moderado,,,,6,Alentejo,ÉVORA,0704,51379.95,12728,789,613,697,786,877,1663,2360,2973,3762,24.77,7.32,5.79,4.59
17-03-2021,ÉVORA,11,1,21,"[0,120]",Baixo a Moderado,,,,11,Alentejo,ÉVORA,0705,130707.58,52428,3569,2852,2176,1966,1803,3769,5945,8797,12366,40.11,9.46,6.73,4.55
17-03-2021,FAFE,21,2,44,"[0,120]",Baixo a Moderado,,,,21,Norte,BRAGA,0307,21908.11,48060,3044,2455,1679,1403,1208,2611,4290,6745,9789,219.37,44.68,30.79,19.58
17-03-2021,FARO,39,3,64,"[0,120]",Baixo a Moderado,,,,39,Algarve,FARO,0805,20256.79,61015,3847,3364,2604,2055,1601,3656,6260,9624,13471,301.2,66.5,47.51,30.9
17-03-2021,FELGUEIRAS,52,4,92,"[0,120]",Baixo a Moderado,,,,52,Norte,PORTO,1303,11573.75,56422,2951,2302,1601,1316,973,2289,3890,6192,9143,487.49,79.0,53.5,33.61
17-03-2021,FERREIRA DO ALENTEJO,7,0,89,"[0,120]",Baixo a Moderado,,,,7,Alentejo,BEJA,0208,64820.68,7845,515,414,372,343,345,688,1060,1474,1989,12.1,3.07,2.27,1.64
17-03-2021,FERREIRA DO ZÊZERE,0,0,0,"[0,120]",Baixo a Moderado,,,,0,Lisboa e Vale do Tejo,SANTARÉM,1411,19038.03,7959,470,370,416,465,456,921,1337,1707,2177,41.81,11.44,8.97,7.02
17-03-2021,FIGUEIRA DA FOZ,119,9,203,"[120,240]",Moderado,,,,119,Centro,COIMBRA,0605,37905.26,58747,4032,3597,2887,2495,2043,4538,7425,11022,15054,154.98,39.72,29.08,19.59
17-03-2021,FIGUEIRA DE CASTELO RODRIGO,1,0,18,"[0,120]",Baixo a Moderado,,,,1,Centro,GUARDA,0904,50857.46,5584,347,352,290,352,391,743,1033,1385,1732,10.98,3.41,2.72,2.03
17-03-2021,FIGUEIRÓ DOS VINHOS,11,1,198,"[120,240]",Moderado,,,,11,Centro,LEIRIA,1008,17344.0,5568,402,386,322,309,351,660,982,1368,1770,32.1,10.21,7.89,5.66
17-03-2021,FORNOS DE ALGODRES,5,0,110,"[0,120]",Baixo a Moderado,,,,5,Centro,GUARDA,0905,13145.05,4528,261,218,247,256,232,488,735,953,1214,34.45,9.24,7.25,5.59
17-03-2021,FREIXO DE ESPADA À CINTA,0,0,0,"[0,120]",Baixo a Moderado,,,,0,Norte,BRAGANÇA,0404,24414.29,3298,211,177,231,196,189,385,616,793,1004,13.51,4.11,3.25,2.52
17-03-2021,FRONTEIRA,1,0,34,"[0,120]",Baixo a Moderado,,,,1,Alentejo,PORTALEGRE,1208,24859.58,2974,213,182,149,156,168,324,473,655,868,11.96,3.49,2.63,1.9
17-03-2021,FUNCHAL,952,68,915,"[480,960]",Muito Elevado,,,,952,Madeira,MADEIRA,3103,7616.2,104024,6382,5086,3643,2821,1990,4811,8454,13540,19922,1365.86,261.58,177.78,111.0
17-03-2021,FUNDÃO,14,1,53,"[0,120]",Baixo a Moderado,,,,14,Centro,CASTELO BRANCO,0504,70019.79,26495,1781,1464,1432,1357,1643,3000,4432,5896,7677,37.84,10.96,8.42,6.33
17-03-2021,GAVIÃO,1,0,31,"[0,120]",Baixo a Moderado,,,,1,Alentejo,PORTALEGRE,1209,29459.45,3263,189,186,222,263,293,556,778,964,1153,11.08,3.91,3.27,2.64
17-03-2021,GÓIS,2,0,53,"[0,120]",Baixo a Moderado,,,,2,Centro,COIMBRA,0606,26330.19,3805,235,199,240,233,244,477,717,916,1151,14.45,4.37,3.48,2.72
17-03-2021,GOLEGÃ,13,1,243,"[240,480]",Elevado,,,,13,Lisboa e Vale do Tejo,SANTARÉM,1412,8431.67,5339,356,299,281,243,255,498,779,1078,1434,63.32,17.01,12.78,9.24
17-03-2021,GONDOMAR,100,7,60,"[0,120]",Baixo a Moderado,,,,100,Norte,PORTO,1304,13191.76,165985,10555,8755,6222,4450,3364,7814,14036,22791,33346,1258.22,252.77,172.76,106.4
17-03-2021,GOUVEIA,21,2,170,"[120,240]",Moderado,,,,21,Centro,GUARDA,0906,30061.17,12387,871,931,780,783,810,1593,2373,3304,4175,41.21,13.89,10.99,7.89
17-03-2021,GRÂNDOLA,8,1,55,"[0,120]",Baixo a Moderado,,,,8,Alentejo,SETÚBAL,1505,82593.66,14639,834,834,708,688,672,1360,2068,2902,3736,17.72,4.52,3.51,2.5
17-03-2021,GUARDA,17,1,44,"[0,120]",Baixo a Moderado,,,,17,Centro,GUARDA,0907,71209.58,38969,2477,2041,1686,1415,1474,2889,4575,6616,9093,54.72,12.77,9.29,6.42
17-03-2021,GUIMARÃES,64,5,42,"[0,120]",Baixo a Moderado,,,,64,Norte,BRAGA,0308,24099.96,152309,9394,7074,4809,3877,2948,6825,11634,18708,28102,631.99,116.61,77.63,48.27
17-03-2021,HORTA,0,0,0,"[0,120]",Baixo a Moderado,,,,0,Açores,AÇORES,4701,17305.53,14521,818,658,468,352,302,654,1122,1780,2598,83.91,15.01,10.29,6.48
17-03-2021,IDANHA-A-NOVA,1,0,12,"[0,120]",Baixo a Moderado,,,,1,Centro,CASTELO BRANCO,0505,141633.51,8043,518,490,519,672,974,1646,2165,2655,3173,5.68,2.24,1.87,1.53
17-03-2021,ÍLHAVO,48,3,124,"[120,240]",Moderado,,,,48,Centro,AVEIRO,0110,7347.55,38699,2227,1943,1444,1193,850,2043,3487,5430,7657,526.66,104.21,73.9,47.46
17-03-2021,LAGOA (FARO),29,2,127,"[120,240]",Moderado,,,,29,Algarve,FARO,0806,8825.45,22762,1314,1168,919,749,670,1419,2338,3506,4820,257.93,54.62,39.73,26.49
17-03-2021,LAGOA,21,2,143,"[120,240]",Moderado,,,,21,Açores,AÇORES,4201,4559.32,14721,536,458,349,238,235,473,822,1280,1816,322.9,39.83,28.08,18.03
17-03-2021,LAGOS,15,1,49,"[0,120]",Baixo a Moderado,,,,15,Algarve,FARO,0807,21299.27,30374,1744,1434,1247,1053,1029,2082,3329,4763,6507,142.61,30.55,22.36,15.63
17-03-2021,LAJES DAS FLORES,0,0,0,"[0,120]",Baixo a Moderado,,,,0,Açores,AÇORES,4801,7004.79,1463,88,53,62,46,54,100,162,215,303,20.89,4.33,3.07,2.31
17-03-2021,LAJES DO PICO,0,0,0,"[0,120]",Baixo a Moderado,,,,0,Açores,AÇORES,4601,15531.09,4490,304,231,223,159,162,321,544,775,1079,28.91,6.95,4.99,3.5
17-03-2021,LAMEGO,37,3,149,"[120,240]",Moderado,,,,37,Norte,VISEU,1805,16542.11,24895,1639,1284,1124,898,783,1681,2805,4089,5728,150.5,34.63,24.72,16.96
17-03-2021,LEIRIA,61,4,49,"[0,120]",Baixo a Moderado,,,,61,Centro,LEIRIA,1009,56508.83,125267,7389,6366,5090,3902,3159,7061,12151,18517,25906,221.68,45.84,32.77,21.5
17-03-2021,LISBOA,586,42,115,"[0,120]",Baixo a Moderado,,,,586,Lisboa e Vale do Tejo,LISBOA,1106,10005.43,509515,33197,33340,27706,23037,26770,49807,77513,110853,144050,5092.6,1439.78,1107.98,774.74
17-03-2021,LOULÉ,53,4,77,"[0,120]",Baixo a Moderado,,,,53,Algarve,FARO,0808,76366.91,68697,3890,3350,2780,2358,2251,4609,7389,10739,14629,89.96,19.16,14.06,9.68
17-03-2021,LOURES,239,17,112,"[0,120]",Baixo a Moderado,,,,239,Lisboa e Vale do Tejo,LISBOA,1107,16723.99,213687,12746,12794,9644,6669,5033,11702,21346,34140,46886,1277.73,280.35,204.14,127.64
17-03-2021,LOURINHÃ,10,1,39,"[0,120]",Baixo a Moderado,,,,10,Lisboa e Vale do Tejo,LISBOA,1108,14717.2,25855,1584,1243,992,842,645,1487,2479,3722,5306,175.68,36.05,25.29,16.84
17-03-2021,LOUSÃ,15,1,87,"[0,120]",Baixo a Moderado,,,,15,Centro,COIMBRA,0607,13840.01,17158,946,866,658,528,450,978,1636,2502,3448,123.97,24.91,18.08,11.82
17-03-2021,LOUSADA,38,3,81,"[0,120]",Baixo a Moderado,,,,38,Norte,PORTO,1305,9608.01,46755,2289,1698,1176,853,621,1474,2650,4348,6637,486.63,69.08,45.25,27.58
17-03-2021,MAÇÃO,0,0,0,"[0,120]",Baixo a Moderado,,,,0,Lisboa e Vale do Tejo,SANTARÉM,1413,39997.98,6267,386,362,390,440,657,1097,1487,1849,2235,15.67,5.59,4.62,3.72
17-03-2021,MACEDO DE CAVALEIROS,12,1,83,"[0,120]",Baixo a Moderado,,,,12,Norte,BRAGANÇA,0405,69914.08,14516,1082,889,878,823,938,1761,2639,3528,4610,20.76,6.59,5.05,3.77
17-03-2021,MACHICO,121,9,606,"[480,960]",Muito Elevado,,,,121,Madeira,MADEIRA,3104,6825.1,19981,1197,860,662,455,331,786,1448,2308,3505,292.76,51.36,33.82,21.22
17-03-2021,MADALENA,0,0,0,"[0,120]",Baixo a Moderado,,,,0,Açores,AÇORES,4602,14712.33,5895,334,256,173,190,179,369,542,798,1132,40.07,7.69,5.42,3.68
17-03-2021,MAFRA,73,5,86,"[0,120]",Baixo a Moderado,,,,73,Lisboa e Vale do Tejo,LISBOA,1109,29165.5,84816,3613,3334,2839,2089,1899,3988,6827,10161,13774,290.81,47.23,34.84,23.41
17-03-2021,MAIA,60,4,43,"[0,120]",Baixo a Moderado,,,,60,Norte,PORTO,1306,8293.94,138971,7801,6617,4512,3339,2631,5970,10482,17099,24900,1675.56,300.22,206.16,126.38
17-03-2021,MANGUALDE,8,1,43,"[0,120]",Baixo a Moderado,,,,8,Centro,VISEU,1806,21925.56,18510,1198,1128,885,852,743,1595,2480,3608,4806,84.42,21.92,16.46,11.31
17-03-2021,MANTEIGAS,2,0,67,"[0,120]",Baixo a Moderado,,,,2,Centro,GUARDA,0908,12197.55,3007,258,197,159,167,146,313,472,669,927,24.65,7.6,5.48,3.87
17-03-2021,MARCO DE CANAVESES,11,1,21,"[0,120]",Baixo a Moderado,,,,11,Norte,PORTO,1307,20188.98,51496,2678,2060,1488,1265,1023,2288,3776,5836,8514,255.07,42.17,28.91,18.7
17-03-2021,MARINHA GRANDE,60,4,156,"[120,240]",Moderado,,,,60,Centro,LEIRIA,1010,18725.19,38508,2365,2302,1638,1359,1058,2417,4055,6357,8722,205.65,46.58,33.95,21.66
17-03-2021,MARVÃO,0,0,0,"[0,120]",Baixo a Moderado,,,,0,Alentejo,PORTALEGRE,1210,15489.9,3005,198,185,142,197,237,434,576,761,959,19.4,6.19,4.91,3.72
17-03-2021,MATOSINHOS,74,5,42,"[0,120]",Baixo a Moderado,,,,74,Norte,PORTO,1308,6241.97,175357,11850,9977,7023,5024,3884,8908,15931,25908,37758,2809.31,604.9,415.06,255.22
17-03-2021,MEALHADA,12,1,60,"[0,120]",Baixo a Moderado,,,,12,Centro,AVEIRO,0111,11065.66,19914,1163,1039,810,828,831,1659,2469,3508,4671,179.96,42.21,31.7,22.31
17-03-2021,MÊDA,0,0,0,"[0,120]",Baixo a Moderado,,,,0,Centro,GUARDA,0909,28604.92,4587,343,306,290,288,443,731,1021,1327,1670,16.04,5.84,4.64,3.57
17-03-2021,MELGAÇO,4,0,49,"[0,120]",Baixo a Moderado,,,,4,Norte,VIANA DO CASTELO,1603,23824.58,8093,507,567,578,614,675,1289,1867,2434,2941,33.97,12.34,10.22,7.84
17-03-2021,MÉRTOLA,9,1,147,"[120,240]",Moderado,,,,9,Alentejo,BEJA,0209,129287.34,6142,400,390,378,423,600,1023,1401,1791,2191,4.75,1.69,1.39,1.08
17-03-2021,MESÃO FRIO,0,0,0,"[0,120]",Baixo a Moderado,,,,0,Norte,VILA REAL,1704,2664.87,3964,265,205,168,157,120,277,445,650,915,148.74,34.33,24.39,16.7
17-03-2021,MIRA,7,0,59,"[0,120]",Baixo a Moderado,,,,7,Centro,COIMBRA,0608,12403.38,11832,727,729,659,550,466,1016,1675,2404,3131,95.4,25.24,19.38,13.5
17-03-2021,MIRANDA DO CORVO,8,1,63,"[0,120]",Baixo a Moderado,,,,8,Centro,COIMBRA,0609,12637.79,12708,706,659,568,498,404,902,1470,2129,2835,100.55,22.43,16.85,11.63
17-03-2021,MIRANDA DO DOURO,0,0,0,"[0,120]",Baixo a Moderado,,,,0,Norte,BRAGANÇA,0406,48718.31,6830,482,429,442,463,470,933,1375,1804,2286,14.02,4.69,3.7,2.82
17-03-2021,MIRANDELA,6,0,28,"[0,120]",Baixo a Moderado,,,,6,Norte,BRAGANÇA,0407,65895.67,21754,1640,1315,1204,1078,947,2025,3229,4544,6184,33.01,9.38,6.9,4.9
17-03-2021,MOGADOURO,3,0,36,"[0,120]",Baixo a Moderado,,,,3,Norte,BRAGANÇA,0408,76064.93,8392,589,529,576,630,655,1285,1861,2390,2979,11.03,3.92,3.14,2.45
17-03-2021,MOIMENTA DA BEIRA,4,0,41,"[0,120]",Baixo a Moderado,,,,4,Norte,VISEU,1807,21996.9,9736,576,514,471,416,461,877,1348,1862,2438,44.26,11.08,8.46,6.13
17-03-2021,MOITA,95,7,147,"[120,240]",Moderado,,,,95,Lisboa e Vale do Tejo,SETÚBAL,1506,5525.98,64407,4226,3646,2623,1801,1425,3226,5849,9495,13721,1165.53,248.3,171.82,105.85
17-03-2021,MONÇÃO,7,0,39,"[0,120]",Baixo a Moderado,,,,7,Norte,VIANA DO CASTELO,1604,21130.85,17869,1161,1105,1031,1006,972,1978,3009,4114,5275,84.56,24.96,19.47,14.24
17-03-2021,MONCHIQUE,0,0,0,"[0,120]",Baixo a Moderado,,,,0,Algarve,FARO,0809,39530.43,5077,353,384,321,355,392,747,1068,1452,1805,12.84,4.57,3.67,2.7
17-03-2021,MONDIM DE BASTO,2,0,29,"[0,120]",Baixo a Moderado,,,,2,Norte,VILA REAL,1705,17207.52,6946,395,300,314,284,283,567,881,1181,1576,40.36,9.16,6.86,5.12
17-03-2021,MONFORTE,5,0,168,"[120,240]",Moderado,,,,5,Alentejo,PORTALEGRE,1211,42024.82,2975,139,115,117,192,168,360,477,592,731,7.08,1.74,1.41,1.14
17-03-2021,MONTALEGRE,1,0,11,"[0,120]",Baixo a Moderado,,,,1,Norte,VILA REAL,1706,80545.71,8997,699,628,595,603,730,1333,1928,2556,3255,11.17,4.04,3.17,2.39
17-03-2021,MONTEMOR-O-NOVO,2,0,13,"[0,120]",Baixo a Moderado,,,,2,Alentejo,ÉVORA,0706,123296.65,15647,991,953,868,878,971,1849,2717,3670,4661,12.69,3.78,2.98,2.2
17-03-2021,MONTEMOR-O-VELHO,19,1,75,"[0,120]",Baixo a Moderado,,,,19,Centro,COIMBRA,0610,22896.23,25224,1496,1397,1217,1057,988,2045,3262,4659,6155,110.17,26.88,20.35,14.25
17-03-2021,MONTIJO,141,10,245,"[240,480]",Elevado,,,,141,Lisboa e Vale do Tejo,SETÚBAL,1507,34861.64,57614,2771,2441,1990,1554,1109,2663,4653,7094,9865,165.26,28.3,20.35,13.35
17-03-2021,MORA,0,0,0,"[0,120]",Baixo a Moderado,,,,0,Alentejo,ÉVORA,0707,44395.02,4138,336,275,252,238,257,495,747,1022,1358,9.32,3.06,2.3,1.68
17-03-2021,MORTÁGUA,4,0,45,"[0,120]",Baixo a Moderado,,,,4,Centro,VISEU,1808,25117.82,8803,638,584,535,499,460,959,1494,2078,2716,35.05,10.81,8.27,5.95
17-03-2021,MOURA,34,2,248,"[240,480]",Elevado,,,,34,Alentejo,BEJA,0210,95845.55,13718,817,656,665,542,461,1003,1668,2324,3141,14.31,3.28,2.42,1.74
17-03-2021,MOURÃO,0,0,0,"[0,120]",Baixo a Moderado,,,,0,Alentejo,ÉVORA,0708,27862.98,2450,139,108,80,104,109,213,293,401,540,8.79,1.94,1.44,1.05
17-03-2021,MURÇA,1,0,18,"[0,120]",Baixo a Moderado,,,,1,Norte,VILA REAL,1707,18937.11,5463,384,341,307,306,319,625,932,1273,1657,28.85,8.75,6.72,4.92
17-03-2021,MURTOSA,1,0,10,"[0,120]",Baixo a Moderado,,,,1,Centro,AVEIRO,0112,7308.78,10279,509,473,403,353,409,762,1165,1638,2147,140.63,29.37,22.41,15.94
17-03-2021,NAZARÉ,6,0,42,"[0,120]",Baixo a Moderado,,,,6,Lisboa e Vale do Tejo,LEIRIA,1011,8243.43,14165,967,903,670,420,396,816,1486,2389,3356,171.84,40.71,28.98,18.03
17-03-2021,NELAS,1,0,8,"[0,120]",Baixo a Moderado,,,,1,Centro,VISEU,1809,12571.48,12974,924,787,668,604,583,1187,1855,2642,3566,103.21,28.37,21.02,14.76
17-03-2021,NISA,2,0,33,"[0,120]",Baixo a Moderado,,,,2,Alentejo,PORTALEGRE,1212,57567.84,6061,405,389,355,483,478,961,1316,1705,2110,10.53,3.67,2.96,2.29
17-03-2021,NORDESTE,1,0,21,"[0,120]",Baixo a Moderado,,,,1,Açores,AÇORES,4202,10146.8,4862,246,180,124,161,162,323,447,627,873,47.92,8.6,6.18,4.41
17-03-2021,ÓBIDOS,1,0,8,"[0,120]",Baixo a Moderado,,,,1,Lisboa e Vale do Tejo,LEIRIA,1012,14155.44,11850,743,650,574,452,436,888,1462,2112,2855,83.72,20.17,14.92,10.33
17-03-2021,ODEMIRA,53,4,214,"[120,240]",Moderado,,,,53,Alentejo,BEJA,0211,172060.15,24717,1475,1317,1225,1397,1349,2746,3971,5288,6763,14.37,3.93,3.07,2.31
17-03-2021,ODIVELAS,207,15,128,"[120,240]",Moderado,,,,207,Lisboa e Vale do Tejo,LISBOA,1116,2654.36,161774,9562,9038,6952,4641,3812,8453,15405,24443,34005,6095.48,1281.27,920.99,580.44
17-03-2021,OEIRAS,137,10,77,"[0,120]",Baixo a Moderado,,,,137,Lisboa e Vale do Tejo,LISBOA,1110,4588.31,177408,11580,11575,8566,6211,5855,12066,20632,32207,43787,3866.78,954.38,701.98,449.69
17-03-2021,OLEIROS,0,0,0,"[0,120]",Baixo a Moderado,,,,0,Centro,CASTELO BRANCO,0506,47109.31,5003,384,341,366,397,487,884,1250,1591,1975,10.62,4.19,3.38,2.65
17-03-2021,OLHÃO,5,0,11,"[0,120]",Baixo a Moderado,,,,5,Algarve,FARO,0810,13086.38,44405,2455,2309,1689,1342,1268,2610,4299,6608,9063,339.33,69.26,50.5,32.85
17-03-2021,OLIVEIRA DE AZEMÉIS,14,1,21,"[0,120]",Baixo a Moderado,,,,14,Norte,AVEIRO,0113,16110.41,66011,4155,3614,2794,2183,1738,3921,6715,10329,14484,409.75,89.91,64.12,41.68
17-03-2021,OLIVEIRA DE FRADES,1,0,10,"[0,120]",Baixo a Moderado,,,,1,Centro,VISEU,1810,14534.62,9936,553,475,438,359,415,774,1212,1687,2240,68.36,15.41,11.61,8.34
17-03-2021,OLIVEIRA DO BAIRRO,14,1,58,"[0,120]",Baixo a Moderado,,,,14,Centro,AVEIRO,0114,8731.99,24277,1327,1182,999,786,810,1596,2595,3777,5104,278.02,58.45,43.25,29.72
17-03-2021,OLIVEIRA DO HOSPITAL,5,0,26,"[0,120]",Baixo a Moderado,,,,5,Centro,COIMBRA,0611,23451.66,19253,1161,1097,962,924,960,1884,2846,3943,5104,82.1,21.76,16.81,12.14
17-03-2021,OURÉM,11,1,25,"[0,120]",Baixo a Moderado,,,,11,Lisboa e Vale do Tejo,SANTARÉM,1421,41668.03,44044,2463,2069,1899,1817,1603,3420,5319,7388,9851,105.7,23.64,17.73,12.77
17-03-2021,OURIQUE,3,0,65,"[0,120]",Baixo a Moderado,,,,3,Alentejo,BEJA,0212,66331.36,4607,313,287,284,268,227,495,779,1066,1379,6.95,2.08,1.61,1.17
17-03-2021,OVAR,10,1,18,"[0,120]",Baixo a Moderado,,,,10,Centro,AVEIRO,0115,14770.25,54260,3294,2709,1994,1636,1234,2870,4864,7573,10867,367.37,73.57,51.27,32.93
17-03-2021,PAÇOS DE FERREIRA,63,4,111,"[0,120]",Baixo a Moderado,,,,63,Norte,PORTO,1309,7099.29,56728,2903,2193,1518,1135,664,1799,3317,5510,8413,799.1,118.51,77.62,46.72
17-03-2021,PALMELA,58,4,90,"[0,120]",Baixo a Moderado,,,,58,Lisboa e Vale do Tejo,SETÚBAL,1508,46512.01,64269,3402,3244,2635,1846,1391,3237,5872,9116,12518,138.18,26.91,19.6,12.62
17-03-2021,PAMPILHOSA DA SERRA,3,0,74,"[0,120]",Baixo a Moderado,,,,3,Centro,COIMBRA,0612,39646.24,4037,238,254,295,339,423,762,1057,1311,1549,10.18,3.91,3.31,2.67
17-03-2021,PAREDES,43,3,50,"[0,120]",Baixo a Moderado,,,,43,Norte,PORTO,1310,15675.69,86067,4272,3532,2412,1717,1258,2975,5387,8919,13191,549.04,84.15,56.9,34.36
17-03-2021,PAREDES DE COURA,1,0,12,"[0,120]",Baixo a Moderado,,,,1,Norte,VIANA DO CASTELO,1605,13818.59,8535,466,528,407,465,515,980,1387,1915,2381,61.76,17.23,13.86,10.04
17-03-2021,PEDRÓGÃO GRANDE,3,0,88,"[0,120]",Baixo a Moderado,,,,3,Centro,LEIRIA,1013,12874.75,3410,175,173,196,221,252,473,669,842,1017,26.49,7.9,6.54,5.2
17-03-2021,PENACOVA,25,2,183,"[120,240]",Moderado,,,,25,Centro,COIMBRA,0613,21673.23,13694,968,923,745,621,703,1324,2069,2992,3960,63.18,18.27,13.81,9.55
17-03-2021,PENAFIEL,25,2,36,"[0,120]",Baixo a Moderado,,,,25,Norte,PORTO,1311,21224.27,69772,3648,2823,2032,1663,1230,2893,4925,7748,11396,328.74,53.69,36.51,23.2
17-03-2021,PENALVA DO CASTELO,1,0,14,"[0,120]",Baixo a Moderado,,,,1,Centro,VISEU,1811,13433.92,7115,449,457,413,391,426,817,1230,1687,2136,52.96,15.9,12.56,9.16
17-03-2021,PENAMACOR,1,0,21,"[0,120]",Baixo a Moderado,,,,1,Centro,CASTELO BRANCO,0507,56370.69,4755,262,248,273,451,633,1084,1357,1605,1867,8.44,3.31,2.85,2.41
17-03-2021,PENEDONO,0,0,0,"[0,120]",Baixo a Moderado,,,,0,Norte,VISEU,1812,13370.75,2591,172,113,129,156,138,294,423,536,708,19.38,5.3,4.01,3.16
17-03-2021,PENELA,15,1,278,"[240,480]",Elevado,,,,15,Centro,COIMBRA,0614,13480.0,5397,314,324,274,359,344,703,977,1301,1615,40.04,11.98,9.65,7.25
17-03-2021,PENICHE,11,1,42,"[0,120]",Baixo a Moderado,,,,11,Lisboa e Vale do Tejo,LEIRIA,1014,7754.98,26501,1746,1504,1203,926,707,1633,2836,4340,6086,341.73,78.48,55.96,36.57
17-03-2021,PESO DA RÉGUA,15,1,95,"[0,120]",Baixo a Moderado,,,,15,Norte,VILA REAL,1708,9486.01,15773,1076,843,650,659,455,1114,1764,2607,3683,166.28,38.83,27.48,18.6
17-03-2021,PINHEL,6,0,70,"[0,120]",Baixo a Moderado,,,,6,Centro,GUARDA,0910,48452.12,8511,577,566,551,538,689,1227,1778,2344,2921,17.57,6.03,4.84,3.67
17-03-2021,POMBAL,38,3,74,"[0,120]",Baixo a Moderado,,,,38,Centro,LEIRIA,1015,62600.28,51461,3187,2791,2494,2328,2027,4355,6849,9640,12827,82.21,20.49,15.4,10.94
17-03-2021,PONTA DELGADA,55,4,81,"[0,120]",Baixo a Moderado,,,,55,Açores,AÇORES,4203,23298.65,67935,3108,2435,1726,1133,902,2035,3761,6196,9304,291.58,39.93,26.59,16.14
17-03-2021,PONTA DO SOL,49,3,570,"[480,960]",Muito Elevado,,,,49,Madeira,MADEIRA,3105,4622.03,8593,319,283,347,208,221,429,776,1059,1378,185.92,29.81,22.91,16.79
17-03-2021,PONTE DA BARCA,3,0,27,"[0,120]",Baixo a Moderado,,,,3,Norte,VIANA DO CASTELO,1606,18211.37,11180,635,576,517,554,490,1044,1561,2137,2772,61.39,15.22,11.73,8.57
17-03-2021,PONTE DE LIMA,25,2,61,"[0,120]",Baixo a Moderado,,,,25,Norte,VIANA DO CASTELO,1607,32025.46,41315,2321,2022,1720,1596,1462,3058,4778,6800,9121,129.01,28.48,21.23,14.92
17-03-2021,PONTE DE SOR,5,0,33,"[0,120]",Baixo a Moderado,,,,5,Alentejo,PORTALEGRE,1213,83971.16,14994,939,800,716,739,831,1570,2286,3086,4025,17.86,4.79,3.68,2.72
17-03-2021,PORTALEGRE,6,0,27,"[0,120]",Baixo a Moderado,,,,6,Alentejo,PORTALEGRE,1214,44713.64,22172,1577,1351,1137,993,984,1977,3114,4465,6042,49.59,13.51,9.99,6.96
17-03-2021,PORTEL,4,0,69,"[0,120]",Baixo a Moderado,,,,4,Alentejo,ÉVORA,0709,60100.57,5828,336,358,283,331,305,636,919,1277,1613,9.7,2.68,2.12,1.53
17-03-2021,PORTIMÃO,53,4,96,"[0,120]",Baixo a Moderado,,,,53,Algarve,FARO,0811,18206.29,55483,3182,2927,2116,1582,1400,2982,5098,8025,11207,304.75,61.56,44.08,28.0
17-03-2021,PORTO,210,15,97,"[0,120]",Baixo a Moderado,,,,210,Norte,PORTO,1312,4142.02,216606,15790,15193,11280,9409,10044,19453,30733,45926,61716,5229.5,1490.0,1108.79,741.98
17-03-2021,PORTO DE MÓS,12,1,52,"[0,120]",Baixo a Moderado,,,,12,Centro,LEIRIA,1016,26183.41,23275,1355,1210,1034,888,872,1760,2794,4004,5359,88.89,20.47,15.29,10.67
17-03-2021,PORTO MONIZ,3,0,128,"[120,240]",Moderado,,,,3,Madeira,MADEIRA,3106,8293.38,2342,143,130,95,98,120,218,313,443,586,28.24,7.07,5.34,3.77
17-03-2021,PORTO SANTO,5,0,96,"[0,120]",Baixo a Moderado,,,,5,Madeira,MADEIRA,3201,4300.7,5202,240,157,134,110,68,178,312,469,709,120.95,16.48,10.9,7.25
17-03-2021,PÓVOA DE LANHOSO,2,0,9,"[0,120]",Baixo a Moderado,,,,2,Norte,BRAGA,0309,13465.29,21499,1175,909,732,673,624,1297,2029,2938,4113,159.67,30.55,21.82,15.07
17-03-2021,PÓVOA DE VARZIM,85,6,135,"[120,240]",Moderado,,,,85,Norte,PORTO,1313,8220.59,62784,3712,3120,2134,1594,1305,2899,5033,8153,11865,763.7,144.33,99.17,61.22
17-03-2021,POVOAÇÃO,2,0,34,"[0,120]",Baixo a Moderado,,,,2,Açores,AÇORES,4204,10640.77,5927,293,212,191,144,134,278,469,681,974,55.7,9.15,6.4,4.41
17-03-2021,VILA DA PRAIA DA VITÓRIA,1,0,5,"[0,120]",Baixo a Moderado,,,,1,Açores,AÇORES,4302,16127.06,21317,1133,789,619,436,336,772,1391,2180,3313,132.18,20.54,13.52,8.63
17-03-2021,PROENÇA-A-NOVA,11,1,151,"[120,240]",Moderado,,,,11,Centro,CASTELO BRANCO,0508,39539.96,7298,508,465,389,400,560,960,1349,1814,2322,18.46,5.87,4.59,3.41
17-03-2021,REDONDO,1,0,16,"[0,120]",Baixo a Moderado,,,,1,Alentejo,ÉVORA,0710,36950.87,6353,349,325,288,288,354,642,930,1255,1604,17.19,4.34,3.4,2.52
17-03-2021,REGUENGOS DE MONSARAZ,6,0,60,"[0,120]",Baixo a Moderado,,,,6,Alentejo,ÉVORA,0711,46399.72,10015,602,511,455,462,473,935,1390,1901,2503,21.58,5.39,4.1,3.0
17-03-2021,RESENDE,14,1,138,"[120,240]",Moderado,,,,14,Norte,VISEU,1813,12334.93,10137,560,493,448,433,422,855,1303,1796,2356,82.18,19.1,14.56,10.56
17-03-2021,RIBEIRA BRAVA,53,4,426,"[240,480]",Elevado,,,,53,Madeira,MADEIRA,3107,6544.88,12435,648,500,411,311,287,598,1009,1509,2157,189.99,32.96,23.06,15.42
17-03-2021,RIBEIRA DE PENA,0,0,0,"[0,120]",Baixo a Moderado,,,,0,Norte,VILA REAL,1709,21745.98,6016,371,301,290,310,368,678,968,1269,1640,27.66,7.54,5.84,4.45
17-03-2021,RIBEIRA GRANDE,45,3,137,"[120,240]",Moderado,,,,45,Açores,AÇORES,4205,18015.13,32811,1163,689,512,345,253,598,1110,1799,2962,182.13,16.44,9.99,6.16
17-03-2021,RIO MAIOR,39,3,191,"[120,240]",Moderado,,,,39,Lisboa e Vale do Tejo,SANTARÉM,1414,27276.45,20379,1251,1144,941,795,648,1443,2384,3528,4779,74.71,17.52,12.93,8.74
17-03-2021,SABROSA,1,0,17,"[0,120]",Baixo a Moderado,,,,1,Norte,VILA REAL,1710,15692.45,5918,393,314,304,302,350,652,956,1270,1663,37.71,10.6,8.09,6.09
17-03-2021,SABUGAL,0,0,0,"[0,120]",Baixo a Moderado,,,,0,Centro,GUARDA,0911,82269.82,10585,724,707,694,796,1009,1805,2499,3206,3930,12.87,4.78,3.9,3.04
17-03-2021,SALVATERRA DE MAGOS,19,1,89,"[0,120]",Baixo a Moderado,,,,19,Lisboa e Vale do Tejo,SANTARÉM,1415,24393.2,21295,1275,1181,1060,799,772,1571,2631,3812,5087,87.3,20.85,15.63,10.79
17-03-2021,SANTA COMBA DÃO,3,0,29,"[0,120]",Baixo a Moderado,,,,3,Centro,VISEU,1814,11194.77,10452,732,684,569,538,464,1002,1571,2255,2987,93.36,26.68,20.14,14.03
17-03-2021,SANTA CRUZ,248,18,548,"[480,960]",Muito Elevado,,,,248,Madeira,MADEIRA,3108,8150.28,45281,1817,1301,974,716,523,1239,2213,3514,5331,555.6,65.41,43.12,27.15
17-03-2021,SANTA CRUZ DA GRACIOSA,0,0,0,"[0,120]",Baixo a Moderado,,,,0,Açores,AÇORES,4401,6065.78,4208,228,180,163,124,145,269,432,612,840,69.37,13.85,10.09,7.12
17-03-2021,SANTA CRUZ DAS FLORES,0,0,0,"[0,120]",Baixo a Moderado,,,,0,Açores,AÇORES,4802,7091.44,2165,125,98,74,56,51,107,181,279,404,30.53,5.7,3.93,2.55
17-03-2021,SANTA MARIA DA FEIRA,67,5,48,"[0,120]",Baixo a Moderado,,,,67,Norte,AVEIRO,0109,21587.65,138636,8182,6743,4771,3856,3079,6935,11706,18449,26631,642.19,123.36,85.46,54.22
17-03-2021,SANTA MARTA DE PENAGUIÃO,6,0,91,"[0,120]",Baixo a Moderado,,,,6,Norte,VILA REAL,1711,6928.13,6599,483,373,337,316,317,633,970,1343,1826,95.25,26.36,19.39,14.0
17-03-2021,SANTANA,3,0,45,"[0,120]",Baixo a Moderado,,,,3,Madeira,MADEIRA,3109,9547.3,6711,418,353,343,282,277,559,902,1255,1673,70.29,17.52,13.15,9.45
17-03-2021,SANTARÉM,41,3,71,"[0,120]",Baixo a Moderado,,,,41,Lisboa e Vale do Tejo,SANTARÉM,1416,55253.58,57421,3654,3441,2760,2466,2206,4672,7432,10873,14527,103.92,26.29,19.68,13.45
17-03-2021,SANTIAGO DO CACÉM,25,2,87,"[0,120]",Baixo a Moderado,,,,25,Alentejo,SETÚBAL,1509,105969.29,28791,2144,1689,1472,1295,1215,2510,3982,5671,7815,27.17,7.37,5.35,3.76
17-03-2021,SANTO TIRSO,39,3,57,"[0,120]",Baixo a Moderado,,,,39,Norte,PORTO,1314,13655.52,68055,4911,3935,2761,2257,1810,4067,6828,10763,15674,498.35,114.78,78.82,50.0
17-03-2021,SÃO BRÁS DE ALPORTEL,4,0,38,"[0,120]",Baixo a Moderado,,,,4,Algarve,FARO,0812,15336.92,10416,596,468,467,404,401,805,1272,1740,2336,67.91,15.23,11.35,8.29
17-03-2021,SÃO JOÃO DA MADEIRA,5,0,23,"[0,120]",Baixo a Moderado,,,,5,Norte,AVEIRO,0116,794.3,21958,1347,1069,796,601,593,1194,1990,3059,4406,2765.49,554.91,385.26,250.63
17-03-2021,SÃO JOÃO DA PESQUEIRA,4,0,56,"[0,120]",Baixo a Moderado,,,,4,Norte,VISEU,1815,26610.85,7125,417,330,294,328,328,656,950,1280,1697,26.77,6.38,4.81,3.57
17-03-2021,SÃO PEDRO DO SUL,17,1,110,"[0,120]",Baixo a Moderado,,,,17,Centro,VISEU,1816,34895.09,15403,990,962,861,759,909,1668,2529,3491,4481,44.14,12.84,10.0,7.25
17-03-2021,SÃO ROQUE DO PICO,1,0,31,"[0,120]",Baixo a Moderado,,,,1,Açores,AÇORES,4603,14236.1,3266,199,141,93,96,113,209,302,443,642,22.94,4.51,3.11,2.12
17-03-2021,SÃO VICENTE,2,0,39,"[0,120]",Baixo a Moderado,,,,2,Madeira,MADEIRA,3110,7883.71,5143,272,264,266,225,280,505,771,1035,1307,65.23,16.58,13.13,9.78
17-03-2021,SARDOAL,2,0,53,"[0,120]",Baixo a Moderado,,,,2,Lisboa e Vale do Tejo,SANTARÉM,1417,9214.72,3741,227,178,148,165,248,413,561,739,966,40.6,10.48,8.02,6.09
17-03-2021,SÁTÃO,6,0,52,"[0,120]",Baixo a Moderado,,,,6,Centro,VISEU,1817,20194.11,11580,765,671,515,465,476,941,1456,2127,2892,57.34,14.32,10.53,7.21
17-03-2021,SEIA,12,1,54,"[0,120]",Baixo a Moderado,,,,12,Centro,GUARDA,0912,43568.83,22234,1807,1589,1238,1122,721,1843,3081,4670,6477,51.03,14.87,10.72,7.07
17-03-2021,SEIXAL,122,9,73,"[0,120]",Baixo a Moderado,,,,122,Lisboa e Vale do Tejo,SETÚBAL,1510,9545.17,167752,10586,9270,6661,4391,2930,7321,13982,23252,33838,1757.49,354.51,243.6,146.49
17-03-2021,SERNANCELHE,2,0,37,"[0,120]",Baixo a Moderado,,,,2,Norte,VISEU,1818,22861.22,5396,305,293,286,273,260,533,819,1112,1417,23.6,6.2,4.86,3.58
17-03-2021,SERPA,44,3,308,"[240,480]",Elevado,,,,44,Alentejo,BEJA,0213,110563.34,14304,903,761,719,697,626,1323,2042,2803,3706,12.94,3.35,2.54,1.85
17-03-2021,SERTÃ,6,0,41,"[0,120]",Baixo a Moderado,,,,6,Centro,CASTELO BRANCO,0509,44673.17,14577,870,779,790,767,1020,1787,2577,3356,4226,32.63,9.46,7.51,5.77
17-03-2021,SESIMBRA,55,4,106,"[0,120]",Baixo a Moderado,,,,55,Lisboa e Vale do Tejo,SETÚBAL,1511,19571.75,51858,2400,2321,1853,1257,1083,2340,4193,6514,8914,264.96,45.54,33.28,21.42
17-03-2021,SETÚBAL,125,9,109,"[0,120]",Baixo a Moderado,,,,125,Lisboa e Vale do Tejo,SETÚBAL,1512,23032.5,115126,7425,6929,5075,3775,2655,6430,11505,18434,25859,499.83,112.27,80.03,49.95
17-03-2021,SEVER DO VOUGA,4,0,35,"[0,120]",Baixo a Moderado,,,,4,Centro,AVEIRO,0117,12987.56,11331,766,637,568,540,567,1107,1675,2312,3078,87.24,23.7,17.8,12.9
17-03-2021,SILVES,3,0,8,"[0,120]",Baixo a Moderado,,,,3,Algarve,FARO,0813,68006.23,36226,2137,1869,1610,1423,1600,3023,4633,6502,8639,53.27,12.7,9.56,6.81
17-03-2021,SINES,7,0,51,"[0,120]",Baixo a Moderado,,,,7,Alentejo,SETÚBAL,1513,20330.17,13715,888,791,551,416,268,684,1235,2026,2914,67.46,14.33,9.97,6.07
17-03-2021,SINTRA,376,27,96,"[0,120]",Baixo a Moderado,,,,376,Lisboa e Vale do Tejo,LISBOA,1111,31922.73,391402,20490,18316,13545,9137,7284,16421,29966,48282,68772,1226.08,215.43,151.25,93.87
17-03-2021,SOBRAL DE MONTE AGRAÇO,17,1,160,"[120,240]",Moderado,,,,17,Lisboa e Vale do Tejo,LISBOA,1112,5210.32,10651,564,507,352,272,212,484,836,1343,1907,204.43,36.6,25.78,16.05
17-03-2021,SOURE,15,1,88,"[0,120]",Baixo a Moderado,,,,15,Centro,COIMBRA,0615,26506.07,17120,1173,1142,1004,883,987,1870,2874,4016,5189,64.59,19.58,15.15,10.84
17-03-2021,SOUSEL,0,0,0,"[0,120]",Baixo a Moderado,,,,0,Alentejo,PORTALEGRE,1215,27932.18,4412,261,274,208,302,292,594,802,1076,1337,15.8,4.79,3.85,2.87
17-03-2021,TÁBUA,7,1,62,"[0,120]",Baixo a Moderado,,,,7,Centro,COIMBRA,0616,19978.58,11368,729,584,524,430,464,894,1418,2002,2731,56.9,13.67,10.02,7.1
17-03-2021,TABUAÇO,3,0,50,"[0,120]",Baixo a Moderado,,,,3,Norte,VISEU,1819,13385.67,6033,372,314,217,282,363,645,862,1176,1548,45.07,11.56,8.79,6.44
17-03-2021,TAROUCA,2,0,26,"[0,120]",Baixo a Moderado,,,,2,Norte,VISEU,1820,10008.49,7804,405,335,313,277,324,601,914,1249,1654,77.98,16.53,12.48,9.13
17-03-2021,TAVIRA,29,2,118,"[0,120]",Baixo a Moderado,,,,29,Algarve,FARO,0814,60696.7,24530,1493,1415,1252,1066,1277,2343,3595,5010,6503,40.41,10.71,8.25,5.92
17-03-2021,TERRAS DE BOURO,0,0,0,"[0,120]",Baixo a Moderado,,,,0,Norte,BRAGA,0310,27746.07,6361,391,372,296,319,340,659,955,1327,1718,22.93,6.19,4.78,3.44
17-03-2021,TOMAR,10,1,27,"[0,120]",Baixo a Moderado,,,,10,Lisboa e Vale do Tejo,SANTARÉM,1418,35120.44,36748,2403,2189,1868,1853,1822,3675,5543,7732,10135,104.64,28.86,22.02,15.78
17-03-2021,TONDELA,4,0,15,"[0,120]",Baixo a Moderado,,,,4,Centro,VISEU,1821,37121.73,26357,1768,1722,1518,1475,1417,2892,4410,6132,7900,71.0,21.28,16.52,11.88
17-03-2021,TORRE DE MONCORVO,0,0,0,"[0,120]",Baixo a Moderado,,,,0,Norte,BRAGANÇA,0409,53155.67,7695,556,478,488,551,719,1270,1758,2236,2792,14.48,5.25,4.21,3.31
17-03-2021,TORRES NOVAS,16,1,46,"[0,120]",Baixo a Moderado,,,,16,Lisboa e Vale do Tejo,SANTARÉM,1419,26999.68,34933,2324,1979,1738,1406,1475,2881,4619,6598,8922,129.38,33.04,24.44,17.11
17-03-2021,TORRES VEDRAS,126,9,160,"[120,240]",Moderado,,,,126,Lisboa e Vale do Tejo,LISBOA,1113,40714.89,78530,4513,3945,3447,2628,2104,4732,8179,12124,16637,192.88,40.86,29.78,20.09
17-03-2021,TRANCOSO,9,1,101,"[0,120]",Baixo a Moderado,,,,9,Centro,GUARDA,0913,36152.47,8875,581,557,542,586,496,1082,1624,2181,2762,24.55,7.64,6.03,4.49
17-03-2021,TROFA,21,2,55,"[0,120]",Baixo a Moderado,,,,21,Norte,PORTO,1318,7201.76,38418,2336,1894,1231,939,684,1623,2854,4748,7084,533.44,98.36,65.93,39.63
17-03-2021,VAGOS,6,0,26,"[0,120]",Baixo a Moderado,,,,6,Centro,AVEIRO,0118,16491.5,22740,1320,1205,922,784,724,1508,2430,3635,4955,137.89,30.04,22.04,14.73
17-03-2021,VALE DE CAMBRA,17,1,80,"[0,120]",Baixo a Moderado,,,,17,Norte,AVEIRO,0119,14733.47,21327,1491,1363,1005,831,798,1629,2634,3997,5488,144.76,37.25,27.13,17.88
17-03-2021,VALENÇA,2,0,15,"[0,120]",Baixo a Moderado,,,,2,Norte,VIANA DO CASTELO,1608,11712.86,13290,867,791,582,582,503,1085,1667,2458,3325,113.46,28.39,20.99,14.23
17-03-2021,VALONGO,50,4,51,"[0,120]",Baixo a Moderado,,,,50,Norte,PORTO,1315,7512.45,97444,5629,4696,3207,2462,1829,4291,7498,12194,17823,1297.18,237.26,162.33,99.81
17-03-2021,VALPAÇOS,3,0,20,"[0,120]",Baixo a Moderado,,,,3,Norte,VILA REAL,1712,54873.93,14818,1217,1118,999,928,997,1925,2924,4042,5259,27.0,9.58,7.37,5.33
17-03-2021,VELAS,0,0,0,"[0,120]",Baixo a Moderado,,,,0,Açores,AÇORES,4502,11738.38,5093,278,208,166,153,113,266,432,640,918,43.39,7.82,5.45,3.68
17-03-2021,VENDAS NOVAS,5,0,44,"[0,120]",Baixo a Moderado,,,,5,Alentejo,ÉVORA,0712,22238.88,11255,677,768,655,501,532,1033,1688,2456,3133,50.61,14.09,11.04,7.59
17-03-2021,VIANA DO ALENTEJO,1,0,19,"[0,120]",Baixo a Moderado,,,,1,Alentejo,ÉVORA,0713,39367.29,5145,245,208,235,210,214,424,659,867,1112,13.07,2.82,2.2,1.67
17-03-2021,VIANA DO CASTELO,140,10,166,"[120,240]",Moderado,,,,140,Norte,VIANA DO CASTELO,1609,31902.01,84417,5470,4433,3591,3061,2982,6043,9634,14067,19537,264.61,61.24,44.09,30.2
17-03-2021,VIDIGUEIRA,14,1,254,"[240,480]",Elevado,,,,14,Alentejo,BEJA,0214,31661.09,5510,300,248,215,233,275,508,723,971,1271,17.4,4.01,3.07,2.28
17-03-2021,VIEIRA DO MINHO,4,0,34,"[0,120]",Baixo a Moderado,,,,4,Norte,BRAGA,0311,21644.35,11842,703,594,525,548,482,1030,1555,2149,2852,54.71,13.18,9.93,7.18
17-03-2021,VILA DE REI,1,0,30,"[0,120]",Baixo a Moderado,,,,1,Centro,CASTELO BRANCO,0510,19154.6,3323,169,128,172,247,302,549,721,849,1018,17.35,5.31,4.43,3.76
17-03-2021,VILA DO BISPO,1,0,19,"[0,120]",Baixo a Moderado,,,,1,Algarve,FARO,0815,17906.06,5154,302,302,314,232,233,465,779,1081,1383,28.78,7.72,6.04,4.35
17-03-2021,VILA DO CONDE,44,3,55,"[0,120]",Baixo a Moderado,,,,44,Norte,PORTO,1316,14902.77,79899,4726,3875,2819,2070,1743,3813,6632,10507,15233,536.13,102.21,70.5,44.5
17-03-2021,VILA DO PORTO,1,0,18,"[0,120]",Baixo a Moderado,,,,1,Açores,AÇORES,4101,9688.74,5616,274,212,135,96,123,219,354,566,840,57.96,8.67,5.84,3.65
17-03-2021,VILA FLOR,8,1,132,"[120,240]",Moderado,,,,8,Norte,BRAGANÇA,0410,26581.14,6044,429,362,422,294,331,625,1047,1409,1838,22.74,6.91,5.3,3.94
17-03-2021,VILA FRANCA DE XIRA,126,9,89,"[0,120]",Baixo a Moderado,,,,126,Lisboa e Vale do Tejo,LISBOA,1114,31819.39,141957,8501,6852,4869,3425,2472,5897,10766,17618,26119,446.14,82.09,55.37,33.84
17-03-2021,VILA FRANCA DO CAMPO,0,0,0,"[0,120]",Baixo a Moderado,,,,0,Açores,AÇORES,4206,7796.82,11051,450,344,248,217,154,371,619,963,1413,141.73,18.12,12.35,7.94
17-03-2021,VILA NOVA DA BARQUINHA,5,0,67,"[0,120]",Baixo a Moderado,,,,5,Lisboa e Vale do Tejo,SANTARÉM,1420,4952.97,7461,415,406,392,364,338,702,1094,1500,1915,150.64,38.66,30.28,22.09
17-03-2021,VILA NOVA DE CERVEIRA,10,1,112,"[0,120]",Baixo a Moderado,,,,10,Norte,VIANA DO CASTELO,1610,10846.66,8910,531,444,410,384,334,718,1128,1572,2103,82.14,19.39,14.49,10.4
17-03-2021,VILA NOVA DE FAMALICÃO,124,9,94,"[0,120]",Baixo a Moderado,,,,124,Norte,BRAGA,0312,20159.26,131676,7817,6164,4202,3282,2749,6031,10233,16397,24214,653.19,120.12,81.34,50.76
17-03-2021,VILA NOVA DE FOZ CÔA,1,0,15,"[0,120]",Baixo a Moderado,,,,1,Centro,GUARDA,0914,39815.18,6503,442,385,390,398,429,827,1217,1602,2044,16.33,5.13,4.02,3.06
17-03-2021,VILA NOVA DE GAIA,204,15,68,"[0,120]",Baixo a Moderado,,,,204,Norte,PORTO,1317,16846.43,300472,18349,15568,10972,8224,6281,14505,25477,41045,59394,1783.64,352.57,243.65,151.23
17-03-2021,VILA NOVA DE PAIVA,1,0,21,"[0,120]",Baixo a Moderado,,,,1,Centro,VISEU,1822,17553.28,4687,289,272,233,217,241,458,691,963,1252,26.7,7.13,5.49,3.94
17-03-2021,VILA NOVA DE POIARES,0,0,0,"[0,120]",Baixo a Moderado,,,,0,Centro,COIMBRA,0617,8445.3,6939,380,284,262,235,182,417,679,963,1343,82.17,15.9,11.4,8.04
17-03-2021,VILA POUCA DE AGUIAR,8,1,67,"[0,120]",Baixo a Moderado,,,,8,Norte,VILA REAL,1713,43706.62,11961,860,817,733,601,627,1228,1961,2778,3638,27.37,8.32,6.36,4.49
17-03-2021,VILA REAL,13,1,26,"[0,120]",Baixo a Moderado,,,,13,Norte,VILA REAL,1714,37880.28,49962,3025,2498,2065,1579,1466,3045,5110,7608,10633,131.9,28.07,20.08,13.49
17-03-2021,VILA REAL DE SANTO ANTÓNIO,4,0,21,"[0,120]",Baixo a Moderado,,,,4,Algarve,FARO,0816,6125.0,18749,1172,1069,811,569,586,1155,1966,3035,4207,306.11,68.69,49.55,32.1
17-03-2021,VILA VELHA DE RÓDÃO,0,0,0,"[0,120]",Baixo a Moderado,,,,0,Centro,CASTELO BRANCO,0511,32991.16,3144,209,229,180,283,306,589,769,998,1207,9.53,3.66,3.03,2.33
17-03-2021,VILA VERDE,27,2,58,"[0,120]",Baixo a Moderado,,,,27,Norte,BRAGA,0313,22866.52,46911,2365,2063,1667,1494,1437,2931,4598,6661,9026,205.15,39.47,29.13,20.11
17-03-2021,VILA VIÇOSA,4,0,52,"[0,120]",Baixo a Moderado,,,,4,Alentejo,ÉVORA,0714,19485.89,7656,487,379,342,345,324,669,1011,1390,1877,39.29,9.63,7.13,5.19
17-03-2021,VIMIOSO,1,0,25,"[0,120]",Baixo a Moderado,,,,1,Norte,BRAGANÇA,0411,48158.51,4023,274,230,261,293,335,628,889,1119,1393,8.35,2.89,2.32,1.85
17-03-2021,VINHAIS,0,0,0,"[0,120]",Baixo a Moderado,,,,0,Norte,BRAGANÇA,0412,69475.09,7746,599,577,636,641,815,1456,2092,2669,3268,11.15,4.7,3.84,3.01
17-03-2021,VISEU,56,4,58,"[0,120]",Baixo a Moderado,,,,56,Centro,VISEU,1823,50710.14,97249,5769,5038,4140,3158,2710,5868,10008,15046,20815,191.77,41.05,29.67,19.74
17-03-2021,VIZELA,5,0,21,"[0,120]",Baixo a Moderado,,,,5,Norte,BRAGA,0314,2469.83,23897,1258,928,655,509,371,880,1535,2463,3721,967.49,150.65,99.72,62.15
17-03-2021,VOUZELA,6,0,62,"[0,120]",Baixo a Moderado,,,,6,Centro,VISEU,1824,19369.46,9619,626,605,554,532,507,1039,1593,2198,2824,49.66,14.58,11.35,8.22
24-03-2021,ABRANTES,8,1,23,"[0,120]",Baixo a Moderado,,,,8,Lisboa e Vale do Tejo,SANTARÉM,1401,71469.08,35130,2473,2213,1730,1748,2021,3769,5499,7712,10185,49.15,14.25,10.79,7.69
24-03-2021,ÁGUEDA,12,1,26,"[0,120]",Baixo a Moderado,,,,12,Centro,AVEIRO,0101,33527.44,46075,3237,2713,2090,1635,1496,3131,5221,7934,11171,137.43,33.32,23.66,15.57
24-03-2021,AGUIAR DA BEIRA,0,0,0,"[0,120]",Baixo a Moderado,,,,0,Centro,GUARDA,0901,20676.57,4652,304,281,235,239,148,387,622,903,1207,22.5,5.84,4.37,3.01
24-03-2021,ALANDROAL,1,0,20,"[0,120]",Baixo a Moderado,,,,1,Alentejo,ÉVORA,0701,54267.81,4992,307,256,296,299,377,676,972,1228,1535,9.2,2.83,2.26,1.79
24-03-2021,ALBERGARIA-A-VELHA,11,1,46,"[0,120]",Baixo a Moderado,,,,11,Centro,AVEIRO,0102,15882.5,24144,1550,1298,996,687,680,1367,2363,3661,5211,152.02,32.81,23.05,14.88
24-03-2021,ALBUFEIRA,45,3,108,"[0,120]",Baixo a Moderado,,,,45,Algarve,FARO,0801,14066.42,41528,2067,1717,1425,985,858,1843,3268,4985,7052,295.24,50.14,35.44,23.23
24-03-2021,ALCÁCER DO SAL,7,0,60,"[0,120]",Baixo a Moderado,,,,7,Alentejo,SETÚBAL,1501,149987.3,11659,884,814,623,623,602,1225,1848,2662,3546,7.77,2.36,1.77,1.23
24-03-2021,ALCANENA,4,0,31,"[0,120]",Baixo a Moderado,,,,4,Lisboa e Vale do Tejo,SANTARÉM,1402,12732.86,12809,891,744,628,536,588,1124,1752,2496,3387,100.6,26.6,19.6,13.76
24-03-2021,ALCOBAÇA,21,1,39,"[0,120]",Baixo a Moderado,,,,21,Lisboa e Vale do Tejo,LEIRIA,1001,40814.09,53555,3420,2927,2466,2059,1676,3735,6201,9128,12548,131.22,30.74,22.36,15.19
24-03-2021,ALCOCHETE,19,1,96,"[0,120]",Baixo a Moderado,,,,19,Lisboa e Vale do Tejo,SETÚBAL,1502,12836.48,19787,857,834,691,476,447,923,1614,2448,3305,154.15,25.75,19.07,12.57
24-03-2021,ALCOUTIM,9,1,417,"[240,480]",Elevado,,,,9,Algarve,FARO,0802,57536.33,2159,191,188,163,190,267,457,620,808,999,3.75,1.74,1.4,1.08
24-03-2021,ALENQUER,21,2,48,"[0,120]",Baixo a Moderado,,,,21,Lisboa e Vale do Tejo,LISBOA,1101,30421.92,44052,2298,2062,1629,1330,1155,2485,4114,6176,8474,144.8,27.85,20.3,13.52
24-03-2021,ALFÂNDEGA DA FÉ,1,0,22,"[0,120]",Baixo a Moderado,,,,1,Norte,BRAGANÇA,0401,32194.64,4550,325,277,301,274,325,599,900,1177,1502,14.13,4.67,3.66,2.8
24-03-2021,ALIJÓ,0,0,0,"[0,120]",Baixo a Moderado,,,,0,Norte,VILA REAL,1701,29759.89,10625,766,687,635,542,666,1208,1843,2530,3296,35.7,11.08,8.5,6.19
24-03-2021,ALJEZUR,2,0,36,"[0,120]",Baixo a Moderado,,,,2,Algarve,FARO,0803,32349.95,5594,316,336,335,320,410,730,1065,1401,1717,17.29,5.31,4.33,3.29
24-03-2021,ALJUSTREL,2,0,24,"[0,120]",Baixo a Moderado,,,,2,Alentejo,BEJA,0201,45847.41,8247,635,521,443,347,358,705,1148,1669,2304,17.99,5.03,3.64,2.5
24-03-2021,ALMADA,161,11,95,"[0,120]",Baixo a Moderado,,,,161,Lisboa e Vale do Tejo,SETÚBAL,1503,7000.89,169039,10469,9777,7876,6144,5111,11255,19131,28908,39377,2414.5,562.45,412.91,273.26
24-03-2021,ALMEIDA,1,0,17,"[0,120]",Baixo a Moderado,,,,1,Centro,GUARDA,0902,51798.46,5830,441,419,396,458,393,851,1247,1666,2107,11.26,4.07,3.22,2.41
24-03-2021,ALMEIRIM,17,1,75,"[0,120]",Baixo a Moderado,,,,17,Lisboa e Vale do Tejo,SANTARÉM,1403,22212.05,22546,1342,1353,1106,866,843,1709,2815,4168,5510,101.5,24.81,18.76,12.67
24-03-2021,ALMODÔVAR,0,0,0,"[0,120]",Baixo a Moderado,,,,0,Alentejo,BEJA,0202,77788.03,6725,414,443,396,373,328,701,1097,1540,1954,8.65,2.51,1.98,1.41
24-03-2021,ALPIARÇA,4,0,57,"[0,120]",Baixo a Moderado,,,,4,Lisboa e Vale do Tejo,SANTARÉM,1404,9536.33,7059,515,486,363,333,274,607,970,1456,1971,74.02,20.67,15.27,10.17
24-03-2021,ALTER DO CHÃO,0,0,0,"[0,120]",Baixo a Moderado,,,,0,Alentejo,PORTALEGRE,1201,36206.62,3165,201,163,136,208,187,395,531,694,895,8.74,2.47,1.92,1.47
24-03-2021,ALVAIÁZERE,1,0,15,"[0,120]",Baixo a Moderado,,,,1,Centro,LEIRIA,1002,16047.76,6597,419,389,346,406,539,945,1291,1680,2099,41.11,13.08,10.47,8.04
24-03-2021,ALVITO,0,0,0,"[0,120]",Baixo a Moderado,,,,0,Alentejo,BEJA,0203,26485.32,2477,145,110,105,111,89,200,305,415,560,9.35,2.11,1.57,1.15
24-03-2021,AMADORA,208,15,113,"[0,120]",Baixo a Moderado,,,,208,Lisboa e Vale do Tejo,LISBOA,1115,2378.47,184106,11186,10936,8780,6460,5890,12350,21130,32066,43252,7742.05,1818.84,1348.44,888.56
24-03-2021,AMARANTE,20,1,38,"[0,120]",Baixo a Moderado,,,,20,Norte,PORTO,1301,30133.15,53193,3086,2413,1812,1643,1311,2954,4766,7179,10265,176.53,34.07,23.82,15.82
24-03-2021,AMARES,3,0,17,"[0,120]",Baixo a Moderado,,,,3,Norte,BRAGA,0301,8195.41,18129,1001,829,622,489,524,1013,1635,2464,3465,221.22,42.28,30.07,19.95
24-03-2021,ANADIA,21,1,77,"[0,120]",Baixo a Moderado,,,,21,Centro,AVEIRO,0103,21663.48,27258,1931,1698,1376,1208,1262,2470,3846,5544,7475,125.83,34.51,25.59,17.75
24-03-2021,ANGRA DO HEROÍSMO,0,0,0,"[0,120]",Baixo a Moderado,,,,0,Açores,AÇORES,4301,23899.66,33807,2006,1473,1122,768,635,1403,2525,3998,6004,141.45,25.12,16.73,10.56
24-03-2021,ANSIÃO,0,0,0,"[0,120]",Baixo a Moderado,,,,0,Centro,LEIRIA,1003,17609.42,12039,727,709,646,694,530,1224,1870,2579,3306,68.37,18.77,14.65,10.62
24-03-2021,ARCOS DE VALDEVEZ,4,0,19,"[0,120]",Baixo a Moderado,,,,4,Norte,VIANA DO CASTELO,1601,44759.64,20926,1329,1338,1282,1343,1515,2858,4140,5478,6807,46.75,15.21,12.24,9.25
24-03-2021,ARGANIL,9,1,82,"[0,120]",Baixo a Moderado,,,,9,Centro,COIMBRA,0601,33283.93,11014,672,648,612,559,596,1155,1767,2415,3087,33.09,9.27,7.26,5.31
24-03-2021,ARMAMAR,9,1,156,"[120,240]",Moderado,,,,9,Norte,VISEU,1801,11723.73,5769,357,305,309,285,310,595,904,1209,1566,49.21,13.36,10.31,7.71
24-03-2021,AROUCA,5,0,24,"[0,120]",Baixo a Moderado,,,,5,Norte,AVEIRO,0104,32910.52,20720,1306,1047,753,683,683,1366,2119,3166,4472,62.96,13.59,9.62,6.44
24-03-2021,ARRAIOLOS,1,0,14,"[0,120]",Baixo a Moderado,,,,1,Alentejo,ÉVORA,0702,68374.55,6928,435,384,283,367,480,847,1130,1514,1949,10.13,2.85,2.21,1.65
24-03-2021,ARRONCHES,3,0,106,"[0,120]",Baixo a Moderado,,,,3,Alentejo,PORTALEGRE,1202,31464.72,2820,155,142,162,187,179,366,528,670,825,8.96,2.62,2.13,1.68
24-03-2021,ARRUDA DOS VINHOS,7,0,45,"[0,120]",Baixo a Moderado,,,,7,Lisboa e Vale do Tejo,LISBOA,1102,7795.93,15412,738,738,562,509,438,947,1509,2247,2985,197.69,38.29,28.82,19.36
24-03-2021,AVEIRO,30,2,38,"[0,120]",Baixo a Moderado,,,,30,Centro,AVEIRO,0105,19757.57,78734,4520,4004,3050,2250,2103,4353,7403,11407,15927,398.49,80.61,57.73,37.47
24-03-2021,AVIS,0,0,0,"[0,120]",Baixo a Moderado,,,,0,Alentejo,PORTALEGRE,1203,60596.51,4247,315,225,206,251,273,524,730,955,1270,7.01,2.1,1.58,1.2
24-03-2021,AZAMBUJA,9,1,40,"[0,120]",Baixo a Moderado,,,,9,Lisboa e Vale do Tejo,LISBOA,1103,26265.65,22716,1322,1171,1070,798,618,1416,2486,3657,4979,86.48,18.96,13.92,9.46
24-03-2021,BAIÃO,7,0,37,"[0,120]",Baixo a Moderado,,,,7,Norte,PORTO,1302,17452.83,18748,1070,862,714,686,725,1411,2125,2987,4057,107.42,23.25,17.11,12.18
24-03-2021,BARCELOS,76,5,65,"[0,120]",Baixo a Moderado,,,,76,Norte,BRAGA,0302,37890.14,116187,6721,5325,3619,2991,2562,5553,9172,14497,21218,306.64,56.0,38.26,24.21
24-03-2021,BARRANCOS,0,0,0,"[0,120]",Baixo a Moderado,,,,0,Alentejo,BEJA,0204,16841.73,1634,90,65,65,94,61,155,220,285,375,9.7,2.23,1.69,1.31
24-03-2021,BARREIRO,41,3,55,"[0,120]",Baixo a Moderado,,,,41,Lisboa e Vale do Tejo,SETÚBAL,1504,3639.07,75147,5194,5565,4459,3105,1767,4872,9331,14896,20090,2065.05,552.07,409.34,256.42
24-03-2021,BATALHA,8,1,50,"[0,120]",Baixo a Moderado,,,,8,Centro,LEIRIA,1004,10341.6,15963,873,762,649,529,549,1078,1727,2489,3362,154.35,32.51,24.07,16.7
24-03-2021,BEJA,27,2,80,"[0,120]",Baixo a Moderado,,,,27,Alentejo,BEJA,0205,114647.55,33579,2005,1840,1386,1272,1039,2311,3697,5537,7542,29.29,6.58,4.83,3.22
24-03-2021,BELMONTE,19,1,297,"[240,480]",Elevado,,,,19,Centro,CASTELO BRANCO,0501,11875.91,6398,444,321,325,310,355,665,990,1311,1755,53.87,14.78,11.04,8.34
24-03-2021,BENAVENTE,24,2,78,"[0,120]",Baixo a Moderado,,,,24,Lisboa e Vale do Tejo,SANTARÉM,1405,52138.39,30602,1468,1376,1141,876,643,1519,2660,4036,5504,58.69,10.56,7.74,5.1
24-03-2021,BOMBARRAL,0,0,0,"[0,120]",Baixo a Moderado,,,,0,Lisboa e Vale do Tejo,LEIRIA,1005,9128.55,12558,875,714,561,491,429,920,1481,2195,3070,137.56,33.63,24.04,16.22
24-03-2021,BORBA,6,0,89,"[0,120]",Baixo a Moderado,,,,6,Alentejo,ÉVORA,0703,14518.65,6736,430,375,279,436,392,828,1107,1482,1912,46.39,13.17,10.21,7.62
24-03-2021,BOTICAS,2,0,40,"[0,120]",Baixo a Moderado,,,,2,Norte,VILA REAL,1702,32195.66,4998,347,306,311,305,380,685,996,1302,1649,15.52,5.12,4.04,3.09
24-03-2021,BRAGA,46,3,25,"[0,120]",Baixo a Moderado,,,,46,Norte,BRAGA,0303,18339.95,182679,10029,7963,5241,4320,3671,7991,13232,21195,31224,996.07,170.25,115.57,72.15
24-03-2021,BRAGANÇA,4,0,12,"[0,120]",Baixo a Moderado,,,,4,Norte,BRAGANÇA,0402,117357.27,33607,2402,1855,1652,1393,1163,2556,4208,6063,8465,28.64,7.21,5.17,3.59
24-03-2021,CABECEIRAS DE BASTO,1,0,6,"[0,120]",Baixo a Moderado,,,,1,Norte,BRAGA,0304,24182.16,15628,774,594,544,575,574,1149,1693,2287,3061,64.63,12.66,9.46,7.0
24-03-2021,CADAVAL,5,0,37,"[0,120]",Baixo a Moderado,,,,5,Lisboa e Vale do Tejo,LISBOA,1104,17489.3,13673,813,796,756,621,625,1246,2002,2798,3611,78.18,20.65,16.0,11.45
24-03-2021,CALDAS DA RAINHA,8,1,15,"[0,120]",Baixo a Moderado,,,,8,Lisboa e Vale do Tejo,LEIRIA,1006,25569.47,51912,3035,2684,2186,1899,1705,3604,5790,8474,11509,203.03,45.01,33.14,22.64
24-03-2021,CALHETA,0,0,0,"[0,120]",Baixo a Moderado,,,,0,Madeira,MADEIRA,3101,11150.43,10867,576,497,507,399,415,814,1321,1818,2394,97.46,21.47,16.3,11.85
24-03-2021,CALHETA (AÇORES),0,0,0,"[0,120]",Baixo a Moderado,,,,0,Açores,AÇORES,4501,12626.4,3184,215,159,141,139,122,261,402,561,776,25.22,6.15,4.44,3.18
24-03-2021,CÂMARA DE LOBOS,58,4,172,"[120,240]",Moderado,,,,58,Madeira,MADEIRA,3102,5216.67,33675,1396,1059,834,545,381,926,1760,2819,4215,645.49,80.79,54.03,33.74
24-03-2021,CAMINHA,7,0,44,"[0,120]",Baixo a Moderado,,,,7,Norte,VIANA DO CASTELO,1602,13652.14,15877,1046,944,818,646,656,1302,2120,3064,4110,116.3,30.11,22.44,15.53
24-03-2021,CAMPO MAIOR,6,0,76,"[0,120]",Baixo a Moderado,,,,6,Alentejo,PORTALEGRE,1204,24720.16,7874,471,364,351,279,327,606,957,1321,1792,31.85,7.25,5.34,3.87
24-03-2021,CANTANHEDE,19,1,54,"[0,120]",Baixo a Moderado,,,,19,Centro,COIMBRA,0602,39088.02,35011,2346,2096,1880,1709,1451,3160,5040,7136,9482,89.57,24.26,18.26,12.89
24-03-2021,CARRAZEDA DE ANSIÃES,3,0,53,"[0,120]",Baixo a Moderado,,,,3,Norte,BRAGANÇA,0403,27924.09,5666,424,389,391,312,465,777,1168,1557,1981,20.29,7.09,5.58,4.18
24-03-2021,CARREGAL DO SAL,9,1,97,"[0,120]",Baixo a Moderado,,,,9,Centro,VISEU,1802,11689.21,9271,587,562,486,462,376,838,1324,1886,2473,79.31,21.16,16.13,11.33
24-03-2021,CARTAXO,7,0,29,"[0,120]",Baixo a Moderado,,,,7,Lisboa e Vale do Tejo,SANTARÉM,1406,15817.28,23843,1415,1376,1142,861,632,1493,2635,4011,5426,150.74,34.3,25.36,16.66
24-03-2021,CASCAIS,128,9,60,"[0,120]",Baixo a Moderado,,,,128,Lisboa e Vale do Tejo,LISBOA,1105,9740.17,213608,12151,11444,8680,6469,5248,11717,20397,31841,43992,2193.1,451.66,326.91,209.41
24-03-2021,CASTANHEIRA DE PÊRA,1,0,38,"[0,120]",Baixo a Moderado,,,,1,Centro,LEIRIA,1007,6677.45,2614,233,195,157,190,187,377,534,729,962,39.15,14.41,10.92,8.0
24-03-2021,CASTELO BRANCO,9,1,17,"[0,120]",Baixo a Moderado,,,,9,Centro,CASTELO BRANCO,0502,143819.15,51987,3528,3042,2499,2229,2225,4454,6953,9995,13523,36.15,9.4,6.95,4.83
24-03-2021,CASTELO DE PAIVA,18,1,116,"[0,120]",Baixo a Moderado,,,,18,Norte,AVEIRO,0106,11500.53,15454,881,697,545,420,431,851,1396,2093,2974,134.37,25.86,18.2,12.14
24-03-2021,CASTELO DE VIDE,5,0,171,"[120,240]",Moderado,,,,5,Alentejo,PORTALEGRE,1205,26491.24,2919,204,173,179,147,170,317,496,669,873,11.02,3.3,2.53,1.87
24-03-2021,CASTRO DAIRE,12,1,87,"[0,120]",Baixo a Moderado,,,,12,Centro,VISEU,1803,37904.13,13823,942,857,765,732,773,1505,2270,3127,4069,36.47,10.74,8.25,5.99
24-03-2021,CASTRO MARIM,5,0,80,"[0,120]",Baixo a Moderado,,,,5,Algarve,FARO,0804,30084.37,6237,370,345,334,322,344,666,1000,1345,1715,20.73,5.7,4.47,3.32
24-03-2021,CASTRO VERDE,3,0,43,"[0,120]",Baixo a Moderado,,,,3,Alentejo,BEJA,0206,56944.23,6949,437,347,303,275,227,502,805,1152,1589,12.2,2.79,2.02,1.41
24-03-2021,CELORICO DA BEIRA,5,0,72,"[0,120]",Baixo a Moderado,,,,5,Centro,GUARDA,0903,24721.63,6928,430,416,363,369,535,904,1267,1683,2113,28.02,8.55,6.81,5.12
24-03-2021,CELORICO DE BASTO,10,1,53,"[0,120]",Baixo a Moderado,,,,10,Norte,BRAGA,0305,18107.02,19040,1001,802,668,728,729,1457,2125,2927,3928,105.15,21.69,16.17,11.74
24-03-2021,CHAMUSCA,1,0,11,"[0,120]",Baixo a Moderado,,,,1,Lisboa e Vale do Tejo,SANTARÉM,1407,74600.54,9197,629,583,553,465,579,1044,1597,2180,2809,12.33,3.77,2.92,2.14
24-03-2021,CHAVES,7,1,18,"[0,120]",Baixo a Moderado,,,,7,Norte,VILA REAL,1703,59122.95,39343,2676,2429,1991,1886,1918,3804,5795,8224,10900,66.54,18.44,13.91,9.8
24-03-2021,CINFÃES,36,3,197,"[120,240]",Moderado,,,,36,Norte,VISEU,1804,23928.76,18244,1067,902,779,734,758,1492,2271,3173,4240,76.24,17.72,13.26,9.49
24-03-2021,COIMBRA,117,8,87,"[0,120]",Baixo a Moderado,,,,117,Centro,COIMBRA,0603,31939.94,134166,9489,8734,6353,5139,5074,10213,16566,25300,34789,420.06,108.92,79.21,51.87
24-03-2021,CONDEIXA-A-NOVA,10,1,56,"[0,120]",Baixo a Moderado,,,,10,Centro,COIMBRA,0604,13867.47,17733,871,809,717,583,490,1073,1790,2599,3470,127.88,25.02,18.74,12.91
24-03-2021,CONSTÂNCIA,0,0,0,"[0,120]",Baixo a Moderado,,,,0,Lisboa e Vale do Tejo,SANTARÉM,1408,8036.58,4030,211,183,187,148,155,303,490,673,884,50.14,11.0,8.37,6.1
24-03-2021,CORUCHE,7,0,40,"[0,120]",Baixo a Moderado,,,,7,Lisboa e Vale do Tejo,SANTARÉM,1409,111572.03,17471,1294,1090,1095,1096,1019,2115,3210,4300,5594,15.66,5.01,3.85,2.88
24-03-2021,CORVO,0,0,0,"[0,120]",Baixo a Moderado,,,,0,Açores,AÇORES,4901,1711.45,464,22,21,11,13,19,32,43,64,86,27.12,5.03,3.74,2.51
24-03-2021,COVILHÃ,34,2,73,"[0,120]",Baixo a Moderado,,,,34,Centro,CASTELO BRANCO,0503,55560.06,46787,3533,2998,2365,2111,2193,4304,6669,9667,13200,84.21,23.76,17.4,12.0
24-03-2021,CRATO,1,0,32,"[0,120]",Baixo a Moderado,,,,1,Alentejo,PORTALEGRE,1206,39806.88,3129,229,258,163,182,228,410,573,831,1060,7.86,2.66,2.09,1.44
24-03-2021,CUBA,6,0,131,"[120,240]",Moderado,,,,6,Alentejo,BEJA,0207,17208.72,4595,255,233,206,190,143,333,539,772,1027,26.7,5.97,4.49,3.13
24-03-2021,ELVAS,5,0,24,"[0,120]",Baixo a Moderado,,,,5,Alentejo,PORTALEGRE,1207,63128.86,20528,1057,1145,902,852,810,1662,2564,3709,4766,32.52,7.55,5.88,4.06
24-03-2021,ENTRONCAMENTO,10,1,46,"[0,120]",Baixo a Moderado,,,,10,Lisboa e Vale do Tejo,SANTARÉM,1410,1372.81,21558,1066,930,868,695,592,1287,2155,3085,4151,1570.14,302.33,224.69,156.96
24-03-2021,ESPINHO,26,2,88,"[0,120]",Baixo a Moderado,,,,26,Norte,AVEIRO,0107,2105.68,29516,2205,1993,1430,1177,960,2137,3567,5560,7765,1401.52,368.71,264.01,169.37
24-03-2021,ESPOSENDE,10,1,29,"[0,120]",Baixo a Moderado,,,,10,Norte,BRAGA,0306,9540.98,34177,1831,1522,1095,894,723,1617,2712,4234,6065,358.21,63.57,44.38,28.42
24-03-2021,ESTARREJA,16,1,62,"[0,120]",Baixo a Moderado,,,,16,Centro,AVEIRO,0108,10817.33,26006,1503,1399,1106,953,728,1681,2787,4186,5689,240.42,52.59,38.7,25.76
24-03-2021,ESTREMOZ,7,1,55,"[0,120]",Baixo a Moderado,,,,7,Alentejo,ÉVORA,0704,51379.95,12728,789,613,697,786,877,1663,2360,2973,3762,24.77,7.32,5.79,4.59
24-03-2021,ÉVORA,8,1,15,"[0,120]",Baixo a Moderado,,,,8,Alentejo,ÉVORA,0705,130707.58,52428,3569,2852,2176,1966,1803,3769,5945,8797,12366,40.11,9.46,6.73,4.55
24-03-2021,FAFE,20,1,42,"[0,120]",Baixo a Moderado,,,,20,Norte,BRAGA,0307,21908.11,48060,3044,2455,1679,1403,1208,2611,4290,6745,9789,219.37,44.68,30.79,19.58
24-03-2021,FARO,36,3,59,"[0,120]",Baixo a Moderado,,,,36,Algarve,FARO,0805,20256.79,61015,3847,3364,2604,2055,1601,3656,6260,9624,13471,301.2,66.5,47.51,30.9
24-03-2021,FELGUEIRAS,34,2,60,"[0,120]",Baixo a Moderado,,,,34,Norte,PORTO,1303,11573.75,56422,2951,2302,1601,1316,973,2289,3890,6192,9143,487.49,79.0,53.5,33.61
24-03-2021,FERREIRA DO ALENTEJO,5,0,64,"[0,120]",Baixo a Moderado,,,,5,Alentejo,BEJA,0208,64820.68,7845,515,414,372,343,345,688,1060,1474,1989,12.1,3.07,2.27,1.64
24-03-2021,FERREIRA DO ZÊZERE,0,0,0,"[0,120]",Baixo a Moderado,,,,0,Lisboa e Vale do Tejo,SANTARÉM,1411,19038.03,7959,470,370,416,465,456,921,1337,1707,2177,41.81,11.44,8.97,7.02
24-03-2021,FIGUEIRA DA FOZ,86,6,146,"[120,240]",Moderado,,,,86,Centro,COIMBRA,0605,37905.26,58747,4032,3597,2887,2495,2043,4538,7425,11022,15054,154.98,39.72,29.08,19.59
24-03-2021,FIGUEIRA DE CASTELO RODRIGO,2,0,36,"[0,120]",Baixo a Moderado,,,,2,Centro,GUARDA,0904,50857.46,5584,347,352,290,352,391,743,1033,1385,1732,10.98,3.41,2.72,2.03
24-03-2021,FIGUEIRÓ DOS VINHOS,15,1,269,"[240,480]",Elevado,,,,15,Centro,LEIRIA,1008,17344.0,5568,402,386,322,309,351,660,982,1368,1770,32.1,10.21,7.89,5.66
24-03-2021,FORNOS DE ALGODRES,4,0,88,"[0,120]",Baixo a Moderado,,,,4,Centro,GUARDA,0905,13145.05,4528,261,218,247,256,232,488,735,953,1214,34.45,9.24,7.25,5.59
24-03-2021,FREIXO DE ESPADA À CINTA,2,0,61,"[0,120]",Baixo a Moderado,,,,2,Norte,BRAGANÇA,0404,24414.29,3298,211,177,231,196,189,385,616,793,1004,13.51,4.11,3.25,2.52
24-03-2021,FRONTEIRA,1,0,34,"[0,120]",Baixo a Moderado,,,,1,Alentejo,PORTALEGRE,1208,24859.58,2974,213,182,149,156,168,324,473,655,868,11.96,3.49,2.63,1.9
24-03-2021,FUNCHAL,180,13,173,"[120,240]",Moderado,,,,180,Madeira,MADEIRA,3103,7616.2,104024,6382,5086,3643,2821,1990,4811,8454,13540,19922,1365.86,261.58,177.78,111.0
24-03-2021,FUNDÃO,8,1,30,"[0,120]",Baixo a Moderado,,,,8,Centro,CASTELO BRANCO,0504,70019.79,26495,1781,1464,1432,1357,1643,3000,4432,5896,7677,37.84,10.96,8.42,6.33
24-03-2021,GAVIÃO,0,0,0,"[0,120]",Baixo a Moderado,,,,0,Alentejo,PORTALEGRE,1209,29459.45,3263,189,186,222,263,293,556,778,964,1153,11.08,3.91,3.27,2.64
24-03-2021,GÓIS,2,0,53,"[0,120]",Baixo a Moderado,,,,2,Centro,COIMBRA,0606,26330.19,3805,235,199,240,233,244,477,717,916,1151,14.45,4.37,3.48,2.72
24-03-2021,GOLEGÃ,12,1,225,"[120,240]",Moderado,,,,12,Lisboa e Vale do Tejo,SANTARÉM,1412,8431.67,5339,356,299,281,243,255,498,779,1078,1434,63.32,17.01,12.78,9.24
24-03-2021,GONDOMAR,116,8,70,"[0,120]",Baixo a Moderado,,,,116,Norte,PORTO,1304,13191.76,165985,10555,8755,6222,4450,3364,7814,14036,22791,33346,1258.22,252.77,172.76,106.4
24-03-2021,GOUVEIA,21,2,170,"[120,240]",Moderado,,,,21,Centro,GUARDA,0906,30061.17,12387,871,931,780,783,810,1593,2373,3304,4175,41.21,13.89,10.99,7.89
24-03-2021,GRÂNDOLA,12,1,82,"[0,120]",Baixo a Moderado,,,,12,Alentejo,SETÚBAL,1505,82593.66,14639,834,834,708,688,672,1360,2068,2902,3736,17.72,4.52,3.51,2.5
24-03-2021,GUARDA,17,1,44,"[0,120]",Baixo a Moderado,,,,17,Centro,GUARDA,0907,71209.58,38969,2477,2041,1686,1415,1474,2889,4575,6616,9093,54.72,12.77,9.29,6.42
24-03-2021,GUIMARÃES,43,3,28,"[0,120]",Baixo a Moderado,,,,43,Norte,BRAGA,0308,24099.96,152309,9394,7074,4809,3877,2948,6825,11634,18708,28102,631.99,116.61,77.63,48.27
24-03-2021,HORTA,0,0,0,"[0,120]",Baixo a Moderado,,,,0,Açores,AÇORES,4701,17305.53,14521,818,658,468,352,302,654,1122,1780,2598,83.91,15.01,10.29,6.48
24-03-2021,IDANHA-A-NOVA,0,0,0,"[0,120]",Baixo a Moderado,,,,0,Centro,CASTELO BRANCO,0505,141633.51,8043,518,490,519,672,974,1646,2165,2655,3173,5.68,2.24,1.87,1.53
24-03-2021,ÍLHAVO,18,1,47,"[0,120]",Baixo a Moderado,,,,18,Centro,AVEIRO,0110,7347.55,38699,2227,1943,1444,1193,850,2043,3487,5430,7657,526.66,104.21,73.9,47.46
24-03-2021,LAGOA (FARO),29,2,127,"[120,240]",Moderado,,,,29,Algarve,FARO,0806,8825.45,22762,1314,1168,919,749,670,1419,2338,3506,4820,257.93,54.62,39.73,26.49
24-03-2021,LAGOA,20,1,136,"[120,240]",Moderado,,,,20,Açores,AÇORES,4201,4559.32,14721,536,458,349,238,235,473,822,1280,1816,322.9,39.83,28.08,18.03
24-03-2021,LAGOS,19,1,63,"[0,120]",Baixo a Moderado,,,,19,Algarve,FARO,0807,21299.27,30374,1744,1434,1247,1053,1029,2082,3329,4763,6507,142.61,30.55,22.36,15.63
24-03-2021,LAJES DAS FLORES,0,0,0,"[0,120]",Baixo a Moderado,,,,0,Açores,AÇORES,4801,7004.79,1463,88,53,62,46,54,100,162,215,303,20.89,4.33,3.07,2.31
24-03-2021,LAJES DO PICO,1,0,22,"[0,120]",Baixo a Moderado,,,,1,Açores,AÇORES,4601,15531.09,4490,304,231,223,159,162,321,544,775,1079,28.91,6.95,4.99,3.5
24-03-2021,LAMEGO,13,1,52,"[0,120]",Baixo a Moderado,,,,13,Norte,VISEU,1805,16542.11,24895,1639,1284,1124,898,783,1681,2805,4089,5728,150.5,34.63,24.72,16.96
24-03-2021,LEIRIA,66,5,53,"[0,120]",Baixo a Moderado,,,,66,Centro,LEIRIA,1009,56508.83,125267,7389,6366,5090,3902,3159,7061,12151,18517,25906,221.68,45.84,32.77,21.5
24-03-2021,LISBOA,453,32,89,"[0,120]",Baixo a Moderado,,,,453,Lisboa e Vale do Tejo,LISBOA,1106,10005.43,509515,33197,33340,27706,23037,26770,49807,77513,110853,144050,5092.6,1439.78,1107.98,774.74
24-03-2021,LOULÉ,31,2,45,"[0,120]",Baixo a Moderado,,,,31,Algarve,FARO,0808,76366.91,68697,3890,3350,2780,2358,2251,4609,7389,10739,14629,89.96,19.16,14.06,9.68
24-03-2021,LOURES,169,12,79,"[0,120]",Baixo a Moderado,,,,169,Lisboa e Vale do Tejo,LISBOA,1107,16723.99,213687,12746,12794,9644,6669,5033,11702,21346,34140,46886,1277.73,280.35,204.14,127.64
24-03-2021,LOURINHÃ,12,1,46,"[0,120]",Baixo a Moderado,,,,12,Lisboa e Vale do Tejo,LISBOA,1108,14717.2,25855,1584,1243,992,842,645,1487,2479,3722,5306,175.68,36.05,25.29,16.84
24-03-2021,LOUSÃ,16,1,93,"[0,120]",Baixo a Moderado,,,,16,Centro,COIMBRA,0607,13840.01,17158,946,866,658,528,450,978,1636,2502,3448,123.97,24.91,18.08,11.82
24-03-2021,LOUSADA,21,2,45,"[0,120]",Baixo a Moderado,,,,21,Norte,PORTO,1305,9608.01,46755,2289,1698,1176,853,621,1474,2650,4348,6637,486.63,69.08,45.25,27.58
24-03-2021,MAÇÃO,0,0,0,"[0,120]",Baixo a Moderado,,,,0,Lisboa e Vale do Tejo,SANTARÉM,1413,39997.98,6267,386,362,390,440,657,1097,1487,1849,2235,15.67,5.59,4.62,3.72
24-03-2021,MACEDO DE CAVALEIROS,3,0,21,"[0,120]",Baixo a Moderado,,,,3,Norte,BRAGANÇA,0405,69914.08,14516,1082,889,878,823,938,1761,2639,3528,4610,20.76,6.59,5.05,3.77
24-03-2021,MACHICO,120,9,601,"[480,960]",Muito Elevado,,,,120,Madeira,MADEIRA,3104,6825.1,19981,1197,860,662,455,331,786,1448,2308,3505,292.76,51.36,33.82,21.22
24-03-2021,MADALENA,1,0,17,"[0,120]",Baixo a Moderado,,,,1,Açores,AÇORES,4602,14712.33,5895,334,256,173,190,179,369,542,798,1132,40.07,7.69,5.42,3.68
24-03-2021,MAFRA,59,4,70,"[0,120]",Baixo a Moderado,,,,59,Lisboa e Vale do Tejo,LISBOA,1109,29165.5,84816,3613,3334,2839,2089,1899,3988,6827,10161,13774,290.81,47.23,34.84,23.41
24-03-2021,MAIA,64,5,46,"[0,120]",Baixo a Moderado,,,,64,Norte,PORTO,1306,8293.94,138971,7801,6617,4512,3339,2631,5970,10482,17099,24900,1675.56,300.22,206.16,126.38
24-03-2021,MANGUALDE,3,0,16,"[0,120]",Baixo a Moderado,,,,3,Centro,VISEU,1806,21925.56,18510,1198,1128,885,852,743,1595,2480,3608,4806,84.42,21.92,16.46,11.31
24-03-2021,MANTEIGAS,0,0,0,"[0,120]",Baixo a Moderado,,,,0,Centro,GUARDA,0908,12197.55,3007,258,197,159,167,146,313,472,669,927,24.65,7.6,5.48,3.87
24-03-2021,MARCO DE CANAVESES,5,0,10,"[0,120]",Baixo a Moderado,,,,5,Norte,PORTO,1307,20188.98,51496,2678,2060,1488,1265,1023,2288,3776,5836,8514,255.07,42.17,28.91,18.7
24-03-2021,MARINHA GRANDE,113,8,293,"[240,480]",Elevado,,,,113,Centro,LEIRIA,1010,18725.19,38508,2365,2302,1638,1359,1058,2417,4055,6357,8722,205.65,46.58,33.95,21.66
24-03-2021,MARVÃO,0,0,0,"[0,120]",Baixo a Moderado,,,,0,Alentejo,PORTALEGRE,1210,15489.9,3005,198,185,142,197,237,434,576,761,959,19.4,6.19,4.91,3.72
24-03-2021,MATOSINHOS,70,5,40,"[0,120]",Baixo a Moderado,,,,70,Norte,PORTO,1308,6241.97,175357,11850,9977,7023,5024,3884,8908,15931,25908,37758,2809.31,604.9,415.06,255.22
24-03-2021,MEALHADA,14,1,70,"[0,120]",Baixo a Moderado,,,,14,Centro,AVEIRO,0111,11065.66,19914,1163,1039,810,828,831,1659,2469,3508,4671,179.96,42.21,31.7,22.31
24-03-2021,MÊDA,0,0,0,"[0,120]",Baixo a Moderado,,,,0,Centro,GUARDA,0909,28604.92,4587,343,306,290,288,443,731,1021,1327,1670,16.04,5.84,4.64,3.57
24-03-2021,MELGAÇO,4,0,49,"[0,120]",Baixo a Moderado,,,,4,Norte,VIANA DO CASTELO,1603,23824.58,8093,507,567,578,614,675,1289,1867,2434,2941,33.97,12.34,10.22,7.84
24-03-2021,MÉRTOLA,2,0,33,"[0,120]",Baixo a Moderado,,,,2,Alentejo,BEJA,0209,129287.34,6142,400,390,378,423,600,1023,1401,1791,2191,4.75,1.69,1.39,1.08
24-03-2021,MESÃO FRIO,1,0,25,"[0,120]",Baixo a Moderado,,,,1,Norte,VILA REAL,1704,2664.87,3964,265,205,168,157,120,277,445,650,915,148.74,34.33,24.39,16.7
24-03-2021,MIRA,6,0,51,"[0,120]",Baixo a Moderado,,,,6,Centro,COIMBRA,0608,12403.38,11832,727,729,659,550,466,1016,1675,2404,3131,95.4,25.24,19.38,13.5
24-03-2021,MIRANDA DO CORVO,6,0,47,"[0,120]",Baixo a Moderado,,,,6,Centro,COIMBRA,0609,12637.79,12708,706,659,568,498,404,902,1470,2129,2835,100.55,22.43,16.85,11.63
24-03-2021,MIRANDA DO DOURO,0,0,0,"[0,120]",Baixo a Moderado,,,,0,Norte,BRAGANÇA,0406,48718.31,6830,482,429,442,463,470,933,1375,1804,2286,14.02,4.69,3.7,2.82
24-03-2021,MIRANDELA,2,0,9,"[0,120]",Baixo a Moderado,,,,2,Norte,BRAGANÇA,0407,65895.67,21754,1640,1315,1204,1078,947,2025,3229,4544,6184,33.01,9.38,6.9,4.9
24-03-2021,MOGADOURO,3,0,36,"[0,120]",Baixo a Moderado,,,,3,Norte,BRAGANÇA,0408,76064.93,8392,589,529,576,630,655,1285,1861,2390,2979,11.03,3.92,3.14,2.45
24-03-2021,MOIMENTA DA BEIRA,5,0,51,"[0,120]",Baixo a Moderado,,,,5,Norte,VISEU,1807,21996.9,9736,576,514,471,416,461,877,1348,1862,2438,44.26,11.08,8.46,6.13
24-03-2021,MOITA,74,5,115,"[0,120]",Baixo a Moderado,,,,74,Lisboa e Vale do Tejo,SETÚBAL,1506,5525.98,64407,4226,3646,2623,1801,1425,3226,5849,9495,13721,1165.53,248.3,171.82,105.85
24-03-2021,MONÇÃO,6,0,34,"[0,120]",Baixo a Moderado,,,,6,Norte,VIANA DO CASTELO,1604,21130.85,17869,1161,1105,1031,1006,972,1978,3009,4114,5275,84.56,24.96,19.47,14.24
24-03-2021,MONCHIQUE,0,0,0,"[0,120]",Baixo a Moderado,,,,0,Algarve,FARO,0809,39530.43,5077,353,384,321,355,392,747,1068,1452,1805,12.84,4.57,3.67,2.7
24-03-2021,MONDIM DE BASTO,1,0,14,"[0,120]",Baixo a Moderado,,,,1,Norte,VILA REAL,1705,17207.52,6946,395,300,314,284,283,567,881,1181,1576,40.36,9.16,6.86,5.12
24-03-2021,MONFORTE,1,0,34,"[0,120]",Baixo a Moderado,,,,1,Alentejo,PORTALEGRE,1211,42024.82,2975,139,115,117,192,168,360,477,592,731,7.08,1.74,1.41,1.14
24-03-2021,MONTALEGRE,0,0,0,"[0,120]",Baixo a Moderado,,,,0,Norte,VILA REAL,1706,80545.71,8997,699,628,595,603,730,1333,1928,2556,3255,11.17,4.04,3.17,2.39
24-03-2021,MONTEMOR-O-NOVO,3,0,19,"[0,120]",Baixo a Moderado,,,,3,Alentejo,ÉVORA,0706,123296.65,15647,991,953,868,878,971,1849,2717,3670,4661,12.69,3.78,2.98,2.2
24-03-2021,MONTEMOR-O-VELHO,21,1,83,"[0,120]",Baixo a Moderado,,,,21,Centro,COIMBRA,0610,22896.23,25224,1496,1397,1217,1057,988,2045,3262,4659,6155,110.17,26.88,20.35,14.25
24-03-2021,MONTIJO,85,6,148,"[120,240]",Moderado,,,,85,Lisboa e Vale do Tejo,SETÚBAL,1507,34861.64,57614,2771,2441,1990,1554,1109,2663,4653,7094,9865,165.26,28.3,20.35,13.35
24-03-2021,MORA,0,0,0,"[0,120]",Baixo a Moderado,,,,0,Alentejo,ÉVORA,0707,44395.02,4138,336,275,252,238,257,495,747,1022,1358,9.32,3.06,2.3,1.68
24-03-2021,MORTÁGUA,4,0,45,"[0,120]",Baixo a Moderado,,,,4,Centro,VISEU,1808,25117.82,8803,638,584,535,499,460,959,1494,2078,2716,35.05,10.81,8.27,5.95
24-03-2021,MOURA,53,4,386,"[240,480]",Elevado,,,,53,Alentejo,BEJA,0210,95845.55,13718,817,656,665,542,461,1003,1668,2324,3141,14.31,3.28,2.42,1.74
24-03-2021,MOURÃO,0,0,0,"[0,120]",Baixo a Moderado,,,,0,Alentejo,ÉVORA,0708,27862.98,2450,139,108,80,104,109,213,293,401,540,8.79,1.94,1.44,1.05
24-03-2021,MURÇA,0,0,0,"[0,120]",Baixo a Moderado,,,,0,Norte,VILA REAL,1707,18937.11,5463,384,341,307,306,319,625,932,1273,1657,28.85,8.75,6.72,4.92
24-03-2021,MURTOSA,2,0,19,"[0,120]",Baixo a Moderado,,,,2,Centro,AVEIRO,0112,7308.78,10279,509,473,403,353,409,762,1165,1638,2147,140.63,29.37,22.41,15.94
24-03-2021,NAZARÉ,1,0,7,"[0,120]",Baixo a Moderado,,,,1,Lisboa e Vale do Tejo,LEIRIA,1011,8243.43,14165,967,903,670,420,396,816,1486,2389,3356,171.84,40.71,28.98,18.03
24-03-2021,NELAS,1,0,8,"[0,120]",Baixo a Moderado,,,,1,Centro,VISEU,1809,12571.48,12974,924,787,668,604,583,1187,1855,2642,3566,103.21,28.37,21.02,14.76
24-03-2021,NISA,2,0,33,"[0,120]",Baixo a Moderado,,,,2,Alentejo,PORTALEGRE,1212,57567.84,6061,405,389,355,483,478,961,1316,1705,2110,10.53,3.67,2.96,2.29
24-03-2021,NORDESTE,1,0,21,"[0,120]",Baixo a Moderado,,,,1,Açores,AÇORES,4202,10146.8,4862,246,180,124,161,162,323,447,627,873,47.92,8.6,6.18,4.41
24-03-2021,ÓBIDOS,1,0,8,"[0,120]",Baixo a Moderado,,,,1,Lisboa e Vale do Tejo,LEIRIA,1012,14155.44,11850,743,650,574,452,436,888,1462,2112,2855,83.72,20.17,14.92,10.33
24-03-2021,ODEMIRA,83,6,336,"[240,480]",Elevado,,,,83,Alentejo,BEJA,0211,172060.15,24717,1475,1317,1225,1397,1349,2746,3971,5288,6763,14.37,3.93,3.07,2.31
24-03-2021,ODIVELAS,133,9,82,"[0,120]",Baixo a Moderado,,,,133,Lisboa e Vale do Tejo,LISBOA,1116,2654.36,161774,9562,9038,6952,4641,3812,8453,15405,24443,34005,6095.48,1281.27,920.99,580.44
24-03-2021,OEIRAS,115,8,65,"[0,120]",Baixo a Moderado,,,,115,Lisboa e Vale do Tejo,LISBOA,1110,4588.31,177408,11580,11575,8566,6211,5855,12066,20632,32207,43787,3866.78,954.38,701.98,449.69
24-03-2021,OLEIROS,0,0,0,"[0,120]",Baixo a Moderado,,,,0,Centro,CASTELO BRANCO,0506,47109.31,5003,384,341,366,397,487,884,1250,1591,1975,10.62,4.19,3.38,2.65
24-03-2021,OLHÃO,8,1,18,"[0,120]",Baixo a Moderado,,,,8,Algarve,FARO,0810,13086.38,44405,2455,2309,1689,1342,1268,2610,4299,6608,9063,339.33,69.26,50.5,32.85
24-03-2021,OLIVEIRA DE AZEMÉIS,10,1,15,"[0,120]",Baixo a Moderado,,,,10,Norte,AVEIRO,0113,16110.41,66011,4155,3614,2794,2183,1738,3921,6715,10329,14484,409.75,89.91,64.12,41.68
24-03-2021,OLIVEIRA DE FRADES,1,0,10,"[0,120]",Baixo a Moderado,,,,1,Centro,VISEU,1810,14534.62,9936,553,475,438,359,415,774,1212,1687,2240,68.36,15.41,11.61,8.34
24-03-2021,OLIVEIRA DO BAIRRO,9,1,37,"[0,120]",Baixo a Moderado,,,,9,Centro,AVEIRO,0114,8731.99,24277,1327,1182,999,786,810,1596,2595,3777,5104,278.02,58.45,43.25,29.72
24-03-2021,OLIVEIRA DO HOSPITAL,2,0,10,"[0,120]",Baixo a Moderado,,,,2,Centro,COIMBRA,0611,23451.66,19253,1161,1097,962,924,960,1884,2846,3943,5104,82.1,21.76,16.81,12.14
24-03-2021,OURÉM,8,1,18,"[0,120]",Baixo a Moderado,,,,8,Lisboa e Vale do Tejo,SANTARÉM,1421,41668.03,44044,2463,2069,1899,1817,1603,3420,5319,7388,9851,105.7,23.64,17.73,12.77
24-03-2021,OURIQUE,0,0,0,"[0,120]",Baixo a Moderado,,,,0,Alentejo,BEJA,0212,66331.36,4607,313,287,284,268,227,495,779,1066,1379,6.95,2.08,1.61,1.17
24-03-2021,OVAR,29,2,53,"[0,120]",Baixo a Moderado,,,,29,Centro,AVEIRO,0115,14770.25,54260,3294,2709,1994,1636,1234,2870,4864,7573,10867,367.37,73.57,51.27,32.93
24-03-2021,PAÇOS DE FERREIRA,33,2,58,"[0,120]",Baixo a Moderado,,,,33,Norte,PORTO,1309,7099.29,56728,2903,2193,1518,1135,664,1799,3317,5510,8413,799.1,118.51,77.62,46.72
24-03-2021,PALMELA,49,3,76,"[0,120]",Baixo a Moderado,,,,49,Lisboa e Vale do Tejo,SETÚBAL,1508,46512.01,64269,3402,3244,2635,1846,1391,3237,5872,9116,12518,138.18,26.91,19.6,12.62
24-03-2021,PAMPILHOSA DA SERRA,1,0,25,"[0,120]",Baixo a Moderado,,,,1,Centro,COIMBRA,0612,39646.24,4037,238,254,295,339,423,762,1057,1311,1549,10.18,3.91,3.31,2.67
24-03-2021,PAREDES,41,3,48,"[0,120]",Baixo a Moderado,,,,41,Norte,PORTO,1310,15675.69,86067,4272,3532,2412,1717,1258,2975,5387,8919,13191,549.04,84.15,56.9,34.36
24-03-2021,PAREDES DE COURA,1,0,12,"[0,120]",Baixo a Moderado,,,,1,Norte,VIANA DO CASTELO,1605,13818.59,8535,466,528,407,465,515,980,1387,1915,2381,61.76,17.23,13.86,10.04
24-03-2021,PEDRÓGÃO GRANDE,3,0,88,"[0,120]",Baixo a Moderado,,,,3,Centro,LEIRIA,1013,12874.75,3410,175,173,196,221,252,473,669,842,1017,26.49,7.9,6.54,5.2
24-03-2021,PENACOVA,20,1,146,"[120,240]",Moderado,,,,20,Centro,COIMBRA,0613,21673.23,13694,968,923,745,621,703,1324,2069,2992,3960,63.18,18.27,13.81,9.55
24-03-2021,PENAFIEL,22,2,32,"[0,120]",Baixo a Moderado,,,,22,Norte,PORTO,1311,21224.27,69772,3648,2823,2032,1663,1230,2893,4925,7748,11396,328.74,53.69,36.51,23.2
24-03-2021,PENALVA DO CASTELO,3,0,42,"[0,120]",Baixo a Moderado,,,,3,Centro,VISEU,1811,13433.92,7115,449,457,413,391,426,817,1230,1687,2136,52.96,15.9,12.56,9.16
24-03-2021,PENAMACOR,0,0,0,"[0,120]",Baixo a Moderado,,,,0,Centro,CASTELO BRANCO,0507,56370.69,4755,262,248,273,451,633,1084,1357,1605,1867,8.44,3.31,2.85,2.41
24-03-2021,PENEDONO,0,0,0,"[0,120]",Baixo a Moderado,,,,0,Norte,VISEU,1812,13370.75,2591,172,113,129,156,138,294,423,536,708,19.38,5.3,4.01,3.16
24-03-2021,PENELA,9,1,167,"[120,240]",Moderado,,,,9,Centro,COIMBRA,0614,13480.0,5397,314,324,274,359,344,703,977,1301,1615,40.04,11.98,9.65,7.25
24-03-2021,PENICHE,15,1,57,"[0,120]",Baixo a Moderado,,,,15,Lisboa e Vale do Tejo,LEIRIA,1014,7754.98,26501,1746,1504,1203,926,707,1633,2836,4340,6086,341.73,78.48,55.96,36.57
24-03-2021,PESO DA RÉGUA,28,2,178,"[120,240]",Moderado,,,,28,Norte,VILA REAL,1708,9486.01,15773,1076,843,650,659,455,1114,1764,2607,3683,166.28,38.83,27.48,18.6
24-03-2021,PINHEL,2,0,23,"[0,120]",Baixo a Moderado,,,,2,Centro,GUARDA,0910,48452.12,8511,577,566,551,538,689,1227,1778,2344,2921,17.57,6.03,4.84,3.67
24-03-2021,POMBAL,14,1,27,"[0,120]",Baixo a Moderado,,,,14,Centro,LEIRIA,1015,62600.28,51461,3187,2791,2494,2328,2027,4355,6849,9640,12827,82.21,20.49,15.4,10.94
24-03-2021,PONTA DELGADA,114,8,168,"[120,240]",Moderado,,,,114,Açores,AÇORES,4203,23298.65,67935,3108,2435,1726,1133,902,2035,3761,6196,9304,291.58,39.93,26.59,16.14
24-03-2021,PONTA DO SOL,13,1,151,"[120,240]",Moderado,,,,13,Madeira,MADEIRA,3105,4622.03,8593,319,283,347,208,221,429,776,1059,1378,185.92,29.81,22.91,16.79
24-03-2021,PONTE DA BARCA,5,0,45,"[0,120]",Baixo a Moderado,,,,5,Norte,VIANA DO CASTELO,1606,18211.37,11180,635,576,517,554,490,1044,1561,2137,2772,61.39,15.22,11.73,8.57
24-03-2021,PONTE DE LIMA,9,1,22,"[0,120]",Baixo a Moderado,,,,9,Norte,VIANA DO CASTELO,1607,32025.46,41315,2321,2022,1720,1596,1462,3058,4778,6800,9121,129.01,28.48,21.23,14.92
24-03-2021,PONTE DE SOR,4,0,27,"[0,120]",Baixo a Moderado,,,,4,Alentejo,PORTALEGRE,1213,83971.16,14994,939,800,716,739,831,1570,2286,3086,4025,17.86,4.79,3.68,2.72
24-03-2021,PORTALEGRE,13,1,59,"[0,120]",Baixo a Moderado,,,,13,Alentejo,PORTALEGRE,1214,44713.64,22172,1577,1351,1137,993,984,1977,3114,4465,6042,49.59,13.51,9.99,6.96
24-03-2021,PORTEL,2,0,34,"[0,120]",Baixo a Moderado,,,,2,Alentejo,ÉVORA,0709,60100.57,5828,336,358,283,331,305,636,919,1277,1613,9.7,2.68,2.12,1.53
24-03-2021,PORTIMÃO,103,7,186,"[120,240]",Moderado,,,,103,Algarve,FARO,0811,18206.29,55483,3182,2927,2116,1582,1400,2982,5098,8025,11207,304.75,61.56,44.08,28.0
24-03-2021,PORTO,197,14,91,"[0,120]",Baixo a Moderado,,,,197,Norte,PORTO,1312,4142.02,216606,15790,15193,11280,9409,10044,19453,30733,45926,61716,5229.5,1490.0,1108.79,741.98
24-03-2021,PORTO DE MÓS,5,0,21,"[0,120]",Baixo a Moderado,,,,5,Centro,LEIRIA,1016,26183.41,23275,1355,1210,1034,888,872,1760,2794,4004,5359,88.89,20.47,15.29,10.67
24-03-2021,PORTO MONIZ,0,0,0,"[0,120]",Baixo a Moderado,,,,0,Madeira,MADEIRA,3106,8293.38,2342,143,130,95,98,120,218,313,443,586,28.24,7.07,5.34,3.77
24-03-2021,PORTO SANTO,1,0,19,"[0,120]",Baixo a Moderado,,,,1,Madeira,MADEIRA,3201,4300.7,5202,240,157,134,110,68,178,312,469,709,120.95,16.48,10.9,7.25
24-03-2021,PÓVOA DE LANHOSO,7,1,33,"[0,120]",Baixo a Moderado,,,,7,Norte,BRAGA,0309,13465.29,21499,1175,909,732,673,624,1297,2029,2938,4113,159.67,30.55,21.82,15.07
24-03-2021,PÓVOA DE VARZIM,78,6,124,"[120,240]",Moderado,,,,78,Norte,PORTO,1313,8220.59,62784,3712,3120,2134,1594,1305,2899,5033,8153,11865,763.7,144.33,99.17,61.22
24-03-2021,POVOAÇÃO,2,0,34,"[0,120]",Baixo a Moderado,,,,2,Açores,AÇORES,4204,10640.77,5927,293,212,191,144,134,278,469,681,974,55.7,9.15,6.4,4.41
24-03-2021,VILA DA PRAIA DA VITÓRIA,1,0,5,"[0,120]",Baixo a Moderado,,,,1,Açores,AÇORES,4302,16127.06,21317,1133,789,619,436,336,772,1391,2180,3313,132.18,20.54,13.52,8.63
24-03-2021,PROENÇA-A-NOVA,3,0,41,"[0,120]",Baixo a Moderado,,,,3,Centro,CASTELO BRANCO,0508,39539.96,7298,508,465,389,400,560,960,1349,1814,2322,18.46,5.87,4.59,3.41
24-03-2021,REDONDO,2,0,31,"[0,120]",Baixo a Moderado,,,,2,Alentejo,ÉVORA,0710,36950.87,6353,349,325,288,288,354,642,930,1255,1604,17.19,4.34,3.4,2.52
24-03-2021,REGUENGOS DE MONSARAZ,9,1,90,"[0,120]",Baixo a Moderado,,,,9,Alentejo,ÉVORA,0711,46399.72,10015,602,511,455,462,473,935,1390,1901,2503,21.58,5.39,4.1,3.0
24-03-2021,RESENDE,5,0,49,"[0,120]",Baixo a Moderado,,,,5,Norte,VISEU,1813,12334.93,10137,560,493,448,433,422,855,1303,1796,2356,82.18,19.1,14.56,10.56
24-03-2021,RIBEIRA BRAVA,48,3,386,"[240,480]",Elevado,,,,48,Madeira,MADEIRA,3107,6544.88,12435,648,500,411,311,287,598,1009,1509,2157,189.99,32.96,23.06,15.42
24-03-2021,RIBEIRA DE PENA,5,0,83,"[0,120]",Baixo a Moderado,,,,5,Norte,VILA REAL,1709,21745.98,6016,371,301,290,310,368,678,968,1269,1640,27.66,7.54,5.84,4.45
24-03-2021,RIBEIRA GRANDE,36,3,110,"[0,120]",Baixo a Moderado,,,,36,Açores,AÇORES,4205,18015.13,32811,1163,689,512,345,253,598,1110,1799,2962,182.13,16.44,9.99,6.16
24-03-2021,RIO MAIOR,57,4,280,"[240,480]",Elevado,,,,57,Lisboa e Vale do Tejo,SANTARÉM,1414,27276.45,20379,1251,1144,941,795,648,1443,2384,3528,4779,74.71,17.52,12.93,8.74
24-03-2021,SABROSA,0,0,0,"[0,120]",Baixo a Moderado,,,,0,Norte,VILA REAL,1710,15692.45,5918,393,314,304,302,350,652,956,1270,1663,37.71,10.6,8.09,6.09
24-03-2021,SABUGAL,0,0,0,"[0,120]",Baixo a Moderado,,,,0,Centro,GUARDA,0911,82269.82,10585,724,707,694,796,1009,1805,2499,3206,3930,12.87,4.78,3.9,3.04
24-03-2021,SALVATERRA DE MAGOS,10,1,47,"[0,120]",Baixo a Moderado,,,,10,Lisboa e Vale do Tejo,SANTARÉM,1415,24393.2,21295,1275,1181,1060,799,772,1571,2631,3812,5087,87.3,20.85,15.63,10.79
24-03-2021,SANTA COMBA DÃO,1,0,10,"[0,120]",Baixo a Moderado,,,,1,Centro,VISEU,1814,11194.77,10452,732,684,569,538,464,1002,1571,2255,2987,93.36,26.68,20.14,14.03
24-03-2021,SANTA CRUZ,96,7,212,"[120,240]",Moderado,,,,96,Madeira,MADEIRA,3108,8150.28,45281,1817,1301,974,716,523,1239,2213,3514,5331,555.6,65.41,43.12,27.15
24-03-2021,SANTA CRUZ DA GRACIOSA,0,0,0,"[0,120]",Baixo a Moderado,,,,0,Açores,AÇORES,4401,6065.78,4208,228,180,163,124,145,269,432,612,840,69.37,13.85,10.09,7.12
24-03-2021,SANTA CRUZ DAS FLORES,0,0,0,"[0,120]",Baixo a Moderado,,,,0,Açores,AÇORES,4802,7091.44,2165,125,98,74,56,51,107,181,279,404,30.53,5.7,3.93,2.55
24-03-2021,SANTA MARIA DA FEIRA,61,4,44,"[0,120]",Baixo a Moderado,,,,61,Norte,AVEIRO,0109,21587.65,138636,8182,6743,4771,3856,3079,6935,11706,18449,26631,642.19,123.36,85.46,54.22
24-03-2021,SANTA MARTA DE PENAGUIÃO,1,0,15,"[0,120]",Baixo a Moderado,,,,1,Norte,VILA REAL,1711,6928.13,6599,483,373,337,316,317,633,970,1343,1826,95.25,26.36,19.39,14.0
24-03-2021,SANTANA,5,0,75,"[0,120]",Baixo a Moderado,,,,5,Madeira,MADEIRA,3109,9547.3,6711,418,353,343,282,277,559,902,1255,1673,70.29,17.52,13.15,9.45
24-03-2021,SANTARÉM,29,2,51,"[0,120]",Baixo a Moderado,,,,29,Lisboa e Vale do Tejo,SANTARÉM,1416,55253.58,57421,3654,3441,2760,2466,2206,4672,7432,10873,14527,103.92,26.29,19.68,13.45
24-03-2021,SANTIAGO DO CACÉM,9,1,31,"[0,120]",Baixo a Moderado,,,,9,Alentejo,SETÚBAL,1509,105969.29,28791,2144,1689,1472,1295,1215,2510,3982,5671,7815,27.17,7.37,5.35,3.76
24-03-2021,SANTO TIRSO,57,4,84,"[0,120]",Baixo a Moderado,,,,57,Norte,PORTO,1314,13655.52,68055,4911,3935,2761,2257,1810,4067,6828,10763,15674,498.35,114.78,78.82,50.0
24-03-2021,SÃO BRÁS DE ALPORTEL,2,0,19,"[0,120]",Baixo a Moderado,,,,2,Algarve,FARO,0812,15336.92,10416,596,468,467,404,401,805,1272,1740,2336,67.91,15.23,11.35,8.29
24-03-2021,SÃO JOÃO DA MADEIRA,2,0,9,"[0,120]",Baixo a Moderado,,,,2,Norte,AVEIRO,0116,794.3,21958,1347,1069,796,601,593,1194,1990,3059,4406,2765.49,554.91,385.26,250.63
24-03-2021,SÃO JOÃO DA PESQUEIRA,1,0,14,"[0,120]",Baixo a Moderado,,,,1,Norte,VISEU,1815,26610.85,7125,417,330,294,328,328,656,950,1280,1697,26.77,6.38,4.81,3.57
24-03-2021,SÃO PEDRO DO SUL,7,0,45,"[0,120]",Baixo a Moderado,,,,7,Centro,VISEU,1816,34895.09,15403,990,962,861,759,909,1668,2529,3491,4481,44.14,12.84,10.0,7.25
24-03-2021,SÃO ROQUE DO PICO,1,0,31,"[0,120]",Baixo a Moderado,,,,1,Açores,AÇORES,4603,14236.1,3266,199,141,93,96,113,209,302,443,642,22.94,4.51,3.11,2.12
24-03-2021,SÃO VICENTE,0,0,0,"[0,120]",Baixo a Moderado,,,,0,Madeira,MADEIRA,3110,7883.71,5143,272,264,266,225,280,505,771,1035,1307,65.23,16.58,13.13,9.78
24-03-2021,SARDOAL,1,0,27,"[0,120]",Baixo a Moderado,,,,1,Lisboa e Vale do Tejo,SANTARÉM,1417,9214.72,3741,227,178,148,165,248,413,561,739,966,40.6,10.48,8.02,6.09
24-03-2021,SÁTÃO,7,0,60,"[0,120]",Baixo a Moderado,,,,7,Centro,VISEU,1817,20194.11,11580,765,671,515,465,476,941,1456,2127,2892,57.34,14.32,10.53,7.21
24-03-2021,SEIA,2,0,9,"[0,120]",Baixo a Moderado,,,,2,Centro,GUARDA,0912,43568.83,22234,1807,1589,1238,1122,721,1843,3081,4670,6477,51.03,14.87,10.72,7.07
24-03-2021,SEIXAL,127,9,76,"[0,120]",Baixo a Moderado,,,,127,Lisboa e Vale do Tejo,SETÚBAL,1510,9545.17,167752,10586,9270,6661,4391,2930,7321,13982,23252,33838,1757.49,354.51,243.6,146.49
24-03-2021,SERNANCELHE,1,0,19,"[0,120]",Baixo a Moderado,,,,1,Norte,VISEU,1818,22861.22,5396,305,293,286,273,260,533,819,1112,1417,23.6,6.2,4.86,3.58
24-03-2021,SERPA,11,1,77,"[0,120]",Baixo a Moderado,,,,11,Alentejo,BEJA,0213,110563.34,14304,903,761,719,697,626,1323,2042,2803,3706,12.94,3.35,2.54,1.85
24-03-2021,SERTÃ,5,0,34,"[0,120]",Baixo a Moderado,,,,5,Centro,CASTELO BRANCO,0509,44673.17,14577,870,779,790,767,1020,1787,2577,3356,4226,32.63,9.46,7.51,5.77
24-03-2021,SESIMBRA,31,2,60,"[0,120]",Baixo a Moderado,,,,31,Lisboa e Vale do Tejo,SETÚBAL,1511,19571.75,51858,2400,2321,1853,1257,1083,2340,4193,6514,8914,264.96,45.54,33.28,21.42
24-03-2021,SETÚBAL,97,7,84,"[0,120]",Baixo a Moderado,,,,97,Lisboa e Vale do Tejo,SETÚBAL,1512,23032.5,115126,7425,6929,5075,3775,2655,6430,11505,18434,25859,499.83,112.27,80.03,49.95
24-03-2021,SEVER DO VOUGA,4,0,35,"[0,120]",Baixo a Moderado,,,,4,Centro,AVEIRO,0117,12987.56,11331,766,637,568,540,567,1107,1675,2312,3078,87.24,23.7,17.8,12.9
24-03-2021,SILVES,13,1,36,"[0,120]",Baixo a Moderado,,,,13,Algarve,FARO,0813,68006.23,36226,2137,1869,1610,1423,1600,3023,4633,6502,8639,53.27,12.7,9.56,6.81
24-03-2021,SINES,11,1,80,"[0,120]",Baixo a Moderado,,,,11,Alentejo,SETÚBAL,1513,20330.17,13715,888,791,551,416,268,684,1235,2026,2914,67.46,14.33,9.97,6.07
24-03-2021,SINTRA,321,23,82,"[0,120]",Baixo a Moderado,,,,321,Lisboa e Vale do Tejo,LISBOA,1111,31922.73,391402,20490,18316,13545,9137,7284,16421,29966,48282,68772,1226.08,215.43,151.25,93.87
24-03-2021,SOBRAL DE MONTE AGRAÇO,18,1,169,"[120,240]",Moderado,,,,18,Lisboa e Vale do Tejo,LISBOA,1112,5210.32,10651,564,507,352,272,212,484,836,1343,1907,204.43,36.6,25.78,16.05
24-03-2021,SOURE,27,2,158,"[120,240]",Moderado,,,,27,Centro,COIMBRA,0615,26506.07,17120,1173,1142,1004,883,987,1870,2874,4016,5189,64.59,19.58,15.15,10.84
24-03-2021,SOUSEL,0,0,0,"[0,120]",Baixo a Moderado,,,,0,Alentejo,PORTALEGRE,1215,27932.18,4412,261,274,208,302,292,594,802,1076,1337,15.8,4.79,3.85,2.87
24-03-2021,TÁBUA,7,1,62,"[0,120]",Baixo a Moderado,,,,7,Centro,COIMBRA,0616,19978.58,11368,729,584,524,430,464,894,1418,2002,2731,56.9,13.67,10.02,7.1
24-03-2021,TABUAÇO,2,0,33,"[0,120]",Baixo a Moderado,,,,2,Norte,VISEU,1819,13385.67,6033,372,314,217,282,363,645,862,1176,1548,45.07,11.56,8.79,6.44
24-03-2021,TAROUCA,0,0,0,"[0,120]",Baixo a Moderado,,,,0,Norte,VISEU,1820,10008.49,7804,405,335,313,277,324,601,914,1249,1654,77.98,16.53,12.48,9.13
24-03-2021,TAVIRA,26,2,106,"[0,120]",Baixo a Moderado,,,,26,Algarve,FARO,0814,60696.7,24530,1493,1415,1252,1066,1277,2343,3595,5010,6503,40.41,10.71,8.25,5.92
24-03-2021,TERRAS DE BOURO,0,0,0,"[0,120]",Baixo a Moderado,,,,0,Norte,BRAGA,0310,27746.07,6361,391,372,296,319,340,659,955,1327,1718,22.93,6.19,4.78,3.44
24-03-2021,TOMAR,5,0,14,"[0,120]",Baixo a Moderado,,,,5,Lisboa e Vale do Tejo,SANTARÉM,1418,35120.44,36748,2403,2189,1868,1853,1822,3675,5543,7732,10135,104.64,28.86,22.02,15.78
24-03-2021,TONDELA,0,0,0,"[0,120]",Baixo a Moderado,,,,0,Centro,VISEU,1821,37121.73,26357,1768,1722,1518,1475,1417,2892,4410,6132,7900,71.0,21.28,16.52,11.88
24-03-2021,TORRE DE MONCORVO,4,0,52,"[0,120]",Baixo a Moderado,,,,4,Norte,BRAGANÇA,0409,53155.67,7695,556,478,488,551,719,1270,1758,2236,2792,14.48,5.25,4.21,3.31
24-03-2021,TORRES NOVAS,11,1,31,"[0,120]",Baixo a Moderado,,,,11,Lisboa e Vale do Tejo,SANTARÉM,1419,26999.68,34933,2324,1979,1738,1406,1475,2881,4619,6598,8922,129.38,33.04,24.44,17.11
24-03-2021,TORRES VEDRAS,87,6,111,"[0,120]",Baixo a Moderado,,,,87,Lisboa e Vale do Tejo,LISBOA,1113,40714.89,78530,4513,3945,3447,2628,2104,4732,8179,12124,16637,192.88,40.86,29.78,20.09
24-03-2021,TRANCOSO,3,0,34,"[0,120]",Baixo a Moderado,,,,3,Centro,GUARDA,0913,36152.47,8875,581,557,542,586,496,1082,1624,2181,2762,24.55,7.64,6.03,4.49
24-03-2021,TROFA,16,1,42,"[0,120]",Baixo a Moderado,,,,16,Norte,PORTO,1318,7201.76,38418,2336,1894,1231,939,684,1623,2854,4748,7084,533.44,98.36,65.93,39.63
24-03-2021,VAGOS,5,0,22,"[0,120]",Baixo a Moderado,,,,5,Centro,AVEIRO,0118,16491.5,22740,1320,1205,922,784,724,1508,2430,3635,4955,137.89,30.04,22.04,14.73
24-03-2021,VALE DE CAMBRA,25,2,117,"[0,120]",Baixo a Moderado,,,,25,Norte,AVEIRO,0119,14733.47,21327,1491,1363,1005,831,798,1629,2634,3997,5488,144.76,37.25,27.13,17.88
24-03-2021,VALENÇA,2,0,15,"[0,120]",Baixo a Moderado,,,,2,Norte,VIANA DO CASTELO,1608,11712.86,13290,867,791,582,582,503,1085,1667,2458,3325,113.46,28.39,20.99,14.23
24-03-2021,VALONGO,56,4,57,"[0,120]",Baixo a Moderado,,,,56,Norte,PORTO,1315,7512.45,97444,5629,4696,3207,2462,1829,4291,7498,12194,17823,1297.18,237.26,162.33,99.81
24-03-2021,VALPAÇOS,4,0,27,"[0,120]",Baixo a Moderado,,,,4,Norte,VILA REAL,1712,54873.93,14818,1217,1118,999,928,997,1925,2924,4042,5259,27.0,9.58,7.37,5.33
24-03-2021,VELAS,0,0,0,"[0,120]",Baixo a Moderado,,,,0,Açores,AÇORES,4502,11738.38,5093,278,208,166,153,113,266,432,640,918,43.39,7.82,5.45,3.68
24-03-2021,VENDAS NOVAS,5,0,44,"[0,120]",Baixo a Moderado,,,,5,Alentejo,ÉVORA,0712,22238.88,11255,677,768,655,501,532,1033,1688,2456,3133,50.61,14.09,11.04,7.59
24-03-2021,VIANA DO ALENTEJO,2,0,39,"[0,120]",Baixo a Moderado,,,,2,Alentejo,ÉVORA,0713,39367.29,5145,245,208,235,210,214,424,659,867,1112,13.07,2.82,2.2,1.67
24-03-2021,VIANA DO CASTELO,124,9,147,"[120,240]",Moderado,,,,124,Norte,VIANA DO CASTELO,1609,31902.01,84417,5470,4433,3591,3061,2982,6043,9634,14067,19537,264.61,61.24,44.09,30.2
24-03-2021,VIDIGUEIRA,5,0,91,"[0,120]",Baixo a Moderado,,,,5,Alentejo,BEJA,0214,31661.09,5510,300,248,215,233,275,508,723,971,1271,17.4,4.01,3.07,2.28
24-03-2021,VIEIRA DO MINHO,1,0,8,"[0,120]",Baixo a Moderado,,,,1,Norte,BRAGA,0311,21644.35,11842,703,594,525,548,482,1030,1555,2149,2852,54.71,13.18,9.93,7.18
24-03-2021,VILA DE REI,0,0,0,"[0,120]",Baixo a Moderado,,,,0,Centro,CASTELO BRANCO,0510,19154.6,3323,169,128,172,247,302,549,721,849,1018,17.35,5.31,4.43,3.76
24-03-2021,VILA DO BISPO,2,0,39,"[0,120]",Baixo a Moderado,,,,2,Algarve,FARO,0815,17906.06,5154,302,302,314,232,233,465,779,1081,1383,28.78,7.72,6.04,4.35
24-03-2021,VILA DO CONDE,38,3,48,"[0,120]",Baixo a Moderado,,,,38,Norte,PORTO,1316,14902.77,79899,4726,3875,2819,2070,1743,3813,6632,10507,15233,536.13,102.21,70.5,44.5
24-03-2021,VILA DO PORTO,1,0,18,"[0,120]",Baixo a Moderado,,,,1,Açores,AÇORES,4101,9688.74,5616,274,212,135,96,123,219,354,566,840,57.96,8.67,5.84,3.65
24-03-2021,VILA FLOR,4,0,66,"[0,120]",Baixo a Moderado,,,,4,Norte,BRAGANÇA,0410,26581.14,6044,429,362,422,294,331,625,1047,1409,1838,22.74,6.91,5.3,3.94
24-03-2021,VILA FRANCA DE XIRA,97,7,68,"[0,120]",Baixo a Moderado,,,,97,Lisboa e Vale do Tejo,LISBOA,1114,31819.39,141957,8501,6852,4869,3425,2472,5897,10766,17618,26119,446.14,82.09,55.37,33.84
24-03-2021,VILA FRANCA DO CAMPO,3,0,27,"[0,120]",Baixo a Moderado,,,,3,Açores,AÇORES,4206,7796.82,11051,450,344,248,217,154,371,619,963,1413,141.73,18.12,12.35,7.94
24-03-2021,VILA NOVA DA BARQUINHA,4,0,54,"[0,120]",Baixo a Moderado,,,,4,Lisboa e Vale do Tejo,SANTARÉM,1420,4952.97,7461,415,406,392,364,338,702,1094,1500,1915,150.64,38.66,30.28,22.09
24-03-2021,VILA NOVA DE CERVEIRA,8,1,90,"[0,120]",Baixo a Moderado,,,,8,Norte,VIANA DO CASTELO,1610,10846.66,8910,531,444,410,384,334,718,1128,1572,2103,82.14,19.39,14.49,10.4
24-03-2021,VILA NOVA DE FAMALICÃO,76,5,58,"[0,120]",Baixo a Moderado,,,,76,Norte,BRAGA,0312,20159.26,131676,7817,6164,4202,3282,2749,6031,10233,16397,24214,653.19,120.12,81.34,50.76
24-03-2021,VILA NOVA DE FOZ CÔA,3,0,46,"[0,120]",Baixo a Moderado,,,,3,Centro,GUARDA,0914,39815.18,6503,442,385,390,398,429,827,1217,1602,2044,16.33,5.13,4.02,3.06
24-03-2021,VILA NOVA DE GAIA,222,16,74,"[0,120]",Baixo a Moderado,,,,222,Norte,PORTO,1317,16846.43,300472,18349,15568,10972,8224,6281,14505,25477,41045,59394,1783.64,352.57,243.65,151.23
24-03-2021,VILA NOVA DE PAIVA,1,0,21,"[0,120]",Baixo a Moderado,,,,1,Centro,VISEU,1822,17553.28,4687,289,272,233,217,241,458,691,963,1252,26.7,7.13,5.49,3.94
24-03-2021,VILA NOVA DE POIARES,0,0,0,"[0,120]",Baixo a Moderado,,,,0,Centro,COIMBRA,0617,8445.3,6939,380,284,262,235,182,417,679,963,1343,82.17,15.9,11.4,8.04
24-03-2021,VILA POUCA DE AGUIAR,8,1,67,"[0,120]",Baixo a Moderado,,,,8,Norte,VILA REAL,1713,43706.62,11961,860,817,733,601,627,1228,1961,2778,3638,27.37,8.32,6.36,4.49
24-03-2021,VILA REAL,19,1,38,"[0,120]",Baixo a Moderado,,,,19,Norte,VILA REAL,1714,37880.28,49962,3025,2498,2065,1579,1466,3045,5110,7608,10633,131.9,28.07,20.08,13.49
24-03-2021,VILA REAL DE SANTO ANTÓNIO,14,1,75,"[0,120]",Baixo a Moderado,,,,14,Algarve,FARO,0816,6125.0,18749,1172,1069,811,569,586,1155,1966,3035,4207,306.11,68.69,49.55,32.1
24-03-2021,VILA VELHA DE RÓDÃO,0,0,0,"[0,120]",Baixo a Moderado,,,,0,Centro,CASTELO BRANCO,0511,32991.16,3144,209,229,180,283,306,589,769,998,1207,9.53,3.66,3.03,2.33
24-03-2021,VILA VERDE,21,2,45,"[0,120]",Baixo a Moderado,,,,21,Norte,BRAGA,0313,22866.52,46911,2365,2063,1667,1494,1437,2931,4598,6661,9026,205.15,39.47,29.13,20.11
24-03-2021,VILA VIÇOSA,1,0,13,"[0,120]",Baixo a Moderado,,,,1,Alentejo,ÉVORA,0714,19485.89,7656,487,379,342,345,324,669,1011,1390,1877,39.29,9.63,7.13,5.19
24-03-2021,VIMIOSO,1,0,25,"[0,120]",Baixo a Moderado,,,,1,Norte,BRAGANÇA,0411,48158.51,4023,274,230,261,293,335,628,889,1119,1393,8.35,2.89,2.32,1.85
24-03-2021,VINHAIS,0,0,0,"[0,120]",Baixo a Moderado,,,,0,Norte,BRAGANÇA,0412,69475.09,7746,599,577,636,641,815,1456,2092,2669,3268,11.15,4.7,3.84,3.01
24-03-2021,VISEU,26,2,27,"[0,120]",Baixo a Moderado,,,,26,Centro,VISEU,1823,50710.14,97249,5769,5038,4140,3158,2710,5868,10008,15046,20815,191.77,41.05,29.67,19.74
24-03-2021,VIZELA,9,1,38,"[0,120]",Baixo a Moderado,,,,9,Norte,BRAGA,0314,2469.83,23897,1258,928,655,509,371,880,1535,2463,3721,967.49,150.65,99.72,62.15
24-03-2021,VOUZELA,3,0,31,"[0,120]",Baixo a Moderado,,,,3,Centro,VISEU,1824,19369.46,9619,626,605,554,532,507,1039,1593,2198,2824,49.66,14.58,11.35,8.22
31-03-2021,ABRANTES,16,1,46,"[0,120]",Baixo a Moderado,,,,16,Lisboa e Vale do Tejo,SANTARÉM,1401,71469.08,35130,2473,2213,1730,1748,2021,3769,5499,7712,10185,49.15,14.25,10.79,7.69
31-03-2021,ÁGUEDA,9,1,20,"[0,120]",Baixo a Moderado,,,,9,Centro,AVEIRO,0101,33527.44,46075,3237,2713,2090,1635,1496,3131,5221,7934,11171,137.43,33.32,23.66,15.57
31-03-2021,AGUIAR DA BEIRA,4,0,86,"[0,120]",Baixo a Moderado,,,,4,Centro,GUARDA,0901,20676.57,4652,304,281,235,239,148,387,622,903,1207,22.5,5.84,4.37,3.01
31-03-2021,ALANDROAL,10,1,200,"[120,240]",Moderado,,,,10,Alentejo,ÉVORA,0701,54267.81,4992,307,256,296,299,377,676,972,1228,1535,9.2,2.83,2.26,1.79
31-03-2021,ALBERGARIA-A-VELHA,9,1,37,"[0,120]",Baixo a Moderado,,,,9,Centro,AVEIRO,0102,15882.5,24144,1550,1298,996,687,680,1367,2363,3661,5211,152.02,32.81,23.05,14.88
31-03-2021,ALBUFEIRA,67,5,161,"[120,240]",Moderado,,,,67,Algarve,FARO,0801,14066.42,41528,2067,1717,1425,985,858,1843,3268,4985,7052,295.24,50.14,35.44,23.23
31-03-2021,ALCÁCER DO SAL,10,1,86,"[0,120]",Baixo a Moderado,,,,10,Alentejo,SETÚBAL,1501,149987.3,11659,884,814,623,623,602,1225,1848,2662,3546,7.77,2.36,1.77,1.23
31-03-2021,ALCANENA,5,0,39,"[0,120]",Baixo a Moderado,,,,5,Lisboa e Vale do Tejo,SANTARÉM,1402,12732.86,12809,891,744,628,536,588,1124,1752,2496,3387,100.6,26.6,19.6,13.76
31-03-2021,ALCOBAÇA,17,1,32,"[0,120]",Baixo a Moderado,,,,17,Lisboa e Vale do Tejo,LEIRIA,1001,40814.09,53555,3420,2927,2466,2059,1676,3735,6201,9128,12548,131.22,30.74,22.36,15.19
31-03-2021,ALCOCHETE,14,1,71,"[0,120]",Baixo a Moderado,,,,14,Lisboa e Vale do Tejo,SETÚBAL,1502,12836.48,19787,857,834,691,476,447,923,1614,2448,3305,154.15,25.75,19.07,12.57
31-03-2021,ALCOUTIM,1,0,46,"[0,120]",Baixo a Moderado,,,,1,Algarve,FARO,0802,57536.33,2159,191,188,163,190,267,457,620,808,999,3.75,1.74,1.4,1.08
31-03-2021,ALENQUER,18,1,41,"[0,120]",Baixo a Moderado,,,,18,Lisboa e Vale do Tejo,LISBOA,1101,30421.92,44052,2298,2062,1629,1330,1155,2485,4114,6176,8474,144.8,27.85,20.3,13.52
31-03-2021,ALFÂNDEGA DA FÉ,0,0,0,"[0,120]",Baixo a Moderado,,,,0,Norte,BRAGANÇA,0401,32194.64,4550,325,277,301,274,325,599,900,1177,1502,14.13,4.67,3.66,2.8
31-03-2021,ALIJÓ,0,0,0,"[0,120]",Baixo a Moderado,,,,0,Norte,VILA REAL,1701,29759.89,10625,766,687,635,542,666,1208,1843,2530,3296,35.7,11.08,8.5,6.19
31-03-2021,ALJEZUR,3,0,54,"[0,120]",Baixo a Moderado,,,,3,Algarve,FARO,0803,32349.95,5594,316,336,335,320,410,730,1065,1401,1717,17.29,5.31,4.33,3.29
31-03-2021,ALJUSTREL,3,0,36,"[0,120]",Baixo a Moderado,,,,3,Alentejo,BEJA,0201,45847.41,8247,635,521,443,347,358,705,1148,1669,2304,17.99,5.03,3.64,2.5
31-03-2021,ALMADA,193,14,114,"[0,120]",Baixo a Moderado,,,,193,Lisboa e Vale do Tejo,SETÚBAL,1503,7000.89,169039,10469,9777,7876,6144,5111,11255,19131,28908,39377,2414.5,562.45,412.91,273.26
31-03-2021,ALMEIDA,0,0,0,"[0,120]",Baixo a Moderado,,,,0,Centro,GUARDA,0902,51798.46,5830,441,419,396,458,393,851,1247,1666,2107,11.26,4.07,3.22,2.41
31-03-2021,ALMEIRIM,21,1,93,"[0,120]",Baixo a Moderado,,,,21,Lisboa e Vale do Tejo,SANTARÉM,1403,22212.05,22546,1342,1353,1106,866,843,1709,2815,4168,5510,101.5,24.81,18.76,12.67
31-03-2021,ALMODÔVAR,2,0,30,"[0,120]",Baixo a Moderado,,,,2,Alentejo,BEJA,0202,77788.03,6725,414,443,396,373,328,701,1097,1540,1954,8.65,2.51,1.98,1.41
31-03-2021,ALPIARÇA,7,0,99,"[0,120]",Baixo a Moderado,,,,7,Lisboa e Vale do Tejo,SANTARÉM,1404,9536.33,7059,515,486,363,333,274,607,970,1456,1971,74.02,20.67,15.27,10.17
31-03-2021,ALTER DO CHÃO,1,0,32,"[0,120]",Baixo a Moderado,,,,1,Alentejo,PORTALEGRE,1201,36206.62,3165,201,163,136,208,187,395,531,694,895,8.74,2.47,1.92,1.47
31-03-2021,ALVAIÁZERE,3,0,45,"[0,120]",Baixo a Moderado,,,,3,Centro,LEIRIA,1002,16047.76,6597,419,389,346,406,539,945,1291,1680,2099,41.11,13.08,10.47,8.04
31-03-2021,ALVITO,0,0,0,"[0,120]",Baixo a Moderado,,,,0,Alentejo,BEJA,0203,26485.32,2477,145,110,105,111,89,200,305,415,560,9.35,2.11,1.57,1.15
31-03-2021,AMADORA,182,13,99,"[0,120]",Baixo a Moderado,,,,182,Lisboa e Vale do Tejo,LISBOA,1115,2378.47,184106,11186,10936,8780,6460,5890,12350,21130,32066,43252,7742.05,1818.84,1348.44,888.56
31-03-2021,AMARANTE,35,3,66,"[0,120]",Baixo a Moderado,,,,35,Norte,PORTO,1301,30133.15,53193,3086,2413,1812,1643,1311,2954,4766,7179,10265,176.53,34.07,23.82,15.82
31-03-2021,AMARES,5,0,28,"[0,120]",Baixo a Moderado,,,,5,Norte,BRAGA,0301,8195.41,18129,1001,829,622,489,524,1013,1635,2464,3465,221.22,42.28,30.07,19.95
31-03-2021,ANADIA,3,0,11,"[0,120]",Baixo a Moderado,,,,3,Centro,AVEIRO,0103,21663.48,27258,1931,1698,1376,1208,1262,2470,3846,5544,7475,125.83,34.51,25.59,17.75
31-03-2021,ANGRA DO HEROÍSMO,1,0,3,"[0,120]",Baixo a Moderado,,,,1,Açores,AÇORES,4301,23899.66,33807,2006,1473,1122,768,635,1403,2525,3998,6004,141.45,25.12,16.73,10.56
31-03-2021,ANSIÃO,3,0,25,"[0,120]",Baixo a Moderado,,,,3,Centro,LEIRIA,1003,17609.42,12039,727,709,646,694,530,1224,1870,2579,3306,68.37,18.77,14.65,10.62
31-03-2021,ARCOS DE VALDEVEZ,7,0,33,"[0,120]",Baixo a Moderado,,,,7,Norte,VIANA DO CASTELO,1601,44759.64,20926,1329,1338,1282,1343,1515,2858,4140,5478,6807,46.75,15.21,12.24,9.25
31-03-2021,ARGANIL,10,1,91,"[0,120]",Baixo a Moderado,,,,10,Centro,COIMBRA,0601,33283.93,11014,672,648,612,559,596,1155,1767,2415,3087,33.09,9.27,7.26,5.31
31-03-2021,ARMAMAR,5,0,87,"[0,120]",Baixo a Moderado,,,,5,Norte,VISEU,1801,11723.73,5769,357,305,309,285,310,595,904,1209,1566,49.21,13.36,10.31,7.71
31-03-2021,AROUCA,4,0,19,"[0,120]",Baixo a Moderado,,,,4,Norte,AVEIRO,0104,32910.52,20720,1306,1047,753,683,683,1366,2119,3166,4472,62.96,13.59,9.62,6.44
31-03-2021,ARRAIOLOS,3,0,43,"[0,120]",Baixo a Moderado,,,,3,Alentejo,ÉVORA,0702,68374.55,6928,435,384,283,367,480,847,1130,1514,1949,10.13,2.85,2.21,1.65
31-03-2021,ARRONCHES,0,0,0,"[0,120]",Baixo a Moderado,,,,0,Alentejo,PORTALEGRE,1202,31464.72,2820,155,142,162,187,179,366,528,670,825,8.96,2.62,2.13,1.68
31-03-2021,ARRUDA DOS VINHOS,6,0,39,"[0,120]",Baixo a Moderado,,,,6,Lisboa e Vale do Tejo,LISBOA,1102,7795.93,15412,738,738,562,509,438,947,1509,2247,2985,197.69,38.29,28.82,19.36
31-03-2021,AVEIRO,41,3,52,"[0,120]",Baixo a Moderado,,,,41,Centro,AVEIRO,0105,19757.57,78734,4520,4004,3050,2250,2103,4353,7403,11407,15927,398.49,80.61,57.73,37.47
31-03-2021,AVIS,0,0,0,"[0,120]",Baixo a Moderado,,,,0,Alentejo,PORTALEGRE,1203,60596.51,4247,315,225,206,251,273,524,730,955,1270,7.01,2.1,1.58,1.2
31-03-2021,AZAMBUJA,6,0,26,"[0,120]",Baixo a Moderado,,,,6,Lisboa e Vale do Tejo,LISBOA,1103,26265.65,22716,1322,1171,1070,798,618,1416,2486,3657,4979,86.48,18.96,13.92,9.46
31-03-2021,BAIÃO,1,0,5,"[0,120]",Baixo a Moderado,,,,1,Norte,PORTO,1302,17452.83,18748,1070,862,714,686,725,1411,2125,2987,4057,107.42,23.25,17.11,12.18
31-03-2021,BARCELOS,62,4,53,"[0,120]",Baixo a Moderado,,,,62,Norte,BRAGA,0302,37890.14,116187,6721,5325,3619,2991,2562,5553,9172,14497,21218,306.64,56.0,38.26,24.21
31-03-2021,BARRANCOS,0,0,0,"[0,120]",Baixo a Moderado,,,,0,Alentejo,BEJA,0204,16841.73,1634,90,65,65,94,61,155,220,285,375,9.7,2.23,1.69,1.31
31-03-2021,BARREIRO,37,3,49,"[0,120]",Baixo a Moderado,,,,37,Lisboa e Vale do Tejo,SETÚBAL,1504,3639.07,75147,5194,5565,4459,3105,1767,4872,9331,14896,20090,2065.05,552.07,409.34,256.42
31-03-2021,BATALHA,5,0,31,"[0,120]",Baixo a Moderado,,,,5,Centro,LEIRIA,1004,10341.6,15963,873,762,649,529,549,1078,1727,2489,3362,154.35,32.51,24.07,16.7
31-03-2021,BEJA,45,3,134,"[120,240]",Moderado,,,,45,Alentejo,BEJA,0205,114647.55,33579,2005,1840,1386,1272,1039,2311,3697,5537,7542,29.29,6.58,4.83,3.22
31-03-2021,BELMONTE,7,0,109,"[0,120]",Baixo a Moderado,,,,7,Centro,CASTELO BRANCO,0501,11875.91,6398,444,321,325,310,355,665,990,1311,1755,53.87,14.78,11.04,8.34
31-03-2021,BENAVENTE,22,2,72,"[0,120]",Baixo a Moderado,,,,22,Lisboa e Vale do Tejo,SANTARÉM,1405,52138.39,30602,1468,1376,1141,876,643,1519,2660,4036,5504,58.69,10.56,7.74,5.1
31-03-2021,BOMBARRAL,5,0,40,"[0,120]",Baixo a Moderado,,,,5,Lisboa e Vale do Tejo,LEIRIA,1005,9128.55,12558,875,714,561,491,429,920,1481,2195,3070,137.56,33.63,24.04,16.22
31-03-2021,BORBA,9,1,134,"[120,240]",Moderado,,,,9,Alentejo,ÉVORA,0703,14518.65,6736,430,375,279,436,392,828,1107,1482,1912,46.39,13.17,10.21,7.62
31-03-2021,BOTICAS,0,0,0,"[0,120]",Baixo a Moderado,,,,0,Norte,VILA REAL,1702,32195.66,4998,347,306,311,305,380,685,996,1302,1649,15.52,5.12,4.04,3.09
31-03-2021,BRAGA,47,3,26,"[0,120]",Baixo a Moderado,,,,47,Norte,BRAGA,0303,18339.95,182679,10029,7963,5241,4320,3671,7991,13232,21195,31224,996.07,170.25,115.57,72.15
31-03-2021,BRAGANÇA,7,1,21,"[0,120]",Baixo a Moderado,,,,7,Norte,BRAGANÇA,0402,117357.27,33607,2402,1855,1652,1393,1163,2556,4208,6063,8465,28.64,7.21,5.17,3.59
31-03-2021,CABECEIRAS DE BASTO,5,0,32,"[0,120]",Baixo a Moderado,,,,5,Norte,BRAGA,0304,24182.16,15628,774,594,544,575,574,1149,1693,2287,3061,64.63,12.66,9.46,7.0
31-03-2021,CADAVAL,5,0,37,"[0,120]",Baixo a Moderado,,,,5,Lisboa e Vale do Tejo,LISBOA,1104,17489.3,13673,813,796,756,621,625,1246,2002,2798,3611,78.18,20.65,16.0,11.45
31-03-2021,CALDAS DA RAINHA,8,1,15,"[0,120]",Baixo a Moderado,,,,8,Lisboa e Vale do Tejo,LEIRIA,1006,25569.47,51912,3035,2684,2186,1899,1705,3604,5790,8474,11509,203.03,45.01,33.14,22.64
31-03-2021,CALHETA,1,0,9,"[0,120]",Baixo a Moderado,,,,1,Madeira,MADEIRA,3101,11150.43,10867,576,497,507,399,415,814,1321,1818,2394,97.46,21.47,16.3,11.85
31-03-2021,CALHETA (AÇORES),0,0,0,"[0,120]",Baixo a Moderado,,,,0,Açores,AÇORES,4501,12626.4,3184,215,159,141,139,122,261,402,561,776,25.22,6.15,4.44,3.18
31-03-2021,CÂMARA DE LOBOS,52,4,154,"[120,240]",Moderado,,,,52,Madeira,MADEIRA,3102,5216.67,33675,1396,1059,834,545,381,926,1760,2819,4215,645.49,80.79,54.03,33.74
31-03-2021,CAMINHA,10,1,63,"[0,120]",Baixo a Moderado,,,,10,Norte,VIANA DO CASTELO,1602,13652.14,15877,1046,944,818,646,656,1302,2120,3064,4110,116.3,30.11,22.44,15.53
31-03-2021,CAMPO MAIOR,4,0,51,"[0,120]",Baixo a Moderado,,,,4,Alentejo,PORTALEGRE,1204,24720.16,7874,471,364,351,279,327,606,957,1321,1792,31.85,7.25,5.34,3.87
31-03-2021,CANTANHEDE,11,1,31,"[0,120]",Baixo a Moderado,,,,11,Centro,COIMBRA,0602,39088.02,35011,2346,2096,1880,1709,1451,3160,5040,7136,9482,89.57,24.26,18.26,12.89
31-03-2021,CARRAZEDA DE ANSIÃES,0,0,0,"[0,120]",Baixo a Moderado,,,,0,Norte,BRAGANÇA,0403,27924.09,5666,424,389,391,312,465,777,1168,1557,1981,20.29,7.09,5.58,4.18
31-03-2021,CARREGAL DO SAL,28,2,302,"[240,480]",Elevado,,,,28,Centro,VISEU,1802,11689.21,9271,587,562,486,462,376,838,1324,1886,2473,79.31,21.16,16.13,11.33
31-03-2021,CARTAXO,5,0,21,"[0,120]",Baixo a Moderado,,,,5,Lisboa e Vale do Tejo,SANTARÉM,1406,15817.28,23843,1415,1376,1142,861,632,1493,2635,4011,5426,150.74,34.3,25.36,16.66
31-03-2021,CASCAIS,128,9,60,"[0,120]",Baixo a Moderado,,,,128,Lisboa e Vale do Tejo,LISBOA,1105,9740.17,213608,12151,11444,8680,6469,5248,11717,20397,31841,43992,2193.1,451.66,326.91,209.41
31-03-2021,CASTANHEIRA DE PÊRA,0,0,0,"[0,120]",Baixo a Moderado,,,,0,Centro,LEIRIA,1007,6677.45,2614,233,195,157,190,187,377,534,729,962,39.15,14.41,10.92,8.0
31-03-2021,CASTELO BRANCO,9,1,17,"[0,120]",Baixo a Moderado,,,,9,Centro,CASTELO BRANCO,0502,143819.15,51987,3528,3042,2499,2229,2225,4454,6953,9995,13523,36.15,9.4,6.95,4.83
31-03-2021,CASTELO DE PAIVA,7,0,45,"[0,120]",Baixo a Moderado,,,,7,Norte,AVEIRO,0106,11500.53,15454,881,697,545,420,431,851,1396,2093,2974,134.37,25.86,18.2,12.14
31-03-2021,CASTELO DE VIDE,0,0,0,"[0,120]",Baixo a Moderado,,,,0,Alentejo,PORTALEGRE,1205,26491.24,2919,204,173,179,147,170,317,496,669,873,11.02,3.3,2.53,1.87
31-03-2021,CASTRO DAIRE,4,0,29,"[0,120]",Baixo a Moderado,,,,4,Centro,VISEU,1803,37904.13,13823,942,857,765,732,773,1505,2270,3127,4069,36.47,10.74,8.25,5.99
31-03-2021,CASTRO MARIM,1,0,16,"[0,120]",Baixo a Moderado,,,,1,Algarve,FARO,0804,30084.37,6237,370,345,334,322,344,666,1000,1345,1715,20.73,5.7,4.47,3.32
31-03-2021,CASTRO VERDE,4,0,58,"[0,120]",Baixo a Moderado,,,,4,Alentejo,BEJA,0206,56944.23,6949,437,347,303,275,227,502,805,1152,1589,12.2,2.79,2.02,1.41
31-03-2021,CELORICO DA BEIRA,4,0,58,"[0,120]",Baixo a Moderado,,,,4,Centro,GUARDA,0903,24721.63,6928,430,416,363,369,535,904,1267,1683,2113,28.02,8.55,6.81,5.12
31-03-2021,CELORICO DE BASTO,11,1,58,"[0,120]",Baixo a Moderado,,,,11,Norte,BRAGA,0305,18107.02,19040,1001,802,668,728,729,1457,2125,2927,3928,105.15,21.69,16.17,11.74
31-03-2021,CHAMUSCA,3,0,33,"[0,120]",Baixo a Moderado,,,,3,Lisboa e Vale do Tejo,SANTARÉM,1407,74600.54,9197,629,583,553,465,579,1044,1597,2180,2809,12.33,3.77,2.92,2.14
31-03-2021,CHAVES,7,1,18,"[0,120]",Baixo a Moderado,,,,7,Norte,VILA REAL,1703,59122.95,39343,2676,2429,1991,1886,1918,3804,5795,8224,10900,66.54,18.44,13.91,9.8
31-03-2021,CINFÃES,32,2,175,"[120,240]",Moderado,,,,32,Norte,VISEU,1804,23928.76,18244,1067,902,779,734,758,1492,2271,3173,4240,76.24,17.72,13.26,9.49
31-03-2021,COIMBRA,75,5,56,"[0,120]",Baixo a Moderado,,,,75,Centro,COIMBRA,0603,31939.94,134166,9489,8734,6353,5139,5074,10213,16566,25300,34789,420.06,108.92,79.21,51.87
31-03-2021,CONDEIXA-A-NOVA,7,0,39,"[0,120]",Baixo a Moderado,,,,7,Centro,COIMBRA,0604,13867.47,17733,871,809,717,583,490,1073,1790,2599,3470,127.88,25.02,18.74,12.91
31-03-2021,CONSTÂNCIA,0,0,0,"[0,120]",Baixo a Moderado,,,,0,Lisboa e Vale do Tejo,SANTARÉM,1408,8036.58,4030,211,183,187,148,155,303,490,673,884,50.14,11.0,8.37,6.1
31-03-2021,CORUCHE,7,0,40,"[0,120]",Baixo a Moderado,,,,7,Lisboa e Vale do Tejo,SANTARÉM,1409,111572.03,17471,1294,1090,1095,1096,1019,2115,3210,4300,5594,15.66,5.01,3.85,2.88
31-03-2021,CORVO,0,0,0,"[0,120]",Baixo a Moderado,,,,0,Açores,AÇORES,4901,1711.45,464,22,21,11,13,19,32,43,64,86,27.12,5.03,3.74,2.51
31-03-2021,COVILHÃ,26,2,56,"[0,120]",Baixo a Moderado,,,,26,Centro,CASTELO BRANCO,0503,55560.06,46787,3533,2998,2365,2111,2193,4304,6669,9667,13200,84.21,23.76,17.4,12.0
31-03-2021,CRATO,0,0,0,"[0,120]",Baixo a Moderado,,,,0,Alentejo,PORTALEGRE,1206,39806.88,3129,229,258,163,182,228,410,573,831,1060,7.86,2.66,2.09,1.44
31-03-2021,CUBA,2,0,44,"[0,120]",Baixo a Moderado,,,,2,Alentejo,BEJA,0207,17208.72,4595,255,233,206,190,143,333,539,772,1027,26.7,5.97,4.49,3.13
31-03-2021,ELVAS,12,1,58,"[0,120]",Baixo a Moderado,,,,12,Alentejo,PORTALEGRE,1207,63128.86,20528,1057,1145,902,852,810,1662,2564,3709,4766,32.52,7.55,5.88,4.06
31-03-2021,ENTRONCAMENTO,13,1,60,"[0,120]",Baixo a Moderado,,,,13,Lisboa e Vale do Tejo,SANTARÉM,1410,1372.81,21558,1066,930,868,695,592,1287,2155,3085,4151,1570.14,302.33,224.69,156.96
31-03-2021,ESPINHO,20,1,68,"[0,120]",Baixo a Moderado,,,,20,Norte,AVEIRO,0107,2105.68,29516,2205,1993,1430,1177,960,2137,3567,5560,7765,1401.52,368.71,264.01,169.37
31-03-2021,ESPOSENDE,4,0,12,"[0,120]",Baixo a Moderado,,,,4,Norte,BRAGA,0306,9540.98,34177,1831,1522,1095,894,723,1617,2712,4234,6065,358.21,63.57,44.38,28.42
31-03-2021,ESTARREJA,26,2,100,"[0,120]",Baixo a Moderado,,,,26,Centro,AVEIRO,0108,10817.33,26006,1503,1399,1106,953,728,1681,2787,4186,5689,240.42,52.59,38.7,25.76
31-03-2021,ESTREMOZ,3,0,24,"[0,120]",Baixo a Moderado,,,,3,Alentejo,ÉVORA,0704,51379.95,12728,789,613,697,786,877,1663,2360,2973,3762,24.77,7.32,5.79,4.59
31-03-2021,ÉVORA,3,0,6,"[0,120]",Baixo a Moderado,,,,3,Alentejo,ÉVORA,0705,130707.58,52428,3569,2852,2176,1966,1803,3769,5945,8797,12366,40.11,9.46,6.73,4.55
31-03-2021,FAFE,16,1,33,"[0,120]",Baixo a Moderado,,,,16,Norte,BRAGA,0307,21908.11,48060,3044,2455,1679,1403,1208,2611,4290,6745,9789,219.37,44.68,30.79,19.58
31-03-2021,FARO,39,3,64,"[0,120]",Baixo a Moderado,,,,39,Algarve,FARO,0805,20256.79,61015,3847,3364,2604,2055,1601,3656,6260,9624,13471,301.2,66.5,47.51,30.9
31-03-2021,FELGUEIRAS,17,1,30,"[0,120]",Baixo a Moderado,,,,17,Norte,PORTO,1303,11573.75,56422,2951,2302,1601,1316,973,2289,3890,6192,9143,487.49,79.0,53.5,33.61
31-03-2021,FERREIRA DO ALENTEJO,6,0,76,"[0,120]",Baixo a Moderado,,,,6,Alentejo,BEJA,0208,64820.68,7845,515,414,372,343,345,688,1060,1474,1989,12.1,3.07,2.27,1.64
31-03-2021,FERREIRA DO ZÊZERE,0,0,0,"[0,120]",Baixo a Moderado,,,,0,Lisboa e Vale do Tejo,SANTARÉM,1411,19038.03,7959,470,370,416,465,456,921,1337,1707,2177,41.81,11.44,8.97,7.02
31-03-2021,FIGUEIRA DA FOZ,71,5,121,"[120,240]",Moderado,,,,71,Centro,COIMBRA,0605,37905.26,58747,4032,3597,2887,2495,2043,4538,7425,11022,15054,154.98,39.72,29.08,19.59
31-03-2021,FIGUEIRA DE CASTELO RODRIGO,2,0,36,"[0,120]",Baixo a Moderado,,,,2,Centro,GUARDA,0904,50857.46,5584,347,352,290,352,391,743,1033,1385,1732,10.98,3.41,2.72,2.03
31-03-2021,FIGUEIRÓ DOS VINHOS,10,1,180,"[120,240]",Moderado,,,,10,Centro,LEIRIA,1008,17344.0,5568,402,386,322,309,351,660,982,1368,1770,32.1,10.21,7.89,5.66
31-03-2021,FORNOS DE ALGODRES,1,0,22,"[0,120]",Baixo a Moderado,,,,1,Centro,GUARDA,0905,13145.05,4528,261,218,247,256,232,488,735,953,1214,34.45,9.24,7.25,5.59
31-03-2021,FREIXO DE ESPADA À CINTA,2,0,61,"[0,120]",Baixo a Moderado,,,,2,Norte,BRAGANÇA,0404,24414.29,3298,211,177,231,196,189,385,616,793,1004,13.51,4.11,3.25,2.52
31-03-2021,FRONTEIRA,0,0,0,"[0,120]",Baixo a Moderado,,,,0,Alentejo,PORTALEGRE,1208,24859.58,2974,213,182,149,156,168,324,473,655,868,11.96,3.49,2.63,1.9
31-03-2021,FUNCHAL,143,10,137,"[120,240]",Moderado,,,,143,Madeira,MADEIRA,3103,7616.2,104024,6382,5086,3643,2821,1990,4811,8454,13540,19922,1365.86,261.58,177.78,111.0
31-03-2021,FUNDÃO,1,0,4,"[0,120]",Baixo a Moderado,,,,1,Centro,CASTELO BRANCO,0504,70019.79,26495,1781,1464,1432,1357,1643,3000,4432,5896,7677,37.84,10.96,8.42,6.33
31-03-2021,GAVIÃO,0,0,0,"[0,120]",Baixo a Moderado,,,,0,Alentejo,PORTALEGRE,1209,29459.45,3263,189,186,222,263,293,556,778,964,1153,11.08,3.91,3.27,2.64
31-03-2021,GÓIS,0,0,0,"[0,120]",Baixo a Moderado,,,,0,Centro,COIMBRA,0606,26330.19,3805,235,199,240,233,244,477,717,916,1151,14.45,4.37,3.48,2.72
31-03-2021,GOLEGÃ,6,0,112,"[0,120]",Baixo a Moderado,,,,6,Lisboa e Vale do Tejo,SANTARÉM,1412,8431.67,5339,356,299,281,243,255,498,779,1078,1434,63.32,17.01,12.78,9.24
31-03-2021,GONDOMAR,131,9,79,"[0,120]",Baixo a Moderado,,,,131,Norte,PORTO,1304,13191.76,165985,10555,8755,6222,4450,3364,7814,14036,22791,33346,1258.22,252.77,172.76,106.4
31-03-2021,GOUVEIA,7,1,57,"[0,120]",Baixo a Moderado,,,,7,Centro,GUARDA,0906,30061.17,12387,871,931,780,783,810,1593,2373,3304,4175,41.21,13.89,10.99,7.89
31-03-2021,GRÂNDOLA,6,0,41,"[0,120]",Baixo a Moderado,,,,6,Alentejo,SETÚBAL,1505,82593.66,14639,834,834,708,688,672,1360,2068,2902,3736,17.72,4.52,3.51,2.5
31-03-2021,GUARDA,7,1,18,"[0,120]",Baixo a Moderado,,,,7,Centro,GUARDA,0907,71209.58,38969,2477,2041,1686,1415,1474,2889,4575,6616,9093,54.72,12.77,9.29,6.42
31-03-2021,GUIMARÃES,30,2,20,"[0,120]",Baixo a Moderado,,,,30,Norte,BRAGA,0308,24099.96,152309,9394,7074,4809,3877,2948,6825,11634,18708,28102,631.99,116.61,77.63,48.27
31-03-2021,HORTA,0,0,0,"[0,120]",Baixo a Moderado,,,,0,Açores,AÇORES,4701,17305.53,14521,818,658,468,352,302,654,1122,1780,2598,83.91,15.01,10.29,6.48
31-03-2021,IDANHA-A-NOVA,0,0,0,"[0,120]",Baixo a Moderado,,,,0,Centro,CASTELO BRANCO,0505,141633.51,8043,518,490,519,672,974,1646,2165,2655,3173,5.68,2.24,1.87,1.53
31-03-2021,ÍLHAVO,15,1,39,"[0,120]",Baixo a Moderado,,,,15,Centro,AVEIRO,0110,7347.55,38699,2227,1943,1444,1193,850,2043,3487,5430,7657,526.66,104.21,73.9,47.46
31-03-2021,LAGOA (FARO),32,2,141,"[120,240]",Moderado,,,,32,Algarve,FARO,0806,8825.45,22762,1314,1168,919,749,670,1419,2338,3506,4820,257.93,54.62,39.73,26.49
31-03-2021,LAGOA,6,0,41,"[0,120]",Baixo a Moderado,,,,6,Açores,AÇORES,4201,4559.32,14721,536,458,349,238,235,473,822,1280,1816,322.9,39.83,28.08,18.03
31-03-2021,LAGOS,21,1,69,"[0,120]",Baixo a Moderado,,,,21,Algarve,FARO,0807,21299.27,30374,1744,1434,1247,1053,1029,2082,3329,4763,6507,142.61,30.55,22.36,15.63
31-03-2021,LAJES DAS FLORES,0,0,0,"[0,120]",Baixo a Moderado,,,,0,Açores,AÇORES,4801,7004.79,1463,88,53,62,46,54,100,162,215,303,20.89,4.33,3.07,2.31
31-03-2021,LAJES DO PICO,1,0,22,"[0,120]",Baixo a Moderado,,,,1,Açores,AÇORES,4601,15531.09,4490,304,231,223,159,162,321,544,775,1079,28.91,6.95,4.99,3.5
31-03-2021,LAMEGO,15,1,60,"[0,120]",Baixo a Moderado,,,,15,Norte,VISEU,1805,16542.11,24895,1639,1284,1124,898,783,1681,2805,4089,5728,150.5,34.63,24.72,16.96
31-03-2021,LEIRIA,63,4,50,"[0,120]",Baixo a Moderado,,,,63,Centro,LEIRIA,1009,56508.83,125267,7389,6366,5090,3902,3159,7061,12151,18517,25906,221.68,45.84,32.77,21.5
31-03-2021,LISBOA,433,31,85,"[0,120]",Baixo a Moderado,,,,433,Lisboa e Vale do Tejo,LISBOA,1106,10005.43,509515,33197,33340,27706,23037,26770,49807,77513,110853,144050,5092.6,1439.78,1107.98,774.74
31-03-2021,LOULÉ,32,2,47,"[0,120]",Baixo a Moderado,,,,32,Algarve,FARO,0808,76366.91,68697,3890,3350,2780,2358,2251,4609,7389,10739,14629,89.96,19.16,14.06,9.68
31-03-2021,LOURES,135,10,63,"[0,120]",Baixo a Moderado,,,,135,Lisboa e Vale do Tejo,LISBOA,1107,16723.99,213687,12746,12794,9644,6669,5033,11702,21346,34140,46886,1277.73,280.35,204.14,127.64
31-03-2021,LOURINHÃ,8,1,31,"[0,120]",Baixo a Moderado,,,,8,Lisboa e Vale do Tejo,LISBOA,1108,14717.2,25855,1584,1243,992,842,645,1487,2479,3722,5306,175.68,36.05,25.29,16.84
31-03-2021,LOUSÃ,8,1,47,"[0,120]",Baixo a Moderado,,,,8,Centro,COIMBRA,0607,13840.01,17158,946,866,658,528,450,978,1636,2502,3448,123.97,24.91,18.08,11.82
31-03-2021,LOUSADA,14,1,30,"[0,120]",Baixo a Moderado,,,,14,Norte,PORTO,1305,9608.01,46755,2289,1698,1176,853,621,1474,2650,4348,6637,486.63,69.08,45.25,27.58
31-03-2021,MAÇÃO,2,0,32,"[0,120]",Baixo a Moderado,,,,2,Lisboa e Vale do Tejo,SANTARÉM,1413,39997.98,6267,386,362,390,440,657,1097,1487,1849,2235,15.67,5.59,4.62,3.72
31-03-2021,MACEDO DE CAVALEIROS,3,0,21,"[0,120]",Baixo a Moderado,,,,3,Norte,BRAGANÇA,0405,69914.08,14516,1082,889,878,823,938,1761,2639,3528,4610,20.76,6.59,5.05,3.77
31-03-2021,MACHICO,100,7,500,"[480,960]",Muito Elevado,,,,100,Madeira,MADEIRA,3104,6825.1,19981,1197,860,662,455,331,786,1448,2308,3505,292.76,51.36,33.82,21.22
31-03-2021,MADALENA,1,0,17,"[0,120]",Baixo a Moderado,,,,1,Açores,AÇORES,4602,14712.33,5895,334,256,173,190,179,369,542,798,1132,40.07,7.69,5.42,3.68
31-03-2021,MAFRA,31,2,37,"[0,120]",Baixo a Moderado,,,,31,Lisboa e Vale do Tejo,LISBOA,1109,29165.5,84816,3613,3334,2839,2089,1899,3988,6827,10161,13774,290.81,47.23,34.84,23.41
31-03-2021,MAIA,58,4,42,"[0,120]",Baixo a Moderado,,,,58,Norte,PORTO,1306,8293.94,138971,7801,6617,4512,3339,2631,5970,10482,17099,24900,1675.56,300.22,206.16,126.38
31-03-2021,MANGUALDE,1,0,5,"[0,120]",Baixo a Moderado,,,,1,Centro,VISEU,1806,21925.56,18510,1198,1128,885,852,743,1595,2480,3608,4806,84.42,21.92,16.46,11.31
31-03-2021,MANTEIGAS,0,0,0,"[0,120]",Baixo a Moderado,,,,0,Centro,GUARDA,0908,12197.55,3007,258,197,159,167,146,313,472,669,927,24.65,7.6,5.48,3.87
31-03-2021,MARCO DE CANAVESES,3,0,6,"[0,120]",Baixo a Moderado,,,,3,Norte,PORTO,1307,20188.98,51496,2678,2060,1488,1265,1023,2288,3776,5836,8514,255.07,42.17,28.91,18.7
31-03-2021,MARINHA GRANDE,78,6,203,"[120,240]",Moderado,,,,78,Centro,LEIRIA,1010,18725.19,38508,2365,2302,1638,1359,1058,2417,4055,6357,8722,205.65,46.58,33.95,21.66
31-03-2021,MARVÃO,0,0,0,"[0,120]",Baixo a Moderado,,,,0,Alentejo,PORTALEGRE,1210,15489.9,3005,198,185,142,197,237,434,576,761,959,19.4,6.19,4.91,3.72
31-03-2021,MATOSINHOS,93,7,53,"[0,120]",Baixo a Moderado,,,,93,Norte,PORTO,1308,6241.97,175357,11850,9977,7023,5024,3884,8908,15931,25908,37758,2809.31,604.9,415.06,255.22
31-03-2021,MEALHADA,9,1,45,"[0,120]",Baixo a Moderado,,,,9,Centro,AVEIRO,0111,11065.66,19914,1163,1039,810,828,831,1659,2469,3508,4671,179.96,42.21,31.7,22.31
31-03-2021,MÊDA,0,0,0,"[0,120]",Baixo a Moderado,,,,0,Centro,GUARDA,0909,28604.92,4587,343,306,290,288,443,731,1021,1327,1670,16.04,5.84,4.64,3.57
31-03-2021,MELGAÇO,4,0,49,"[0,120]",Baixo a Moderado,,,,4,Norte,VIANA DO CASTELO,1603,23824.58,8093,507,567,578,614,675,1289,1867,2434,2941,33.97,12.34,10.22,7.84
31-03-2021,MÉRTOLA,0,0,0,"[0,120]",Baixo a Moderado,,,,0,Alentejo,BEJA,0209,129287.34,6142,400,390,378,423,600,1023,1401,1791,2191,4.75,1.69,1.39,1.08
31-03-2021,MESÃO FRIO,1,0,25,"[0,120]",Baixo a Moderado,,,,1,Norte,VILA REAL,1704,2664.87,3964,265,205,168,157,120,277,445,650,915,148.74,34.33,24.39,16.7
31-03-2021,MIRA,4,0,34,"[0,120]",Baixo a Moderado,,,,4,Centro,COIMBRA,0608,12403.38,11832,727,729,659,550,466,1016,1675,2404,3131,95.4,25.24,19.38,13.5
31-03-2021,MIRANDA DO CORVO,7,0,55,"[0,120]",Baixo a Moderado,,,,7,Centro,COIMBRA,0609,12637.79,12708,706,659,568,498,404,902,1470,2129,2835,100.55,22.43,16.85,11.63
31-03-2021,MIRANDA DO DOURO,0,0,0,"[0,120]",Baixo a Moderado,,,,0,Norte,BRAGANÇA,0406,48718.31,6830,482,429,442,463,470,933,1375,1804,2286,14.02,4.69,3.7,2.82
31-03-2021,MIRANDELA,1,0,5,"[0,120]",Baixo a Moderado,,,,1,Norte,BRAGANÇA,0407,65895.67,21754,1640,1315,1204,1078,947,2025,3229,4544,6184,33.01,9.38,6.9,4.9
31-03-2021,MOGADOURO,1,0,12,"[0,120]",Baixo a Moderado,,,,1,Norte,BRAGANÇA,0408,76064.93,8392,589,529,576,630,655,1285,1861,2390,2979,11.03,3.92,3.14,2.45
31-03-2021,MOIMENTA DA BEIRA,2,0,21,"[0,120]",Baixo a Moderado,,,,2,Norte,VISEU,1807,21996.9,9736,576,514,471,416,461,877,1348,1862,2438,44.26,11.08,8.46,6.13
31-03-2021,MOITA,58,4,90,"[0,120]",Baixo a Moderado,,,,58,Lisboa e Vale do Tejo,SETÚBAL,1506,5525.98,64407,4226,3646,2623,1801,1425,3226,5849,9495,13721,1165.53,248.3,171.82,105.85
31-03-2021,MONÇÃO,5,0,28,"[0,120]",Baixo a Moderado,,,,5,Norte,VIANA DO CASTELO,1604,21130.85,17869,1161,1105,1031,1006,972,1978,3009,4114,5275,84.56,24.96,19.47,14.24
31-03-2021,MONCHIQUE,5,0,98,"[0,120]",Baixo a Moderado,,,,5,Algarve,FARO,0809,39530.43,5077,353,384,321,355,392,747,1068,1452,1805,12.84,4.57,3.67,2.7
31-03-2021,MONDIM DE BASTO,1,0,14,"[0,120]",Baixo a Moderado,,,,1,Norte,VILA REAL,1705,17207.52,6946,395,300,314,284,283,567,881,1181,1576,40.36,9.16,6.86,5.12
31-03-2021,MONFORTE,0,0,0,"[0,120]",Baixo a Moderado,,,,0,Alentejo,PORTALEGRE,1211,42024.82,2975,139,115,117,192,168,360,477,592,731,7.08,1.74,1.41,1.14
31-03-2021,MONTALEGRE,2,0,22,"[0,120]",Baixo a Moderado,,,,2,Norte,VILA REAL,1706,80545.71,8997,699,628,595,603,730,1333,1928,2556,3255,11.17,4.04,3.17,2.39
31-03-2021,MONTEMOR-O-NOVO,2,0,13,"[0,120]",Baixo a Moderado,,,,2,Alentejo,ÉVORA,0706,123296.65,15647,991,953,868,878,971,1849,2717,3670,4661,12.69,3.78,2.98,2.2
31-03-2021,MONTEMOR-O-VELHO,15,1,59,"[0,120]",Baixo a Moderado,,,,15,Centro,COIMBRA,0610,22896.23,25224,1496,1397,1217,1057,988,2045,3262,4659,6155,110.17,26.88,20.35,14.25
31-03-2021,MONTIJO,65,5,113,"[0,120]",Baixo a Moderado,,,,65,Lisboa e Vale do Tejo,SETÚBAL,1507,34861.64,57614,2771,2441,1990,1554,1109,2663,4653,7094,9865,165.26,28.3,20.35,13.35
31-03-2021,MORA,0,0,0,"[0,120]",Baixo a Moderado,,,,0,Alentejo,ÉVORA,0707,44395.02,4138,336,275,252,238,257,495,747,1022,1358,9.32,3.06,2.3,1.68
31-03-2021,MORTÁGUA,1,0,11,"[0,120]",Baixo a Moderado,,,,1,Centro,VISEU,1808,25117.82,8803,638,584,535,499,460,959,1494,2078,2716,35.05,10.81,8.27,5.95
31-03-2021,MOURA,65,5,474,"[240,480]",Elevado,,,,65,Alentejo,BEJA,0210,95845.55,13718,817,656,665,542,461,1003,1668,2324,3141,14.31,3.28,2.42,1.74
31-03-2021,MOURÃO,1,0,41,"[0,120]",Baixo a Moderado,,,,1,Alentejo,ÉVORA,0708,27862.98,2450,139,108,80,104,109,213,293,401,540,8.79,1.94,1.44,1.05
31-03-2021,MURÇA,0,0,0,"[0,120]",Baixo a Moderado,,,,0,Norte,VILA REAL,1707,18937.11,5463,384,341,307,306,319,625,932,1273,1657,28.85,8.75,6.72,4.92
31-03-2021,MURTOSA,5,0,49,"[0,120]",Baixo a Moderado,,,,5,Centro,AVEIRO,0112,7308.78,10279,509,473,403,353,409,762,1165,1638,2147,140.63,29.37,22.41,15.94
31-03-2021,NAZARÉ,1,0,7,"[0,120]",Baixo a Moderado,,,,1,Lisboa e Vale do Tejo,LEIRIA,1011,8243.43,14165,967,903,670,420,396,816,1486,2389,3356,171.84,40.71,28.98,18.03
31-03-2021,NELAS,0,0,0,"[0,120]",Baixo a Moderado,,,,0,Centro,VISEU,1809,12571.48,12974,924,787,668,604,583,1187,1855,2642,3566,103.21,28.37,21.02,14.76
31-03-2021,NISA,2,0,33,"[0,120]",Baixo a Moderado,,,,2,Alentejo,PORTALEGRE,1212,57567.84,6061,405,389,355,483,478,961,1316,1705,2110,10.53,3.67,2.96,2.29
31-03-2021,NORDESTE,4,0,82,"[0,120]",Baixo a Moderado,,,,4,Açores,AÇORES,4202,10146.8,4862,246,180,124,161,162,323,447,627,873,47.92,8.6,6.18,4.41
31-03-2021,ÓBIDOS,1,0,8,"[0,120]",Baixo a Moderado,,,,1,Lisboa e Vale do Tejo,LEIRIA,1012,14155.44,11850,743,650,574,452,436,888,1462,2112,2855,83.72,20.17,14.92,10.33
31-03-2021,ODEMIRA,78,6,316,"[240,480]",Elevado,,,,78,Alentejo,BEJA,0211,172060.15,24717,1475,1317,1225,1397,1349,2746,3971,5288,6763,14.37,3.93,3.07,2.31
31-03-2021,ODIVELAS,112,8,69,"[0,120]",Baixo a Moderado,,,,112,Lisboa e Vale do Tejo,LISBOA,1116,2654.36,161774,9562,9038,6952,4641,3812,8453,15405,24443,34005,6095.48,1281.27,920.99,580.44
31-03-2021,OEIRAS,122,9,69,"[0,120]",Baixo a Moderado,,,,122,Lisboa e Vale do Tejo,LISBOA,1110,4588.31,177408,11580,11575,8566,6211,5855,12066,20632,32207,43787,3866.78,954.38,701.98,449.69
31-03-2021,OLEIROS,0,0,0,"[0,120]",Baixo a Moderado,,,,0,Centro,CASTELO BRANCO,0506,47109.31,5003,384,341,366,397,487,884,1250,1591,1975,10.62,4.19,3.38,2.65
31-03-2021,OLHÃO,12,1,27,"[0,120]",Baixo a Moderado,,,,12,Algarve,FARO,0810,13086.38,44405,2455,2309,1689,1342,1268,2610,4299,6608,9063,339.33,69.26,50.5,32.85
31-03-2021,OLIVEIRA DE AZEMÉIS,18,1,27,"[0,120]",Baixo a Moderado,,,,18,Norte,AVEIRO,0113,16110.41,66011,4155,3614,2794,2183,1738,3921,6715,10329,14484,409.75,89.91,64.12,41.68
31-03-2021,OLIVEIRA DE FRADES,1,0,10,"[0,120]",Baixo a Moderado,,,,1,Centro,VISEU,1810,14534.62,9936,553,475,438,359,415,774,1212,1687,2240,68.36,15.41,11.61,8.34
31-03-2021,OLIVEIRA DO BAIRRO,8,1,33,"[0,120]",Baixo a Moderado,,,,8,Centro,AVEIRO,0114,8731.99,24277,1327,1182,999,786,810,1596,2595,3777,5104,278.02,58.45,43.25,29.72
31-03-2021,OLIVEIRA DO HOSPITAL,7,0,36,"[0,120]",Baixo a Moderado,,,,7,Centro,COIMBRA,0611,23451.66,19253,1161,1097,962,924,960,1884,2846,3943,5104,82.1,21.76,16.81,12.14
31-03-2021,OURÉM,10,1,23,"[0,120]",Baixo a Moderado,,,,10,Lisboa e Vale do Tejo,SANTARÉM,1421,41668.03,44044,2463,2069,1899,1817,1603,3420,5319,7388,9851,105.7,23.64,17.73,12.77
31-03-2021,OURIQUE,0,0,0,"[0,120]",Baixo a Moderado,,,,0,Alentejo,BEJA,0212,66331.36,4607,313,287,284,268,227,495,779,1066,1379,6.95,2.08,1.61,1.17
31-03-2021,OVAR,35,3,65,"[0,120]",Baixo a Moderado,,,,35,Centro,AVEIRO,0115,14770.25,54260,3294,2709,1994,1636,1234,2870,4864,7573,10867,367.37,73.57,51.27,32.93
31-03-2021,PAÇOS DE FERREIRA,57,4,100,"[0,120]",Baixo a Moderado,,,,57,Norte,PORTO,1309,7099.29,56728,2903,2193,1518,1135,664,1799,3317,5510,8413,799.1,118.51,77.62,46.72
31-03-2021,PALMELA,51,4,79,"[0,120]",Baixo a Moderado,,,,51,Lisboa e Vale do Tejo,SETÚBAL,1508,46512.01,64269,3402,3244,2635,1846,1391,3237,5872,9116,12518,138.18,26.91,19.6,12.62
31-03-2021,PAMPILHOSA DA SERRA,2,0,50,"[0,120]",Baixo a Moderado,,,,2,Centro,COIMBRA,0612,39646.24,4037,238,254,295,339,423,762,1057,1311,1549,10.18,3.91,3.31,2.67
31-03-2021,PAREDES,62,4,72,"[0,120]",Baixo a Moderado,,,,62,Norte,PORTO,1310,15675.69,86067,4272,3532,2412,1717,1258,2975,5387,8919,13191,549.04,84.15,56.9,34.36
31-03-2021,PAREDES DE COURA,3,0,35,"[0,120]",Baixo a Moderado,,,,3,Norte,VIANA DO CASTELO,1605,13818.59,8535,466,528,407,465,515,980,1387,1915,2381,61.76,17.23,13.86,10.04
31-03-2021,PEDRÓGÃO GRANDE,2,0,59,"[0,120]",Baixo a Moderado,,,,2,Centro,LEIRIA,1013,12874.75,3410,175,173,196,221,252,473,669,842,1017,26.49,7.9,6.54,5.2
31-03-2021,PENACOVA,7,0,51,"[0,120]",Baixo a Moderado,,,,7,Centro,COIMBRA,0613,21673.23,13694,968,923,745,621,703,1324,2069,2992,3960,63.18,18.27,13.81,9.55
31-03-2021,PENAFIEL,26,2,37,"[0,120]",Baixo a Moderado,,,,26,Norte,PORTO,1311,21224.27,69772,3648,2823,2032,1663,1230,2893,4925,7748,11396,328.74,53.69,36.51,23.2
31-03-2021,PENALVA DO CASTELO,2,0,28,"[0,120]",Baixo a Moderado,,,,2,Centro,VISEU,1811,13433.92,7115,449,457,413,391,426,817,1230,1687,2136,52.96,15.9,12.56,9.16
31-03-2021,PENAMACOR,0,0,0,"[0,120]",Baixo a Moderado,,,,0,Centro,CASTELO BRANCO,0507,56370.69,4755,262,248,273,451,633,1084,1357,1605,1867,8.44,3.31,2.85,2.41
31-03-2021,PENEDONO,0,0,0,"[0,120]",Baixo a Moderado,,,,0,Norte,VISEU,1812,13370.75,2591,172,113,129,156,138,294,423,536,708,19.38,5.3,4.01,3.16
31-03-2021,PENELA,9,1,167,"[120,240]",Moderado,,,,9,Centro,COIMBRA,0614,13480.0,5397,314,324,274,359,344,703,977,1301,1615,40.04,11.98,9.65,7.25
31-03-2021,PENICHE,21,1,79,"[0,120]",Baixo a Moderado,,,,21,Lisboa e Vale do Tejo,LEIRIA,1014,7754.98,26501,1746,1504,1203,926,707,1633,2836,4340,6086,341.73,78.48,55.96,36.57
31-03-2021,PESO DA RÉGUA,18,1,114,"[0,120]",Baixo a Moderado,,,,18,Norte,VILA REAL,1708,9486.01,15773,1076,843,650,659,455,1114,1764,2607,3683,166.28,38.83,27.48,18.6
31-03-2021,PINHEL,1,0,12,"[0,120]",Baixo a Moderado,,,,1,Centro,GUARDA,0910,48452.12,8511,577,566,551,538,689,1227,1778,2344,2921,17.57,6.03,4.84,3.67
31-03-2021,POMBAL,10,1,19,"[0,120]",Baixo a Moderado,,,,10,Centro,LEIRIA,1015,62600.28,51461,3187,2791,2494,2328,2027,4355,6849,9640,12827,82.21,20.49,15.4,10.94
31-03-2021,PONTA DELGADA,121,9,178,"[120,240]",Moderado,,,,121,Açores,AÇORES,4203,23298.65,67935,3108,2435,1726,1133,902,2035,3761,6196,9304,291.58,39.93,26.59,16.14
31-03-2021,PONTA DO SOL,13,1,151,"[120,240]",Moderado,,,,13,Madeira,MADEIRA,3105,4622.03,8593,319,283,347,208,221,429,776,1059,1378,185.92,29.81,22.91,16.79
31-03-2021,PONTE DA BARCA,7,1,63,"[0,120]",Baixo a Moderado,,,,7,Norte,VIANA DO CASTELO,1606,18211.37,11180,635,576,517,554,490,1044,1561,2137,2772,61.39,15.22,11.73,8.57
31-03-2021,PONTE DE LIMA,9,1,22,"[0,120]",Baixo a Moderado,,,,9,Norte,VIANA DO CASTELO,1607,32025.46,41315,2321,2022,1720,1596,1462,3058,4778,6800,9121,129.01,28.48,21.23,14.92
31-03-2021,PONTE DE SOR,5,0,33,"[0,120]",Baixo a Moderado,,,,5,Alentejo,PORTALEGRE,1213,83971.16,14994,939,800,716,739,831,1570,2286,3086,4025,17.86,4.79,3.68,2.72
31-03-2021,PORTALEGRE,9,1,41,"[0,120]",Baixo a Moderado,,,,9,Alentejo,PORTALEGRE,1214,44713.64,22172,1577,1351,1137,993,984,1977,3114,4465,6042,49.59,13.51,9.99,6.96
31-03-2021,PORTEL,2,0,34,"[0,120]",Baixo a Moderado,,,,2,Alentejo,ÉVORA,0709,60100.57,5828,336,358,283,331,305,636,919,1277,1613,9.7,2.68,2.12,1.53
31-03-2021,PORTIMÃO,171,12,308,"[240,480]",Elevado,,,,171,Algarve,FARO,0811,18206.29,55483,3182,2927,2116,1582,1400,2982,5098,8025,11207,304.75,61.56,44.08,28.0
31-03-2021,PORTO,210,15,97,"[0,120]",Baixo a Moderado,,,,210,Norte,PORTO,1312,4142.02,216606,15790,15193,11280,9409,10044,19453,30733,45926,61716,5229.5,1490.0,1108.79,741.98
31-03-2021,PORTO DE MÓS,15,1,64,"[0,120]",Baixo a Moderado,,,,15,Centro,LEIRIA,1016,26183.41,23275,1355,1210,1034,888,872,1760,2794,4004,5359,88.89,20.47,15.29,10.67
31-03-2021,PORTO MONIZ,1,0,43,"[0,120]",Baixo a Moderado,,,,1,Madeira,MADEIRA,3106,8293.38,2342,143,130,95,98,120,218,313,443,586,28.24,7.07,5.34,3.77
31-03-2021,PORTO SANTO,0,0,0,"[0,120]",Baixo a Moderado,,,,0,Madeira,MADEIRA,3201,4300.7,5202,240,157,134,110,68,178,312,469,709,120.95,16.48,10.9,7.25
31-03-2021,PÓVOA DE LANHOSO,11,1,51,"[0,120]",Baixo a Moderado,,,,11,Norte,BRAGA,0309,13465.29,21499,1175,909,732,673,624,1297,2029,2938,4113,159.67,30.55,21.82,15.07
31-03-2021,PÓVOA DE VARZIM,70,5,111,"[0,120]",Baixo a Moderado,,,,70,Norte,PORTO,1313,8220.59,62784,3712,3120,2134,1594,1305,2899,5033,8153,11865,763.7,144.33,99.17,61.22
31-03-2021,POVOAÇÃO,0,0,0,"[0,120]",Baixo a Moderado,,,,0,Açores,AÇORES,4204,10640.77,5927,293,212,191,144,134,278,469,681,974,55.7,9.15,6.4,4.41
31-03-2021,VILA DA PRAIA DA VITÓRIA,0,0,0,"[0,120]",Baixo a Moderado,,,,0,Açores,AÇORES,4302,16127.06,21317,1133,789,619,436,336,772,1391,2180,3313,132.18,20.54,13.52,8.63
31-03-2021,PROENÇA-A-NOVA,1,0,14,"[0,120]",Baixo a Moderado,,,,1,Centro,CASTELO BRANCO,0508,39539.96,7298,508,465,389,400,560,960,1349,1814,2322,18.46,5.87,4.59,3.41
31-03-2021,REDONDO,2,0,31,"[0,120]",Baixo a Moderado,,,,2,Alentejo,ÉVORA,0710,36950.87,6353,349,325,288,288,354,642,930,1255,1604,17.19,4.34,3.4,2.52
31-03-2021,REGUENGOS DE MONSARAZ,10,1,100,"[0,120]",Baixo a Moderado,,,,10,Alentejo,ÉVORA,0711,46399.72,10015,602,511,455,462,473,935,1390,1901,2503,21.58,5.39,4.1,3.0
31-03-2021,RESENDE,5,0,49,"[0,120]",Baixo a Moderado,,,,5,Norte,VISEU,1813,12334.93,10137,560,493,448,433,422,855,1303,1796,2356,82.18,19.1,14.56,10.56
31-03-2021,RIBEIRA BRAVA,28,2,225,"[120,240]",Moderado,,,,28,Madeira,MADEIRA,3107,6544.88,12435,648,500,411,311,287,598,1009,1509,2157,189.99,32.96,23.06,15.42
31-03-2021,RIBEIRA DE PENA,17,1,283,"[240,480]",Elevado,,,,17,Norte,VILA REAL,1709,21745.98,6016,371,301,290,310,368,678,968,1269,1640,27.66,7.54,5.84,4.45
31-03-2021,RIBEIRA GRANDE,9,1,27,"[0,120]",Baixo a Moderado,,,,9,Açores,AÇORES,4205,18015.13,32811,1163,689,512,345,253,598,1110,1799,2962,182.13,16.44,9.99,6.16
31-03-2021,RIO MAIOR,68,5,334,"[240,480]",Elevado,,,,68,Lisboa e Vale do Tejo,SANTARÉM,1414,27276.45,20379,1251,1144,941,795,648,1443,2384,3528,4779,74.71,17.52,12.93,8.74
31-03-2021,SABROSA,0,0,0,"[0,120]",Baixo a Moderado,,,,0,Norte,VILA REAL,1710,15692.45,5918,393,314,304,302,350,652,956,1270,1663,37.71,10.6,8.09,6.09
31-03-2021,SABUGAL,1,0,9,"[0,120]",Baixo a Moderado,,,,1,Centro,GUARDA,0911,82269.82,10585,724,707,694,796,1009,1805,2499,3206,3930,12.87,4.78,3.9,3.04
31-03-2021,SALVATERRA DE MAGOS,1,0,5,"[0,120]",Baixo a Moderado,,,,1,Lisboa e Vale do Tejo,SANTARÉM,1415,24393.2,21295,1275,1181,1060,799,772,1571,2631,3812,5087,87.3,20.85,15.63,10.79
31-03-2021,SANTA COMBA DÃO,6,0,57,"[0,120]",Baixo a Moderado,,,,6,Centro,VISEU,1814,11194.77,10452,732,684,569,538,464,1002,1571,2255,2987,93.36,26.68,20.14,14.03
31-03-2021,SANTA CRUZ,83,6,183,"[120,240]",Moderado,,,,83,Madeira,MADEIRA,3108,8150.28,45281,1817,1301,974,716,523,1239,2213,3514,5331,555.6,65.41,43.12,27.15
31-03-2021,SANTA CRUZ DA GRACIOSA,0,0,0,"[0,120]",Baixo a Moderado,,,,0,Açores,AÇORES,4401,6065.78,4208,228,180,163,124,145,269,432,612,840,69.37,13.85,10.09,7.12
31-03-2021,SANTA CRUZ DAS FLORES,0,0,0,"[0,120]",Baixo a Moderado,,,,0,Açores,AÇORES,4802,7091.44,2165,125,98,74,56,51,107,181,279,404,30.53,5.7,3.93,2.55
31-03-2021,SANTA MARIA DA FEIRA,60,4,43,"[0,120]",Baixo a Moderado,,,,60,Norte,AVEIRO,0109,21587.65,138636,8182,6743,4771,3856,3079,6935,11706,18449,26631,642.19,123.36,85.46,54.22
31-03-2021,SANTA MARTA DE PENAGUIÃO,0,0,0,"[0,120]",Baixo a Moderado,,,,0,Norte,VILA REAL,1711,6928.13,6599,483,373,337,316,317,633,970,1343,1826,95.25,26.36,19.39,14.0
31-03-2021,SANTANA,7,0,104,"[0,120]",Baixo a Moderado,,,,7,Madeira,MADEIRA,3109,9547.3,6711,418,353,343,282,277,559,902,1255,1673,70.29,17.52,13.15,9.45
31-03-2021,SANTARÉM,19,1,33,"[0,120]",Baixo a Moderado,,,,19,Lisboa e Vale do Tejo,SANTARÉM,1416,55253.58,57421,3654,3441,2760,2466,2206,4672,7432,10873,14527,103.92,26.29,19.68,13.45
31-03-2021,SANTIAGO DO CACÉM,3,0,10,"[0,120]",Baixo a Moderado,,,,3,Alentejo,SETÚBAL,1509,105969.29,28791,2144,1689,1472,1295,1215,2510,3982,5671,7815,27.17,7.37,5.35,3.76
31-03-2021,SANTO TIRSO,61,4,90,"[0,120]",Baixo a Moderado,,,,61,Norte,PORTO,1314,13655.52,68055,4911,3935,2761,2257,1810,4067,6828,10763,15674,498.35,114.78,78.82,50.0
31-03-2021,SÃO BRÁS DE ALPORTEL,0,0,0,"[0,120]",Baixo a Moderado,,,,0,Algarve,FARO,0812,15336.92,10416,596,468,467,404,401,805,1272,1740,2336,67.91,15.23,11.35,8.29
31-03-2021,SÃO JOÃO DA MADEIRA,2,0,9,"[0,120]",Baixo a Moderado,,,,2,Norte,AVEIRO,0116,794.3,21958,1347,1069,796,601,593,1194,1990,3059,4406,2765.49,554.91,385.26,250.63
31-03-2021,SÃO JOÃO DA PESQUEIRA,0,0,0,"[0,120]",Baixo a Moderado,,,,0,Norte,VISEU,1815,26610.85,7125,417,330,294,328,328,656,950,1280,1697,26.77,6.38,4.81,3.57
31-03-2021,SÃO PEDRO DO SUL,2,0,13,"[0,120]",Baixo a Moderado,,,,2,Centro,VISEU,1816,34895.09,15403,990,962,861,759,909,1668,2529,3491,4481,44.14,12.84,10.0,7.25
31-03-2021,SÃO ROQUE DO PICO,0,0,0,"[0,120]",Baixo a Moderado,,,,0,Açores,AÇORES,4603,14236.1,3266,199,141,93,96,113,209,302,443,642,22.94,4.51,3.11,2.12
31-03-2021,SÃO VICENTE,3,0,58,"[0,120]",Baixo a Moderado,,,,3,Madeira,MADEIRA,3110,7883.71,5143,272,264,266,225,280,505,771,1035,1307,65.23,16.58,13.13,9.78
31-03-2021,SARDOAL,1,0,27,"[0,120]",Baixo a Moderado,,,,1,Lisboa e Vale do Tejo,SANTARÉM,1417,9214.72,3741,227,178,148,165,248,413,561,739,966,40.6,10.48,8.02,6.09
31-03-2021,SÁTÃO,7,0,60,"[0,120]",Baixo a Moderado,,,,7,Centro,VISEU,1817,20194.11,11580,765,671,515,465,476,941,1456,2127,2892,57.34,14.32,10.53,7.21
31-03-2021,SEIA,1,0,4,"[0,120]",Baixo a Moderado,,,,1,Centro,GUARDA,0912,43568.83,22234,1807,1589,1238,1122,721,1843,3081,4670,6477,51.03,14.87,10.72,7.07
31-03-2021,SEIXAL,119,9,71,"[0,120]",Baixo a Moderado,,,,119,Lisboa e Vale do Tejo,SETÚBAL,1510,9545.17,167752,10586,9270,6661,4391,2930,7321,13982,23252,33838,1757.49,354.51,243.6,146.49
31-03-2021,SERNANCELHE,1,0,19,"[0,120]",Baixo a Moderado,,,,1,Norte,VISEU,1818,22861.22,5396,305,293,286,273,260,533,819,1112,1417,23.6,6.2,4.86,3.58
31-03-2021,SERPA,4,0,28,"[0,120]",Baixo a Moderado,,,,4,Alentejo,BEJA,0213,110563.34,14304,903,761,719,697,626,1323,2042,2803,3706,12.94,3.35,2.54,1.85
31-03-2021,SERTÃ,6,0,41,"[0,120]",Baixo a Moderado,,,,6,Centro,CASTELO BRANCO,0509,44673.17,14577,870,779,790,767,1020,1787,2577,3356,4226,32.63,9.46,7.51,5.77
31-03-2021,SESIMBRA,29,2,56,"[0,120]",Baixo a Moderado,,,,29,Lisboa e Vale do Tejo,SETÚBAL,1511,19571.75,51858,2400,2321,1853,1257,1083,2340,4193,6514,8914,264.96,45.54,33.28,21.42
31-03-2021,SETÚBAL,89,6,77,"[0,120]",Baixo a Moderado,,,,89,Lisboa e Vale do Tejo,SETÚBAL,1512,23032.5,115126,7425,6929,5075,3775,2655,6430,11505,18434,25859,499.83,112.27,80.03,49.95
31-03-2021,SEVER DO VOUGA,2,0,18,"[0,120]",Baixo a Moderado,,,,2,Centro,AVEIRO,0117,12987.56,11331,766,637,568,540,567,1107,1675,2312,3078,87.24,23.7,17.8,12.9
31-03-2021,SILVES,23,2,63,"[0,120]",Baixo a Moderado,,,,23,Algarve,FARO,0813,68006.23,36226,2137,1869,1610,1423,1600,3023,4633,6502,8639,53.27,12.7,9.56,6.81
31-03-2021,SINES,10,1,73,"[0,120]",Baixo a Moderado,,,,10,Alentejo,SETÚBAL,1513,20330.17,13715,888,791,551,416,268,684,1235,2026,2914,67.46,14.33,9.97,6.07
31-03-2021,SINTRA,294,21,75,"[0,120]",Baixo a Moderado,,,,294,Lisboa e Vale do Tejo,LISBOA,1111,31922.73,391402,20490,18316,13545,9137,7284,16421,29966,48282,68772,1226.08,215.43,151.25,93.87
31-03-2021,SOBRAL DE MONTE AGRAÇO,12,1,113,"[0,120]",Baixo a Moderado,,,,12,Lisboa e Vale do Tejo,LISBOA,1112,5210.32,10651,564,507,352,272,212,484,836,1343,1907,204.43,36.6,25.78,16.05
31-03-2021,SOURE,21,2,123,"[120,240]",Moderado,,,,21,Centro,COIMBRA,0615,26506.07,17120,1173,1142,1004,883,987,1870,2874,4016,5189,64.59,19.58,15.15,10.84
31-03-2021,SOUSEL,0,0,0,"[0,120]",Baixo a Moderado,,,,0,Alentejo,PORTALEGRE,1215,27932.18,4412,261,274,208,302,292,594,802,1076,1337,15.8,4.79,3.85,2.87
31-03-2021,TÁBUA,4,0,35,"[0,120]",Baixo a Moderado,,,,4,Centro,COIMBRA,0616,19978.58,11368,729,584,524,430,464,894,1418,2002,2731,56.9,13.67,10.02,7.1
31-03-2021,TABUAÇO,1,0,17,"[0,120]",Baixo a Moderado,,,,1,Norte,VISEU,1819,13385.67,6033,372,314,217,282,363,645,862,1176,1548,45.07,11.56,8.79,6.44
31-03-2021,TAROUCA,0,0,0,"[0,120]",Baixo a Moderado,,,,0,Norte,VISEU,1820,10008.49,7804,405,335,313,277,324,601,914,1249,1654,77.98,16.53,12.48,9.13
31-03-2021,TAVIRA,9,1,37,"[0,120]",Baixo a Moderado,,,,9,Algarve,FARO,0814,60696.7,24530,1493,1415,1252,1066,1277,2343,3595,5010,6503,40.41,10.71,8.25,5.92
31-03-2021,TERRAS DE BOURO,0,0,0,"[0,120]",Baixo a Moderado,,,,0,Norte,BRAGA,0310,27746.07,6361,391,372,296,319,340,659,955,1327,1718,22.93,6.19,4.78,3.44
31-03-2021,TOMAR,8,1,22,"[0,120]",Baixo a Moderado,,,,8,Lisboa e Vale do Tejo,SANTARÉM,1418,35120.44,36748,2403,2189,1868,1853,1822,3675,5543,7732,10135,104.64,28.86,22.02,15.78
31-03-2021,TONDELA,0,0,0,"[0,120]",Baixo a Moderado,,,,0,Centro,VISEU,1821,37121.73,26357,1768,1722,1518,1475,1417,2892,4410,6132,7900,71.0,21.28,16.52,11.88
31-03-2021,TORRE DE MONCORVO,8,1,104,"[0,120]",Baixo a Moderado,,,,8,Norte,BRAGANÇA,0409,53155.67,7695,556,478,488,551,719,1270,1758,2236,2792,14.48,5.25,4.21,3.31
31-03-2021,TORRES NOVAS,5,0,14,"[0,120]",Baixo a Moderado,,,,5,Lisboa e Vale do Tejo,SANTARÉM,1419,26999.68,34933,2324,1979,1738,1406,1475,2881,4619,6598,8922,129.38,33.04,24.44,17.11
31-03-2021,TORRES VEDRAS,70,5,89,"[0,120]",Baixo a Moderado,,,,70,Lisboa e Vale do Tejo,LISBOA,1113,40714.89,78530,4513,3945,3447,2628,2104,4732,8179,12124,16637,192.88,40.86,29.78,20.09
31-03-2021,TRANCOSO,3,0,34,"[0,120]",Baixo a Moderado,,,,3,Centro,GUARDA,0913,36152.47,8875,581,557,542,586,496,1082,1624,2181,2762,24.55,7.64,6.03,4.49
31-03-2021,TROFA,37,3,96,"[0,120]",Baixo a Moderado,,,,37,Norte,PORTO,1318,7201.76,38418,2336,1894,1231,939,684,1623,2854,4748,7084,533.44,98.36,65.93,39.63
31-03-2021,VAGOS,8,1,35,"[0,120]",Baixo a Moderado,,,,8,Centro,AVEIRO,0118,16491.5,22740,1320,1205,922,784,724,1508,2430,3635,4955,137.89,30.04,22.04,14.73
31-03-2021,VALE DE CAMBRA,14,1,66,"[0,120]",Baixo a Moderado,,,,14,Norte,AVEIRO,0119,14733.47,21327,1491,1363,1005,831,798,1629,2634,3997,5488,144.76,37.25,27.13,17.88
31-03-2021,VALENÇA,4,0,30,"[0,120]",Baixo a Moderado,,,,4,Norte,VIANA DO CASTELO,1608,11712.86,13290,867,791,582,582,503,1085,1667,2458,3325,113.46,28.39,20.99,14.23
31-03-2021,VALONGO,69,5,71,"[0,120]",Baixo a Moderado,,,,69,Norte,PORTO,1315,7512.45,97444,5629,4696,3207,2462,1829,4291,7498,12194,17823,1297.18,237.26,162.33,99.81
31-03-2021,VALPAÇOS,5,0,34,"[0,120]",Baixo a Moderado,,,,5,Norte,VILA REAL,1712,54873.93,14818,1217,1118,999,928,997,1925,2924,4042,5259,27.0,9.58,7.37,5.33
31-03-2021,VELAS,0,0,0,"[0,120]",Baixo a Moderado,,,,0,Açores,AÇORES,4502,11738.38,5093,278,208,166,153,113,266,432,640,918,43.39,7.82,5.45,3.68
31-03-2021,VENDAS NOVAS,2,0,18,"[0,120]",Baixo a Moderado,,,,2,Alentejo,ÉVORA,0712,22238.88,11255,677,768,655,501,532,1033,1688,2456,3133,50.61,14.09,11.04,7.59
31-03-2021,VIANA DO ALENTEJO,2,0,39,"[0,120]",Baixo a Moderado,,,,2,Alentejo,ÉVORA,0713,39367.29,5145,245,208,235,210,214,424,659,867,1112,13.07,2.82,2.2,1.67
31-03-2021,VIANA DO CASTELO,50,4,59,"[0,120]",Baixo a Moderado,,,,50,Norte,VIANA DO CASTELO,1609,31902.01,84417,5470,4433,3591,3061,2982,6043,9634,14067,19537,264.61,61.24,44.09,30.2
31-03-2021,VIDIGUEIRA,1,0,18,"[0,120]",Baixo a Moderado,,,,1,Alentejo,BEJA,0214,31661.09,5510,300,248,215,233,275,508,723,971,1271,17.4,4.01,3.07,2.28
31-03-2021,VIEIRA DO MINHO,4,0,34,"[0,120]",Baixo a Moderado,,,,4,Norte,BRAGA,0311,21644.35,11842,703,594,525,548,482,1030,1555,2149,2852,54.71,13.18,9.93,7.18
31-03-2021,VILA DE REI,1,0,30,"[0,120]",Baixo a Moderado,,,,1,Centro,CASTELO BRANCO,0510,19154.6,3323,169,128,172,247,302,549,721,849,1018,17.35,5.31,4.43,3.76
31-03-2021,VILA DO BISPO,11,1,213,"[120,240]",Moderado,,,,11,Algarve,FARO,0815,17906.06,5154,302,302,314,232,233,465,779,1081,1383,28.78,7.72,6.04,4.35
31-03-2021,VILA DO CONDE,22,2,28,"[0,120]",Baixo a Moderado,,,,22,Norte,PORTO,1316,14902.77,79899,4726,3875,2819,2070,1743,3813,6632,10507,15233,536.13,102.21,70.5,44.5
31-03-2021,VILA DO PORTO,0,0,0,"[0,120]",Baixo a Moderado,,,,0,Açores,AÇORES,4101,9688.74,5616,274,212,135,96,123,219,354,566,840,57.96,8.67,5.84,3.65
31-03-2021,VILA FLOR,4,0,66,"[0,120]",Baixo a Moderado,,,,4,Norte,BRAGANÇA,0410,26581.14,6044,429,362,422,294,331,625,1047,1409,1838,22.74,6.91,5.3,3.94
31-03-2021,VILA FRANCA DE XIRA,104,7,73,"[0,120]",Baixo a Moderado,,,,104,Lisboa e Vale do Tejo,LISBOA,1114,31819.39,141957,8501,6852,4869,3425,2472,5897,10766,17618,26119,446.14,82.09,55.37,33.84
31-03-2021,VILA FRANCA DO CAMPO,4,0,36,"[0,120]",Baixo a Moderado,,,,4,Açores,AÇORES,4206,7796.82,11051,450,344,248,217,154,371,619,963,1413,141.73,18.12,12.35,7.94
31-03-2021,VILA NOVA DA BARQUINHA,6,0,80,"[0,120]",Baixo a Moderado,,,,6,Lisboa e Vale do Tejo,SANTARÉM,1420,4952.97,7461,415,406,392,364,338,702,1094,1500,1915,150.64,38.66,30.28,22.09
31-03-2021,VILA NOVA DE CERVEIRA,4,0,45,"[0,120]",Baixo a Moderado,,,,4,Norte,VIANA DO CASTELO,1610,10846.66,8910,531,444,410,384,334,718,1128,1572,2103,82.14,19.39,14.49,10.4
31-03-2021,VILA NOVA DE FAMALICÃO,83,6,63,"[0,120]",Baixo a Moderado,,,,83,Norte,BRAGA,0312,20159.26,131676,7817,6164,4202,3282,2749,6031,10233,16397,24214,653.19,120.12,81.34,50.76
31-03-2021,VILA NOVA DE FOZ CÔA,2,0,31,"[0,120]",Baixo a Moderado,,,,2,Centro,GUARDA,0914,39815.18,6503,442,385,390,398,429,827,1217,1602,2044,16.33,5.13,4.02,3.06
31-03-2021,VILA NOVA DE GAIA,198,14,66,"[0,120]",Baixo a Moderado,,,,198,Norte,PORTO,1317,16846.43,300472,18349,15568,10972,8224,6281,14505,25477,41045,59394,1783.64,352.57,243.65,151.23
31-03-2021,VILA NOVA DE PAIVA,0,0,0,"[0,120]",Baixo a Moderado,,,,0,Centro,VISEU,1822,17553.28,4687,289,272,233,217,241,458,691,963,1252,26.7,7.13,5.49,3.94
31-03-2021,VILA NOVA DE POIARES,0,0,0,"[0,120]",Baixo a Moderado,,,,0,Centro,COIMBRA,0617,8445.3,6939,380,284,262,235,182,417,679,963,1343,82.17,15.9,11.4,8.04
31-03-2021,VILA POUCA DE AGUIAR,1,0,8,"[0,120]",Baixo a Moderado,,,,1,Norte,VILA REAL,1713,43706.62,11961,860,817,733,601,627,1228,1961,2778,3638,27.37,8.32,6.36,4.49
31-03-2021,VILA REAL,10,1,20,"[0,120]",Baixo a Moderado,,,,10,Norte,VILA REAL,1714,37880.28,49962,3025,2498,2065,1579,1466,3045,5110,7608,10633,131.9,28.07,20.08,13.49
31-03-2021,VILA REAL DE SANTO ANTÓNIO,20,1,107,"[0,120]",Baixo a Moderado,,,,20,Algarve,FARO,0816,6125.0,18749,1172,1069,811,569,586,1155,1966,3035,4207,306.11,68.69,49.55,32.1
31-03-2021,VILA VELHA DE RÓDÃO,0,0,0,"[0,120]",Baixo a Moderado,,,,0,Centro,CASTELO BRANCO,0511,32991.16,3144,209,229,180,283,306,589,769,998,1207,9.53,3.66,3.03,2.33
31-03-2021,VILA VERDE,21,2,45,"[0,120]",Baixo a Moderado,,,,21,Norte,BRAGA,0313,22866.52,46911,2365,2063,1667,1494,1437,2931,4598,6661,9026,205.15,39.47,29.13,20.11
31-03-2021,VILA VIÇOSA,0,0,0,"[0,120]",Baixo a Moderado,,,,0,Alentejo,ÉVORA,0714,19485.89,7656,487,379,342,345,324,669,1011,1390,1877,39.29,9.63,7.13,5.19
31-03-2021,VIMIOSO,7,1,174,"[120,240]",Moderado,,,,7,Norte,BRAGANÇA,0411,48158.51,4023,274,230,261,293,335,628,889,1119,1393,8.35,2.89,2.32,1.85
31-03-2021,VINHAIS,2,0,26,"[0,120]",Baixo a Moderado,,,,2,Norte,BRAGANÇA,0412,69475.09,7746,599,577,636,641,815,1456,2092,2669,3268,11.15,4.7,3.84,3.01
31-03-2021,VISEU,11,1,11,"[0,120]",Baixo a Moderado,,,,11,Centro,VISEU,1823,50710.14,97249,5769,5038,4140,3158,2710,5868,10008,15046,20815,191.77,41.05,29.67,19.74
31-03-2021,VIZELA,7,0,29,"[0,120]",Baixo a Moderado,,,,7,Norte,BRAGA,0314,2469.83,23897,1258,928,655,509,371,880,1535,2463,3721,967.49,150.65,99.72,62.15
31-03-2021,VOUZELA,2,0,21,"[0,120]",Baixo a Moderado,,,,2,Centro,VISEU,1824,19369.46,9619,626,605,554,532,507,1039,1593,2198,2824,49.66,14.58,11.35,8.22
07-04-2021,ABRANTES,15,1,43,"[0,120]",Baixo a Moderado,,,,15,Lisboa e Vale do Tejo,SANTARÉM,1401,71469.08,35130,2473,2213,1730,1748,2021,3769,5499,7712,10185,49.15,14.25,10.79,7.69
07-04-2021,ÁGUEDA,6,0,13,"[0,120]",Baixo a Moderado,,,,6,Centro,AVEIRO,0101,33527.44,46075,3237,2713,2090,1635,1496,3131,5221,7934,11171,137.43,33.32,23.66,15.57
07-04-2021,AGUIAR DA BEIRA,5,0,107,"[0,120]",Baixo a Moderado,,,,5,Centro,GUARDA,0901,20676.57,4652,304,281,235,239,148,387,622,903,1207,22.5,5.84,4.37,3.01
07-04-2021,ALANDROAL,29,2,581,"[480,960]",Muito Elevado,,,,29,Alentejo,ÉVORA,0701,54267.81,4992,307,256,296,299,377,676,972,1228,1535,9.2,2.83,2.26,1.79
07-04-2021,ALBERGARIA-A-VELHA,15,1,62,"[0,120]",Baixo a Moderado,,,,15,Centro,AVEIRO,0102,15882.5,24144,1550,1298,996,687,680,1367,2363,3661,5211,152.02,32.81,23.05,14.88
07-04-2021,ALBUFEIRA,66,5,159,"[120,240]",Moderado,,,,66,Algarve,FARO,0801,14066.42,41528,2067,1717,1425,985,858,1843,3268,4985,7052,295.24,50.14,35.44,23.23
07-04-2021,ALCÁCER DO SAL,6,0,51,"[0,120]",Baixo a Moderado,,,,6,Alentejo,SETÚBAL,1501,149987.3,11659,884,814,623,623,602,1225,1848,2662,3546,7.77,2.36,1.77,1.23
07-04-2021,ALCANENA,3,0,23,"[0,120]",Baixo a Moderado,,,,3,Lisboa e Vale do Tejo,SANTARÉM,1402,12732.86,12809,891,744,628,536,588,1124,1752,2496,3387,100.6,26.6,19.6,13.76
07-04-2021,ALCOBAÇA,9,1,17,"[0,120]",Baixo a Moderado,,,,9,Lisboa e Vale do Tejo,LEIRIA,1001,40814.09,53555,3420,2927,2466,2059,1676,3735,6201,9128,12548,131.22,30.74,22.36,15.19
07-04-2021,ALCOCHETE,9,1,45,"[0,120]",Baixo a Moderado,,,,9,Lisboa e Vale do Tejo,SETÚBAL,1502,12836.48,19787,857,834,691,476,447,923,1614,2448,3305,154.15,25.75,19.07,12.57
07-04-2021,ALCOUTIM,0,0,0,"[0,120]",Baixo a Moderado,,,,0,Algarve,FARO,0802,57536.33,2159,191,188,163,190,267,457,620,808,999,3.75,1.74,1.4,1.08
07-04-2021,ALENQUER,21,2,48,"[0,120]",Baixo a Moderado,,,,21,Lisboa e Vale do Tejo,LISBOA,1101,30421.92,44052,2298,2062,1629,1330,1155,2485,4114,6176,8474,144.8,27.85,20.3,13.52
07-04-2021,ALFÂNDEGA DA FÉ,0,0,0,"[0,120]",Baixo a Moderado,,,,0,Norte,BRAGANÇA,0401,32194.64,4550,325,277,301,274,325,599,900,1177,1502,14.13,4.67,3.66,2.8
07-04-2021,ALIJÓ,3,0,28,"[0,120]",Baixo a Moderado,,,,3,Norte,VILA REAL,1701,29759.89,10625,766,687,635,542,666,1208,1843,2530,3296,35.7,11.08,8.5,6.19
07-04-2021,ALJEZUR,4,0,72,"[0,120]",Baixo a Moderado,,,,4,Algarve,FARO,0803,32349.95,5594,316,336,335,320,410,730,1065,1401,1717,17.29,5.31,4.33,3.29
07-04-2021,ALJUSTREL,2,0,24,"[0,120]",Baixo a Moderado,,,,2,Alentejo,BEJA,0201,45847.41,8247,635,521,443,347,358,705,1148,1669,2304,17.99,5.03,3.64,2.5
07-04-2021,ALMADA,198,14,117,"[0,120]",Baixo a Moderado,,,,198,Lisboa e Vale do Tejo,SETÚBAL,1503,7000.89,169039,10469,9777,7876,6144,5111,11255,19131,28908,39377,2414.5,562.45,412.91,273.26
07-04-2021,ALMEIDA,0,0,0,"[0,120]",Baixo a Moderado,,,,0,Centro,GUARDA,0902,51798.46,5830,441,419,396,458,393,851,1247,1666,2107,11.26,4.07,3.22,2.41
07-04-2021,ALMEIRIM,29,2,129,"[120,240]",Moderado,,,,29,Lisboa e Vale do Tejo,SANTARÉM,1403,22212.05,22546,1342,1353,1106,866,843,1709,2815,4168,5510,101.5,24.81,18.76,12.67
07-04-2021,ALMODÔVAR,4,0,59,"[0,120]",Baixo a Moderado,,,,4,Alentejo,BEJA,0202,77788.03,6725,414,443,396,373,328,701,1097,1540,1954,8.65,2.51,1.98,1.41
07-04-2021,ALPIARÇA,5,0,71,"[0,120]",Baixo a Moderado,,,,5,Lisboa e Vale do Tejo,SANTARÉM,1404,9536.33,7059,515,486,363,333,274,607,970,1456,1971,74.02,20.67,15.27,10.17
07-04-2021,ALTER DO CHÃO,1,0,32,"[0,120]",Baixo a Moderado,,,,1,Alentejo,PORTALEGRE,1201,36206.62,3165,201,163,136,208,187,395,531,694,895,8.74,2.47,1.92,1.47
07-04-2021,ALVAIÁZERE,2,0,30,"[0,120]",Baixo a Moderado,,,,2,Centro,LEIRIA,1002,16047.76,6597,419,389,346,406,539,945,1291,1680,2099,41.11,13.08,10.47,8.04
07-04-2021,ALVITO,0,0,0,"[0,120]",Baixo a Moderado,,,,0,Alentejo,BEJA,0203,26485.32,2477,145,110,105,111,89,200,305,415,560,9.35,2.11,1.57,1.15
07-04-2021,AMADORA,169,12,92,"[0,120]",Baixo a Moderado,,,,169,Lisboa e Vale do Tejo,LISBOA,1115,2378.47,184106,11186,10936,8780,6460,5890,12350,21130,32066,43252,7742.05,1818.84,1348.44,888.56
07-04-2021,AMARANTE,39,3,73,"[0,120]",Baixo a Moderado,,,,39,Norte,PORTO,1301,30133.15,53193,3086,2413,1812,1643,1311,2954,4766,7179,10265,176.53,34.07,23.82,15.82
07-04-2021,AMARES,8,1,44,"[0,120]",Baixo a Moderado,,,,8,Norte,BRAGA,0301,8195.41,18129,1001,829,622,489,524,1013,1635,2464,3465,221.22,42.28,30.07,19.95
07-04-2021,ANADIA,2,0,7,"[0,120]",Baixo a Moderado,,,,2,Centro,AVEIRO,0103,21663.48,27258,1931,1698,1376,1208,1262,2470,3846,5544,7475,125.83,34.51,25.59,17.75
07-04-2021,ANGRA DO HEROÍSMO,1,0,3,"[0,120]",Baixo a Moderado,,,,1,Açores,AÇORES,4301,23899.66,33807,2006,1473,1122,768,635,1403,2525,3998,6004,141.45,25.12,16.73,10.56
07-04-2021,ANSIÃO,6,0,50,"[0,120]",Baixo a Moderado,,,,6,Centro,LEIRIA,1003,17609.42,12039,727,709,646,694,530,1224,1870,2579,3306,68.37,18.77,14.65,10.62
07-04-2021,ARCOS DE VALDEVEZ,13,1,62,"[0,120]",Baixo a Moderado,,,,13,Norte,VIANA DO CASTELO,1601,44759.64,20926,1329,1338,1282,1343,1515,2858,4140,5478,6807,46.75,15.21,12.24,9.25
07-04-2021,ARGANIL,7,1,64,"[0,120]",Baixo a Moderado,,,,7,Centro,COIMBRA,0601,33283.93,11014,672,648,612,559,596,1155,1767,2415,3087,33.09,9.27,7.26,5.31
07-04-2021,ARMAMAR,1,0,17,"[0,120]",Baixo a Moderado,,,,1,Norte,VISEU,1801,11723.73,5769,357,305,309,285,310,595,904,1209,1566,49.21,13.36,10.31,7.71
07-04-2021,AROUCA,1,0,5,"[0,120]",Baixo a Moderado,,,,1,Norte,AVEIRO,0104,32910.52,20720,1306,1047,753,683,683,1366,2119,3166,4472,62.96,13.59,9.62,6.44
07-04-2021,ARRAIOLOS,3,0,43,"[0,120]",Baixo a Moderado,,,,3,Alentejo,ÉVORA,0702,68374.55,6928,435,384,283,367,480,847,1130,1514,1949,10.13,2.85,2.21,1.65
07-04-2021,ARRONCHES,0,0,0,"[0,120]",Baixo a Moderado,,,,0,Alentejo,PORTALEGRE,1202,31464.72,2820,155,142,162,187,179,366,528,670,825,8.96,2.62,2.13,1.68
07-04-2021,ARRUDA DOS VINHOS,4,0,26,"[0,120]",Baixo a Moderado,,,,4,Lisboa e Vale do Tejo,LISBOA,1102,7795.93,15412,738,738,562,509,438,947,1509,2247,2985,197.69,38.29,28.82,19.36
07-04-2021,AVEIRO,41,3,52,"[0,120]",Baixo a Moderado,,,,41,Centro,AVEIRO,0105,19757.57,78734,4520,4004,3050,2250,2103,4353,7403,11407,15927,398.49,80.61,57.73,37.47
07-04-2021,AVIS,0,0,0,"[0,120]",Baixo a Moderado,,,,0,Alentejo,PORTALEGRE,1203,60596.51,4247,315,225,206,251,273,524,730,955,1270,7.01,2.1,1.58,1.2
07-04-2021,AZAMBUJA,0,0,0,"[0,120]",Baixo a Moderado,,,,0,Lisboa e Vale do Tejo,LISBOA,1103,26265.65,22716,1322,1171,1070,798,618,1416,2486,3657,4979,86.48,18.96,13.92,9.46
07-04-2021,BAIÃO,1,0,5,"[0,120]",Baixo a Moderado,,,,1,Norte,PORTO,1302,17452.83,18748,1070,862,714,686,725,1411,2125,2987,4057,107.42,23.25,17.11,12.18
07-04-2021,BARCELOS,58,4,50,"[0,120]",Baixo a Moderado,,,,58,Norte,BRAGA,0302,37890.14,116187,6721,5325,3619,2991,2562,5553,9172,14497,21218,306.64,56.0,38.26,24.21
07-04-2021,BARRANCOS,7,0,428,"[240,480]",Elevado,,,,7,Alentejo,BEJA,0204,16841.73,1634,90,65,65,94,61,155,220,285,375,9.7,2.23,1.69,1.31
07-04-2021,BARREIRO,52,4,69,"[0,120]",Baixo a Moderado,,,,52,Lisboa e Vale do Tejo,SETÚBAL,1504,3639.07,75147,5194,5565,4459,3105,1767,4872,9331,14896,20090,2065.05,552.07,409.34,256.42
07-04-2021,BATALHA,1,0,6,"[0,120]",Baixo a Moderado,,,,1,Centro,LEIRIA,1004,10341.6,15963,873,762,649,529,549,1078,1727,2489,3362,154.35,32.51,24.07,16.7
07-04-2021,BEJA,58,4,173,"[120,240]",Moderado,,,,58,Alentejo,BEJA,0205,114647.55,33579,2005,1840,1386,1272,1039,2311,3697,5537,7542,29.29,6.58,4.83,3.22
07-04-2021,BELMONTE,2,0,31,"[0,120]",Baixo a Moderado,,,,2,Centro,CASTELO BRANCO,0501,11875.91,6398,444,321,325,310,355,665,990,1311,1755,53.87,14.78,11.04,8.34
07-04-2021,BENAVENTE,15,1,49,"[0,120]",Baixo a Moderado,,,,15,Lisboa e Vale do Tejo,SANTARÉM,1405,52138.39,30602,1468,1376,1141,876,643,1519,2660,4036,5504,58.69,10.56,7.74,5.1
07-04-2021,BOMBARRAL,6,0,48,"[0,120]",Baixo a Moderado,,,,6,Lisboa e Vale do Tejo,LEIRIA,1005,9128.55,12558,875,714,561,491,429,920,1481,2195,3070,137.56,33.63,24.04,16.22
07-04-2021,BORBA,5,0,74,"[0,120]",Baixo a Moderado,,,,5,Alentejo,ÉVORA,0703,14518.65,6736,430,375,279,436,392,828,1107,1482,1912,46.39,13.17,10.21,7.62
07-04-2021,BOTICAS,2,0,40,"[0,120]",Baixo a Moderado,,,,2,Norte,VILA REAL,1702,32195.66,4998,347,306,311,305,380,685,996,1302,1649,15.52,5.12,4.04,3.09
07-04-2021,BRAGA,69,5,38,"[0,120]",Baixo a Moderado,,,,69,Norte,BRAGA,0303,18339.95,182679,10029,7963,5241,4320,3671,7991,13232,21195,31224,996.07,170.25,115.57,72.15
07-04-2021,BRAGANÇA,6,0,18,"[0,120]",Baixo a Moderado,,,,6,Norte,BRAGANÇA,0402,117357.27,33607,2402,1855,1652,1393,1163,2556,4208,6063,8465,28.64,7.21,5.17,3.59
07-04-2021,CABECEIRAS DE BASTO,4,0,26,"[0,120]",Baixo a Moderado,,,,4,Norte,BRAGA,0304,24182.16,15628,774,594,544,575,574,1149,1693,2287,3061,64.63,12.66,9.46,7.0
07-04-2021,CADAVAL,2,0,15,"[0,120]",Baixo a Moderado,,,,2,Lisboa e Vale do Tejo,LISBOA,1104,17489.3,13673,813,796,756,621,625,1246,2002,2798,3611,78.18,20.65,16.0,11.45
07-04-2021,CALDAS DA RAINHA,9,1,17,"[0,120]",Baixo a Moderado,,,,9,Lisboa e Vale do Tejo,LEIRIA,1006,25569.47,51912,3035,2684,2186,1899,1705,3604,5790,8474,11509,203.03,45.01,33.14,22.64
07-04-2021,CALHETA,1,0,9,"[0,120]",Baixo a Moderado,,,,1,Madeira,MADEIRA,3101,11150.43,10867,576,497,507,399,415,814,1321,1818,2394,97.46,21.47,16.3,11.85
07-04-2021,CALHETA (AÇORES),0,0,0,"[0,120]",Baixo a Moderado,,,,0,Açores,AÇORES,4501,12626.4,3184,215,159,141,139,122,261,402,561,776,25.22,6.15,4.44,3.18
07-04-2021,CÂMARA DE LOBOS,33,2,98,"[0,120]",Baixo a Moderado,,,,33,Madeira,MADEIRA,3102,5216.67,33675,1396,1059,834,545,381,926,1760,2819,4215,645.49,80.79,54.03,33.74
07-04-2021,CAMINHA,10,1,63,"[0,120]",Baixo a Moderado,,,,10,Norte,VIANA DO CASTELO,1602,13652.14,15877,1046,944,818,646,656,1302,2120,3064,4110,116.3,30.11,22.44,15.53
07-04-2021,CAMPO MAIOR,1,0,13,"[0,120]",Baixo a Moderado,,,,1,Alentejo,PORTALEGRE,1204,24720.16,7874,471,364,351,279,327,606,957,1321,1792,31.85,7.25,5.34,3.87
07-04-2021,CANTANHEDE,11,1,31,"[0,120]",Baixo a Moderado,,,,11,Centro,COIMBRA,0602,39088.02,35011,2346,2096,1880,1709,1451,3160,5040,7136,9482,89.57,24.26,18.26,12.89
07-04-2021,CARRAZEDA DE ANSIÃES,0,0,0,"[0,120]",Baixo a Moderado,,,,0,Norte,BRAGANÇA,0403,27924.09,5666,424,389,391,312,465,777,1168,1557,1981,20.29,7.09,5.58,4.18
07-04-2021,CARREGAL DO SAL,21,2,227,"[120,240]",Moderado,,,,21,Centro,VISEU,1802,11689.21,9271,587,562,486,462,376,838,1324,1886,2473,79.31,21.16,16.13,11.33
07-04-2021,CARTAXO,6,0,25,"[0,120]",Baixo a Moderado,,,,6,Lisboa e Vale do Tejo,SANTARÉM,1406,15817.28,23843,1415,1376,1142,861,632,1493,2635,4011,5426,150.74,34.3,25.36,16.66
07-04-2021,CASCAIS,117,8,55,"[0,120]",Baixo a Moderado,,,,117,Lisboa e Vale do Tejo,LISBOA,1105,9740.17,213608,12151,11444,8680,6469,5248,11717,20397,31841,43992,2193.1,451.66,326.91,209.41
07-04-2021,CASTANHEIRA DE PÊRA,0,0,0,"[0,120]",Baixo a Moderado,,,,0,Centro,LEIRIA,1007,6677.45,2614,233,195,157,190,187,377,534,729,962,39.15,14.41,10.92,8.0
07-04-2021,CASTELO BRANCO,7,0,13,"[0,120]",Baixo a Moderado,,,,7,Centro,CASTELO BRANCO,0502,143819.15,51987,3528,3042,2499,2229,2225,4454,6953,9995,13523,36.15,9.4,6.95,4.83
07-04-2021,CASTELO DE PAIVA,1,0,6,"[0,120]",Baixo a Moderado,,,,1,Norte,AVEIRO,0106,11500.53,15454,881,697,545,420,431,851,1396,2093,2974,134.37,25.86,18.2,12.14
07-04-2021,CASTELO DE VIDE,0,0,0,"[0,120]",Baixo a Moderado,,,,0,Alentejo,PORTALEGRE,1205,26491.24,2919,204,173,179,147,170,317,496,669,873,11.02,3.3,2.53,1.87
07-04-2021,CASTRO DAIRE,2,0,14,"[0,120]",Baixo a Moderado,,,,2,Centro,VISEU,1803,37904.13,13823,942,857,765,732,773,1505,2270,3127,4069,36.47,10.74,8.25,5.99
07-04-2021,CASTRO MARIM,1,0,16,"[0,120]",Baixo a Moderado,,,,1,Algarve,FARO,0804,30084.37,6237,370,345,334,322,344,666,1000,1345,1715,20.73,5.7,4.47,3.32
07-04-2021,CASTRO VERDE,2,0,29,"[0,120]",Baixo a Moderado,,,,2,Alentejo,BEJA,0206,56944.23,6949,437,347,303,275,227,502,805,1152,1589,12.2,2.79,2.02,1.41
07-04-2021,CELORICO DA BEIRA,0,0,0,"[0,120]",Baixo a Moderado,,,,0,Centro,GUARDA,0903,24721.63,6928,430,416,363,369,535,904,1267,1683,2113,28.02,8.55,6.81,5.12
07-04-2021,CELORICO DE BASTO,9,1,47,"[0,120]",Baixo a Moderado,,,,9,Norte,BRAGA,0305,18107.02,19040,1001,802,668,728,729,1457,2125,2927,3928,105.15,21.69,16.17,11.74
07-04-2021,CHAMUSCA,4,0,43,"[0,120]",Baixo a Moderado,,,,4,Lisboa e Vale do Tejo,SANTARÉM,1407,74600.54,9197,629,583,553,465,579,1044,1597,2180,2809,12.33,3.77,2.92,2.14
07-04-2021,CHAVES,23,2,58,"[0,120]",Baixo a Moderado,,,,23,Norte,VILA REAL,1703,59122.95,39343,2676,2429,1991,1886,1918,3804,5795,8224,10900,66.54,18.44,13.91,9.8
07-04-2021,CINFÃES,17,1,93,"[0,120]",Baixo a Moderado,,,,17,Norte,VISEU,1804,23928.76,18244,1067,902,779,734,758,1492,2271,3173,4240,76.24,17.72,13.26,9.49
07-04-2021,COIMBRA,60,4,45,"[0,120]",Baixo a Moderado,,,,60,Centro,COIMBRA,0603,31939.94,134166,9489,8734,6353,5139,5074,10213,16566,25300,34789,420.06,108.92,79.21,51.87
07-04-2021,CONDEIXA-A-NOVA,1,0,6,"[0,120]",Baixo a Moderado,,,,1,Centro,COIMBRA,0604,13867.47,17733,871,809,717,583,490,1073,1790,2599,3470,127.88,25.02,18.74,12.91
07-04-2021,CONSTÂNCIA,0,0,0,"[0,120]",Baixo a Moderado,,,,0,Lisboa e Vale do Tejo,SANTARÉM,1408,8036.58,4030,211,183,187,148,155,303,490,673,884,50.14,11.0,8.37,6.1
07-04-2021,CORUCHE,6,0,34,"[0,120]",Baixo a Moderado,,,,6,Lisboa e Vale do Tejo,SANTARÉM,1409,111572.03,17471,1294,1090,1095,1096,1019,2115,3210,4300,5594,15.66,5.01,3.85,2.88
07-04-2021,CORVO,0,0,0,"[0,120]",Baixo a Moderado,,,,0,Açores,AÇORES,4901,1711.45,464,22,21,11,13,19,32,43,64,86,27.12,5.03,3.74,2.51
07-04-2021,COVILHÃ,13,1,28,"[0,120]",Baixo a Moderado,,,,13,Centro,CASTELO BRANCO,0503,55560.06,46787,3533,2998,2365,2111,2193,4304,6669,9667,13200,84.21,23.76,17.4,12.0
07-04-2021,CRATO,0,0,0,"[0,120]",Baixo a Moderado,,,,0,Alentejo,PORTALEGRE,1206,39806.88,3129,229,258,163,182,228,410,573,831,1060,7.86,2.66,2.09,1.44
07-04-2021,CUBA,0,0,0,"[0,120]",Baixo a Moderado,,,,0,Alentejo,BEJA,0207,17208.72,4595,255,233,206,190,143,333,539,772,1027,26.7,5.97,4.49,3.13
07-04-2021,ELVAS,16,1,78,"[0,120]",Baixo a Moderado,,,,16,Alentejo,PORTALEGRE,1207,63128.86,20528,1057,1145,902,852,810,1662,2564,3709,4766,32.52,7.55,5.88,4.06
07-04-2021,ENTRONCAMENTO,8,1,37,"[0,120]",Baixo a Moderado,,,,8,Lisboa e Vale do Tejo,SANTARÉM,1410,1372.81,21558,1066,930,868,695,592,1287,2155,3085,4151,1570.14,302.33,224.69,156.96
07-04-2021,ESPINHO,21,1,71,"[0,120]",Baixo a Moderado,,,,21,Norte,AVEIRO,0107,2105.68,29516,2205,1993,1430,1177,960,2137,3567,5560,7765,1401.52,368.71,264.01,169.37
07-04-2021,ESPOSENDE,8,1,23,"[0,120]",Baixo a Moderado,,,,8,Norte,BRAGA,0306,9540.98,34177,1831,1522,1095,894,723,1617,2712,4234,6065,358.21,63.57,44.38,28.42
07-04-2021,ESTARREJA,26,2,100,"[0,120]",Baixo a Moderado,,,,26,Centro,AVEIRO,0108,10817.33,26006,1503,1399,1106,953,728,1681,2787,4186,5689,240.42,52.59,38.7,25.76
07-04-2021,ESTREMOZ,2,0,16,"[0,120]",Baixo a Moderado,,,,2,Alentejo,ÉVORA,0704,51379.95,12728,789,613,697,786,877,1663,2360,2973,3762,24.77,7.32,5.79,4.59
07-04-2021,ÉVORA,5,0,10,"[0,120]",Baixo a Moderado,,,,5,Alentejo,ÉVORA,0705,130707.58,52428,3569,2852,2176,1966,1803,3769,5945,8797,12366,40.11,9.46,6.73,4.55
07-04-2021,FAFE,20,1,42,"[0,120]",Baixo a Moderado,,,,20,Norte,BRAGA,0307,21908.11,48060,3044,2455,1679,1403,1208,2611,4290,6745,9789,219.37,44.68,30.79,19.58
07-04-2021,FARO,41,3,67,"[0,120]",Baixo a Moderado,,,,41,Algarve,FARO,0805,20256.79,61015,3847,3364,2604,2055,1601,3656,6260,9624,13471,301.2,66.5,47.51,30.9
07-04-2021,FELGUEIRAS,13,1,23,"[0,120]",Baixo a Moderado,,,,13,Norte,PORTO,1303,11573.75,56422,2951,2302,1601,1316,973,2289,3890,6192,9143,487.49,79.0,53.5,33.61
07-04-2021,FERREIRA DO ALENTEJO,0,0,0,"[0,120]",Baixo a Moderado,,,,0,Alentejo,BEJA,0208,64820.68,7845,515,414,372,343,345,688,1060,1474,1989,12.1,3.07,2.27,1.64
07-04-2021,FERREIRA DO ZÊZERE,1,0,13,"[0,120]",Baixo a Moderado,,,,1,Lisboa e Vale do Tejo,SANTARÉM,1411,19038.03,7959,470,370,416,465,456,921,1337,1707,2177,41.81,11.44,8.97,7.02
07-04-2021,FIGUEIRA DA FOZ,75,5,128,"[120,240]",Moderado,,,,75,Centro,COIMBRA,0605,37905.26,58747,4032,3597,2887,2495,2043,4538,7425,11022,15054,154.98,39.72,29.08,19.59
07-04-2021,FIGUEIRA DE CASTELO RODRIGO,0,0,0,"[0,120]",Baixo a Moderado,,,,0,Centro,GUARDA,0904,50857.46,5584,347,352,290,352,391,743,1033,1385,1732,10.98,3.41,2.72,2.03
07-04-2021,FIGUEIRÓ DOS VINHOS,5,0,90,"[0,120]",Baixo a Moderado,,,,5,Centro,LEIRIA,1008,17344.0,5568,402,386,322,309,351,660,982,1368,1770,32.1,10.21,7.89,5.66
07-04-2021,FORNOS DE ALGODRES,0,0,0,"[0,120]",Baixo a Moderado,,,,0,Centro,GUARDA,0905,13145.05,4528,261,218,247,256,232,488,735,953,1214,34.45,9.24,7.25,5.59
07-04-2021,FREIXO DE ESPADA À CINTA,0,0,0,"[0,120]",Baixo a Moderado,,,,0,Norte,BRAGANÇA,0404,24414.29,3298,211,177,231,196,189,385,616,793,1004,13.51,4.11,3.25,2.52
07-04-2021,FRONTEIRA,0,0,0,"[0,120]",Baixo a Moderado,,,,0,Alentejo,PORTALEGRE,1208,24859.58,2974,213,182,149,156,168,324,473,655,868,11.96,3.49,2.63,1.9
07-04-2021,FUNCHAL,112,8,108,"[0,120]",Baixo a Moderado,,,,112,Madeira,MADEIRA,3103,7616.2,104024,6382,5086,3643,2821,1990,4811,8454,13540,19922,1365.86,261.58,177.78,111.0
07-04-2021,FUNDÃO,2,0,8,"[0,120]",Baixo a Moderado,,,,2,Centro,CASTELO BRANCO,0504,70019.79,26495,1781,1464,1432,1357,1643,3000,4432,5896,7677,37.84,10.96,8.42,6.33
07-04-2021,GAVIÃO,0,0,0,"[0,120]",Baixo a Moderado,,,,0,Alentejo,PORTALEGRE,1209,29459.45,3263,189,186,222,263,293,556,778,964,1153,11.08,3.91,3.27,2.64
07-04-2021,GÓIS,2,0,53,"[0,120]",Baixo a Moderado,,,,2,Centro,COIMBRA,0606,26330.19,3805,235,199,240,233,244,477,717,916,1151,14.45,4.37,3.48,2.72
07-04-2021,GOLEGÃ,6,0,112,"[0,120]",Baixo a Moderado,,,,6,Lisboa e Vale do Tejo,SANTARÉM,1412,8431.67,5339,356,299,281,243,255,498,779,1078,1434,63.32,17.01,12.78,9.24
07-04-2021,GONDOMAR,108,8,65,"[0,120]",Baixo a Moderado,,,,108,Norte,PORTO,1304,13191.76,165985,10555,8755,6222,4450,3364,7814,14036,22791,33346,1258.22,252.77,172.76,106.4
07-04-2021,GOUVEIA,1,0,8,"[0,120]",Baixo a Moderado,,,,1,Centro,GUARDA,0906,30061.17,12387,871,931,780,783,810,1593,2373,3304,4175,41.21,13.89,10.99,7.89
07-04-2021,GRÂNDOLA,4,0,27,"[0,120]",Baixo a Moderado,,,,4,Alentejo,SETÚBAL,1505,82593.66,14639,834,834,708,688,672,1360,2068,2902,3736,17.72,4.52,3.51,2.5
07-04-2021,GUARDA,3,0,8,"[0,120]",Baixo a Moderado,,,,3,Centro,GUARDA,0907,71209.58,38969,2477,2041,1686,1415,1474,2889,4575,6616,9093,54.72,12.77,9.29,6.42
07-04-2021,GUIMARÃES,40,3,26,"[0,120]",Baixo a Moderado,,,,40,Norte,BRAGA,0308,24099.96,152309,9394,7074,4809,3877,2948,6825,11634,18708,28102,631.99,116.61,77.63,48.27
07-04-2021,HORTA,0,0,0,"[0,120]",Baixo a Moderado,,,,0,Açores,AÇORES,4701,17305.53,14521,818,658,468,352,302,654,1122,1780,2598,83.91,15.01,10.29,6.48
07-04-2021,IDANHA-A-NOVA,0,0,0,"[0,120]",Baixo a Moderado,,,,0,Centro,CASTELO BRANCO,0505,141633.51,8043,518,490,519,672,974,1646,2165,2655,3173,5.68,2.24,1.87,1.53
07-04-2021,ÍLHAVO,20,1,52,"[0,120]",Baixo a Moderado,,,,20,Centro,AVEIRO,0110,7347.55,38699,2227,1943,1444,1193,850,2043,3487,5430,7657,526.66,104.21,73.9,47.46
07-04-2021,LAGOA (FARO),41,3,180,"[120,240]",Moderado,,,,41,Algarve,FARO,0806,8825.45,22762,1314,1168,919,749,670,1419,2338,3506,4820,257.93,54.62,39.73,26.49
07-04-2021,LAGOA,9,1,61,"[0,120]",Baixo a Moderado,,,,9,Açores,AÇORES,4201,4559.32,14721,536,458,349,238,235,473,822,1280,1816,322.9,39.83,28.08,18.03
07-04-2021,LAGOS,5,0,16,"[0,120]",Baixo a Moderado,,,,5,Algarve,FARO,0807,21299.27,30374,1744,1434,1247,1053,1029,2082,3329,4763,6507,142.61,30.55,22.36,15.63
07-04-2021,LAJES DAS FLORES,0,0,0,"[0,120]",Baixo a Moderado,,,,0,Açores,AÇORES,4801,7004.79,1463,88,53,62,46,54,100,162,215,303,20.89,4.33,3.07,2.31
07-04-2021,LAJES DO PICO,0,0,0,"[0,120]",Baixo a Moderado,,,,0,Açores,AÇORES,4601,15531.09,4490,304,231,223,159,162,321,544,775,1079,28.91,6.95,4.99,3.5
07-04-2021,LAMEGO,21,1,84,"[0,120]",Baixo a Moderado,,,,21,Norte,VISEU,1805,16542.11,24895,1639,1284,1124,898,783,1681,2805,4089,5728,150.5,34.63,24.72,16.96
07-04-2021,LEIRIA,70,5,56,"[0,120]",Baixo a Moderado,,,,70,Centro,LEIRIA,1009,56508.83,125267,7389,6366,5090,3902,3159,7061,12151,18517,25906,221.68,45.84,32.77,21.5
07-04-2021,LISBOA,453,32,89,"[0,120]",Baixo a Moderado,,,,453,Lisboa e Vale do Tejo,LISBOA,1106,10005.43,509515,33197,33340,27706,23037,26770,49807,77513,110853,144050,5092.6,1439.78,1107.98,774.74
07-04-2021,LOULÉ,43,3,63,"[0,120]",Baixo a Moderado,,,,43,Algarve,FARO,0808,76366.91,68697,3890,3350,2780,2358,2251,4609,7389,10739,14629,89.96,19.16,14.06,9.68
07-04-2021,LOURES,109,8,51,"[0,120]",Baixo a Moderado,,,,109,Lisboa e Vale do Tejo,LISBOA,1107,16723.99,213687,12746,12794,9644,6669,5033,11702,21346,34140,46886,1277.73,280.35,204.14,127.64
07-04-2021,LOURINHÃ,11,1,43,"[0,120]",Baixo a Moderado,,,,11,Lisboa e Vale do Tejo,LISBOA,1108,14717.2,25855,1584,1243,992,842,645,1487,2479,3722,5306,175.68,36.05,25.29,16.84
07-04-2021,LOUSÃ,8,1,47,"[0,120]",Baixo a Moderado,,,,8,Centro,COIMBRA,0607,13840.01,17158,946,866,658,528,450,978,1636,2502,3448,123.97,24.91,18.08,11.82
07-04-2021,LOUSADA,12,1,26,"[0,120]",Baixo a Moderado,,,,12,Norte,PORTO,1305,9608.01,46755,2289,1698,1176,853,621,1474,2650,4348,6637,486.63,69.08,45.25,27.58
07-04-2021,MAÇÃO,2,0,32,"[0,120]",Baixo a Moderado,,,,2,Lisboa e Vale do Tejo,SANTARÉM,1413,39997.98,6267,386,362,390,440,657,1097,1487,1849,2235,15.67,5.59,4.62,3.72
07-04-2021,MACEDO DE CAVALEIROS,3,0,21,"[0,120]",Baixo a Moderado,,,,3,Norte,BRAGANÇA,0405,69914.08,14516,1082,889,878,823,938,1761,2639,3528,4610,20.76,6.59,5.05,3.77
07-04-2021,MACHICO,94,7,470,"[240,480]",Elevado,,,,94,Madeira,MADEIRA,3104,6825.1,19981,1197,860,662,455,331,786,1448,2308,3505,292.76,51.36,33.82,21.22
07-04-2021,MADALENA,0,0,0,"[0,120]",Baixo a Moderado,,,,0,Açores,AÇORES,4602,14712.33,5895,334,256,173,190,179,369,542,798,1132,40.07,7.69,5.42,3.68
07-04-2021,MAFRA,36,3,42,"[0,120]",Baixo a Moderado,,,,36,Lisboa e Vale do Tejo,LISBOA,1109,29165.5,84816,3613,3334,2839,2089,1899,3988,6827,10161,13774,290.81,47.23,34.84,23.41
07-04-2021,MAIA,56,4,40,"[0,120]",Baixo a Moderado,,,,56,Norte,PORTO,1306,8293.94,138971,7801,6617,4512,3339,2631,5970,10482,17099,24900,1675.56,300.22,206.16,126.38
07-04-2021,MANGUALDE,1,0,5,"[0,120]",Baixo a Moderado,,,,1,Centro,VISEU,1806,21925.56,18510,1198,1128,885,852,743,1595,2480,3608,4806,84.42,21.92,16.46,11.31
07-04-2021,MANTEIGAS,0,0,0,"[0,120]",Baixo a Moderado,,,,0,Centro,GUARDA,0908,12197.55,3007,258,197,159,167,146,313,472,669,927,24.65,7.6,5.48,3.87
07-04-2021,MARCO DE CANAVESES,14,1,27,"[0,120]",Baixo a Moderado,,,,14,Norte,PORTO,1307,20188.98,51496,2678,2060,1488,1265,1023,2288,3776,5836,8514,255.07,42.17,28.91,18.7
07-04-2021,MARINHA GRANDE,65,5,169,"[120,240]",Moderado,,,,65,Centro,LEIRIA,1010,18725.19,38508,2365,2302,1638,1359,1058,2417,4055,6357,8722,205.65,46.58,33.95,21.66
07-04-2021,MARVÃO,0,0,0,"[0,120]",Baixo a Moderado,,,,0,Alentejo,PORTALEGRE,1210,15489.9,3005,198,185,142,197,237,434,576,761,959,19.4,6.19,4.91,3.72
07-04-2021,MATOSINHOS,98,7,56,"[0,120]",Baixo a Moderado,,,,98,Norte,PORTO,1308,6241.97,175357,11850,9977,7023,5024,3884,8908,15931,25908,37758,2809.31,604.9,415.06,255.22
07-04-2021,MEALHADA,2,0,10,"[0,120]",Baixo a Moderado,,,,2,Centro,AVEIRO,0111,11065.66,19914,1163,1039,810,828,831,1659,2469,3508,4671,179.96,42.21,31.7,22.31
07-04-2021,MÊDA,2,0,44,"[0,120]",Baixo a Moderado,,,,2,Centro,GUARDA,0909,28604.92,4587,343,306,290,288,443,731,1021,1327,1670,16.04,5.84,4.64,3.57
07-04-2021,MELGAÇO,5,0,62,"[0,120]",Baixo a Moderado,,,,5,Norte,VIANA DO CASTELO,1603,23824.58,8093,507,567,578,614,675,1289,1867,2434,2941,33.97,12.34,10.22,7.84
07-04-2021,MÉRTOLA,4,0,65,"[0,120]",Baixo a Moderado,,,,4,Alentejo,BEJA,0209,129287.34,6142,400,390,378,423,600,1023,1401,1791,2191,4.75,1.69,1.39,1.08
07-04-2021,MESÃO FRIO,0,0,0,"[0,120]",Baixo a Moderado,,,,0,Norte,VILA REAL,1704,2664.87,3964,265,205,168,157,120,277,445,650,915,148.74,34.33,24.39,16.7
07-04-2021,MIRA,8,1,68,"[0,120]",Baixo a Moderado,,,,8,Centro,COIMBRA,0608,12403.38,11832,727,729,659,550,466,1016,1675,2404,3131,95.4,25.24,19.38,13.5
07-04-2021,MIRANDA DO CORVO,21,1,165,"[120,240]",Moderado,,,,21,Centro,COIMBRA,0609,12637.79,12708,706,659,568,498,404,902,1470,2129,2835,100.55,22.43,16.85,11.63
07-04-2021,MIRANDA DO DOURO,0,0,0,"[0,120]",Baixo a Moderado,,,,0,Norte,BRAGANÇA,0406,48718.31,6830,482,429,442,463,470,933,1375,1804,2286,14.02,4.69,3.7,2.82
07-04-2021,MIRANDELA,5,0,23,"[0,120]",Baixo a Moderado,,,,5,Norte,BRAGANÇA,0407,65895.67,21754,1640,1315,1204,1078,947,2025,3229,4544,6184,33.01,9.38,6.9,4.9
07-04-2021,MOGADOURO,0,0,0,"[0,120]",Baixo a Moderado,,,,0,Norte,BRAGANÇA,0408,76064.93,8392,589,529,576,630,655,1285,1861,2390,2979,11.03,3.92,3.14,2.45
07-04-2021,MOIMENTA DA BEIRA,1,0,10,"[0,120]",Baixo a Moderado,,,,1,Norte,VISEU,1807,21996.9,9736,576,514,471,416,461,877,1348,1862,2438,44.26,11.08,8.46,6.13
07-04-2021,MOITA,62,4,96,"[0,120]",Baixo a Moderado,,,,62,Lisboa e Vale do Tejo,SETÚBAL,1506,5525.98,64407,4226,3646,2623,1801,1425,3226,5849,9495,13721,1165.53,248.3,171.82,105.85
07-04-2021,MONÇÃO,5,0,28,"[0,120]",Baixo a Moderado,,,,5,Norte,VIANA DO CASTELO,1604,21130.85,17869,1161,1105,1031,1006,972,1978,3009,4114,5275,84.56,24.96,19.47,14.24
07-04-2021,MONCHIQUE,6,0,118,"[0,120]",Baixo a Moderado,,,,6,Algarve,FARO,0809,39530.43,5077,353,384,321,355,392,747,1068,1452,1805,12.84,4.57,3.67,2.7
07-04-2021,MONDIM DE BASTO,0,0,0,"[0,120]",Baixo a Moderado,,,,0,Norte,VILA REAL,1705,17207.52,6946,395,300,314,284,283,567,881,1181,1576,40.36,9.16,6.86,5.12
07-04-2021,MONFORTE,0,0,0,"[0,120]",Baixo a Moderado,,,,0,Alentejo,PORTALEGRE,1211,42024.82,2975,139,115,117,192,168,360,477,592,731,7.08,1.74,1.41,1.14
07-04-2021,MONTALEGRE,3,0,33,"[0,120]",Baixo a Moderado,,,,3,Norte,VILA REAL,1706,80545.71,8997,699,628,595,603,730,1333,1928,2556,3255,11.17,4.04,3.17,2.39
07-04-2021,MONTEMOR-O-NOVO,4,0,26,"[0,120]",Baixo a Moderado,,,,4,Alentejo,ÉVORA,0706,123296.65,15647,991,953,868,878,971,1849,2717,3670,4661,12.69,3.78,2.98,2.2
07-04-2021,MONTEMOR-O-VELHO,16,1,63,"[0,120]",Baixo a Moderado,,,,16,Centro,COIMBRA,0610,22896.23,25224,1496,1397,1217,1057,988,2045,3262,4659,6155,110.17,26.88,20.35,14.25
07-04-2021,MONTIJO,32,2,56,"[0,120]",Baixo a Moderado,,,,32,Lisboa e Vale do Tejo,SETÚBAL,1507,34861.64,57614,2771,2441,1990,1554,1109,2663,4653,7094,9865,165.26,28.3,20.35,13.35
07-04-2021,MORA,0,0,0,"[0,120]",Baixo a Moderado,,,,0,Alentejo,ÉVORA,0707,44395.02,4138,336,275,252,238,257,495,747,1022,1358,9.32,3.06,2.3,1.68
07-04-2021,MORTÁGUA,1,0,11,"[0,120]",Baixo a Moderado,,,,1,Centro,VISEU,1808,25117.82,8803,638,584,535,499,460,959,1494,2078,2716,35.05,10.81,8.27,5.95
07-04-2021,MOURA,63,4,459,"[240,480]",Elevado,,,,63,Alentejo,BEJA,0210,95845.55,13718,817,656,665,542,461,1003,1668,2324,3141,14.31,3.28,2.42,1.74
07-04-2021,MOURÃO,1,0,41,"[0,120]",Baixo a Moderado,,,,1,Alentejo,ÉVORA,0708,27862.98,2450,139,108,80,104,109,213,293,401,540,8.79,1.94,1.44,1.05
07-04-2021,MURÇA,0,0,0,"[0,120]",Baixo a Moderado,,,,0,Norte,VILA REAL,1707,18937.11,5463,384,341,307,306,319,625,932,1273,1657,28.85,8.75,6.72,4.92
07-04-2021,MURTOSA,8,1,78,"[0,120]",Baixo a Moderado,,,,8,Centro,AVEIRO,0112,7308.78,10279,509,473,403,353,409,762,1165,1638,2147,140.63,29.37,22.41,15.94
07-04-2021,NAZARÉ,3,0,21,"[0,120]",Baixo a Moderado,,,,3,Lisboa e Vale do Tejo,LEIRIA,1011,8243.43,14165,967,903,670,420,396,816,1486,2389,3356,171.84,40.71,28.98,18.03
07-04-2021,NELAS,1,0,8,"[0,120]",Baixo a Moderado,,,,1,Centro,VISEU,1809,12571.48,12974,924,787,668,604,583,1187,1855,2642,3566,103.21,28.37,21.02,14.76
07-04-2021,NISA,2,0,33,"[0,120]",Baixo a Moderado,,,,2,Alentejo,PORTALEGRE,1212,57567.84,6061,405,389,355,483,478,961,1316,1705,2110,10.53,3.67,2.96,2.29
07-04-2021,NORDESTE,28,2,576,"[480,960]",Muito Elevado,,,,28,Açores,AÇORES,4202,10146.8,4862,246,180,124,161,162,323,447,627,873,47.92,8.6,6.18,4.41
07-04-2021,ÓBIDOS,1,0,8,"[0,120]",Baixo a Moderado,,,,1,Lisboa e Vale do Tejo,LEIRIA,1012,14155.44,11850,743,650,574,452,436,888,1462,2112,2855,83.72,20.17,14.92,10.33
07-04-2021,ODEMIRA,84,6,340,"[240,480]",Elevado,,,,84,Alentejo,BEJA,0211,172060.15,24717,1475,1317,1225,1397,1349,2746,3971,5288,6763,14.37,3.93,3.07,2.31
07-04-2021,ODIVELAS,92,7,57,"[0,120]",Baixo a Moderado,,,,92,Lisboa e Vale do Tejo,LISBOA,1116,2654.36,161774,9562,9038,6952,4641,3812,8453,15405,24443,34005,6095.48,1281.27,920.99,580.44
07-04-2021,OEIRAS,137,10,77,"[0,120]",Baixo a Moderado,,,,137,Lisboa e Vale do Tejo,LISBOA,1110,4588.31,177408,11580,11575,8566,6211,5855,12066,20632,32207,43787,3866.78,954.38,701.98,449.69
07-04-2021,OLEIROS,0,0,0,"[0,120]",Baixo a Moderado,,,,0,Centro,CASTELO BRANCO,0506,47109.31,5003,384,341,366,397,487,884,1250,1591,1975,10.62,4.19,3.38,2.65
07-04-2021,OLHÃO,19,1,43,"[0,120]",Baixo a Moderado,,,,19,Algarve,FARO,0810,13086.38,44405,2455,2309,1689,1342,1268,2610,4299,6608,9063,339.33,69.26,50.5,32.85
07-04-2021,OLIVEIRA DE AZEMÉIS,25,2,38,"[0,120]",Baixo a Moderado,,,,25,Norte,AVEIRO,0113,16110.41,66011,4155,3614,2794,2183,1738,3921,6715,10329,14484,409.75,89.91,64.12,41.68
07-04-2021,OLIVEIRA DE FRADES,2,0,20,"[0,120]",Baixo a Moderado,,,,2,Centro,VISEU,1810,14534.62,9936,553,475,438,359,415,774,1212,1687,2240,68.36,15.41,11.61,8.34
07-04-2021,OLIVEIRA DO BAIRRO,7,1,29,"[0,120]",Baixo a Moderado,,,,7,Centro,AVEIRO,0114,8731.99,24277,1327,1182,999,786,810,1596,2595,3777,5104,278.02,58.45,43.25,29.72
07-04-2021,OLIVEIRA DO HOSPITAL,7,0,36,"[0,120]",Baixo a Moderado,,,,7,Centro,COIMBRA,0611,23451.66,19253,1161,1097,962,924,960,1884,2846,3943,5104,82.1,21.76,16.81,12.14
07-04-2021,OURÉM,11,1,25,"[0,120]",Baixo a Moderado,,,,11,Lisboa e Vale do Tejo,SANTARÉM,1421,41668.03,44044,2463,2069,1899,1817,1603,3420,5319,7388,9851,105.7,23.64,17.73,12.77
07-04-2021,OURIQUE,0,0,0,"[0,120]",Baixo a Moderado,,,,0,Alentejo,BEJA,0212,66331.36,4607,313,287,284,268,227,495,779,1066,1379,6.95,2.08,1.61,1.17
07-04-2021,OVAR,22,2,41,"[0,120]",Baixo a Moderado,,,,22,Centro,AVEIRO,0115,14770.25,54260,3294,2709,1994,1636,1234,2870,4864,7573,10867,367.37,73.57,51.27,32.93
07-04-2021,PAÇOS DE FERREIRA,75,5,132,"[120,240]",Moderado,,,,75,Norte,PORTO,1309,7099.29,56728,2903,2193,1518,1135,664,1799,3317,5510,8413,799.1,118.51,77.62,46.72
07-04-2021,PALMELA,30,2,47,"[0,120]",Baixo a Moderado,,,,30,Lisboa e Vale do Tejo,SETÚBAL,1508,46512.01,64269,3402,3244,2635,1846,1391,3237,5872,9116,12518,138.18,26.91,19.6,12.62
07-04-2021,PAMPILHOSA DA SERRA,1,0,25,"[0,120]",Baixo a Moderado,,,,1,Centro,COIMBRA,0612,39646.24,4037,238,254,295,339,423,762,1057,1311,1549,10.18,3.91,3.31,2.67
07-04-2021,PAREDES,71,5,82,"[0,120]",Baixo a Moderado,,,,71,Norte,PORTO,1310,15675.69,86067,4272,3532,2412,1717,1258,2975,5387,8919,13191,549.04,84.15,56.9,34.36
07-04-2021,PAREDES DE COURA,3,0,35,"[0,120]",Baixo a Moderado,,,,3,Norte,VIANA DO CASTELO,1605,13818.59,8535,466,528,407,465,515,980,1387,1915,2381,61.76,17.23,13.86,10.04
07-04-2021,PEDRÓGÃO GRANDE,2,0,59,"[0,120]",Baixo a Moderado,,,,2,Centro,LEIRIA,1013,12874.75,3410,175,173,196,221,252,473,669,842,1017,26.49,7.9,6.54,5.2
07-04-2021,PENACOVA,6,0,44,"[0,120]",Baixo a Moderado,,,,6,Centro,COIMBRA,0613,21673.23,13694,968,923,745,621,703,1324,2069,2992,3960,63.18,18.27,13.81,9.55
07-04-2021,PENAFIEL,28,2,40,"[0,120]",Baixo a Moderado,,,,28,Norte,PORTO,1311,21224.27,69772,3648,2823,2032,1663,1230,2893,4925,7748,11396,328.74,53.69,36.51,23.2
07-04-2021,PENALVA DO CASTELO,9,1,126,"[120,240]",Moderado,,,,9,Centro,VISEU,1811,13433.92,7115,449,457,413,391,426,817,1230,1687,2136,52.96,15.9,12.56,9.16
07-04-2021,PENAMACOR,0,0,0,"[0,120]",Baixo a Moderado,,,,0,Centro,CASTELO BRANCO,0507,56370.69,4755,262,248,273,451,633,1084,1357,1605,1867,8.44,3.31,2.85,2.41
07-04-2021,PENEDONO,1,0,39,"[0,120]",Baixo a Moderado,,,,1,Norte,VISEU,1812,13370.75,2591,172,113,129,156,138,294,423,536,708,19.38,5.3,4.01,3.16
07-04-2021,PENELA,11,1,204,"[120,240]",Moderado,,,,11,Centro,COIMBRA,0614,13480.0,5397,314,324,274,359,344,703,977,1301,1615,40.04,11.98,9.65,7.25
07-04-2021,PENICHE,17,1,64,"[0,120]",Baixo a Moderado,,,,17,Lisboa e Vale do Tejo,LEIRIA,1014,7754.98,26501,1746,1504,1203,926,707,1633,2836,4340,6086,341.73,78.48,55.96,36.57
07-04-2021,PESO DA RÉGUA,15,1,95,"[0,120]",Baixo a Moderado,,,,15,Norte,VILA REAL,1708,9486.01,15773,1076,843,650,659,455,1114,1764,2607,3683,166.28,38.83,27.48,18.6
07-04-2021,PINHEL,0,0,0,"[0,120]",Baixo a Moderado,,,,0,Centro,GUARDA,0910,48452.12,8511,577,566,551,538,689,1227,1778,2344,2921,17.57,6.03,4.84,3.67
07-04-2021,POMBAL,10,1,19,"[0,120]",Baixo a Moderado,,,,10,Centro,LEIRIA,1015,62600.28,51461,3187,2791,2494,2328,2027,4355,6849,9640,12827,82.21,20.49,15.4,10.94
07-04-2021,PONTA DELGADA,87,6,128,"[120,240]",Moderado,,,,87,Açores,AÇORES,4203,23298.65,67935,3108,2435,1726,1133,902,2035,3761,6196,9304,291.58,39.93,26.59,16.14
07-04-2021,PONTA DO SOL,7,0,81,"[0,120]",Baixo a Moderado,,,,7,Madeira,MADEIRA,3105,4622.03,8593,319,283,347,208,221,429,776,1059,1378,185.92,29.81,22.91,16.79
07-04-2021,PONTE DA BARCA,9,1,81,"[0,120]",Baixo a Moderado,,,,9,Norte,VIANA DO CASTELO,1606,18211.37,11180,635,576,517,554,490,1044,1561,2137,2772,61.39,15.22,11.73,8.57
07-04-2021,PONTE DE LIMA,11,1,27,"[0,120]",Baixo a Moderado,,,,11,Norte,VIANA DO CASTELO,1607,32025.46,41315,2321,2022,1720,1596,1462,3058,4778,6800,9121,129.01,28.48,21.23,14.92
07-04-2021,PONTE DE SOR,5,0,33,"[0,120]",Baixo a Moderado,,,,5,Alentejo,PORTALEGRE,1213,83971.16,14994,939,800,716,739,831,1570,2286,3086,4025,17.86,4.79,3.68,2.72
07-04-2021,PORTALEGRE,3,0,14,"[0,120]",Baixo a Moderado,,,,3,Alentejo,PORTALEGRE,1214,44713.64,22172,1577,1351,1137,993,984,1977,3114,4465,6042,49.59,13.51,9.99,6.96
07-04-2021,PORTEL,1,0,17,"[0,120]",Baixo a Moderado,,,,1,Alentejo,ÉVORA,0709,60100.57,5828,336,358,283,331,305,636,919,1277,1613,9.7,2.68,2.12,1.53
07-04-2021,PORTIMÃO,176,13,317,"[240,480]",Elevado,,,,176,Algarve,FARO,0811,18206.29,55483,3182,2927,2116,1582,1400,2982,5098,8025,11207,304.75,61.56,44.08,28.0
07-04-2021,PORTO,169,12,78,"[0,120]",Baixo a Moderado,,,,169,Norte,PORTO,1312,4142.02,216606,15790,15193,11280,9409,10044,19453,30733,45926,61716,5229.5,1490.0,1108.79,741.98
07-04-2021,PORTO DE MÓS,30,2,129,"[120,240]",Moderado,,,,30,Centro,LEIRIA,1016,26183.41,23275,1355,1210,1034,888,872,1760,2794,4004,5359,88.89,20.47,15.29,10.67
07-04-2021,PORTO MONIZ,3,0,128,"[120,240]",Moderado,,,,3,Madeira,MADEIRA,3106,8293.38,2342,143,130,95,98,120,218,313,443,586,28.24,7.07,5.34,3.77
07-04-2021,PORTO SANTO,1,0,19,"[0,120]",Baixo a Moderado,,,,1,Madeira,MADEIRA,3201,4300.7,5202,240,157,134,110,68,178,312,469,709,120.95,16.48,10.9,7.25
07-04-2021,PÓVOA DE LANHOSO,6,0,28,"[0,120]",Baixo a Moderado,,,,6,Norte,BRAGA,0309,13465.29,21499,1175,909,732,673,624,1297,2029,2938,4113,159.67,30.55,21.82,15.07
07-04-2021,PÓVOA DE VARZIM,67,5,107,"[0,120]",Baixo a Moderado,,,,67,Norte,PORTO,1313,8220.59,62784,3712,3120,2134,1594,1305,2899,5033,8153,11865,763.7,144.33,99.17,61.22
07-04-2021,POVOAÇÃO,0,0,0,"[0,120]",Baixo a Moderado,,,,0,Açores,AÇORES,4204,10640.77,5927,293,212,191,144,134,278,469,681,974,55.7,9.15,6.4,4.41
07-04-2021,VILA DA PRAIA DA VITÓRIA,0,0,0,"[0,120]",Baixo a Moderado,,,,0,Açores,AÇORES,4302,16127.06,21317,1133,789,619,436,336,772,1391,2180,3313,132.18,20.54,13.52,8.63
07-04-2021,PROENÇA-A-NOVA,1,0,14,"[0,120]",Baixo a Moderado,,,,1,Centro,CASTELO BRANCO,0508,39539.96,7298,508,465,389,400,560,960,1349,1814,2322,18.46,5.87,4.59,3.41
07-04-2021,REDONDO,3,0,47,"[0,120]",Baixo a Moderado,,,,3,Alentejo,ÉVORA,0710,36950.87,6353,349,325,288,288,354,642,930,1255,1604,17.19,4.34,3.4,2.52
07-04-2021,REGUENGOS DE MONSARAZ,3,0,30,"[0,120]",Baixo a Moderado,,,,3,Alentejo,ÉVORA,0711,46399.72,10015,602,511,455,462,473,935,1390,1901,2503,21.58,5.39,4.1,3.0
07-04-2021,RESENDE,8,1,79,"[0,120]",Baixo a Moderado,,,,8,Norte,VISEU,1813,12334.93,10137,560,493,448,433,422,855,1303,1796,2356,82.18,19.1,14.56,10.56
07-04-2021,RIBEIRA BRAVA,14,1,113,"[0,120]",Baixo a Moderado,,,,14,Madeira,MADEIRA,3107,6544.88,12435,648,500,411,311,287,598,1009,1509,2157,189.99,32.96,23.06,15.42
07-04-2021,RIBEIRA DE PENA,8,1,133,"[120,240]",Moderado,,,,8,Norte,VILA REAL,1709,21745.98,6016,371,301,290,310,368,678,968,1269,1640,27.66,7.54,5.84,4.45
07-04-2021,RIBEIRA GRANDE,10,1,30,"[0,120]",Baixo a Moderado,,,,10,Açores,AÇORES,4205,18015.13,32811,1163,689,512,345,253,598,1110,1799,2962,182.13,16.44,9.99,6.16
07-04-2021,RIO MAIOR,58,4,285,"[240,480]",Elevado,,,,58,Lisboa e Vale do Tejo,SANTARÉM,1414,27276.45,20379,1251,1144,941,795,648,1443,2384,3528,4779,74.71,17.52,12.93,8.74
07-04-2021,SABROSA,0,0,0,"[0,120]",Baixo a Moderado,,,,0,Norte,VILA REAL,1710,15692.45,5918,393,314,304,302,350,652,956,1270,1663,37.71,10.6,8.09,6.09
07-04-2021,SABUGAL,1,0,9,"[0,120]",Baixo a Moderado,,,,1,Centro,GUARDA,0911,82269.82,10585,724,707,694,796,1009,1805,2499,3206,3930,12.87,4.78,3.9,3.04
07-04-2021,SALVATERRA DE MAGOS,0,0,0,"[0,120]",Baixo a Moderado,,,,0,Lisboa e Vale do Tejo,SANTARÉM,1415,24393.2,21295,1275,1181,1060,799,772,1571,2631,3812,5087,87.3,20.85,15.63,10.79
07-04-2021,SANTA COMBA DÃO,8,1,77,"[0,120]",Baixo a Moderado,,,,8,Centro,VISEU,1814,11194.77,10452,732,684,569,538,464,1002,1571,2255,2987,93.36,26.68,20.14,14.03
07-04-2021,SANTA CRUZ,58,4,128,"[120,240]",Moderado,,,,58,Madeira,MADEIRA,3108,8150.28,45281,1817,1301,974,716,523,1239,2213,3514,5331,555.6,65.41,43.12,27.15
07-04-2021,SANTA CRUZ DA GRACIOSA,0,0,0,"[0,120]",Baixo a Moderado,,,,0,Açores,AÇORES,4401,6065.78,4208,228,180,163,124,145,269,432,612,840,69.37,13.85,10.09,7.12
07-04-2021,SANTA CRUZ DAS FLORES,0,0,0,"[0,120]",Baixo a Moderado,,,,0,Açores,AÇORES,4802,7091.44,2165,125,98,74,56,51,107,181,279,404,30.53,5.7,3.93,2.55
07-04-2021,SANTA MARIA DA FEIRA,37,3,27,"[0,120]",Baixo a Moderado,,,,37,Norte,AVEIRO,0109,21587.65,138636,8182,6743,4771,3856,3079,6935,11706,18449,26631,642.19,123.36,85.46,54.22
07-04-2021,SANTA MARTA DE PENAGUIÃO,0,0,0,"[0,120]",Baixo a Moderado,,,,0,Norte,VILA REAL,1711,6928.13,6599,483,373,337,316,317,633,970,1343,1826,95.25,26.36,19.39,14.0
07-04-2021,SANTANA,10,1,149,"[120,240]",Moderado,,,,10,Madeira,MADEIRA,3109,9547.3,6711,418,353,343,282,277,559,902,1255,1673,70.29,17.52,13.15,9.45
07-04-2021,SANTARÉM,13,1,23,"[0,120]",Baixo a Moderado,,,,13,Lisboa e Vale do Tejo,SANTARÉM,1416,55253.58,57421,3654,3441,2760,2466,2206,4672,7432,10873,14527,103.92,26.29,19.68,13.45
07-04-2021,SANTIAGO DO CACÉM,5,0,17,"[0,120]",Baixo a Moderado,,,,5,Alentejo,SETÚBAL,1509,105969.29,28791,2144,1689,1472,1295,1215,2510,3982,5671,7815,27.17,7.37,5.35,3.76
07-04-2021,SANTO TIRSO,52,4,76,"[0,120]",Baixo a Moderado,,,,52,Norte,PORTO,1314,13655.52,68055,4911,3935,2761,2257,1810,4067,6828,10763,15674,498.35,114.78,78.82,50.0
07-04-2021,SÃO BRÁS DE ALPORTEL,0,0,0,"[0,120]",Baixo a Moderado,,,,0,Algarve,FARO,0812,15336.92,10416,596,468,467,404,401,805,1272,1740,2336,67.91,15.23,11.35,8.29
07-04-2021,SÃO JOÃO DA MADEIRA,1,0,5,"[0,120]",Baixo a Moderado,,,,1,Norte,AVEIRO,0116,794.3,21958,1347,1069,796,601,593,1194,1990,3059,4406,2765.49,554.91,385.26,250.63
07-04-2021,SÃO JOÃO DA PESQUEIRA,2,0,28,"[0,120]",Baixo a Moderado,,,,2,Norte,VISEU,1815,26610.85,7125,417,330,294,328,328,656,950,1280,1697,26.77,6.38,4.81,3.57
07-04-2021,SÃO PEDRO DO SUL,2,0,13,"[0,120]",Baixo a Moderado,,,,2,Centro,VISEU,1816,34895.09,15403,990,962,861,759,909,1668,2529,3491,4481,44.14,12.84,10.0,7.25
07-04-2021,SÃO ROQUE DO PICO,0,0,0,"[0,120]",Baixo a Moderado,,,,0,Açores,AÇORES,4603,14236.1,3266,199,141,93,96,113,209,302,443,642,22.94,4.51,3.11,2.12
07-04-2021,SÃO VICENTE,6,0,117,"[0,120]",Baixo a Moderado,,,,6,Madeira,MADEIRA,3110,7883.71,5143,272,264,266,225,280,505,771,1035,1307,65.23,16.58,13.13,9.78
07-04-2021,SARDOAL,1,0,27,"[0,120]",Baixo a Moderado,,,,1,Lisboa e Vale do Tejo,SANTARÉM,1417,9214.72,3741,227,178,148,165,248,413,561,739,966,40.6,10.48,8.02,6.09
07-04-2021,SÁTÃO,2,0,17,"[0,120]",Baixo a Moderado,,,,2,Centro,VISEU,1817,20194.11,11580,765,671,515,465,476,941,1456,2127,2892,57.34,14.32,10.53,7.21
07-04-2021,SEIA,0,0,0,"[0,120]",Baixo a Moderado,,,,0,Centro,GUARDA,0912,43568.83,22234,1807,1589,1238,1122,721,1843,3081,4670,6477,51.03,14.87,10.72,7.07
07-04-2021,SEIXAL,91,6,54,"[0,120]",Baixo a Moderado,,,,91,Lisboa e Vale do Tejo,SETÚBAL,1510,9545.17,167752,10586,9270,6661,4391,2930,7321,13982,23252,33838,1757.49,354.51,243.6,146.49
07-04-2021,SERNANCELHE,1,0,19,"[0,120]",Baixo a Moderado,,,,1,Norte,VISEU,1818,22861.22,5396,305,293,286,273,260,533,819,1112,1417,23.6,6.2,4.86,3.58
07-04-2021,SERPA,6,0,42,"[0,120]",Baixo a Moderado,,,,6,Alentejo,BEJA,0213,110563.34,14304,903,761,719,697,626,1323,2042,2803,3706,12.94,3.35,2.54,1.85
07-04-2021,SERTÃ,1,0,7,"[0,120]",Baixo a Moderado,,,,1,Centro,CASTELO BRANCO,0509,44673.17,14577,870,779,790,767,1020,1787,2577,3356,4226,32.63,9.46,7.51,5.77
07-04-2021,SESIMBRA,23,2,44,"[0,120]",Baixo a Moderado,,,,23,Lisboa e Vale do Tejo,SETÚBAL,1511,19571.75,51858,2400,2321,1853,1257,1083,2340,4193,6514,8914,264.96,45.54,33.28,21.42
07-04-2021,SETÚBAL,71,5,62,"[0,120]",Baixo a Moderado,,,,71,Lisboa e Vale do Tejo,SETÚBAL,1512,23032.5,115126,7425,6929,5075,3775,2655,6430,11505,18434,25859,499.83,112.27,80.03,49.95
07-04-2021,SEVER DO VOUGA,1,0,9,"[0,120]",Baixo a Moderado,,,,1,Centro,AVEIRO,0117,12987.56,11331,766,637,568,540,567,1107,1675,2312,3078,87.24,23.7,17.8,12.9
07-04-2021,SILVES,27,2,75,"[0,120]",Baixo a Moderado,,,,27,Algarve,FARO,0813,68006.23,36226,2137,1869,1610,1423,1600,3023,4633,6502,8639,53.27,12.7,9.56,6.81
07-04-2021,SINES,4,0,29,"[0,120]",Baixo a Moderado,,,,4,Alentejo,SETÚBAL,1513,20330.17,13715,888,791,551,416,268,684,1235,2026,2914,67.46,14.33,9.97,6.07
07-04-2021,SINTRA,360,26,92,"[0,120]",Baixo a Moderado,,,,360,Lisboa e Vale do Tejo,LISBOA,1111,31922.73,391402,20490,18316,13545,9137,7284,16421,29966,48282,68772,1226.08,215.43,151.25,93.87
07-04-2021,SOBRAL DE MONTE AGRAÇO,8,1,75,"[0,120]",Baixo a Moderado,,,,8,Lisboa e Vale do Tejo,LISBOA,1112,5210.32,10651,564,507,352,272,212,484,836,1343,1907,204.43,36.6,25.78,16.05
07-04-2021,SOURE,8,1,47,"[0,120]",Baixo a Moderado,,,,8,Centro,COIMBRA,0615,26506.07,17120,1173,1142,1004,883,987,1870,2874,4016,5189,64.59,19.58,15.15,10.84
07-04-2021,SOUSEL,1,0,23,"[0,120]",Baixo a Moderado,,,,1,Alentejo,PORTALEGRE,1215,27932.18,4412,261,274,208,302,292,594,802,1076,1337,15.8,4.79,3.85,2.87
07-04-2021,TÁBUA,4,0,35,"[0,120]",Baixo a Moderado,,,,4,Centro,COIMBRA,0616,19978.58,11368,729,584,524,430,464,894,1418,2002,2731,56.9,13.67,10.02,7.1
07-04-2021,TABUAÇO,1,0,17,"[0,120]",Baixo a Moderado,,,,1,Norte,VISEU,1819,13385.67,6033,372,314,217,282,363,645,862,1176,1548,45.07,11.56,8.79,6.44
07-04-2021,TAROUCA,1,0,13,"[0,120]",Baixo a Moderado,,,,1,Norte,VISEU,1820,10008.49,7804,405,335,313,277,324,601,914,1249,1654,77.98,16.53,12.48,9.13
07-04-2021,TAVIRA,12,1,49,"[0,120]",Baixo a Moderado,,,,12,Algarve,FARO,0814,60696.7,24530,1493,1415,1252,1066,1277,2343,3595,5010,6503,40.41,10.71,8.25,5.92
07-04-2021,TERRAS DE BOURO,1,0,16,"[0,120]",Baixo a Moderado,,,,1,Norte,BRAGA,0310,27746.07,6361,391,372,296,319,340,659,955,1327,1718,22.93,6.19,4.78,3.44
07-04-2021,TOMAR,10,1,27,"[0,120]",Baixo a Moderado,,,,10,Lisboa e Vale do Tejo,SANTARÉM,1418,35120.44,36748,2403,2189,1868,1853,1822,3675,5543,7732,10135,104.64,28.86,22.02,15.78
07-04-2021,TONDELA,9,1,34,"[0,120]",Baixo a Moderado,,,,9,Centro,VISEU,1821,37121.73,26357,1768,1722,1518,1475,1417,2892,4410,6132,7900,71.0,21.28,16.52,11.88
07-04-2021,TORRE DE MONCORVO,4,0,52,"[0,120]",Baixo a Moderado,,,,4,Norte,BRAGANÇA,0409,53155.67,7695,556,478,488,551,719,1270,1758,2236,2792,14.48,5.25,4.21,3.31
07-04-2021,TORRES NOVAS,6,0,17,"[0,120]",Baixo a Moderado,,,,6,Lisboa e Vale do Tejo,SANTARÉM,1419,26999.68,34933,2324,1979,1738,1406,1475,2881,4619,6598,8922,129.38,33.04,24.44,17.11
07-04-2021,TORRES VEDRAS,72,5,92,"[0,120]",Baixo a Moderado,,,,72,Lisboa e Vale do Tejo,LISBOA,1113,40714.89,78530,4513,3945,3447,2628,2104,4732,8179,12124,16637,192.88,40.86,29.78,20.09
07-04-2021,TRANCOSO,2,0,23,"[0,120]",Baixo a Moderado,,,,2,Centro,GUARDA,0913,36152.47,8875,581,557,542,586,496,1082,1624,2181,2762,24.55,7.64,6.03,4.49
07-04-2021,TROFA,40,3,104,"[0,120]",Baixo a Moderado,,,,40,Norte,PORTO,1318,7201.76,38418,2336,1894,1231,939,684,1623,2854,4748,7084,533.44,98.36,65.93,39.63
07-04-2021,VAGOS,10,1,44,"[0,120]",Baixo a Moderado,,,,10,Centro,AVEIRO,0118,16491.5,22740,1320,1205,922,784,724,1508,2430,3635,4955,137.89,30.04,22.04,14.73
07-04-2021,VALE DE CAMBRA,7,1,33,"[0,120]",Baixo a Moderado,,,,7,Norte,AVEIRO,0119,14733.47,21327,1491,1363,1005,831,798,1629,2634,3997,5488,144.76,37.25,27.13,17.88
07-04-2021,VALENÇA,8,1,60,"[0,120]",Baixo a Moderado,,,,8,Norte,VIANA DO CASTELO,1608,11712.86,13290,867,791,582,582,503,1085,1667,2458,3325,113.46,28.39,20.99,14.23
07-04-2021,VALONGO,101,7,104,"[0,120]",Baixo a Moderado,,,,101,Norte,PORTO,1315,7512.45,97444,5629,4696,3207,2462,1829,4291,7498,12194,17823,1297.18,237.26,162.33,99.81
07-04-2021,VALPAÇOS,8,1,54,"[0,120]",Baixo a Moderado,,,,8,Norte,VILA REAL,1712,54873.93,14818,1217,1118,999,928,997,1925,2924,4042,5259,27.0,9.58,7.37,5.33
07-04-2021,VELAS,0,0,0,"[0,120]",Baixo a Moderado,,,,0,Açores,AÇORES,4502,11738.38,5093,278,208,166,153,113,266,432,640,918,43.39,7.82,5.45,3.68
07-04-2021,VENDAS NOVAS,0,0,0,"[0,120]",Baixo a Moderado,,,,0,Alentejo,ÉVORA,0712,22238.88,11255,677,768,655,501,532,1033,1688,2456,3133,50.61,14.09,11.04,7.59
07-04-2021,VIANA DO ALENTEJO,1,0,19,"[0,120]",Baixo a Moderado,,,,1,Alentejo,ÉVORA,0713,39367.29,5145,245,208,235,210,214,424,659,867,1112,13.07,2.82,2.2,1.67
07-04-2021,VIANA DO CASTELO,43,3,51,"[0,120]",Baixo a Moderado,,,,43,Norte,VIANA DO CASTELO,1609,31902.01,84417,5470,4433,3591,3061,2982,6043,9634,14067,19537,264.61,61.24,44.09,30.2
07-04-2021,VIDIGUEIRA,0,0,0,"[0,120]",Baixo a Moderado,,,,0,Alentejo,BEJA,0214,31661.09,5510,300,248,215,233,275,508,723,971,1271,17.4,4.01,3.07,2.28
07-04-2021,VIEIRA DO MINHO,6,0,51,"[0,120]",Baixo a Moderado,,,,6,Norte,BRAGA,0311,21644.35,11842,703,594,525,548,482,1030,1555,2149,2852,54.71,13.18,9.93,7.18
07-04-2021,VILA DE REI,2,0,60,"[0,120]",Baixo a Moderado,,,,2,Centro,CASTELO BRANCO,0510,19154.6,3323,169,128,172,247,302,549,721,849,1018,17.35,5.31,4.43,3.76
07-04-2021,VILA DO BISPO,9,1,175,"[120,240]",Moderado,,,,9,Algarve,FARO,0815,17906.06,5154,302,302,314,232,233,465,779,1081,1383,28.78,7.72,6.04,4.35
07-04-2021,VILA DO CONDE,29,2,36,"[0,120]",Baixo a Moderado,,,,29,Norte,PORTO,1316,14902.77,79899,4726,3875,2819,2070,1743,3813,6632,10507,15233,536.13,102.21,70.5,44.5
07-04-2021,VILA DO PORTO,1,0,18,"[0,120]",Baixo a Moderado,,,,1,Açores,AÇORES,4101,9688.74,5616,274,212,135,96,123,219,354,566,840,57.96,8.67,5.84,3.65
07-04-2021,VILA FLOR,2,0,33,"[0,120]",Baixo a Moderado,,,,2,Norte,BRAGANÇA,0410,26581.14,6044,429,362,422,294,331,625,1047,1409,1838,22.74,6.91,5.3,3.94
07-04-2021,VILA FRANCA DE XIRA,207,15,146,"[120,240]",Moderado,,,,207,Lisboa e Vale do Tejo,LISBOA,1114,31819.39,141957,8501,6852,4869,3425,2472,5897,10766,17618,26119,446.14,82.09,55.37,33.84
07-04-2021,VILA FRANCA DO CAMPO,30,2,271,"[240,480]",Elevado,,,,30,Açores,AÇORES,4206,7796.82,11051,450,344,248,217,154,371,619,963,1413,141.73,18.12,12.35,7.94
07-04-2021,VILA NOVA DA BARQUINHA,7,1,94,"[0,120]",Baixo a Moderado,,,,7,Lisboa e Vale do Tejo,SANTARÉM,1420,4952.97,7461,415,406,392,364,338,702,1094,1500,1915,150.64,38.66,30.28,22.09
07-04-2021,VILA NOVA DE CERVEIRA,3,0,34,"[0,120]",Baixo a Moderado,,,,3,Norte,VIANA DO CASTELO,1610,10846.66,8910,531,444,410,384,334,718,1128,1572,2103,82.14,19.39,14.49,10.4
07-04-2021,VILA NOVA DE FAMALICÃO,111,8,84,"[0,120]",Baixo a Moderado,,,,111,Norte,BRAGA,0312,20159.26,131676,7817,6164,4202,3282,2749,6031,10233,16397,24214,653.19,120.12,81.34,50.76
07-04-2021,VILA NOVA DE FOZ CÔA,0,0,0,"[0,120]",Baixo a Moderado,,,,0,Centro,GUARDA,0914,39815.18,6503,442,385,390,398,429,827,1217,1602,2044,16.33,5.13,4.02,3.06
07-04-2021,VILA NOVA DE GAIA,135,10,45,"[0,120]",Baixo a Moderado,,,,135,Norte,PORTO,1317,16846.43,300472,18349,15568,10972,8224,6281,14505,25477,41045,59394,1783.64,352.57,243.65,151.23
07-04-2021,VILA NOVA DE PAIVA,0,0,0,"[0,120]",Baixo a Moderado,,,,0,Centro,VISEU,1822,17553.28,4687,289,272,233,217,241,458,691,963,1252,26.7,7.13,5.49,3.94
07-04-2021,VILA NOVA DE POIARES,0,0,0,"[0,120]",Baixo a Moderado,,,,0,Centro,COIMBRA,0617,8445.3,6939,380,284,262,235,182,417,679,963,1343,82.17,15.9,11.4,8.04
07-04-2021,VILA POUCA DE AGUIAR,0,0,0,"[0,120]",Baixo a Moderado,,,,0,Norte,VILA REAL,1713,43706.62,11961,860,817,733,601,627,1228,1961,2778,3638,27.37,8.32,6.36,4.49
07-04-2021,VILA REAL,4,0,8,"[0,120]",Baixo a Moderado,,,,4,Norte,VILA REAL,1714,37880.28,49962,3025,2498,2065,1579,1466,3045,5110,7608,10633,131.9,28.07,20.08,13.49
07-04-2021,VILA REAL DE SANTO ANTÓNIO,6,0,32,"[0,120]",Baixo a Moderado,,,,6,Algarve,FARO,0816,6125.0,18749,1172,1069,811,569,586,1155,1966,3035,4207,306.11,68.69,49.55,32.1
07-04-2021,VILA VELHA DE RÓDÃO,0,0,0,"[0,120]",Baixo a Moderado,,,,0,Centro,CASTELO BRANCO,0511,32991.16,3144,209,229,180,283,306,589,769,998,1207,9.53,3.66,3.03,2.33
07-04-2021,VILA VERDE,24,2,51,"[0,120]",Baixo a Moderado,,,,24,Norte,BRAGA,0313,22866.52,46911,2365,2063,1667,1494,1437,2931,4598,6661,9026,205.15,39.47,29.13,20.11
07-04-2021,VILA VIÇOSA,0,0,0,"[0,120]",Baixo a Moderado,,,,0,Alentejo,ÉVORA,0714,19485.89,7656,487,379,342,345,324,669,1011,1390,1877,39.29,9.63,7.13,5.19
07-04-2021,VIMIOSO,9,1,224,"[120,240]",Moderado,,,,9,Norte,BRAGANÇA,0411,48158.51,4023,274,230,261,293,335,628,889,1119,1393,8.35,2.89,2.32,1.85
07-04-2021,VINHAIS,2,0,26,"[0,120]",Baixo a Moderado,,,,2,Norte,BRAGANÇA,0412,69475.09,7746,599,577,636,641,815,1456,2092,2669,3268,11.15,4.7,3.84,3.01
07-04-2021,VISEU,10,1,10,"[0,120]",Baixo a Moderado,,,,10,Centro,VISEU,1823,50710.14,97249,5769,5038,4140,3158,2710,5868,10008,15046,20815,191.77,41.05,29.67,19.74
07-04-2021,VIZELA,6,0,25,"[0,120]",Baixo a Moderado,,,,6,Norte,BRAGA,0314,2469.83,23897,1258,928,655,509,371,880,1535,2463,3721,967.49,150.65,99.72,62.15
07-04-2021,VOUZELA,2,0,21,"[0,120]",Baixo a Moderado,,,,2,Centro,VISEU,1824,19369.46,9619,626,605,554,532,507,1039,1593,2198,2824,49.66,14.58,11.35,8.22
14-04-2021,ABRANTES,13,1,37,"[0,120]",Baixo a Moderado,,,,13,Lisboa e Vale do Tejo,SANTARÉM,1401,71469.08,35130,2473,2213,1730,1748,2021,3769,5499,7712,10185,49.15,14.25,10.79,7.69
14-04-2021,ÁGUEDA,4,0,9,"[0,120]",Baixo a Moderado,,,,4,Centro,AVEIRO,0101,33527.44,46075,3237,2713,2090,1635,1496,3131,5221,7934,11171,137.43,33.32,23.66,15.57
14-04-2021,AGUIAR DA BEIRA,3,0,64,"[0,120]",Baixo a Moderado,,,,3,Centro,GUARDA,0901,20676.57,4652,304,281,235,239,148,387,622,903,1207,22.5,5.84,4.37,3.01
14-04-2021,ALANDROAL,18,1,361,"[240,480]",Elevado,,,,18,Alentejo,ÉVORA,0701,54267.81,4992,307,256,296,299,377,676,972,1228,1535,9.2,2.83,2.26,1.79
14-04-2021,ALBERGARIA-A-VELHA,14,1,58,"[0,120]",Baixo a Moderado,,,,14,Centro,AVEIRO,0102,15882.5,24144,1550,1298,996,687,680,1367,2363,3661,5211,152.02,32.81,23.05,14.88
14-04-2021,ALBUFEIRA,94,7,226,"[120,240]",Moderado,,,,94,Algarve,FARO,0801,14066.42,41528,2067,1717,1425,985,858,1843,3268,4985,7052,295.24,50.14,35.44,23.23
14-04-2021,ALCÁCER DO SAL,2,0,17,"[0,120]",Baixo a Moderado,,,,2,Alentejo,SETÚBAL,1501,149987.3,11659,884,814,623,623,602,1225,1848,2662,3546,7.77,2.36,1.77,1.23
14-04-2021,ALCANENA,3,0,23,"[0,120]",Baixo a Moderado,,,,3,Lisboa e Vale do Tejo,SANTARÉM,1402,12732.86,12809,891,744,628,536,588,1124,1752,2496,3387,100.6,26.6,19.6,13.76
14-04-2021,ALCOBAÇA,15,1,28,"[0,120]",Baixo a Moderado,,,,15,Lisboa e Vale do Tejo,LEIRIA,1001,40814.09,53555,3420,2927,2466,2059,1676,3735,6201,9128,12548,131.22,30.74,22.36,15.19
14-04-2021,ALCOCHETE,3,0,15,"[0,120]",Baixo a Moderado,,,,3,Lisboa e Vale do Tejo,SETÚBAL,1502,12836.48,19787,857,834,691,476,447,923,1614,2448,3305,154.15,25.75,19.07,12.57
14-04-2021,ALCOUTIM,0,0,0,"[0,120]",Baixo a Moderado,,,,0,Algarve,FARO,0802,57536.33,2159,191,188,163,190,267,457,620,808,999,3.75,1.74,1.4,1.08
14-04-2021,ALENQUER,14,1,32,"[0,120]",Baixo a Moderado,,,,14,Lisboa e Vale do Tejo,LISBOA,1101,30421.92,44052,2298,2062,1629,1330,1155,2485,4114,6176,8474,144.8,27.85,20.3,13.52
14-04-2021,ALFÂNDEGA DA FÉ,0,0,0,"[0,120]",Baixo a Moderado,,,,0,Norte,BRAGANÇA,0401,32194.64,4550,325,277,301,274,325,599,900,1177,1502,14.13,4.67,3.66,2.8
14-04-2021,ALIJÓ,12,1,113,"[0,120]",Baixo a Moderado,,,,12,Norte,VILA REAL,1701,29759.89,10625,766,687,635,542,666,1208,1843,2530,3296,35.7,11.08,8.5,6.19
14-04-2021,ALJEZUR,17,1,304,"[240,480]",Elevado,,,,17,Algarve,FARO,0803,32349.95,5594,316,336,335,320,410,730,1065,1401,1717,17.29,5.31,4.33,3.29
14-04-2021,ALJUSTREL,1,0,12,"[0,120]",Baixo a Moderado,,,,1,Alentejo,BEJA,0201,45847.41,8247,635,521,443,347,358,705,1148,1669,2304,17.99,5.03,3.64,2.5
14-04-2021,ALMADA,171,12,101,"[0,120]",Baixo a Moderado,,,,171,Lisboa e Vale do Tejo,SETÚBAL,1503,7000.89,169039,10469,9777,7876,6144,5111,11255,19131,28908,39377,2414.5,562.45,412.91,273.26
14-04-2021,ALMEIDA,0,0,0,"[0,120]",Baixo a Moderado,,,,0,Centro,GUARDA,0902,51798.46,5830,441,419,396,458,393,851,1247,1666,2107,11.26,4.07,3.22,2.41
14-04-2021,ALMEIRIM,40,3,177,"[120,240]",Moderado,,,,40,Lisboa e Vale do Tejo,SANTARÉM,1403,22212.05,22546,1342,1353,1106,866,843,1709,2815,4168,5510,101.5,24.81,18.76,12.67
14-04-2021,ALMODÔVAR,2,0,30,"[0,120]",Baixo a Moderado,,,,2,Alentejo,BEJA,0202,77788.03,6725,414,443,396,373,328,701,1097,1540,1954,8.65,2.51,1.98,1.41
14-04-2021,ALPIARÇA,5,0,71,"[0,120]",Baixo a Moderado,,,,5,Lisboa e Vale do Tejo,SANTARÉM,1404,9536.33,7059,515,486,363,333,274,607,970,1456,1971,74.02,20.67,15.27,10.17
14-04-2021,ALTER DO CHÃO,0,0,0,"[0,120]",Baixo a Moderado,,,,0,Alentejo,PORTALEGRE,1201,36206.62,3165,201,163,136,208,187,395,531,694,895,8.74,2.47,1.92,1.47
14-04-2021,ALVAIÁZERE,0,0,0,"[0,120]",Baixo a Moderado,,,,0,Centro,LEIRIA,1002,16047.76,6597,419,389,346,406,539,945,1291,1680,2099,41.11,13.08,10.47,8.04
14-04-2021,ALVITO,0,0,0,"[0,120]",Baixo a Moderado,,,,0,Alentejo,BEJA,0203,26485.32,2477,145,110,105,111,89,200,305,415,560,9.35,2.11,1.57,1.15
14-04-2021,AMADORA,125,9,68,"[0,120]",Baixo a Moderado,,,,125,Lisboa e Vale do Tejo,LISBOA,1115,2378.47,184106,11186,10936,8780,6460,5890,12350,21130,32066,43252,7742.05,1818.84,1348.44,888.56
14-04-2021,AMARANTE,30,2,56,"[0,120]",Baixo a Moderado,,,,30,Norte,PORTO,1301,30133.15,53193,3086,2413,1812,1643,1311,2954,4766,7179,10265,176.53,34.07,23.82,15.82
14-04-2021,AMARES,8,1,44,"[0,120]",Baixo a Moderado,,,,8,Norte,BRAGA,0301,8195.41,18129,1001,829,622,489,524,1013,1635,2464,3465,221.22,42.28,30.07,19.95
14-04-2021,ANADIA,3,0,11,"[0,120]",Baixo a Moderado,,,,3,Centro,AVEIRO,0103,21663.48,27258,1931,1698,1376,1208,1262,2470,3846,5544,7475,125.83,34.51,25.59,17.75
14-04-2021,ANGRA DO HEROÍSMO,0,0,0,"[0,120]",Baixo a Moderado,,,,0,Açores,AÇORES,4301,23899.66,33807,2006,1473,1122,768,635,1403,2525,3998,6004,141.45,25.12,16.73,10.56
14-04-2021,ANSIÃO,5,0,42,"[0,120]",Baixo a Moderado,,,,5,Centro,LEIRIA,1003,17609.42,12039,727,709,646,694,530,1224,1870,2579,3306,68.37,18.77,14.65,10.62
14-04-2021,ARCOS DE VALDEVEZ,10,1,48,"[0,120]",Baixo a Moderado,,,,10,Norte,VIANA DO CASTELO,1601,44759.64,20926,1329,1338,1282,1343,1515,2858,4140,5478,6807,46.75,15.21,12.24,9.25
14-04-2021,ARGANIL,8,1,73,"[0,120]",Baixo a Moderado,,,,8,Centro,COIMBRA,0601,33283.93,11014,672,648,612,559,596,1155,1767,2415,3087,33.09,9.27,7.26,5.31
14-04-2021,ARMAMAR,1,0,17,"[0,120]",Baixo a Moderado,,,,1,Norte,VISEU,1801,11723.73,5769,357,305,309,285,310,595,904,1209,1566,49.21,13.36,10.31,7.71
14-04-2021,AROUCA,0,0,0,"[0,120]",Baixo a Moderado,,,,0,Norte,AVEIRO,0104,32910.52,20720,1306,1047,753,683,683,1366,2119,3166,4472,62.96,13.59,9.62,6.44
14-04-2021,ARRAIOLOS,0,0,0,"[0,120]",Baixo a Moderado,,,,0,Alentejo,ÉVORA,0702,68374.55,6928,435,384,283,367,480,847,1130,1514,1949,10.13,2.85,2.21,1.65
14-04-2021,ARRONCHES,1,0,35,"[0,120]",Baixo a Moderado,,,,1,Alentejo,PORTALEGRE,1202,31464.72,2820,155,142,162,187,179,366,528,670,825,8.96,2.62,2.13,1.68
14-04-2021,ARRUDA DOS VINHOS,4,0,26,"[0,120]",Baixo a Moderado,,,,4,Lisboa e Vale do Tejo,LISBOA,1102,7795.93,15412,738,738,562,509,438,947,1509,2247,2985,197.69,38.29,28.82,19.36
14-04-2021,AVEIRO,33,2,42,"[0,120]",Baixo a Moderado,,,,33,Centro,AVEIRO,0105,19757.57,78734,4520,4004,3050,2250,2103,4353,7403,11407,15927,398.49,80.61,57.73,37.47
14-04-2021,AVIS,0,0,0,"[0,120]",Baixo a Moderado,,,,0,Alentejo,PORTALEGRE,1203,60596.51,4247,315,225,206,251,273,524,730,955,1270,7.01,2.1,1.58,1.2
14-04-2021,AZAMBUJA,1,0,4,"[0,120]",Baixo a Moderado,,,,1,Lisboa e Vale do Tejo,LISBOA,1103,26265.65,22716,1322,1171,1070,798,618,1416,2486,3657,4979,86.48,18.96,13.92,9.46
14-04-2021,BAIÃO,8,1,43,"[0,120]",Baixo a Moderado,,,,8,Norte,PORTO,1302,17452.83,18748,1070,862,714,686,725,1411,2125,2987,4057,107.42,23.25,17.11,12.18
14-04-2021,BARCELOS,73,5,63,"[0,120]",Baixo a Moderado,,,,73,Norte,BRAGA,0302,37890.14,116187,6721,5325,3619,2991,2562,5553,9172,14497,21218,306.64,56.0,38.26,24.21
14-04-2021,BARRANCOS,9,1,551,"[480,960]",Muito Elevado,,,,9,Alentejo,BEJA,0204,16841.73,1634,90,65,65,94,61,155,220,285,375,9.7,2.23,1.69,1.31
14-04-2021,BARREIRO,62,4,83,"[0,120]",Baixo a Moderado,,,,62,Lisboa e Vale do Tejo,SETÚBAL,1504,3639.07,75147,5194,5565,4459,3105,1767,4872,9331,14896,20090,2065.05,552.07,409.34,256.42
14-04-2021,BATALHA,1,0,6,"[0,120]",Baixo a Moderado,,,,1,Centro,LEIRIA,1004,10341.6,15963,873,762,649,529,549,1078,1727,2489,3362,154.35,32.51,24.07,16.7
14-04-2021,BEJA,36,3,107,"[0,120]",Baixo a Moderado,,,,36,Alentejo,BEJA,0205,114647.55,33579,2005,1840,1386,1272,1039,2311,3697,5537,7542,29.29,6.58,4.83,3.22
14-04-2021,BELMONTE,1,0,16,"[0,120]",Baixo a Moderado,,,,1,Centro,CASTELO BRANCO,0501,11875.91,6398,444,321,325,310,355,665,990,1311,1755,53.87,14.78,11.04,8.34
14-04-2021,BENAVENTE,16,1,52,"[0,120]",Baixo a Moderado,,,,16,Lisboa e Vale do Tejo,SANTARÉM,1405,52138.39,30602,1468,1376,1141,876,643,1519,2660,4036,5504,58.69,10.56,7.74,5.1
14-04-2021,BOMBARRAL,2,0,16,"[0,120]",Baixo a Moderado,,,,2,Lisboa e Vale do Tejo,LEIRIA,1005,9128.55,12558,875,714,561,491,429,920,1481,2195,3070,137.56,33.63,24.04,16.22
14-04-2021,BORBA,2,0,30,"[0,120]",Baixo a Moderado,,,,2,Alentejo,ÉVORA,0703,14518.65,6736,430,375,279,436,392,828,1107,1482,1912,46.39,13.17,10.21,7.62
14-04-2021,BOTICAS,3,0,60,"[0,120]",Baixo a Moderado,,,,3,Norte,VILA REAL,1702,32195.66,4998,347,306,311,305,380,685,996,1302,1649,15.52,5.12,4.04,3.09
14-04-2021,BRAGA,66,5,36,"[0,120]",Baixo a Moderado,,,,66,Norte,BRAGA,0303,18339.95,182679,10029,7963,5241,4320,3671,7991,13232,21195,31224,996.07,170.25,115.57,72.15
14-04-2021,BRAGANÇA,9,1,27,"[0,120]",Baixo a Moderado,,,,9,Norte,BRAGANÇA,0402,117357.27,33607,2402,1855,1652,1393,1163,2556,4208,6063,8465,28.64,7.21,5.17,3.59
14-04-2021,CABECEIRAS DE BASTO,14,1,90,"[0,120]",Baixo a Moderado,,,,14,Norte,BRAGA,0304,24182.16,15628,774,594,544,575,574,1149,1693,2287,3061,64.63,12.66,9.46,7.0
14-04-2021,CADAVAL,2,0,15,"[0,120]",Baixo a Moderado,,,,2,Lisboa e Vale do Tejo,LISBOA,1104,17489.3,13673,813,796,756,621,625,1246,2002,2798,3611,78.18,20.65,16.0,11.45
14-04-2021,CALDAS DA RAINHA,11,1,21,"[0,120]",Baixo a Moderado,,,,11,Lisboa e Vale do Tejo,LEIRIA,1006,25569.47,51912,3035,2684,2186,1899,1705,3604,5790,8474,11509,203.03,45.01,33.14,22.64
14-04-2021,CALHETA,0,0,0,"[0,120]",Baixo a Moderado,,,,0,Madeira,MADEIRA,3101,11150.43,10867,576,497,507,399,415,814,1321,1818,2394,97.46,21.47,16.3,11.85
14-04-2021,CALHETA (AÇORES),0,0,0,"[0,120]",Baixo a Moderado,,,,0,Açores,AÇORES,4501,12626.4,3184,215,159,141,139,122,261,402,561,776,25.22,6.15,4.44,3.18
14-04-2021,CÂMARA DE LOBOS,22,2,65,"[0,120]",Baixo a Moderado,,,,22,Madeira,MADEIRA,3102,5216.67,33675,1396,1059,834,545,381,926,1760,2819,4215,645.49,80.79,54.03,33.74
14-04-2021,CAMINHA,8,1,50,"[0,120]",Baixo a Moderado,,,,8,Norte,VIANA DO CASTELO,1602,13652.14,15877,1046,944,818,646,656,1302,2120,3064,4110,116.3,30.11,22.44,15.53
14-04-2021,CAMPO MAIOR,1,0,13,"[0,120]",Baixo a Moderado,,,,1,Alentejo,PORTALEGRE,1204,24720.16,7874,471,364,351,279,327,606,957,1321,1792,31.85,7.25,5.34,3.87
14-04-2021,CANTANHEDE,6,0,17,"[0,120]",Baixo a Moderado,,,,6,Centro,COIMBRA,0602,39088.02,35011,2346,2096,1880,1709,1451,3160,5040,7136,9482,89.57,24.26,18.26,12.89
14-04-2021,CARRAZEDA DE ANSIÃES,0,0,0,"[0,120]",Baixo a Moderado,,,,0,Norte,BRAGANÇA,0403,27924.09,5666,424,389,391,312,465,777,1168,1557,1981,20.29,7.09,5.58,4.18
14-04-2021,CARREGAL DO SAL,15,1,162,"[120,240]",Moderado,,,,15,Centro,VISEU,1802,11689.21,9271,587,562,486,462,376,838,1324,1886,2473,79.31,21.16,16.13,11.33
14-04-2021,CARTAXO,9,1,38,"[0,120]",Baixo a Moderado,,,,9,Lisboa e Vale do Tejo,SANTARÉM,1406,15817.28,23843,1415,1376,1142,861,632,1493,2635,4011,5426,150.74,34.3,25.36,16.66
14-04-2021,CASCAIS,96,7,45,"[0,120]",Baixo a Moderado,,,,96,Lisboa e Vale do Tejo,LISBOA,1105,9740.17,213608,12151,11444,8680,6469,5248,11717,20397,31841,43992,2193.1,451.66,326.91,209.41
14-04-2021,CASTANHEIRA DE PÊRA,0,0,0,"[0,120]",Baixo a Moderado,,,,0,Centro,LEIRIA,1007,6677.45,2614,233,195,157,190,187,377,534,729,962,39.15,14.41,10.92,8.0
14-04-2021,CASTELO BRANCO,7,0,13,"[0,120]",Baixo a Moderado,,,,7,Centro,CASTELO BRANCO,0502,143819.15,51987,3528,3042,2499,2229,2225,4454,6953,9995,13523,36.15,9.4,6.95,4.83
14-04-2021,CASTELO DE PAIVA,3,0,19,"[0,120]",Baixo a Moderado,,,,3,Norte,AVEIRO,0106,11500.53,15454,881,697,545,420,431,851,1396,2093,2974,134.37,25.86,18.2,12.14
14-04-2021,CASTELO DE VIDE,0,0,0,"[0,120]",Baixo a Moderado,,,,0,Alentejo,PORTALEGRE,1205,26491.24,2919,204,173,179,147,170,317,496,669,873,11.02,3.3,2.53,1.87
14-04-2021,CASTRO DAIRE,7,1,51,"[0,120]",Baixo a Moderado,,,,7,Centro,VISEU,1803,37904.13,13823,942,857,765,732,773,1505,2270,3127,4069,36.47,10.74,8.25,5.99
14-04-2021,CASTRO MARIM,0,0,0,"[0,120]",Baixo a Moderado,,,,0,Algarve,FARO,0804,30084.37,6237,370,345,334,322,344,666,1000,1345,1715,20.73,5.7,4.47,3.32
14-04-2021,CASTRO VERDE,2,0,29,"[0,120]",Baixo a Moderado,,,,2,Alentejo,BEJA,0206,56944.23,6949,437,347,303,275,227,502,805,1152,1589,12.2,2.79,2.02,1.41
14-04-2021,CELORICO DA BEIRA,2,0,29,"[0,120]",Baixo a Moderado,,,,2,Centro,GUARDA,0903,24721.63,6928,430,416,363,369,535,904,1267,1683,2113,28.02,8.55,6.81,5.12
14-04-2021,CELORICO DE BASTO,11,1,58,"[0,120]",Baixo a Moderado,,,,11,Norte,BRAGA,0305,18107.02,19040,1001,802,668,728,729,1457,2125,2927,3928,105.15,21.69,16.17,11.74
14-04-2021,CHAMUSCA,3,0,33,"[0,120]",Baixo a Moderado,,,,3,Lisboa e Vale do Tejo,SANTARÉM,1407,74600.54,9197,629,583,553,465,579,1044,1597,2180,2809,12.33,3.77,2.92,2.14
14-04-2021,CHAVES,28,2,71,"[0,120]",Baixo a Moderado,,,,28,Norte,VILA REAL,1703,59122.95,39343,2676,2429,1991,1886,1918,3804,5795,8224,10900,66.54,18.44,13.91,9.8
14-04-2021,CINFÃES,19,1,104,"[0,120]",Baixo a Moderado,,,,19,Norte,VISEU,1804,23928.76,18244,1067,902,779,734,758,1492,2271,3173,4240,76.24,17.72,13.26,9.49
14-04-2021,COIMBRA,50,4,37,"[0,120]",Baixo a Moderado,,,,50,Centro,COIMBRA,0603,31939.94,134166,9489,8734,6353,5139,5074,10213,16566,25300,34789,420.06,108.92,79.21,51.87
14-04-2021,CONDEIXA-A-NOVA,5,0,28,"[0,120]",Baixo a Moderado,,,,5,Centro,COIMBRA,0604,13867.47,17733,871,809,717,583,490,1073,1790,2599,3470,127.88,25.02,18.74,12.91
14-04-2021,CONSTÂNCIA,0,0,0,"[0,120]",Baixo a Moderado,,,,0,Lisboa e Vale do Tejo,SANTARÉM,1408,8036.58,4030,211,183,187,148,155,303,490,673,884,50.14,11.0,8.37,6.1
14-04-2021,CORUCHE,8,1,46,"[0,120]",Baixo a Moderado,,,,8,Lisboa e Vale do Tejo,SANTARÉM,1409,111572.03,17471,1294,1090,1095,1096,1019,2115,3210,4300,5594,15.66,5.01,3.85,2.88
14-04-2021,CORVO,0,0,0,"[0,120]",Baixo a Moderado,,,,0,Açores,AÇORES,4901,1711.45,464,22,21,11,13,19,32,43,64,86,27.12,5.03,3.74,2.51
14-04-2021,COVILHÃ,9,1,19,"[0,120]",Baixo a Moderado,,,,9,Centro,CASTELO BRANCO,0503,55560.06,46787,3533,2998,2365,2111,2193,4304,6669,9667,13200,84.21,23.76,17.4,12.0
14-04-2021,CRATO,0,0,0,"[0,120]",Baixo a Moderado,,,,0,Alentejo,PORTALEGRE,1206,39806.88,3129,229,258,163,182,228,410,573,831,1060,7.86,2.66,2.09,1.44
14-04-2021,CUBA,0,0,0,"[0,120]",Baixo a Moderado,,,,0,Alentejo,BEJA,0207,17208.72,4595,255,233,206,190,143,333,539,772,1027,26.7,5.97,4.49,3.13
14-04-2021,ELVAS,14,1,68,"[0,120]",Baixo a Moderado,,,,14,Alentejo,PORTALEGRE,1207,63128.86,20528,1057,1145,902,852,810,1662,2564,3709,4766,32.52,7.55,5.88,4.06
14-04-2021,ENTRONCAMENTO,2,0,9,"[0,120]",Baixo a Moderado,,,,2,Lisboa e Vale do Tejo,SANTARÉM,1410,1372.81,21558,1066,930,868,695,592,1287,2155,3085,4151,1570.14,302.33,224.69,156.96
14-04-2021,ESPINHO,27,2,91,"[0,120]",Baixo a Moderado,,,,27,Norte,AVEIRO,0107,2105.68,29516,2205,1993,1430,1177,960,2137,3567,5560,7765,1401.52,368.71,264.01,169.37
14-04-2021,ESPOSENDE,27,2,79,"[0,120]",Baixo a Moderado,,,,27,Norte,BRAGA,0306,9540.98,34177,1831,1522,1095,894,723,1617,2712,4234,6065,358.21,63.57,44.38,28.42
14-04-2021,ESTARREJA,19,1,73,"[0,120]",Baixo a Moderado,,,,19,Centro,AVEIRO,0108,10817.33,26006,1503,1399,1106,953,728,1681,2787,4186,5689,240.42,52.59,38.7,25.76
14-04-2021,ESTREMOZ,2,0,16,"[0,120]",Baixo a Moderado,,,,2,Alentejo,ÉVORA,0704,51379.95,12728,789,613,697,786,877,1663,2360,2973,3762,24.77,7.32,5.79,4.59
14-04-2021,ÉVORA,6,0,11,"[0,120]",Baixo a Moderado,,,,6,Alentejo,ÉVORA,0705,130707.58,52428,3569,2852,2176,1966,1803,3769,5945,8797,12366,40.11,9.46,6.73,4.55
14-04-2021,FAFE,28,2,58,"[0,120]",Baixo a Moderado,,,,28,Norte,BRAGA,0307,21908.11,48060,3044,2455,1679,1403,1208,2611,4290,6745,9789,219.37,44.68,30.79,19.58
14-04-2021,FARO,65,5,107,"[0,120]",Baixo a Moderado,,,,65,Algarve,FARO,0805,20256.79,61015,3847,3364,2604,2055,1601,3656,6260,9624,13471,301.2,66.5,47.51,30.9
14-04-2021,FELGUEIRAS,20,1,35,"[0,120]",Baixo a Moderado,,,,20,Norte,PORTO,1303,11573.75,56422,2951,2302,1601,1316,973,2289,3890,6192,9143,487.49,79.0,53.5,33.61
14-04-2021,FERREIRA DO ALENTEJO,0,0,0,"[0,120]",Baixo a Moderado,,,,0,Alentejo,BEJA,0208,64820.68,7845,515,414,372,343,345,688,1060,1474,1989,12.1,3.07,2.27,1.64
14-04-2021,FERREIRA DO ZÊZERE,2,0,25,"[0,120]",Baixo a Moderado,,,,2,Lisboa e Vale do Tejo,SANTARÉM,1411,19038.03,7959,470,370,416,465,456,921,1337,1707,2177,41.81,11.44,8.97,7.02
14-04-2021,FIGUEIRA DA FOZ,85,6,145,"[120,240]",Moderado,,,,85,Centro,COIMBRA,0605,37905.26,58747,4032,3597,2887,2495,2043,4538,7425,11022,15054,154.98,39.72,29.08,19.59
14-04-2021,FIGUEIRA DE CASTELO RODRIGO,0,0,0,"[0,120]",Baixo a Moderado,,,,0,Centro,GUARDA,0904,50857.46,5584,347,352,290,352,391,743,1033,1385,1732,10.98,3.41,2.72,2.03
14-04-2021,FIGUEIRÓ DOS VINHOS,3,0,54,"[0,120]",Baixo a Moderado,,,,3,Centro,LEIRIA,1008,17344.0,5568,402,386,322,309,351,660,982,1368,1770,32.1,10.21,7.89,5.66
14-04-2021,FORNOS DE ALGODRES,0,0,0,"[0,120]",Baixo a Moderado,,,,0,Centro,GUARDA,0905,13145.05,4528,261,218,247,256,232,488,735,953,1214,34.45,9.24,7.25,5.59
14-04-2021,FREIXO DE ESPADA À CINTA,0,0,0,"[0,120]",Baixo a Moderado,,,,0,Norte,BRAGANÇA,0404,24414.29,3298,211,177,231,196,189,385,616,793,1004,13.51,4.11,3.25,2.52
14-04-2021,FRONTEIRA,0,0,0,"[0,120]",Baixo a Moderado,,,,0,Alentejo,PORTALEGRE,1208,24859.58,2974,213,182,149,156,168,324,473,655,868,11.96,3.49,2.63,1.9
14-04-2021,FUNCHAL,109,8,105,"[0,120]",Baixo a Moderado,,,,109,Madeira,MADEIRA,3103,7616.2,104024,6382,5086,3643,2821,1990,4811,8454,13540,19922,1365.86,261.58,177.78,111.0
14-04-2021,FUNDÃO,2,0,8,"[0,120]",Baixo a Moderado,,,,2,Centro,CASTELO BRANCO,0504,70019.79,26495,1781,1464,1432,1357,1643,3000,4432,5896,7677,37.84,10.96,8.42,6.33
14-04-2021,GAVIÃO,0,0,0,"[0,120]",Baixo a Moderado,,,,0,Alentejo,PORTALEGRE,1209,29459.45,3263,189,186,222,263,293,556,778,964,1153,11.08,3.91,3.27,2.64
14-04-2021,GÓIS,2,0,53,"[0,120]",Baixo a Moderado,,,,2,Centro,COIMBRA,0606,26330.19,3805,235,199,240,233,244,477,717,916,1151,14.45,4.37,3.48,2.72
14-04-2021,GOLEGÃ,5,0,94,"[0,120]",Baixo a Moderado,,,,5,Lisboa e Vale do Tejo,SANTARÉM,1412,8431.67,5339,356,299,281,243,255,498,779,1078,1434,63.32,17.01,12.78,9.24
14-04-2021,GONDOMAR,91,7,55,"[0,120]",Baixo a Moderado,,,,91,Norte,PORTO,1304,13191.76,165985,10555,8755,6222,4450,3364,7814,14036,22791,33346,1258.22,252.77,172.76,106.4
14-04-2021,GOUVEIA,3,0,24,"[0,120]",Baixo a Moderado,,,,3,Centro,GUARDA,0906,30061.17,12387,871,931,780,783,810,1593,2373,3304,4175,41.21,13.89,10.99,7.89
14-04-2021,GRÂNDOLA,5,0,34,"[0,120]",Baixo a Moderado,,,,5,Alentejo,SETÚBAL,1505,82593.66,14639,834,834,708,688,672,1360,2068,2902,3736,17.72,4.52,3.51,2.5
14-04-2021,GUARDA,5,0,13,"[0,120]",Baixo a Moderado,,,,5,Centro,GUARDA,0907,71209.58,38969,2477,2041,1686,1415,1474,2889,4575,6616,9093,54.72,12.77,9.29,6.42
14-04-2021,GUIMARÃES,84,6,55,"[0,120]",Baixo a Moderado,,,,84,Norte,BRAGA,0308,24099.96,152309,9394,7074,4809,3877,2948,6825,11634,18708,28102,631.99,116.61,77.63,48.27
14-04-2021,HORTA,0,0,0,"[0,120]",Baixo a Moderado,,,,0,Açores,AÇORES,4701,17305.53,14521,818,658,468,352,302,654,1122,1780,2598,83.91,15.01,10.29,6.48
14-04-2021,IDANHA-A-NOVA,0,0,0,"[0,120]",Baixo a Moderado,,,,0,Centro,CASTELO BRANCO,0505,141633.51,8043,518,490,519,672,974,1646,2165,2655,3173,5.68,2.24,1.87,1.53
14-04-2021,ÍLHAVO,12,1,31,"[0,120]",Baixo a Moderado,,,,12,Centro,AVEIRO,0110,7347.55,38699,2227,1943,1444,1193,850,2043,3487,5430,7657,526.66,104.21,73.9,47.46
14-04-2021,LAGOA (FARO),27,2,119,"[0,120]",Baixo a Moderado,,,,27,Algarve,FARO,0806,8825.45,22762,1314,1168,919,749,670,1419,2338,3506,4820,257.93,54.62,39.73,26.49
14-04-2021,LAGOA,28,2,190,"[120,240]",Moderado,,,,28,Açores,AÇORES,4201,4559.32,14721,536,458,349,238,235,473,822,1280,1816,322.9,39.83,28.08,18.03
14-04-2021,LAGOS,5,0,16,"[0,120]",Baixo a Moderado,,,,5,Algarve,FARO,0807,21299.27,30374,1744,1434,1247,1053,1029,2082,3329,4763,6507,142.61,30.55,22.36,15.63
14-04-2021,LAJES DAS FLORES,0,0,0,"[0,120]",Baixo a Moderado,,,,0,Açores,AÇORES,4801,7004.79,1463,88,53,62,46,54,100,162,215,303,20.89,4.33,3.07,2.31
14-04-2021,LAJES DO PICO,1,0,22,"[0,120]",Baixo a Moderado,,,,1,Açores,AÇORES,4601,15531.09,4490,304,231,223,159,162,321,544,775,1079,28.91,6.95,4.99,3.5
14-04-2021,LAMEGO,18,1,72,"[0,120]",Baixo a Moderado,,,,18,Norte,VISEU,1805,16542.11,24895,1639,1284,1124,898,783,1681,2805,4089,5728,150.5,34.63,24.72,16.96
14-04-2021,LEIRIA,76,5,61,"[0,120]",Baixo a Moderado,,,,76,Centro,LEIRIA,1009,56508.83,125267,7389,6366,5090,3902,3159,7061,12151,18517,25906,221.68,45.84,32.77,21.5
14-04-2021,LISBOA,494,35,97,"[0,120]",Baixo a Moderado,,,,494,Lisboa e Vale do Tejo,LISBOA,1106,10005.43,509515,33197,33340,27706,23037,26770,49807,77513,110853,144050,5092.6,1439.78,1107.98,774.74
14-04-2021,LOULÉ,36,3,52,"[0,120]",Baixo a Moderado,,,,36,Algarve,FARO,0808,76366.91,68697,3890,3350,2780,2358,2251,4609,7389,10739,14629,89.96,19.16,14.06,9.68
14-04-2021,LOURES,96,7,45,"[0,120]",Baixo a Moderado,,,,96,Lisboa e Vale do Tejo,LISBOA,1107,16723.99,213687,12746,12794,9644,6669,5033,11702,21346,34140,46886,1277.73,280.35,204.14,127.64
14-04-2021,LOURINHÃ,19,1,73,"[0,120]",Baixo a Moderado,,,,19,Lisboa e Vale do Tejo,LISBOA,1108,14717.2,25855,1584,1243,992,842,645,1487,2479,3722,5306,175.68,36.05,25.29,16.84
14-04-2021,LOUSÃ,12,1,70,"[0,120]",Baixo a Moderado,,,,12,Centro,COIMBRA,0607,13840.01,17158,946,866,658,528,450,978,1636,2502,3448,123.97,24.91,18.08,11.82
14-04-2021,LOUSADA,24,2,51,"[0,120]",Baixo a Moderado,,,,24,Norte,PORTO,1305,9608.01,46755,2289,1698,1176,853,621,1474,2650,4348,6637,486.63,69.08,45.25,27.58
14-04-2021,MAÇÃO,2,0,32,"[0,120]",Baixo a Moderado,,,,2,Lisboa e Vale do Tejo,SANTARÉM,1413,39997.98,6267,386,362,390,440,657,1097,1487,1849,2235,15.67,5.59,4.62,3.72
14-04-2021,MACEDO DE CAVALEIROS,4,0,28,"[0,120]",Baixo a Moderado,,,,4,Norte,BRAGANÇA,0405,69914.08,14516,1082,889,878,823,938,1761,2639,3528,4610,20.76,6.59,5.05,3.77
14-04-2021,MACHICO,116,8,581,"[480,960]",Muito Elevado,,,,116,Madeira,MADEIRA,3104,6825.1,19981,1197,860,662,455,331,786,1448,2308,3505,292.76,51.36,33.82,21.22
14-04-2021,MADALENA,0,0,0,"[0,120]",Baixo a Moderado,,,,0,Açores,AÇORES,4602,14712.33,5895,334,256,173,190,179,369,542,798,1132,40.07,7.69,5.42,3.68
14-04-2021,MAFRA,50,4,59,"[0,120]",Baixo a Moderado,,,,50,Lisboa e Vale do Tejo,LISBOA,1109,29165.5,84816,3613,3334,2839,2089,1899,3988,6827,10161,13774,290.81,47.23,34.84,23.41
14-04-2021,MAIA,57,4,41,"[0,120]",Baixo a Moderado,,,,57,Norte,PORTO,1306,8293.94,138971,7801,6617,4512,3339,2631,5970,10482,17099,24900,1675.56,300.22,206.16,126.38
14-04-2021,MANGUALDE,0,0,0,"[0,120]",Baixo a Moderado,,,,0,Centro,VISEU,1806,21925.56,18510,1198,1128,885,852,743,1595,2480,3608,4806,84.42,21.92,16.46,11.31
14-04-2021,MANTEIGAS,0,0,0,"[0,120]",Baixo a Moderado,,,,0,Centro,GUARDA,0908,12197.55,3007,258,197,159,167,146,313,472,669,927,24.65,7.6,5.48,3.87
14-04-2021,MARCO DE CANAVESES,40,3,78,"[0,120]",Baixo a Moderado,,,,40,Norte,PORTO,1307,20188.98,51496,2678,2060,1488,1265,1023,2288,3776,5836,8514,255.07,42.17,28.91,18.7
14-04-2021,MARINHA GRANDE,70,5,182,"[120,240]",Moderado,,,,70,Centro,LEIRIA,1010,18725.19,38508,2365,2302,1638,1359,1058,2417,4055,6357,8722,205.65,46.58,33.95,21.66
14-04-2021,MARVÃO,0,0,0,"[0,120]",Baixo a Moderado,,,,0,Alentejo,PORTALEGRE,1210,15489.9,3005,198,185,142,197,237,434,576,761,959,19.4,6.19,4.91,3.72
14-04-2021,MATOSINHOS,88,6,50,"[0,120]",Baixo a Moderado,,,,88,Norte,PORTO,1308,6241.97,175357,11850,9977,7023,5024,3884,8908,15931,25908,37758,2809.31,604.9,415.06,255.22
14-04-2021,MEALHADA,3,0,15,"[0,120]",Baixo a Moderado,,,,3,Centro,AVEIRO,0111,11065.66,19914,1163,1039,810,828,831,1659,2469,3508,4671,179.96,42.21,31.7,22.31
14-04-2021,MÊDA,6,0,131,"[120,240]",Moderado,,,,6,Centro,GUARDA,0909,28604.92,4587,343,306,290,288,443,731,1021,1327,1670,16.04,5.84,4.64,3.57
14-04-2021,MELGAÇO,4,0,49,"[0,120]",Baixo a Moderado,,,,4,Norte,VIANA DO CASTELO,1603,23824.58,8093,507,567,578,614,675,1289,1867,2434,2941,33.97,12.34,10.22,7.84
14-04-2021,MÉRTOLA,6,0,98,"[0,120]",Baixo a Moderado,,,,6,Alentejo,BEJA,0209,129287.34,6142,400,390,378,423,600,1023,1401,1791,2191,4.75,1.69,1.39,1.08
14-04-2021,MESÃO FRIO,2,0,50,"[0,120]",Baixo a Moderado,,,,2,Norte,VILA REAL,1704,2664.87,3964,265,205,168,157,120,277,445,650,915,148.74,34.33,24.39,16.7
14-04-2021,MIRA,7,0,59,"[0,120]",Baixo a Moderado,,,,7,Centro,COIMBRA,0608,12403.38,11832,727,729,659,550,466,1016,1675,2404,3131,95.4,25.24,19.38,13.5
14-04-2021,MIRANDA DO CORVO,22,2,173,"[120,240]",Moderado,,,,22,Centro,COIMBRA,0609,12637.79,12708,706,659,568,498,404,902,1470,2129,2835,100.55,22.43,16.85,11.63
14-04-2021,MIRANDA DO DOURO,9,1,132,"[120,240]",Moderado,,,,9,Norte,BRAGANÇA,0406,48718.31,6830,482,429,442,463,470,933,1375,1804,2286,14.02,4.69,3.7,2.82
14-04-2021,MIRANDELA,20,1,92,"[0,120]",Baixo a Moderado,,,,20,Norte,BRAGANÇA,0407,65895.67,21754,1640,1315,1204,1078,947,2025,3229,4544,6184,33.01,9.38,6.9,4.9
14-04-2021,MOGADOURO,0,0,0,"[0,120]",Baixo a Moderado,,,,0,Norte,BRAGANÇA,0408,76064.93,8392,589,529,576,630,655,1285,1861,2390,2979,11.03,3.92,3.14,2.45
14-04-2021,MOIMENTA DA BEIRA,3,0,31,"[0,120]",Baixo a Moderado,,,,3,Norte,VISEU,1807,21996.9,9736,576,514,471,416,461,877,1348,1862,2438,44.26,11.08,8.46,6.13
14-04-2021,MOITA,50,4,78,"[0,120]",Baixo a Moderado,,,,50,Lisboa e Vale do Tejo,SETÚBAL,1506,5525.98,64407,4226,3646,2623,1801,1425,3226,5849,9495,13721,1165.53,248.3,171.82,105.85
14-04-2021,MONÇÃO,4,0,22,"[0,120]",Baixo a Moderado,,,,4,Norte,VIANA DO CASTELO,1604,21130.85,17869,1161,1105,1031,1006,972,1978,3009,4114,5275,84.56,24.96,19.47,14.24
14-04-2021,MONCHIQUE,1,0,20,"[0,120]",Baixo a Moderado,,,,1,Algarve,FARO,0809,39530.43,5077,353,384,321,355,392,747,1068,1452,1805,12.84,4.57,3.67,2.7
14-04-2021,MONDIM DE BASTO,0,0,0,"[0,120]",Baixo a Moderado,,,,0,Norte,VILA REAL,1705,17207.52,6946,395,300,314,284,283,567,881,1181,1576,40.36,9.16,6.86,5.12
14-04-2021,MONFORTE,0,0,0,"[0,120]",Baixo a Moderado,,,,0,Alentejo,PORTALEGRE,1211,42024.82,2975,139,115,117,192,168,360,477,592,731,7.08,1.74,1.41,1.14
14-04-2021,MONTALEGRE,2,0,22,"[0,120]",Baixo a Moderado,,,,2,Norte,VILA REAL,1706,80545.71,8997,699,628,595,603,730,1333,1928,2556,3255,11.17,4.04,3.17,2.39
14-04-2021,MONTEMOR-O-NOVO,4,0,26,"[0,120]",Baixo a Moderado,,,,4,Alentejo,ÉVORA,0706,123296.65,15647,991,953,868,878,971,1849,2717,3670,4661,12.69,3.78,2.98,2.2
14-04-2021,MONTEMOR-O-VELHO,16,1,63,"[0,120]",Baixo a Moderado,,,,16,Centro,COIMBRA,0610,22896.23,25224,1496,1397,1217,1057,988,2045,3262,4659,6155,110.17,26.88,20.35,14.25
14-04-2021,MONTIJO,30,2,52,"[0,120]",Baixo a Moderado,,,,30,Lisboa e Vale do Tejo,SETÚBAL,1507,34861.64,57614,2771,2441,1990,1554,1109,2663,4653,7094,9865,165.26,28.3,20.35,13.35
14-04-2021,MORA,0,0,0,"[0,120]",Baixo a Moderado,,,,0,Alentejo,ÉVORA,0707,44395.02,4138,336,275,252,238,257,495,747,1022,1358,9.32,3.06,2.3,1.68
14-04-2021,MORTÁGUA,1,0,11,"[0,120]",Baixo a Moderado,,,,1,Centro,VISEU,1808,25117.82,8803,638,584,535,499,460,959,1494,2078,2716,35.05,10.81,8.27,5.95
14-04-2021,MOURA,43,3,313,"[240,480]",Elevado,,,,43,Alentejo,BEJA,0210,95845.55,13718,817,656,665,542,461,1003,1668,2324,3141,14.31,3.28,2.42,1.74
14-04-2021,MOURÃO,0,0,0,"[0,120]",Baixo a Moderado,,,,0,Alentejo,ÉVORA,0708,27862.98,2450,139,108,80,104,109,213,293,401,540,8.79,1.94,1.44,1.05
14-04-2021,MURÇA,0,0,0,"[0,120]",Baixo a Moderado,,,,0,Norte,VILA REAL,1707,18937.11,5463,384,341,307,306,319,625,932,1273,1657,28.85,8.75,6.72,4.92
14-04-2021,MURTOSA,5,0,49,"[0,120]",Baixo a Moderado,,,,5,Centro,AVEIRO,0112,7308.78,10279,509,473,403,353,409,762,1165,1638,2147,140.63,29.37,22.41,15.94
14-04-2021,NAZARÉ,7,0,49,"[0,120]",Baixo a Moderado,,,,7,Lisboa e Vale do Tejo,LEIRIA,1011,8243.43,14165,967,903,670,420,396,816,1486,2389,3356,171.84,40.71,28.98,18.03
14-04-2021,NELAS,3,0,23,"[0,120]",Baixo a Moderado,,,,3,Centro,VISEU,1809,12571.48,12974,924,787,668,604,583,1187,1855,2642,3566,103.21,28.37,21.02,14.76
14-04-2021,NISA,0,0,0,"[0,120]",Baixo a Moderado,,,,0,Alentejo,PORTALEGRE,1212,57567.84,6061,405,389,355,483,478,961,1316,1705,2110,10.53,3.67,2.96,2.29
14-04-2021,NORDESTE,51,4,1049,"[960,Max]",Extremamente Elevado,,,,51,Açores,AÇORES,4202,10146.8,4862,246,180,124,161,162,323,447,627,873,47.92,8.6,6.18,4.41
14-04-2021,ÓBIDOS,1,0,8,"[0,120]",Baixo a Moderado,,,,1,Lisboa e Vale do Tejo,LEIRIA,1012,14155.44,11850,743,650,574,452,436,888,1462,2112,2855,83.72,20.17,14.92,10.33
14-04-2021,ODEMIRA,187,13,757,"[480,960]",Muito Elevado,,,,187,Alentejo,BEJA,0211,172060.15,24717,1475,1317,1225,1397,1349,2746,3971,5288,6763,14.37,3.93,3.07,2.31
14-04-2021,ODIVELAS,94,7,58,"[0,120]",Baixo a Moderado,,,,94,Lisboa e Vale do Tejo,LISBOA,1116,2654.36,161774,9562,9038,6952,4641,3812,8453,15405,24443,34005,6095.48,1281.27,920.99,580.44
14-04-2021,OEIRAS,130,9,73,"[0,120]",Baixo a Moderado,,,,130,Lisboa e Vale do Tejo,LISBOA,1110,4588.31,177408,11580,11575,8566,6211,5855,12066,20632,32207,43787,3866.78,954.38,701.98,449.69
14-04-2021,OLEIROS,0,0,0,"[0,120]",Baixo a Moderado,,,,0,Centro,CASTELO BRANCO,0506,47109.31,5003,384,341,366,397,487,884,1250,1591,1975,10.62,4.19,3.38,2.65
14-04-2021,OLHÃO,58,4,131,"[120,240]",Moderado,,,,58,Algarve,FARO,0810,13086.38,44405,2455,2309,1689,1342,1268,2610,4299,6608,9063,339.33,69.26,50.5,32.85
14-04-2021,OLIVEIRA DE AZEMÉIS,36,3,55,"[0,120]",Baixo a Moderado,,,,36,Norte,AVEIRO,0113,16110.41,66011,4155,3614,2794,2183,1738,3921,6715,10329,14484,409.75,89.91,64.12,41.68
14-04-2021,OLIVEIRA DE FRADES,1,0,10,"[0,120]",Baixo a Moderado,,,,1,Centro,VISEU,1810,14534.62,9936,553,475,438,359,415,774,1212,1687,2240,68.36,15.41,11.61,8.34
14-04-2021,OLIVEIRA DO BAIRRO,5,0,21,"[0,120]",Baixo a Moderado,,,,5,Centro,AVEIRO,0114,8731.99,24277,1327,1182,999,786,810,1596,2595,3777,5104,278.02,58.45,43.25,29.72
14-04-2021,OLIVEIRA DO HOSPITAL,9,1,47,"[0,120]",Baixo a Moderado,,,,9,Centro,COIMBRA,0611,23451.66,19253,1161,1097,962,924,960,1884,2846,3943,5104,82.1,21.76,16.81,12.14
14-04-2021,OURÉM,7,1,16,"[0,120]",Baixo a Moderado,,,,7,Lisboa e Vale do Tejo,SANTARÉM,1421,41668.03,44044,2463,2069,1899,1817,1603,3420,5319,7388,9851,105.7,23.64,17.73,12.77
14-04-2021,OURIQUE,0,0,0,"[0,120]",Baixo a Moderado,,,,0,Alentejo,BEJA,0212,66331.36,4607,313,287,284,268,227,495,779,1066,1379,6.95,2.08,1.61,1.17
14-04-2021,OVAR,35,3,65,"[0,120]",Baixo a Moderado,,,,35,Centro,AVEIRO,0115,14770.25,54260,3294,2709,1994,1636,1234,2870,4864,7573,10867,367.37,73.57,51.27,32.93
14-04-2021,PAÇOS DE FERREIRA,66,5,116,"[0,120]",Baixo a Moderado,,,,66,Norte,PORTO,1309,7099.29,56728,2903,2193,1518,1135,664,1799,3317,5510,8413,799.1,118.51,77.62,46.72
14-04-2021,PALMELA,20,1,31,"[0,120]",Baixo a Moderado,,,,20,Lisboa e Vale do Tejo,SETÚBAL,1508,46512.01,64269,3402,3244,2635,1846,1391,3237,5872,9116,12518,138.18,26.91,19.6,12.62
14-04-2021,PAMPILHOSA DA SERRA,1,0,25,"[0,120]",Baixo a Moderado,,,,1,Centro,COIMBRA,0612,39646.24,4037,238,254,295,339,423,762,1057,1311,1549,10.18,3.91,3.31,2.67
14-04-2021,PAREDES,119,8,138,"[120,240]",Moderado,,,,119,Norte,PORTO,1310,15675.69,86067,4272,3532,2412,1717,1258,2975,5387,8919,13191,549.04,84.15,56.9,34.36
14-04-2021,PAREDES DE COURA,1,0,12,"[0,120]",Baixo a Moderado,,,,1,Norte,VIANA DO CASTELO,1605,13818.59,8535,466,528,407,465,515,980,1387,1915,2381,61.76,17.23,13.86,10.04
14-04-2021,PEDRÓGÃO GRANDE,0,0,0,"[0,120]",Baixo a Moderado,,,,0,Centro,LEIRIA,1013,12874.75,3410,175,173,196,221,252,473,669,842,1017,26.49,7.9,6.54,5.2
14-04-2021,PENACOVA,5,0,37,"[0,120]",Baixo a Moderado,,,,5,Centro,COIMBRA,0613,21673.23,13694,968,923,745,621,703,1324,2069,2992,3960,63.18,18.27,13.81,9.55
14-04-2021,PENAFIEL,52,4,75,"[0,120]",Baixo a Moderado,,,,52,Norte,PORTO,1311,21224.27,69772,3648,2823,2032,1663,1230,2893,4925,7748,11396,328.74,53.69,36.51,23.2
14-04-2021,PENALVA DO CASTELO,10,1,141,"[120,240]",Moderado,,,,10,Centro,VISEU,1811,13433.92,7115,449,457,413,391,426,817,1230,1687,2136,52.96,15.9,12.56,9.16
14-04-2021,PENAMACOR,0,0,0,"[0,120]",Baixo a Moderado,,,,0,Centro,CASTELO BRANCO,0507,56370.69,4755,262,248,273,451,633,1084,1357,1605,1867,8.44,3.31,2.85,2.41
14-04-2021,PENEDONO,1,0,39,"[0,120]",Baixo a Moderado,,,,1,Norte,VISEU,1812,13370.75,2591,172,113,129,156,138,294,423,536,708,19.38,5.3,4.01,3.16
14-04-2021,PENELA,18,1,334,"[240,480]",Elevado,,,,18,Centro,COIMBRA,0614,13480.0,5397,314,324,274,359,344,703,977,1301,1615,40.04,11.98,9.65,7.25
14-04-2021,PENICHE,15,1,57,"[0,120]",Baixo a Moderado,,,,15,Lisboa e Vale do Tejo,LEIRIA,1014,7754.98,26501,1746,1504,1203,926,707,1633,2836,4340,6086,341.73,78.48,55.96,36.57
14-04-2021,PESO DA RÉGUA,16,1,101,"[0,120]",Baixo a Moderado,,,,16,Norte,VILA REAL,1708,9486.01,15773,1076,843,650,659,455,1114,1764,2607,3683,166.28,38.83,27.48,18.6
14-04-2021,PINHEL,0,0,0,"[0,120]",Baixo a Moderado,,,,0,Centro,GUARDA,0910,48452.12,8511,577,566,551,538,689,1227,1778,2344,2921,17.57,6.03,4.84,3.67
14-04-2021,POMBAL,10,1,19,"[0,120]",Baixo a Moderado,,,,10,Centro,LEIRIA,1015,62600.28,51461,3187,2791,2494,2328,2027,4355,6849,9640,12827,82.21,20.49,15.4,10.94
14-04-2021,PONTA DELGADA,62,4,91,"[0,120]",Baixo a Moderado,,,,62,Açores,AÇORES,4203,23298.65,67935,3108,2435,1726,1133,902,2035,3761,6196,9304,291.58,39.93,26.59,16.14
14-04-2021,PONTA DO SOL,4,0,47,"[0,120]",Baixo a Moderado,,,,4,Madeira,MADEIRA,3105,4622.03,8593,319,283,347,208,221,429,776,1059,1378,185.92,29.81,22.91,16.79
14-04-2021,PONTE DA BARCA,10,1,89,"[0,120]",Baixo a Moderado,,,,10,Norte,VIANA DO CASTELO,1606,18211.37,11180,635,576,517,554,490,1044,1561,2137,2772,61.39,15.22,11.73,8.57
14-04-2021,PONTE DE LIMA,13,1,31,"[0,120]",Baixo a Moderado,,,,13,Norte,VIANA DO CASTELO,1607,32025.46,41315,2321,2022,1720,1596,1462,3058,4778,6800,9121,129.01,28.48,21.23,14.92
14-04-2021,PONTE DE SOR,1,0,7,"[0,120]",Baixo a Moderado,,,,1,Alentejo,PORTALEGRE,1213,83971.16,14994,939,800,716,739,831,1570,2286,3086,4025,17.86,4.79,3.68,2.72
14-04-2021,PORTALEGRE,3,0,14,"[0,120]",Baixo a Moderado,,,,3,Alentejo,PORTALEGRE,1214,44713.64,22172,1577,1351,1137,993,984,1977,3114,4465,6042,49.59,13.51,9.99,6.96
14-04-2021,PORTEL,1,0,17,"[0,120]",Baixo a Moderado,,,,1,Alentejo,ÉVORA,0709,60100.57,5828,336,358,283,331,305,636,919,1277,1613,9.7,2.68,2.12,1.53
14-04-2021,PORTIMÃO,212,15,382,"[240,480]",Elevado,,,,212,Algarve,FARO,0811,18206.29,55483,3182,2927,2116,1582,1400,2982,5098,8025,11207,304.75,61.56,44.08,28.0
14-04-2021,PORTO,130,9,60,"[0,120]",Baixo a Moderado,,,,130,Norte,PORTO,1312,4142.02,216606,15790,15193,11280,9409,10044,19453,30733,45926,61716,5229.5,1490.0,1108.79,741.98
14-04-2021,PORTO DE MÓS,22,2,95,"[0,120]",Baixo a Moderado,,,,22,Centro,LEIRIA,1016,26183.41,23275,1355,1210,1034,888,872,1760,2794,4004,5359,88.89,20.47,15.29,10.67
14-04-2021,PORTO MONIZ,3,0,128,"[120,240]",Moderado,,,,3,Madeira,MADEIRA,3106,8293.38,2342,143,130,95,98,120,218,313,443,586,28.24,7.07,5.34,3.77
14-04-2021,PORTO SANTO,0,0,0,"[0,120]",Baixo a Moderado,,,,0,Madeira,MADEIRA,3201,4300.7,5202,240,157,134,110,68,178,312,469,709,120.95,16.48,10.9,7.25
14-04-2021,PÓVOA DE LANHOSO,3,0,14,"[0,120]",Baixo a Moderado,,,,3,Norte,BRAGA,0309,13465.29,21499,1175,909,732,673,624,1297,2029,2938,4113,159.67,30.55,21.82,15.07
14-04-2021,PÓVOA DE VARZIM,47,3,75,"[0,120]",Baixo a Moderado,,,,47,Norte,PORTO,1313,8220.59,62784,3712,3120,2134,1594,1305,2899,5033,8153,11865,763.7,144.33,99.17,61.22
14-04-2021,POVOAÇÃO,3,0,51,"[0,120]",Baixo a Moderado,,,,3,Açores,AÇORES,4204,10640.77,5927,293,212,191,144,134,278,469,681,974,55.7,9.15,6.4,4.41
14-04-2021,VILA DA PRAIA DA VITÓRIA,1,0,5,"[0,120]",Baixo a Moderado,,,,1,Açores,AÇORES,4302,16127.06,21317,1133,789,619,436,336,772,1391,2180,3313,132.18,20.54,13.52,8.63
14-04-2021,PROENÇA-A-NOVA,4,0,55,"[0,120]",Baixo a Moderado,,,,4,Centro,CASTELO BRANCO,0508,39539.96,7298,508,465,389,400,560,960,1349,1814,2322,18.46,5.87,4.59,3.41
14-04-2021,REDONDO,2,0,31,"[0,120]",Baixo a Moderado,,,,2,Alentejo,ÉVORA,0710,36950.87,6353,349,325,288,288,354,642,930,1255,1604,17.19,4.34,3.4,2.52
14-04-2021,REGUENGOS DE MONSARAZ,0,0,0,"[0,120]",Baixo a Moderado,,,,0,Alentejo,ÉVORA,0711,46399.72,10015,602,511,455,462,473,935,1390,1901,2503,21.58,5.39,4.1,3.0
14-04-2021,RESENDE,39,3,385,"[240,480]",Elevado,,,,39,Norte,VISEU,1813,12334.93,10137,560,493,448,433,422,855,1303,1796,2356,82.18,19.1,14.56,10.56
14-04-2021,RIBEIRA BRAVA,5,0,40,"[0,120]",Baixo a Moderado,,,,5,Madeira,MADEIRA,3107,6544.88,12435,648,500,411,311,287,598,1009,1509,2157,189.99,32.96,23.06,15.42
14-04-2021,RIBEIRA DE PENA,4,0,66,"[0,120]",Baixo a Moderado,,,,4,Norte,VILA REAL,1709,21745.98,6016,371,301,290,310,368,678,968,1269,1640,27.66,7.54,5.84,4.45
14-04-2021,RIBEIRA GRANDE,48,3,146,"[120,240]",Moderado,,,,48,Açores,AÇORES,4205,18015.13,32811,1163,689,512,345,253,598,1110,1799,2962,182.13,16.44,9.99,6.16
14-04-2021,RIO MAIOR,63,4,309,"[240,480]",Elevado,,,,63,Lisboa e Vale do Tejo,SANTARÉM,1414,27276.45,20379,1251,1144,941,795,648,1443,2384,3528,4779,74.71,17.52,12.93,8.74
14-04-2021,SABROSA,2,0,34,"[0,120]",Baixo a Moderado,,,,2,Norte,VILA REAL,1710,15692.45,5918,393,314,304,302,350,652,956,1270,1663,37.71,10.6,8.09,6.09
14-04-2021,SABUGAL,0,0,0,"[0,120]",Baixo a Moderado,,,,0,Centro,GUARDA,0911,82269.82,10585,724,707,694,796,1009,1805,2499,3206,3930,12.87,4.78,3.9,3.04
14-04-2021,SALVATERRA DE MAGOS,1,0,5,"[0,120]",Baixo a Moderado,,,,1,Lisboa e Vale do Tejo,SANTARÉM,1415,24393.2,21295,1275,1181,1060,799,772,1571,2631,3812,5087,87.3,20.85,15.63,10.79
14-04-2021,SANTA COMBA DÃO,6,0,57,"[0,120]",Baixo a Moderado,,,,6,Centro,VISEU,1814,11194.77,10452,732,684,569,538,464,1002,1571,2255,2987,93.36,26.68,20.14,14.03
14-04-2021,SANTA CRUZ,35,2,77,"[0,120]",Baixo a Moderado,,,,35,Madeira,MADEIRA,3108,8150.28,45281,1817,1301,974,716,523,1239,2213,3514,5331,555.6,65.41,43.12,27.15
14-04-2021,SANTA CRUZ DA GRACIOSA,0,0,0,"[0,120]",Baixo a Moderado,,,,0,Açores,AÇORES,4401,6065.78,4208,228,180,163,124,145,269,432,612,840,69.37,13.85,10.09,7.12
14-04-2021,SANTA CRUZ DAS FLORES,1,0,46,"[0,120]",Baixo a Moderado,,,,1,Açores,AÇORES,4802,7091.44,2165,125,98,74,56,51,107,181,279,404,30.53,5.7,3.93,2.55
14-04-2021,SANTA MARIA DA FEIRA,29,2,21,"[0,120]",Baixo a Moderado,,,,29,Norte,AVEIRO,0109,21587.65,138636,8182,6743,4771,3856,3079,6935,11706,18449,26631,642.19,123.36,85.46,54.22
14-04-2021,SANTA MARTA DE PENAGUIÃO,1,0,15,"[0,120]",Baixo a Moderado,,,,1,Norte,VILA REAL,1711,6928.13,6599,483,373,337,316,317,633,970,1343,1826,95.25,26.36,19.39,14.0
14-04-2021,SANTANA,7,0,104,"[0,120]",Baixo a Moderado,,,,7,Madeira,MADEIRA,3109,9547.3,6711,418,353,343,282,277,559,902,1255,1673,70.29,17.52,13.15,9.45
14-04-2021,SANTARÉM,9,1,16,"[0,120]",Baixo a Moderado,,,,9,Lisboa e Vale do Tejo,SANTARÉM,1416,55253.58,57421,3654,3441,2760,2466,2206,4672,7432,10873,14527,103.92,26.29,19.68,13.45
14-04-2021,SANTIAGO DO CACÉM,6,0,21,"[0,120]",Baixo a Moderado,,,,6,Alentejo,SETÚBAL,1509,105969.29,28791,2144,1689,1472,1295,1215,2510,3982,5671,7815,27.17,7.37,5.35,3.76
14-04-2021,SANTO TIRSO,60,4,88,"[0,120]",Baixo a Moderado,,,,60,Norte,PORTO,1314,13655.52,68055,4911,3935,2761,2257,1810,4067,6828,10763,15674,498.35,114.78,78.82,50.0
14-04-2021,SÃO BRÁS DE ALPORTEL,1,0,10,"[0,120]",Baixo a Moderado,,,,1,Algarve,FARO,0812,15336.92,10416,596,468,467,404,401,805,1272,1740,2336,67.91,15.23,11.35,8.29
14-04-2021,SÃO JOÃO DA MADEIRA,3,0,14,"[0,120]",Baixo a Moderado,,,,3,Norte,AVEIRO,0116,794.3,21958,1347,1069,796,601,593,1194,1990,3059,4406,2765.49,554.91,385.26,250.63
14-04-2021,SÃO JOÃO DA PESQUEIRA,2,0,28,"[0,120]",Baixo a Moderado,,,,2,Norte,VISEU,1815,26610.85,7125,417,330,294,328,328,656,950,1280,1697,26.77,6.38,4.81,3.57
14-04-2021,SÃO PEDRO DO SUL,5,0,32,"[0,120]",Baixo a Moderado,,,,5,Centro,VISEU,1816,34895.09,15403,990,962,861,759,909,1668,2529,3491,4481,44.14,12.84,10.0,7.25
14-04-2021,SÃO ROQUE DO PICO,0,0,0,"[0,120]",Baixo a Moderado,,,,0,Açores,AÇORES,4603,14236.1,3266,199,141,93,96,113,209,302,443,642,22.94,4.51,3.11,2.12
14-04-2021,SÃO VICENTE,4,0,78,"[0,120]",Baixo a Moderado,,,,4,Madeira,MADEIRA,3110,7883.71,5143,272,264,266,225,280,505,771,1035,1307,65.23,16.58,13.13,9.78
14-04-2021,SARDOAL,1,0,27,"[0,120]",Baixo a Moderado,,,,1,Lisboa e Vale do Tejo,SANTARÉM,1417,9214.72,3741,227,178,148,165,248,413,561,739,966,40.6,10.48,8.02,6.09
14-04-2021,SÁTÃO,2,0,17,"[0,120]",Baixo a Moderado,,,,2,Centro,VISEU,1817,20194.11,11580,765,671,515,465,476,941,1456,2127,2892,57.34,14.32,10.53,7.21
14-04-2021,SEIA,1,0,4,"[0,120]",Baixo a Moderado,,,,1,Centro,GUARDA,0912,43568.83,22234,1807,1589,1238,1122,721,1843,3081,4670,6477,51.03,14.87,10.72,7.07
14-04-2021,SEIXAL,81,6,48,"[0,120]",Baixo a Moderado,,,,81,Lisboa e Vale do Tejo,SETÚBAL,1510,9545.17,167752,10586,9270,6661,4391,2930,7321,13982,23252,33838,1757.49,354.51,243.6,146.49
14-04-2021,SERNANCELHE,0,0,0,"[0,120]",Baixo a Moderado,,,,0,Norte,VISEU,1818,22861.22,5396,305,293,286,273,260,533,819,1112,1417,23.6,6.2,4.86,3.58
14-04-2021,SERPA,13,1,91,"[0,120]",Baixo a Moderado,,,,13,Alentejo,BEJA,0213,110563.34,14304,903,761,719,697,626,1323,2042,2803,3706,12.94,3.35,2.54,1.85
14-04-2021,SERTÃ,0,0,0,"[0,120]",Baixo a Moderado,,,,0,Centro,CASTELO BRANCO,0509,44673.17,14577,870,779,790,767,1020,1787,2577,3356,4226,32.63,9.46,7.51,5.77
14-04-2021,SESIMBRA,20,1,39,"[0,120]",Baixo a Moderado,,,,20,Lisboa e Vale do Tejo,SETÚBAL,1511,19571.75,51858,2400,2321,1853,1257,1083,2340,4193,6514,8914,264.96,45.54,33.28,21.42
14-04-2021,SETÚBAL,79,6,69,"[0,120]",Baixo a Moderado,,,,79,Lisboa e Vale do Tejo,SETÚBAL,1512,23032.5,115126,7425,6929,5075,3775,2655,6430,11505,18434,25859,499.83,112.27,80.03,49.95
14-04-2021,SEVER DO VOUGA,12,1,106,"[0,120]",Baixo a Moderado,,,,12,Centro,AVEIRO,0117,12987.56,11331,766,637,568,540,567,1107,1675,2312,3078,87.24,23.7,17.8,12.9
14-04-2021,SILVES,29,2,80,"[0,120]",Baixo a Moderado,,,,29,Algarve,FARO,0813,68006.23,36226,2137,1869,1610,1423,1600,3023,4633,6502,8639,53.27,12.7,9.56,6.81
14-04-2021,SINES,4,0,29,"[0,120]",Baixo a Moderado,,,,4,Alentejo,SETÚBAL,1513,20330.17,13715,888,791,551,416,268,684,1235,2026,2914,67.46,14.33,9.97,6.07
14-04-2021,SINTRA,348,25,89,"[0,120]",Baixo a Moderado,,,,348,Lisboa e Vale do Tejo,LISBOA,1111,31922.73,391402,20490,18316,13545,9137,7284,16421,29966,48282,68772,1226.08,215.43,151.25,93.87
14-04-2021,SOBRAL DE MONTE AGRAÇO,7,1,66,"[0,120]",Baixo a Moderado,,,,7,Lisboa e Vale do Tejo,LISBOA,1112,5210.32,10651,564,507,352,272,212,484,836,1343,1907,204.43,36.6,25.78,16.05
14-04-2021,SOURE,6,0,35,"[0,120]",Baixo a Moderado,,,,6,Centro,COIMBRA,0615,26506.07,17120,1173,1142,1004,883,987,1870,2874,4016,5189,64.59,19.58,15.15,10.84
14-04-2021,SOUSEL,0,0,0,"[0,120]",Baixo a Moderado,,,,0,Alentejo,PORTALEGRE,1215,27932.18,4412,261,274,208,302,292,594,802,1076,1337,15.8,4.79,3.85,2.87
14-04-2021,TÁBUA,3,0,26,"[0,120]",Baixo a Moderado,,,,3,Centro,COIMBRA,0616,19978.58,11368,729,584,524,430,464,894,1418,2002,2731,56.9,13.67,10.02,7.1
14-04-2021,TABUAÇO,5,0,83,"[0,120]",Baixo a Moderado,,,,5,Norte,VISEU,1819,13385.67,6033,372,314,217,282,363,645,862,1176,1548,45.07,11.56,8.79,6.44
14-04-2021,TAROUCA,2,0,26,"[0,120]",Baixo a Moderado,,,,2,Norte,VISEU,1820,10008.49,7804,405,335,313,277,324,601,914,1249,1654,77.98,16.53,12.48,9.13
14-04-2021,TAVIRA,21,2,86,"[0,120]",Baixo a Moderado,,,,21,Algarve,FARO,0814,60696.7,24530,1493,1415,1252,1066,1277,2343,3595,5010,6503,40.41,10.71,8.25,5.92
14-04-2021,TERRAS DE BOURO,1,0,16,"[0,120]",Baixo a Moderado,,,,1,Norte,BRAGA,0310,27746.07,6361,391,372,296,319,340,659,955,1327,1718,22.93,6.19,4.78,3.44
14-04-2021,TOMAR,12,1,33,"[0,120]",Baixo a Moderado,,,,12,Lisboa e Vale do Tejo,SANTARÉM,1418,35120.44,36748,2403,2189,1868,1853,1822,3675,5543,7732,10135,104.64,28.86,22.02,15.78
14-04-2021,TONDELA,15,1,57,"[0,120]",Baixo a Moderado,,,,15,Centro,VISEU,1821,37121.73,26357,1768,1722,1518,1475,1417,2892,4410,6132,7900,71.0,21.28,16.52,11.88
14-04-2021,TORRE DE MONCORVO,0,0,0,"[0,120]",Baixo a Moderado,,,,0,Norte,BRAGANÇA,0409,53155.67,7695,556,478,488,551,719,1270,1758,2236,2792,14.48,5.25,4.21,3.31
14-04-2021,TORRES NOVAS,6,0,17,"[0,120]",Baixo a Moderado,,,,6,Lisboa e Vale do Tejo,SANTARÉM,1419,26999.68,34933,2324,1979,1738,1406,1475,2881,4619,6598,8922,129.38,33.04,24.44,17.11
14-04-2021,TORRES VEDRAS,70,5,89,"[0,120]",Baixo a Moderado,,,,70,Lisboa e Vale do Tejo,LISBOA,1113,40714.89,78530,4513,3945,3447,2628,2104,4732,8179,12124,16637,192.88,40.86,29.78,20.09
14-04-2021,TRANCOSO,1,0,11,"[0,120]",Baixo a Moderado,,,,1,Centro,GUARDA,0913,36152.47,8875,581,557,542,586,496,1082,1624,2181,2762,24.55,7.64,6.03,4.49
14-04-2021,TROFA,25,2,65,"[0,120]",Baixo a Moderado,,,,25,Norte,PORTO,1318,7201.76,38418,2336,1894,1231,939,684,1623,2854,4748,7084,533.44,98.36,65.93,39.63
14-04-2021,VAGOS,8,1,35,"[0,120]",Baixo a Moderado,,,,8,Centro,AVEIRO,0118,16491.5,22740,1320,1205,922,784,724,1508,2430,3635,4955,137.89,30.04,22.04,14.73
14-04-2021,VALE DE CAMBRA,7,1,33,"[0,120]",Baixo a Moderado,,,,7,Norte,AVEIRO,0119,14733.47,21327,1491,1363,1005,831,798,1629,2634,3997,5488,144.76,37.25,27.13,17.88
14-04-2021,VALENÇA,10,1,75,"[0,120]",Baixo a Moderado,,,,10,Norte,VIANA DO CASTELO,1608,11712.86,13290,867,791,582,582,503,1085,1667,2458,3325,113.46,28.39,20.99,14.23
14-04-2021,VALONGO,152,11,156,"[120,240]",Moderado,,,,152,Norte,PORTO,1315,7512.45,97444,5629,4696,3207,2462,1829,4291,7498,12194,17823,1297.18,237.26,162.33,99.81
14-04-2021,VALPAÇOS,13,1,88,"[0,120]",Baixo a Moderado,,,,13,Norte,VILA REAL,1712,54873.93,14818,1217,1118,999,928,997,1925,2924,4042,5259,27.0,9.58,7.37,5.33
14-04-2021,VELAS,0,0,0,"[0,120]",Baixo a Moderado,,,,0,Açores,AÇORES,4502,11738.38,5093,278,208,166,153,113,266,432,640,918,43.39,7.82,5.45,3.68
14-04-2021,VENDAS NOVAS,0,0,0,"[0,120]",Baixo a Moderado,,,,0,Alentejo,ÉVORA,0712,22238.88,11255,677,768,655,501,532,1033,1688,2456,3133,50.61,14.09,11.04,7.59
14-04-2021,VIANA DO ALENTEJO,1,0,19,"[0,120]",Baixo a Moderado,,,,1,Alentejo,ÉVORA,0713,39367.29,5145,245,208,235,210,214,424,659,867,1112,13.07,2.82,2.2,1.67
14-04-2021,VIANA DO CASTELO,64,5,76,"[0,120]",Baixo a Moderado,,,,64,Norte,VIANA DO CASTELO,1609,31902.01,84417,5470,4433,3591,3061,2982,6043,9634,14067,19537,264.61,61.24,44.09,30.2
14-04-2021,VIDIGUEIRA,0,0,0,"[0,120]",Baixo a Moderado,,,,0,Alentejo,BEJA,0214,31661.09,5510,300,248,215,233,275,508,723,971,1271,17.4,4.01,3.07,2.28
14-04-2021,VIEIRA DO MINHO,4,0,34,"[0,120]",Baixo a Moderado,,,,4,Norte,BRAGA,0311,21644.35,11842,703,594,525,548,482,1030,1555,2149,2852,54.71,13.18,9.93,7.18
14-04-2021,VILA DE REI,1,0,30,"[0,120]",Baixo a Moderado,,,,1,Centro,CASTELO BRANCO,0510,19154.6,3323,169,128,172,247,302,549,721,849,1018,17.35,5.31,4.43,3.76
14-04-2021,VILA DO BISPO,0,0,0,"[0,120]",Baixo a Moderado,,,,0,Algarve,FARO,0815,17906.06,5154,302,302,314,232,233,465,779,1081,1383,28.78,7.72,6.04,4.35
14-04-2021,VILA DO CONDE,35,3,44,"[0,120]",Baixo a Moderado,,,,35,Norte,PORTO,1316,14902.77,79899,4726,3875,2819,2070,1743,3813,6632,10507,15233,536.13,102.21,70.5,44.5
14-04-2021,VILA DO PORTO,1,0,18,"[0,120]",Baixo a Moderado,,,,1,Açores,AÇORES,4101,9688.74,5616,274,212,135,96,123,219,354,566,840,57.96,8.67,5.84,3.65
14-04-2021,VILA FLOR,1,0,17,"[0,120]",Baixo a Moderado,,,,1,Norte,BRAGANÇA,0410,26581.14,6044,429,362,422,294,331,625,1047,1409,1838,22.74,6.91,5.3,3.94
14-04-2021,VILA FRANCA DE XIRA,221,16,156,"[120,240]",Moderado,,,,221,Lisboa e Vale do Tejo,LISBOA,1114,31819.39,141957,8501,6852,4869,3425,2472,5897,10766,17618,26119,446.14,82.09,55.37,33.84
14-04-2021,VILA FRANCA DO CAMPO,145,10,1312,"[960,Max]",Extremamente Elevado,,,,145,Açores,AÇORES,4206,7796.82,11051,450,344,248,217,154,371,619,963,1413,141.73,18.12,12.35,7.94
14-04-2021,VILA NOVA DA BARQUINHA,1,0,13,"[0,120]",Baixo a Moderado,,,,1,Lisboa e Vale do Tejo,SANTARÉM,1420,4952.97,7461,415,406,392,364,338,702,1094,1500,1915,150.64,38.66,30.28,22.09
14-04-2021,VILA NOVA DE CERVEIRA,5,0,56,"[0,120]",Baixo a Moderado,,,,5,Norte,VIANA DO CASTELO,1610,10846.66,8910,531,444,410,384,334,718,1128,1572,2103,82.14,19.39,14.49,10.4
14-04-2021,VILA NOVA DE FAMALICÃO,165,12,125,"[120,240]",Moderado,,,,165,Norte,BRAGA,0312,20159.26,131676,7817,6164,4202,3282,2749,6031,10233,16397,24214,653.19,120.12,81.34,50.76
14-04-2021,VILA NOVA DE FOZ CÔA,3,0,46,"[0,120]",Baixo a Moderado,,,,3,Centro,GUARDA,0914,39815.18,6503,442,385,390,398,429,827,1217,1602,2044,16.33,5.13,4.02,3.06
14-04-2021,VILA NOVA DE GAIA,162,12,54,"[0,120]",Baixo a Moderado,,,,162,Norte,PORTO,1317,16846.43,300472,18349,15568,10972,8224,6281,14505,25477,41045,59394,1783.64,352.57,243.65,151.23
14-04-2021,VILA NOVA DE PAIVA,0,0,0,"[0,120]",Baixo a Moderado,,,,0,Centro,VISEU,1822,17553.28,4687,289,272,233,217,241,458,691,963,1252,26.7,7.13,5.49,3.94
14-04-2021,VILA NOVA DE POIARES,0,0,0,"[0,120]",Baixo a Moderado,,,,0,Centro,COIMBRA,0617,8445.3,6939,380,284,262,235,182,417,679,963,1343,82.17,15.9,11.4,8.04
14-04-2021,VILA POUCA DE AGUIAR,7,1,59,"[0,120]",Baixo a Moderado,,,,7,Norte,VILA REAL,1713,43706.62,11961,860,817,733,601,627,1228,1961,2778,3638,27.37,8.32,6.36,4.49
14-04-2021,VILA REAL,10,1,20,"[0,120]",Baixo a Moderado,,,,10,Norte,VILA REAL,1714,37880.28,49962,3025,2498,2065,1579,1466,3045,5110,7608,10633,131.9,28.07,20.08,13.49
14-04-2021,VILA REAL DE SANTO ANTÓNIO,6,0,32,"[0,120]",Baixo a Moderado,,,,6,Algarve,FARO,0816,6125.0,18749,1172,1069,811,569,586,1155,1966,3035,4207,306.11,68.69,49.55,32.1
14-04-2021,VILA VELHA DE RÓDÃO,0,0,0,"[0,120]",Baixo a Moderado,,,,0,Centro,CASTELO BRANCO,0511,32991.16,3144,209,229,180,283,306,589,769,998,1207,9.53,3.66,3.03,2.33
14-04-2021,VILA VERDE,21,2,45,"[0,120]",Baixo a Moderado,,,,21,Norte,BRAGA,0313,22866.52,46911,2365,2063,1667,1494,1437,2931,4598,6661,9026,205.15,39.47,29.13,20.11
14-04-2021,VILA VIÇOSA,0,0,0,"[0,120]",Baixo a Moderado,,,,0,Alentejo,ÉVORA,0714,19485.89,7656,487,379,342,345,324,669,1011,1390,1877,39.29,9.63,7.13,5.19
14-04-2021,VIMIOSO,3,0,75,"[0,120]",Baixo a Moderado,,,,3,Norte,BRAGANÇA,0411,48158.51,4023,274,230,261,293,335,628,889,1119,1393,8.35,2.89,2.32,1.85
14-04-2021,VINHAIS,5,0,65,"[0,120]",Baixo a Moderado,,,,5,Norte,BRAGANÇA,0412,69475.09,7746,599,577,636,641,815,1456,2092,2669,3268,11.15,4.7,3.84,3.01
14-04-2021,VISEU,14,1,14,"[0,120]",Baixo a Moderado,,,,14,Centro,VISEU,1823,50710.14,97249,5769,5038,4140,3158,2710,5868,10008,15046,20815,191.77,41.05,29.67,19.74
14-04-2021,VIZELA,6,0,25,"[0,120]",Baixo a Moderado,,,,6,Norte,BRAGA,0314,2469.83,23897,1258,928,655,509,371,880,1535,2463,3721,967.49,150.65,99.72,62.15
14-04-2021,VOUZELA,4,0,42,"[0,120]",Baixo a Moderado,,,,4,Centro,VISEU,1824,19369.46,9619,626,605,554,532,507,1039,1593,2198,2824,49.66,14.58,11.35,8.22
21-04-2021,ABRANTES,29,2,83,"[0,120]",Baixo a Moderado,,,,29,Lisboa e Vale do Tejo,SANTARÉM,1401,71469.08,35130,2473,2213,1730,1748,2021,3769,5499,7712,10185,49.15,14.25,10.79,7.69
21-04-2021,ÁGUEDA,7,0,15,"[0,120]",Baixo a Moderado,,,,7,Centro,AVEIRO,0101,33527.44,46075,3237,2713,2090,1635,1496,3131,5221,7934,11171,137.43,33.32,23.66,15.57
21-04-2021,AGUIAR DA BEIRA,4,0,86,"[0,120]",Baixo a Moderado,,,,4,Centro,GUARDA,0901,20676.57,4652,304,281,235,239,148,387,622,903,1207,22.5,5.84,4.37,3.01
21-04-2021,ALANDROAL,3,0,60,"[0,120]",Baixo a Moderado,,,,3,Alentejo,ÉVORA,0701,54267.81,4992,307,256,296,299,377,676,972,1228,1535,9.2,2.83,2.26,1.79
21-04-2021,ALBERGARIA-A-VELHA,7,1,29,"[0,120]",Baixo a Moderado,,,,7,Centro,AVEIRO,0102,15882.5,24144,1550,1298,996,687,680,1367,2363,3661,5211,152.02,32.81,23.05,14.88
21-04-2021,ALBUFEIRA,66,5,159,"[120,240]",Moderado,,,,66,Algarve,FARO,0801,14066.42,41528,2067,1717,1425,985,858,1843,3268,4985,7052,295.24,50.14,35.44,23.23
21-04-2021,ALCÁCER DO SAL,1,0,9,"[0,120]",Baixo a Moderado,,,,1,Alentejo,SETÚBAL,1501,149987.3,11659,884,814,623,623,602,1225,1848,2662,3546,7.77,2.36,1.77,1.23
21-04-2021,ALCANENA,2,0,16,"[0,120]",Baixo a Moderado,,,,2,Lisboa e Vale do Tejo,SANTARÉM,1402,12732.86,12809,891,744,628,536,588,1124,1752,2496,3387,100.6,26.6,19.6,13.76
21-04-2021,ALCOBAÇA,23,2,43,"[0,120]",Baixo a Moderado,,,,23,Lisboa e Vale do Tejo,LEIRIA,1001,40814.09,53555,3420,2927,2466,2059,1676,3735,6201,9128,12548,131.22,30.74,22.36,15.19
21-04-2021,ALCOCHETE,9,1,45,"[0,120]",Baixo a Moderado,,,,9,Lisboa e Vale do Tejo,SETÚBAL,1502,12836.48,19787,857,834,691,476,447,923,1614,2448,3305,154.15,25.75,19.07,12.57
21-04-2021,ALCOUTIM,0,0,0,"[0,120]",Baixo a Moderado,,,,0,Algarve,FARO,0802,57536.33,2159,191,188,163,190,267,457,620,808,999,3.75,1.74,1.4,1.08
21-04-2021,ALENQUER,14,1,32,"[0,120]",Baixo a Moderado,,,,14,Lisboa e Vale do Tejo,LISBOA,1101,30421.92,44052,2298,2062,1629,1330,1155,2485,4114,6176,8474,144.8,27.85,20.3,13.52
21-04-2021,ALFÂNDEGA DA FÉ,0,0,0,"[0,120]",Baixo a Moderado,,,,0,Norte,BRAGANÇA,0401,32194.64,4550,325,277,301,274,325,599,900,1177,1502,14.13,4.67,3.66,2.8
21-04-2021,ALIJÓ,22,2,207,"[120,240]",Moderado,,,,22,Norte,VILA REAL,1701,29759.89,10625,766,687,635,542,666,1208,1843,2530,3296,35.7,11.08,8.5,6.19
21-04-2021,ALJEZUR,28,2,501,"[480,960]",Muito Elevado,,,,28,Algarve,FARO,0803,32349.95,5594,316,336,335,320,410,730,1065,1401,1717,17.29,5.31,4.33,3.29
21-04-2021,ALJUSTREL,0,0,0,"[0,120]",Baixo a Moderado,,,,0,Alentejo,BEJA,0201,45847.41,8247,635,521,443,347,358,705,1148,1669,2304,17.99,5.03,3.64,2.5
21-04-2021,ALMADA,128,9,76,"[0,120]",Baixo a Moderado,,,,128,Lisboa e Vale do Tejo,SETÚBAL,1503,7000.89,169039,10469,9777,7876,6144,5111,11255,19131,28908,39377,2414.5,562.45,412.91,273.26
21-04-2021,ALMEIDA,1,0,17,"[0,120]",Baixo a Moderado,,,,1,Centro,GUARDA,0902,51798.46,5830,441,419,396,458,393,851,1247,1666,2107,11.26,4.07,3.22,2.41
21-04-2021,ALMEIRIM,43,3,191,"[120,240]",Moderado,,,,43,Lisboa e Vale do Tejo,SANTARÉM,1403,22212.05,22546,1342,1353,1106,866,843,1709,2815,4168,5510,101.5,24.81,18.76,12.67
21-04-2021,ALMODÔVAR,0,0,0,"[0,120]",Baixo a Moderado,,,,0,Alentejo,BEJA,0202,77788.03,6725,414,443,396,373,328,701,1097,1540,1954,8.65,2.51,1.98,1.41
21-04-2021,ALPIARÇA,12,1,170,"[120,240]",Moderado,,,,12,Lisboa e Vale do Tejo,SANTARÉM,1404,9536.33,7059,515,486,363,333,274,607,970,1456,1971,74.02,20.67,15.27,10.17
21-04-2021,ALTER DO CHÃO,0,0,0,"[0,120]",Baixo a Moderado,,,,0,Alentejo,PORTALEGRE,1201,36206.62,3165,201,163,136,208,187,395,531,694,895,8.74,2.47,1.92,1.47
21-04-2021,ALVAIÁZERE,1,0,15,"[0,120]",Baixo a Moderado,,,,1,Centro,LEIRIA,1002,16047.76,6597,419,389,346,406,539,945,1291,1680,2099,41.11,13.08,10.47,8.04
21-04-2021,ALVITO,0,0,0,"[0,120]",Baixo a Moderado,,,,0,Alentejo,BEJA,0203,26485.32,2477,145,110,105,111,89,200,305,415,560,9.35,2.11,1.57,1.15
21-04-2021,AMADORA,94,7,51,"[0,120]",Baixo a Moderado,,,,94,Lisboa e Vale do Tejo,LISBOA,1115,2378.47,184106,11186,10936,8780,6460,5890,12350,21130,32066,43252,7742.05,1818.84,1348.44,888.56
21-04-2021,AMARANTE,20,1,38,"[0,120]",Baixo a Moderado,,,,20,Norte,PORTO,1301,30133.15,53193,3086,2413,1812,1643,1311,2954,4766,7179,10265,176.53,34.07,23.82,15.82
21-04-2021,AMARES,3,0,17,"[0,120]",Baixo a Moderado,,,,3,Norte,BRAGA,0301,8195.41,18129,1001,829,622,489,524,1013,1635,2464,3465,221.22,42.28,30.07,19.95
21-04-2021,ANADIA,5,0,18,"[0,120]",Baixo a Moderado,,,,5,Centro,AVEIRO,0103,21663.48,27258,1931,1698,1376,1208,1262,2470,3846,5544,7475,125.83,34.51,25.59,17.75
21-04-2021,ANGRA DO HEROÍSMO,6,0,18,"[0,120]",Baixo a Moderado,,,,6,Açores,AÇORES,4301,23899.66,33807,2006,1473,1122,768,635,1403,2525,3998,6004,141.45,25.12,16.73,10.56
21-04-2021,ANSIÃO,5,0,42,"[0,120]",Baixo a Moderado,,,,5,Centro,LEIRIA,1003,17609.42,12039,727,709,646,694,530,1224,1870,2579,3306,68.37,18.77,14.65,10.62
21-04-2021,ARCOS DE VALDEVEZ,8,1,38,"[0,120]",Baixo a Moderado,,,,8,Norte,VIANA DO CASTELO,1601,44759.64,20926,1329,1338,1282,1343,1515,2858,4140,5478,6807,46.75,15.21,12.24,9.25
21-04-2021,ARGANIL,14,1,127,"[120,240]",Moderado,,,,14,Centro,COIMBRA,0601,33283.93,11014,672,648,612,559,596,1155,1767,2415,3087,33.09,9.27,7.26,5.31
21-04-2021,ARMAMAR,1,0,17,"[0,120]",Baixo a Moderado,,,,1,Norte,VISEU,1801,11723.73,5769,357,305,309,285,310,595,904,1209,1566,49.21,13.36,10.31,7.71
21-04-2021,AROUCA,5,0,24,"[0,120]",Baixo a Moderado,,,,5,Norte,AVEIRO,0104,32910.52,20720,1306,1047,753,683,683,1366,2119,3166,4472,62.96,13.59,9.62,6.44
21-04-2021,ARRAIOLOS,0,0,0,"[0,120]",Baixo a Moderado,,,,0,Alentejo,ÉVORA,0702,68374.55,6928,435,384,283,367,480,847,1130,1514,1949,10.13,2.85,2.21,1.65
21-04-2021,ARRONCHES,1,0,35,"[0,120]",Baixo a Moderado,,,,1,Alentejo,PORTALEGRE,1202,31464.72,2820,155,142,162,187,179,366,528,670,825,8.96,2.62,2.13,1.68
21-04-2021,ARRUDA DOS VINHOS,5,0,32,"[0,120]",Baixo a Moderado,,,,5,Lisboa e Vale do Tejo,LISBOA,1102,7795.93,15412,738,738,562,509,438,947,1509,2247,2985,197.69,38.29,28.82,19.36
21-04-2021,AVEIRO,34,2,43,"[0,120]",Baixo a Moderado,,,,34,Centro,AVEIRO,0105,19757.57,78734,4520,4004,3050,2250,2103,4353,7403,11407,15927,398.49,80.61,57.73,37.47
21-04-2021,AVIS,0,0,0,"[0,120]",Baixo a Moderado,,,,0,Alentejo,PORTALEGRE,1203,60596.51,4247,315,225,206,251,273,524,730,955,1270,7.01,2.1,1.58,1.2
21-04-2021,AZAMBUJA,1,0,4,"[0,120]",Baixo a Moderado,,,,1,Lisboa e Vale do Tejo,LISBOA,1103,26265.65,22716,1322,1171,1070,798,618,1416,2486,3657,4979,86.48,18.96,13.92,9.46
21-04-2021,BAIÃO,23,2,123,"[120,240]",Moderado,,,,23,Norte,PORTO,1302,17452.83,18748,1070,862,714,686,725,1411,2125,2987,4057,107.42,23.25,17.11,12.18
21-04-2021,BARCELOS,100,7,86,"[0,120]",Baixo a Moderado,,,,100,Norte,BRAGA,0302,37890.14,116187,6721,5325,3619,2991,2562,5553,9172,14497,21218,306.64,56.0,38.26,24.21
21-04-2021,BARRANCOS,2,0,122,"[120,240]",Moderado,,,,2,Alentejo,BEJA,0204,16841.73,1634,90,65,65,94,61,155,220,285,375,9.7,2.23,1.69,1.31
21-04-2021,BARREIRO,61,4,81,"[0,120]",Baixo a Moderado,,,,61,Lisboa e Vale do Tejo,SETÚBAL,1504,3639.07,75147,5194,5565,4459,3105,1767,4872,9331,14896,20090,2065.05,552.07,409.34,256.42
21-04-2021,BATALHA,8,1,50,"[0,120]",Baixo a Moderado,,,,8,Centro,LEIRIA,1004,10341.6,15963,873,762,649,529,549,1078,1727,2489,3362,154.35,32.51,24.07,16.7
21-04-2021,BEJA,33,2,98,"[0,120]",Baixo a Moderado,,,,33,Alentejo,BEJA,0205,114647.55,33579,2005,1840,1386,1272,1039,2311,3697,5537,7542,29.29,6.58,4.83,3.22
21-04-2021,BELMONTE,0,0,0,"[0,120]",Baixo a Moderado,,,,0,Centro,CASTELO BRANCO,0501,11875.91,6398,444,321,325,310,355,665,990,1311,1755,53.87,14.78,11.04,8.34
21-04-2021,BENAVENTE,20,1,65,"[0,120]",Baixo a Moderado,,,,20,Lisboa e Vale do Tejo,SANTARÉM,1405,52138.39,30602,1468,1376,1141,876,643,1519,2660,4036,5504,58.69,10.56,7.74,5.1
21-04-2021,BOMBARRAL,1,0,8,"[0,120]",Baixo a Moderado,,,,1,Lisboa e Vale do Tejo,LEIRIA,1005,9128.55,12558,875,714,561,491,429,920,1481,2195,3070,137.56,33.63,24.04,16.22
21-04-2021,BORBA,3,0,45,"[0,120]",Baixo a Moderado,,,,3,Alentejo,ÉVORA,0703,14518.65,6736,430,375,279,436,392,828,1107,1482,1912,46.39,13.17,10.21,7.62
21-04-2021,BOTICAS,3,0,60,"[0,120]",Baixo a Moderado,,,,3,Norte,VILA REAL,1702,32195.66,4998,347,306,311,305,380,685,996,1302,1649,15.52,5.12,4.04,3.09
21-04-2021,BRAGA,88,6,48,"[0,120]",Baixo a Moderado,,,,88,Norte,BRAGA,0303,18339.95,182679,10029,7963,5241,4320,3671,7991,13232,21195,31224,996.07,170.25,115.57,72.15
21-04-2021,BRAGANÇA,15,1,45,"[0,120]",Baixo a Moderado,,,,15,Norte,BRAGANÇA,0402,117357.27,33607,2402,1855,1652,1393,1163,2556,4208,6063,8465,28.64,7.21,5.17,3.59
21-04-2021,CABECEIRAS DE BASTO,51,4,326,"[240,480]",Elevado,,,,51,Norte,BRAGA,0304,24182.16,15628,774,594,544,575,574,1149,1693,2287,3061,64.63,12.66,9.46,7.0
21-04-2021,CADAVAL,2,0,15,"[0,120]",Baixo a Moderado,,,,2,Lisboa e Vale do Tejo,LISBOA,1104,17489.3,13673,813,796,756,621,625,1246,2002,2798,3611,78.18,20.65,16.0,11.45
21-04-2021,CALDAS DA RAINHA,9,1,17,"[0,120]",Baixo a Moderado,,,,9,Lisboa e Vale do Tejo,LEIRIA,1006,25569.47,51912,3035,2684,2186,1899,1705,3604,5790,8474,11509,203.03,45.01,33.14,22.64
21-04-2021,CALHETA,0,0,0,"[0,120]",Baixo a Moderado,,,,0,Madeira,MADEIRA,3101,11150.43,10867,576,497,507,399,415,814,1321,1818,2394,97.46,21.47,16.3,11.85
21-04-2021,CALHETA (AÇORES),0,0,0,"[0,120]",Baixo a Moderado,,,,0,Açores,AÇORES,4501,12626.4,3184,215,159,141,139,122,261,402,561,776,25.22,6.15,4.44,3.18
21-04-2021,CÂMARA DE LOBOS,18,1,53,"[0,120]",Baixo a Moderado,,,,18,Madeira,MADEIRA,3102,5216.67,33675,1396,1059,834,545,381,926,1760,2819,4215,645.49,80.79,54.03,33.74
21-04-2021,CAMINHA,7,0,44,"[0,120]",Baixo a Moderado,,,,7,Norte,VIANA DO CASTELO,1602,13652.14,15877,1046,944,818,646,656,1302,2120,3064,4110,116.3,30.11,22.44,15.53
21-04-2021,CAMPO MAIOR,1,0,13,"[0,120]",Baixo a Moderado,,,,1,Alentejo,PORTALEGRE,1204,24720.16,7874,471,364,351,279,327,606,957,1321,1792,31.85,7.25,5.34,3.87
21-04-2021,CANTANHEDE,4,0,11,"[0,120]",Baixo a Moderado,,,,4,Centro,COIMBRA,0602,39088.02,35011,2346,2096,1880,1709,1451,3160,5040,7136,9482,89.57,24.26,18.26,12.89
21-04-2021,CARRAZEDA DE ANSIÃES,0,0,0,"[0,120]",Baixo a Moderado,,,,0,Norte,BRAGANÇA,0403,27924.09,5666,424,389,391,312,465,777,1168,1557,1981,20.29,7.09,5.58,4.18
21-04-2021,CARREGAL DO SAL,21,2,227,"[120,240]",Moderado,,,,21,Centro,VISEU,1802,11689.21,9271,587,562,486,462,376,838,1324,1886,2473,79.31,21.16,16.13,11.33
21-04-2021,CARTAXO,7,0,29,"[0,120]",Baixo a Moderado,,,,7,Lisboa e Vale do Tejo,SANTARÉM,1406,15817.28,23843,1415,1376,1142,861,632,1493,2635,4011,5426,150.74,34.3,25.36,16.66
21-04-2021,CASCAIS,94,7,44,"[0,120]",Baixo a Moderado,,,,94,Lisboa e Vale do Tejo,LISBOA,1105,9740.17,213608,12151,11444,8680,6469,5248,11717,20397,31841,43992,2193.1,451.66,326.91,209.41
21-04-2021,CASTANHEIRA DE PÊRA,0,0,0,"[0,120]",Baixo a Moderado,,,,0,Centro,LEIRIA,1007,6677.45,2614,233,195,157,190,187,377,534,729,962,39.15,14.41,10.92,8.0
21-04-2021,CASTELO BRANCO,5,0,10,"[0,120]",Baixo a Moderado,,,,5,Centro,CASTELO BRANCO,0502,143819.15,51987,3528,3042,2499,2229,2225,4454,6953,9995,13523,36.15,9.4,6.95,4.83
21-04-2021,CASTELO DE PAIVA,21,2,136,"[120,240]",Moderado,,,,21,Norte,AVEIRO,0106,11500.53,15454,881,697,545,420,431,851,1396,2093,2974,134.37,25.86,18.2,12.14
21-04-2021,CASTELO DE VIDE,1,0,34,"[0,120]",Baixo a Moderado,,,,1,Alentejo,PORTALEGRE,1205,26491.24,2919,204,173,179,147,170,317,496,669,873,11.02,3.3,2.53,1.87
21-04-2021,CASTRO DAIRE,13,1,94,"[0,120]",Baixo a Moderado,,,,13,Centro,VISEU,1803,37904.13,13823,942,857,765,732,773,1505,2270,3127,4069,36.47,10.74,8.25,5.99
21-04-2021,CASTRO MARIM,1,0,16,"[0,120]",Baixo a Moderado,,,,1,Algarve,FARO,0804,30084.37,6237,370,345,334,322,344,666,1000,1345,1715,20.73,5.7,4.47,3.32
21-04-2021,CASTRO VERDE,1,0,14,"[0,120]",Baixo a Moderado,,,,1,Alentejo,BEJA,0206,56944.23,6949,437,347,303,275,227,502,805,1152,1589,12.2,2.79,2.02,1.41
21-04-2021,CELORICO DA BEIRA,2,0,29,"[0,120]",Baixo a Moderado,,,,2,Centro,GUARDA,0903,24721.63,6928,430,416,363,369,535,904,1267,1683,2113,28.02,8.55,6.81,5.12
21-04-2021,CELORICO DE BASTO,22,2,116,"[0,120]",Baixo a Moderado,,,,22,Norte,BRAGA,0305,18107.02,19040,1001,802,668,728,729,1457,2125,2927,3928,105.15,21.69,16.17,11.74
21-04-2021,CHAMUSCA,3,0,33,"[0,120]",Baixo a Moderado,,,,3,Lisboa e Vale do Tejo,SANTARÉM,1407,74600.54,9197,629,583,553,465,579,1044,1597,2180,2809,12.33,3.77,2.92,2.14
21-04-2021,CHAVES,24,2,61,"[0,120]",Baixo a Moderado,,,,24,Norte,VILA REAL,1703,59122.95,39343,2676,2429,1991,1886,1918,3804,5795,8224,10900,66.54,18.44,13.91,9.8
21-04-2021,CINFÃES,45,3,247,"[240,480]",Elevado,,,,45,Norte,VISEU,1804,23928.76,18244,1067,902,779,734,758,1492,2271,3173,4240,76.24,17.72,13.26,9.49
21-04-2021,COIMBRA,51,4,38,"[0,120]",Baixo a Moderado,,,,51,Centro,COIMBRA,0603,31939.94,134166,9489,8734,6353,5139,5074,10213,16566,25300,34789,420.06,108.92,79.21,51.87
21-04-2021,CONDEIXA-A-NOVA,4,0,23,"[0,120]",Baixo a Moderado,,,,4,Centro,COIMBRA,0604,13867.47,17733,871,809,717,583,490,1073,1790,2599,3470,127.88,25.02,18.74,12.91
21-04-2021,CONSTÂNCIA,1,0,25,"[0,120]",Baixo a Moderado,,,,1,Lisboa e Vale do Tejo,SANTARÉM,1408,8036.58,4030,211,183,187,148,155,303,490,673,884,50.14,11.0,8.37,6.1
21-04-2021,CORUCHE,35,2,200,"[120,240]",Moderado,,,,35,Lisboa e Vale do Tejo,SANTARÉM,1409,111572.03,17471,1294,1090,1095,1096,1019,2115,3210,4300,5594,15.66,5.01,3.85,2.88
21-04-2021,CORVO,0,0,0,"[0,120]",Baixo a Moderado,,,,0,Açores,AÇORES,4901,1711.45,464,22,21,11,13,19,32,43,64,86,27.12,5.03,3.74,2.51
21-04-2021,COVILHÃ,4,0,9,"[0,120]",Baixo a Moderado,,,,4,Centro,CASTELO BRANCO,0503,55560.06,46787,3533,2998,2365,2111,2193,4304,6669,9667,13200,84.21,23.76,17.4,12.0
21-04-2021,CRATO,0,0,0,"[0,120]",Baixo a Moderado,,,,0,Alentejo,PORTALEGRE,1206,39806.88,3129,229,258,163,182,228,410,573,831,1060,7.86,2.66,2.09,1.44
21-04-2021,CUBA,3,0,65,"[0,120]",Baixo a Moderado,,,,3,Alentejo,BEJA,0207,17208.72,4595,255,233,206,190,143,333,539,772,1027,26.7,5.97,4.49,3.13
21-04-2021,ELVAS,6,0,29,"[0,120]",Baixo a Moderado,,,,6,Alentejo,PORTALEGRE,1207,63128.86,20528,1057,1145,902,852,810,1662,2564,3709,4766,32.52,7.55,5.88,4.06
21-04-2021,ENTRONCAMENTO,5,0,23,"[0,120]",Baixo a Moderado,,,,5,Lisboa e Vale do Tejo,SANTARÉM,1410,1372.81,21558,1066,930,868,695,592,1287,2155,3085,4151,1570.14,302.33,224.69,156.96
21-04-2021,ESPINHO,21,1,71,"[0,120]",Baixo a Moderado,,,,21,Norte,AVEIRO,0107,2105.68,29516,2205,1993,1430,1177,960,2137,3567,5560,7765,1401.52,368.71,264.01,169.37
21-04-2021,ESPOSENDE,30,2,88,"[0,120]",Baixo a Moderado,,,,30,Norte,BRAGA,0306,9540.98,34177,1831,1522,1095,894,723,1617,2712,4234,6065,358.21,63.57,44.38,28.42
21-04-2021,ESTARREJA,11,1,42,"[0,120]",Baixo a Moderado,,,,11,Centro,AVEIRO,0108,10817.33,26006,1503,1399,1106,953,728,1681,2787,4186,5689,240.42,52.59,38.7,25.76
21-04-2021,ESTREMOZ,2,0,16,"[0,120]",Baixo a Moderado,,,,2,Alentejo,ÉVORA,0704,51379.95,12728,789,613,697,786,877,1663,2360,2973,3762,24.77,7.32,5.79,4.59
21-04-2021,ÉVORA,7,0,13,"[0,120]",Baixo a Moderado,,,,7,Alentejo,ÉVORA,0705,130707.58,52428,3569,2852,2176,1966,1803,3769,5945,8797,12366,40.11,9.46,6.73,4.55
21-04-2021,FAFE,68,5,141,"[120,240]",Moderado,,,,68,Norte,BRAGA,0307,21908.11,48060,3044,2455,1679,1403,1208,2611,4290,6745,9789,219.37,44.68,30.79,19.58
21-04-2021,FARO,61,4,100,"[0,120]",Baixo a Moderado,,,,61,Algarve,FARO,0805,20256.79,61015,3847,3364,2604,2055,1601,3656,6260,9624,13471,301.2,66.5,47.51,30.9
21-04-2021,FELGUEIRAS,19,1,34,"[0,120]",Baixo a Moderado,,,,19,Norte,PORTO,1303,11573.75,56422,2951,2302,1601,1316,973,2289,3890,6192,9143,487.49,79.0,53.5,33.61
21-04-2021,FERREIRA DO ALENTEJO,3,0,38,"[0,120]",Baixo a Moderado,,,,3,Alentejo,BEJA,0208,64820.68,7845,515,414,372,343,345,688,1060,1474,1989,12.1,3.07,2.27,1.64
21-04-2021,FERREIRA DO ZÊZERE,1,0,13,"[0,120]",Baixo a Moderado,,,,1,Lisboa e Vale do Tejo,SANTARÉM,1411,19038.03,7959,470,370,416,465,456,921,1337,1707,2177,41.81,11.44,8.97,7.02
21-04-2021,FIGUEIRA DA FOZ,90,6,153,"[120,240]",Moderado,,,,90,Centro,COIMBRA,0605,37905.26,58747,4032,3597,2887,2495,2043,4538,7425,11022,15054,154.98,39.72,29.08,19.59
21-04-2021,FIGUEIRA DE CASTELO RODRIGO,1,0,18,"[0,120]",Baixo a Moderado,,,,1,Centro,GUARDA,0904,50857.46,5584,347,352,290,352,391,743,1033,1385,1732,10.98,3.41,2.72,2.03
21-04-2021,FIGUEIRÓ DOS VINHOS,5,0,90,"[0,120]",Baixo a Moderado,,,,5,Centro,LEIRIA,1008,17344.0,5568,402,386,322,309,351,660,982,1368,1770,32.1,10.21,7.89,5.66
21-04-2021,FORNOS DE ALGODRES,0,0,0,"[0,120]",Baixo a Moderado,,,,0,Centro,GUARDA,0905,13145.05,4528,261,218,247,256,232,488,735,953,1214,34.45,9.24,7.25,5.59
21-04-2021,FREIXO DE ESPADA À CINTA,0,0,0,"[0,120]",Baixo a Moderado,,,,0,Norte,BRAGANÇA,0404,24414.29,3298,211,177,231,196,189,385,616,793,1004,13.51,4.11,3.25,2.52
21-04-2021,FRONTEIRA,0,0,0,"[0,120]",Baixo a Moderado,,,,0,Alentejo,PORTALEGRE,1208,24859.58,2974,213,182,149,156,168,324,473,655,868,11.96,3.49,2.63,1.9
21-04-2021,FUNCHAL,140,10,135,"[120,240]",Moderado,,,,140,Madeira,MADEIRA,3103,7616.2,104024,6382,5086,3643,2821,1990,4811,8454,13540,19922,1365.86,261.58,177.78,111.0
21-04-2021,FUNDÃO,5,0,19,"[0,120]",Baixo a Moderado,,,,5,Centro,CASTELO BRANCO,0504,70019.79,26495,1781,1464,1432,1357,1643,3000,4432,5896,7677,37.84,10.96,8.42,6.33
21-04-2021,GAVIÃO,0,0,0,"[0,120]",Baixo a Moderado,,,,0,Alentejo,PORTALEGRE,1209,29459.45,3263,189,186,222,263,293,556,778,964,1153,11.08,3.91,3.27,2.64
21-04-2021,GÓIS,0,0,0,"[0,120]",Baixo a Moderado,,,,0,Centro,COIMBRA,0606,26330.19,3805,235,199,240,233,244,477,717,916,1151,14.45,4.37,3.48,2.72
21-04-2021,GOLEGÃ,4,0,75,"[0,120]",Baixo a Moderado,,,,4,Lisboa e Vale do Tejo,SANTARÉM,1412,8431.67,5339,356,299,281,243,255,498,779,1078,1434,63.32,17.01,12.78,9.24
21-04-2021,GONDOMAR,80,6,48,"[0,120]",Baixo a Moderado,,,,80,Norte,PORTO,1304,13191.76,165985,10555,8755,6222,4450,3364,7814,14036,22791,33346,1258.22,252.77,172.76,106.4
21-04-2021,GOUVEIA,3,0,24,"[0,120]",Baixo a Moderado,,,,3,Centro,GUARDA,0906,30061.17,12387,871,931,780,783,810,1593,2373,3304,4175,41.21,13.89,10.99,7.89
21-04-2021,GRÂNDOLA,1,0,7,"[0,120]",Baixo a Moderado,,,,1,Alentejo,SETÚBAL,1505,82593.66,14639,834,834,708,688,672,1360,2068,2902,3736,17.72,4.52,3.51,2.5
21-04-2021,GUARDA,4,0,10,"[0,120]",Baixo a Moderado,,,,4,Centro,GUARDA,0907,71209.58,38969,2477,2041,1686,1415,1474,2889,4575,6616,9093,54.72,12.77,9.29,6.42
21-04-2021,GUIMARÃES,104,7,68,"[0,120]",Baixo a Moderado,,,,104,Norte,BRAGA,0308,24099.96,152309,9394,7074,4809,3877,2948,6825,11634,18708,28102,631.99,116.61,77.63,48.27
21-04-2021,HORTA,6,0,41,"[0,120]",Baixo a Moderado,,,,6,Açores,AÇORES,4701,17305.53,14521,818,658,468,352,302,654,1122,1780,2598,83.91,15.01,10.29,6.48
21-04-2021,IDANHA-A-NOVA,0,0,0,"[0,120]",Baixo a Moderado,,,,0,Centro,CASTELO BRANCO,0505,141633.51,8043,518,490,519,672,974,1646,2165,2655,3173,5.68,2.24,1.87,1.53
21-04-2021,ÍLHAVO,7,0,18,"[0,120]",Baixo a Moderado,,,,7,Centro,AVEIRO,0110,7347.55,38699,2227,1943,1444,1193,850,2043,3487,5430,7657,526.66,104.21,73.9,47.46
21-04-2021,LAGOA (FARO),17,1,75,"[0,120]",Baixo a Moderado,,,,17,Algarve,FARO,0806,8825.45,22762,1314,1168,919,749,670,1419,2338,3506,4820,257.93,54.62,39.73,26.49
21-04-2021,LAGOA,47,3,319,"[240,480]",Elevado,,,,47,Açores,AÇORES,4201,4559.32,14721,536,458,349,238,235,473,822,1280,1816,322.9,39.83,28.08,18.03
21-04-2021,LAGOS,20,1,66,"[0,120]",Baixo a Moderado,,,,20,Algarve,FARO,0807,21299.27,30374,1744,1434,1247,1053,1029,2082,3329,4763,6507,142.61,30.55,22.36,15.63
21-04-2021,LAJES DAS FLORES,0,0,0,"[0,120]",Baixo a Moderado,,,,0,Açores,AÇORES,4801,7004.79,1463,88,53,62,46,54,100,162,215,303,20.89,4.33,3.07,2.31
21-04-2021,LAJES DO PICO,1,0,22,"[0,120]",Baixo a Moderado,,,,1,Açores,AÇORES,4601,15531.09,4490,304,231,223,159,162,321,544,775,1079,28.91,6.95,4.99,3.5
21-04-2021,LAMEGO,23,2,92,"[0,120]",Baixo a Moderado,,,,23,Norte,VISEU,1805,16542.11,24895,1639,1284,1124,898,783,1681,2805,4089,5728,150.5,34.63,24.72,16.96
21-04-2021,LEIRIA,85,6,68,"[0,120]",Baixo a Moderado,,,,85,Centro,LEIRIA,1009,56508.83,125267,7389,6366,5090,3902,3159,7061,12151,18517,25906,221.68,45.84,32.77,21.5
21-04-2021,LISBOA,489,35,96,"[0,120]",Baixo a Moderado,,,,489,Lisboa e Vale do Tejo,LISBOA,1106,10005.43,509515,33197,33340,27706,23037,26770,49807,77513,110853,144050,5092.6,1439.78,1107.98,774.74
21-04-2021,LOULÉ,30,2,44,"[0,120]",Baixo a Moderado,,,,30,Algarve,FARO,0808,76366.91,68697,3890,3350,2780,2358,2251,4609,7389,10739,14629,89.96,19.16,14.06,9.68
21-04-2021,LOURES,79,6,37,"[0,120]",Baixo a Moderado,,,,79,Lisboa e Vale do Tejo,LISBOA,1107,16723.99,213687,12746,12794,9644,6669,5033,11702,21346,34140,46886,1277.73,280.35,204.14,127.64
21-04-2021,LOURINHÃ,15,1,58,"[0,120]",Baixo a Moderado,,,,15,Lisboa e Vale do Tejo,LISBOA,1108,14717.2,25855,1584,1243,992,842,645,1487,2479,3722,5306,175.68,36.05,25.29,16.84
21-04-2021,LOUSÃ,6,0,35,"[0,120]",Baixo a Moderado,,,,6,Centro,COIMBRA,0607,13840.01,17158,946,866,658,528,450,978,1636,2502,3448,123.97,24.91,18.08,11.82
21-04-2021,LOUSADA,26,2,56,"[0,120]",Baixo a Moderado,,,,26,Norte,PORTO,1305,9608.01,46755,2289,1698,1176,853,621,1474,2650,4348,6637,486.63,69.08,45.25,27.58
21-04-2021,MAÇÃO,4,0,64,"[0,120]",Baixo a Moderado,,,,4,Lisboa e Vale do Tejo,SANTARÉM,1413,39997.98,6267,386,362,390,440,657,1097,1487,1849,2235,15.67,5.59,4.62,3.72
21-04-2021,MACEDO DE CAVALEIROS,5,0,34,"[0,120]",Baixo a Moderado,,,,5,Norte,BRAGANÇA,0405,69914.08,14516,1082,889,878,823,938,1761,2639,3528,4610,20.76,6.59,5.05,3.77
21-04-2021,MACHICO,109,8,546,"[480,960]",Muito Elevado,,,,109,Madeira,MADEIRA,3104,6825.1,19981,1197,860,662,455,331,786,1448,2308,3505,292.76,51.36,33.82,21.22
21-04-2021,MADALENA,0,0,0,"[0,120]",Baixo a Moderado,,,,0,Açores,AÇORES,4602,14712.33,5895,334,256,173,190,179,369,542,798,1132,40.07,7.69,5.42,3.68
21-04-2021,MAFRA,47,3,55,"[0,120]",Baixo a Moderado,,,,47,Lisboa e Vale do Tejo,LISBOA,1109,29165.5,84816,3613,3334,2839,2089,1899,3988,6827,10161,13774,290.81,47.23,34.84,23.41
21-04-2021,MAIA,58,4,42,"[0,120]",Baixo a Moderado,,,,58,Norte,PORTO,1306,8293.94,138971,7801,6617,4512,3339,2631,5970,10482,17099,24900,1675.56,300.22,206.16,126.38
21-04-2021,MANGUALDE,0,0,0,"[0,120]",Baixo a Moderado,,,,0,Centro,VISEU,1806,21925.56,18510,1198,1128,885,852,743,1595,2480,3608,4806,84.42,21.92,16.46,11.31
21-04-2021,MANTEIGAS,0,0,0,"[0,120]",Baixo a Moderado,,,,0,Centro,GUARDA,0908,12197.55,3007,258,197,159,167,146,313,472,669,927,24.65,7.6,5.48,3.87
21-04-2021,MARCO DE CANAVESES,62,4,120,"[120,240]",Moderado,,,,62,Norte,PORTO,1307,20188.98,51496,2678,2060,1488,1265,1023,2288,3776,5836,8514,255.07,42.17,28.91,18.7
21-04-2021,MARINHA GRANDE,54,4,140,"[120,240]",Moderado,,,,54,Centro,LEIRIA,1010,18725.19,38508,2365,2302,1638,1359,1058,2417,4055,6357,8722,205.65,46.58,33.95,21.66
21-04-2021,MARVÃO,0,0,0,"[0,120]",Baixo a Moderado,,,,0,Alentejo,PORTALEGRE,1210,15489.9,3005,198,185,142,197,237,434,576,761,959,19.4,6.19,4.91,3.72
21-04-2021,MATOSINHOS,81,6,46,"[0,120]",Baixo a Moderado,,,,81,Norte,PORTO,1308,6241.97,175357,11850,9977,7023,5024,3884,8908,15931,25908,37758,2809.31,604.9,415.06,255.22
21-04-2021,MEALHADA,4,0,20,"[0,120]",Baixo a Moderado,,,,4,Centro,AVEIRO,0111,11065.66,19914,1163,1039,810,828,831,1659,2469,3508,4671,179.96,42.21,31.7,22.31
21-04-2021,MÊDA,7,1,153,"[120,240]",Moderado,,,,7,Centro,GUARDA,0909,28604.92,4587,343,306,290,288,443,731,1021,1327,1670,16.04,5.84,4.64,3.57
21-04-2021,MELGAÇO,10,1,124,"[120,240]",Moderado,,,,10,Norte,VIANA DO CASTELO,1603,23824.58,8093,507,567,578,614,675,1289,1867,2434,2941,33.97,12.34,10.22,7.84
21-04-2021,MÉRTOLA,3,0,49,"[0,120]",Baixo a Moderado,,,,3,Alentejo,BEJA,0209,129287.34,6142,400,390,378,423,600,1023,1401,1791,2191,4.75,1.69,1.39,1.08
21-04-2021,MESÃO FRIO,3,0,76,"[0,120]",Baixo a Moderado,,,,3,Norte,VILA REAL,1704,2664.87,3964,265,205,168,157,120,277,445,650,915,148.74,34.33,24.39,16.7
21-04-2021,MIRA,7,0,59,"[0,120]",Baixo a Moderado,,,,7,Centro,COIMBRA,0608,12403.38,11832,727,729,659,550,466,1016,1675,2404,3131,95.4,25.24,19.38,13.5
21-04-2021,MIRANDA DO CORVO,8,1,63,"[0,120]",Baixo a Moderado,,,,8,Centro,COIMBRA,0609,12637.79,12708,706,659,568,498,404,902,1470,2129,2835,100.55,22.43,16.85,11.63
21-04-2021,MIRANDA DO DOURO,16,1,234,"[120,240]",Moderado,,,,16,Norte,BRAGANÇA,0406,48718.31,6830,482,429,442,463,470,933,1375,1804,2286,14.02,4.69,3.7,2.82
21-04-2021,MIRANDELA,18,1,83,"[0,120]",Baixo a Moderado,,,,18,Norte,BRAGANÇA,0407,65895.67,21754,1640,1315,1204,1078,947,2025,3229,4544,6184,33.01,9.38,6.9,4.9
21-04-2021,MOGADOURO,0,0,0,"[0,120]",Baixo a Moderado,,,,0,Norte,BRAGANÇA,0408,76064.93,8392,589,529,576,630,655,1285,1861,2390,2979,11.03,3.92,3.14,2.45
21-04-2021,MOIMENTA DA BEIRA,4,0,41,"[0,120]",Baixo a Moderado,,,,4,Norte,VISEU,1807,21996.9,9736,576,514,471,416,461,877,1348,1862,2438,44.26,11.08,8.46,6.13
21-04-2021,MOITA,25,2,39,"[0,120]",Baixo a Moderado,,,,25,Lisboa e Vale do Tejo,SETÚBAL,1506,5525.98,64407,4226,3646,2623,1801,1425,3226,5849,9495,13721,1165.53,248.3,171.82,105.85
21-04-2021,MONÇÃO,8,1,45,"[0,120]",Baixo a Moderado,,,,8,Norte,VIANA DO CASTELO,1604,21130.85,17869,1161,1105,1031,1006,972,1978,3009,4114,5275,84.56,24.96,19.47,14.24
21-04-2021,MONCHIQUE,1,0,20,"[0,120]",Baixo a Moderado,,,,1,Algarve,FARO,0809,39530.43,5077,353,384,321,355,392,747,1068,1452,1805,12.84,4.57,3.67,2.7
21-04-2021,MONDIM DE BASTO,0,0,0,"[0,120]",Baixo a Moderado,,,,0,Norte,VILA REAL,1705,17207.52,6946,395,300,314,284,283,567,881,1181,1576,40.36,9.16,6.86,5.12
21-04-2021,MONFORTE,0,0,0,"[0,120]",Baixo a Moderado,,,,0,Alentejo,PORTALEGRE,1211,42024.82,2975,139,115,117,192,168,360,477,592,731,7.08,1.74,1.41,1.14
21-04-2021,MONTALEGRE,4,0,44,"[0,120]",Baixo a Moderado,,,,4,Norte,VILA REAL,1706,80545.71,8997,699,628,595,603,730,1333,1928,2556,3255,11.17,4.04,3.17,2.39
21-04-2021,MONTEMOR-O-NOVO,0,0,0,"[0,120]",Baixo a Moderado,,,,0,Alentejo,ÉVORA,0706,123296.65,15647,991,953,868,878,971,1849,2717,3670,4661,12.69,3.78,2.98,2.2
21-04-2021,MONTEMOR-O-VELHO,11,1,44,"[0,120]",Baixo a Moderado,,,,11,Centro,COIMBRA,0610,22896.23,25224,1496,1397,1217,1057,988,2045,3262,4659,6155,110.17,26.88,20.35,14.25
21-04-2021,MONTIJO,45,3,78,"[0,120]",Baixo a Moderado,,,,45,Lisboa e Vale do Tejo,SETÚBAL,1507,34861.64,57614,2771,2441,1990,1554,1109,2663,4653,7094,9865,165.26,28.3,20.35,13.35
21-04-2021,MORA,0,0,0,"[0,120]",Baixo a Moderado,,,,0,Alentejo,ÉVORA,0707,44395.02,4138,336,275,252,238,257,495,747,1022,1358,9.32,3.06,2.3,1.68
21-04-2021,MORTÁGUA,0,0,0,"[0,120]",Baixo a Moderado,,,,0,Centro,VISEU,1808,25117.82,8803,638,584,535,499,460,959,1494,2078,2716,35.05,10.81,8.27,5.95
21-04-2021,MOURA,21,1,153,"[120,240]",Moderado,,,,21,Alentejo,BEJA,0210,95845.55,13718,817,656,665,542,461,1003,1668,2324,3141,14.31,3.28,2.42,1.74
21-04-2021,MOURÃO,0,0,0,"[0,120]",Baixo a Moderado,,,,0,Alentejo,ÉVORA,0708,27862.98,2450,139,108,80,104,109,213,293,401,540,8.79,1.94,1.44,1.05
21-04-2021,MURÇA,0,0,0,"[0,120]",Baixo a Moderado,,,,0,Norte,VILA REAL,1707,18937.11,5463,384,341,307,306,319,625,932,1273,1657,28.85,8.75,6.72,4.92
21-04-2021,MURTOSA,0,0,0,"[0,120]",Baixo a Moderado,,,,0,Centro,AVEIRO,0112,7308.78,10279,509,473,403,353,409,762,1165,1638,2147,140.63,29.37,22.41,15.94
21-04-2021,NAZARÉ,11,1,78,"[0,120]",Baixo a Moderado,,,,11,Lisboa e Vale do Tejo,LEIRIA,1011,8243.43,14165,967,903,670,420,396,816,1486,2389,3356,171.84,40.71,28.98,18.03
21-04-2021,NELAS,2,0,15,"[0,120]",Baixo a Moderado,,,,2,Centro,VISEU,1809,12571.48,12974,924,787,668,604,583,1187,1855,2642,3566,103.21,28.37,21.02,14.76
21-04-2021,NISA,0,0,0,"[0,120]",Baixo a Moderado,,,,0,Alentejo,PORTALEGRE,1212,57567.84,6061,405,389,355,483,478,961,1316,1705,2110,10.53,3.67,2.96,2.29
21-04-2021,NORDESTE,28,2,576,"[480,960]",Muito Elevado,,,,28,Açores,AÇORES,4202,10146.8,4862,246,180,124,161,162,323,447,627,873,47.92,8.6,6.18,4.41
21-04-2021,ÓBIDOS,0,0,0,"[0,120]",Baixo a Moderado,,,,0,Lisboa e Vale do Tejo,LEIRIA,1012,14155.44,11850,743,650,574,452,436,888,1462,2112,2855,83.72,20.17,14.92,10.33
21-04-2021,ODEMIRA,245,17,991,"[960,Max]",Extremamente Elevado,,,,245,Alentejo,BEJA,0211,172060.15,24717,1475,1317,1225,1397,1349,2746,3971,5288,6763,14.37,3.93,3.07,2.31
21-04-2021,ODIVELAS,79,6,49,"[0,120]",Baixo a Moderado,,,,79,Lisboa e Vale do Tejo,LISBOA,1116,2654.36,161774,9562,9038,6952,4641,3812,8453,15405,24443,34005,6095.48,1281.27,920.99,580.44
21-04-2021,OEIRAS,103,7,58,"[0,120]",Baixo a Moderado,,,,103,Lisboa e Vale do Tejo,LISBOA,1110,4588.31,177408,11580,11575,8566,6211,5855,12066,20632,32207,43787,3866.78,954.38,701.98,449.69
21-04-2021,OLEIROS,0,0,0,"[0,120]",Baixo a Moderado,,,,0,Centro,CASTELO BRANCO,0506,47109.31,5003,384,341,366,397,487,884,1250,1591,1975,10.62,4.19,3.38,2.65
21-04-2021,OLHÃO,49,3,110,"[0,120]",Baixo a Moderado,,,,49,Algarve,FARO,0810,13086.38,44405,2455,2309,1689,1342,1268,2610,4299,6608,9063,339.33,69.26,50.5,32.85
21-04-2021,OLIVEIRA DE AZEMÉIS,35,2,53,"[0,120]",Baixo a Moderado,,,,35,Norte,AVEIRO,0113,16110.41,66011,4155,3614,2794,2183,1738,3921,6715,10329,14484,409.75,89.91,64.12,41.68
21-04-2021,OLIVEIRA DE FRADES,0,0,0,"[0,120]",Baixo a Moderado,,,,0,Centro,VISEU,1810,14534.62,9936,553,475,438,359,415,774,1212,1687,2240,68.36,15.41,11.61,8.34
21-04-2021,OLIVEIRA DO BAIRRO,4,0,16,"[0,120]",Baixo a Moderado,,,,4,Centro,AVEIRO,0114,8731.99,24277,1327,1182,999,786,810,1596,2595,3777,5104,278.02,58.45,43.25,29.72
21-04-2021,OLIVEIRA DO HOSPITAL,17,1,88,"[0,120]",Baixo a Moderado,,,,17,Centro,COIMBRA,0611,23451.66,19253,1161,1097,962,924,960,1884,2846,3943,5104,82.1,21.76,16.81,12.14
21-04-2021,OURÉM,7,1,16,"[0,120]",Baixo a Moderado,,,,7,Lisboa e Vale do Tejo,SANTARÉM,1421,41668.03,44044,2463,2069,1899,1817,1603,3420,5319,7388,9851,105.7,23.64,17.73,12.77
21-04-2021,OURIQUE,0,0,0,"[0,120]",Baixo a Moderado,,,,0,Alentejo,BEJA,0212,66331.36,4607,313,287,284,268,227,495,779,1066,1379,6.95,2.08,1.61,1.17
21-04-2021,OVAR,30,2,55,"[0,120]",Baixo a Moderado,,,,30,Centro,AVEIRO,0115,14770.25,54260,3294,2709,1994,1636,1234,2870,4864,7573,10867,367.37,73.57,51.27,32.93
21-04-2021,PAÇOS DE FERREIRA,71,5,125,"[120,240]",Moderado,,,,71,Norte,PORTO,1309,7099.29,56728,2903,2193,1518,1135,664,1799,3317,5510,8413,799.1,118.51,77.62,46.72
21-04-2021,PALMELA,15,1,23,"[0,120]",Baixo a Moderado,,,,15,Lisboa e Vale do Tejo,SETÚBAL,1508,46512.01,64269,3402,3244,2635,1846,1391,3237,5872,9116,12518,138.18,26.91,19.6,12.62
21-04-2021,PAMPILHOSA DA SERRA,1,0,25,"[0,120]",Baixo a Moderado,,,,1,Centro,COIMBRA,0612,39646.24,4037,238,254,295,339,423,762,1057,1311,1549,10.18,3.91,3.31,2.67
21-04-2021,PAREDES,180,13,209,"[120,240]",Moderado,,,,180,Norte,PORTO,1310,15675.69,86067,4272,3532,2412,1717,1258,2975,5387,8919,13191,549.04,84.15,56.9,34.36
21-04-2021,PAREDES DE COURA,0,0,0,"[0,120]",Baixo a Moderado,,,,0,Norte,VIANA DO CASTELO,1605,13818.59,8535,466,528,407,465,515,980,1387,1915,2381,61.76,17.23,13.86,10.04
21-04-2021,PEDRÓGÃO GRANDE,0,0,0,"[0,120]",Baixo a Moderado,,,,0,Centro,LEIRIA,1013,12874.75,3410,175,173,196,221,252,473,669,842,1017,26.49,7.9,6.54,5.2
21-04-2021,PENACOVA,4,0,29,"[0,120]",Baixo a Moderado,,,,4,Centro,COIMBRA,0613,21673.23,13694,968,923,745,621,703,1324,2069,2992,3960,63.18,18.27,13.81,9.55
21-04-2021,PENAFIEL,91,6,130,"[120,240]",Moderado,,,,91,Norte,PORTO,1311,21224.27,69772,3648,2823,2032,1663,1230,2893,4925,7748,11396,328.74,53.69,36.51,23.2
21-04-2021,PENALVA DO CASTELO,2,0,28,"[0,120]",Baixo a Moderado,,,,2,Centro,VISEU,1811,13433.92,7115,449,457,413,391,426,817,1230,1687,2136,52.96,15.9,12.56,9.16
21-04-2021,PENAMACOR,0,0,0,"[0,120]",Baixo a Moderado,,,,0,Centro,CASTELO BRANCO,0507,56370.69,4755,262,248,273,451,633,1084,1357,1605,1867,8.44,3.31,2.85,2.41
21-04-2021,PENEDONO,0,0,0,"[0,120]",Baixo a Moderado,,,,0,Norte,VISEU,1812,13370.75,2591,172,113,129,156,138,294,423,536,708,19.38,5.3,4.01,3.16
21-04-2021,PENELA,15,1,278,"[240,480]",Elevado,,,,15,Centro,COIMBRA,0614,13480.0,5397,314,324,274,359,344,703,977,1301,1615,40.04,11.98,9.65,7.25
21-04-2021,PENICHE,30,2,113,"[0,120]",Baixo a Moderado,,,,30,Lisboa e Vale do Tejo,LEIRIA,1014,7754.98,26501,1746,1504,1203,926,707,1633,2836,4340,6086,341.73,78.48,55.96,36.57
21-04-2021,PESO DA RÉGUA,20,1,127,"[120,240]",Moderado,,,,20,Norte,VILA REAL,1708,9486.01,15773,1076,843,650,659,455,1114,1764,2607,3683,166.28,38.83,27.48,18.6
21-04-2021,PINHEL,3,0,35,"[0,120]",Baixo a Moderado,,,,3,Centro,GUARDA,0910,48452.12,8511,577,566,551,538,689,1227,1778,2344,2921,17.57,6.03,4.84,3.67
21-04-2021,POMBAL,11,1,21,"[0,120]",Baixo a Moderado,,,,11,Centro,LEIRIA,1015,62600.28,51461,3187,2791,2494,2328,2027,4355,6849,9640,12827,82.21,20.49,15.4,10.94
21-04-2021,PONTA DELGADA,62,4,91,"[0,120]",Baixo a Moderado,,,,62,Açores,AÇORES,4203,23298.65,67935,3108,2435,1726,1133,902,2035,3761,6196,9304,291.58,39.93,26.59,16.14
21-04-2021,PONTA DO SOL,6,0,70,"[0,120]",Baixo a Moderado,,,,6,Madeira,MADEIRA,3105,4622.03,8593,319,283,347,208,221,429,776,1059,1378,185.92,29.81,22.91,16.79
21-04-2021,PONTE DA BARCA,8,1,72,"[0,120]",Baixo a Moderado,,,,8,Norte,VIANA DO CASTELO,1606,18211.37,11180,635,576,517,554,490,1044,1561,2137,2772,61.39,15.22,11.73,8.57
21-04-2021,PONTE DE LIMA,11,1,27,"[0,120]",Baixo a Moderado,,,,11,Norte,VIANA DO CASTELO,1607,32025.46,41315,2321,2022,1720,1596,1462,3058,4778,6800,9121,129.01,28.48,21.23,14.92
21-04-2021,PONTE DE SOR,3,0,20,"[0,120]",Baixo a Moderado,,,,3,Alentejo,PORTALEGRE,1213,83971.16,14994,939,800,716,739,831,1570,2286,3086,4025,17.86,4.79,3.68,2.72
21-04-2021,PORTALEGRE,2,0,9,"[0,120]",Baixo a Moderado,,,,2,Alentejo,PORTALEGRE,1214,44713.64,22172,1577,1351,1137,993,984,1977,3114,4465,6042,49.59,13.51,9.99,6.96
21-04-2021,PORTEL,0,0,0,"[0,120]",Baixo a Moderado,,,,0,Alentejo,ÉVORA,0709,60100.57,5828,336,358,283,331,305,636,919,1277,1613,9.7,2.68,2.12,1.53
21-04-2021,PORTIMÃO,170,12,306,"[240,480]",Elevado,,,,170,Algarve,FARO,0811,18206.29,55483,3182,2927,2116,1582,1400,2982,5098,8025,11207,304.75,61.56,44.08,28.0
21-04-2021,PORTO,167,12,77,"[0,120]",Baixo a Moderado,,,,167,Norte,PORTO,1312,4142.02,216606,15790,15193,11280,9409,10044,19453,30733,45926,61716,5229.5,1490.0,1108.79,741.98
21-04-2021,PORTO DE MÓS,5,0,21,"[0,120]",Baixo a Moderado,,,,5,Centro,LEIRIA,1016,26183.41,23275,1355,1210,1034,888,872,1760,2794,4004,5359,88.89,20.47,15.29,10.67
21-04-2021,PORTO MONIZ,7,1,299,"[240,480]",Elevado,,,,7,Madeira,MADEIRA,3106,8293.38,2342,143,130,95,98,120,218,313,443,586,28.24,7.07,5.34,3.77
21-04-2021,PORTO SANTO,0,0,0,"[0,120]",Baixo a Moderado,,,,0,Madeira,MADEIRA,3201,4300.7,5202,240,157,134,110,68,178,312,469,709,120.95,16.48,10.9,7.25
21-04-2021,PÓVOA DE LANHOSO,16,1,74,"[0,120]",Baixo a Moderado,,,,16,Norte,BRAGA,0309,13465.29,21499,1175,909,732,673,624,1297,2029,2938,4113,159.67,30.55,21.82,15.07
21-04-2021,PÓVOA DE VARZIM,32,2,51,"[0,120]",Baixo a Moderado,,,,32,Norte,PORTO,1313,8220.59,62784,3712,3120,2134,1594,1305,2899,5033,8153,11865,763.7,144.33,99.17,61.22
21-04-2021,POVOAÇÃO,3,0,51,"[0,120]",Baixo a Moderado,,,,3,Açores,AÇORES,4204,10640.77,5927,293,212,191,144,134,278,469,681,974,55.7,9.15,6.4,4.41
21-04-2021,VILA DA PRAIA DA VITÓRIA,1,0,5,"[0,120]",Baixo a Moderado,,,,1,Açores,AÇORES,4302,16127.06,21317,1133,789,619,436,336,772,1391,2180,3313,132.18,20.54,13.52,8.63
21-04-2021,PROENÇA-A-NOVA,3,0,41,"[0,120]",Baixo a Moderado,,,,3,Centro,CASTELO BRANCO,0508,39539.96,7298,508,465,389,400,560,960,1349,1814,2322,18.46,5.87,4.59,3.41
21-04-2021,REDONDO,0,0,0,"[0,120]",Baixo a Moderado,,,,0,Alentejo,ÉVORA,0710,36950.87,6353,349,325,288,288,354,642,930,1255,1604,17.19,4.34,3.4,2.52
21-04-2021,REGUENGOS DE MONSARAZ,0,0,0,"[0,120]",Baixo a Moderado,,,,0,Alentejo,ÉVORA,0711,46399.72,10015,602,511,455,462,473,935,1390,1901,2503,21.58,5.39,4.1,3.0
21-04-2021,RESENDE,58,4,572,"[480,960]",Muito Elevado,,,,58,Norte,VISEU,1813,12334.93,10137,560,493,448,433,422,855,1303,1796,2356,82.18,19.1,14.56,10.56
21-04-2021,RIBEIRA BRAVA,9,1,72,"[0,120]",Baixo a Moderado,,,,9,Madeira,MADEIRA,3107,6544.88,12435,648,500,411,311,287,598,1009,1509,2157,189.99,32.96,23.06,15.42
21-04-2021,RIBEIRA DE PENA,5,0,83,"[0,120]",Baixo a Moderado,,,,5,Norte,VILA REAL,1709,21745.98,6016,371,301,290,310,368,678,968,1269,1640,27.66,7.54,5.84,4.45
21-04-2021,RIBEIRA GRANDE,104,7,317,"[240,480]",Elevado,,,,104,Açores,AÇORES,4205,18015.13,32811,1163,689,512,345,253,598,1110,1799,2962,182.13,16.44,9.99,6.16
21-04-2021,RIO MAIOR,28,2,137,"[120,240]",Moderado,,,,28,Lisboa e Vale do Tejo,SANTARÉM,1414,27276.45,20379,1251,1144,941,795,648,1443,2384,3528,4779,74.71,17.52,12.93,8.74
21-04-2021,SABROSA,2,0,34,"[0,120]",Baixo a Moderado,,,,2,Norte,VILA REAL,1710,15692.45,5918,393,314,304,302,350,652,956,1270,1663,37.71,10.6,8.09,6.09
21-04-2021,SABUGAL,0,0,0,"[0,120]",Baixo a Moderado,,,,0,Centro,GUARDA,0911,82269.82,10585,724,707,694,796,1009,1805,2499,3206,3930,12.87,4.78,3.9,3.04
21-04-2021,SALVATERRA DE MAGOS,3,0,14,"[0,120]",Baixo a Moderado,,,,3,Lisboa e Vale do Tejo,SANTARÉM,1415,24393.2,21295,1275,1181,1060,799,772,1571,2631,3812,5087,87.3,20.85,15.63,10.79
21-04-2021,SANTA COMBA DÃO,4,0,38,"[0,120]",Baixo a Moderado,,,,4,Centro,VISEU,1814,11194.77,10452,732,684,569,538,464,1002,1571,2255,2987,93.36,26.68,20.14,14.03
21-04-2021,SANTA CRUZ,28,2,62,"[0,120]",Baixo a Moderado,,,,28,Madeira,MADEIRA,3108,8150.28,45281,1817,1301,974,716,523,1239,2213,3514,5331,555.6,65.41,43.12,27.15
21-04-2021,SANTA CRUZ DA GRACIOSA,0,0,0,"[0,120]",Baixo a Moderado,,,,0,Açores,AÇORES,4401,6065.78,4208,228,180,163,124,145,269,432,612,840,69.37,13.85,10.09,7.12
21-04-2021,SANTA CRUZ DAS FLORES,1,0,46,"[0,120]",Baixo a Moderado,,,,1,Açores,AÇORES,4802,7091.44,2165,125,98,74,56,51,107,181,279,404,30.53,5.7,3.93,2.55
21-04-2021,SANTA MARIA DA FEIRA,40,3,29,"[0,120]",Baixo a Moderado,,,,40,Norte,AVEIRO,0109,21587.65,138636,8182,6743,4771,3856,3079,6935,11706,18449,26631,642.19,123.36,85.46,54.22
21-04-2021,SANTA MARTA DE PENAGUIÃO,1,0,15,"[0,120]",Baixo a Moderado,,,,1,Norte,VILA REAL,1711,6928.13,6599,483,373,337,316,317,633,970,1343,1826,95.25,26.36,19.39,14.0
21-04-2021,SANTANA,1,0,15,"[0,120]",Baixo a Moderado,,,,1,Madeira,MADEIRA,3109,9547.3,6711,418,353,343,282,277,559,902,1255,1673,70.29,17.52,13.15,9.45
21-04-2021,SANTARÉM,8,1,14,"[0,120]",Baixo a Moderado,,,,8,Lisboa e Vale do Tejo,SANTARÉM,1416,55253.58,57421,3654,3441,2760,2466,2206,4672,7432,10873,14527,103.92,26.29,19.68,13.45
21-04-2021,SANTIAGO DO CACÉM,7,0,24,"[0,120]",Baixo a Moderado,,,,7,Alentejo,SETÚBAL,1509,105969.29,28791,2144,1689,1472,1295,1215,2510,3982,5671,7815,27.17,7.37,5.35,3.76
21-04-2021,SANTO TIRSO,49,3,72,"[0,120]",Baixo a Moderado,,,,49,Norte,PORTO,1314,13655.52,68055,4911,3935,2761,2257,1810,4067,6828,10763,15674,498.35,114.78,78.82,50.0
21-04-2021,SÃO BRÁS DE ALPORTEL,0,0,0,"[0,120]",Baixo a Moderado,,,,0,Algarve,FARO,0812,15336.92,10416,596,468,467,404,401,805,1272,1740,2336,67.91,15.23,11.35,8.29
21-04-2021,SÃO JOÃO DA MADEIRA,7,1,32,"[0,120]",Baixo a Moderado,,,,7,Norte,AVEIRO,0116,794.3,21958,1347,1069,796,601,593,1194,1990,3059,4406,2765.49,554.91,385.26,250.63
21-04-2021,SÃO JOÃO DA PESQUEIRA,1,0,14,"[0,120]",Baixo a Moderado,,,,1,Norte,VISEU,1815,26610.85,7125,417,330,294,328,328,656,950,1280,1697,26.77,6.38,4.81,3.57
21-04-2021,SÃO PEDRO DO SUL,6,0,39,"[0,120]",Baixo a Moderado,,,,6,Centro,VISEU,1816,34895.09,15403,990,962,861,759,909,1668,2529,3491,4481,44.14,12.84,10.0,7.25
21-04-2021,SÃO ROQUE DO PICO,0,0,0,"[0,120]",Baixo a Moderado,,,,0,Açores,AÇORES,4603,14236.1,3266,199,141,93,96,113,209,302,443,642,22.94,4.51,3.11,2.12
21-04-2021,SÃO VICENTE,3,0,58,"[0,120]",Baixo a Moderado,,,,3,Madeira,MADEIRA,3110,7883.71,5143,272,264,266,225,280,505,771,1035,1307,65.23,16.58,13.13,9.78
21-04-2021,SARDOAL,0,0,0,"[0,120]",Baixo a Moderado,,,,0,Lisboa e Vale do Tejo,SANTARÉM,1417,9214.72,3741,227,178,148,165,248,413,561,739,966,40.6,10.48,8.02,6.09
21-04-2021,SÁTÃO,1,0,9,"[0,120]",Baixo a Moderado,,,,1,Centro,VISEU,1817,20194.11,11580,765,671,515,465,476,941,1456,2127,2892,57.34,14.32,10.53,7.21
21-04-2021,SEIA,2,0,9,"[0,120]",Baixo a Moderado,,,,2,Centro,GUARDA,0912,43568.83,22234,1807,1589,1238,1122,721,1843,3081,4670,6477,51.03,14.87,10.72,7.07
21-04-2021,SEIXAL,77,6,46,"[0,120]",Baixo a Moderado,,,,77,Lisboa e Vale do Tejo,SETÚBAL,1510,9545.17,167752,10586,9270,6661,4391,2930,7321,13982,23252,33838,1757.49,354.51,243.6,146.49
21-04-2021,SERNANCELHE,0,0,0,"[0,120]",Baixo a Moderado,,,,0,Norte,VISEU,1818,22861.22,5396,305,293,286,273,260,533,819,1112,1417,23.6,6.2,4.86,3.58
21-04-2021,SERPA,11,1,77,"[0,120]",Baixo a Moderado,,,,11,Alentejo,BEJA,0213,110563.34,14304,903,761,719,697,626,1323,2042,2803,3706,12.94,3.35,2.54,1.85
21-04-2021,SERTÃ,0,0,0,"[0,120]",Baixo a Moderado,,,,0,Centro,CASTELO BRANCO,0509,44673.17,14577,870,779,790,767,1020,1787,2577,3356,4226,32.63,9.46,7.51,5.77
21-04-2021,SESIMBRA,16,1,31,"[0,120]",Baixo a Moderado,,,,16,Lisboa e Vale do Tejo,SETÚBAL,1511,19571.75,51858,2400,2321,1853,1257,1083,2340,4193,6514,8914,264.96,45.54,33.28,21.42
21-04-2021,SETÚBAL,94,7,82,"[0,120]",Baixo a Moderado,,,,94,Lisboa e Vale do Tejo,SETÚBAL,1512,23032.5,115126,7425,6929,5075,3775,2655,6430,11505,18434,25859,499.83,112.27,80.03,49.95
21-04-2021,SEVER DO VOUGA,17,1,150,"[120,240]",Moderado,,,,17,Centro,AVEIRO,0117,12987.56,11331,766,637,568,540,567,1107,1675,2312,3078,87.24,23.7,17.8,12.9
21-04-2021,SILVES,18,1,50,"[0,120]",Baixo a Moderado,,,,18,Algarve,FARO,0813,68006.23,36226,2137,1869,1610,1423,1600,3023,4633,6502,8639,53.27,12.7,9.56,6.81
21-04-2021,SINES,4,0,29,"[0,120]",Baixo a Moderado,,,,4,Alentejo,SETÚBAL,1513,20330.17,13715,888,791,551,416,268,684,1235,2026,2914,67.46,14.33,9.97,6.07
21-04-2021,SINTRA,274,20,70,"[0,120]",Baixo a Moderado,,,,274,Lisboa e Vale do Tejo,LISBOA,1111,31922.73,391402,20490,18316,13545,9137,7284,16421,29966,48282,68772,1226.08,215.43,151.25,93.87
21-04-2021,SOBRAL DE MONTE AGRAÇO,4,0,38,"[0,120]",Baixo a Moderado,,,,4,Lisboa e Vale do Tejo,LISBOA,1112,5210.32,10651,564,507,352,272,212,484,836,1343,1907,204.43,36.6,25.78,16.05
21-04-2021,SOURE,8,1,47,"[0,120]",Baixo a Moderado,,,,8,Centro,COIMBRA,0615,26506.07,17120,1173,1142,1004,883,987,1870,2874,4016,5189,64.59,19.58,15.15,10.84
21-04-2021,SOUSEL,1,0,23,"[0,120]",Baixo a Moderado,,,,1,Alentejo,PORTALEGRE,1215,27932.18,4412,261,274,208,302,292,594,802,1076,1337,15.8,4.79,3.85,2.87
21-04-2021,TÁBUA,10,1,88,"[0,120]",Baixo a Moderado,,,,10,Centro,COIMBRA,0616,19978.58,11368,729,584,524,430,464,894,1418,2002,2731,56.9,13.67,10.02,7.1
21-04-2021,TABUAÇO,12,1,199,"[120,240]",Moderado,,,,12,Norte,VISEU,1819,13385.67,6033,372,314,217,282,363,645,862,1176,1548,45.07,11.56,8.79,6.44
21-04-2021,TAROUCA,1,0,13,"[0,120]",Baixo a Moderado,,,,1,Norte,VISEU,1820,10008.49,7804,405,335,313,277,324,601,914,1249,1654,77.98,16.53,12.48,9.13
21-04-2021,TAVIRA,22,2,90,"[0,120]",Baixo a Moderado,,,,22,Algarve,FARO,0814,60696.7,24530,1493,1415,1252,1066,1277,2343,3595,5010,6503,40.41,10.71,8.25,5.92
21-04-2021,TERRAS DE BOURO,0,0,0,"[0,120]",Baixo a Moderado,,,,0,Norte,BRAGA,0310,27746.07,6361,391,372,296,319,340,659,955,1327,1718,22.93,6.19,4.78,3.44
21-04-2021,TOMAR,9,1,24,"[0,120]",Baixo a Moderado,,,,9,Lisboa e Vale do Tejo,SANTARÉM,1418,35120.44,36748,2403,2189,1868,1853,1822,3675,5543,7732,10135,104.64,28.86,22.02,15.78
21-04-2021,TONDELA,9,1,34,"[0,120]",Baixo a Moderado,,,,9,Centro,VISEU,1821,37121.73,26357,1768,1722,1518,1475,1417,2892,4410,6132,7900,71.0,21.28,16.52,11.88
21-04-2021,TORRE DE MONCORVO,1,0,13,"[0,120]",Baixo a Moderado,,,,1,Norte,BRAGANÇA,0409,53155.67,7695,556,478,488,551,719,1270,1758,2236,2792,14.48,5.25,4.21,3.31
21-04-2021,TORRES NOVAS,3,0,9,"[0,120]",Baixo a Moderado,,,,3,Lisboa e Vale do Tejo,SANTARÉM,1419,26999.68,34933,2324,1979,1738,1406,1475,2881,4619,6598,8922,129.38,33.04,24.44,17.11
21-04-2021,TORRES VEDRAS,84,6,107,"[0,120]",Baixo a Moderado,,,,84,Lisboa e Vale do Tejo,LISBOA,1113,40714.89,78530,4513,3945,3447,2628,2104,4732,8179,12124,16637,192.88,40.86,29.78,20.09
21-04-2021,TRANCOSO,0,0,0,"[0,120]",Baixo a Moderado,,,,0,Centro,GUARDA,0913,36152.47,8875,581,557,542,586,496,1082,1624,2181,2762,24.55,7.64,6.03,4.49
21-04-2021,TROFA,21,2,55,"[0,120]",Baixo a Moderado,,,,21,Norte,PORTO,1318,7201.76,38418,2336,1894,1231,939,684,1623,2854,4748,7084,533.44,98.36,65.93,39.63
21-04-2021,VAGOS,12,1,53,"[0,120]",Baixo a Moderado,,,,12,Centro,AVEIRO,0118,16491.5,22740,1320,1205,922,784,724,1508,2430,3635,4955,137.89,30.04,22.04,14.73
21-04-2021,VALE DE CAMBRA,3,0,14,"[0,120]",Baixo a Moderado,,,,3,Norte,AVEIRO,0119,14733.47,21327,1491,1363,1005,831,798,1629,2634,3997,5488,144.76,37.25,27.13,17.88
21-04-2021,VALENÇA,8,1,60,"[0,120]",Baixo a Moderado,,,,8,Norte,VIANA DO CASTELO,1608,11712.86,13290,867,791,582,582,503,1085,1667,2458,3325,113.46,28.39,20.99,14.23
21-04-2021,VALONGO,180,13,185,"[120,240]",Moderado,,,,180,Norte,PORTO,1315,7512.45,97444,5629,4696,3207,2462,1829,4291,7498,12194,17823,1297.18,237.26,162.33,99.81
21-04-2021,VALPAÇOS,12,1,81,"[0,120]",Baixo a Moderado,,,,12,Norte,VILA REAL,1712,54873.93,14818,1217,1118,999,928,997,1925,2924,4042,5259,27.0,9.58,7.37,5.33
21-04-2021,VELAS,1,0,20,"[0,120]",Baixo a Moderado,,,,1,Açores,AÇORES,4502,11738.38,5093,278,208,166,153,113,266,432,640,918,43.39,7.82,5.45,3.68
21-04-2021,VENDAS NOVAS,0,0,0,"[0,120]",Baixo a Moderado,,,,0,Alentejo,ÉVORA,0712,22238.88,11255,677,768,655,501,532,1033,1688,2456,3133,50.61,14.09,11.04,7.59
21-04-2021,VIANA DO ALENTEJO,1,0,19,"[0,120]",Baixo a Moderado,,,,1,Alentejo,ÉVORA,0713,39367.29,5145,245,208,235,210,214,424,659,867,1112,13.07,2.82,2.2,1.67
21-04-2021,VIANA DO CASTELO,72,5,85,"[0,120]",Baixo a Moderado,,,,72,Norte,VIANA DO CASTELO,1609,31902.01,84417,5470,4433,3591,3061,2982,6043,9634,14067,19537,264.61,61.24,44.09,30.2
21-04-2021,VIDIGUEIRA,0,0,0,"[0,120]",Baixo a Moderado,,,,0,Alentejo,BEJA,0214,31661.09,5510,300,248,215,233,275,508,723,971,1271,17.4,4.01,3.07,2.28
21-04-2021,VIEIRA DO MINHO,2,0,17,"[0,120]",Baixo a Moderado,,,,2,Norte,BRAGA,0311,21644.35,11842,703,594,525,548,482,1030,1555,2149,2852,54.71,13.18,9.93,7.18
21-04-2021,VILA DE REI,0,0,0,"[0,120]",Baixo a Moderado,,,,0,Centro,CASTELO BRANCO,0510,19154.6,3323,169,128,172,247,302,549,721,849,1018,17.35,5.31,4.43,3.76
21-04-2021,VILA DO BISPO,1,0,19,"[0,120]",Baixo a Moderado,,,,1,Algarve,FARO,0815,17906.06,5154,302,302,314,232,233,465,779,1081,1383,28.78,7.72,6.04,4.35
21-04-2021,VILA DO CONDE,34,2,43,"[0,120]",Baixo a Moderado,,,,34,Norte,PORTO,1316,14902.77,79899,4726,3875,2819,2070,1743,3813,6632,10507,15233,536.13,102.21,70.5,44.5
21-04-2021,VILA DO PORTO,6,0,107,"[0,120]",Baixo a Moderado,,,,6,Açores,AÇORES,4101,9688.74,5616,274,212,135,96,123,219,354,566,840,57.96,8.67,5.84,3.65
21-04-2021,VILA FLOR,1,0,17,"[0,120]",Baixo a Moderado,,,,1,Norte,BRAGANÇA,0410,26581.14,6044,429,362,422,294,331,625,1047,1409,1838,22.74,6.91,5.3,3.94
21-04-2021,VILA FRANCA DE XIRA,158,11,111,"[0,120]",Baixo a Moderado,,,,158,Lisboa e Vale do Tejo,LISBOA,1114,31819.39,141957,8501,6852,4869,3425,2472,5897,10766,17618,26119,446.14,82.09,55.37,33.84
21-04-2021,VILA FRANCA DO CAMPO,150,11,1357,"[960,Max]",Extremamente Elevado,,,,150,Açores,AÇORES,4206,7796.82,11051,450,344,248,217,154,371,619,963,1413,141.73,18.12,12.35,7.94
21-04-2021,VILA NOVA DA BARQUINHA,0,0,0,"[0,120]",Baixo a Moderado,,,,0,Lisboa e Vale do Tejo,SANTARÉM,1420,4952.97,7461,415,406,392,364,338,702,1094,1500,1915,150.64,38.66,30.28,22.09
21-04-2021,VILA NOVA DE CERVEIRA,3,0,34,"[0,120]",Baixo a Moderado,,,,3,Norte,VIANA DO CASTELO,1610,10846.66,8910,531,444,410,384,334,718,1128,1572,2103,82.14,19.39,14.49,10.4
21-04-2021,VILA NOVA DE FAMALICÃO,192,14,146,"[120,240]",Moderado,,,,192,Norte,BRAGA,0312,20159.26,131676,7817,6164,4202,3282,2749,6031,10233,16397,24214,653.19,120.12,81.34,50.76
21-04-2021,VILA NOVA DE FOZ CÔA,4,0,62,"[0,120]",Baixo a Moderado,,,,4,Centro,GUARDA,0914,39815.18,6503,442,385,390,398,429,827,1217,1602,2044,16.33,5.13,4.02,3.06
21-04-2021,VILA NOVA DE GAIA,183,13,61,"[0,120]",Baixo a Moderado,,,,183,Norte,PORTO,1317,16846.43,300472,18349,15568,10972,8224,6281,14505,25477,41045,59394,1783.64,352.57,243.65,151.23
21-04-2021,VILA NOVA DE PAIVA,0,0,0,"[0,120]",Baixo a Moderado,,,,0,Centro,VISEU,1822,17553.28,4687,289,272,233,217,241,458,691,963,1252,26.7,7.13,5.49,3.94
21-04-2021,VILA NOVA DE POIARES,0,0,0,"[0,120]",Baixo a Moderado,,,,0,Centro,COIMBRA,0617,8445.3,6939,380,284,262,235,182,417,679,963,1343,82.17,15.9,11.4,8.04
21-04-2021,VILA POUCA DE AGUIAR,15,1,125,"[120,240]",Moderado,,,,15,Norte,VILA REAL,1713,43706.62,11961,860,817,733,601,627,1228,1961,2778,3638,27.37,8.32,6.36,4.49
21-04-2021,VILA REAL,14,1,28,"[0,120]",Baixo a Moderado,,,,14,Norte,VILA REAL,1714,37880.28,49962,3025,2498,2065,1579,1466,3045,5110,7608,10633,131.9,28.07,20.08,13.49
21-04-2021,VILA REAL DE SANTO ANTÓNIO,26,2,139,"[120,240]",Moderado,,,,26,Algarve,FARO,0816,6125.0,18749,1172,1069,811,569,586,1155,1966,3035,4207,306.11,68.69,49.55,32.1
21-04-2021,VILA VELHA DE RÓDÃO,0,0,0,"[0,120]",Baixo a Moderado,,,,0,Centro,CASTELO BRANCO,0511,32991.16,3144,209,229,180,283,306,589,769,998,1207,9.53,3.66,3.03,2.33
21-04-2021,VILA VERDE,22,2,47,"[0,120]",Baixo a Moderado,,,,22,Norte,BRAGA,0313,22866.52,46911,2365,2063,1667,1494,1437,2931,4598,6661,9026,205.15,39.47,29.13,20.11
21-04-2021,VILA VIÇOSA,7,0,91,"[0,120]",Baixo a Moderado,,,,7,Alentejo,ÉVORA,0714,19485.89,7656,487,379,342,345,324,669,1011,1390,1877,39.29,9.63,7.13,5.19
21-04-2021,VIMIOSO,0,0,0,"[0,120]",Baixo a Moderado,,,,0,Norte,BRAGANÇA,0411,48158.51,4023,274,230,261,293,335,628,889,1119,1393,8.35,2.89,2.32,1.85
21-04-2021,VINHAIS,6,0,77,"[0,120]",Baixo a Moderado,,,,6,Norte,BRAGANÇA,0412,69475.09,7746,599,577,636,641,815,1456,2092,2669,3268,11.15,4.7,3.84,3.01
21-04-2021,VISEU,8,1,8,"[0,120]",Baixo a Moderado,,,,8,Centro,VISEU,1823,50710.14,97249,5769,5038,4140,3158,2710,5868,10008,15046,20815,191.77,41.05,29.67,19.74
21-04-2021,VIZELA,5,0,21,"[0,120]",Baixo a Moderado,,,,5,Norte,BRAGA,0314,2469.83,23897,1258,928,655,509,371,880,1535,2463,3721,967.49,150.65,99.72,62.15
21-04-2021,VOUZELA,4,0,42,"[0,120]",Baixo a Moderado,,,,4,Centro,VISEU,1824,19369.46,9619,626,605,554,532,507,1039,1593,2198,2824,49.66,14.58,11.35,8.22
28-04-2021,ABRANTES,27,2,77,"[0,120]",Baixo a Moderado,,,,27,Lisboa e Vale do Tejo,SANTARÉM,1401,71469.08,35130,2473,2213,1730,1748,2021,3769,5499,7712,10185,49.15,14.25,10.79,7.69
28-04-2021,ÁGUEDA,11,1,24,"[0,120]",Baixo a Moderado,,,,11,Centro,AVEIRO,0101,33527.44,46075,3237,2713,2090,1635,1496,3131,5221,7934,11171,137.43,33.32,23.66,15.57
28-04-2021,AGUIAR DA BEIRA,2,0,43,"[0,120]",Baixo a Moderado,,,,2,Centro,GUARDA,0901,20676.57,4652,304,281,235,239,148,387,622,903,1207,22.5,5.84,4.37,3.01
28-04-2021,ALANDROAL,2,0,40,"[0,120]",Baixo a Moderado,,,,2,Alentejo,ÉVORA,0701,54267.81,4992,307,256,296,299,377,676,972,1228,1535,9.2,2.83,2.26,1.79
28-04-2021,ALBERGARIA-A-VELHA,5,0,21,"[0,120]",Baixo a Moderado,,,,5,Centro,AVEIRO,0102,15882.5,24144,1550,1298,996,687,680,1367,2363,3661,5211,152.02,32.81,23.05,14.88
28-04-2021,ALBUFEIRA,34,2,82,"[0,120]",Baixo a Moderado,,,,34,Algarve,FARO,0801,14066.42,41528,2067,1717,1425,985,858,1843,3268,4985,7052,295.24,50.14,35.44,23.23
28-04-2021,ALCÁCER DO SAL,2,0,17,"[0,120]",Baixo a Moderado,,,,2,Alentejo,SETÚBAL,1501,149987.3,11659,884,814,623,623,602,1225,1848,2662,3546,7.77,2.36,1.77,1.23
28-04-2021,ALCANENA,1,0,8,"[0,120]",Baixo a Moderado,,,,1,Lisboa e Vale do Tejo,SANTARÉM,1402,12732.86,12809,891,744,628,536,588,1124,1752,2496,3387,100.6,26.6,19.6,13.76
28-04-2021,ALCOBAÇA,21,1,39,"[0,120]",Baixo a Moderado,,,,21,Lisboa e Vale do Tejo,LEIRIA,1001,40814.09,53555,3420,2927,2466,2059,1676,3735,6201,9128,12548,131.22,30.74,22.36,15.19
28-04-2021,ALCOCHETE,20,1,101,"[0,120]",Baixo a Moderado,,,,20,Lisboa e Vale do Tejo,SETÚBAL,1502,12836.48,19787,857,834,691,476,447,923,1614,2448,3305,154.15,25.75,19.07,12.57
28-04-2021,ALCOUTIM,0,0,0,"[0,120]",Baixo a Moderado,,,,0,Algarve,FARO,0802,57536.33,2159,191,188,163,190,267,457,620,808,999,3.75,1.74,1.4,1.08
28-04-2021,ALENQUER,31,2,70,"[0,120]",Baixo a Moderado,,,,31,Lisboa e Vale do Tejo,LISBOA,1101,30421.92,44052,2298,2062,1629,1330,1155,2485,4114,6176,8474,144.8,27.85,20.3,13.52
28-04-2021,ALFÂNDEGA DA FÉ,0,0,0,"[0,120]",Baixo a Moderado,,,,0,Norte,BRAGANÇA,0401,32194.64,4550,325,277,301,274,325,599,900,1177,1502,14.13,4.67,3.66,2.8
28-04-2021,ALIJÓ,21,2,198,"[120,240]",Moderado,,,,21,Norte,VILA REAL,1701,29759.89,10625,766,687,635,542,666,1208,1843,2530,3296,35.7,11.08,8.5,6.19
28-04-2021,ALJEZUR,26,2,465,"[240,480]",Elevado,,,,26,Algarve,FARO,0803,32349.95,5594,316,336,335,320,410,730,1065,1401,1717,17.29,5.31,4.33,3.29
28-04-2021,ALJUSTREL,1,0,12,"[0,120]",Baixo a Moderado,,,,1,Alentejo,BEJA,0201,45847.41,8247,635,521,443,347,358,705,1148,1669,2304,17.99,5.03,3.64,2.5
28-04-2021,ALMADA,113,8,67,"[0,120]",Baixo a Moderado,,,,113,Lisboa e Vale do Tejo,SETÚBAL,1503,7000.89,169039,10469,9777,7876,6144,5111,11255,19131,28908,39377,2414.5,562.45,412.91,273.26
28-04-2021,ALMEIDA,1,0,17,"[0,120]",Baixo a Moderado,,,,1,Centro,GUARDA,0902,51798.46,5830,441,419,396,458,393,851,1247,1666,2107,11.26,4.07,3.22,2.41
28-04-2021,ALMEIRIM,21,1,93,"[0,120]",Baixo a Moderado,,,,21,Lisboa e Vale do Tejo,SANTARÉM,1403,22212.05,22546,1342,1353,1106,866,843,1709,2815,4168,5510,101.5,24.81,18.76,12.67
28-04-2021,ALMODÔVAR,0,0,0,"[0,120]",Baixo a Moderado,,,,0,Alentejo,BEJA,0202,77788.03,6725,414,443,396,373,328,701,1097,1540,1954,8.65,2.51,1.98,1.41
28-04-2021,ALPIARÇA,12,1,170,"[120,240]",Moderado,,,,12,Lisboa e Vale do Tejo,SANTARÉM,1404,9536.33,7059,515,486,363,333,274,607,970,1456,1971,74.02,20.67,15.27,10.17
28-04-2021,ALTER DO CHÃO,0,0,0,"[0,120]",Baixo a Moderado,,,,0,Alentejo,PORTALEGRE,1201,36206.62,3165,201,163,136,208,187,395,531,694,895,8.74,2.47,1.92,1.47
28-04-2021,ALVAIÁZERE,3,0,45,"[0,120]",Baixo a Moderado,,,,3,Centro,LEIRIA,1002,16047.76,6597,419,389,346,406,539,945,1291,1680,2099,41.11,13.08,10.47,8.04
28-04-2021,ALVITO,0,0,0,"[0,120]",Baixo a Moderado,,,,0,Alentejo,BEJA,0203,26485.32,2477,145,110,105,111,89,200,305,415,560,9.35,2.11,1.57,1.15
28-04-2021,AMADORA,103,7,56,"[0,120]",Baixo a Moderado,,,,103,Lisboa e Vale do Tejo,LISBOA,1115,2378.47,184106,11186,10936,8780,6460,5890,12350,21130,32066,43252,7742.05,1818.84,1348.44,888.56
28-04-2021,AMARANTE,13,1,24,"[0,120]",Baixo a Moderado,,,,13,Norte,PORTO,1301,30133.15,53193,3086,2413,1812,1643,1311,2954,4766,7179,10265,176.53,34.07,23.82,15.82
28-04-2021,AMARES,7,1,39,"[0,120]",Baixo a Moderado,,,,7,Norte,BRAGA,0301,8195.41,18129,1001,829,622,489,524,1013,1635,2464,3465,221.22,42.28,30.07,19.95
28-04-2021,ANADIA,5,0,18,"[0,120]",Baixo a Moderado,,,,5,Centro,AVEIRO,0103,21663.48,27258,1931,1698,1376,1208,1262,2470,3846,5544,7475,125.83,34.51,25.59,17.75
28-04-2021,ANGRA DO HEROÍSMO,6,0,18,"[0,120]",Baixo a Moderado,,,,6,Açores,AÇORES,4301,23899.66,33807,2006,1473,1122,768,635,1403,2525,3998,6004,141.45,25.12,16.73,10.56
28-04-2021,ANSIÃO,3,0,25,"[0,120]",Baixo a Moderado,,,,3,Centro,LEIRIA,1003,17609.42,12039,727,709,646,694,530,1224,1870,2579,3306,68.37,18.77,14.65,10.62
28-04-2021,ARCOS DE VALDEVEZ,16,1,76,"[0,120]",Baixo a Moderado,,,,16,Norte,VIANA DO CASTELO,1601,44759.64,20926,1329,1338,1282,1343,1515,2858,4140,5478,6807,46.75,15.21,12.24,9.25
28-04-2021,ARGANIL,26,2,236,"[120,240]",Moderado,,,,26,Centro,COIMBRA,0601,33283.93,11014,672,648,612,559,596,1155,1767,2415,3087,33.09,9.27,7.26,5.31
28-04-2021,ARMAMAR,1,0,17,"[0,120]",Baixo a Moderado,,,,1,Norte,VISEU,1801,11723.73,5769,357,305,309,285,310,595,904,1209,1566,49.21,13.36,10.31,7.71
28-04-2021,AROUCA,9,1,43,"[0,120]",Baixo a Moderado,,,,9,Norte,AVEIRO,0104,32910.52,20720,1306,1047,753,683,683,1366,2119,3166,4472,62.96,13.59,9.62,6.44
28-04-2021,ARRAIOLOS,0,0,0,"[0,120]",Baixo a Moderado,,,,0,Alentejo,ÉVORA,0702,68374.55,6928,435,384,283,367,480,847,1130,1514,1949,10.13,2.85,2.21,1.65
28-04-2021,ARRONCHES,0,0,0,"[0,120]",Baixo a Moderado,,,,0,Alentejo,PORTALEGRE,1202,31464.72,2820,155,142,162,187,179,366,528,670,825,8.96,2.62,2.13,1.68
28-04-2021,ARRUDA DOS VINHOS,4,0,26,"[0,120]",Baixo a Moderado,,,,4,Lisboa e Vale do Tejo,LISBOA,1102,7795.93,15412,738,738,562,509,438,947,1509,2247,2985,197.69,38.29,28.82,19.36
28-04-2021,AVEIRO,30,2,38,"[0,120]",Baixo a Moderado,,,,30,Centro,AVEIRO,0105,19757.57,78734,4520,4004,3050,2250,2103,4353,7403,11407,15927,398.49,80.61,57.73,37.47
28-04-2021,AVIS,0,0,0,"[0,120]",Baixo a Moderado,,,,0,Alentejo,PORTALEGRE,1203,60596.51,4247,315,225,206,251,273,524,730,955,1270,7.01,2.1,1.58,1.2
28-04-2021,AZAMBUJA,6,0,26,"[0,120]",Baixo a Moderado,,,,6,Lisboa e Vale do Tejo,LISBOA,1103,26265.65,22716,1322,1171,1070,798,618,1416,2486,3657,4979,86.48,18.96,13.92,9.46
28-04-2021,BAIÃO,18,1,96,"[0,120]",Baixo a Moderado,,,,18,Norte,PORTO,1302,17452.83,18748,1070,862,714,686,725,1411,2125,2987,4057,107.42,23.25,17.11,12.18
28-04-2021,BARCELOS,81,6,70,"[0,120]",Baixo a Moderado,,,,81,Norte,BRAGA,0302,37890.14,116187,6721,5325,3619,2991,2562,5553,9172,14497,21218,306.64,56.0,38.26,24.21
28-04-2021,BARRANCOS,0,0,0,"[0,120]",Baixo a Moderado,,,,0,Alentejo,BEJA,0204,16841.73,1634,90,65,65,94,61,155,220,285,375,9.7,2.23,1.69,1.31
28-04-2021,BARREIRO,38,3,51,"[0,120]",Baixo a Moderado,,,,38,Lisboa e Vale do Tejo,SETÚBAL,1504,3639.07,75147,5194,5565,4459,3105,1767,4872,9331,14896,20090,2065.05,552.07,409.34,256.42
28-04-2021,BATALHA,23,2,144,"[120,240]",Moderado,,,,23,Centro,LEIRIA,1004,10341.6,15963,873,762,649,529,549,1078,1727,2489,3362,154.35,32.51,24.07,16.7
28-04-2021,BEJA,76,5,226,"[120,240]",Moderado,,,,76,Alentejo,BEJA,0205,114647.55,33579,2005,1840,1386,1272,1039,2311,3697,5537,7542,29.29,6.58,4.83,3.22
28-04-2021,BELMONTE,0,0,0,"[0,120]",Baixo a Moderado,,,,0,Centro,CASTELO BRANCO,0501,11875.91,6398,444,321,325,310,355,665,990,1311,1755,53.87,14.78,11.04,8.34
28-04-2021,BENAVENTE,9,1,29,"[0,120]",Baixo a Moderado,,,,9,Lisboa e Vale do Tejo,SANTARÉM,1405,52138.39,30602,1468,1376,1141,876,643,1519,2660,4036,5504,58.69,10.56,7.74,5.1
28-04-2021,BOMBARRAL,1,0,8,"[0,120]",Baixo a Moderado,,,,1,Lisboa e Vale do Tejo,LEIRIA,1005,9128.55,12558,875,714,561,491,429,920,1481,2195,3070,137.56,33.63,24.04,16.22
28-04-2021,BORBA,1,0,15,"[0,120]",Baixo a Moderado,,,,1,Alentejo,ÉVORA,0703,14518.65,6736,430,375,279,436,392,828,1107,1482,1912,46.39,13.17,10.21,7.62
28-04-2021,BOTICAS,6,0,120,"[120,240]",Moderado,,,,6,Norte,VILA REAL,1702,32195.66,4998,347,306,311,305,380,685,996,1302,1649,15.52,5.12,4.04,3.09
28-04-2021,BRAGA,108,8,59,"[0,120]",Baixo a Moderado,,,,108,Norte,BRAGA,0303,18339.95,182679,10029,7963,5241,4320,3671,7991,13232,21195,31224,996.07,170.25,115.57,72.15
28-04-2021,BRAGANÇA,20,1,60,"[0,120]",Baixo a Moderado,,,,20,Norte,BRAGANÇA,0402,117357.27,33607,2402,1855,1652,1393,1163,2556,4208,6063,8465,28.64,7.21,5.17,3.59
28-04-2021,CABECEIRAS DE BASTO,83,6,531,"[480,960]",Muito Elevado,,,,83,Norte,BRAGA,0304,24182.16,15628,774,594,544,575,574,1149,1693,2287,3061,64.63,12.66,9.46,7.0
28-04-2021,CADAVAL,1,0,7,"[0,120]",Baixo a Moderado,,,,1,Lisboa e Vale do Tejo,LISBOA,1104,17489.3,13673,813,796,756,621,625,1246,2002,2798,3611,78.18,20.65,16.0,11.45
28-04-2021,CALDAS DA RAINHA,10,1,19,"[0,120]",Baixo a Moderado,,,,10,Lisboa e Vale do Tejo,LEIRIA,1006,25569.47,51912,3035,2684,2186,1899,1705,3604,5790,8474,11509,203.03,45.01,33.14,22.64
28-04-2021,CALHETA,0,0,0,"[0,120]",Baixo a Moderado,,,,0,Madeira,MADEIRA,3101,11150.43,10867,576,497,507,399,415,814,1321,1818,2394,97.46,21.47,16.3,11.85
28-04-2021,CALHETA (AÇORES),1,0,31,"[0,120]",Baixo a Moderado,,,,1,Açores,AÇORES,4501,12626.4,3184,215,159,141,139,122,261,402,561,776,25.22,6.15,4.44,3.18
28-04-2021,CÂMARA DE LOBOS,16,1,48,"[0,120]",Baixo a Moderado,,,,16,Madeira,MADEIRA,3102,5216.67,33675,1396,1059,834,545,381,926,1760,2819,4215,645.49,80.79,54.03,33.74
28-04-2021,CAMINHA,3,0,19,"[0,120]",Baixo a Moderado,,,,3,Norte,VIANA DO CASTELO,1602,13652.14,15877,1046,944,818,646,656,1302,2120,3064,4110,116.3,30.11,22.44,15.53
28-04-2021,CAMPO MAIOR,1,0,13,"[0,120]",Baixo a Moderado,,,,1,Alentejo,PORTALEGRE,1204,24720.16,7874,471,364,351,279,327,606,957,1321,1792,31.85,7.25,5.34,3.87
28-04-2021,CANTANHEDE,2,0,6,"[0,120]",Baixo a Moderado,,,,2,Centro,COIMBRA,0602,39088.02,35011,2346,2096,1880,1709,1451,3160,5040,7136,9482,89.57,24.26,18.26,12.89
28-04-2021,CARRAZEDA DE ANSIÃES,0,0,0,"[0,120]",Baixo a Moderado,,,,0,Norte,BRAGANÇA,0403,27924.09,5666,424,389,391,312,465,777,1168,1557,1981,20.29,7.09,5.58,4.18
28-04-2021,CARREGAL DO SAL,14,1,151,"[120,240]",Moderado,,,,14,Centro,VISEU,1802,11689.21,9271,587,562,486,462,376,838,1324,1886,2473,79.31,21.16,16.13,11.33
28-04-2021,CARTAXO,2,0,8,"[0,120]",Baixo a Moderado,,,,2,Lisboa e Vale do Tejo,SANTARÉM,1406,15817.28,23843,1415,1376,1142,861,632,1493,2635,4011,5426,150.74,34.3,25.36,16.66
28-04-2021,CASCAIS,92,7,43,"[0,120]",Baixo a Moderado,,,,92,Lisboa e Vale do Tejo,LISBOA,1105,9740.17,213608,12151,11444,8680,6469,5248,11717,20397,31841,43992,2193.1,451.66,326.91,209.41
28-04-2021,CASTANHEIRA DE PÊRA,0,0,0,"[0,120]",Baixo a Moderado,,,,0,Centro,LEIRIA,1007,6677.45,2614,233,195,157,190,187,377,534,729,962,39.15,14.41,10.92,8.0
28-04-2021,CASTELO BRANCO,5,0,10,"[0,120]",Baixo a Moderado,,,,5,Centro,CASTELO BRANCO,0502,143819.15,51987,3528,3042,2499,2229,2225,4454,6953,9995,13523,36.15,9.4,6.95,4.83
28-04-2021,CASTELO DE PAIVA,32,2,207,"[120,240]",Moderado,,,,32,Norte,AVEIRO,0106,11500.53,15454,881,697,545,420,431,851,1396,2093,2974,134.37,25.86,18.2,12.14
28-04-2021,CASTELO DE VIDE,1,0,34,"[0,120]",Baixo a Moderado,,,,1,Alentejo,PORTALEGRE,1205,26491.24,2919,204,173,179,147,170,317,496,669,873,11.02,3.3,2.53,1.87
28-04-2021,CASTRO DAIRE,9,1,65,"[0,120]",Baixo a Moderado,,,,9,Centro,VISEU,1803,37904.13,13823,942,857,765,732,773,1505,2270,3127,4069,36.47,10.74,8.25,5.99
28-04-2021,CASTRO MARIM,1,0,16,"[0,120]",Baixo a Moderado,,,,1,Algarve,FARO,0804,30084.37,6237,370,345,334,322,344,666,1000,1345,1715,20.73,5.7,4.47,3.32
28-04-2021,CASTRO VERDE,0,0,0,"[0,120]",Baixo a Moderado,,,,0,Alentejo,BEJA,0206,56944.23,6949,437,347,303,275,227,502,805,1152,1589,12.2,2.79,2.02,1.41
28-04-2021,CELORICO DA BEIRA,0,0,0,"[0,120]",Baixo a Moderado,,,,0,Centro,GUARDA,0903,24721.63,6928,430,416,363,369,535,904,1267,1683,2113,28.02,8.55,6.81,5.12
28-04-2021,CELORICO DE BASTO,24,2,126,"[120,240]",Moderado,,,,24,Norte,BRAGA,0305,18107.02,19040,1001,802,668,728,729,1457,2125,2927,3928,105.15,21.69,16.17,11.74
28-04-2021,CHAMUSCA,3,0,33,"[0,120]",Baixo a Moderado,,,,3,Lisboa e Vale do Tejo,SANTARÉM,1407,74600.54,9197,629,583,553,465,579,1044,1597,2180,2809,12.33,3.77,2.92,2.14
28-04-2021,CHAVES,33,2,84,"[0,120]",Baixo a Moderado,,,,33,Norte,VILA REAL,1703,59122.95,39343,2676,2429,1991,1886,1918,3804,5795,8224,10900,66.54,18.44,13.91,9.8
28-04-2021,CINFÃES,42,3,230,"[120,240]",Moderado,,,,42,Norte,VISEU,1804,23928.76,18244,1067,902,779,734,758,1492,2271,3173,4240,76.24,17.72,13.26,9.49
28-04-2021,COIMBRA,40,3,30,"[0,120]",Baixo a Moderado,,,,40,Centro,COIMBRA,0603,31939.94,134166,9489,8734,6353,5139,5074,10213,16566,25300,34789,420.06,108.92,79.21,51.87
28-04-2021,CONDEIXA-A-NOVA,2,0,11,"[0,120]",Baixo a Moderado,,,,2,Centro,COIMBRA,0604,13867.47,17733,871,809,717,583,490,1073,1790,2599,3470,127.88,25.02,18.74,12.91
28-04-2021,CONSTÂNCIA,2,0,50,"[0,120]",Baixo a Moderado,,,,2,Lisboa e Vale do Tejo,SANTARÉM,1408,8036.58,4030,211,183,187,148,155,303,490,673,884,50.14,11.0,8.37,6.1
28-04-2021,CORUCHE,52,4,298,"[240,480]",Elevado,,,,52,Lisboa e Vale do Tejo,SANTARÉM,1409,111572.03,17471,1294,1090,1095,1096,1019,2115,3210,4300,5594,15.66,5.01,3.85,2.88
28-04-2021,CORVO,0,0,0,"[0,120]",Baixo a Moderado,,,,0,Açores,AÇORES,4901,1711.45,464,22,21,11,13,19,32,43,64,86,27.12,5.03,3.74,2.51
28-04-2021,COVILHÃ,7,1,15,"[0,120]",Baixo a Moderado,,,,7,Centro,CASTELO BRANCO,0503,55560.06,46787,3533,2998,2365,2111,2193,4304,6669,9667,13200,84.21,23.76,17.4,12.0
28-04-2021,CRATO,0,0,0,"[0,120]",Baixo a Moderado,,,,0,Alentejo,PORTALEGRE,1206,39806.88,3129,229,258,163,182,228,410,573,831,1060,7.86,2.66,2.09,1.44
28-04-2021,CUBA,2,0,44,"[0,120]",Baixo a Moderado,,,,2,Alentejo,BEJA,0207,17208.72,4595,255,233,206,190,143,333,539,772,1027,26.7,5.97,4.49,3.13
28-04-2021,ELVAS,2,0,10,"[0,120]",Baixo a Moderado,,,,2,Alentejo,PORTALEGRE,1207,63128.86,20528,1057,1145,902,852,810,1662,2564,3709,4766,32.52,7.55,5.88,4.06
28-04-2021,ENTRONCAMENTO,6,0,28,"[0,120]",Baixo a Moderado,,,,6,Lisboa e Vale do Tejo,SANTARÉM,1410,1372.81,21558,1066,930,868,695,592,1287,2155,3085,4151,1570.14,302.33,224.69,156.96
28-04-2021,ESPINHO,24,2,81,"[0,120]",Baixo a Moderado,,,,24,Norte,AVEIRO,0107,2105.68,29516,2205,1993,1430,1177,960,2137,3567,5560,7765,1401.52,368.71,264.01,169.37
28-04-2021,ESPOSENDE,16,1,47,"[0,120]",Baixo a Moderado,,,,16,Norte,BRAGA,0306,9540.98,34177,1831,1522,1095,894,723,1617,2712,4234,6065,358.21,63.57,44.38,28.42
28-04-2021,ESTARREJA,4,0,15,"[0,120]",Baixo a Moderado,,,,4,Centro,AVEIRO,0108,10817.33,26006,1503,1399,1106,953,728,1681,2787,4186,5689,240.42,52.59,38.7,25.76
28-04-2021,ESTREMOZ,2,0,16,"[0,120]",Baixo a Moderado,,,,2,Alentejo,ÉVORA,0704,51379.95,12728,789,613,697,786,877,1663,2360,2973,3762,24.77,7.32,5.79,4.59
28-04-2021,ÉVORA,6,0,11,"[0,120]",Baixo a Moderado,,,,6,Alentejo,ÉVORA,0705,130707.58,52428,3569,2852,2176,1966,1803,3769,5945,8797,12366,40.11,9.46,6.73,4.55
28-04-2021,FAFE,99,7,206,"[120,240]",Moderado,,,,99,Norte,BRAGA,0307,21908.11,48060,3044,2455,1679,1403,1208,2611,4290,6745,9789,219.37,44.68,30.79,19.58
28-04-2021,FARO,42,3,69,"[0,120]",Baixo a Moderado,,,,42,Algarve,FARO,0805,20256.79,61015,3847,3364,2604,2055,1601,3656,6260,9624,13471,301.2,66.5,47.51,30.9
28-04-2021,FELGUEIRAS,21,1,37,"[0,120]",Baixo a Moderado,,,,21,Norte,PORTO,1303,11573.75,56422,2951,2302,1601,1316,973,2289,3890,6192,9143,487.49,79.0,53.5,33.61
28-04-2021,FERREIRA DO ALENTEJO,4,0,51,"[0,120]",Baixo a Moderado,,,,4,Alentejo,BEJA,0208,64820.68,7845,515,414,372,343,345,688,1060,1474,1989,12.1,3.07,2.27,1.64
28-04-2021,FERREIRA DO ZÊZERE,2,0,25,"[0,120]",Baixo a Moderado,,,,2,Lisboa e Vale do Tejo,SANTARÉM,1411,19038.03,7959,470,370,416,465,456,921,1337,1707,2177,41.81,11.44,8.97,7.02
28-04-2021,FIGUEIRA DA FOZ,62,4,106,"[0,120]",Baixo a Moderado,,,,62,Centro,COIMBRA,0605,37905.26,58747,4032,3597,2887,2495,2043,4538,7425,11022,15054,154.98,39.72,29.08,19.59
28-04-2021,FIGUEIRA DE CASTELO RODRIGO,1,0,18,"[0,120]",Baixo a Moderado,,,,1,Centro,GUARDA,0904,50857.46,5584,347,352,290,352,391,743,1033,1385,1732,10.98,3.41,2.72,2.03
28-04-2021,FIGUEIRÓ DOS VINHOS,13,1,233,"[120,240]",Moderado,,,,13,Centro,LEIRIA,1008,17344.0,5568,402,386,322,309,351,660,982,1368,1770,32.1,10.21,7.89,5.66
28-04-2021,FORNOS DE ALGODRES,4,0,88,"[0,120]",Baixo a Moderado,,,,4,Centro,GUARDA,0905,13145.05,4528,261,218,247,256,232,488,735,953,1214,34.45,9.24,7.25,5.59
28-04-2021,FREIXO DE ESPADA À CINTA,0,0,0,"[0,120]",Baixo a Moderado,,,,0,Norte,BRAGANÇA,0404,24414.29,3298,211,177,231,196,189,385,616,793,1004,13.51,4.11,3.25,2.52
28-04-2021,FRONTEIRA,0,0,0,"[0,120]",Baixo a Moderado,,,,0,Alentejo,PORTALEGRE,1208,24859.58,2974,213,182,149,156,168,324,473,655,868,11.96,3.49,2.63,1.9
28-04-2021,FUNCHAL,153,11,147,"[120,240]",Moderado,,,,153,Madeira,MADEIRA,3103,7616.2,104024,6382,5086,3643,2821,1990,4811,8454,13540,19922,1365.86,261.58,177.78,111.0
28-04-2021,FUNDÃO,9,1,34,"[0,120]",Baixo a Moderado,,,,9,Centro,CASTELO BRANCO,0504,70019.79,26495,1781,1464,1432,1357,1643,3000,4432,5896,7677,37.84,10.96,8.42,6.33
28-04-2021,GAVIÃO,0,0,0,"[0,120]",Baixo a Moderado,,,,0,Alentejo,PORTALEGRE,1209,29459.45,3263,189,186,222,263,293,556,778,964,1153,11.08,3.91,3.27,2.64
28-04-2021,GÓIS,0,0,0,"[0,120]",Baixo a Moderado,,,,0,Centro,COIMBRA,0606,26330.19,3805,235,199,240,233,244,477,717,916,1151,14.45,4.37,3.48,2.72
28-04-2021,GOLEGÃ,3,0,56,"[0,120]",Baixo a Moderado,,,,3,Lisboa e Vale do Tejo,SANTARÉM,1412,8431.67,5339,356,299,281,243,255,498,779,1078,1434,63.32,17.01,12.78,9.24
28-04-2021,GONDOMAR,85,6,51,"[0,120]",Baixo a Moderado,,,,85,Norte,PORTO,1304,13191.76,165985,10555,8755,6222,4450,3364,7814,14036,22791,33346,1258.22,252.77,172.76,106.4
28-04-2021,GOUVEIA,0,0,0,"[0,120]",Baixo a Moderado,,,,0,Centro,GUARDA,0906,30061.17,12387,871,931,780,783,810,1593,2373,3304,4175,41.21,13.89,10.99,7.89
28-04-2021,GRÂNDOLA,0,0,0,"[0,120]",Baixo a Moderado,,,,0,Alentejo,SETÚBAL,1505,82593.66,14639,834,834,708,688,672,1360,2068,2902,3736,17.72,4.52,3.51,2.5
28-04-2021,GUARDA,9,1,23,"[0,120]",Baixo a Moderado,,,,9,Centro,GUARDA,0907,71209.58,38969,2477,2041,1686,1415,1474,2889,4575,6616,9093,54.72,12.77,9.29,6.42
28-04-2021,GUIMARÃES,104,7,68,"[0,120]",Baixo a Moderado,,,,104,Norte,BRAGA,0308,24099.96,152309,9394,7074,4809,3877,2948,6825,11634,18708,28102,631.99,116.61,77.63,48.27
28-04-2021,HORTA,6,0,41,"[0,120]",Baixo a Moderado,,,,6,Açores,AÇORES,4701,17305.53,14521,818,658,468,352,302,654,1122,1780,2598,83.91,15.01,10.29,6.48
28-04-2021,IDANHA-A-NOVA,0,0,0,"[0,120]",Baixo a Moderado,,,,0,Centro,CASTELO BRANCO,0505,141633.51,8043,518,490,519,672,974,1646,2165,2655,3173,5.68,2.24,1.87,1.53
28-04-2021,ÍLHAVO,12,1,31,"[0,120]",Baixo a Moderado,,,,12,Centro,AVEIRO,0110,7347.55,38699,2227,1943,1444,1193,850,2043,3487,5430,7657,526.66,104.21,73.9,47.46
28-04-2021,LAGOA (FARO),17,1,75,"[0,120]",Baixo a Moderado,,,,17,Algarve,FARO,0806,8825.45,22762,1314,1168,919,749,670,1419,2338,3506,4820,257.93,54.62,39.73,26.49
28-04-2021,LAGOA,51,4,346,"[240,480]",Elevado,,,,51,Açores,AÇORES,4201,4559.32,14721,536,458,349,238,235,473,822,1280,1816,322.9,39.83,28.08,18.03
28-04-2021,LAGOS,52,4,171,"[120,240]",Moderado,,,,52,Algarve,FARO,0807,21299.27,30374,1744,1434,1247,1053,1029,2082,3329,4763,6507,142.61,30.55,22.36,15.63
28-04-2021,LAJES DAS FLORES,0,0,0,"[0,120]",Baixo a Moderado,,,,0,Açores,AÇORES,4801,7004.79,1463,88,53,62,46,54,100,162,215,303,20.89,4.33,3.07,2.31
28-04-2021,LAJES DO PICO,0,0,0,"[0,120]",Baixo a Moderado,,,,0,Açores,AÇORES,4601,15531.09,4490,304,231,223,159,162,321,544,775,1079,28.91,6.95,4.99,3.5
28-04-2021,LAMEGO,39,3,157,"[120,240]",Moderado,,,,39,Norte,VISEU,1805,16542.11,24895,1639,1284,1124,898,783,1681,2805,4089,5728,150.5,34.63,24.72,16.96
28-04-2021,LEIRIA,79,6,63,"[0,120]",Baixo a Moderado,,,,79,Centro,LEIRIA,1009,56508.83,125267,7389,6366,5090,3902,3159,7061,12151,18517,25906,221.68,45.84,32.77,21.5
28-04-2021,LISBOA,387,28,76,"[0,120]",Baixo a Moderado,,,,387,Lisboa e Vale do Tejo,LISBOA,1106,10005.43,509515,33197,33340,27706,23037,26770,49807,77513,110853,144050,5092.6,1439.78,1107.98,774.74
28-04-2021,LOULÉ,44,3,64,"[0,120]",Baixo a Moderado,,,,44,Algarve,FARO,0808,76366.91,68697,3890,3350,2780,2358,2251,4609,7389,10739,14629,89.96,19.16,14.06,9.68
28-04-2021,LOURES,85,6,40,"[0,120]",Baixo a Moderado,,,,85,Lisboa e Vale do Tejo,LISBOA,1107,16723.99,213687,12746,12794,9644,6669,5033,11702,21346,34140,46886,1277.73,280.35,204.14,127.64
28-04-2021,LOURINHÃ,8,1,31,"[0,120]",Baixo a Moderado,,,,8,Lisboa e Vale do Tejo,LISBOA,1108,14717.2,25855,1584,1243,992,842,645,1487,2479,3722,5306,175.68,36.05,25.29,16.84
28-04-2021,LOUSÃ,5,0,29,"[0,120]",Baixo a Moderado,,,,5,Centro,COIMBRA,0607,13840.01,17158,946,866,658,528,450,978,1636,2502,3448,123.97,24.91,18.08,11.82
28-04-2021,LOUSADA,18,1,38,"[0,120]",Baixo a Moderado,,,,18,Norte,PORTO,1305,9608.01,46755,2289,1698,1176,853,621,1474,2650,4348,6637,486.63,69.08,45.25,27.58
28-04-2021,MAÇÃO,3,0,48,"[0,120]",Baixo a Moderado,,,,3,Lisboa e Vale do Tejo,SANTARÉM,1413,39997.98,6267,386,362,390,440,657,1097,1487,1849,2235,15.67,5.59,4.62,3.72
28-04-2021,MACEDO DE CAVALEIROS,3,0,21,"[0,120]",Baixo a Moderado,,,,3,Norte,BRAGANÇA,0405,69914.08,14516,1082,889,878,823,938,1761,2639,3528,4610,20.76,6.59,5.05,3.77
28-04-2021,MACHICO,60,4,300,"[240,480]",Elevado,,,,60,Madeira,MADEIRA,3104,6825.1,19981,1197,860,662,455,331,786,1448,2308,3505,292.76,51.36,33.82,21.22
28-04-2021,MADALENA,0,0,0,"[0,120]",Baixo a Moderado,,,,0,Açores,AÇORES,4602,14712.33,5895,334,256,173,190,179,369,542,798,1132,40.07,7.69,5.42,3.68
28-04-2021,MAFRA,51,4,60,"[0,120]",Baixo a Moderado,,,,51,Lisboa e Vale do Tejo,LISBOA,1109,29165.5,84816,3613,3334,2839,2089,1899,3988,6827,10161,13774,290.81,47.23,34.84,23.41
28-04-2021,MAIA,65,5,47,"[0,120]",Baixo a Moderado,,,,65,Norte,PORTO,1306,8293.94,138971,7801,6617,4512,3339,2631,5970,10482,17099,24900,1675.56,300.22,206.16,126.38
28-04-2021,MANGUALDE,0,0,0,"[0,120]",Baixo a Moderado,,,,0,Centro,VISEU,1806,21925.56,18510,1198,1128,885,852,743,1595,2480,3608,4806,84.42,21.92,16.46,11.31
28-04-2021,MANTEIGAS,0,0,0,"[0,120]",Baixo a Moderado,,,,0,Centro,GUARDA,0908,12197.55,3007,258,197,159,167,146,313,472,669,927,24.65,7.6,5.48,3.87
28-04-2021,MARCO DE CANAVESES,58,4,113,"[0,120]",Baixo a Moderado,,,,58,Norte,PORTO,1307,20188.98,51496,2678,2060,1488,1265,1023,2288,3776,5836,8514,255.07,42.17,28.91,18.7
28-04-2021,MARINHA GRANDE,32,2,83,"[0,120]",Baixo a Moderado,,,,32,Centro,LEIRIA,1010,18725.19,38508,2365,2302,1638,1359,1058,2417,4055,6357,8722,205.65,46.58,33.95,21.66
28-04-2021,MARVÃO,1,0,33,"[0,120]",Baixo a Moderado,,,,1,Alentejo,PORTALEGRE,1210,15489.9,3005,198,185,142,197,237,434,576,761,959,19.4,6.19,4.91,3.72
28-04-2021,MATOSINHOS,74,5,42,"[0,120]",Baixo a Moderado,,,,74,Norte,PORTO,1308,6241.97,175357,11850,9977,7023,5024,3884,8908,15931,25908,37758,2809.31,604.9,415.06,255.22
28-04-2021,MEALHADA,3,0,15,"[0,120]",Baixo a Moderado,,,,3,Centro,AVEIRO,0111,11065.66,19914,1163,1039,810,828,831,1659,2469,3508,4671,179.96,42.21,31.7,22.31
28-04-2021,MÊDA,5,0,109,"[0,120]",Baixo a Moderado,,,,5,Centro,GUARDA,0909,28604.92,4587,343,306,290,288,443,731,1021,1327,1670,16.04,5.84,4.64,3.57
28-04-2021,MELGAÇO,11,1,136,"[120,240]",Moderado,,,,11,Norte,VIANA DO CASTELO,1603,23824.58,8093,507,567,578,614,675,1289,1867,2434,2941,33.97,12.34,10.22,7.84
28-04-2021,MÉRTOLA,1,0,16,"[0,120]",Baixo a Moderado,,,,1,Alentejo,BEJA,0209,129287.34,6142,400,390,378,423,600,1023,1401,1791,2191,4.75,1.69,1.39,1.08
28-04-2021,MESÃO FRIO,3,0,76,"[0,120]",Baixo a Moderado,,,,3,Norte,VILA REAL,1704,2664.87,3964,265,205,168,157,120,277,445,650,915,148.74,34.33,24.39,16.7
28-04-2021,MIRA,12,1,101,"[0,120]",Baixo a Moderado,,,,12,Centro,COIMBRA,0608,12403.38,11832,727,729,659,550,466,1016,1675,2404,3131,95.4,25.24,19.38,13.5
28-04-2021,MIRANDA DO CORVO,4,0,31,"[0,120]",Baixo a Moderado,,,,4,Centro,COIMBRA,0609,12637.79,12708,706,659,568,498,404,902,1470,2129,2835,100.55,22.43,16.85,11.63
28-04-2021,MIRANDA DO DOURO,14,1,205,"[120,240]",Moderado,,,,14,Norte,BRAGANÇA,0406,48718.31,6830,482,429,442,463,470,933,1375,1804,2286,14.02,4.69,3.7,2.82
28-04-2021,MIRANDELA,7,0,32,"[0,120]",Baixo a Moderado,,,,7,Norte,BRAGANÇA,0407,65895.67,21754,1640,1315,1204,1078,947,2025,3229,4544,6184,33.01,9.38,6.9,4.9
28-04-2021,MOGADOURO,0,0,0,"[0,120]",Baixo a Moderado,,,,0,Norte,BRAGANÇA,0408,76064.93,8392,589,529,576,630,655,1285,1861,2390,2979,11.03,3.92,3.14,2.45
28-04-2021,MOIMENTA DA BEIRA,8,1,82,"[0,120]",Baixo a Moderado,,,,8,Norte,VISEU,1807,21996.9,9736,576,514,471,416,461,877,1348,1862,2438,44.26,11.08,8.46,6.13
28-04-2021,MOITA,16,1,25,"[0,120]",Baixo a Moderado,,,,16,Lisboa e Vale do Tejo,SETÚBAL,1506,5525.98,64407,4226,3646,2623,1801,1425,3226,5849,9495,13721,1165.53,248.3,171.82,105.85
28-04-2021,MONÇÃO,11,1,62,"[0,120]",Baixo a Moderado,,,,11,Norte,VIANA DO CASTELO,1604,21130.85,17869,1161,1105,1031,1006,972,1978,3009,4114,5275,84.56,24.96,19.47,14.24
28-04-2021,MONCHIQUE,1,0,20,"[0,120]",Baixo a Moderado,,,,1,Algarve,FARO,0809,39530.43,5077,353,384,321,355,392,747,1068,1452,1805,12.84,4.57,3.67,2.7
28-04-2021,MONDIM DE BASTO,0,0,0,"[0,120]",Baixo a Moderado,,,,0,Norte,VILA REAL,1705,17207.52,6946,395,300,314,284,283,567,881,1181,1576,40.36,9.16,6.86,5.12
28-04-2021,MONFORTE,0,0,0,"[0,120]",Baixo a Moderado,,,,0,Alentejo,PORTALEGRE,1211,42024.82,2975,139,115,117,192,168,360,477,592,731,7.08,1.74,1.41,1.14
28-04-2021,MONTALEGRE,5,0,56,"[0,120]",Baixo a Moderado,,,,5,Norte,VILA REAL,1706,80545.71,8997,699,628,595,603,730,1333,1928,2556,3255,11.17,4.04,3.17,2.39
28-04-2021,MONTEMOR-O-NOVO,6,0,38,"[0,120]",Baixo a Moderado,,,,6,Alentejo,ÉVORA,0706,123296.65,15647,991,953,868,878,971,1849,2717,3670,4661,12.69,3.78,2.98,2.2
28-04-2021,MONTEMOR-O-VELHO,7,1,28,"[0,120]",Baixo a Moderado,,,,7,Centro,COIMBRA,0610,22896.23,25224,1496,1397,1217,1057,988,2045,3262,4659,6155,110.17,26.88,20.35,14.25
28-04-2021,MONTIJO,53,4,92,"[0,120]",Baixo a Moderado,,,,53,Lisboa e Vale do Tejo,SETÚBAL,1507,34861.64,57614,2771,2441,1990,1554,1109,2663,4653,7094,9865,165.26,28.3,20.35,13.35
28-04-2021,MORA,0,0,0,"[0,120]",Baixo a Moderado,,,,0,Alentejo,ÉVORA,0707,44395.02,4138,336,275,252,238,257,495,747,1022,1358,9.32,3.06,2.3,1.68
28-04-2021,MORTÁGUA,2,0,23,"[0,120]",Baixo a Moderado,,,,2,Centro,VISEU,1808,25117.82,8803,638,584,535,499,460,959,1494,2078,2716,35.05,10.81,8.27,5.95
28-04-2021,MOURA,7,0,51,"[0,120]",Baixo a Moderado,,,,7,Alentejo,BEJA,0210,95845.55,13718,817,656,665,542,461,1003,1668,2324,3141,14.31,3.28,2.42,1.74
28-04-2021,MOURÃO,0,0,0,"[0,120]",Baixo a Moderado,,,,0,Alentejo,ÉVORA,0708,27862.98,2450,139,108,80,104,109,213,293,401,540,8.79,1.94,1.44,1.05
28-04-2021,MURÇA,0,0,0,"[0,120]",Baixo a Moderado,,,,0,Norte,VILA REAL,1707,18937.11,5463,384,341,307,306,319,625,932,1273,1657,28.85,8.75,6.72,4.92
28-04-2021,MURTOSA,1,0,10,"[0,120]",Baixo a Moderado,,,,1,Centro,AVEIRO,0112,7308.78,10279,509,473,403,353,409,762,1165,1638,2147,140.63,29.37,22.41,15.94
28-04-2021,NAZARÉ,8,1,56,"[0,120]",Baixo a Moderado,,,,8,Lisboa e Vale do Tejo,LEIRIA,1011,8243.43,14165,967,903,670,420,396,816,1486,2389,3356,171.84,40.71,28.98,18.03
28-04-2021,NELAS,3,0,23,"[0,120]",Baixo a Moderado,,,,3,Centro,VISEU,1809,12571.48,12974,924,787,668,604,583,1187,1855,2642,3566,103.21,28.37,21.02,14.76
28-04-2021,NISA,0,0,0,"[0,120]",Baixo a Moderado,,,,0,Alentejo,PORTALEGRE,1212,57567.84,6061,405,389,355,483,478,961,1316,1705,2110,10.53,3.67,2.96,2.29
28-04-2021,NORDESTE,5,0,103,"[0,120]",Baixo a Moderado,,,,5,Açores,AÇORES,4202,10146.8,4862,246,180,124,161,162,323,447,627,873,47.92,8.6,6.18,4.41
28-04-2021,ÓBIDOS,2,0,17,"[0,120]",Baixo a Moderado,,,,2,Lisboa e Vale do Tejo,LEIRIA,1012,14155.44,11850,743,650,574,452,436,888,1462,2112,2855,83.72,20.17,14.92,10.33
28-04-2021,ODEMIRA,139,10,562,"[480,960]",Muito Elevado,,,,139,Alentejo,BEJA,0211,172060.15,24717,1475,1317,1225,1397,1349,2746,3971,5288,6763,14.37,3.93,3.07,2.31
28-04-2021,ODIVELAS,71,5,44,"[0,120]",Baixo a Moderado,,,,71,Lisboa e Vale do Tejo,LISBOA,1116,2654.36,161774,9562,9038,6952,4641,3812,8453,15405,24443,34005,6095.48,1281.27,920.99,580.44
28-04-2021,OEIRAS,110,8,62,"[0,120]",Baixo a Moderado,,,,110,Lisboa e Vale do Tejo,LISBOA,1110,4588.31,177408,11580,11575,8566,6211,5855,12066,20632,32207,43787,3866.78,954.38,701.98,449.69
28-04-2021,OLEIROS,0,0,0,"[0,120]",Baixo a Moderado,,,,0,Centro,CASTELO BRANCO,0506,47109.31,5003,384,341,366,397,487,884,1250,1591,1975,10.62,4.19,3.38,2.65
28-04-2021,OLHÃO,25,2,56,"[0,120]",Baixo a Moderado,,,,25,Algarve,FARO,0810,13086.38,44405,2455,2309,1689,1342,1268,2610,4299,6608,9063,339.33,69.26,50.5,32.85
28-04-2021,OLIVEIRA DE AZEMÉIS,28,2,42,"[0,120]",Baixo a Moderado,,,,28,Norte,AVEIRO,0113,16110.41,66011,4155,3614,2794,2183,1738,3921,6715,10329,14484,409.75,89.91,64.12,41.68
28-04-2021,OLIVEIRA DE FRADES,1,0,10,"[0,120]",Baixo a Moderado,,,,1,Centro,VISEU,1810,14534.62,9936,553,475,438,359,415,774,1212,1687,2240,68.36,15.41,11.61,8.34
28-04-2021,OLIVEIRA DO BAIRRO,2,0,8,"[0,120]",Baixo a Moderado,,,,2,Centro,AVEIRO,0114,8731.99,24277,1327,1182,999,786,810,1596,2595,3777,5104,278.02,58.45,43.25,29.72
28-04-2021,OLIVEIRA DO HOSPITAL,43,3,223,"[120,240]",Moderado,,,,43,Centro,COIMBRA,0611,23451.66,19253,1161,1097,962,924,960,1884,2846,3943,5104,82.1,21.76,16.81,12.14
28-04-2021,OURÉM,10,1,23,"[0,120]",Baixo a Moderado,,,,10,Lisboa e Vale do Tejo,SANTARÉM,1421,41668.03,44044,2463,2069,1899,1817,1603,3420,5319,7388,9851,105.7,23.64,17.73,12.77
28-04-2021,OURIQUE,0,0,0,"[0,120]",Baixo a Moderado,,,,0,Alentejo,BEJA,0212,66331.36,4607,313,287,284,268,227,495,779,1066,1379,6.95,2.08,1.61,1.17
28-04-2021,OVAR,11,1,20,"[0,120]",Baixo a Moderado,,,,11,Centro,AVEIRO,0115,14770.25,54260,3294,2709,1994,1636,1234,2870,4864,7573,10867,367.37,73.57,51.27,32.93
28-04-2021,PAÇOS DE FERREIRA,88,6,155,"[120,240]",Moderado,,,,88,Norte,PORTO,1309,7099.29,56728,2903,2193,1518,1135,664,1799,3317,5510,8413,799.1,118.51,77.62,46.72
28-04-2021,PALMELA,8,1,12,"[0,120]",Baixo a Moderado,,,,8,Lisboa e Vale do Tejo,SETÚBAL,1508,46512.01,64269,3402,3244,2635,1846,1391,3237,5872,9116,12518,138.18,26.91,19.6,12.62
28-04-2021,PAMPILHOSA DA SERRA,1,0,25,"[0,120]",Baixo a Moderado,,,,1,Centro,COIMBRA,0612,39646.24,4037,238,254,295,339,423,762,1057,1311,1549,10.18,3.91,3.31,2.67
28-04-2021,PAREDES,210,15,244,"[240,480]",Elevado,,,,210,Norte,PORTO,1310,15675.69,86067,4272,3532,2412,1717,1258,2975,5387,8919,13191,549.04,84.15,56.9,34.36
28-04-2021,PAREDES DE COURA,3,0,35,"[0,120]",Baixo a Moderado,,,,3,Norte,VIANA DO CASTELO,1605,13818.59,8535,466,528,407,465,515,980,1387,1915,2381,61.76,17.23,13.86,10.04
28-04-2021,PEDRÓGÃO GRANDE,0,0,0,"[0,120]",Baixo a Moderado,,,,0,Centro,LEIRIA,1013,12874.75,3410,175,173,196,221,252,473,669,842,1017,26.49,7.9,6.54,5.2
28-04-2021,PENACOVA,1,0,7,"[0,120]",Baixo a Moderado,,,,1,Centro,COIMBRA,0613,21673.23,13694,968,923,745,621,703,1324,2069,2992,3960,63.18,18.27,13.81,9.55
28-04-2021,PENAFIEL,108,8,155,"[120,240]",Moderado,,,,108,Norte,PORTO,1311,21224.27,69772,3648,2823,2032,1663,1230,2893,4925,7748,11396,328.74,53.69,36.51,23.2
28-04-2021,PENALVA DO CASTELO,1,0,14,"[0,120]",Baixo a Moderado,,,,1,Centro,VISEU,1811,13433.92,7115,449,457,413,391,426,817,1230,1687,2136,52.96,15.9,12.56,9.16
28-04-2021,PENAMACOR,0,0,0,"[0,120]",Baixo a Moderado,,,,0,Centro,CASTELO BRANCO,0507,56370.69,4755,262,248,273,451,633,1084,1357,1605,1867,8.44,3.31,2.85,2.41
28-04-2021,PENEDONO,1,0,39,"[0,120]",Baixo a Moderado,,,,1,Norte,VISEU,1812,13370.75,2591,172,113,129,156,138,294,423,536,708,19.38,5.3,4.01,3.16
28-04-2021,PENELA,1,0,19,"[0,120]",Baixo a Moderado,,,,1,Centro,COIMBRA,0614,13480.0,5397,314,324,274,359,344,703,977,1301,1615,40.04,11.98,9.65,7.25
28-04-2021,PENICHE,59,4,223,"[120,240]",Moderado,,,,59,Lisboa e Vale do Tejo,LEIRIA,1014,7754.98,26501,1746,1504,1203,926,707,1633,2836,4340,6086,341.73,78.48,55.96,36.57
28-04-2021,PESO DA RÉGUA,23,2,146,"[120,240]",Moderado,,,,23,Norte,VILA REAL,1708,9486.01,15773,1076,843,650,659,455,1114,1764,2607,3683,166.28,38.83,27.48,18.6
28-04-2021,PINHEL,5,0,59,"[0,120]",Baixo a Moderado,,,,5,Centro,GUARDA,0910,48452.12,8511,577,566,551,538,689,1227,1778,2344,2921,17.57,6.03,4.84,3.67
28-04-2021,POMBAL,12,1,23,"[0,120]",Baixo a Moderado,,,,12,Centro,LEIRIA,1015,62600.28,51461,3187,2791,2494,2328,2027,4355,6849,9640,12827,82.21,20.49,15.4,10.94
28-04-2021,PONTA DELGADA,68,5,100,"[0,120]",Baixo a Moderado,,,,68,Açores,AÇORES,4203,23298.65,67935,3108,2435,1726,1133,902,2035,3761,6196,9304,291.58,39.93,26.59,16.14
28-04-2021,PONTA DO SOL,6,0,70,"[0,120]",Baixo a Moderado,,,,6,Madeira,MADEIRA,3105,4622.03,8593,319,283,347,208,221,429,776,1059,1378,185.92,29.81,22.91,16.79
28-04-2021,PONTE DA BARCA,14,1,125,"[120,240]",Moderado,,,,14,Norte,VIANA DO CASTELO,1606,18211.37,11180,635,576,517,554,490,1044,1561,2137,2772,61.39,15.22,11.73,8.57
28-04-2021,PONTE DE LIMA,48,3,116,"[0,120]",Baixo a Moderado,,,,48,Norte,VIANA DO CASTELO,1607,32025.46,41315,2321,2022,1720,1596,1462,3058,4778,6800,9121,129.01,28.48,21.23,14.92
28-04-2021,PONTE DE SOR,2,0,13,"[0,120]",Baixo a Moderado,,,,2,Alentejo,PORTALEGRE,1213,83971.16,14994,939,800,716,739,831,1570,2286,3086,4025,17.86,4.79,3.68,2.72
28-04-2021,PORTALEGRE,2,0,9,"[0,120]",Baixo a Moderado,,,,2,Alentejo,PORTALEGRE,1214,44713.64,22172,1577,1351,1137,993,984,1977,3114,4465,6042,49.59,13.51,9.99,6.96
28-04-2021,PORTEL,0,0,0,"[0,120]",Baixo a Moderado,,,,0,Alentejo,ÉVORA,0709,60100.57,5828,336,358,283,331,305,636,919,1277,1613,9.7,2.68,2.12,1.53
28-04-2021,PORTIMÃO,88,6,159,"[120,240]",Moderado,,,,88,Algarve,FARO,0811,18206.29,55483,3182,2927,2116,1582,1400,2982,5098,8025,11207,304.75,61.56,44.08,28.0
28-04-2021,PORTO,191,14,88,"[0,120]",Baixo a Moderado,,,,191,Norte,PORTO,1312,4142.02,216606,15790,15193,11280,9409,10044,19453,30733,45926,61716,5229.5,1490.0,1108.79,741.98
28-04-2021,PORTO DE MÓS,6,0,26,"[0,120]",Baixo a Moderado,,,,6,Centro,LEIRIA,1016,26183.41,23275,1355,1210,1034,888,872,1760,2794,4004,5359,88.89,20.47,15.29,10.67
28-04-2021,PORTO MONIZ,7,1,299,"[240,480]",Elevado,,,,7,Madeira,MADEIRA,3106,8293.38,2342,143,130,95,98,120,218,313,443,586,28.24,7.07,5.34,3.77
28-04-2021,PORTO SANTO,0,0,0,"[0,120]",Baixo a Moderado,,,,0,Madeira,MADEIRA,3201,4300.7,5202,240,157,134,110,68,178,312,469,709,120.95,16.48,10.9,7.25
28-04-2021,PÓVOA DE LANHOSO,31,2,144,"[120,240]",Moderado,,,,31,Norte,BRAGA,0309,13465.29,21499,1175,909,732,673,624,1297,2029,2938,4113,159.67,30.55,21.82,15.07
28-04-2021,PÓVOA DE VARZIM,29,2,46,"[0,120]",Baixo a Moderado,,,,29,Norte,PORTO,1313,8220.59,62784,3712,3120,2134,1594,1305,2899,5033,8153,11865,763.7,144.33,99.17,61.22
28-04-2021,POVOAÇÃO,0,0,0,"[0,120]",Baixo a Moderado,,,,0,Açores,AÇORES,4204,10640.77,5927,293,212,191,144,134,278,469,681,974,55.7,9.15,6.4,4.41
28-04-2021,VILA DA PRAIA DA VITÓRIA,1,0,5,"[0,120]",Baixo a Moderado,,,,1,Açores,AÇORES,4302,16127.06,21317,1133,789,619,436,336,772,1391,2180,3313,132.18,20.54,13.52,8.63
28-04-2021,PROENÇA-A-NOVA,0,0,0,"[0,120]",Baixo a Moderado,,,,0,Centro,CASTELO BRANCO,0508,39539.96,7298,508,465,389,400,560,960,1349,1814,2322,18.46,5.87,4.59,3.41
28-04-2021,REDONDO,0,0,0,"[0,120]",Baixo a Moderado,,,,0,Alentejo,ÉVORA,0710,36950.87,6353,349,325,288,288,354,642,930,1255,1604,17.19,4.34,3.4,2.52
28-04-2021,REGUENGOS DE MONSARAZ,0,0,0,"[0,120]",Baixo a Moderado,,,,0,Alentejo,ÉVORA,0711,46399.72,10015,602,511,455,462,473,935,1390,1901,2503,21.58,5.39,4.1,3.0
28-04-2021,RESENDE,41,3,404,"[240,480]",Elevado,,,,41,Norte,VISEU,1813,12334.93,10137,560,493,448,433,422,855,1303,1796,2356,82.18,19.1,14.56,10.56
28-04-2021,RIBEIRA BRAVA,7,0,56,"[0,120]",Baixo a Moderado,,,,7,Madeira,MADEIRA,3107,6544.88,12435,648,500,411,311,287,598,1009,1509,2157,189.99,32.96,23.06,15.42
28-04-2021,RIBEIRA DE PENA,5,0,83,"[0,120]",Baixo a Moderado,,,,5,Norte,VILA REAL,1709,21745.98,6016,371,301,290,310,368,678,968,1269,1640,27.66,7.54,5.84,4.45
28-04-2021,RIBEIRA GRANDE,107,8,326,"[240,480]",Elevado,,,,107,Açores,AÇORES,4205,18015.13,32811,1163,689,512,345,253,598,1110,1799,2962,182.13,16.44,9.99,6.16
28-04-2021,RIO MAIOR,11,1,54,"[0,120]",Baixo a Moderado,,,,11,Lisboa e Vale do Tejo,SANTARÉM,1414,27276.45,20379,1251,1144,941,795,648,1443,2384,3528,4779,74.71,17.52,12.93,8.74
28-04-2021,SABROSA,3,0,51,"[0,120]",Baixo a Moderado,,,,3,Norte,VILA REAL,1710,15692.45,5918,393,314,304,302,350,652,956,1270,1663,37.71,10.6,8.09,6.09
28-04-2021,SABUGAL,0,0,0,"[0,120]",Baixo a Moderado,,,,0,Centro,GUARDA,0911,82269.82,10585,724,707,694,796,1009,1805,2499,3206,3930,12.87,4.78,3.9,3.04
28-04-2021,SALVATERRA DE MAGOS,3,0,14,"[0,120]",Baixo a Moderado,,,,3,Lisboa e Vale do Tejo,SANTARÉM,1415,24393.2,21295,1275,1181,1060,799,772,1571,2631,3812,5087,87.3,20.85,15.63,10.79
28-04-2021,SANTA COMBA DÃO,12,1,115,"[0,120]",Baixo a Moderado,,,,12,Centro,VISEU,1814,11194.77,10452,732,684,569,538,464,1002,1571,2255,2987,93.36,26.68,20.14,14.03
28-04-2021,SANTA CRUZ,45,3,99,"[0,120]",Baixo a Moderado,,,,45,Madeira,MADEIRA,3108,8150.28,45281,1817,1301,974,716,523,1239,2213,3514,5331,555.6,65.41,43.12,27.15
28-04-2021,SANTA CRUZ DA GRACIOSA,0,0,0,"[0,120]",Baixo a Moderado,,,,0,Açores,AÇORES,4401,6065.78,4208,228,180,163,124,145,269,432,612,840,69.37,13.85,10.09,7.12
28-04-2021,SANTA CRUZ DAS FLORES,1,0,46,"[0,120]",Baixo a Moderado,,,,1,Açores,AÇORES,4802,7091.44,2165,125,98,74,56,51,107,181,279,404,30.53,5.7,3.93,2.55
28-04-2021,SANTA MARIA DA FEIRA,64,5,46,"[0,120]",Baixo a Moderado,,,,64,Norte,AVEIRO,0109,21587.65,138636,8182,6743,4771,3856,3079,6935,11706,18449,26631,642.19,123.36,85.46,54.22
28-04-2021,SANTA MARTA DE PENAGUIÃO,1,0,15,"[0,120]",Baixo a Moderado,,,,1,Norte,VILA REAL,1711,6928.13,6599,483,373,337,316,317,633,970,1343,1826,95.25,26.36,19.39,14.0
28-04-2021,SANTANA,3,0,45,"[0,120]",Baixo a Moderado,,,,3,Madeira,MADEIRA,3109,9547.3,6711,418,353,343,282,277,559,902,1255,1673,70.29,17.52,13.15,9.45
28-04-2021,SANTARÉM,8,1,14,"[0,120]",Baixo a Moderado,,,,8,Lisboa e Vale do Tejo,SANTARÉM,1416,55253.58,57421,3654,3441,2760,2466,2206,4672,7432,10873,14527,103.92,26.29,19.68,13.45
28-04-2021,SANTIAGO DO CACÉM,5,0,17,"[0,120]",Baixo a Moderado,,,,5,Alentejo,SETÚBAL,1509,105969.29,28791,2144,1689,1472,1295,1215,2510,3982,5671,7815,27.17,7.37,5.35,3.76
28-04-2021,SANTO TIRSO,29,2,43,"[0,120]",Baixo a Moderado,,,,29,Norte,PORTO,1314,13655.52,68055,4911,3935,2761,2257,1810,4067,6828,10763,15674,498.35,114.78,78.82,50.0
28-04-2021,SÃO BRÁS DE ALPORTEL,0,0,0,"[0,120]",Baixo a Moderado,,,,0,Algarve,FARO,0812,15336.92,10416,596,468,467,404,401,805,1272,1740,2336,67.91,15.23,11.35,8.29
28-04-2021,SÃO JOÃO DA MADEIRA,10,1,46,"[0,120]",Baixo a Moderado,,,,10,Norte,AVEIRO,0116,794.3,21958,1347,1069,796,601,593,1194,1990,3059,4406,2765.49,554.91,385.26,250.63
28-04-2021,SÃO JOÃO DA PESQUEIRA,1,0,14,"[0,120]",Baixo a Moderado,,,,1,Norte,VISEU,1815,26610.85,7125,417,330,294,328,328,656,950,1280,1697,26.77,6.38,4.81,3.57
28-04-2021,SÃO PEDRO DO SUL,4,0,26,"[0,120]",Baixo a Moderado,,,,4,Centro,VISEU,1816,34895.09,15403,990,962,861,759,909,1668,2529,3491,4481,44.14,12.84,10.0,7.25
28-04-2021,SÃO ROQUE DO PICO,0,0,0,"[0,120]",Baixo a Moderado,,,,0,Açores,AÇORES,4603,14236.1,3266,199,141,93,96,113,209,302,443,642,22.94,4.51,3.11,2.12
28-04-2021,SÃO VICENTE,2,0,39,"[0,120]",Baixo a Moderado,,,,2,Madeira,MADEIRA,3110,7883.71,5143,272,264,266,225,280,505,771,1035,1307,65.23,16.58,13.13,9.78
28-04-2021,SARDOAL,3,0,80,"[0,120]",Baixo a Moderado,,,,3,Lisboa e Vale do Tejo,SANTARÉM,1417,9214.72,3741,227,178,148,165,248,413,561,739,966,40.6,10.48,8.02,6.09
28-04-2021,SÁTÃO,0,0,0,"[0,120]",Baixo a Moderado,,,,0,Centro,VISEU,1817,20194.11,11580,765,671,515,465,476,941,1456,2127,2892,57.34,14.32,10.53,7.21
28-04-2021,SEIA,2,0,9,"[0,120]",Baixo a Moderado,,,,2,Centro,GUARDA,0912,43568.83,22234,1807,1589,1238,1122,721,1843,3081,4670,6477,51.03,14.87,10.72,7.07
28-04-2021,SEIXAL,74,5,44,"[0,120]",Baixo a Moderado,,,,74,Lisboa e Vale do Tejo,SETÚBAL,1510,9545.17,167752,10586,9270,6661,4391,2930,7321,13982,23252,33838,1757.49,354.51,243.6,146.49
28-04-2021,SERNANCELHE,0,0,0,"[0,120]",Baixo a Moderado,,,,0,Norte,VISEU,1818,22861.22,5396,305,293,286,273,260,533,819,1112,1417,23.6,6.2,4.86,3.58
28-04-2021,SERPA,5,0,35,"[0,120]",Baixo a Moderado,,,,5,Alentejo,BEJA,0213,110563.34,14304,903,761,719,697,626,1323,2042,2803,3706,12.94,3.35,2.54,1.85
28-04-2021,SERTÃ,1,0,7,"[0,120]",Baixo a Moderado,,,,1,Centro,CASTELO BRANCO,0509,44673.17,14577,870,779,790,767,1020,1787,2577,3356,4226,32.63,9.46,7.51,5.77
28-04-2021,SESIMBRA,12,1,23,"[0,120]",Baixo a Moderado,,,,12,Lisboa e Vale do Tejo,SETÚBAL,1511,19571.75,51858,2400,2321,1853,1257,1083,2340,4193,6514,8914,264.96,45.54,33.28,21.42
28-04-2021,SETÚBAL,78,6,68,"[0,120]",Baixo a Moderado,,,,78,Lisboa e Vale do Tejo,SETÚBAL,1512,23032.5,115126,7425,6929,5075,3775,2655,6430,11505,18434,25859,499.83,112.27,80.03,49.95
28-04-2021,SEVER DO VOUGA,7,1,62,"[0,120]",Baixo a Moderado,,,,7,Centro,AVEIRO,0117,12987.56,11331,766,637,568,540,567,1107,1675,2312,3078,87.24,23.7,17.8,12.9
28-04-2021,SILVES,12,1,33,"[0,120]",Baixo a Moderado,,,,12,Algarve,FARO,0813,68006.23,36226,2137,1869,1610,1423,1600,3023,4633,6502,8639,53.27,12.7,9.56,6.81
28-04-2021,SINES,4,0,29,"[0,120]",Baixo a Moderado,,,,4,Alentejo,SETÚBAL,1513,20330.17,13715,888,791,551,416,268,684,1235,2026,2914,67.46,14.33,9.97,6.07
28-04-2021,SINTRA,254,18,65,"[0,120]",Baixo a Moderado,,,,254,Lisboa e Vale do Tejo,LISBOA,1111,31922.73,391402,20490,18316,13545,9137,7284,16421,29966,48282,68772,1226.08,215.43,151.25,93.87
28-04-2021,SOBRAL DE MONTE AGRAÇO,2,0,19,"[0,120]",Baixo a Moderado,,,,2,Lisboa e Vale do Tejo,LISBOA,1112,5210.32,10651,564,507,352,272,212,484,836,1343,1907,204.43,36.6,25.78,16.05
28-04-2021,SOURE,4,0,23,"[0,120]",Baixo a Moderado,,,,4,Centro,COIMBRA,0615,26506.07,17120,1173,1142,1004,883,987,1870,2874,4016,5189,64.59,19.58,15.15,10.84
28-04-2021,SOUSEL,1,0,23,"[0,120]",Baixo a Moderado,,,,1,Alentejo,PORTALEGRE,1215,27932.18,4412,261,274,208,302,292,594,802,1076,1337,15.8,4.79,3.85,2.87
28-04-2021,TÁBUA,32,2,281,"[240,480]",Elevado,,,,32,Centro,COIMBRA,0616,19978.58,11368,729,584,524,430,464,894,1418,2002,2731,56.9,13.67,10.02,7.1
28-04-2021,TABUAÇO,15,1,249,"[240,480]",Elevado,,,,15,Norte,VISEU,1819,13385.67,6033,372,314,217,282,363,645,862,1176,1548,45.07,11.56,8.79,6.44
28-04-2021,TAROUCA,0,0,0,"[0,120]",Baixo a Moderado,,,,0,Norte,VISEU,1820,10008.49,7804,405,335,313,277,324,601,914,1249,1654,77.98,16.53,12.48,9.13
28-04-2021,TAVIRA,10,1,41,"[0,120]",Baixo a Moderado,,,,10,Algarve,FARO,0814,60696.7,24530,1493,1415,1252,1066,1277,2343,3595,5010,6503,40.41,10.71,8.25,5.92
28-04-2021,TERRAS DE BOURO,0,0,0,"[0,120]",Baixo a Moderado,,,,0,Norte,BRAGA,0310,27746.07,6361,391,372,296,319,340,659,955,1327,1718,22.93,6.19,4.78,3.44
28-04-2021,TOMAR,5,0,14,"[0,120]",Baixo a Moderado,,,,5,Lisboa e Vale do Tejo,SANTARÉM,1418,35120.44,36748,2403,2189,1868,1853,1822,3675,5543,7732,10135,104.64,28.86,22.02,15.78
28-04-2021,TONDELA,8,1,30,"[0,120]",Baixo a Moderado,,,,8,Centro,VISEU,1821,37121.73,26357,1768,1722,1518,1475,1417,2892,4410,6132,7900,71.0,21.28,16.52,11.88
28-04-2021,TORRE DE MONCORVO,3,0,39,"[0,120]",Baixo a Moderado,,,,3,Norte,BRAGANÇA,0409,53155.67,7695,556,478,488,551,719,1270,1758,2236,2792,14.48,5.25,4.21,3.31
28-04-2021,TORRES NOVAS,4,0,11,"[0,120]",Baixo a Moderado,,,,4,Lisboa e Vale do Tejo,SANTARÉM,1419,26999.68,34933,2324,1979,1738,1406,1475,2881,4619,6598,8922,129.38,33.04,24.44,17.11
28-04-2021,TORRES VEDRAS,92,7,117,"[0,120]",Baixo a Moderado,,,,92,Lisboa e Vale do Tejo,LISBOA,1113,40714.89,78530,4513,3945,3447,2628,2104,4732,8179,12124,16637,192.88,40.86,29.78,20.09
28-04-2021,TRANCOSO,2,0,23,"[0,120]",Baixo a Moderado,,,,2,Centro,GUARDA,0913,36152.47,8875,581,557,542,586,496,1082,1624,2181,2762,24.55,7.64,6.03,4.49
28-04-2021,TROFA,27,2,70,"[0,120]",Baixo a Moderado,,,,27,Norte,PORTO,1318,7201.76,38418,2336,1894,1231,939,684,1623,2854,4748,7084,533.44,98.36,65.93,39.63
28-04-2021,VAGOS,10,1,44,"[0,120]",Baixo a Moderado,,,,10,Centro,AVEIRO,0118,16491.5,22740,1320,1205,922,784,724,1508,2430,3635,4955,137.89,30.04,22.04,14.73
28-04-2021,VALE DE CAMBRA,11,1,52,"[0,120]",Baixo a Moderado,,,,11,Norte,AVEIRO,0119,14733.47,21327,1491,1363,1005,831,798,1629,2634,3997,5488,144.76,37.25,27.13,17.88
28-04-2021,VALENÇA,3,0,23,"[0,120]",Baixo a Moderado,,,,3,Norte,VIANA DO CASTELO,1608,11712.86,13290,867,791,582,582,503,1085,1667,2458,3325,113.46,28.39,20.99,14.23
28-04-2021,VALONGO,150,11,154,"[120,240]",Moderado,,,,150,Norte,PORTO,1315,7512.45,97444,5629,4696,3207,2462,1829,4291,7498,12194,17823,1297.18,237.26,162.33,99.81
28-04-2021,VALPAÇOS,14,1,94,"[0,120]",Baixo a Moderado,,,,14,Norte,VILA REAL,1712,54873.93,14818,1217,1118,999,928,997,1925,2924,4042,5259,27.0,9.58,7.37,5.33
28-04-2021,VELAS,1,0,20,"[0,120]",Baixo a Moderado,,,,1,Açores,AÇORES,4502,11738.38,5093,278,208,166,153,113,266,432,640,918,43.39,7.82,5.45,3.68
28-04-2021,VENDAS NOVAS,0,0,0,"[0,120]",Baixo a Moderado,,,,0,Alentejo,ÉVORA,0712,22238.88,11255,677,768,655,501,532,1033,1688,2456,3133,50.61,14.09,11.04,7.59
28-04-2021,VIANA DO ALENTEJO,0,0,0,"[0,120]",Baixo a Moderado,,,,0,Alentejo,ÉVORA,0713,39367.29,5145,245,208,235,210,214,424,659,867,1112,13.07,2.82,2.2,1.67
28-04-2021,VIANA DO CASTELO,69,5,82,"[0,120]",Baixo a Moderado,,,,69,Norte,VIANA DO CASTELO,1609,31902.01,84417,5470,4433,3591,3061,2982,6043,9634,14067,19537,264.61,61.24,44.09,30.2
28-04-2021,VIDIGUEIRA,12,1,218,"[120,240]",Moderado,,,,12,Alentejo,BEJA,0214,31661.09,5510,300,248,215,233,275,508,723,971,1271,17.4,4.01,3.07,2.28
28-04-2021,VIEIRA DO MINHO,2,0,17,"[0,120]",Baixo a Moderado,,,,2,Norte,BRAGA,0311,21644.35,11842,703,594,525,548,482,1030,1555,2149,2852,54.71,13.18,9.93,7.18
28-04-2021,VILA DE REI,0,0,0,"[0,120]",Baixo a Moderado,,,,0,Centro,CASTELO BRANCO,0510,19154.6,3323,169,128,172,247,302,549,721,849,1018,17.35,5.31,4.43,3.76
28-04-2021,VILA DO BISPO,3,0,58,"[0,120]",Baixo a Moderado,,,,3,Algarve,FARO,0815,17906.06,5154,302,302,314,232,233,465,779,1081,1383,28.78,7.72,6.04,4.35
28-04-2021,VILA DO CONDE,33,2,41,"[0,120]",Baixo a Moderado,,,,33,Norte,PORTO,1316,14902.77,79899,4726,3875,2819,2070,1743,3813,6632,10507,15233,536.13,102.21,70.5,44.5
28-04-2021,VILA DO PORTO,6,0,107,"[0,120]",Baixo a Moderado,,,,6,Açores,AÇORES,4101,9688.74,5616,274,212,135,96,123,219,354,566,840,57.96,8.67,5.84,3.65
28-04-2021,VILA FLOR,1,0,17,"[0,120]",Baixo a Moderado,,,,1,Norte,BRAGANÇA,0410,26581.14,6044,429,362,422,294,331,625,1047,1409,1838,22.74,6.91,5.3,3.94
28-04-2021,VILA FRANCA DE XIRA,122,9,86,"[0,120]",Baixo a Moderado,,,,122,Lisboa e Vale do Tejo,LISBOA,1114,31819.39,141957,8501,6852,4869,3425,2472,5897,10766,17618,26119,446.14,82.09,55.37,33.84
28-04-2021,VILA FRANCA DO CAMPO,42,3,380,"[240,480]",Elevado,,,,42,Açores,AÇORES,4206,7796.82,11051,450,344,248,217,154,371,619,963,1413,141.73,18.12,12.35,7.94
28-04-2021,VILA NOVA DA BARQUINHA,0,0,0,"[0,120]",Baixo a Moderado,,,,0,Lisboa e Vale do Tejo,SANTARÉM,1420,4952.97,7461,415,406,392,364,338,702,1094,1500,1915,150.64,38.66,30.28,22.09
28-04-2021,VILA NOVA DE CERVEIRA,0,0,0,"[0,120]",Baixo a Moderado,,,,0,Norte,VIANA DO CASTELO,1610,10846.66,8910,531,444,410,384,334,718,1128,1572,2103,82.14,19.39,14.49,10.4
28-04-2021,VILA NOVA DE FAMALICÃO,145,10,110,"[0,120]",Baixo a Moderado,,,,145,Norte,BRAGA,0312,20159.26,131676,7817,6164,4202,3282,2749,6031,10233,16397,24214,653.19,120.12,81.34,50.76
28-04-2021,VILA NOVA DE FOZ CÔA,1,0,15,"[0,120]",Baixo a Moderado,,,,1,Centro,GUARDA,0914,39815.18,6503,442,385,390,398,429,827,1217,1602,2044,16.33,5.13,4.02,3.06
28-04-2021,VILA NOVA DE GAIA,183,13,61,"[0,120]",Baixo a Moderado,,,,183,Norte,PORTO,1317,16846.43,300472,18349,15568,10972,8224,6281,14505,25477,41045,59394,1783.64,352.57,243.65,151.23
28-04-2021,VILA NOVA DE PAIVA,0,0,0,"[0,120]",Baixo a Moderado,,,,0,Centro,VISEU,1822,17553.28,4687,289,272,233,217,241,458,691,963,1252,26.7,7.13,5.49,3.94
28-04-2021,VILA NOVA DE POIARES,1,0,14,"[0,120]",Baixo a Moderado,,,,1,Centro,COIMBRA,0617,8445.3,6939,380,284,262,235,182,417,679,963,1343,82.17,15.9,11.4,8.04
28-04-2021,VILA POUCA DE AGUIAR,10,1,84,"[0,120]",Baixo a Moderado,,,,10,Norte,VILA REAL,1713,43706.62,11961,860,817,733,601,627,1228,1961,2778,3638,27.37,8.32,6.36,4.49
28-04-2021,VILA REAL,20,1,40,"[0,120]",Baixo a Moderado,,,,20,Norte,VILA REAL,1714,37880.28,49962,3025,2498,2065,1579,1466,3045,5110,7608,10633,131.9,28.07,20.08,13.49
28-04-2021,VILA REAL DE SANTO ANTÓNIO,34,2,181,"[120,240]",Moderado,,,,34,Algarve,FARO,0816,6125.0,18749,1172,1069,811,569,586,1155,1966,3035,4207,306.11,68.69,49.55,32.1
28-04-2021,VILA VELHA DE RÓDÃO,0,0,0,"[0,120]",Baixo a Moderado,,,,0,Centro,CASTELO BRANCO,0511,32991.16,3144,209,229,180,283,306,589,769,998,1207,9.53,3.66,3.03,2.33
28-04-2021,VILA VERDE,23,2,49,"[0,120]",Baixo a Moderado,,,,23,Norte,BRAGA,0313,22866.52,46911,2365,2063,1667,1494,1437,2931,4598,6661,9026,205.15,39.47,29.13,20.11
28-04-2021,VILA VIÇOSA,7,0,91,"[0,120]",Baixo a Moderado,,,,7,Alentejo,ÉVORA,0714,19485.89,7656,487,379,342,345,324,669,1011,1390,1877,39.29,9.63,7.13,5.19
28-04-2021,VIMIOSO,3,0,75,"[0,120]",Baixo a Moderado,,,,3,Norte,BRAGANÇA,0411,48158.51,4023,274,230,261,293,335,628,889,1119,1393,8.35,2.89,2.32,1.85
28-04-2021,VINHAIS,2,0,26,"[0,120]",Baixo a Moderado,,,,2,Norte,BRAGANÇA,0412,69475.09,7746,599,577,636,641,815,1456,2092,2669,3268,11.15,4.7,3.84,3.01
28-04-2021,VISEU,15,1,15,"[0,120]",Baixo a Moderado,,,,15,Centro,VISEU,1823,50710.14,97249,5769,5038,4140,3158,2710,5868,10008,15046,20815,191.77,41.05,29.67,19.74
28-04-2021,VIZELA,6,0,25,"[0,120]",Baixo a Moderado,,,,6,Norte,BRAGA,0314,2469.83,23897,1258,928,655,509,371,880,1535,2463,3721,967.49,150.65,99.72,62.15
28-04-2021,VOUZELA,2,0,21,"[0,120]",Baixo a Moderado,,,,2,Centro,VISEU,1824,19369.46,9619,626,605,554,532,507,1039,1593,2198,2824,49.66,14.58,11.35,8.22
06-05-2021,ABRANTES,18,1,51,"[0,120]",Baixo a Moderado,,,,18,Lisboa e Vale do Tejo,SANTARÉM,1401,71469.08,35130,2473,2213,1730,1748,2021,3769,5499,7712,10185,49.15,14.25,10.79,7.69
06-05-2021,ÁGUEDA,6,0,13,"[0,120]",Baixo a Moderado,,,,6,Centro,AVEIRO,0101,33527.44,46075,3237,2713,2090,1635,1496,3131,5221,7934,11171,137.43,33.32,23.66,15.57
06-05-2021,AGUIAR DA BEIRA,4,0,86,"[0,120]",Baixo a Moderado,,,,4,Centro,GUARDA,0901,20676.57,4652,304,281,235,239,148,387,622,903,1207,22.5,5.84,4.37,3.01
06-05-2021,ALANDROAL,3,0,60,"[0,120]",Baixo a Moderado,,,,3,Alentejo,ÉVORA,0701,54267.81,4992,307,256,296,299,377,676,972,1228,1535,9.2,2.83,2.26,1.79
06-05-2021,ALBERGARIA-A-VELHA,1,0,4,"[0,120]",Baixo a Moderado,,,,1,Centro,AVEIRO,0102,15882.5,24144,1550,1298,996,687,680,1367,2363,3661,5211,152.02,32.81,23.05,14.88
06-05-2021,ALBUFEIRA,27,2,65,"[0,120]",Baixo a Moderado,,,,27,Algarve,FARO,0801,14066.42,41528,2067,1717,1425,985,858,1843,3268,4985,7052,295.24,50.14,35.44,23.23
06-05-2021,ALCÁCER DO SAL,2,0,17,"[0,120]",Baixo a Moderado,,,,2,Alentejo,SETÚBAL,1501,149987.3,11659,884,814,623,623,602,1225,1848,2662,3546,7.77,2.36,1.77,1.23
06-05-2021,ALCANENA,0,0,0,"[0,120]",Baixo a Moderado,,,,0,Lisboa e Vale do Tejo,SANTARÉM,1402,12732.86,12809,891,744,628,536,588,1124,1752,2496,3387,100.6,26.6,19.6,13.76
06-05-2021,ALCOBAÇA,9,1,17,"[0,120]",Baixo a Moderado,,,,9,Lisboa e Vale do Tejo,LEIRIA,1001,40814.09,53555,3420,2927,2466,2059,1676,3735,6201,9128,12548,131.22,30.74,22.36,15.19
06-05-2021,ALCOCHETE,14,1,71,"[0,120]",Baixo a Moderado,,,,14,Lisboa e Vale do Tejo,SETÚBAL,1502,12836.48,19787,857,834,691,476,447,923,1614,2448,3305,154.15,25.75,19.07,12.57
06-05-2021,ALCOUTIM,0,0,0,"[0,120]",Baixo a Moderado,,,,0,Algarve,FARO,0802,57536.33,2159,191,188,163,190,267,457,620,808,999,3.75,1.74,1.4,1.08
06-05-2021,ALENQUER,33,2,75,"[0,120]",Baixo a Moderado,,,,33,Lisboa e Vale do Tejo,LISBOA,1101,30421.92,44052,2298,2062,1629,1330,1155,2485,4114,6176,8474,144.8,27.85,20.3,13.52
06-05-2021,ALFÂNDEGA DA FÉ,0,0,0,"[0,120]",Baixo a Moderado,,,,0,Norte,BRAGANÇA,0401,32194.64,4550,325,277,301,274,325,599,900,1177,1502,14.13,4.67,3.66,2.8
06-05-2021,ALIJÓ,5,0,47,"[0,120]",Baixo a Moderado,,,,5,Norte,VILA REAL,1701,29759.89,10625,766,687,635,542,666,1208,1843,2530,3296,35.7,11.08,8.5,6.19
06-05-2021,ALJEZUR,5,0,89,"[0,120]",Baixo a Moderado,,,,5,Algarve,FARO,0803,32349.95,5594,316,336,335,320,410,730,1065,1401,1717,17.29,5.31,4.33,3.29
06-05-2021,ALJUSTREL,2,0,24,"[0,120]",Baixo a Moderado,,,,2,Alentejo,BEJA,0201,45847.41,8247,635,521,443,347,358,705,1148,1669,2304,17.99,5.03,3.64,2.5
06-05-2021,ALMADA,68,5,40,"[0,120]",Baixo a Moderado,,,,68,Lisboa e Vale do Tejo,SETÚBAL,1503,7000.89,169039,10469,9777,7876,6144,5111,11255,19131,28908,39377,2414.5,562.45,412.91,273.26
06-05-2021,ALMEIDA,0,0,0,"[0,120]",Baixo a Moderado,,,,0,Centro,GUARDA,0902,51798.46,5830,441,419,396,458,393,851,1247,1666,2107,11.26,4.07,3.22,2.41
06-05-2021,ALMEIRIM,7,0,31,"[0,120]",Baixo a Moderado,,,,7,Lisboa e Vale do Tejo,SANTARÉM,1403,22212.05,22546,1342,1353,1106,866,843,1709,2815,4168,5510,101.5,24.81,18.76,12.67
06-05-2021,ALMODÔVAR,0,0,0,"[0,120]",Baixo a Moderado,,,,0,Alentejo,BEJA,0202,77788.03,6725,414,443,396,373,328,701,1097,1540,1954,8.65,2.51,1.98,1.41
06-05-2021,ALPIARÇA,9,1,127,"[120,240]",Moderado,,,,9,Lisboa e Vale do Tejo,SANTARÉM,1404,9536.33,7059,515,486,363,333,274,607,970,1456,1971,74.02,20.67,15.27,10.17
06-05-2021,ALTER DO CHÃO,0,0,0,"[0,120]",Baixo a Moderado,,,,0,Alentejo,PORTALEGRE,1201,36206.62,3165,201,163,136,208,187,395,531,694,895,8.74,2.47,1.92,1.47
06-05-2021,ALVAIÁZERE,12,1,182,"[120,240]",Moderado,,,,12,Centro,LEIRIA,1002,16047.76,6597,419,389,346,406,539,945,1291,1680,2099,41.11,13.08,10.47,8.04
06-05-2021,ALVITO,0,0,0,"[0,120]",Baixo a Moderado,,,,0,Alentejo,BEJA,0203,26485.32,2477,145,110,105,111,89,200,305,415,560,9.35,2.11,1.57,1.15
06-05-2021,AMADORA,83,6,45,"[0,120]",Baixo a Moderado,,,,83,Lisboa e Vale do Tejo,LISBOA,1115,2378.47,184106,11186,10936,8780,6460,5890,12350,21130,32066,43252,7742.05,1818.84,1348.44,888.56
06-05-2021,AMARANTE,22,2,41,"[0,120]",Baixo a Moderado,,,,22,Norte,PORTO,1301,30133.15,53193,3086,2413,1812,1643,1311,2954,4766,7179,10265,176.53,34.07,23.82,15.82
06-05-2021,AMARES,14,1,77,"[0,120]",Baixo a Moderado,,,,14,Norte,BRAGA,0301,8195.41,18129,1001,829,622,489,524,1013,1635,2464,3465,221.22,42.28,30.07,19.95
06-05-2021,ANADIA,2,0,7,"[0,120]",Baixo a Moderado,,,,2,Centro,AVEIRO,0103,21663.48,27258,1931,1698,1376,1208,1262,2470,3846,5544,7475,125.83,34.51,25.59,17.75
06-05-2021,ANGRA DO HEROÍSMO,1,0,3,"[0,120]",Baixo a Moderado,,,,1,Açores,AÇORES,4301,23899.66,33807,2006,1473,1122,768,635,1403,2525,3998,6004,141.45,25.12,16.73,10.56
06-05-2021,ANSIÃO,0,0,0,"[0,120]",Baixo a Moderado,,,,0,Centro,LEIRIA,1003,17609.42,12039,727,709,646,694,530,1224,1870,2579,3306,68.37,18.77,14.65,10.62
06-05-2021,ARCOS DE VALDEVEZ,11,1,53,"[0,120]",Baixo a Moderado,,,,11,Norte,VIANA DO CASTELO,1601,44759.64,20926,1329,1338,1282,1343,1515,2858,4140,5478,6807,46.75,15.21,12.24,9.25
06-05-2021,ARGANIL,65,5,590,"[480,960]",Muito Elevado,,,,65,Centro,COIMBRA,0601,33283.93,11014,672,648,612,559,596,1155,1767,2415,3087,33.09,9.27,7.26,5.31
06-05-2021,ARMAMAR,0,0,0,"[0,120]",Baixo a Moderado,,,,0,Norte,VISEU,1801,11723.73,5769,357,305,309,285,310,595,904,1209,1566,49.21,13.36,10.31,7.71
06-05-2021,AROUCA,16,1,77,"[0,120]",Baixo a Moderado,,,,16,Norte,AVEIRO,0104,32910.52,20720,1306,1047,753,683,683,1366,2119,3166,4472,62.96,13.59,9.62,6.44
06-05-2021,ARRAIOLOS,0,0,0,"[0,120]",Baixo a Moderado,,,,0,Alentejo,ÉVORA,0702,68374.55,6928,435,384,283,367,480,847,1130,1514,1949,10.13,2.85,2.21,1.65
06-05-2021,ARRONCHES,0,0,0,"[0,120]",Baixo a Moderado,,,,0,Alentejo,PORTALEGRE,1202,31464.72,2820,155,142,162,187,179,366,528,670,825,8.96,2.62,2.13,1.68
06-05-2021,ARRUDA DOS VINHOS,5,0,32,"[0,120]",Baixo a Moderado,,,,5,Lisboa e Vale do Tejo,LISBOA,1102,7795.93,15412,738,738,562,509,438,947,1509,2247,2985,197.69,38.29,28.82,19.36
06-05-2021,AVEIRO,41,3,52,"[0,120]",Baixo a Moderado,,,,41,Centro,AVEIRO,0105,19757.57,78734,4520,4004,3050,2250,2103,4353,7403,11407,15927,398.49,80.61,57.73,37.47
06-05-2021,AVIS,0,0,0,"[0,120]",Baixo a Moderado,,,,0,Alentejo,PORTALEGRE,1203,60596.51,4247,315,225,206,251,273,524,730,955,1270,7.01,2.1,1.58,1.2
06-05-2021,AZAMBUJA,3,0,13,"[0,120]",Baixo a Moderado,,,,3,Lisboa e Vale do Tejo,LISBOA,1103,26265.65,22716,1322,1171,1070,798,618,1416,2486,3657,4979,86.48,18.96,13.92,9.46
06-05-2021,BAIÃO,7,0,37,"[0,120]",Baixo a Moderado,,,,7,Norte,PORTO,1302,17452.83,18748,1070,862,714,686,725,1411,2125,2987,4057,107.42,23.25,17.11,12.18
06-05-2021,BARCELOS,63,4,54,"[0,120]",Baixo a Moderado,,,,63,Norte,BRAGA,0302,37890.14,116187,6721,5325,3619,2991,2562,5553,9172,14497,21218,306.64,56.0,38.26,24.21
06-05-2021,BARRANCOS,0,0,0,"[0,120]",Baixo a Moderado,,,,0,Alentejo,BEJA,0204,16841.73,1634,90,65,65,94,61,155,220,285,375,9.7,2.23,1.69,1.31
06-05-2021,BARREIRO,27,2,36,"[0,120]",Baixo a Moderado,,,,27,Lisboa e Vale do Tejo,SETÚBAL,1504,3639.07,75147,5194,5565,4459,3105,1767,4872,9331,14896,20090,2065.05,552.07,409.34,256.42
06-05-2021,BATALHA,10,1,63,"[0,120]",Baixo a Moderado,,,,10,Centro,LEIRIA,1004,10341.6,15963,873,762,649,529,549,1078,1727,2489,3362,154.35,32.51,24.07,16.7
06-05-2021,BEJA,69,5,205,"[120,240]",Moderado,,,,69,Alentejo,BEJA,0205,114647.55,33579,2005,1840,1386,1272,1039,2311,3697,5537,7542,29.29,6.58,4.83,3.22
06-05-2021,BELMONTE,0,0,0,"[0,120]",Baixo a Moderado,,,,0,Centro,CASTELO BRANCO,0501,11875.91,6398,444,321,325,310,355,665,990,1311,1755,53.87,14.78,11.04,8.34
06-05-2021,BENAVENTE,2,0,7,"[0,120]",Baixo a Moderado,,,,2,Lisboa e Vale do Tejo,SANTARÉM,1405,52138.39,30602,1468,1376,1141,876,643,1519,2660,4036,5504,58.69,10.56,7.74,5.1
06-05-2021,BOMBARRAL,0,0,0,"[0,120]",Baixo a Moderado,,,,0,Lisboa e Vale do Tejo,LEIRIA,1005,9128.55,12558,875,714,561,491,429,920,1481,2195,3070,137.56,33.63,24.04,16.22
06-05-2021,BORBA,0,0,0,"[0,120]",Baixo a Moderado,,,,0,Alentejo,ÉVORA,0703,14518.65,6736,430,375,279,436,392,828,1107,1482,1912,46.39,13.17,10.21,7.62
06-05-2021,BOTICAS,4,0,80,"[0,120]",Baixo a Moderado,,,,4,Norte,VILA REAL,1702,32195.66,4998,347,306,311,305,380,685,996,1302,1649,15.52,5.12,4.04,3.09
06-05-2021,BRAGA,111,8,61,"[0,120]",Baixo a Moderado,,,,111,Norte,BRAGA,0303,18339.95,182679,10029,7963,5241,4320,3671,7991,13232,21195,31224,996.07,170.25,115.57,72.15
06-05-2021,BRAGANÇA,14,1,42,"[0,120]",Baixo a Moderado,,,,14,Norte,BRAGANÇA,0402,117357.27,33607,2402,1855,1652,1393,1163,2556,4208,6063,8465,28.64,7.21,5.17,3.59
06-05-2021,CABECEIRAS DE BASTO,59,4,378,"[240,480]",Elevado,,,,59,Norte,BRAGA,0304,24182.16,15628,774,594,544,575,574,1149,1693,2287,3061,64.63,12.66,9.46,7.0
06-05-2021,CADAVAL,3,0,22,"[0,120]",Baixo a Moderado,,,,3,Lisboa e Vale do Tejo,LISBOA,1104,17489.3,13673,813,796,756,621,625,1246,2002,2798,3611,78.18,20.65,16.0,11.45
06-05-2021,CALDAS DA RAINHA,5,0,10,"[0,120]",Baixo a Moderado,,,,5,Lisboa e Vale do Tejo,LEIRIA,1006,25569.47,51912,3035,2684,2186,1899,1705,3604,5790,8474,11509,203.03,45.01,33.14,22.64
06-05-2021,CALHETA,0,0,0,"[0,120]",Baixo a Moderado,,,,0,Madeira,MADEIRA,3101,11150.43,10867,576,497,507,399,415,814,1321,1818,2394,97.46,21.47,16.3,11.85
06-05-2021,CALHETA (AÇORES),1,0,31,"[0,120]",Baixo a Moderado,,,,1,Açores,AÇORES,4501,12626.4,3184,215,159,141,139,122,261,402,561,776,25.22,6.15,4.44,3.18
06-05-2021,CÂMARA DE LOBOS,18,1,53,"[0,120]",Baixo a Moderado,,,,18,Madeira,MADEIRA,3102,5216.67,33675,1396,1059,834,545,381,926,1760,2819,4215,645.49,80.79,54.03,33.74
06-05-2021,CAMINHA,6,0,38,"[0,120]",Baixo a Moderado,,,,6,Norte,VIANA DO CASTELO,1602,13652.14,15877,1046,944,818,646,656,1302,2120,3064,4110,116.3,30.11,22.44,15.53
06-05-2021,CAMPO MAIOR,1,0,13,"[0,120]",Baixo a Moderado,,,,1,Alentejo,PORTALEGRE,1204,24720.16,7874,471,364,351,279,327,606,957,1321,1792,31.85,7.25,5.34,3.87
06-05-2021,CANTANHEDE,3,0,9,"[0,120]",Baixo a Moderado,,,,3,Centro,COIMBRA,0602,39088.02,35011,2346,2096,1880,1709,1451,3160,5040,7136,9482,89.57,24.26,18.26,12.89
06-05-2021,CARRAZEDA DE ANSIÃES,0,0,0,"[0,120]",Baixo a Moderado,,,,0,Norte,BRAGANÇA,0403,27924.09,5666,424,389,391,312,465,777,1168,1557,1981,20.29,7.09,5.58,4.18
06-05-2021,CARREGAL DO SAL,13,1,140,"[120,240]",Moderado,,,,13,Centro,VISEU,1802,11689.21,9271,587,562,486,462,376,838,1324,1886,2473,79.31,21.16,16.13,11.33
06-05-2021,CARTAXO,3,0,13,"[0,120]",Baixo a Moderado,,,,3,Lisboa e Vale do Tejo,SANTARÉM,1406,15817.28,23843,1415,1376,1142,861,632,1493,2635,4011,5426,150.74,34.3,25.36,16.66
06-05-2021,CASCAIS,64,5,30,"[0,120]",Baixo a Moderado,,,,64,Lisboa e Vale do Tejo,LISBOA,1105,9740.17,213608,12151,11444,8680,6469,5248,11717,20397,31841,43992,2193.1,451.66,326.91,209.41
06-05-2021,CASTANHEIRA DE PÊRA,1,0,38,"[0,120]",Baixo a Moderado,,,,1,Centro,LEIRIA,1007,6677.45,2614,233,195,157,190,187,377,534,729,962,39.15,14.41,10.92,8.0
06-05-2021,CASTELO BRANCO,14,1,27,"[0,120]",Baixo a Moderado,,,,14,Centro,CASTELO BRANCO,0502,143819.15,51987,3528,3042,2499,2229,2225,4454,6953,9995,13523,36.15,9.4,6.95,4.83
06-05-2021,CASTELO DE PAIVA,35,2,226,"[120,240]",Moderado,,,,35,Norte,AVEIRO,0106,11500.53,15454,881,697,545,420,431,851,1396,2093,2974,134.37,25.86,18.2,12.14
06-05-2021,CASTELO DE VIDE,0,0,0,"[0,120]",Baixo a Moderado,,,,0,Alentejo,PORTALEGRE,1205,26491.24,2919,204,173,179,147,170,317,496,669,873,11.02,3.3,2.53,1.87
06-05-2021,CASTRO DAIRE,3,0,22,"[0,120]",Baixo a Moderado,,,,3,Centro,VISEU,1803,37904.13,13823,942,857,765,732,773,1505,2270,3127,4069,36.47,10.74,8.25,5.99
06-05-2021,CASTRO MARIM,0,0,0,"[0,120]",Baixo a Moderado,,,,0,Algarve,FARO,0804,30084.37,6237,370,345,334,322,344,666,1000,1345,1715,20.73,5.7,4.47,3.32
06-05-2021,CASTRO VERDE,0,0,0,"[0,120]",Baixo a Moderado,,,,0,Alentejo,BEJA,0206,56944.23,6949,437,347,303,275,227,502,805,1152,1589,12.2,2.79,2.02,1.41
06-05-2021,CELORICO DA BEIRA,0,0,0,"[0,120]",Baixo a Moderado,,,,0,Centro,GUARDA,0903,24721.63,6928,430,416,363,369,535,904,1267,1683,2113,28.02,8.55,6.81,5.12
06-05-2021,CELORICO DE BASTO,10,1,53,"[0,120]",Baixo a Moderado,,,,10,Norte,BRAGA,0305,18107.02,19040,1001,802,668,728,729,1457,2125,2927,3928,105.15,21.69,16.17,11.74
06-05-2021,CHAMUSCA,1,0,11,"[0,120]",Baixo a Moderado,,,,1,Lisboa e Vale do Tejo,SANTARÉM,1407,74600.54,9197,629,583,553,465,579,1044,1597,2180,2809,12.33,3.77,2.92,2.14
06-05-2021,CHAVES,22,2,56,"[0,120]",Baixo a Moderado,,,,22,Norte,VILA REAL,1703,59122.95,39343,2676,2429,1991,1886,1918,3804,5795,8224,10900,66.54,18.44,13.91,9.8
06-05-2021,CINFÃES,20,1,110,"[0,120]",Baixo a Moderado,,,,20,Norte,VISEU,1804,23928.76,18244,1067,902,779,734,758,1492,2271,3173,4240,76.24,17.72,13.26,9.49
06-05-2021,COIMBRA,32,2,24,"[0,120]",Baixo a Moderado,,,,32,Centro,COIMBRA,0603,31939.94,134166,9489,8734,6353,5139,5074,10213,16566,25300,34789,420.06,108.92,79.21,51.87
06-05-2021,CONDEIXA-A-NOVA,3,0,17,"[0,120]",Baixo a Moderado,,,,3,Centro,COIMBRA,0604,13867.47,17733,871,809,717,583,490,1073,1790,2599,3470,127.88,25.02,18.74,12.91
06-05-2021,CONSTÂNCIA,1,0,25,"[0,120]",Baixo a Moderado,,,,1,Lisboa e Vale do Tejo,SANTARÉM,1408,8036.58,4030,211,183,187,148,155,303,490,673,884,50.14,11.0,8.37,6.1
06-05-2021,CORUCHE,27,2,155,"[120,240]",Moderado,,,,27,Lisboa e Vale do Tejo,SANTARÉM,1409,111572.03,17471,1294,1090,1095,1096,1019,2115,3210,4300,5594,15.66,5.01,3.85,2.88
06-05-2021,CORVO,0,0,0,"[0,120]",Baixo a Moderado,,,,0,Açores,AÇORES,4901,1711.45,464,22,21,11,13,19,32,43,64,86,27.12,5.03,3.74,2.51
06-05-2021,COVILHÃ,25,2,53,"[0,120]",Baixo a Moderado,,,,25,Centro,CASTELO BRANCO,0503,55560.06,46787,3533,2998,2365,2111,2193,4304,6669,9667,13200,84.21,23.76,17.4,12.0
06-05-2021,CRATO,0,0,0,"[0,120]",Baixo a Moderado,,,,0,Alentejo,PORTALEGRE,1206,39806.88,3129,229,258,163,182,228,410,573,831,1060,7.86,2.66,2.09,1.44
06-05-2021,CUBA,0,0,0,"[0,120]",Baixo a Moderado,,,,0,Alentejo,BEJA,0207,17208.72,4595,255,233,206,190,143,333,539,772,1027,26.7,5.97,4.49,3.13
06-05-2021,ELVAS,2,0,10,"[0,120]",Baixo a Moderado,,,,2,Alentejo,PORTALEGRE,1207,63128.86,20528,1057,1145,902,852,810,1662,2564,3709,4766,32.52,7.55,5.88,4.06
06-05-2021,ENTRONCAMENTO,0,0,0,"[0,120]",Baixo a Moderado,,,,0,Lisboa e Vale do Tejo,SANTARÉM,1410,1372.81,21558,1066,930,868,695,592,1287,2155,3085,4151,1570.14,302.33,224.69,156.96
06-05-2021,ESPINHO,19,1,64,"[0,120]",Baixo a Moderado,,,,19,Norte,AVEIRO,0107,2105.68,29516,2205,1993,1430,1177,960,2137,3567,5560,7765,1401.52,368.71,264.01,169.37
06-05-2021,ESPOSENDE,12,1,35,"[0,120]",Baixo a Moderado,,,,12,Norte,BRAGA,0306,9540.98,34177,1831,1522,1095,894,723,1617,2712,4234,6065,358.21,63.57,44.38,28.42
06-05-2021,ESTARREJA,3,0,12,"[0,120]",Baixo a Moderado,,,,3,Centro,AVEIRO,0108,10817.33,26006,1503,1399,1106,953,728,1681,2787,4186,5689,240.42,52.59,38.7,25.76
06-05-2021,ESTREMOZ,1,0,8,"[0,120]",Baixo a Moderado,,,,1,Alentejo,ÉVORA,0704,51379.95,12728,789,613,697,786,877,1663,2360,2973,3762,24.77,7.32,5.79,4.59
06-05-2021,ÉVORA,12,1,23,"[0,120]",Baixo a Moderado,,,,12,Alentejo,ÉVORA,0705,130707.58,52428,3569,2852,2176,1966,1803,3769,5945,8797,12366,40.11,9.46,6.73,4.55
06-05-2021,FAFE,77,5,160,"[120,240]",Moderado,,,,77,Norte,BRAGA,0307,21908.11,48060,3044,2455,1679,1403,1208,2611,4290,6745,9789,219.37,44.68,30.79,19.58
06-05-2021,FARO,28,2,46,"[0,120]",Baixo a Moderado,,,,28,Algarve,FARO,0805,20256.79,61015,3847,3364,2604,2055,1601,3656,6260,9624,13471,301.2,66.5,47.51,30.9
06-05-2021,FELGUEIRAS,21,1,37,"[0,120]",Baixo a Moderado,,,,21,Norte,PORTO,1303,11573.75,56422,2951,2302,1601,1316,973,2289,3890,6192,9143,487.49,79.0,53.5,33.61
06-05-2021,FERREIRA DO ALENTEJO,5,0,64,"[0,120]",Baixo a Moderado,,,,5,Alentejo,BEJA,0208,64820.68,7845,515,414,372,343,345,688,1060,1474,1989,12.1,3.07,2.27,1.64
06-05-2021,FERREIRA DO ZÊZERE,2,0,25,"[0,120]",Baixo a Moderado,,,,2,Lisboa e Vale do Tejo,SANTARÉM,1411,19038.03,7959,470,370,416,465,456,921,1337,1707,2177,41.81,11.44,8.97,7.02
06-05-2021,FIGUEIRA DA FOZ,53,4,90,"[0,120]",Baixo a Moderado,,,,53,Centro,COIMBRA,0605,37905.26,58747,4032,3597,2887,2495,2043,4538,7425,11022,15054,154.98,39.72,29.08,19.59
06-05-2021,FIGUEIRA DE CASTELO RODRIGO,0,0,0,"[0,120]",Baixo a Moderado,,,,0,Centro,GUARDA,0904,50857.46,5584,347,352,290,352,391,743,1033,1385,1732,10.98,3.41,2.72,2.03
06-05-2021,FIGUEIRÓ DOS VINHOS,7,1,126,"[120,240]",Moderado,,,,7,Centro,LEIRIA,1008,17344.0,5568,402,386,322,309,351,660,982,1368,1770,32.1,10.21,7.89,5.66
06-05-2021,FORNOS DE ALGODRES,7,1,155,"[120,240]",Moderado,,,,7,Centro,GUARDA,0905,13145.05,4528,261,218,247,256,232,488,735,953,1214,34.45,9.24,7.25,5.59
06-05-2021,FREIXO DE ESPADA À CINTA,0,0,0,"[0,120]",Baixo a Moderado,,,,0,Norte,BRAGANÇA,0404,24414.29,3298,211,177,231,196,189,385,616,793,1004,13.51,4.11,3.25,2.52
06-05-2021,FRONTEIRA,0,0,0,"[0,120]",Baixo a Moderado,,,,0,Alentejo,PORTALEGRE,1208,24859.58,2974,213,182,149,156,168,324,473,655,868,11.96,3.49,2.63,1.9
06-05-2021,FUNCHAL,151,11,145,"[120,240]",Moderado,,,,151,Madeira,MADEIRA,3103,7616.2,104024,6382,5086,3643,2821,1990,4811,8454,13540,19922,1365.86,261.58,177.78,111.0
06-05-2021,FUNDÃO,4,0,15,"[0,120]",Baixo a Moderado,,,,4,Centro,CASTELO BRANCO,0504,70019.79,26495,1781,1464,1432,1357,1643,3000,4432,5896,7677,37.84,10.96,8.42,6.33
06-05-2021,GAVIÃO,0,0,0,"[0,120]",Baixo a Moderado,,,,0,Alentejo,PORTALEGRE,1209,29459.45,3263,189,186,222,263,293,556,778,964,1153,11.08,3.91,3.27,2.64
06-05-2021,GÓIS,0,0,0,"[0,120]",Baixo a Moderado,,,,0,Centro,COIMBRA,0606,26330.19,3805,235,199,240,233,244,477,717,916,1151,14.45,4.37,3.48,2.72
06-05-2021,GOLEGÃ,9,1,169,"[120,240]",Moderado,,,,9,Lisboa e Vale do Tejo,SANTARÉM,1412,8431.67,5339,356,299,281,243,255,498,779,1078,1434,63.32,17.01,12.78,9.24
06-05-2021,GONDOMAR,115,8,69,"[0,120]",Baixo a Moderado,,,,115,Norte,PORTO,1304,13191.76,165985,10555,8755,6222,4450,3364,7814,14036,22791,33346,1258.22,252.77,172.76,106.4
06-05-2021,GOUVEIA,0,0,0,"[0,120]",Baixo a Moderado,,,,0,Centro,GUARDA,0906,30061.17,12387,871,931,780,783,810,1593,2373,3304,4175,41.21,13.89,10.99,7.89
06-05-2021,GRÂNDOLA,2,0,14,"[0,120]",Baixo a Moderado,,,,2,Alentejo,SETÚBAL,1505,82593.66,14639,834,834,708,688,672,1360,2068,2902,3736,17.72,4.52,3.51,2.5
06-05-2021,GUARDA,8,1,21,"[0,120]",Baixo a Moderado,,,,8,Centro,GUARDA,0907,71209.58,38969,2477,2041,1686,1415,1474,2889,4575,6616,9093,54.72,12.77,9.29,6.42
06-05-2021,GUIMARÃES,96,7,63,"[0,120]",Baixo a Moderado,,,,96,Norte,BRAGA,0308,24099.96,152309,9394,7074,4809,3877,2948,6825,11634,18708,28102,631.99,116.61,77.63,48.27
06-05-2021,HORTA,0,0,0,"[0,120]",Baixo a Moderado,,,,0,Açores,AÇORES,4701,17305.53,14521,818,658,468,352,302,654,1122,1780,2598,83.91,15.01,10.29,6.48
06-05-2021,IDANHA-A-NOVA,0,0,0,"[0,120]",Baixo a Moderado,,,,0,Centro,CASTELO BRANCO,0505,141633.51,8043,518,490,519,672,974,1646,2165,2655,3173,5.68,2.24,1.87,1.53
06-05-2021,ÍLHAVO,8,1,21,"[0,120]",Baixo a Moderado,,,,8,Centro,AVEIRO,0110,7347.55,38699,2227,1943,1444,1193,850,2043,3487,5430,7657,526.66,104.21,73.9,47.46
06-05-2021,LAGOA (FARO),6,0,26,"[0,120]",Baixo a Moderado,,,,6,Algarve,FARO,0806,8825.45,22762,1314,1168,919,749,670,1419,2338,3506,4820,257.93,54.62,39.73,26.49
06-05-2021,LAGOA,35,3,238,"[120,240]",Moderado,,,,35,Açores,AÇORES,4201,4559.32,14721,536,458,349,238,235,473,822,1280,1816,322.9,39.83,28.08,18.03
06-05-2021,LAGOS,44,3,145,"[120,240]",Moderado,,,,44,Algarve,FARO,0807,21299.27,30374,1744,1434,1247,1053,1029,2082,3329,4763,6507,142.61,30.55,22.36,15.63
06-05-2021,LAJES DAS FLORES,4,0,273,"[240,480]",Elevado,,,,4,Açores,AÇORES,4801,7004.79,1463,88,53,62,46,54,100,162,215,303,20.89,4.33,3.07,2.31
06-05-2021,LAJES DO PICO,0,0,0,"[0,120]",Baixo a Moderado,,,,0,Açores,AÇORES,4601,15531.09,4490,304,231,223,159,162,321,544,775,1079,28.91,6.95,4.99,3.5
06-05-2021,LAMEGO,70,5,281,"[240,480]",Elevado,,,,70,Norte,VISEU,1805,16542.11,24895,1639,1284,1124,898,783,1681,2805,4089,5728,150.5,34.63,24.72,16.96
06-05-2021,LEIRIA,38,3,30,"[0,120]",Baixo a Moderado,,,,38,Centro,LEIRIA,1009,56508.83,125267,7389,6366,5090,3902,3159,7061,12151,18517,25906,221.68,45.84,32.77,21.5
06-05-2021,LISBOA,341,24,67,"[0,120]",Baixo a Moderado,,,,341,Lisboa e Vale do Tejo,LISBOA,1106,10005.43,509515,33197,33340,27706,23037,26770,49807,77513,110853,144050,5092.6,1439.78,1107.98,774.74
06-05-2021,LOULÉ,42,3,61,"[0,120]",Baixo a Moderado,,,,42,Algarve,FARO,0808,76366.91,68697,3890,3350,2780,2358,2251,4609,7389,10739,14629,89.96,19.16,14.06,9.68
06-05-2021,LOURES,53,4,25,"[0,120]",Baixo a Moderado,,,,53,Lisboa e Vale do Tejo,LISBOA,1107,16723.99,213687,12746,12794,9644,6669,5033,11702,21346,34140,46886,1277.73,280.35,204.14,127.64
06-05-2021,LOURINHÃ,7,0,27,"[0,120]",Baixo a Moderado,,,,7,Lisboa e Vale do Tejo,LISBOA,1108,14717.2,25855,1584,1243,992,842,645,1487,2479,3722,5306,175.68,36.05,25.29,16.84
06-05-2021,LOUSÃ,8,1,47,"[0,120]",Baixo a Moderado,,,,8,Centro,COIMBRA,0607,13840.01,17158,946,866,658,528,450,978,1636,2502,3448,123.97,24.91,18.08,11.82
06-05-2021,LOUSADA,24,2,51,"[0,120]",Baixo a Moderado,,,,24,Norte,PORTO,1305,9608.01,46755,2289,1698,1176,853,621,1474,2650,4348,6637,486.63,69.08,45.25,27.58
06-05-2021,MAÇÃO,0,0,0,"[0,120]",Baixo a Moderado,,,,0,Lisboa e Vale do Tejo,SANTARÉM,1413,39997.98,6267,386,362,390,440,657,1097,1487,1849,2235,15.67,5.59,4.62,3.72
06-05-2021,MACEDO DE CAVALEIROS,2,0,14,"[0,120]",Baixo a Moderado,,,,2,Norte,BRAGANÇA,0405,69914.08,14516,1082,889,878,823,938,1761,2639,3528,4610,20.76,6.59,5.05,3.77
06-05-2021,MACHICO,32,2,160,"[120,240]",Moderado,,,,32,Madeira,MADEIRA,3104,6825.1,19981,1197,860,662,455,331,786,1448,2308,3505,292.76,51.36,33.82,21.22
06-05-2021,MADALENA,0,0,0,"[0,120]",Baixo a Moderado,,,,0,Açores,AÇORES,4602,14712.33,5895,334,256,173,190,179,369,542,798,1132,40.07,7.69,5.42,3.68
06-05-2021,MAFRA,52,4,61,"[0,120]",Baixo a Moderado,,,,52,Lisboa e Vale do Tejo,LISBOA,1109,29165.5,84816,3613,3334,2839,2089,1899,3988,6827,10161,13774,290.81,47.23,34.84,23.41
06-05-2021,MAIA,44,3,32,"[0,120]",Baixo a Moderado,,,,44,Norte,PORTO,1306,8293.94,138971,7801,6617,4512,3339,2631,5970,10482,17099,24900,1675.56,300.22,206.16,126.38
06-05-2021,MANGUALDE,1,0,5,"[0,120]",Baixo a Moderado,,,,1,Centro,VISEU,1806,21925.56,18510,1198,1128,885,852,743,1595,2480,3608,4806,84.42,21.92,16.46,11.31
06-05-2021,MANTEIGAS,0,0,0,"[0,120]",Baixo a Moderado,,,,0,Centro,GUARDA,0908,12197.55,3007,258,197,159,167,146,313,472,669,927,24.65,7.6,5.48,3.87
06-05-2021,MARCO DE CANAVESES,43,3,84,"[0,120]",Baixo a Moderado,,,,43,Norte,PORTO,1307,20188.98,51496,2678,2060,1488,1265,1023,2288,3776,5836,8514,255.07,42.17,28.91,18.7
06-05-2021,MARINHA GRANDE,12,1,31,"[0,120]",Baixo a Moderado,,,,12,Centro,LEIRIA,1010,18725.19,38508,2365,2302,1638,1359,1058,2417,4055,6357,8722,205.65,46.58,33.95,21.66
06-05-2021,MARVÃO,0,0,0,"[0,120]",Baixo a Moderado,,,,0,Alentejo,PORTALEGRE,1210,15489.9,3005,198,185,142,197,237,434,576,761,959,19.4,6.19,4.91,3.72
06-05-2021,MATOSINHOS,74,5,42,"[0,120]",Baixo a Moderado,,,,74,Norte,PORTO,1308,6241.97,175357,11850,9977,7023,5024,3884,8908,15931,25908,37758,2809.31,604.9,415.06,255.22
06-05-2021,MEALHADA,0,0,0,"[0,120]",Baixo a Moderado,,,,0,Centro,AVEIRO,0111,11065.66,19914,1163,1039,810,828,831,1659,2469,3508,4671,179.96,42.21,31.7,22.31
06-05-2021,MÊDA,1,0,22,"[0,120]",Baixo a Moderado,,,,1,Centro,GUARDA,0909,28604.92,4587,343,306,290,288,443,731,1021,1327,1670,16.04,5.84,4.64,3.57
06-05-2021,MELGAÇO,10,1,124,"[120,240]",Moderado,,,,10,Norte,VIANA DO CASTELO,1603,23824.58,8093,507,567,578,614,675,1289,1867,2434,2941,33.97,12.34,10.22,7.84
06-05-2021,MÉRTOLA,0,0,0,"[0,120]",Baixo a Moderado,,,,0,Alentejo,BEJA,0209,129287.34,6142,400,390,378,423,600,1023,1401,1791,2191,4.75,1.69,1.39,1.08
06-05-2021,MESÃO FRIO,3,0,76,"[0,120]",Baixo a Moderado,,,,3,Norte,VILA REAL,1704,2664.87,3964,265,205,168,157,120,277,445,650,915,148.74,34.33,24.39,16.7
06-05-2021,MIRA,7,0,59,"[0,120]",Baixo a Moderado,,,,7,Centro,COIMBRA,0608,12403.38,11832,727,729,659,550,466,1016,1675,2404,3131,95.4,25.24,19.38,13.5
06-05-2021,MIRANDA DO CORVO,5,0,39,"[0,120]",Baixo a Moderado,,,,5,Centro,COIMBRA,0609,12637.79,12708,706,659,568,498,404,902,1470,2129,2835,100.55,22.43,16.85,11.63
06-05-2021,MIRANDA DO DOURO,6,0,88,"[0,120]",Baixo a Moderado,,,,6,Norte,BRAGANÇA,0406,48718.31,6830,482,429,442,463,470,933,1375,1804,2286,14.02,4.69,3.7,2.82
06-05-2021,MIRANDELA,2,0,9,"[0,120]",Baixo a Moderado,,,,2,Norte,BRAGANÇA,0407,65895.67,21754,1640,1315,1204,1078,947,2025,3229,4544,6184,33.01,9.38,6.9,4.9
06-05-2021,MOGADOURO,3,0,36,"[0,120]",Baixo a Moderado,,,,3,Norte,BRAGANÇA,0408,76064.93,8392,589,529,576,630,655,1285,1861,2390,2979,11.03,3.92,3.14,2.45
06-05-2021,MOIMENTA DA BEIRA,10,1,103,"[0,120]",Baixo a Moderado,,,,10,Norte,VISEU,1807,21996.9,9736,576,514,471,416,461,877,1348,1862,2438,44.26,11.08,8.46,6.13
06-05-2021,MOITA,15,1,23,"[0,120]",Baixo a Moderado,,,,15,Lisboa e Vale do Tejo,SETÚBAL,1506,5525.98,64407,4226,3646,2623,1801,1425,3226,5849,9495,13721,1165.53,248.3,171.82,105.85
06-05-2021,MONÇÃO,8,1,45,"[0,120]",Baixo a Moderado,,,,8,Norte,VIANA DO CASTELO,1604,21130.85,17869,1161,1105,1031,1006,972,1978,3009,4114,5275,84.56,24.96,19.47,14.24
06-05-2021,MONCHIQUE,0,0,0,"[0,120]",Baixo a Moderado,,,,0,Algarve,FARO,0809,39530.43,5077,353,384,321,355,392,747,1068,1452,1805,12.84,4.57,3.67,2.7
06-05-2021,MONDIM DE BASTO,2,0,29,"[0,120]",Baixo a Moderado,,,,2,Norte,VILA REAL,1705,17207.52,6946,395,300,314,284,283,567,881,1181,1576,40.36,9.16,6.86,5.12
06-05-2021,MONFORTE,0,0,0,"[0,120]",Baixo a Moderado,,,,0,Alentejo,PORTALEGRE,1211,42024.82,2975,139,115,117,192,168,360,477,592,731,7.08,1.74,1.41,1.14
06-05-2021,MONTALEGRE,6,0,67,"[0,120]",Baixo a Moderado,,,,6,Norte,VILA REAL,1706,80545.71,8997,699,628,595,603,730,1333,1928,2556,3255,11.17,4.04,3.17,2.39
06-05-2021,MONTEMOR-O-NOVO,0,0,0,"[0,120]",Baixo a Moderado,,,,0,Alentejo,ÉVORA,0706,123296.65,15647,991,953,868,878,971,1849,2717,3670,4661,12.69,3.78,2.98,2.2
06-05-2021,MONTEMOR-O-VELHO,4,0,16,"[0,120]",Baixo a Moderado,,,,4,Centro,COIMBRA,0610,22896.23,25224,1496,1397,1217,1057,988,2045,3262,4659,6155,110.17,26.88,20.35,14.25
06-05-2021,MONTIJO,52,4,90,"[0,120]",Baixo a Moderado,,,,52,Lisboa e Vale do Tejo,SETÚBAL,1507,34861.64,57614,2771,2441,1990,1554,1109,2663,4653,7094,9865,165.26,28.3,20.35,13.35
06-05-2021,MORA,0,0,0,"[0,120]",Baixo a Moderado,,,,0,Alentejo,ÉVORA,0707,44395.02,4138,336,275,252,238,257,495,747,1022,1358,9.32,3.06,2.3,1.68
06-05-2021,MORTÁGUA,1,0,11,"[0,120]",Baixo a Moderado,,,,1,Centro,VISEU,1808,25117.82,8803,638,584,535,499,460,959,1494,2078,2716,35.05,10.81,8.27,5.95
06-05-2021,MOURA,2,0,15,"[0,120]",Baixo a Moderado,,,,2,Alentejo,BEJA,0210,95845.55,13718,817,656,665,542,461,1003,1668,2324,3141,14.31,3.28,2.42,1.74
06-05-2021,MOURÃO,0,0,0,"[0,120]",Baixo a Moderado,,,,0,Alentejo,ÉVORA,0708,27862.98,2450,139,108,80,104,109,213,293,401,540,8.79,1.94,1.44,1.05
06-05-2021,MURÇA,1,0,18,"[0,120]",Baixo a Moderado,,,,1,Norte,VILA REAL,1707,18937.11,5463,384,341,307,306,319,625,932,1273,1657,28.85,8.75,6.72,4.92
06-05-2021,MURTOSA,1,0,10,"[0,120]",Baixo a Moderado,,,,1,Centro,AVEIRO,0112,7308.78,10279,509,473,403,353,409,762,1165,1638,2147,140.63,29.37,22.41,15.94
06-05-2021,NAZARÉ,3,0,21,"[0,120]",Baixo a Moderado,,,,3,Lisboa e Vale do Tejo,LEIRIA,1011,8243.43,14165,967,903,670,420,396,816,1486,2389,3356,171.84,40.71,28.98,18.03
06-05-2021,NELAS,6,0,46,"[0,120]",Baixo a Moderado,,,,6,Centro,VISEU,1809,12571.48,12974,924,787,668,604,583,1187,1855,2642,3566,103.21,28.37,21.02,14.76
06-05-2021,NISA,0,0,0,"[0,120]",Baixo a Moderado,,,,0,Alentejo,PORTALEGRE,1212,57567.84,6061,405,389,355,483,478,961,1316,1705,2110,10.53,3.67,2.96,2.29
06-05-2021,NORDESTE,6,0,123,"[120,240]",Moderado,,,,6,Açores,AÇORES,4202,10146.8,4862,246,180,124,161,162,323,447,627,873,47.92,8.6,6.18,4.41
06-05-2021,ÓBIDOS,4,0,34,"[0,120]",Baixo a Moderado,,,,4,Lisboa e Vale do Tejo,LEIRIA,1012,14155.44,11850,743,650,574,452,436,888,1462,2112,2855,83.72,20.17,14.92,10.33
06-05-2021,ODEMIRA,56,4,227,"[120,240]",Moderado,,,,56,Alentejo,BEJA,0211,172060.15,24717,1475,1317,1225,1397,1349,2746,3971,5288,6763,14.37,3.93,3.07,2.31
06-05-2021,ODIVELAS,79,6,49,"[0,120]",Baixo a Moderado,,,,79,Lisboa e Vale do Tejo,LISBOA,1116,2654.36,161774,9562,9038,6952,4641,3812,8453,15405,24443,34005,6095.48,1281.27,920.99,580.44
06-05-2021,OEIRAS,108,8,61,"[0,120]",Baixo a Moderado,,,,108,Lisboa e Vale do Tejo,LISBOA,1110,4588.31,177408,11580,11575,8566,6211,5855,12066,20632,32207,43787,3866.78,954.38,701.98,449.69
06-05-2021,OLEIROS,0,0,0,"[0,120]",Baixo a Moderado,,,,0,Centro,CASTELO BRANCO,0506,47109.31,5003,384,341,366,397,487,884,1250,1591,1975,10.62,4.19,3.38,2.65
06-05-2021,OLHÃO,30,2,68,"[0,120]",Baixo a Moderado,,,,30,Algarve,FARO,0810,13086.38,44405,2455,2309,1689,1342,1268,2610,4299,6608,9063,339.33,69.26,50.5,32.85
06-05-2021,OLIVEIRA DE AZEMÉIS,49,3,74,"[0,120]",Baixo a Moderado,,,,49,Norte,AVEIRO,0113,16110.41,66011,4155,3614,2794,2183,1738,3921,6715,10329,14484,409.75,89.91,64.12,41.68
06-05-2021,OLIVEIRA DE FRADES,2,0,20,"[0,120]",Baixo a Moderado,,,,2,Centro,VISEU,1810,14534.62,9936,553,475,438,359,415,774,1212,1687,2240,68.36,15.41,11.61,8.34
06-05-2021,OLIVEIRA DO BAIRRO,4,0,16,"[0,120]",Baixo a Moderado,,,,4,Centro,AVEIRO,0114,8731.99,24277,1327,1182,999,786,810,1596,2595,3777,5104,278.02,58.45,43.25,29.72
06-05-2021,OLIVEIRA DO HOSPITAL,54,4,280,"[240,480]",Elevado,,,,54,Centro,COIMBRA,0611,23451.66,19253,1161,1097,962,924,960,1884,2846,3943,5104,82.1,21.76,16.81,12.14
06-05-2021,OURÉM,14,1,32,"[0,120]",Baixo a Moderado,,,,14,Lisboa e Vale do Tejo,SANTARÉM,1421,41668.03,44044,2463,2069,1899,1817,1603,3420,5319,7388,9851,105.7,23.64,17.73,12.77
06-05-2021,OURIQUE,0,0,0,"[0,120]",Baixo a Moderado,,,,0,Alentejo,BEJA,0212,66331.36,4607,313,287,284,268,227,495,779,1066,1379,6.95,2.08,1.61,1.17
06-05-2021,OVAR,12,1,22,"[0,120]",Baixo a Moderado,,,,12,Centro,AVEIRO,0115,14770.25,54260,3294,2709,1994,1636,1234,2870,4864,7573,10867,367.37,73.57,51.27,32.93
06-05-2021,PAÇOS DE FERREIRA,88,6,155,"[120,240]",Moderado,,,,88,Norte,PORTO,1309,7099.29,56728,2903,2193,1518,1135,664,1799,3317,5510,8413,799.1,118.51,77.62,46.72
06-05-2021,PALMELA,6,0,9,"[0,120]",Baixo a Moderado,,,,6,Lisboa e Vale do Tejo,SETÚBAL,1508,46512.01,64269,3402,3244,2635,1846,1391,3237,5872,9116,12518,138.18,26.91,19.6,12.62
06-05-2021,PAMPILHOSA DA SERRA,2,0,50,"[0,120]",Baixo a Moderado,,,,2,Centro,COIMBRA,0612,39646.24,4037,238,254,295,339,423,762,1057,1311,1549,10.18,3.91,3.31,2.67
06-05-2021,PAREDES,195,14,227,"[120,240]",Moderado,,,,195,Norte,PORTO,1310,15675.69,86067,4272,3532,2412,1717,1258,2975,5387,8919,13191,549.04,84.15,56.9,34.36
06-05-2021,PAREDES DE COURA,4,0,47,"[0,120]",Baixo a Moderado,,,,4,Norte,VIANA DO CASTELO,1605,13818.59,8535,466,528,407,465,515,980,1387,1915,2381,61.76,17.23,13.86,10.04
06-05-2021,PEDRÓGÃO GRANDE,2,0,59,"[0,120]",Baixo a Moderado,,,,2,Centro,LEIRIA,1013,12874.75,3410,175,173,196,221,252,473,669,842,1017,26.49,7.9,6.54,5.2
06-05-2021,PENACOVA,0,0,0,"[0,120]",Baixo a Moderado,,,,0,Centro,COIMBRA,0613,21673.23,13694,968,923,745,621,703,1324,2069,2992,3960,63.18,18.27,13.81,9.55
06-05-2021,PENAFIEL,94,7,135,"[120,240]",Moderado,,,,94,Norte,PORTO,1311,21224.27,69772,3648,2823,2032,1663,1230,2893,4925,7748,11396,328.74,53.69,36.51,23.2
06-05-2021,PENALVA DO CASTELO,0,0,0,"[0,120]",Baixo a Moderado,,,,0,Centro,VISEU,1811,13433.92,7115,449,457,413,391,426,817,1230,1687,2136,52.96,15.9,12.56,9.16
06-05-2021,PENAMACOR,0,0,0,"[0,120]",Baixo a Moderado,,,,0,Centro,CASTELO BRANCO,0507,56370.69,4755,262,248,273,451,633,1084,1357,1605,1867,8.44,3.31,2.85,2.41
06-05-2021,PENEDONO,1,0,39,"[0,120]",Baixo a Moderado,,,,1,Norte,VISEU,1812,13370.75,2591,172,113,129,156,138,294,423,536,708,19.38,5.3,4.01,3.16
06-05-2021,PENELA,0,0,0,"[0,120]",Baixo a Moderado,,,,0,Centro,COIMBRA,0614,13480.0,5397,314,324,274,359,344,703,977,1301,1615,40.04,11.98,9.65,7.25
06-05-2021,PENICHE,40,3,151,"[120,240]",Moderado,,,,40,Lisboa e Vale do Tejo,LEIRIA,1014,7754.98,26501,1746,1504,1203,926,707,1633,2836,4340,6086,341.73,78.48,55.96,36.57
06-05-2021,PESO DA RÉGUA,12,1,76,"[0,120]",Baixo a Moderado,,,,12,Norte,VILA REAL,1708,9486.01,15773,1076,843,650,659,455,1114,1764,2607,3683,166.28,38.83,27.48,18.6
06-05-2021,PINHEL,2,0,23,"[0,120]",Baixo a Moderado,,,,2,Centro,GUARDA,0910,48452.12,8511,577,566,551,538,689,1227,1778,2344,2921,17.57,6.03,4.84,3.67
06-05-2021,POMBAL,16,1,31,"[0,120]",Baixo a Moderado,,,,16,Centro,LEIRIA,1015,62600.28,51461,3187,2791,2494,2328,2027,4355,6849,9640,12827,82.21,20.49,15.4,10.94
06-05-2021,PONTA DELGADA,76,5,112,"[0,120]",Baixo a Moderado,,,,76,Açores,AÇORES,4203,23298.65,67935,3108,2435,1726,1133,902,2035,3761,6196,9304,291.58,39.93,26.59,16.14
06-05-2021,PONTA DO SOL,6,0,70,"[0,120]",Baixo a Moderado,,,,6,Madeira,MADEIRA,3105,4622.03,8593,319,283,347,208,221,429,776,1059,1378,185.92,29.81,22.91,16.79
06-05-2021,PONTE DA BARCA,14,1,125,"[120,240]",Moderado,,,,14,Norte,VIANA DO CASTELO,1606,18211.37,11180,635,576,517,554,490,1044,1561,2137,2772,61.39,15.22,11.73,8.57
06-05-2021,PONTE DE LIMA,50,4,121,"[120,240]",Moderado,,,,50,Norte,VIANA DO CASTELO,1607,32025.46,41315,2321,2022,1720,1596,1462,3058,4778,6800,9121,129.01,28.48,21.23,14.92
06-05-2021,PONTE DE SOR,0,0,0,"[0,120]",Baixo a Moderado,,,,0,Alentejo,PORTALEGRE,1213,83971.16,14994,939,800,716,739,831,1570,2286,3086,4025,17.86,4.79,3.68,2.72
06-05-2021,PORTALEGRE,0,0,0,"[0,120]",Baixo a Moderado,,,,0,Alentejo,PORTALEGRE,1214,44713.64,22172,1577,1351,1137,993,984,1977,3114,4465,6042,49.59,13.51,9.99,6.96
06-05-2021,PORTEL,0,0,0,"[0,120]",Baixo a Moderado,,,,0,Alentejo,ÉVORA,0709,60100.57,5828,336,358,283,331,305,636,919,1277,1613,9.7,2.68,2.12,1.53
06-05-2021,PORTIMÃO,31,2,56,"[0,120]",Baixo a Moderado,,,,31,Algarve,FARO,0811,18206.29,55483,3182,2927,2116,1582,1400,2982,5098,8025,11207,304.75,61.56,44.08,28.0
06-05-2021,PORTO,119,9,55,"[0,120]",Baixo a Moderado,,,,119,Norte,PORTO,1312,4142.02,216606,15790,15193,11280,9409,10044,19453,30733,45926,61716,5229.5,1490.0,1108.79,741.98
06-05-2021,PORTO DE MÓS,12,1,52,"[0,120]",Baixo a Moderado,,,,12,Centro,LEIRIA,1016,26183.41,23275,1355,1210,1034,888,872,1760,2794,4004,5359,88.89,20.47,15.29,10.67
06-05-2021,PORTO MONIZ,1,0,43,"[0,120]",Baixo a Moderado,,,,1,Madeira,MADEIRA,3106,8293.38,2342,143,130,95,98,120,218,313,443,586,28.24,7.07,5.34,3.77
06-05-2021,PORTO SANTO,0,0,0,"[0,120]",Baixo a Moderado,,,,0,Madeira,MADEIRA,3201,4300.7,5202,240,157,134,110,68,178,312,469,709,120.95,16.48,10.9,7.25
06-05-2021,PÓVOA DE LANHOSO,16,1,74,"[0,120]",Baixo a Moderado,,,,16,Norte,BRAGA,0309,13465.29,21499,1175,909,732,673,624,1297,2029,2938,4113,159.67,30.55,21.82,15.07
06-05-2021,PÓVOA DE VARZIM,24,2,38,"[0,120]",Baixo a Moderado,,,,24,Norte,PORTO,1313,8220.59,62784,3712,3120,2134,1594,1305,2899,5033,8153,11865,763.7,144.33,99.17,61.22
06-05-2021,POVOAÇÃO,4,0,67,"[0,120]",Baixo a Moderado,,,,4,Açores,AÇORES,4204,10640.77,5927,293,212,191,144,134,278,469,681,974,55.7,9.15,6.4,4.41
06-05-2021,VILA DA PRAIA DA VITÓRIA,0,0,0,"[0,120]",Baixo a Moderado,,,,0,Açores,AÇORES,4302,16127.06,21317,1133,789,619,436,336,772,1391,2180,3313,132.18,20.54,13.52,8.63
06-05-2021,PROENÇA-A-NOVA,0,0,0,"[0,120]",Baixo a Moderado,,,,0,Centro,CASTELO BRANCO,0508,39539.96,7298,508,465,389,400,560,960,1349,1814,2322,18.46,5.87,4.59,3.41
06-05-2021,REDONDO,0,0,0,"[0,120]",Baixo a Moderado,,,,0,Alentejo,ÉVORA,0710,36950.87,6353,349,325,288,288,354,642,930,1255,1604,17.19,4.34,3.4,2.52
06-05-2021,REGUENGOS DE MONSARAZ,0,0,0,"[0,120]",Baixo a Moderado,,,,0,Alentejo,ÉVORA,0711,46399.72,10015,602,511,455,462,473,935,1390,1901,2503,21.58,5.39,4.1,3.0
06-05-2021,RESENDE,24,2,237,"[120,240]",Moderado,,,,24,Norte,VISEU,1813,12334.93,10137,560,493,448,433,422,855,1303,1796,2356,82.18,19.1,14.56,10.56
06-05-2021,RIBEIRA BRAVA,5,0,40,"[0,120]",Baixo a Moderado,,,,5,Madeira,MADEIRA,3107,6544.88,12435,648,500,411,311,287,598,1009,1509,2157,189.99,32.96,23.06,15.42
06-05-2021,RIBEIRA DE PENA,0,0,0,"[0,120]",Baixo a Moderado,,,,0,Norte,VILA REAL,1709,21745.98,6016,371,301,290,310,368,678,968,1269,1640,27.66,7.54,5.84,4.45
06-05-2021,RIBEIRA GRANDE,71,5,216,"[120,240]",Moderado,,,,71,Açores,AÇORES,4205,18015.13,32811,1163,689,512,345,253,598,1110,1799,2962,182.13,16.44,9.99,6.16
06-05-2021,RIO MAIOR,8,1,39,"[0,120]",Baixo a Moderado,,,,8,Lisboa e Vale do Tejo,SANTARÉM,1414,27276.45,20379,1251,1144,941,795,648,1443,2384,3528,4779,74.71,17.52,12.93,8.74
06-05-2021,SABROSA,1,0,17,"[0,120]",Baixo a Moderado,,,,1,Norte,VILA REAL,1710,15692.45,5918,393,314,304,302,350,652,956,1270,1663,37.71,10.6,8.09,6.09
06-05-2021,SABUGAL,0,0,0,"[0,120]",Baixo a Moderado,,,,0,Centro,GUARDA,0911,82269.82,10585,724,707,694,796,1009,1805,2499,3206,3930,12.87,4.78,3.9,3.04
06-05-2021,SALVATERRA DE MAGOS,2,0,9,"[0,120]",Baixo a Moderado,,,,2,Lisboa e Vale do Tejo,SANTARÉM,1415,24393.2,21295,1275,1181,1060,799,772,1571,2631,3812,5087,87.3,20.85,15.63,10.79
06-05-2021,SANTA COMBA DÃO,17,1,163,"[120,240]",Moderado,,,,17,Centro,VISEU,1814,11194.77,10452,732,684,569,538,464,1002,1571,2255,2987,93.36,26.68,20.14,14.03
06-05-2021,SANTA CRUZ,56,4,124,"[120,240]",Moderado,,,,56,Madeira,MADEIRA,3108,8150.28,45281,1817,1301,974,716,523,1239,2213,3514,5331,555.6,65.41,43.12,27.15
06-05-2021,SANTA CRUZ DA GRACIOSA,0,0,0,"[0,120]",Baixo a Moderado,,,,0,Açores,AÇORES,4401,6065.78,4208,228,180,163,124,145,269,432,612,840,69.37,13.85,10.09,7.12
06-05-2021,SANTA CRUZ DAS FLORES,1,0,46,"[0,120]",Baixo a Moderado,,,,1,Açores,AÇORES,4802,7091.44,2165,125,98,74,56,51,107,181,279,404,30.53,5.7,3.93,2.55
06-05-2021,SANTA MARIA DA FEIRA,47,3,34,"[0,120]",Baixo a Moderado,,,,47,Norte,AVEIRO,0109,21587.65,138636,8182,6743,4771,3856,3079,6935,11706,18449,26631,642.19,123.36,85.46,54.22
06-05-2021,SANTA MARTA DE PENAGUIÃO,1,0,15,"[0,120]",Baixo a Moderado,,,,1,Norte,VILA REAL,1711,6928.13,6599,483,373,337,316,317,633,970,1343,1826,95.25,26.36,19.39,14.0
06-05-2021,SANTANA,2,0,30,"[0,120]",Baixo a Moderado,,,,2,Madeira,MADEIRA,3109,9547.3,6711,418,353,343,282,277,559,902,1255,1673,70.29,17.52,13.15,9.45
06-05-2021,SANTARÉM,6,0,10,"[0,120]",Baixo a Moderado,,,,6,Lisboa e Vale do Tejo,SANTARÉM,1416,55253.58,57421,3654,3441,2760,2466,2206,4672,7432,10873,14527,103.92,26.29,19.68,13.45
06-05-2021,SANTIAGO DO CACÉM,3,0,10,"[0,120]",Baixo a Moderado,,,,3,Alentejo,SETÚBAL,1509,105969.29,28791,2144,1689,1472,1295,1215,2510,3982,5671,7815,27.17,7.37,5.35,3.76
06-05-2021,SANTO TIRSO,26,2,38,"[0,120]",Baixo a Moderado,,,,26,Norte,PORTO,1314,13655.52,68055,4911,3935,2761,2257,1810,4067,6828,10763,15674,498.35,114.78,78.82,50.0
06-05-2021,SÃO BRÁS DE ALPORTEL,0,0,0,"[0,120]",Baixo a Moderado,,,,0,Algarve,FARO,0812,15336.92,10416,596,468,467,404,401,805,1272,1740,2336,67.91,15.23,11.35,8.29
06-05-2021,SÃO JOÃO DA MADEIRA,8,1,36,"[0,120]",Baixo a Moderado,,,,8,Norte,AVEIRO,0116,794.3,21958,1347,1069,796,601,593,1194,1990,3059,4406,2765.49,554.91,385.26,250.63
06-05-2021,SÃO JOÃO DA PESQUEIRA,0,0,0,"[0,120]",Baixo a Moderado,,,,0,Norte,VISEU,1815,26610.85,7125,417,330,294,328,328,656,950,1280,1697,26.77,6.38,4.81,3.57
06-05-2021,SÃO PEDRO DO SUL,4,0,26,"[0,120]",Baixo a Moderado,,,,4,Centro,VISEU,1816,34895.09,15403,990,962,861,759,909,1668,2529,3491,4481,44.14,12.84,10.0,7.25
06-05-2021,SÃO ROQUE DO PICO,0,0,0,"[0,120]",Baixo a Moderado,,,,0,Açores,AÇORES,4603,14236.1,3266,199,141,93,96,113,209,302,443,642,22.94,4.51,3.11,2.12
06-05-2021,SÃO VICENTE,0,0,0,"[0,120]",Baixo a Moderado,,,,0,Madeira,MADEIRA,3110,7883.71,5143,272,264,266,225,280,505,771,1035,1307,65.23,16.58,13.13,9.78
06-05-2021,SARDOAL,3,0,80,"[0,120]",Baixo a Moderado,,,,3,Lisboa e Vale do Tejo,SANTARÉM,1417,9214.72,3741,227,178,148,165,248,413,561,739,966,40.6,10.48,8.02,6.09
06-05-2021,SÁTÃO,1,0,9,"[0,120]",Baixo a Moderado,,,,1,Centro,VISEU,1817,20194.11,11580,765,671,515,465,476,941,1456,2127,2892,57.34,14.32,10.53,7.21
06-05-2021,SEIA,1,0,4,"[0,120]",Baixo a Moderado,,,,1,Centro,GUARDA,0912,43568.83,22234,1807,1589,1238,1122,721,1843,3081,4670,6477,51.03,14.87,10.72,7.07
06-05-2021,SEIXAL,67,5,40,"[0,120]",Baixo a Moderado,,,,67,Lisboa e Vale do Tejo,SETÚBAL,1510,9545.17,167752,10586,9270,6661,4391,2930,7321,13982,23252,33838,1757.49,354.51,243.6,146.49
06-05-2021,SERNANCELHE,1,0,19,"[0,120]",Baixo a Moderado,,,,1,Norte,VISEU,1818,22861.22,5396,305,293,286,273,260,533,819,1112,1417,23.6,6.2,4.86,3.58
06-05-2021,SERPA,7,1,49,"[0,120]",Baixo a Moderado,,,,7,Alentejo,BEJA,0213,110563.34,14304,903,761,719,697,626,1323,2042,2803,3706,12.94,3.35,2.54,1.85
06-05-2021,SERTÃ,2,0,14,"[0,120]",Baixo a Moderado,,,,2,Centro,CASTELO BRANCO,0509,44673.17,14577,870,779,790,767,1020,1787,2577,3356,4226,32.63,9.46,7.51,5.77
06-05-2021,SESIMBRA,19,1,37,"[0,120]",Baixo a Moderado,,,,19,Lisboa e Vale do Tejo,SETÚBAL,1511,19571.75,51858,2400,2321,1853,1257,1083,2340,4193,6514,8914,264.96,45.54,33.28,21.42
06-05-2021,SETÚBAL,51,4,44,"[0,120]",Baixo a Moderado,,,,51,Lisboa e Vale do Tejo,SETÚBAL,1512,23032.5,115126,7425,6929,5075,3775,2655,6430,11505,18434,25859,499.83,112.27,80.03,49.95
06-05-2021,SEVER DO VOUGA,8,1,71,"[0,120]",Baixo a Moderado,,,,8,Centro,AVEIRO,0117,12987.56,11331,766,637,568,540,567,1107,1675,2312,3078,87.24,23.7,17.8,12.9
06-05-2021,SILVES,11,1,30,"[0,120]",Baixo a Moderado,,,,11,Algarve,FARO,0813,68006.23,36226,2137,1869,1610,1423,1600,3023,4633,6502,8639,53.27,12.7,9.56,6.81
06-05-2021,SINES,1,0,7,"[0,120]",Baixo a Moderado,,,,1,Alentejo,SETÚBAL,1513,20330.17,13715,888,791,551,416,268,684,1235,2026,2914,67.46,14.33,9.97,6.07
06-05-2021,SINTRA,172,12,44,"[0,120]",Baixo a Moderado,,,,172,Lisboa e Vale do Tejo,LISBOA,1111,31922.73,391402,20490,18316,13545,9137,7284,16421,29966,48282,68772,1226.08,215.43,151.25,93.87
06-05-2021,SOBRAL DE MONTE AGRAÇO,1,0,9,"[0,120]",Baixo a Moderado,,,,1,Lisboa e Vale do Tejo,LISBOA,1112,5210.32,10651,564,507,352,272,212,484,836,1343,1907,204.43,36.6,25.78,16.05
06-05-2021,SOURE,0,0,0,"[0,120]",Baixo a Moderado,,,,0,Centro,COIMBRA,0615,26506.07,17120,1173,1142,1004,883,987,1870,2874,4016,5189,64.59,19.58,15.15,10.84
06-05-2021,SOUSEL,1,0,23,"[0,120]",Baixo a Moderado,,,,1,Alentejo,PORTALEGRE,1215,27932.18,4412,261,274,208,302,292,594,802,1076,1337,15.8,4.79,3.85,2.87
06-05-2021,TÁBUA,26,2,229,"[120,240]",Moderado,,,,26,Centro,COIMBRA,0616,19978.58,11368,729,584,524,430,464,894,1418,2002,2731,56.9,13.67,10.02,7.1
06-05-2021,TABUAÇO,5,0,83,"[0,120]",Baixo a Moderado,,,,5,Norte,VISEU,1819,13385.67,6033,372,314,217,282,363,645,862,1176,1548,45.07,11.56,8.79,6.44
06-05-2021,TAROUCA,2,0,26,"[0,120]",Baixo a Moderado,,,,2,Norte,VISEU,1820,10008.49,7804,405,335,313,277,324,601,914,1249,1654,77.98,16.53,12.48,9.13
06-05-2021,TAVIRA,15,1,61,"[0,120]",Baixo a Moderado,,,,15,Algarve,FARO,0814,60696.7,24530,1493,1415,1252,1066,1277,2343,3595,5010,6503,40.41,10.71,8.25,5.92
06-05-2021,TERRAS DE BOURO,0,0,0,"[0,120]",Baixo a Moderado,,,,0,Norte,BRAGA,0310,27746.07,6361,391,372,296,319,340,659,955,1327,1718,22.93,6.19,4.78,3.44
06-05-2021,TOMAR,7,0,19,"[0,120]",Baixo a Moderado,,,,7,Lisboa e Vale do Tejo,SANTARÉM,1418,35120.44,36748,2403,2189,1868,1853,1822,3675,5543,7732,10135,104.64,28.86,22.02,15.78
06-05-2021,TONDELA,4,0,15,"[0,120]",Baixo a Moderado,,,,4,Centro,VISEU,1821,37121.73,26357,1768,1722,1518,1475,1417,2892,4410,6132,7900,71.0,21.28,16.52,11.88
06-05-2021,TORRE DE MONCORVO,2,0,26,"[0,120]",Baixo a Moderado,,,,2,Norte,BRAGANÇA,0409,53155.67,7695,556,478,488,551,719,1270,1758,2236,2792,14.48,5.25,4.21,3.31
06-05-2021,TORRES NOVAS,7,0,20,"[0,120]",Baixo a Moderado,,,,7,Lisboa e Vale do Tejo,SANTARÉM,1419,26999.68,34933,2324,1979,1738,1406,1475,2881,4619,6598,8922,129.38,33.04,24.44,17.11
06-05-2021,TORRES VEDRAS,79,6,101,"[0,120]",Baixo a Moderado,,,,79,Lisboa e Vale do Tejo,LISBOA,1113,40714.89,78530,4513,3945,3447,2628,2104,4732,8179,12124,16637,192.88,40.86,29.78,20.09
06-05-2021,TRANCOSO,2,0,23,"[0,120]",Baixo a Moderado,,,,2,Centro,GUARDA,0913,36152.47,8875,581,557,542,586,496,1082,1624,2181,2762,24.55,7.64,6.03,4.49
06-05-2021,TROFA,21,2,55,"[0,120]",Baixo a Moderado,,,,21,Norte,PORTO,1318,7201.76,38418,2336,1894,1231,939,684,1623,2854,4748,7084,533.44,98.36,65.93,39.63
06-05-2021,VAGOS,5,0,22,"[0,120]",Baixo a Moderado,,,,5,Centro,AVEIRO,0118,16491.5,22740,1320,1205,922,784,724,1508,2430,3635,4955,137.89,30.04,22.04,14.73
06-05-2021,VALE DE CAMBRA,29,2,136,"[120,240]",Moderado,,,,29,Norte,AVEIRO,0119,14733.47,21327,1491,1363,1005,831,798,1629,2634,3997,5488,144.76,37.25,27.13,17.88
06-05-2021,VALENÇA,1,0,8,"[0,120]",Baixo a Moderado,,,,1,Norte,VIANA DO CASTELO,1608,11712.86,13290,867,791,582,582,503,1085,1667,2458,3325,113.46,28.39,20.99,14.23
06-05-2021,VALONGO,112,8,115,"[0,120]",Baixo a Moderado,,,,112,Norte,PORTO,1315,7512.45,97444,5629,4696,3207,2462,1829,4291,7498,12194,17823,1297.18,237.26,162.33,99.81
06-05-2021,VALPAÇOS,12,1,81,"[0,120]",Baixo a Moderado,,,,12,Norte,VILA REAL,1712,54873.93,14818,1217,1118,999,928,997,1925,2924,4042,5259,27.0,9.58,7.37,5.33
06-05-2021,VELAS,0,0,0,"[0,120]",Baixo a Moderado,,,,0,Açores,AÇORES,4502,11738.38,5093,278,208,166,153,113,266,432,640,918,43.39,7.82,5.45,3.68
06-05-2021,VENDAS NOVAS,1,0,9,"[0,120]",Baixo a Moderado,,,,1,Alentejo,ÉVORA,0712,22238.88,11255,677,768,655,501,532,1033,1688,2456,3133,50.61,14.09,11.04,7.59
06-05-2021,VIANA DO ALENTEJO,0,0,0,"[0,120]",Baixo a Moderado,,,,0,Alentejo,ÉVORA,0713,39367.29,5145,245,208,235,210,214,424,659,867,1112,13.07,2.82,2.2,1.67
06-05-2021,VIANA DO CASTELO,79,6,94,"[0,120]",Baixo a Moderado,,,,79,Norte,VIANA DO CASTELO,1609,31902.01,84417,5470,4433,3591,3061,2982,6043,9634,14067,19537,264.61,61.24,44.09,30.2
06-05-2021,VIDIGUEIRA,12,1,218,"[120,240]",Moderado,,,,12,Alentejo,BEJA,0214,31661.09,5510,300,248,215,233,275,508,723,971,1271,17.4,4.01,3.07,2.28
06-05-2021,VIEIRA DO MINHO,6,0,51,"[0,120]",Baixo a Moderado,,,,6,Norte,BRAGA,0311,21644.35,11842,703,594,525,548,482,1030,1555,2149,2852,54.71,13.18,9.93,7.18
06-05-2021,VILA DE REI,0,0,0,"[0,120]",Baixo a Moderado,,,,0,Centro,CASTELO BRANCO,0510,19154.6,3323,169,128,172,247,302,549,721,849,1018,17.35,5.31,4.43,3.76
06-05-2021,VILA DO BISPO,2,0,39,"[0,120]",Baixo a Moderado,,,,2,Algarve,FARO,0815,17906.06,5154,302,302,314,232,233,465,779,1081,1383,28.78,7.72,6.04,4.35
06-05-2021,VILA DO CONDE,23,2,29,"[0,120]",Baixo a Moderado,,,,23,Norte,PORTO,1316,14902.77,79899,4726,3875,2819,2070,1743,3813,6632,10507,15233,536.13,102.21,70.5,44.5
06-05-2021,VILA DO PORTO,3,0,53,"[0,120]",Baixo a Moderado,,,,3,Açores,AÇORES,4101,9688.74,5616,274,212,135,96,123,219,354,566,840,57.96,8.67,5.84,3.65
06-05-2021,VILA FLOR,0,0,0,"[0,120]",Baixo a Moderado,,,,0,Norte,BRAGANÇA,0410,26581.14,6044,429,362,422,294,331,625,1047,1409,1838,22.74,6.91,5.3,3.94
06-05-2021,VILA FRANCA DE XIRA,50,4,35,"[0,120]",Baixo a Moderado,,,,50,Lisboa e Vale do Tejo,LISBOA,1114,31819.39,141957,8501,6852,4869,3425,2472,5897,10766,17618,26119,446.14,82.09,55.37,33.84
06-05-2021,VILA FRANCA DO CAMPO,17,1,154,"[120,240]",Moderado,,,,17,Açores,AÇORES,4206,7796.82,11051,450,344,248,217,154,371,619,963,1413,141.73,18.12,12.35,7.94
06-05-2021,VILA NOVA DA BARQUINHA,0,0,0,"[0,120]",Baixo a Moderado,,,,0,Lisboa e Vale do Tejo,SANTARÉM,1420,4952.97,7461,415,406,392,364,338,702,1094,1500,1915,150.64,38.66,30.28,22.09
06-05-2021,VILA NOVA DE CERVEIRA,1,0,11,"[0,120]",Baixo a Moderado,,,,1,Norte,VIANA DO CASTELO,1610,10846.66,8910,531,444,410,384,334,718,1128,1572,2103,82.14,19.39,14.49,10.4
06-05-2021,VILA NOVA DE FAMALICÃO,75,5,57,"[0,120]",Baixo a Moderado,,,,75,Norte,BRAGA,0312,20159.26,131676,7817,6164,4202,3282,2749,6031,10233,16397,24214,653.19,120.12,81.34,50.76
06-05-2021,VILA NOVA DE FOZ CÔA,0,0,0,"[0,120]",Baixo a Moderado,,,,0,Centro,GUARDA,0914,39815.18,6503,442,385,390,398,429,827,1217,1602,2044,16.33,5.13,4.02,3.06
06-05-2021,VILA NOVA DE GAIA,225,16,75,"[0,120]",Baixo a Moderado,,,,225,Norte,PORTO,1317,16846.43,300472,18349,15568,10972,8224,6281,14505,25477,41045,59394,1783.64,352.57,243.65,151.23
06-05-2021,VILA NOVA DE PAIVA,0,0,0,"[0,120]",Baixo a Moderado,,,,0,Centro,VISEU,1822,17553.28,4687,289,272,233,217,241,458,691,963,1252,26.7,7.13,5.49,3.94
06-05-2021,VILA NOVA DE POIARES,7,1,101,"[0,120]",Baixo a Moderado,,,,7,Centro,COIMBRA,0617,8445.3,6939,380,284,262,235,182,417,679,963,1343,82.17,15.9,11.4,8.04
06-05-2021,VILA POUCA DE AGUIAR,2,0,17,"[0,120]",Baixo a Moderado,,,,2,Norte,VILA REAL,1713,43706.62,11961,860,817,733,601,627,1228,1961,2778,3638,27.37,8.32,6.36,4.49
06-05-2021,VILA REAL,23,2,46,"[0,120]",Baixo a Moderado,,,,23,Norte,VILA REAL,1714,37880.28,49962,3025,2498,2065,1579,1466,3045,5110,7608,10633,131.9,28.07,20.08,13.49
06-05-2021,VILA REAL DE SANTO ANTÓNIO,22,2,117,"[0,120]",Baixo a Moderado,,,,22,Algarve,FARO,0816,6125.0,18749,1172,1069,811,569,586,1155,1966,3035,4207,306.11,68.69,49.55,32.1
06-05-2021,VILA VELHA DE RÓDÃO,0,0,0,"[0,120]",Baixo a Moderado,,,,0,Centro,CASTELO BRANCO,0511,32991.16,3144,209,229,180,283,306,589,769,998,1207,9.53,3.66,3.03,2.33
06-05-2021,VILA VERDE,17,1,36,"[0,120]",Baixo a Moderado,,,,17,Norte,BRAGA,0313,22866.52,46911,2365,2063,1667,1494,1437,2931,4598,6661,9026,205.15,39.47,29.13,20.11
06-05-2021,VILA VIÇOSA,0,0,0,"[0,120]",Baixo a Moderado,,,,0,Alentejo,ÉVORA,0714,19485.89,7656,487,379,342,345,324,669,1011,1390,1877,39.29,9.63,7.13,5.19
06-05-2021,VIMIOSO,3,0,75,"[0,120]",Baixo a Moderado,,,,3,Norte,BRAGANÇA,0411,48158.51,4023,274,230,261,293,335,628,889,1119,1393,8.35,2.89,2.32,1.85
06-05-2021,VINHAIS,1,0,13,"[0,120]",Baixo a Moderado,,,,1,Norte,BRAGANÇA,0412,69475.09,7746,599,577,636,641,815,1456,2092,2669,3268,11.15,4.7,3.84,3.01
06-05-2021,VISEU,18,1,19,"[0,120]",Baixo a Moderado,,,,18,Centro,VISEU,1823,50710.14,97249,5769,5038,4140,3158,2710,5868,10008,15046,20815,191.77,41.05,29.67,19.74
06-05-2021,VIZELA,3,0,13,"[0,120]",Baixo a Moderado,,,,3,Norte,BRAGA,0314,2469.83,23897,1258,928,655,509,371,880,1535,2463,3721,967.49,150.65,99.72,62.15
06-05-2021,VOUZELA,1,0,10,"[0,120]",Baixo a Moderado,,,,1,Centro,VISEU,1824,19369.46,9619,626,605,554,532,507,1039,1593,2198,2824,49.66,14.58,11.35,8.22
13-05-2021,ABRANTES,10,1,28,"[0,120]",Baixo a Moderado,,,,10,Lisboa e Vale do Tejo,SANTARÉM,1401,71469.08,35130,2473,2213,1730,1748,2021,3769,5499,7712,10185,49.15,14.25,10.79,7.69
13-05-2021,ÁGUEDA,1,0,2,"[0,120]",Baixo a Moderado,,,,1,Centro,AVEIRO,0101,33527.44,46075,3237,2713,2090,1635,1496,3131,5221,7934,11171,137.43,33.32,23.66,15.57
13-05-2021,AGUIAR DA BEIRA,4,0,86,"[0,120]",Baixo a Moderado,,,,4,Centro,GUARDA,0901,20676.57,4652,304,281,235,239,148,387,622,903,1207,22.5,5.84,4.37,3.01
13-05-2021,ALANDROAL,1,0,20,"[0,120]",Baixo a Moderado,,,,1,Alentejo,ÉVORA,0701,54267.81,4992,307,256,296,299,377,676,972,1228,1535,9.2,2.83,2.26,1.79
13-05-2021,ALBERGARIA-A-VELHA,1,0,4,"[0,120]",Baixo a Moderado,,,,1,Centro,AVEIRO,0102,15882.5,24144,1550,1298,996,687,680,1367,2363,3661,5211,152.02,32.81,23.05,14.88
13-05-2021,ALBUFEIRA,63,5,152,"[120,240]",Moderado,,,,63,Algarve,FARO,0801,14066.42,41528,2067,1717,1425,985,858,1843,3268,4985,7052,295.24,50.14,35.44,23.23
13-05-2021,ALCÁCER DO SAL,2,0,17,"[0,120]",Baixo a Moderado,,,,2,Alentejo,SETÚBAL,1501,149987.3,11659,884,814,623,623,602,1225,1848,2662,3546,7.77,2.36,1.77,1.23
13-05-2021,ALCANENA,2,0,16,"[0,120]",Baixo a Moderado,,,,2,Lisboa e Vale do Tejo,SANTARÉM,1402,12732.86,12809,891,744,628,536,588,1124,1752,2496,3387,100.6,26.6,19.6,13.76
13-05-2021,ALCOBAÇA,9,1,17,"[0,120]",Baixo a Moderado,,,,9,Lisboa e Vale do Tejo,LEIRIA,1001,40814.09,53555,3420,2927,2466,2059,1676,3735,6201,9128,12548,131.22,30.74,22.36,15.19
13-05-2021,ALCOCHETE,5,0,25,"[0,120]",Baixo a Moderado,,,,5,Lisboa e Vale do Tejo,SETÚBAL,1502,12836.48,19787,857,834,691,476,447,923,1614,2448,3305,154.15,25.75,19.07,12.57
13-05-2021,ALCOUTIM,0,0,0,"[0,120]",Baixo a Moderado,,,,0,Algarve,FARO,0802,57536.33,2159,191,188,163,190,267,457,620,808,999,3.75,1.74,1.4,1.08
13-05-2021,ALENQUER,9,1,20,"[0,120]",Baixo a Moderado,,,,9,Lisboa e Vale do Tejo,LISBOA,1101,30421.92,44052,2298,2062,1629,1330,1155,2485,4114,6176,8474,144.8,27.85,20.3,13.52
13-05-2021,ALFÂNDEGA DA FÉ,0,0,0,"[0,120]",Baixo a Moderado,,,,0,Norte,BRAGANÇA,0401,32194.64,4550,325,277,301,274,325,599,900,1177,1502,14.13,4.67,3.66,2.8
13-05-2021,ALIJÓ,11,1,104,"[0,120]",Baixo a Moderado,,,,11,Norte,VILA REAL,1701,29759.89,10625,766,687,635,542,666,1208,1843,2530,3296,35.7,11.08,8.5,6.19
13-05-2021,ALJEZUR,1,0,18,"[0,120]",Baixo a Moderado,,,,1,Algarve,FARO,0803,32349.95,5594,316,336,335,320,410,730,1065,1401,1717,17.29,5.31,4.33,3.29
13-05-2021,ALJUSTREL,2,0,24,"[0,120]",Baixo a Moderado,,,,2,Alentejo,BEJA,0201,45847.41,8247,635,521,443,347,358,705,1148,1669,2304,17.99,5.03,3.64,2.5
13-05-2021,ALMADA,56,4,33,"[0,120]",Baixo a Moderado,,,,56,Lisboa e Vale do Tejo,SETÚBAL,1503,7000.89,169039,10469,9777,7876,6144,5111,11255,19131,28908,39377,2414.5,562.45,412.91,273.26
13-05-2021,ALMEIDA,1,0,17,"[0,120]",Baixo a Moderado,,,,1,Centro,GUARDA,0902,51798.46,5830,441,419,396,458,393,851,1247,1666,2107,11.26,4.07,3.22,2.41
13-05-2021,ALMEIRIM,10,1,44,"[0,120]",Baixo a Moderado,,,,10,Lisboa e Vale do Tejo,SANTARÉM,1403,22212.05,22546,1342,1353,1106,866,843,1709,2815,4168,5510,101.5,24.81,18.76,12.67
13-05-2021,ALMODÔVAR,1,0,15,"[0,120]",Baixo a Moderado,,,,1,Alentejo,BEJA,0202,77788.03,6725,414,443,396,373,328,701,1097,1540,1954,8.65,2.51,1.98,1.41
13-05-2021,ALPIARÇA,8,1,113,"[0,120]",Baixo a Moderado,,,,8,Lisboa e Vale do Tejo,SANTARÉM,1404,9536.33,7059,515,486,363,333,274,607,970,1456,1971,74.02,20.67,15.27,10.17
13-05-2021,ALTER DO CHÃO,0,0,0,"[0,120]",Baixo a Moderado,,,,0,Alentejo,PORTALEGRE,1201,36206.62,3165,201,163,136,208,187,395,531,694,895,8.74,2.47,1.92,1.47
13-05-2021,ALVAIÁZERE,10,1,152,"[120,240]",Moderado,,,,10,Centro,LEIRIA,1002,16047.76,6597,419,389,346,406,539,945,1291,1680,2099,41.11,13.08,10.47,8.04
13-05-2021,ALVITO,0,0,0,"[0,120]",Baixo a Moderado,,,,0,Alentejo,BEJA,0203,26485.32,2477,145,110,105,111,89,200,305,415,560,9.35,2.11,1.57,1.15
13-05-2021,AMADORA,53,4,29,"[0,120]",Baixo a Moderado,,,,53,Lisboa e Vale do Tejo,LISBOA,1115,2378.47,184106,11186,10936,8780,6460,5890,12350,21130,32066,43252,7742.05,1818.84,1348.44,888.56
13-05-2021,AMARANTE,22,2,41,"[0,120]",Baixo a Moderado,,,,22,Norte,PORTO,1301,30133.15,53193,3086,2413,1812,1643,1311,2954,4766,7179,10265,176.53,34.07,23.82,15.82
13-05-2021,AMARES,10,1,55,"[0,120]",Baixo a Moderado,,,,10,Norte,BRAGA,0301,8195.41,18129,1001,829,622,489,524,1013,1635,2464,3465,221.22,42.28,30.07,19.95
13-05-2021,ANADIA,1,0,4,"[0,120]",Baixo a Moderado,,,,1,Centro,AVEIRO,0103,21663.48,27258,1931,1698,1376,1208,1262,2470,3846,5544,7475,125.83,34.51,25.59,17.75
13-05-2021,ANGRA DO HEROÍSMO,2,0,6,"[0,120]",Baixo a Moderado,,,,2,Açores,AÇORES,4301,23899.66,33807,2006,1473,1122,768,635,1403,2525,3998,6004,141.45,25.12,16.73,10.56
13-05-2021,ANSIÃO,0,0,0,"[0,120]",Baixo a Moderado,,,,0,Centro,LEIRIA,1003,17609.42,12039,727,709,646,694,530,1224,1870,2579,3306,68.37,18.77,14.65,10.62
13-05-2021,ARCOS DE VALDEVEZ,8,1,38,"[0,120]",Baixo a Moderado,,,,8,Norte,VIANA DO CASTELO,1601,44759.64,20926,1329,1338,1282,1343,1515,2858,4140,5478,6807,46.75,15.21,12.24,9.25
13-05-2021,ARGANIL,91,6,826,"[480,960]",Muito Elevado,,,,91,Centro,COIMBRA,0601,33283.93,11014,672,648,612,559,596,1155,1767,2415,3087,33.09,9.27,7.26,5.31
13-05-2021,ARMAMAR,0,0,0,"[0,120]",Baixo a Moderado,,,,0,Norte,VISEU,1801,11723.73,5769,357,305,309,285,310,595,904,1209,1566,49.21,13.36,10.31,7.71
13-05-2021,AROUCA,18,1,87,"[0,120]",Baixo a Moderado,,,,18,Norte,AVEIRO,0104,32910.52,20720,1306,1047,753,683,683,1366,2119,3166,4472,62.96,13.59,9.62,6.44
13-05-2021,ARRAIOLOS,0,0,0,"[0,120]",Baixo a Moderado,,,,0,Alentejo,ÉVORA,0702,68374.55,6928,435,384,283,367,480,847,1130,1514,1949,10.13,2.85,2.21,1.65
13-05-2021,ARRONCHES,0,0,0,"[0,120]",Baixo a Moderado,,,,0,Alentejo,PORTALEGRE,1202,31464.72,2820,155,142,162,187,179,366,528,670,825,8.96,2.62,2.13,1.68
13-05-2021,ARRUDA DOS VINHOS,2,0,13,"[0,120]",Baixo a Moderado,,,,2,Lisboa e Vale do Tejo,LISBOA,1102,7795.93,15412,738,738,562,509,438,947,1509,2247,2985,197.69,38.29,28.82,19.36
13-05-2021,AVEIRO,27,2,34,"[0,120]",Baixo a Moderado,,,,27,Centro,AVEIRO,0105,19757.57,78734,4520,4004,3050,2250,2103,4353,7403,11407,15927,398.49,80.61,57.73,37.47
13-05-2021,AVIS,0,0,0,"[0,120]",Baixo a Moderado,,,,0,Alentejo,PORTALEGRE,1203,60596.51,4247,315,225,206,251,273,524,730,955,1270,7.01,2.1,1.58,1.2
13-05-2021,AZAMBUJA,4,0,18,"[0,120]",Baixo a Moderado,,,,4,Lisboa e Vale do Tejo,LISBOA,1103,26265.65,22716,1322,1171,1070,798,618,1416,2486,3657,4979,86.48,18.96,13.92,9.46
13-05-2021,BAIÃO,8,1,43,"[0,120]",Baixo a Moderado,,,,8,Norte,PORTO,1302,17452.83,18748,1070,862,714,686,725,1411,2125,2987,4057,107.42,23.25,17.11,12.18
13-05-2021,BARCELOS,69,5,59,"[0,120]",Baixo a Moderado,,,,69,Norte,BRAGA,0302,37890.14,116187,6721,5325,3619,2991,2562,5553,9172,14497,21218,306.64,56.0,38.26,24.21
13-05-2021,BARRANCOS,0,0,0,"[0,120]",Baixo a Moderado,,,,0,Alentejo,BEJA,0204,16841.73,1634,90,65,65,94,61,155,220,285,375,9.7,2.23,1.69,1.31
13-05-2021,BARREIRO,33,2,44,"[0,120]",Baixo a Moderado,,,,33,Lisboa e Vale do Tejo,SETÚBAL,1504,3639.07,75147,5194,5565,4459,3105,1767,4872,9331,14896,20090,2065.05,552.07,409.34,256.42
13-05-2021,BATALHA,5,0,31,"[0,120]",Baixo a Moderado,,,,5,Centro,LEIRIA,1004,10341.6,15963,873,762,649,529,549,1078,1727,2489,3362,154.35,32.51,24.07,16.7
13-05-2021,BEJA,23,2,68,"[0,120]",Baixo a Moderado,,,,23,Alentejo,BEJA,0205,114647.55,33579,2005,1840,1386,1272,1039,2311,3697,5537,7542,29.29,6.58,4.83,3.22
13-05-2021,BELMONTE,1,0,16,"[0,120]",Baixo a Moderado,,,,1,Centro,CASTELO BRANCO,0501,11875.91,6398,444,321,325,310,355,665,990,1311,1755,53.87,14.78,11.04,8.34
13-05-2021,BENAVENTE,4,0,13,"[0,120]",Baixo a Moderado,,,,4,Lisboa e Vale do Tejo,SANTARÉM,1405,52138.39,30602,1468,1376,1141,876,643,1519,2660,4036,5504,58.69,10.56,7.74,5.1
13-05-2021,BOMBARRAL,0,0,0,"[0,120]",Baixo a Moderado,,,,0,Lisboa e Vale do Tejo,LEIRIA,1005,9128.55,12558,875,714,561,491,429,920,1481,2195,3070,137.56,33.63,24.04,16.22
13-05-2021,BORBA,0,0,0,"[0,120]",Baixo a Moderado,,,,0,Alentejo,ÉVORA,0703,14518.65,6736,430,375,279,436,392,828,1107,1482,1912,46.39,13.17,10.21,7.62
13-05-2021,BOTICAS,0,0,0,"[0,120]",Baixo a Moderado,,,,0,Norte,VILA REAL,1702,32195.66,4998,347,306,311,305,380,685,996,1302,1649,15.52,5.12,4.04,3.09
13-05-2021,BRAGA,142,10,78,"[0,120]",Baixo a Moderado,,,,142,Norte,BRAGA,0303,18339.95,182679,10029,7963,5241,4320,3671,7991,13232,21195,31224,996.07,170.25,115.57,72.15
13-05-2021,BRAGANÇA,9,1,27,"[0,120]",Baixo a Moderado,,,,9,Norte,BRAGANÇA,0402,117357.27,33607,2402,1855,1652,1393,1163,2556,4208,6063,8465,28.64,7.21,5.17,3.59
13-05-2021,CABECEIRAS DE BASTO,17,1,109,"[0,120]",Baixo a Moderado,,,,17,Norte,BRAGA,0304,24182.16,15628,774,594,544,575,574,1149,1693,2287,3061,64.63,12.66,9.46,7.0
13-05-2021,CADAVAL,3,0,22,"[0,120]",Baixo a Moderado,,,,3,Lisboa e Vale do Tejo,LISBOA,1104,17489.3,13673,813,796,756,621,625,1246,2002,2798,3611,78.18,20.65,16.0,11.45
13-05-2021,CALDAS DA RAINHA,7,0,13,"[0,120]",Baixo a Moderado,,,,7,Lisboa e Vale do Tejo,LEIRIA,1006,25569.47,51912,3035,2684,2186,1899,1705,3604,5790,8474,11509,203.03,45.01,33.14,22.64
13-05-2021,CALHETA,0,0,0,"[0,120]",Baixo a Moderado,,,,0,Madeira,MADEIRA,3101,11150.43,10867,576,497,507,399,415,814,1321,1818,2394,97.46,21.47,16.3,11.85
13-05-2021,CALHETA (AÇORES),0,0,0,"[0,120]",Baixo a Moderado,,,,0,Açores,AÇORES,4501,12626.4,3184,215,159,141,139,122,261,402,561,776,25.22,6.15,4.44,3.18
13-05-2021,CÂMARA DE LOBOS,15,1,45,"[0,120]",Baixo a Moderado,,,,15,Madeira,MADEIRA,3102,5216.67,33675,1396,1059,834,545,381,926,1760,2819,4215,645.49,80.79,54.03,33.74
13-05-2021,CAMINHA,5,0,31,"[0,120]",Baixo a Moderado,,,,5,Norte,VIANA DO CASTELO,1602,13652.14,15877,1046,944,818,646,656,1302,2120,3064,4110,116.3,30.11,22.44,15.53
13-05-2021,CAMPO MAIOR,7,1,89,"[0,120]",Baixo a Moderado,,,,7,Alentejo,PORTALEGRE,1204,24720.16,7874,471,364,351,279,327,606,957,1321,1792,31.85,7.25,5.34,3.87
13-05-2021,CANTANHEDE,7,1,20,"[0,120]",Baixo a Moderado,,,,7,Centro,COIMBRA,0602,39088.02,35011,2346,2096,1880,1709,1451,3160,5040,7136,9482,89.57,24.26,18.26,12.89
13-05-2021,CARRAZEDA DE ANSIÃES,1,0,18,"[0,120]",Baixo a Moderado,,,,1,Norte,BRAGANÇA,0403,27924.09,5666,424,389,391,312,465,777,1168,1557,1981,20.29,7.09,5.58,4.18
13-05-2021,CARREGAL DO SAL,8,1,86,"[0,120]",Baixo a Moderado,,,,8,Centro,VISEU,1802,11689.21,9271,587,562,486,462,376,838,1324,1886,2473,79.31,21.16,16.13,11.33
13-05-2021,CARTAXO,3,0,13,"[0,120]",Baixo a Moderado,,,,3,Lisboa e Vale do Tejo,SANTARÉM,1406,15817.28,23843,1415,1376,1142,861,632,1493,2635,4011,5426,150.74,34.3,25.36,16.66
13-05-2021,CASCAIS,47,3,22,"[0,120]",Baixo a Moderado,,,,47,Lisboa e Vale do Tejo,LISBOA,1105,9740.17,213608,12151,11444,8680,6469,5248,11717,20397,31841,43992,2193.1,451.66,326.91,209.41
13-05-2021,CASTANHEIRA DE PÊRA,1,0,38,"[0,120]",Baixo a Moderado,,,,1,Centro,LEIRIA,1007,6677.45,2614,233,195,157,190,187,377,534,729,962,39.15,14.41,10.92,8.0
13-05-2021,CASTELO BRANCO,15,1,29,"[0,120]",Baixo a Moderado,,,,15,Centro,CASTELO BRANCO,0502,143819.15,51987,3528,3042,2499,2229,2225,4454,6953,9995,13523,36.15,9.4,6.95,4.83
13-05-2021,CASTELO DE PAIVA,46,3,298,"[240,480]",Elevado,,,,46,Norte,AVEIRO,0106,11500.53,15454,881,697,545,420,431,851,1396,2093,2974,134.37,25.86,18.2,12.14
13-05-2021,CASTELO DE VIDE,0,0,0,"[0,120]",Baixo a Moderado,,,,0,Alentejo,PORTALEGRE,1205,26491.24,2919,204,173,179,147,170,317,496,669,873,11.02,3.3,2.53,1.87
13-05-2021,CASTRO DAIRE,1,0,7,"[0,120]",Baixo a Moderado,,,,1,Centro,VISEU,1803,37904.13,13823,942,857,765,732,773,1505,2270,3127,4069,36.47,10.74,8.25,5.99
13-05-2021,CASTRO MARIM,0,0,0,"[0,120]",Baixo a Moderado,,,,0,Algarve,FARO,0804,30084.37,6237,370,345,334,322,344,666,1000,1345,1715,20.73,5.7,4.47,3.32
13-05-2021,CASTRO VERDE,0,0,0,"[0,120]",Baixo a Moderado,,,,0,Alentejo,BEJA,0206,56944.23,6949,437,347,303,275,227,502,805,1152,1589,12.2,2.79,2.02,1.41
13-05-2021,CELORICO DA BEIRA,0,0,0,"[0,120]",Baixo a Moderado,,,,0,Centro,GUARDA,0903,24721.63,6928,430,416,363,369,535,904,1267,1683,2113,28.02,8.55,6.81,5.12
13-05-2021,CELORICO DE BASTO,4,0,21,"[0,120]",Baixo a Moderado,,,,4,Norte,BRAGA,0305,18107.02,19040,1001,802,668,728,729,1457,2125,2927,3928,105.15,21.69,16.17,11.74
13-05-2021,CHAMUSCA,1,0,11,"[0,120]",Baixo a Moderado,,,,1,Lisboa e Vale do Tejo,SANTARÉM,1407,74600.54,9197,629,583,553,465,579,1044,1597,2180,2809,12.33,3.77,2.92,2.14
13-05-2021,CHAVES,21,1,53,"[0,120]",Baixo a Moderado,,,,21,Norte,VILA REAL,1703,59122.95,39343,2676,2429,1991,1886,1918,3804,5795,8224,10900,66.54,18.44,13.91,9.8
13-05-2021,CINFÃES,16,1,88,"[0,120]",Baixo a Moderado,,,,16,Norte,VISEU,1804,23928.76,18244,1067,902,779,734,758,1492,2271,3173,4240,76.24,17.72,13.26,9.49
13-05-2021,COIMBRA,15,1,11,"[0,120]",Baixo a Moderado,,,,15,Centro,COIMBRA,0603,31939.94,134166,9489,8734,6353,5139,5074,10213,16566,25300,34789,420.06,108.92,79.21,51.87
13-05-2021,CONDEIXA-A-NOVA,1,0,6,"[0,120]",Baixo a Moderado,,,,1,Centro,COIMBRA,0604,13867.47,17733,871,809,717,583,490,1073,1790,2599,3470,127.88,25.02,18.74,12.91
13-05-2021,CONSTÂNCIA,0,0,0,"[0,120]",Baixo a Moderado,,,,0,Lisboa e Vale do Tejo,SANTARÉM,1408,8036.58,4030,211,183,187,148,155,303,490,673,884,50.14,11.0,8.37,6.1
13-05-2021,CORUCHE,13,1,74,"[0,120]",Baixo a Moderado,,,,13,Lisboa e Vale do Tejo,SANTARÉM,1409,111572.03,17471,1294,1090,1095,1096,1019,2115,3210,4300,5594,15.66,5.01,3.85,2.88
13-05-2021,CORVO,0,0,0,"[0,120]",Baixo a Moderado,,,,0,Açores,AÇORES,4901,1711.45,464,22,21,11,13,19,32,43,64,86,27.12,5.03,3.74,2.51
13-05-2021,COVILHÃ,21,2,45,"[0,120]",Baixo a Moderado,,,,21,Centro,CASTELO BRANCO,0503,55560.06,46787,3533,2998,2365,2111,2193,4304,6669,9667,13200,84.21,23.76,17.4,12.0
13-05-2021,CRATO,0,0,0,"[0,120]",Baixo a Moderado,,,,0,Alentejo,PORTALEGRE,1206,39806.88,3129,229,258,163,182,228,410,573,831,1060,7.86,2.66,2.09,1.44
13-05-2021,CUBA,0,0,0,"[0,120]",Baixo a Moderado,,,,0,Alentejo,BEJA,0207,17208.72,4595,255,233,206,190,143,333,539,772,1027,26.7,5.97,4.49,3.13
13-05-2021,ELVAS,2,0,10,"[0,120]",Baixo a Moderado,,,,2,Alentejo,PORTALEGRE,1207,63128.86,20528,1057,1145,902,852,810,1662,2564,3709,4766,32.52,7.55,5.88,4.06
13-05-2021,ENTRONCAMENTO,4,0,19,"[0,120]",Baixo a Moderado,,,,4,Lisboa e Vale do Tejo,SANTARÉM,1410,1372.81,21558,1066,930,868,695,592,1287,2155,3085,4151,1570.14,302.33,224.69,156.96
13-05-2021,ESPINHO,10,1,34,"[0,120]",Baixo a Moderado,,,,10,Norte,AVEIRO,0107,2105.68,29516,2205,1993,1430,1177,960,2137,3567,5560,7765,1401.52,368.71,264.01,169.37
13-05-2021,ESPOSENDE,14,1,41,"[0,120]",Baixo a Moderado,,,,14,Norte,BRAGA,0306,9540.98,34177,1831,1522,1095,894,723,1617,2712,4234,6065,358.21,63.57,44.38,28.42
13-05-2021,ESTARREJA,4,0,15,"[0,120]",Baixo a Moderado,,,,4,Centro,AVEIRO,0108,10817.33,26006,1503,1399,1106,953,728,1681,2787,4186,5689,240.42,52.59,38.7,25.76
13-05-2021,ESTREMOZ,0,0,0,"[0,120]",Baixo a Moderado,,,,0,Alentejo,ÉVORA,0704,51379.95,12728,789,613,697,786,877,1663,2360,2973,3762,24.77,7.32,5.79,4.59
13-05-2021,ÉVORA,21,1,40,"[0,120]",Baixo a Moderado,,,,21,Alentejo,ÉVORA,0705,130707.58,52428,3569,2852,2176,1966,1803,3769,5945,8797,12366,40.11,9.46,6.73,4.55
13-05-2021,FAFE,63,4,131,"[120,240]",Moderado,,,,63,Norte,BRAGA,0307,21908.11,48060,3044,2455,1679,1403,1208,2611,4290,6745,9789,219.37,44.68,30.79,19.58
13-05-2021,FARO,46,3,75,"[0,120]",Baixo a Moderado,,,,46,Algarve,FARO,0805,20256.79,61015,3847,3364,2604,2055,1601,3656,6260,9624,13471,301.2,66.5,47.51,30.9
13-05-2021,FELGUEIRAS,16,1,28,"[0,120]",Baixo a Moderado,,,,16,Norte,PORTO,1303,11573.75,56422,2951,2302,1601,1316,973,2289,3890,6192,9143,487.49,79.0,53.5,33.61
13-05-2021,FERREIRA DO ALENTEJO,8,1,102,"[0,120]",Baixo a Moderado,,,,8,Alentejo,BEJA,0208,64820.68,7845,515,414,372,343,345,688,1060,1474,1989,12.1,3.07,2.27,1.64
13-05-2021,FERREIRA DO ZÊZERE,1,0,13,"[0,120]",Baixo a Moderado,,,,1,Lisboa e Vale do Tejo,SANTARÉM,1411,19038.03,7959,470,370,416,465,456,921,1337,1707,2177,41.81,11.44,8.97,7.02
13-05-2021,FIGUEIRA DA FOZ,53,4,90,"[0,120]",Baixo a Moderado,,,,53,Centro,COIMBRA,0605,37905.26,58747,4032,3597,2887,2495,2043,4538,7425,11022,15054,154.98,39.72,29.08,19.59
13-05-2021,FIGUEIRA DE CASTELO RODRIGO,0,0,0,"[0,120]",Baixo a Moderado,,,,0,Centro,GUARDA,0904,50857.46,5584,347,352,290,352,391,743,1033,1385,1732,10.98,3.41,2.72,2.03
13-05-2021,FIGUEIRÓ DOS VINHOS,0,0,0,"[0,120]",Baixo a Moderado,,,,0,Centro,LEIRIA,1008,17344.0,5568,402,386,322,309,351,660,982,1368,1770,32.1,10.21,7.89,5.66
13-05-2021,FORNOS DE ALGODRES,3,0,66,"[0,120]",Baixo a Moderado,,,,3,Centro,GUARDA,0905,13145.05,4528,261,218,247,256,232,488,735,953,1214,34.45,9.24,7.25,5.59
13-05-2021,FREIXO DE ESPADA À CINTA,1,0,30,"[0,120]",Baixo a Moderado,,,,1,Norte,BRAGANÇA,0404,24414.29,3298,211,177,231,196,189,385,616,793,1004,13.51,4.11,3.25,2.52
13-05-2021,FRONTEIRA,0,0,0,"[0,120]",Baixo a Moderado,,,,0,Alentejo,PORTALEGRE,1208,24859.58,2974,213,182,149,156,168,324,473,655,868,11.96,3.49,2.63,1.9
13-05-2021,FUNCHAL,129,9,124,"[120,240]",Moderado,,,,129,Madeira,MADEIRA,3103,7616.2,104024,6382,5086,3643,2821,1990,4811,8454,13540,19922,1365.86,261.58,177.78,111.0
13-05-2021,FUNDÃO,0,0,0,"[0,120]",Baixo a Moderado,,,,0,Centro,CASTELO BRANCO,0504,70019.79,26495,1781,1464,1432,1357,1643,3000,4432,5896,7677,37.84,10.96,8.42,6.33
13-05-2021,GAVIÃO,0,0,0,"[0,120]",Baixo a Moderado,,,,0,Alentejo,PORTALEGRE,1209,29459.45,3263,189,186,222,263,293,556,778,964,1153,11.08,3.91,3.27,2.64
13-05-2021,GÓIS,0,0,0,"[0,120]",Baixo a Moderado,,,,0,Centro,COIMBRA,0606,26330.19,3805,235,199,240,233,244,477,717,916,1151,14.45,4.37,3.48,2.72
13-05-2021,GOLEGÃ,11,1,206,"[120,240]",Moderado,,,,11,Lisboa e Vale do Tejo,SANTARÉM,1412,8431.67,5339,356,299,281,243,255,498,779,1078,1434,63.32,17.01,12.78,9.24
13-05-2021,GONDOMAR,110,8,66,"[0,120]",Baixo a Moderado,,,,110,Norte,PORTO,1304,13191.76,165985,10555,8755,6222,4450,3364,7814,14036,22791,33346,1258.22,252.77,172.76,106.4
13-05-2021,GOUVEIA,1,0,8,"[0,120]",Baixo a Moderado,,,,1,Centro,GUARDA,0906,30061.17,12387,871,931,780,783,810,1593,2373,3304,4175,41.21,13.89,10.99,7.89
13-05-2021,GRÂNDOLA,2,0,14,"[0,120]",Baixo a Moderado,,,,2,Alentejo,SETÚBAL,1505,82593.66,14639,834,834,708,688,672,1360,2068,2902,3736,17.72,4.52,3.51,2.5
13-05-2021,GUARDA,4,0,10,"[0,120]",Baixo a Moderado,,,,4,Centro,GUARDA,0907,71209.58,38969,2477,2041,1686,1415,1474,2889,4575,6616,9093,54.72,12.77,9.29,6.42
13-05-2021,GUIMARÃES,72,5,47,"[0,120]",Baixo a Moderado,,,,72,Norte,BRAGA,0308,24099.96,152309,9394,7074,4809,3877,2948,6825,11634,18708,28102,631.99,116.61,77.63,48.27
13-05-2021,HORTA,0,0,0,"[0,120]",Baixo a Moderado,,,,0,Açores,AÇORES,4701,17305.53,14521,818,658,468,352,302,654,1122,1780,2598,83.91,15.01,10.29,6.48
13-05-2021,IDANHA-A-NOVA,1,0,12,"[0,120]",Baixo a Moderado,,,,1,Centro,CASTELO BRANCO,0505,141633.51,8043,518,490,519,672,974,1646,2165,2655,3173,5.68,2.24,1.87,1.53
13-05-2021,ÍLHAVO,1,0,3,"[0,120]",Baixo a Moderado,,,,1,Centro,AVEIRO,0110,7347.55,38699,2227,1943,1444,1193,850,2043,3487,5430,7657,526.66,104.21,73.9,47.46
13-05-2021,LAGOA (FARO),27,2,119,"[0,120]",Baixo a Moderado,,,,27,Algarve,FARO,0806,8825.45,22762,1314,1168,919,749,670,1419,2338,3506,4820,257.93,54.62,39.73,26.49
13-05-2021,LAGOA,19,1,129,"[120,240]",Moderado,,,,19,Açores,AÇORES,4201,4559.32,14721,536,458,349,238,235,473,822,1280,1816,322.9,39.83,28.08,18.03
13-05-2021,LAGOS,14,1,46,"[0,120]",Baixo a Moderado,,,,14,Algarve,FARO,0807,21299.27,30374,1744,1434,1247,1053,1029,2082,3329,4763,6507,142.61,30.55,22.36,15.63
13-05-2021,LAJES DAS FLORES,6,0,410,"[240,480]",Elevado,,,,6,Açores,AÇORES,4801,7004.79,1463,88,53,62,46,54,100,162,215,303,20.89,4.33,3.07,2.31
13-05-2021,LAJES DO PICO,0,0,0,"[0,120]",Baixo a Moderado,,,,0,Açores,AÇORES,4601,15531.09,4490,304,231,223,159,162,321,544,775,1079,28.91,6.95,4.99,3.5
13-05-2021,LAMEGO,65,5,261,"[240,480]",Elevado,,,,65,Norte,VISEU,1805,16542.11,24895,1639,1284,1124,898,783,1681,2805,4089,5728,150.5,34.63,24.72,16.96
13-05-2021,LEIRIA,18,1,14,"[0,120]",Baixo a Moderado,,,,18,Centro,LEIRIA,1009,56508.83,125267,7389,6366,5090,3902,3159,7061,12151,18517,25906,221.68,45.84,32.77,21.5
13-05-2021,LISBOA,413,29,81,"[0,120]",Baixo a Moderado,,,,413,Lisboa e Vale do Tejo,LISBOA,1106,10005.43,509515,33197,33340,27706,23037,26770,49807,77513,110853,144050,5092.6,1439.78,1107.98,774.74
13-05-2021,LOULÉ,47,3,68,"[0,120]",Baixo a Moderado,,,,47,Algarve,FARO,0808,76366.91,68697,3890,3350,2780,2358,2251,4609,7389,10739,14629,89.96,19.16,14.06,9.68
13-05-2021,LOURES,45,3,21,"[0,120]",Baixo a Moderado,,,,45,Lisboa e Vale do Tejo,LISBOA,1107,16723.99,213687,12746,12794,9644,6669,5033,11702,21346,34140,46886,1277.73,280.35,204.14,127.64
13-05-2021,LOURINHÃ,6,0,23,"[0,120]",Baixo a Moderado,,,,6,Lisboa e Vale do Tejo,LISBOA,1108,14717.2,25855,1584,1243,992,842,645,1487,2479,3722,5306,175.68,36.05,25.29,16.84
13-05-2021,LOUSÃ,7,1,41,"[0,120]",Baixo a Moderado,,,,7,Centro,COIMBRA,0607,13840.01,17158,946,866,658,528,450,978,1636,2502,3448,123.97,24.91,18.08,11.82
13-05-2021,LOUSADA,31,2,66,"[0,120]",Baixo a Moderado,,,,31,Norte,PORTO,1305,9608.01,46755,2289,1698,1176,853,621,1474,2650,4348,6637,486.63,69.08,45.25,27.58
13-05-2021,MAÇÃO,0,0,0,"[0,120]",Baixo a Moderado,,,,0,Lisboa e Vale do Tejo,SANTARÉM,1413,39997.98,6267,386,362,390,440,657,1097,1487,1849,2235,15.67,5.59,4.62,3.72
13-05-2021,MACEDO DE CAVALEIROS,1,0,7,"[0,120]",Baixo a Moderado,,,,1,Norte,BRAGANÇA,0405,69914.08,14516,1082,889,878,823,938,1761,2639,3528,4610,20.76,6.59,5.05,3.77
13-05-2021,MACHICO,22,2,110,"[0,120]",Baixo a Moderado,,,,22,Madeira,MADEIRA,3104,6825.1,19981,1197,860,662,455,331,786,1448,2308,3505,292.76,51.36,33.82,21.22
13-05-2021,MADALENA,0,0,0,"[0,120]",Baixo a Moderado,,,,0,Açores,AÇORES,4602,14712.33,5895,334,256,173,190,179,369,542,798,1132,40.07,7.69,5.42,3.68
13-05-2021,MAFRA,34,2,40,"[0,120]",Baixo a Moderado,,,,34,Lisboa e Vale do Tejo,LISBOA,1109,29165.5,84816,3613,3334,2839,2089,1899,3988,6827,10161,13774,290.81,47.23,34.84,23.41
13-05-2021,MAIA,44,3,32,"[0,120]",Baixo a Moderado,,,,44,Norte,PORTO,1306,8293.94,138971,7801,6617,4512,3339,2631,5970,10482,17099,24900,1675.56,300.22,206.16,126.38
13-05-2021,MANGUALDE,4,0,22,"[0,120]",Baixo a Moderado,,,,4,Centro,VISEU,1806,21925.56,18510,1198,1128,885,852,743,1595,2480,3608,4806,84.42,21.92,16.46,11.31
13-05-2021,MANTEIGAS,0,0,0,"[0,120]",Baixo a Moderado,,,,0,Centro,GUARDA,0908,12197.55,3007,258,197,159,167,146,313,472,669,927,24.65,7.6,5.48,3.87
13-05-2021,MARCO DE CANAVESES,33,2,64,"[0,120]",Baixo a Moderado,,,,33,Norte,PORTO,1307,20188.98,51496,2678,2060,1488,1265,1023,2288,3776,5836,8514,255.07,42.17,28.91,18.7
13-05-2021,MARINHA GRANDE,7,0,18,"[0,120]",Baixo a Moderado,,,,7,Centro,LEIRIA,1010,18725.19,38508,2365,2302,1638,1359,1058,2417,4055,6357,8722,205.65,46.58,33.95,21.66
13-05-2021,MARVÃO,0,0,0,"[0,120]",Baixo a Moderado,,,,0,Alentejo,PORTALEGRE,1210,15489.9,3005,198,185,142,197,237,434,576,761,959,19.4,6.19,4.91,3.72
13-05-2021,MATOSINHOS,77,6,44,"[0,120]",Baixo a Moderado,,,,77,Norte,PORTO,1308,6241.97,175357,11850,9977,7023,5024,3884,8908,15931,25908,37758,2809.31,604.9,415.06,255.22
13-05-2021,MEALHADA,3,0,15,"[0,120]",Baixo a Moderado,,,,3,Centro,AVEIRO,0111,11065.66,19914,1163,1039,810,828,831,1659,2469,3508,4671,179.96,42.21,31.7,22.31
13-05-2021,MÊDA,0,0,0,"[0,120]",Baixo a Moderado,,,,0,Centro,GUARDA,0909,28604.92,4587,343,306,290,288,443,731,1021,1327,1670,16.04,5.84,4.64,3.57
13-05-2021,MELGAÇO,10,1,124,"[120,240]",Moderado,,,,10,Norte,VIANA DO CASTELO,1603,23824.58,8093,507,567,578,614,675,1289,1867,2434,2941,33.97,12.34,10.22,7.84
13-05-2021,MÉRTOLA,0,0,0,"[0,120]",Baixo a Moderado,,,,0,Alentejo,BEJA,0209,129287.34,6142,400,390,378,423,600,1023,1401,1791,2191,4.75,1.69,1.39,1.08
13-05-2021,MESÃO FRIO,1,0,25,"[0,120]",Baixo a Moderado,,,,1,Norte,VILA REAL,1704,2664.87,3964,265,205,168,157,120,277,445,650,915,148.74,34.33,24.39,16.7
13-05-2021,MIRA,4,0,34,"[0,120]",Baixo a Moderado,,,,4,Centro,COIMBRA,0608,12403.38,11832,727,729,659,550,466,1016,1675,2404,3131,95.4,25.24,19.38,13.5
13-05-2021,MIRANDA DO CORVO,2,0,16,"[0,120]",Baixo a Moderado,,,,2,Centro,COIMBRA,0609,12637.79,12708,706,659,568,498,404,902,1470,2129,2835,100.55,22.43,16.85,11.63
13-05-2021,MIRANDA DO DOURO,0,0,0,"[0,120]",Baixo a Moderado,,,,0,Norte,BRAGANÇA,0406,48718.31,6830,482,429,442,463,470,933,1375,1804,2286,14.02,4.69,3.7,2.82
13-05-2021,MIRANDELA,1,0,5,"[0,120]",Baixo a Moderado,,,,1,Norte,BRAGANÇA,0407,65895.67,21754,1640,1315,1204,1078,947,2025,3229,4544,6184,33.01,9.38,6.9,4.9
13-05-2021,MOGADOURO,1,0,12,"[0,120]",Baixo a Moderado,,,,1,Norte,BRAGANÇA,0408,76064.93,8392,589,529,576,630,655,1285,1861,2390,2979,11.03,3.92,3.14,2.45
13-05-2021,MOIMENTA DA BEIRA,3,0,31,"[0,120]",Baixo a Moderado,,,,3,Norte,VISEU,1807,21996.9,9736,576,514,471,416,461,877,1348,1862,2438,44.26,11.08,8.46,6.13
13-05-2021,MOITA,17,1,26,"[0,120]",Baixo a Moderado,,,,17,Lisboa e Vale do Tejo,SETÚBAL,1506,5525.98,64407,4226,3646,2623,1801,1425,3226,5849,9495,13721,1165.53,248.3,171.82,105.85
13-05-2021,MONÇÃO,12,1,67,"[0,120]",Baixo a Moderado,,,,12,Norte,VIANA DO CASTELO,1604,21130.85,17869,1161,1105,1031,1006,972,1978,3009,4114,5275,84.56,24.96,19.47,14.24
13-05-2021,MONCHIQUE,0,0,0,"[0,120]",Baixo a Moderado,,,,0,Algarve,FARO,0809,39530.43,5077,353,384,321,355,392,747,1068,1452,1805,12.84,4.57,3.67,2.7
13-05-2021,MONDIM DE BASTO,3,0,43,"[0,120]",Baixo a Moderado,,,,3,Norte,VILA REAL,1705,17207.52,6946,395,300,314,284,283,567,881,1181,1576,40.36,9.16,6.86,5.12
13-05-2021,MONFORTE,0,0,0,"[0,120]",Baixo a Moderado,,,,0,Alentejo,PORTALEGRE,1211,42024.82,2975,139,115,117,192,168,360,477,592,731,7.08,1.74,1.41,1.14
13-05-2021,MONTALEGRE,26,2,289,"[240,480]",Elevado,,,,26,Norte,VILA REAL,1706,80545.71,8997,699,628,595,603,730,1333,1928,2556,3255,11.17,4.04,3.17,2.39
13-05-2021,MONTEMOR-O-NOVO,0,0,0,"[0,120]",Baixo a Moderado,,,,0,Alentejo,ÉVORA,0706,123296.65,15647,991,953,868,878,971,1849,2717,3670,4661,12.69,3.78,2.98,2.2
13-05-2021,MONTEMOR-O-VELHO,2,0,8,"[0,120]",Baixo a Moderado,,,,2,Centro,COIMBRA,0610,22896.23,25224,1496,1397,1217,1057,988,2045,3262,4659,6155,110.17,26.88,20.35,14.25
13-05-2021,MONTIJO,54,4,94,"[0,120]",Baixo a Moderado,,,,54,Lisboa e Vale do Tejo,SETÚBAL,1507,34861.64,57614,2771,2441,1990,1554,1109,2663,4653,7094,9865,165.26,28.3,20.35,13.35
13-05-2021,MORA,0,0,0,"[0,120]",Baixo a Moderado,,,,0,Alentejo,ÉVORA,0707,44395.02,4138,336,275,252,238,257,495,747,1022,1358,9.32,3.06,2.3,1.68
13-05-2021,MORTÁGUA,1,0,11,"[0,120]",Baixo a Moderado,,,,1,Centro,VISEU,1808,25117.82,8803,638,584,535,499,460,959,1494,2078,2716,35.05,10.81,8.27,5.95
13-05-2021,MOURA,2,0,15,"[0,120]",Baixo a Moderado,,,,2,Alentejo,BEJA,0210,95845.55,13718,817,656,665,542,461,1003,1668,2324,3141,14.31,3.28,2.42,1.74
13-05-2021,MOURÃO,0,0,0,"[0,120]",Baixo a Moderado,,,,0,Alentejo,ÉVORA,0708,27862.98,2450,139,108,80,104,109,213,293,401,540,8.79,1.94,1.44,1.05
13-05-2021,MURÇA,1,0,18,"[0,120]",Baixo a Moderado,,,,1,Norte,VILA REAL,1707,18937.11,5463,384,341,307,306,319,625,932,1273,1657,28.85,8.75,6.72,4.92
13-05-2021,MURTOSA,0,0,0,"[0,120]",Baixo a Moderado,,,,0,Centro,AVEIRO,0112,7308.78,10279,509,473,403,353,409,762,1165,1638,2147,140.63,29.37,22.41,15.94
13-05-2021,NAZARÉ,2,0,14,"[0,120]",Baixo a Moderado,,,,2,Lisboa e Vale do Tejo,LEIRIA,1011,8243.43,14165,967,903,670,420,396,816,1486,2389,3356,171.84,40.71,28.98,18.03
13-05-2021,NELAS,2,0,15,"[0,120]",Baixo a Moderado,,,,2,Centro,VISEU,1809,12571.48,12974,924,787,668,604,583,1187,1855,2642,3566,103.21,28.37,21.02,14.76
13-05-2021,NISA,0,0,0,"[0,120]",Baixo a Moderado,,,,0,Alentejo,PORTALEGRE,1212,57567.84,6061,405,389,355,483,478,961,1316,1705,2110,10.53,3.67,2.96,2.29
13-05-2021,NORDESTE,16,1,329,"[240,480]",Elevado,,,,16,Açores,AÇORES,4202,10146.8,4862,246,180,124,161,162,323,447,627,873,47.92,8.6,6.18,4.41
13-05-2021,ÓBIDOS,2,0,17,"[0,120]",Baixo a Moderado,,,,2,Lisboa e Vale do Tejo,LEIRIA,1012,14155.44,11850,743,650,574,452,436,888,1462,2112,2855,83.72,20.17,14.92,10.33
13-05-2021,ODEMIRA,67,5,271,"[240,480]",Elevado,,,,67,Alentejo,BEJA,0211,172060.15,24717,1475,1317,1225,1397,1349,2746,3971,5288,6763,14.37,3.93,3.07,2.31
13-05-2021,ODIVELAS,50,4,31,"[0,120]",Baixo a Moderado,,,,50,Lisboa e Vale do Tejo,LISBOA,1116,2654.36,161774,9562,9038,6952,4641,3812,8453,15405,24443,34005,6095.48,1281.27,920.99,580.44
13-05-2021,OEIRAS,80,6,45,"[0,120]",Baixo a Moderado,,,,80,Lisboa e Vale do Tejo,LISBOA,1110,4588.31,177408,11580,11575,8566,6211,5855,12066,20632,32207,43787,3866.78,954.38,701.98,449.69
13-05-2021,OLEIROS,0,0,0,"[0,120]",Baixo a Moderado,,,,0,Centro,CASTELO BRANCO,0506,47109.31,5003,384,341,366,397,487,884,1250,1591,1975,10.62,4.19,3.38,2.65
13-05-2021,OLHÃO,22,2,50,"[0,120]",Baixo a Moderado,,,,22,Algarve,FARO,0810,13086.38,44405,2455,2309,1689,1342,1268,2610,4299,6608,9063,339.33,69.26,50.5,32.85
13-05-2021,OLIVEIRA DE AZEMÉIS,51,4,77,"[0,120]",Baixo a Moderado,,,,51,Norte,AVEIRO,0113,16110.41,66011,4155,3614,2794,2183,1738,3921,6715,10329,14484,409.75,89.91,64.12,41.68
13-05-2021,OLIVEIRA DE FRADES,0,0,0,"[0,120]",Baixo a Moderado,,,,0,Centro,VISEU,1810,14534.62,9936,553,475,438,359,415,774,1212,1687,2240,68.36,15.41,11.61,8.34
13-05-2021,OLIVEIRA DO BAIRRO,6,0,25,"[0,120]",Baixo a Moderado,,,,6,Centro,AVEIRO,0114,8731.99,24277,1327,1182,999,786,810,1596,2595,3777,5104,278.02,58.45,43.25,29.72
13-05-2021,OLIVEIRA DO HOSPITAL,44,3,229,"[120,240]",Moderado,,,,44,Centro,COIMBRA,0611,23451.66,19253,1161,1097,962,924,960,1884,2846,3943,5104,82.1,21.76,16.81,12.14
13-05-2021,OURÉM,11,1,25,"[0,120]",Baixo a Moderado,,,,11,Lisboa e Vale do Tejo,SANTARÉM,1421,41668.03,44044,2463,2069,1899,1817,1603,3420,5319,7388,9851,105.7,23.64,17.73,12.77
13-05-2021,OURIQUE,0,0,0,"[0,120]",Baixo a Moderado,,,,0,Alentejo,BEJA,0212,66331.36,4607,313,287,284,268,227,495,779,1066,1379,6.95,2.08,1.61,1.17
13-05-2021,OVAR,12,1,22,"[0,120]",Baixo a Moderado,,,,12,Centro,AVEIRO,0115,14770.25,54260,3294,2709,1994,1636,1234,2870,4864,7573,10867,367.37,73.57,51.27,32.93
13-05-2021,PAÇOS DE FERREIRA,67,5,118,"[0,120]",Baixo a Moderado,,,,67,Norte,PORTO,1309,7099.29,56728,2903,2193,1518,1135,664,1799,3317,5510,8413,799.1,118.51,77.62,46.72
13-05-2021,PALMELA,3,0,5,"[0,120]",Baixo a Moderado,,,,3,Lisboa e Vale do Tejo,SETÚBAL,1508,46512.01,64269,3402,3244,2635,1846,1391,3237,5872,9116,12518,138.18,26.91,19.6,12.62
13-05-2021,PAMPILHOSA DA SERRA,1,0,25,"[0,120]",Baixo a Moderado,,,,1,Centro,COIMBRA,0612,39646.24,4037,238,254,295,339,423,762,1057,1311,1549,10.18,3.91,3.31,2.67
13-05-2021,PAREDES,93,7,108,"[0,120]",Baixo a Moderado,,,,93,Norte,PORTO,1310,15675.69,86067,4272,3532,2412,1717,1258,2975,5387,8919,13191,549.04,84.15,56.9,34.36
13-05-2021,PAREDES DE COURA,1,0,12,"[0,120]",Baixo a Moderado,,,,1,Norte,VIANA DO CASTELO,1605,13818.59,8535,466,528,407,465,515,980,1387,1915,2381,61.76,17.23,13.86,10.04
13-05-2021,PEDRÓGÃO GRANDE,2,0,59,"[0,120]",Baixo a Moderado,,,,2,Centro,LEIRIA,1013,12874.75,3410,175,173,196,221,252,473,669,842,1017,26.49,7.9,6.54,5.2
13-05-2021,PENACOVA,1,0,7,"[0,120]",Baixo a Moderado,,,,1,Centro,COIMBRA,0613,21673.23,13694,968,923,745,621,703,1324,2069,2992,3960,63.18,18.27,13.81,9.55
13-05-2021,PENAFIEL,63,4,90,"[0,120]",Baixo a Moderado,,,,63,Norte,PORTO,1311,21224.27,69772,3648,2823,2032,1663,1230,2893,4925,7748,11396,328.74,53.69,36.51,23.2
13-05-2021,PENALVA DO CASTELO,0,0,0,"[0,120]",Baixo a Moderado,,,,0,Centro,VISEU,1811,13433.92,7115,449,457,413,391,426,817,1230,1687,2136,52.96,15.9,12.56,9.16
13-05-2021,PENAMACOR,0,0,0,"[0,120]",Baixo a Moderado,,,,0,Centro,CASTELO BRANCO,0507,56370.69,4755,262,248,273,451,633,1084,1357,1605,1867,8.44,3.31,2.85,2.41
13-05-2021,PENEDONO,0,0,0,"[0,120]",Baixo a Moderado,,,,0,Norte,VISEU,1812,13370.75,2591,172,113,129,156,138,294,423,536,708,19.38,5.3,4.01,3.16
13-05-2021,PENELA,0,0,0,"[0,120]",Baixo a Moderado,,,,0,Centro,COIMBRA,0614,13480.0,5397,314,324,274,359,344,703,977,1301,1615,40.04,11.98,9.65,7.25
13-05-2021,PENICHE,24,2,91,"[0,120]",Baixo a Moderado,,,,24,Lisboa e Vale do Tejo,LEIRIA,1014,7754.98,26501,1746,1504,1203,926,707,1633,2836,4340,6086,341.73,78.48,55.96,36.57
13-05-2021,PESO DA RÉGUA,6,0,38,"[0,120]",Baixo a Moderado,,,,6,Norte,VILA REAL,1708,9486.01,15773,1076,843,650,659,455,1114,1764,2607,3683,166.28,38.83,27.48,18.6
13-05-2021,PINHEL,0,0,0,"[0,120]",Baixo a Moderado,,,,0,Centro,GUARDA,0910,48452.12,8511,577,566,551,538,689,1227,1778,2344,2921,17.57,6.03,4.84,3.67
13-05-2021,POMBAL,27,2,52,"[0,120]",Baixo a Moderado,,,,27,Centro,LEIRIA,1015,62600.28,51461,3187,2791,2494,2328,2027,4355,6849,9640,12827,82.21,20.49,15.4,10.94
13-05-2021,PONTA DELGADA,49,3,72,"[0,120]",Baixo a Moderado,,,,49,Açores,AÇORES,4203,23298.65,67935,3108,2435,1726,1133,902,2035,3761,6196,9304,291.58,39.93,26.59,16.14
13-05-2021,PONTA DO SOL,11,1,128,"[120,240]",Moderado,,,,11,Madeira,MADEIRA,3105,4622.03,8593,319,283,347,208,221,429,776,1059,1378,185.92,29.81,22.91,16.79
13-05-2021,PONTE DA BARCA,2,0,18,"[0,120]",Baixo a Moderado,,,,2,Norte,VIANA DO CASTELO,1606,18211.37,11180,635,576,517,554,490,1044,1561,2137,2772,61.39,15.22,11.73,8.57
13-05-2021,PONTE DE LIMA,18,1,44,"[0,120]",Baixo a Moderado,,,,18,Norte,VIANA DO CASTELO,1607,32025.46,41315,2321,2022,1720,1596,1462,3058,4778,6800,9121,129.01,28.48,21.23,14.92
13-05-2021,PONTE DE SOR,0,0,0,"[0,120]",Baixo a Moderado,,,,0,Alentejo,PORTALEGRE,1213,83971.16,14994,939,800,716,739,831,1570,2286,3086,4025,17.86,4.79,3.68,2.72
13-05-2021,PORTALEGRE,0,0,0,"[0,120]",Baixo a Moderado,,,,0,Alentejo,PORTALEGRE,1214,44713.64,22172,1577,1351,1137,993,984,1977,3114,4465,6042,49.59,13.51,9.99,6.96
13-05-2021,PORTEL,0,0,0,"[0,120]",Baixo a Moderado,,,,0,Alentejo,ÉVORA,0709,60100.57,5828,336,358,283,331,305,636,919,1277,1613,9.7,2.68,2.12,1.53
13-05-2021,PORTIMÃO,25,2,45,"[0,120]",Baixo a Moderado,,,,25,Algarve,FARO,0811,18206.29,55483,3182,2927,2116,1582,1400,2982,5098,8025,11207,304.75,61.56,44.08,28.0
13-05-2021,PORTO,130,9,60,"[0,120]",Baixo a Moderado,,,,130,Norte,PORTO,1312,4142.02,216606,15790,15193,11280,9409,10044,19453,30733,45926,61716,5229.5,1490.0,1108.79,741.98
13-05-2021,PORTO DE MÓS,10,1,43,"[0,120]",Baixo a Moderado,,,,10,Centro,LEIRIA,1016,26183.41,23275,1355,1210,1034,888,872,1760,2794,4004,5359,88.89,20.47,15.29,10.67
13-05-2021,PORTO MONIZ,0,0,0,"[0,120]",Baixo a Moderado,,,,0,Madeira,MADEIRA,3106,8293.38,2342,143,130,95,98,120,218,313,443,586,28.24,7.07,5.34,3.77
13-05-2021,PORTO SANTO,0,0,0,"[0,120]",Baixo a Moderado,,,,0,Madeira,MADEIRA,3201,4300.7,5202,240,157,134,110,68,178,312,469,709,120.95,16.48,10.9,7.25
13-05-2021,PÓVOA DE LANHOSO,8,1,37,"[0,120]",Baixo a Moderado,,,,8,Norte,BRAGA,0309,13465.29,21499,1175,909,732,673,624,1297,2029,2938,4113,159.67,30.55,21.82,15.07
13-05-2021,PÓVOA DE VARZIM,12,1,19,"[0,120]",Baixo a Moderado,,,,12,Norte,PORTO,1313,8220.59,62784,3712,3120,2134,1594,1305,2899,5033,8153,11865,763.7,144.33,99.17,61.22
13-05-2021,POVOAÇÃO,5,0,84,"[0,120]",Baixo a Moderado,,,,5,Açores,AÇORES,4204,10640.77,5927,293,212,191,144,134,278,469,681,974,55.7,9.15,6.4,4.41
13-05-2021,VILA DA PRAIA DA VITÓRIA,1,0,5,"[0,120]",Baixo a Moderado,,,,1,Açores,AÇORES,4302,16127.06,21317,1133,789,619,436,336,772,1391,2180,3313,132.18,20.54,13.52,8.63
13-05-2021,PROENÇA-A-NOVA,0,0,0,"[0,120]",Baixo a Moderado,,,,0,Centro,CASTELO BRANCO,0508,39539.96,7298,508,465,389,400,560,960,1349,1814,2322,18.46,5.87,4.59,3.41
13-05-2021,REDONDO,0,0,0,"[0,120]",Baixo a Moderado,,,,0,Alentejo,ÉVORA,0710,36950.87,6353,349,325,288,288,354,642,930,1255,1604,17.19,4.34,3.4,2.52
13-05-2021,REGUENGOS DE MONSARAZ,0,0,0,"[0,120]",Baixo a Moderado,,,,0,Alentejo,ÉVORA,0711,46399.72,10015,602,511,455,462,473,935,1390,1901,2503,21.58,5.39,4.1,3.0
13-05-2021,RESENDE,16,1,158,"[120,240]",Moderado,,,,16,Norte,VISEU,1813,12334.93,10137,560,493,448,433,422,855,1303,1796,2356,82.18,19.1,14.56,10.56
13-05-2021,RIBEIRA BRAVA,9,1,72,"[0,120]",Baixo a Moderado,,,,9,Madeira,MADEIRA,3107,6544.88,12435,648,500,411,311,287,598,1009,1509,2157,189.99,32.96,23.06,15.42
13-05-2021,RIBEIRA DE PENA,1,0,17,"[0,120]",Baixo a Moderado,,,,1,Norte,VILA REAL,1709,21745.98,6016,371,301,290,310,368,678,968,1269,1640,27.66,7.54,5.84,4.45
13-05-2021,RIBEIRA GRANDE,123,9,375,"[240,480]",Elevado,,,,123,Açores,AÇORES,4205,18015.13,32811,1163,689,512,345,253,598,1110,1799,2962,182.13,16.44,9.99,6.16
13-05-2021,RIO MAIOR,5,0,25,"[0,120]",Baixo a Moderado,,,,5,Lisboa e Vale do Tejo,SANTARÉM,1414,27276.45,20379,1251,1144,941,795,648,1443,2384,3528,4779,74.71,17.52,12.93,8.74
13-05-2021,SABROSA,0,0,0,"[0,120]",Baixo a Moderado,,,,0,Norte,VILA REAL,1710,15692.45,5918,393,314,304,302,350,652,956,1270,1663,37.71,10.6,8.09,6.09
13-05-2021,SABUGAL,0,0,0,"[0,120]",Baixo a Moderado,,,,0,Centro,GUARDA,0911,82269.82,10585,724,707,694,796,1009,1805,2499,3206,3930,12.87,4.78,3.9,3.04
13-05-2021,SALVATERRA DE MAGOS,2,0,9,"[0,120]",Baixo a Moderado,,,,2,Lisboa e Vale do Tejo,SANTARÉM,1415,24393.2,21295,1275,1181,1060,799,772,1571,2631,3812,5087,87.3,20.85,15.63,10.79
13-05-2021,SANTA COMBA DÃO,6,0,57,"[0,120]",Baixo a Moderado,,,,6,Centro,VISEU,1814,11194.77,10452,732,684,569,538,464,1002,1571,2255,2987,93.36,26.68,20.14,14.03
13-05-2021,SANTA CRUZ,39,3,86,"[0,120]",Baixo a Moderado,,,,39,Madeira,MADEIRA,3108,8150.28,45281,1817,1301,974,716,523,1239,2213,3514,5331,555.6,65.41,43.12,27.15
13-05-2021,SANTA CRUZ DA GRACIOSA,0,0,0,"[0,120]",Baixo a Moderado,,,,0,Açores,AÇORES,4401,6065.78,4208,228,180,163,124,145,269,432,612,840,69.37,13.85,10.09,7.12
13-05-2021,SANTA CRUZ DAS FLORES,0,0,0,"[0,120]",Baixo a Moderado,,,,0,Açores,AÇORES,4802,7091.44,2165,125,98,74,56,51,107,181,279,404,30.53,5.7,3.93,2.55
13-05-2021,SANTA MARIA DA FEIRA,18,1,13,"[0,120]",Baixo a Moderado,,,,18,Norte,AVEIRO,0109,21587.65,138636,8182,6743,4771,3856,3079,6935,11706,18449,26631,642.19,123.36,85.46,54.22
13-05-2021,SANTA MARTA DE PENAGUIÃO,3,0,45,"[0,120]",Baixo a Moderado,,,,3,Norte,VILA REAL,1711,6928.13,6599,483,373,337,316,317,633,970,1343,1826,95.25,26.36,19.39,14.0
13-05-2021,SANTANA,0,0,0,"[0,120]",Baixo a Moderado,,,,0,Madeira,MADEIRA,3109,9547.3,6711,418,353,343,282,277,559,902,1255,1673,70.29,17.52,13.15,9.45
13-05-2021,SANTARÉM,6,0,10,"[0,120]",Baixo a Moderado,,,,6,Lisboa e Vale do Tejo,SANTARÉM,1416,55253.58,57421,3654,3441,2760,2466,2206,4672,7432,10873,14527,103.92,26.29,19.68,13.45
13-05-2021,SANTIAGO DO CACÉM,6,0,21,"[0,120]",Baixo a Moderado,,,,6,Alentejo,SETÚBAL,1509,105969.29,28791,2144,1689,1472,1295,1215,2510,3982,5671,7815,27.17,7.37,5.35,3.76
13-05-2021,SANTO TIRSO,21,2,31,"[0,120]",Baixo a Moderado,,,,21,Norte,PORTO,1314,13655.52,68055,4911,3935,2761,2257,1810,4067,6828,10763,15674,498.35,114.78,78.82,50.0
13-05-2021,SÃO BRÁS DE ALPORTEL,2,0,19,"[0,120]",Baixo a Moderado,,,,2,Algarve,FARO,0812,15336.92,10416,596,468,467,404,401,805,1272,1740,2336,67.91,15.23,11.35,8.29
13-05-2021,SÃO JOÃO DA MADEIRA,2,0,9,"[0,120]",Baixo a Moderado,,,,2,Norte,AVEIRO,0116,794.3,21958,1347,1069,796,601,593,1194,1990,3059,4406,2765.49,554.91,385.26,250.63
13-05-2021,SÃO JOÃO DA PESQUEIRA,0,0,0,"[0,120]",Baixo a Moderado,,,,0,Norte,VISEU,1815,26610.85,7125,417,330,294,328,328,656,950,1280,1697,26.77,6.38,4.81,3.57
13-05-2021,SÃO PEDRO DO SUL,5,0,32,"[0,120]",Baixo a Moderado,,,,5,Centro,VISEU,1816,34895.09,15403,990,962,861,759,909,1668,2529,3491,4481,44.14,12.84,10.0,7.25
13-05-2021,SÃO ROQUE DO PICO,0,0,0,"[0,120]",Baixo a Moderado,,,,0,Açores,AÇORES,4603,14236.1,3266,199,141,93,96,113,209,302,443,642,22.94,4.51,3.11,2.12
13-05-2021,SÃO VICENTE,4,0,78,"[0,120]",Baixo a Moderado,,,,4,Madeira,MADEIRA,3110,7883.71,5143,272,264,266,225,280,505,771,1035,1307,65.23,16.58,13.13,9.78
13-05-2021,SARDOAL,0,0,0,"[0,120]",Baixo a Moderado,,,,0,Lisboa e Vale do Tejo,SANTARÉM,1417,9214.72,3741,227,178,148,165,248,413,561,739,966,40.6,10.48,8.02,6.09
13-05-2021,SÁTÃO,4,0,35,"[0,120]",Baixo a Moderado,,,,4,Centro,VISEU,1817,20194.11,11580,765,671,515,465,476,941,1456,2127,2892,57.34,14.32,10.53,7.21
13-05-2021,SEIA,1,0,4,"[0,120]",Baixo a Moderado,,,,1,Centro,GUARDA,0912,43568.83,22234,1807,1589,1238,1122,721,1843,3081,4670,6477,51.03,14.87,10.72,7.07
13-05-2021,SEIXAL,59,4,35,"[0,120]",Baixo a Moderado,,,,59,Lisboa e Vale do Tejo,SETÚBAL,1510,9545.17,167752,10586,9270,6661,4391,2930,7321,13982,23252,33838,1757.49,354.51,243.6,146.49
13-05-2021,SERNANCELHE,0,0,0,"[0,120]",Baixo a Moderado,,,,0,Norte,VISEU,1818,22861.22,5396,305,293,286,273,260,533,819,1112,1417,23.6,6.2,4.86,3.58
13-05-2021,SERPA,6,0,42,"[0,120]",Baixo a Moderado,,,,6,Alentejo,BEJA,0213,110563.34,14304,903,761,719,697,626,1323,2042,2803,3706,12.94,3.35,2.54,1.85
13-05-2021,SERTÃ,1,0,7,"[0,120]",Baixo a Moderado,,,,1,Centro,CASTELO BRANCO,0509,44673.17,14577,870,779,790,767,1020,1787,2577,3356,4226,32.63,9.46,7.51,5.77
13-05-2021,SESIMBRA,11,1,21,"[0,120]",Baixo a Moderado,,,,11,Lisboa e Vale do Tejo,SETÚBAL,1511,19571.75,51858,2400,2321,1853,1257,1083,2340,4193,6514,8914,264.96,45.54,33.28,21.42
13-05-2021,SETÚBAL,37,3,32,"[0,120]",Baixo a Moderado,,,,37,Lisboa e Vale do Tejo,SETÚBAL,1512,23032.5,115126,7425,6929,5075,3775,2655,6430,11505,18434,25859,499.83,112.27,80.03,49.95
13-05-2021,SEVER DO VOUGA,11,1,97,"[0,120]",Baixo a Moderado,,,,11,Centro,AVEIRO,0117,12987.56,11331,766,637,568,540,567,1107,1675,2312,3078,87.24,23.7,17.8,12.9
13-05-2021,SILVES,22,2,61,"[0,120]",Baixo a Moderado,,,,22,Algarve,FARO,0813,68006.23,36226,2137,1869,1610,1423,1600,3023,4633,6502,8639,53.27,12.7,9.56,6.81
13-05-2021,SINES,2,0,15,"[0,120]",Baixo a Moderado,,,,2,Alentejo,SETÚBAL,1513,20330.17,13715,888,791,551,416,268,684,1235,2026,2914,67.46,14.33,9.97,6.07
13-05-2021,SINTRA,133,10,34,"[0,120]",Baixo a Moderado,,,,133,Lisboa e Vale do Tejo,LISBOA,1111,31922.73,391402,20490,18316,13545,9137,7284,16421,29966,48282,68772,1226.08,215.43,151.25,93.87
13-05-2021,SOBRAL DE MONTE AGRAÇO,0,0,0,"[0,120]",Baixo a Moderado,,,,0,Lisboa e Vale do Tejo,LISBOA,1112,5210.32,10651,564,507,352,272,212,484,836,1343,1907,204.43,36.6,25.78,16.05
13-05-2021,SOURE,1,0,6,"[0,120]",Baixo a Moderado,,,,1,Centro,COIMBRA,0615,26506.07,17120,1173,1142,1004,883,987,1870,2874,4016,5189,64.59,19.58,15.15,10.84
13-05-2021,SOUSEL,0,0,0,"[0,120]",Baixo a Moderado,,,,0,Alentejo,PORTALEGRE,1215,27932.18,4412,261,274,208,302,292,594,802,1076,1337,15.8,4.79,3.85,2.87
13-05-2021,TÁBUA,11,1,97,"[0,120]",Baixo a Moderado,,,,11,Centro,COIMBRA,0616,19978.58,11368,729,584,524,430,464,894,1418,2002,2731,56.9,13.67,10.02,7.1
13-05-2021,TABUAÇO,2,0,33,"[0,120]",Baixo a Moderado,,,,2,Norte,VISEU,1819,13385.67,6033,372,314,217,282,363,645,862,1176,1548,45.07,11.56,8.79,6.44
13-05-2021,TAROUCA,7,1,90,"[0,120]",Baixo a Moderado,,,,7,Norte,VISEU,1820,10008.49,7804,405,335,313,277,324,601,914,1249,1654,77.98,16.53,12.48,9.13
13-05-2021,TAVIRA,19,1,77,"[0,120]",Baixo a Moderado,,,,19,Algarve,FARO,0814,60696.7,24530,1493,1415,1252,1066,1277,2343,3595,5010,6503,40.41,10.71,8.25,5.92
13-05-2021,TERRAS DE BOURO,0,0,0,"[0,120]",Baixo a Moderado,,,,0,Norte,BRAGA,0310,27746.07,6361,391,372,296,319,340,659,955,1327,1718,22.93,6.19,4.78,3.44
13-05-2021,TOMAR,9,1,24,"[0,120]",Baixo a Moderado,,,,9,Lisboa e Vale do Tejo,SANTARÉM,1418,35120.44,36748,2403,2189,1868,1853,1822,3675,5543,7732,10135,104.64,28.86,22.02,15.78
13-05-2021,TONDELA,0,0,0,"[0,120]",Baixo a Moderado,,,,0,Centro,VISEU,1821,37121.73,26357,1768,1722,1518,1475,1417,2892,4410,6132,7900,71.0,21.28,16.52,11.88
13-05-2021,TORRE DE MONCORVO,0,0,0,"[0,120]",Baixo a Moderado,,,,0,Norte,BRAGANÇA,0409,53155.67,7695,556,478,488,551,719,1270,1758,2236,2792,14.48,5.25,4.21,3.31
13-05-2021,TORRES NOVAS,7,0,20,"[0,120]",Baixo a Moderado,,,,7,Lisboa e Vale do Tejo,SANTARÉM,1419,26999.68,34933,2324,1979,1738,1406,1475,2881,4619,6598,8922,129.38,33.04,24.44,17.11
13-05-2021,TORRES VEDRAS,100,7,127,"[120,240]",Moderado,,,,100,Lisboa e Vale do Tejo,LISBOA,1113,40714.89,78530,4513,3945,3447,2628,2104,4732,8179,12124,16637,192.88,40.86,29.78,20.09
13-05-2021,TRANCOSO,0,0,0,"[0,120]",Baixo a Moderado,,,,0,Centro,GUARDA,0913,36152.47,8875,581,557,542,586,496,1082,1624,2181,2762,24.55,7.64,6.03,4.49
13-05-2021,TROFA,10,1,26,"[0,120]",Baixo a Moderado,,,,10,Norte,PORTO,1318,7201.76,38418,2336,1894,1231,939,684,1623,2854,4748,7084,533.44,98.36,65.93,39.63
13-05-2021,VAGOS,4,0,18,"[0,120]",Baixo a Moderado,,,,4,Centro,AVEIRO,0118,16491.5,22740,1320,1205,922,784,724,1508,2430,3635,4955,137.89,30.04,22.04,14.73
13-05-2021,VALE DE CAMBRA,30,2,141,"[120,240]",Moderado,,,,30,Norte,AVEIRO,0119,14733.47,21327,1491,1363,1005,831,798,1629,2634,3997,5488,144.76,37.25,27.13,17.88
13-05-2021,VALENÇA,2,0,15,"[0,120]",Baixo a Moderado,,,,2,Norte,VIANA DO CASTELO,1608,11712.86,13290,867,791,582,582,503,1085,1667,2458,3325,113.46,28.39,20.99,14.23
13-05-2021,VALONGO,90,6,92,"[0,120]",Baixo a Moderado,,,,90,Norte,PORTO,1315,7512.45,97444,5629,4696,3207,2462,1829,4291,7498,12194,17823,1297.18,237.26,162.33,99.81
13-05-2021,VALPAÇOS,9,1,61,"[0,120]",Baixo a Moderado,,,,9,Norte,VILA REAL,1712,54873.93,14818,1217,1118,999,928,997,1925,2924,4042,5259,27.0,9.58,7.37,5.33
13-05-2021,VELAS,0,0,0,"[0,120]",Baixo a Moderado,,,,0,Açores,AÇORES,4502,11738.38,5093,278,208,166,153,113,266,432,640,918,43.39,7.82,5.45,3.68
13-05-2021,VENDAS NOVAS,9,1,80,"[0,120]",Baixo a Moderado,,,,9,Alentejo,ÉVORA,0712,22238.88,11255,677,768,655,501,532,1033,1688,2456,3133,50.61,14.09,11.04,7.59
13-05-2021,VIANA DO ALENTEJO,0,0,0,"[0,120]",Baixo a Moderado,,,,0,Alentejo,ÉVORA,0713,39367.29,5145,245,208,235,210,214,424,659,867,1112,13.07,2.82,2.2,1.67
13-05-2021,VIANA DO CASTELO,80,6,95,"[0,120]",Baixo a Moderado,,,,80,Norte,VIANA DO CASTELO,1609,31902.01,84417,5470,4433,3591,3061,2982,6043,9634,14067,19537,264.61,61.24,44.09,30.2
13-05-2021,VIDIGUEIRA,1,0,18,"[0,120]",Baixo a Moderado,,,,1,Alentejo,BEJA,0214,31661.09,5510,300,248,215,233,275,508,723,971,1271,17.4,4.01,3.07,2.28
13-05-2021,VIEIRA DO MINHO,3,0,25,"[0,120]",Baixo a Moderado,,,,3,Norte,BRAGA,0311,21644.35,11842,703,594,525,548,482,1030,1555,2149,2852,54.71,13.18,9.93,7.18
13-05-2021,VILA DE REI,0,0,0,"[0,120]",Baixo a Moderado,,,,0,Centro,CASTELO BRANCO,0510,19154.6,3323,169,128,172,247,302,549,721,849,1018,17.35,5.31,4.43,3.76
13-05-2021,VILA DO BISPO,2,0,39,"[0,120]",Baixo a Moderado,,,,2,Algarve,FARO,0815,17906.06,5154,302,302,314,232,233,465,779,1081,1383,28.78,7.72,6.04,4.35
13-05-2021,VILA DO CONDE,18,1,23,"[0,120]",Baixo a Moderado,,,,18,Norte,PORTO,1316,14902.77,79899,4726,3875,2819,2070,1743,3813,6632,10507,15233,536.13,102.21,70.5,44.5
13-05-2021,VILA DO PORTO,2,0,36,"[0,120]",Baixo a Moderado,,,,2,Açores,AÇORES,4101,9688.74,5616,274,212,135,96,123,219,354,566,840,57.96,8.67,5.84,3.65
13-05-2021,VILA FLOR,0,0,0,"[0,120]",Baixo a Moderado,,,,0,Norte,BRAGANÇA,0410,26581.14,6044,429,362,422,294,331,625,1047,1409,1838,22.74,6.91,5.3,3.94
13-05-2021,VILA FRANCA DE XIRA,37,3,26,"[0,120]",Baixo a Moderado,,,,37,Lisboa e Vale do Tejo,LISBOA,1114,31819.39,141957,8501,6852,4869,3425,2472,5897,10766,17618,26119,446.14,82.09,55.37,33.84
13-05-2021,VILA FRANCA DO CAMPO,16,1,145,"[120,240]",Moderado,,,,16,Açores,AÇORES,4206,7796.82,11051,450,344,248,217,154,371,619,963,1413,141.73,18.12,12.35,7.94
13-05-2021,VILA NOVA DA BARQUINHA,1,0,13,"[0,120]",Baixo a Moderado,,,,1,Lisboa e Vale do Tejo,SANTARÉM,1420,4952.97,7461,415,406,392,364,338,702,1094,1500,1915,150.64,38.66,30.28,22.09
13-05-2021,VILA NOVA DE CERVEIRA,1,0,11,"[0,120]",Baixo a Moderado,,,,1,Norte,VIANA DO CASTELO,1610,10846.66,8910,531,444,410,384,334,718,1128,1572,2103,82.14,19.39,14.49,10.4
13-05-2021,VILA NOVA DE FAMALICÃO,57,4,43,"[0,120]",Baixo a Moderado,,,,57,Norte,BRAGA,0312,20159.26,131676,7817,6164,4202,3282,2749,6031,10233,16397,24214,653.19,120.12,81.34,50.76
13-05-2021,VILA NOVA DE FOZ CÔA,2,0,31,"[0,120]",Baixo a Moderado,,,,2,Centro,GUARDA,0914,39815.18,6503,442,385,390,398,429,827,1217,1602,2044,16.33,5.13,4.02,3.06
13-05-2021,VILA NOVA DE GAIA,207,15,69,"[0,120]",Baixo a Moderado,,,,207,Norte,PORTO,1317,16846.43,300472,18349,15568,10972,8224,6281,14505,25477,41045,59394,1783.64,352.57,243.65,151.23
13-05-2021,VILA NOVA DE PAIVA,1,0,21,"[0,120]",Baixo a Moderado,,,,1,Centro,VISEU,1822,17553.28,4687,289,272,233,217,241,458,691,963,1252,26.7,7.13,5.49,3.94
13-05-2021,VILA NOVA DE POIARES,10,1,144,"[120,240]",Moderado,,,,10,Centro,COIMBRA,0617,8445.3,6939,380,284,262,235,182,417,679,963,1343,82.17,15.9,11.4,8.04
13-05-2021,VILA POUCA DE AGUIAR,2,0,17,"[0,120]",Baixo a Moderado,,,,2,Norte,VILA REAL,1713,43706.62,11961,860,817,733,601,627,1228,1961,2778,3638,27.37,8.32,6.36,4.49
13-05-2021,VILA REAL,11,1,22,"[0,120]",Baixo a Moderado,,,,11,Norte,VILA REAL,1714,37880.28,49962,3025,2498,2065,1579,1466,3045,5110,7608,10633,131.9,28.07,20.08,13.49
13-05-2021,VILA REAL DE SANTO ANTÓNIO,10,1,53,"[0,120]",Baixo a Moderado,,,,10,Algarve,FARO,0816,6125.0,18749,1172,1069,811,569,586,1155,1966,3035,4207,306.11,68.69,49.55,32.1
13-05-2021,VILA VELHA DE RÓDÃO,0,0,0,"[0,120]",Baixo a Moderado,,,,0,Centro,CASTELO BRANCO,0511,32991.16,3144,209,229,180,283,306,589,769,998,1207,9.53,3.66,3.03,2.33
13-05-2021,VILA VERDE,31,2,66,"[0,120]",Baixo a Moderado,,,,31,Norte,BRAGA,0313,22866.52,46911,2365,2063,1667,1494,1437,2931,4598,6661,9026,205.15,39.47,29.13,20.11
13-05-2021,VILA VIÇOSA,0,0,0,"[0,120]",Baixo a Moderado,,,,0,Alentejo,ÉVORA,0714,19485.89,7656,487,379,342,345,324,669,1011,1390,1877,39.29,9.63,7.13,5.19
13-05-2021,VIMIOSO,0,0,0,"[0,120]",Baixo a Moderado,,,,0,Norte,BRAGANÇA,0411,48158.51,4023,274,230,261,293,335,628,889,1119,1393,8.35,2.89,2.32,1.85
13-05-2021,VINHAIS,2,0,26,"[0,120]",Baixo a Moderado,,,,2,Norte,BRAGANÇA,0412,69475.09,7746,599,577,636,641,815,1456,2092,2669,3268,11.15,4.7,3.84,3.01
13-05-2021,VISEU,21,2,22,"[0,120]",Baixo a Moderado,,,,21,Centro,VISEU,1823,50710.14,97249,5769,5038,4140,3158,2710,5868,10008,15046,20815,191.77,41.05,29.67,19.74
13-05-2021,VIZELA,2,0,8,"[0,120]",Baixo a Moderado,,,,2,Norte,BRAGA,0314,2469.83,23897,1258,928,655,509,371,880,1535,2463,3721,967.49,150.65,99.72,62.15
13-05-2021,VOUZELA,0,0,0,"[0,120]",Baixo a Moderado,,,,0,Centro,VISEU,1824,19369.46,9619,626,605,554,532,507,1039,1593,2198,2824,49.66,14.58,11.35,8.22
20-05-2021,ABRANTES,3,0,9,"[0,120]",Baixo a Moderado,,,,3,Lisboa e Vale do Tejo,SANTARÉM,1401,71469.08,35130,2473,2213,1730,1748,2021,3769,5499,7712,10185,49.15,14.25,10.79,7.69
20-05-2021,ÁGUEDA,5,0,11,"[0,120]",Baixo a Moderado,,,,5,Centro,AVEIRO,0101,33527.44,46075,3237,2713,2090,1635,1496,3131,5221,7934,11171,137.43,33.32,23.66,15.57
20-05-2021,AGUIAR DA BEIRA,0,0,0,"[0,120]",Baixo a Moderado,,,,0,Centro,GUARDA,0901,20676.57,4652,304,281,235,239,148,387,622,903,1207,22.5,5.84,4.37,3.01
20-05-2021,ALANDROAL,0,0,0,"[0,120]",Baixo a Moderado,,,,0,Alentejo,ÉVORA,0701,54267.81,4992,307,256,296,299,377,676,972,1228,1535,9.2,2.83,2.26,1.79
20-05-2021,ALBERGARIA-A-VELHA,3,0,12,"[0,120]",Baixo a Moderado,,,,3,Centro,AVEIRO,0102,15882.5,24144,1550,1298,996,687,680,1367,2363,3661,5211,152.02,32.81,23.05,14.88
20-05-2021,ALBUFEIRA,63,5,152,"[120,240]",Moderado,,,,63,Algarve,FARO,0801,14066.42,41528,2067,1717,1425,985,858,1843,3268,4985,7052,295.24,50.14,35.44,23.23
20-05-2021,ALCÁCER DO SAL,0,0,0,"[0,120]",Baixo a Moderado,,,,0,Alentejo,SETÚBAL,1501,149987.3,11659,884,814,623,623,602,1225,1848,2662,3546,7.77,2.36,1.77,1.23
20-05-2021,ALCANENA,7,1,55,"[0,120]",Baixo a Moderado,,,,7,Lisboa e Vale do Tejo,SANTARÉM,1402,12732.86,12809,891,744,628,536,588,1124,1752,2496,3387,100.6,26.6,19.6,13.76
20-05-2021,ALCOBAÇA,13,1,24,"[0,120]",Baixo a Moderado,,,,13,Lisboa e Vale do Tejo,LEIRIA,1001,40814.09,53555,3420,2927,2466,2059,1676,3735,6201,9128,12548,131.22,30.74,22.36,15.19
20-05-2021,ALCOCHETE,8,1,40,"[0,120]",Baixo a Moderado,,,,8,Lisboa e Vale do Tejo,SETÚBAL,1502,12836.48,19787,857,834,691,476,447,923,1614,2448,3305,154.15,25.75,19.07,12.57
20-05-2021,ALCOUTIM,0,0,0,"[0,120]",Baixo a Moderado,,,,0,Algarve,FARO,0802,57536.33,2159,191,188,163,190,267,457,620,808,999,3.75,1.74,1.4,1.08
20-05-2021,ALENQUER,17,1,39,"[0,120]",Baixo a Moderado,,,,17,Lisboa e Vale do Tejo,LISBOA,1101,30421.92,44052,2298,2062,1629,1330,1155,2485,4114,6176,8474,144.8,27.85,20.3,13.52
20-05-2021,ALFÂNDEGA DA FÉ,0,0,0,"[0,120]",Baixo a Moderado,,,,0,Norte,BRAGANÇA,0401,32194.64,4550,325,277,301,274,325,599,900,1177,1502,14.13,4.67,3.66,2.8
20-05-2021,ALIJÓ,11,1,104,"[0,120]",Baixo a Moderado,,,,11,Norte,VILA REAL,1701,29759.89,10625,766,687,635,542,666,1208,1843,2530,3296,35.7,11.08,8.5,6.19
20-05-2021,ALJEZUR,2,0,36,"[0,120]",Baixo a Moderado,,,,2,Algarve,FARO,0803,32349.95,5594,316,336,335,320,410,730,1065,1401,1717,17.29,5.31,4.33,3.29
20-05-2021,ALJUSTREL,0,0,0,"[0,120]",Baixo a Moderado,,,,0,Alentejo,BEJA,0201,45847.41,8247,635,521,443,347,358,705,1148,1669,2304,17.99,5.03,3.64,2.5
20-05-2021,ALMADA,76,5,45,"[0,120]",Baixo a Moderado,,,,76,Lisboa e Vale do Tejo,SETÚBAL,1503,7000.89,169039,10469,9777,7876,6144,5111,11255,19131,28908,39377,2414.5,562.45,412.91,273.26
20-05-2021,ALMEIDA,2,0,34,"[0,120]",Baixo a Moderado,,,,2,Centro,GUARDA,0902,51798.46,5830,441,419,396,458,393,851,1247,1666,2107,11.26,4.07,3.22,2.41
20-05-2021,ALMEIRIM,3,0,13,"[0,120]",Baixo a Moderado,,,,3,Lisboa e Vale do Tejo,SANTARÉM,1403,22212.05,22546,1342,1353,1106,866,843,1709,2815,4168,5510,101.5,24.81,18.76,12.67
20-05-2021,ALMODÔVAR,2,0,30,"[0,120]",Baixo a Moderado,,,,2,Alentejo,BEJA,0202,77788.03,6725,414,443,396,373,328,701,1097,1540,1954,8.65,2.51,1.98,1.41
20-05-2021,ALPIARÇA,3,0,42,"[0,120]",Baixo a Moderado,,,,3,Lisboa e Vale do Tejo,SANTARÉM,1404,9536.33,7059,515,486,363,333,274,607,970,1456,1971,74.02,20.67,15.27,10.17
20-05-2021,ALTER DO CHÃO,0,0,0,"[0,120]",Baixo a Moderado,,,,0,Alentejo,PORTALEGRE,1201,36206.62,3165,201,163,136,208,187,395,531,694,895,8.74,2.47,1.92,1.47
20-05-2021,ALVAIÁZERE,1,0,15,"[0,120]",Baixo a Moderado,,,,1,Centro,LEIRIA,1002,16047.76,6597,419,389,346,406,539,945,1291,1680,2099,41.11,13.08,10.47,8.04
20-05-2021,ALVITO,0,0,0,"[0,120]",Baixo a Moderado,,,,0,Alentejo,BEJA,0203,26485.32,2477,145,110,105,111,89,200,305,415,560,9.35,2.11,1.57,1.15
20-05-2021,AMADORA,72,5,39,"[0,120]",Baixo a Moderado,,,,72,Lisboa e Vale do Tejo,LISBOA,1115,2378.47,184106,11186,10936,8780,6460,5890,12350,21130,32066,43252,7742.05,1818.84,1348.44,888.56
20-05-2021,AMARANTE,11,1,21,"[0,120]",Baixo a Moderado,,,,11,Norte,PORTO,1301,30133.15,53193,3086,2413,1812,1643,1311,2954,4766,7179,10265,176.53,34.07,23.82,15.82
20-05-2021,AMARES,8,1,44,"[0,120]",Baixo a Moderado,,,,8,Norte,BRAGA,0301,8195.41,18129,1001,829,622,489,524,1013,1635,2464,3465,221.22,42.28,30.07,19.95
20-05-2021,ANADIA,3,0,11,"[0,120]",Baixo a Moderado,,,,3,Centro,AVEIRO,0103,21663.48,27258,1931,1698,1376,1208,1262,2470,3846,5544,7475,125.83,34.51,25.59,17.75
20-05-2021,ANGRA DO HEROÍSMO,1,0,3,"[0,120]",Baixo a Moderado,,,,1,Açores,AÇORES,4301,23899.66,33807,2006,1473,1122,768,635,1403,2525,3998,6004,141.45,25.12,16.73,10.56
20-05-2021,ANSIÃO,2,0,17,"[0,120]",Baixo a Moderado,,,,2,Centro,LEIRIA,1003,17609.42,12039,727,709,646,694,530,1224,1870,2579,3306,68.37,18.77,14.65,10.62
20-05-2021,ARCOS DE VALDEVEZ,14,1,67,"[0,120]",Baixo a Moderado,,,,14,Norte,VIANA DO CASTELO,1601,44759.64,20926,1329,1338,1282,1343,1515,2858,4140,5478,6807,46.75,15.21,12.24,9.25
20-05-2021,ARGANIL,67,5,608,"[480,960]",Muito Elevado,,,,67,Centro,COIMBRA,0601,33283.93,11014,672,648,612,559,596,1155,1767,2415,3087,33.09,9.27,7.26,5.31
20-05-2021,ARMAMAR,0,0,0,"[0,120]",Baixo a Moderado,,,,0,Norte,VISEU,1801,11723.73,5769,357,305,309,285,310,595,904,1209,1566,49.21,13.36,10.31,7.71
20-05-2021,AROUCA,7,1,34,"[0,120]",Baixo a Moderado,,,,7,Norte,AVEIRO,0104,32910.52,20720,1306,1047,753,683,683,1366,2119,3166,4472,62.96,13.59,9.62,6.44
20-05-2021,ARRAIOLOS,0,0,0,"[0,120]",Baixo a Moderado,,,,0,Alentejo,ÉVORA,0702,68374.55,6928,435,384,283,367,480,847,1130,1514,1949,10.13,2.85,2.21,1.65
20-05-2021,ARRONCHES,0,0,0,"[0,120]",Baixo a Moderado,,,,0,Alentejo,PORTALEGRE,1202,31464.72,2820,155,142,162,187,179,366,528,670,825,8.96,2.62,2.13,1.68
20-05-2021,ARRUDA DOS VINHOS,4,0,26,"[0,120]",Baixo a Moderado,,,,4,Lisboa e Vale do Tejo,LISBOA,1102,7795.93,15412,738,738,562,509,438,947,1509,2247,2985,197.69,38.29,28.82,19.36
20-05-2021,AVEIRO,18,1,23,"[0,120]",Baixo a Moderado,,,,18,Centro,AVEIRO,0105,19757.57,78734,4520,4004,3050,2250,2103,4353,7403,11407,15927,398.49,80.61,57.73,37.47
20-05-2021,AVIS,0,0,0,"[0,120]",Baixo a Moderado,,,,0,Alentejo,PORTALEGRE,1203,60596.51,4247,315,225,206,251,273,524,730,955,1270,7.01,2.1,1.58,1.2
20-05-2021,AZAMBUJA,12,1,53,"[0,120]",Baixo a Moderado,,,,12,Lisboa e Vale do Tejo,LISBOA,1103,26265.65,22716,1322,1171,1070,798,618,1416,2486,3657,4979,86.48,18.96,13.92,9.46
20-05-2021,BAIÃO,6,0,32,"[0,120]",Baixo a Moderado,,,,6,Norte,PORTO,1302,17452.83,18748,1070,862,714,686,725,1411,2125,2987,4057,107.42,23.25,17.11,12.18
20-05-2021,BARCELOS,78,6,67,"[0,120]",Baixo a Moderado,,,,78,Norte,BRAGA,0302,37890.14,116187,6721,5325,3619,2991,2562,5553,9172,14497,21218,306.64,56.0,38.26,24.21
20-05-2021,BARRANCOS,0,0,0,"[0,120]",Baixo a Moderado,,,,0,Alentejo,BEJA,0204,16841.73,1634,90,65,65,94,61,155,220,285,375,9.7,2.23,1.69,1.31
20-05-2021,BARREIRO,37,3,49,"[0,120]",Baixo a Moderado,,,,37,Lisboa e Vale do Tejo,SETÚBAL,1504,3639.07,75147,5194,5565,4459,3105,1767,4872,9331,14896,20090,2065.05,552.07,409.34,256.42
20-05-2021,BATALHA,4,0,25,"[0,120]",Baixo a Moderado,,,,4,Centro,LEIRIA,1004,10341.6,15963,873,762,649,529,549,1078,1727,2489,3362,154.35,32.51,24.07,16.7
20-05-2021,BEJA,10,1,30,"[0,120]",Baixo a Moderado,,,,10,Alentejo,BEJA,0205,114647.55,33579,2005,1840,1386,1272,1039,2311,3697,5537,7542,29.29,6.58,4.83,3.22
20-05-2021,BELMONTE,2,0,31,"[0,120]",Baixo a Moderado,,,,2,Centro,CASTELO BRANCO,0501,11875.91,6398,444,321,325,310,355,665,990,1311,1755,53.87,14.78,11.04,8.34
20-05-2021,BENAVENTE,8,1,26,"[0,120]",Baixo a Moderado,,,,8,Lisboa e Vale do Tejo,SANTARÉM,1405,52138.39,30602,1468,1376,1141,876,643,1519,2660,4036,5504,58.69,10.56,7.74,5.1
20-05-2021,BOMBARRAL,0,0,0,"[0,120]",Baixo a Moderado,,,,0,Lisboa e Vale do Tejo,LEIRIA,1005,9128.55,12558,875,714,561,491,429,920,1481,2195,3070,137.56,33.63,24.04,16.22
20-05-2021,BORBA,0,0,0,"[0,120]",Baixo a Moderado,,,,0,Alentejo,ÉVORA,0703,14518.65,6736,430,375,279,436,392,828,1107,1482,1912,46.39,13.17,10.21,7.62
20-05-2021,BOTICAS,0,0,0,"[0,120]",Baixo a Moderado,,,,0,Norte,VILA REAL,1702,32195.66,4998,347,306,311,305,380,685,996,1302,1649,15.52,5.12,4.04,3.09
20-05-2021,BRAGA,161,11,88,"[0,120]",Baixo a Moderado,,,,161,Norte,BRAGA,0303,18339.95,182679,10029,7963,5241,4320,3671,7991,13232,21195,31224,996.07,170.25,115.57,72.15
20-05-2021,BRAGANÇA,32,2,95,"[0,120]",Baixo a Moderado,,,,32,Norte,BRAGANÇA,0402,117357.27,33607,2402,1855,1652,1393,1163,2556,4208,6063,8465,28.64,7.21,5.17,3.59
20-05-2021,CABECEIRAS DE BASTO,8,1,51,"[0,120]",Baixo a Moderado,,,,8,Norte,BRAGA,0304,24182.16,15628,774,594,544,575,574,1149,1693,2287,3061,64.63,12.66,9.46,7.0
20-05-2021,CADAVAL,2,0,15,"[0,120]",Baixo a Moderado,,,,2,Lisboa e Vale do Tejo,LISBOA,1104,17489.3,13673,813,796,756,621,625,1246,2002,2798,3611,78.18,20.65,16.0,11.45
20-05-2021,CALDAS DA RAINHA,9,1,17,"[0,120]",Baixo a Moderado,,,,9,Lisboa e Vale do Tejo,LEIRIA,1006,25569.47,51912,3035,2684,2186,1899,1705,3604,5790,8474,11509,203.03,45.01,33.14,22.64
20-05-2021,CALHETA,1,0,9,"[0,120]",Baixo a Moderado,,,,1,Madeira,MADEIRA,3101,11150.43,10867,576,497,507,399,415,814,1321,1818,2394,97.46,21.47,16.3,11.85
20-05-2021,CALHETA (AÇORES),0,0,0,"[0,120]",Baixo a Moderado,,,,0,Açores,AÇORES,4501,12626.4,3184,215,159,141,139,122,261,402,561,776,25.22,6.15,4.44,3.18
20-05-2021,CÂMARA DE LOBOS,13,1,39,"[0,120]",Baixo a Moderado,,,,13,Madeira,MADEIRA,3102,5216.67,33675,1396,1059,834,545,381,926,1760,2819,4215,645.49,80.79,54.03,33.74
20-05-2021,CAMINHA,2,0,13,"[0,120]",Baixo a Moderado,,,,2,Norte,VIANA DO CASTELO,1602,13652.14,15877,1046,944,818,646,656,1302,2120,3064,4110,116.3,30.11,22.44,15.53
20-05-2021,CAMPO MAIOR,7,1,89,"[0,120]",Baixo a Moderado,,,,7,Alentejo,PORTALEGRE,1204,24720.16,7874,471,364,351,279,327,606,957,1321,1792,31.85,7.25,5.34,3.87
20-05-2021,CANTANHEDE,17,1,49,"[0,120]",Baixo a Moderado,,,,17,Centro,COIMBRA,0602,39088.02,35011,2346,2096,1880,1709,1451,3160,5040,7136,9482,89.57,24.26,18.26,12.89
20-05-2021,CARRAZEDA DE ANSIÃES,2,0,35,"[0,120]",Baixo a Moderado,,,,2,Norte,BRAGANÇA,0403,27924.09,5666,424,389,391,312,465,777,1168,1557,1981,20.29,7.09,5.58,4.18
20-05-2021,CARREGAL DO SAL,3,0,32,"[0,120]",Baixo a Moderado,,,,3,Centro,VISEU,1802,11689.21,9271,587,562,486,462,376,838,1324,1886,2473,79.31,21.16,16.13,11.33
20-05-2021,CARTAXO,14,1,59,"[0,120]",Baixo a Moderado,,,,14,Lisboa e Vale do Tejo,SANTARÉM,1406,15817.28,23843,1415,1376,1142,861,632,1493,2635,4011,5426,150.74,34.3,25.36,16.66
20-05-2021,CASCAIS,100,7,47,"[0,120]",Baixo a Moderado,,,,100,Lisboa e Vale do Tejo,LISBOA,1105,9740.17,213608,12151,11444,8680,6469,5248,11717,20397,31841,43992,2193.1,451.66,326.91,209.41
20-05-2021,CASTANHEIRA DE PÊRA,0,0,0,"[0,120]",Baixo a Moderado,,,,0,Centro,LEIRIA,1007,6677.45,2614,233,195,157,190,187,377,534,729,962,39.15,14.41,10.92,8.0
20-05-2021,CASTELO BRANCO,5,0,10,"[0,120]",Baixo a Moderado,,,,5,Centro,CASTELO BRANCO,0502,143819.15,51987,3528,3042,2499,2229,2225,4454,6953,9995,13523,36.15,9.4,6.95,4.83
20-05-2021,CASTELO DE PAIVA,35,2,226,"[120,240]",Moderado,,,,35,Norte,AVEIRO,0106,11500.53,15454,881,697,545,420,431,851,1396,2093,2974,134.37,25.86,18.2,12.14
20-05-2021,CASTELO DE VIDE,0,0,0,"[0,120]",Baixo a Moderado,,,,0,Alentejo,PORTALEGRE,1205,26491.24,2919,204,173,179,147,170,317,496,669,873,11.02,3.3,2.53,1.87
20-05-2021,CASTRO DAIRE,2,0,14,"[0,120]",Baixo a Moderado,,,,2,Centro,VISEU,1803,37904.13,13823,942,857,765,732,773,1505,2270,3127,4069,36.47,10.74,8.25,5.99
20-05-2021,CASTRO MARIM,3,0,48,"[0,120]",Baixo a Moderado,,,,3,Algarve,FARO,0804,30084.37,6237,370,345,334,322,344,666,1000,1345,1715,20.73,5.7,4.47,3.32
20-05-2021,CASTRO VERDE,0,0,0,"[0,120]",Baixo a Moderado,,,,0,Alentejo,BEJA,0206,56944.23,6949,437,347,303,275,227,502,805,1152,1589,12.2,2.79,2.02,1.41
20-05-2021,CELORICO DA BEIRA,0,0,0,"[0,120]",Baixo a Moderado,,,,0,Centro,GUARDA,0903,24721.63,6928,430,416,363,369,535,904,1267,1683,2113,28.02,8.55,6.81,5.12
20-05-2021,CELORICO DE BASTO,5,0,26,"[0,120]",Baixo a Moderado,,,,5,Norte,BRAGA,0305,18107.02,19040,1001,802,668,728,729,1457,2125,2927,3928,105.15,21.69,16.17,11.74
20-05-2021,CHAMUSCA,8,1,87,"[0,120]",Baixo a Moderado,,,,8,Lisboa e Vale do Tejo,SANTARÉM,1407,74600.54,9197,629,583,553,465,579,1044,1597,2180,2809,12.33,3.77,2.92,2.14
20-05-2021,CHAVES,22,2,56,"[0,120]",Baixo a Moderado,,,,22,Norte,VILA REAL,1703,59122.95,39343,2676,2429,1991,1886,1918,3804,5795,8224,10900,66.54,18.44,13.91,9.8
20-05-2021,CINFÃES,15,1,82,"[0,120]",Baixo a Moderado,,,,15,Norte,VISEU,1804,23928.76,18244,1067,902,779,734,758,1492,2271,3173,4240,76.24,17.72,13.26,9.49
20-05-2021,COIMBRA,17,1,13,"[0,120]",Baixo a Moderado,,,,17,Centro,COIMBRA,0603,31939.94,134166,9489,8734,6353,5139,5074,10213,16566,25300,34789,420.06,108.92,79.21,51.87
20-05-2021,CONDEIXA-A-NOVA,1,0,6,"[0,120]",Baixo a Moderado,,,,1,Centro,COIMBRA,0604,13867.47,17733,871,809,717,583,490,1073,1790,2599,3470,127.88,25.02,18.74,12.91
20-05-2021,CONSTÂNCIA,2,0,50,"[0,120]",Baixo a Moderado,,,,2,Lisboa e Vale do Tejo,SANTARÉM,1408,8036.58,4030,211,183,187,148,155,303,490,673,884,50.14,11.0,8.37,6.1
20-05-2021,CORUCHE,7,0,40,"[0,120]",Baixo a Moderado,,,,7,Lisboa e Vale do Tejo,SANTARÉM,1409,111572.03,17471,1294,1090,1095,1096,1019,2115,3210,4300,5594,15.66,5.01,3.85,2.88
20-05-2021,CORVO,0,0,0,"[0,120]",Baixo a Moderado,,,,0,Açores,AÇORES,4901,1711.45,464,22,21,11,13,19,32,43,64,86,27.12,5.03,3.74,2.51
20-05-2021,COVILHÃ,15,1,32,"[0,120]",Baixo a Moderado,,,,15,Centro,CASTELO BRANCO,0503,55560.06,46787,3533,2998,2365,2111,2193,4304,6669,9667,13200,84.21,23.76,17.4,12.0
20-05-2021,CRATO,0,0,0,"[0,120]",Baixo a Moderado,,,,0,Alentejo,PORTALEGRE,1206,39806.88,3129,229,258,163,182,228,410,573,831,1060,7.86,2.66,2.09,1.44
20-05-2021,CUBA,1,0,22,"[0,120]",Baixo a Moderado,,,,1,Alentejo,BEJA,0207,17208.72,4595,255,233,206,190,143,333,539,772,1027,26.7,5.97,4.49,3.13
20-05-2021,ELVAS,7,0,34,"[0,120]",Baixo a Moderado,,,,7,Alentejo,PORTALEGRE,1207,63128.86,20528,1057,1145,902,852,810,1662,2564,3709,4766,32.52,7.55,5.88,4.06
20-05-2021,ENTRONCAMENTO,12,1,56,"[0,120]",Baixo a Moderado,,,,12,Lisboa e Vale do Tejo,SANTARÉM,1410,1372.81,21558,1066,930,868,695,592,1287,2155,3085,4151,1570.14,302.33,224.69,156.96
20-05-2021,ESPINHO,2,0,7,"[0,120]",Baixo a Moderado,,,,2,Norte,AVEIRO,0107,2105.68,29516,2205,1993,1430,1177,960,2137,3567,5560,7765,1401.52,368.71,264.01,169.37
20-05-2021,ESPOSENDE,16,1,47,"[0,120]",Baixo a Moderado,,,,16,Norte,BRAGA,0306,9540.98,34177,1831,1522,1095,894,723,1617,2712,4234,6065,358.21,63.57,44.38,28.42
20-05-2021,ESTARREJA,3,0,12,"[0,120]",Baixo a Moderado,,,,3,Centro,AVEIRO,0108,10817.33,26006,1503,1399,1106,953,728,1681,2787,4186,5689,240.42,52.59,38.7,25.76
20-05-2021,ESTREMOZ,0,0,0,"[0,120]",Baixo a Moderado,,,,0,Alentejo,ÉVORA,0704,51379.95,12728,789,613,697,786,877,1663,2360,2973,3762,24.77,7.32,5.79,4.59
20-05-2021,ÉVORA,26,2,50,"[0,120]",Baixo a Moderado,,,,26,Alentejo,ÉVORA,0705,130707.58,52428,3569,2852,2176,1966,1803,3769,5945,8797,12366,40.11,9.46,6.73,4.55
20-05-2021,FAFE,58,4,121,"[120,240]",Moderado,,,,58,Norte,BRAGA,0307,21908.11,48060,3044,2455,1679,1403,1208,2611,4290,6745,9789,219.37,44.68,30.79,19.58
20-05-2021,FARO,55,4,90,"[0,120]",Baixo a Moderado,,,,55,Algarve,FARO,0805,20256.79,61015,3847,3364,2604,2055,1601,3656,6260,9624,13471,301.2,66.5,47.51,30.9
20-05-2021,FELGUEIRAS,27,2,48,"[0,120]",Baixo a Moderado,,,,27,Norte,PORTO,1303,11573.75,56422,2951,2302,1601,1316,973,2289,3890,6192,9143,487.49,79.0,53.5,33.61
20-05-2021,FERREIRA DO ALENTEJO,7,0,89,"[0,120]",Baixo a Moderado,,,,7,Alentejo,BEJA,0208,64820.68,7845,515,414,372,343,345,688,1060,1474,1989,12.1,3.07,2.27,1.64
20-05-2021,FERREIRA DO ZÊZERE,0,0,0,"[0,120]",Baixo a Moderado,,,,0,Lisboa e Vale do Tejo,SANTARÉM,1411,19038.03,7959,470,370,416,465,456,921,1337,1707,2177,41.81,11.44,8.97,7.02
20-05-2021,FIGUEIRA DA FOZ,43,3,73,"[0,120]",Baixo a Moderado,,,,43,Centro,COIMBRA,0605,37905.26,58747,4032,3597,2887,2495,2043,4538,7425,11022,15054,154.98,39.72,29.08,19.59
20-05-2021,FIGUEIRA DE CASTELO RODRIGO,0,0,0,"[0,120]",Baixo a Moderado,,,,0,Centro,GUARDA,0904,50857.46,5584,347,352,290,352,391,743,1033,1385,1732,10.98,3.41,2.72,2.03
20-05-2021,FIGUEIRÓ DOS VINHOS,0,0,0,"[0,120]",Baixo a Moderado,,,,0,Centro,LEIRIA,1008,17344.0,5568,402,386,322,309,351,660,982,1368,1770,32.1,10.21,7.89,5.66
20-05-2021,FORNOS DE ALGODRES,0,0,0,"[0,120]",Baixo a Moderado,,,,0,Centro,GUARDA,0905,13145.05,4528,261,218,247,256,232,488,735,953,1214,34.45,9.24,7.25,5.59
20-05-2021,FREIXO DE ESPADA À CINTA,1,0,30,"[0,120]",Baixo a Moderado,,,,1,Norte,BRAGANÇA,0404,24414.29,3298,211,177,231,196,189,385,616,793,1004,13.51,4.11,3.25,2.52
20-05-2021,FRONTEIRA,0,0,0,"[0,120]",Baixo a Moderado,,,,0,Alentejo,PORTALEGRE,1208,24859.58,2974,213,182,149,156,168,324,473,655,868,11.96,3.49,2.63,1.9
20-05-2021,FUNCHAL,145,10,139,"[120,240]",Moderado,,,,145,Madeira,MADEIRA,3103,7616.2,104024,6382,5086,3643,2821,1990,4811,8454,13540,19922,1365.86,261.58,177.78,111.0
20-05-2021,FUNDÃO,1,0,4,"[0,120]",Baixo a Moderado,,,,1,Centro,CASTELO BRANCO,0504,70019.79,26495,1781,1464,1432,1357,1643,3000,4432,5896,7677,37.84,10.96,8.42,6.33
20-05-2021,GAVIÃO,0,0,0,"[0,120]",Baixo a Moderado,,,,0,Alentejo,PORTALEGRE,1209,29459.45,3263,189,186,222,263,293,556,778,964,1153,11.08,3.91,3.27,2.64
20-05-2021,GÓIS,3,0,79,"[0,120]",Baixo a Moderado,,,,3,Centro,COIMBRA,0606,26330.19,3805,235,199,240,233,244,477,717,916,1151,14.45,4.37,3.48,2.72
20-05-2021,GOLEGÃ,13,1,243,"[240,480]",Elevado,,,,13,Lisboa e Vale do Tejo,SANTARÉM,1412,8431.67,5339,356,299,281,243,255,498,779,1078,1434,63.32,17.01,12.78,9.24
20-05-2021,GONDOMAR,93,7,56,"[0,120]",Baixo a Moderado,,,,93,Norte,PORTO,1304,13191.76,165985,10555,8755,6222,4450,3364,7814,14036,22791,33346,1258.22,252.77,172.76,106.4
20-05-2021,GOUVEIA,13,1,105,"[0,120]",Baixo a Moderado,,,,13,Centro,GUARDA,0906,30061.17,12387,871,931,780,783,810,1593,2373,3304,4175,41.21,13.89,10.99,7.89
20-05-2021,GRÂNDOLA,3,0,20,"[0,120]",Baixo a Moderado,,,,3,Alentejo,SETÚBAL,1505,82593.66,14639,834,834,708,688,672,1360,2068,2902,3736,17.72,4.52,3.51,2.5
20-05-2021,GUARDA,7,1,18,"[0,120]",Baixo a Moderado,,,,7,Centro,GUARDA,0907,71209.58,38969,2477,2041,1686,1415,1474,2889,4575,6616,9093,54.72,12.77,9.29,6.42
20-05-2021,GUIMARÃES,44,3,29,"[0,120]",Baixo a Moderado,,,,44,Norte,BRAGA,0308,24099.96,152309,9394,7074,4809,3877,2948,6825,11634,18708,28102,631.99,116.61,77.63,48.27
20-05-2021,HORTA,0,0,0,"[0,120]",Baixo a Moderado,,,,0,Açores,AÇORES,4701,17305.53,14521,818,658,468,352,302,654,1122,1780,2598,83.91,15.01,10.29,6.48
20-05-2021,IDANHA-A-NOVA,1,0,12,"[0,120]",Baixo a Moderado,,,,1,Centro,CASTELO BRANCO,0505,141633.51,8043,518,490,519,672,974,1646,2165,2655,3173,5.68,2.24,1.87,1.53
20-05-2021,ÍLHAVO,6,0,16,"[0,120]",Baixo a Moderado,,,,6,Centro,AVEIRO,0110,7347.55,38699,2227,1943,1444,1193,850,2043,3487,5430,7657,526.66,104.21,73.9,47.46
20-05-2021,LAGOA (FARO),41,3,180,"[120,240]",Moderado,,,,41,Algarve,FARO,0806,8825.45,22762,1314,1168,919,749,670,1419,2338,3506,4820,257.93,54.62,39.73,26.49
20-05-2021,LAGOA,6,0,41,"[0,120]",Baixo a Moderado,,,,6,Açores,AÇORES,4201,4559.32,14721,536,458,349,238,235,473,822,1280,1816,322.9,39.83,28.08,18.03
20-05-2021,LAGOS,13,1,43,"[0,120]",Baixo a Moderado,,,,13,Algarve,FARO,0807,21299.27,30374,1744,1434,1247,1053,1029,2082,3329,4763,6507,142.61,30.55,22.36,15.63
20-05-2021,LAJES DAS FLORES,2,0,137,"[120,240]",Moderado,,,,2,Açores,AÇORES,4801,7004.79,1463,88,53,62,46,54,100,162,215,303,20.89,4.33,3.07,2.31
20-05-2021,LAJES DO PICO,0,0,0,"[0,120]",Baixo a Moderado,,,,0,Açores,AÇORES,4601,15531.09,4490,304,231,223,159,162,321,544,775,1079,28.91,6.95,4.99,3.5
20-05-2021,LAMEGO,45,3,181,"[120,240]",Moderado,,,,45,Norte,VISEU,1805,16542.11,24895,1639,1284,1124,898,783,1681,2805,4089,5728,150.5,34.63,24.72,16.96
20-05-2021,LEIRIA,33,2,26,"[0,120]",Baixo a Moderado,,,,33,Centro,LEIRIA,1009,56508.83,125267,7389,6366,5090,3902,3159,7061,12151,18517,25906,221.68,45.84,32.77,21.5
20-05-2021,LISBOA,601,43,118,"[0,120]",Baixo a Moderado,,,,601,Lisboa e Vale do Tejo,LISBOA,1106,10005.43,509515,33197,33340,27706,23037,26770,49807,77513,110853,144050,5092.6,1439.78,1107.98,774.74
20-05-2021,LOULÉ,47,3,68,"[0,120]",Baixo a Moderado,,,,47,Algarve,FARO,0808,76366.91,68697,3890,3350,2780,2358,2251,4609,7389,10739,14629,89.96,19.16,14.06,9.68
20-05-2021,LOURES,79,6,37,"[0,120]",Baixo a Moderado,,,,79,Lisboa e Vale do Tejo,LISBOA,1107,16723.99,213687,12746,12794,9644,6669,5033,11702,21346,34140,46886,1277.73,280.35,204.14,127.64
20-05-2021,LOURINHÃ,10,1,39,"[0,120]",Baixo a Moderado,,,,10,Lisboa e Vale do Tejo,LISBOA,1108,14717.2,25855,1584,1243,992,842,645,1487,2479,3722,5306,175.68,36.05,25.29,16.84
20-05-2021,LOUSÃ,7,1,41,"[0,120]",Baixo a Moderado,,,,7,Centro,COIMBRA,0607,13840.01,17158,946,866,658,528,450,978,1636,2502,3448,123.97,24.91,18.08,11.82
20-05-2021,LOUSADA,26,2,56,"[0,120]",Baixo a Moderado,,,,26,Norte,PORTO,1305,9608.01,46755,2289,1698,1176,853,621,1474,2650,4348,6637,486.63,69.08,45.25,27.58
20-05-2021,MAÇÃO,0,0,0,"[0,120]",Baixo a Moderado,,,,0,Lisboa e Vale do Tejo,SANTARÉM,1413,39997.98,6267,386,362,390,440,657,1097,1487,1849,2235,15.67,5.59,4.62,3.72
20-05-2021,MACEDO DE CAVALEIROS,4,0,28,"[0,120]",Baixo a Moderado,,,,4,Norte,BRAGANÇA,0405,69914.08,14516,1082,889,878,823,938,1761,2639,3528,4610,20.76,6.59,5.05,3.77
20-05-2021,MACHICO,19,1,95,"[0,120]",Baixo a Moderado,,,,19,Madeira,MADEIRA,3104,6825.1,19981,1197,860,662,455,331,786,1448,2308,3505,292.76,51.36,33.82,21.22
20-05-2021,MADALENA,0,0,0,"[0,120]",Baixo a Moderado,,,,0,Açores,AÇORES,4602,14712.33,5895,334,256,173,190,179,369,542,798,1132,40.07,7.69,5.42,3.68
20-05-2021,MAFRA,24,2,28,"[0,120]",Baixo a Moderado,,,,24,Lisboa e Vale do Tejo,LISBOA,1109,29165.5,84816,3613,3334,2839,2089,1899,3988,6827,10161,13774,290.81,47.23,34.84,23.41
20-05-2021,MAIA,56,4,40,"[0,120]",Baixo a Moderado,,,,56,Norte,PORTO,1306,8293.94,138971,7801,6617,4512,3339,2631,5970,10482,17099,24900,1675.56,300.22,206.16,126.38
20-05-2021,MANGUALDE,10,1,54,"[0,120]",Baixo a Moderado,,,,10,Centro,VISEU,1806,21925.56,18510,1198,1128,885,852,743,1595,2480,3608,4806,84.42,21.92,16.46,11.31
20-05-2021,MANTEIGAS,0,0,0,"[0,120]",Baixo a Moderado,,,,0,Centro,GUARDA,0908,12197.55,3007,258,197,159,167,146,313,472,669,927,24.65,7.6,5.48,3.87
20-05-2021,MARCO DE CANAVESES,26,2,50,"[0,120]",Baixo a Moderado,,,,26,Norte,PORTO,1307,20188.98,51496,2678,2060,1488,1265,1023,2288,3776,5836,8514,255.07,42.17,28.91,18.7
20-05-2021,MARINHA GRANDE,3,0,8,"[0,120]",Baixo a Moderado,,,,3,Centro,LEIRIA,1010,18725.19,38508,2365,2302,1638,1359,1058,2417,4055,6357,8722,205.65,46.58,33.95,21.66
20-05-2021,MARVÃO,0,0,0,"[0,120]",Baixo a Moderado,,,,0,Alentejo,PORTALEGRE,1210,15489.9,3005,198,185,142,197,237,434,576,761,959,19.4,6.19,4.91,3.72
20-05-2021,MATOSINHOS,93,7,53,"[0,120]",Baixo a Moderado,,,,93,Norte,PORTO,1308,6241.97,175357,11850,9977,7023,5024,3884,8908,15931,25908,37758,2809.31,604.9,415.06,255.22
20-05-2021,MEALHADA,3,0,15,"[0,120]",Baixo a Moderado,,,,3,Centro,AVEIRO,0111,11065.66,19914,1163,1039,810,828,831,1659,2469,3508,4671,179.96,42.21,31.7,22.31
20-05-2021,MÊDA,1,0,22,"[0,120]",Baixo a Moderado,,,,1,Centro,GUARDA,0909,28604.92,4587,343,306,290,288,443,731,1021,1327,1670,16.04,5.84,4.64,3.57
20-05-2021,MELGAÇO,3,0,37,"[0,120]",Baixo a Moderado,,,,3,Norte,VIANA DO CASTELO,1603,23824.58,8093,507,567,578,614,675,1289,1867,2434,2941,33.97,12.34,10.22,7.84
20-05-2021,MÉRTOLA,0,0,0,"[0,120]",Baixo a Moderado,,,,0,Alentejo,BEJA,0209,129287.34,6142,400,390,378,423,600,1023,1401,1791,2191,4.75,1.69,1.39,1.08
20-05-2021,MESÃO FRIO,0,0,0,"[0,120]",Baixo a Moderado,,,,0,Norte,VILA REAL,1704,2664.87,3964,265,205,168,157,120,277,445,650,915,148.74,34.33,24.39,16.7
20-05-2021,MIRA,1,0,8,"[0,120]",Baixo a Moderado,,,,1,Centro,COIMBRA,0608,12403.38,11832,727,729,659,550,466,1016,1675,2404,3131,95.4,25.24,19.38,13.5
20-05-2021,MIRANDA DO CORVO,2,0,16,"[0,120]",Baixo a Moderado,,,,2,Centro,COIMBRA,0609,12637.79,12708,706,659,568,498,404,902,1470,2129,2835,100.55,22.43,16.85,11.63
20-05-2021,MIRANDA DO DOURO,1,0,15,"[0,120]",Baixo a Moderado,,,,1,Norte,BRAGANÇA,0406,48718.31,6830,482,429,442,463,470,933,1375,1804,2286,14.02,4.69,3.7,2.82
20-05-2021,MIRANDELA,0,0,0,"[0,120]",Baixo a Moderado,,,,0,Norte,BRAGANÇA,0407,65895.67,21754,1640,1315,1204,1078,947,2025,3229,4544,6184,33.01,9.38,6.9,4.9
20-05-2021,MOGADOURO,0,0,0,"[0,120]",Baixo a Moderado,,,,0,Norte,BRAGANÇA,0408,76064.93,8392,589,529,576,630,655,1285,1861,2390,2979,11.03,3.92,3.14,2.45
20-05-2021,MOIMENTA DA BEIRA,1,0,10,"[0,120]",Baixo a Moderado,,,,1,Norte,VISEU,1807,21996.9,9736,576,514,471,416,461,877,1348,1862,2438,44.26,11.08,8.46,6.13
20-05-2021,MOITA,20,1,31,"[0,120]",Baixo a Moderado,,,,20,Lisboa e Vale do Tejo,SETÚBAL,1506,5525.98,64407,4226,3646,2623,1801,1425,3226,5849,9495,13721,1165.53,248.3,171.82,105.85
20-05-2021,MONÇÃO,9,1,50,"[0,120]",Baixo a Moderado,,,,9,Norte,VIANA DO CASTELO,1604,21130.85,17869,1161,1105,1031,1006,972,1978,3009,4114,5275,84.56,24.96,19.47,14.24
20-05-2021,MONCHIQUE,0,0,0,"[0,120]",Baixo a Moderado,,,,0,Algarve,FARO,0809,39530.43,5077,353,384,321,355,392,747,1068,1452,1805,12.84,4.57,3.67,2.7
20-05-2021,MONDIM DE BASTO,1,0,14,"[0,120]",Baixo a Moderado,,,,1,Norte,VILA REAL,1705,17207.52,6946,395,300,314,284,283,567,881,1181,1576,40.36,9.16,6.86,5.12
20-05-2021,MONFORTE,0,0,0,"[0,120]",Baixo a Moderado,,,,0,Alentejo,PORTALEGRE,1211,42024.82,2975,139,115,117,192,168,360,477,592,731,7.08,1.74,1.41,1.14
20-05-2021,MONTALEGRE,35,2,389,"[240,480]",Elevado,,,,35,Norte,VILA REAL,1706,80545.71,8997,699,628,595,603,730,1333,1928,2556,3255,11.17,4.04,3.17,2.39
20-05-2021,MONTEMOR-O-NOVO,0,0,0,"[0,120]",Baixo a Moderado,,,,0,Alentejo,ÉVORA,0706,123296.65,15647,991,953,868,878,971,1849,2717,3670,4661,12.69,3.78,2.98,2.2
20-05-2021,MONTEMOR-O-VELHO,1,0,4,"[0,120]",Baixo a Moderado,,,,1,Centro,COIMBRA,0610,22896.23,25224,1496,1397,1217,1057,988,2045,3262,4659,6155,110.17,26.88,20.35,14.25
20-05-2021,MONTIJO,44,3,76,"[0,120]",Baixo a Moderado,,,,44,Lisboa e Vale do Tejo,SETÚBAL,1507,34861.64,57614,2771,2441,1990,1554,1109,2663,4653,7094,9865,165.26,28.3,20.35,13.35
20-05-2021,MORA,0,0,0,"[0,120]",Baixo a Moderado,,,,0,Alentejo,ÉVORA,0707,44395.02,4138,336,275,252,238,257,495,747,1022,1358,9.32,3.06,2.3,1.68
20-05-2021,MORTÁGUA,0,0,0,"[0,120]",Baixo a Moderado,,,,0,Centro,VISEU,1808,25117.82,8803,638,584,535,499,460,959,1494,2078,2716,35.05,10.81,8.27,5.95
20-05-2021,MOURA,0,0,0,"[0,120]",Baixo a Moderado,,,,0,Alentejo,BEJA,0210,95845.55,13718,817,656,665,542,461,1003,1668,2324,3141,14.31,3.28,2.42,1.74
20-05-2021,MOURÃO,0,0,0,"[0,120]",Baixo a Moderado,,,,0,Alentejo,ÉVORA,0708,27862.98,2450,139,108,80,104,109,213,293,401,540,8.79,1.94,1.44,1.05
20-05-2021,MURÇA,1,0,18,"[0,120]",Baixo a Moderado,,,,1,Norte,VILA REAL,1707,18937.11,5463,384,341,307,306,319,625,932,1273,1657,28.85,8.75,6.72,4.92
20-05-2021,MURTOSA,0,0,0,"[0,120]",Baixo a Moderado,,,,0,Centro,AVEIRO,0112,7308.78,10279,509,473,403,353,409,762,1165,1638,2147,140.63,29.37,22.41,15.94
20-05-2021,NAZARÉ,4,0,28,"[0,120]",Baixo a Moderado,,,,4,Lisboa e Vale do Tejo,LEIRIA,1011,8243.43,14165,967,903,670,420,396,816,1486,2389,3356,171.84,40.71,28.98,18.03
20-05-2021,NELAS,0,0,0,"[0,120]",Baixo a Moderado,,,,0,Centro,VISEU,1809,12571.48,12974,924,787,668,604,583,1187,1855,2642,3566,103.21,28.37,21.02,14.76
20-05-2021,NISA,0,0,0,"[0,120]",Baixo a Moderado,,,,0,Alentejo,PORTALEGRE,1212,57567.84,6061,405,389,355,483,478,961,1316,1705,2110,10.53,3.67,2.96,2.29
20-05-2021,NORDESTE,19,1,391,"[240,480]",Elevado,,,,19,Açores,AÇORES,4202,10146.8,4862,246,180,124,161,162,323,447,627,873,47.92,8.6,6.18,4.41
20-05-2021,ÓBIDOS,1,0,8,"[0,120]",Baixo a Moderado,,,,1,Lisboa e Vale do Tejo,LEIRIA,1012,14155.44,11850,743,650,574,452,436,888,1462,2112,2855,83.72,20.17,14.92,10.33
20-05-2021,ODEMIRA,71,5,287,"[240,480]",Elevado,,,,71,Alentejo,BEJA,0211,172060.15,24717,1475,1317,1225,1397,1349,2746,3971,5288,6763,14.37,3.93,3.07,2.31
20-05-2021,ODIVELAS,65,5,40,"[0,120]",Baixo a Moderado,,,,65,Lisboa e Vale do Tejo,LISBOA,1116,2654.36,161774,9562,9038,6952,4641,3812,8453,15405,24443,34005,6095.48,1281.27,920.99,580.44
20-05-2021,OEIRAS,85,6,48,"[0,120]",Baixo a Moderado,,,,85,Lisboa e Vale do Tejo,LISBOA,1110,4588.31,177408,11580,11575,8566,6211,5855,12066,20632,32207,43787,3866.78,954.38,701.98,449.69
20-05-2021,OLEIROS,0,0,0,"[0,120]",Baixo a Moderado,,,,0,Centro,CASTELO BRANCO,0506,47109.31,5003,384,341,366,397,487,884,1250,1591,1975,10.62,4.19,3.38,2.65
20-05-2021,OLHÃO,6,0,14,"[0,120]",Baixo a Moderado,,,,6,Algarve,FARO,0810,13086.38,44405,2455,2309,1689,1342,1268,2610,4299,6608,9063,339.33,69.26,50.5,32.85
20-05-2021,OLIVEIRA DE AZEMÉIS,37,3,56,"[0,120]",Baixo a Moderado,,,,37,Norte,AVEIRO,0113,16110.41,66011,4155,3614,2794,2183,1738,3921,6715,10329,14484,409.75,89.91,64.12,41.68
20-05-2021,OLIVEIRA DE FRADES,2,0,20,"[0,120]",Baixo a Moderado,,,,2,Centro,VISEU,1810,14534.62,9936,553,475,438,359,415,774,1212,1687,2240,68.36,15.41,11.61,8.34
20-05-2021,OLIVEIRA DO BAIRRO,4,0,16,"[0,120]",Baixo a Moderado,,,,4,Centro,AVEIRO,0114,8731.99,24277,1327,1182,999,786,810,1596,2595,3777,5104,278.02,58.45,43.25,29.72
20-05-2021,OLIVEIRA DO HOSPITAL,25,2,130,"[120,240]",Moderado,,,,25,Centro,COIMBRA,0611,23451.66,19253,1161,1097,962,924,960,1884,2846,3943,5104,82.1,21.76,16.81,12.14
20-05-2021,OURÉM,16,1,36,"[0,120]",Baixo a Moderado,,,,16,Lisboa e Vale do Tejo,SANTARÉM,1421,41668.03,44044,2463,2069,1899,1817,1603,3420,5319,7388,9851,105.7,23.64,17.73,12.77
20-05-2021,OURIQUE,0,0,0,"[0,120]",Baixo a Moderado,,,,0,Alentejo,BEJA,0212,66331.36,4607,313,287,284,268,227,495,779,1066,1379,6.95,2.08,1.61,1.17
20-05-2021,OVAR,17,1,31,"[0,120]",Baixo a Moderado,,,,17,Centro,AVEIRO,0115,14770.25,54260,3294,2709,1994,1636,1234,2870,4864,7573,10867,367.37,73.57,51.27,32.93
20-05-2021,PAÇOS DE FERREIRA,45,3,79,"[0,120]",Baixo a Moderado,,,,45,Norte,PORTO,1309,7099.29,56728,2903,2193,1518,1135,664,1799,3317,5510,8413,799.1,118.51,77.62,46.72
20-05-2021,PALMELA,7,1,11,"[0,120]",Baixo a Moderado,,,,7,Lisboa e Vale do Tejo,SETÚBAL,1508,46512.01,64269,3402,3244,2635,1846,1391,3237,5872,9116,12518,138.18,26.91,19.6,12.62
20-05-2021,PAMPILHOSA DA SERRA,1,0,25,"[0,120]",Baixo a Moderado,,,,1,Centro,COIMBRA,0612,39646.24,4037,238,254,295,339,423,762,1057,1311,1549,10.18,3.91,3.31,2.67
20-05-2021,PAREDES,44,3,51,"[0,120]",Baixo a Moderado,,,,44,Norte,PORTO,1310,15675.69,86067,4272,3532,2412,1717,1258,2975,5387,8919,13191,549.04,84.15,56.9,34.36
20-05-2021,PAREDES DE COURA,0,0,0,"[0,120]",Baixo a Moderado,,,,0,Norte,VIANA DO CASTELO,1605,13818.59,8535,466,528,407,465,515,980,1387,1915,2381,61.76,17.23,13.86,10.04
20-05-2021,PEDRÓGÃO GRANDE,0,0,0,"[0,120]",Baixo a Moderado,,,,0,Centro,LEIRIA,1013,12874.75,3410,175,173,196,221,252,473,669,842,1017,26.49,7.9,6.54,5.2
20-05-2021,PENACOVA,9,1,66,"[0,120]",Baixo a Moderado,,,,9,Centro,COIMBRA,0613,21673.23,13694,968,923,745,621,703,1324,2069,2992,3960,63.18,18.27,13.81,9.55
20-05-2021,PENAFIEL,56,4,80,"[0,120]",Baixo a Moderado,,,,56,Norte,PORTO,1311,21224.27,69772,3648,2823,2032,1663,1230,2893,4925,7748,11396,328.74,53.69,36.51,23.2
20-05-2021,PENALVA DO CASTELO,3,0,42,"[0,120]",Baixo a Moderado,,,,3,Centro,VISEU,1811,13433.92,7115,449,457,413,391,426,817,1230,1687,2136,52.96,15.9,12.56,9.16
20-05-2021,PENAMACOR,0,0,0,"[0,120]",Baixo a Moderado,,,,0,Centro,CASTELO BRANCO,0507,56370.69,4755,262,248,273,451,633,1084,1357,1605,1867,8.44,3.31,2.85,2.41
20-05-2021,PENEDONO,0,0,0,"[0,120]",Baixo a Moderado,,,,0,Norte,VISEU,1812,13370.75,2591,172,113,129,156,138,294,423,536,708,19.38,5.3,4.01,3.16
20-05-2021,PENELA,0,0,0,"[0,120]",Baixo a Moderado,,,,0,Centro,COIMBRA,0614,13480.0,5397,314,324,274,359,344,703,977,1301,1615,40.04,11.98,9.65,7.25
20-05-2021,PENICHE,22,2,83,"[0,120]",Baixo a Moderado,,,,22,Lisboa e Vale do Tejo,LEIRIA,1014,7754.98,26501,1746,1504,1203,926,707,1633,2836,4340,6086,341.73,78.48,55.96,36.57
20-05-2021,PESO DA RÉGUA,4,0,25,"[0,120]",Baixo a Moderado,,,,4,Norte,VILA REAL,1708,9486.01,15773,1076,843,650,659,455,1114,1764,2607,3683,166.28,38.83,27.48,18.6
20-05-2021,PINHEL,2,0,23,"[0,120]",Baixo a Moderado,,,,2,Centro,GUARDA,0910,48452.12,8511,577,566,551,538,689,1227,1778,2344,2921,17.57,6.03,4.84,3.67
20-05-2021,POMBAL,20,1,39,"[0,120]",Baixo a Moderado,,,,20,Centro,LEIRIA,1015,62600.28,51461,3187,2791,2494,2328,2027,4355,6849,9640,12827,82.21,20.49,15.4,10.94
20-05-2021,PONTA DELGADA,28,2,41,"[0,120]",Baixo a Moderado,,,,28,Açores,AÇORES,4203,23298.65,67935,3108,2435,1726,1133,902,2035,3761,6196,9304,291.58,39.93,26.59,16.14
20-05-2021,PONTA DO SOL,13,1,151,"[120,240]",Moderado,,,,13,Madeira,MADEIRA,3105,4622.03,8593,319,283,347,208,221,429,776,1059,1378,185.92,29.81,22.91,16.79
20-05-2021,PONTE DA BARCA,2,0,18,"[0,120]",Baixo a Moderado,,,,2,Norte,VIANA DO CASTELO,1606,18211.37,11180,635,576,517,554,490,1044,1561,2137,2772,61.39,15.22,11.73,8.57
20-05-2021,PONTE DE LIMA,9,1,22,"[0,120]",Baixo a Moderado,,,,9,Norte,VIANA DO CASTELO,1607,32025.46,41315,2321,2022,1720,1596,1462,3058,4778,6800,9121,129.01,28.48,21.23,14.92
20-05-2021,PONTE DE SOR,4,0,27,"[0,120]",Baixo a Moderado,,,,4,Alentejo,PORTALEGRE,1213,83971.16,14994,939,800,716,739,831,1570,2286,3086,4025,17.86,4.79,3.68,2.72
20-05-2021,PORTALEGRE,0,0,0,"[0,120]",Baixo a Moderado,,,,0,Alentejo,PORTALEGRE,1214,44713.64,22172,1577,1351,1137,993,984,1977,3114,4465,6042,49.59,13.51,9.99,6.96
20-05-2021,PORTEL,0,0,0,"[0,120]",Baixo a Moderado,,,,0,Alentejo,ÉVORA,0709,60100.57,5828,336,358,283,331,305,636,919,1277,1613,9.7,2.68,2.12,1.53
20-05-2021,PORTIMÃO,31,2,56,"[0,120]",Baixo a Moderado,,,,31,Algarve,FARO,0811,18206.29,55483,3182,2927,2116,1582,1400,2982,5098,8025,11207,304.75,61.56,44.08,28.0
20-05-2021,PORTO,162,12,75,"[0,120]",Baixo a Moderado,,,,162,Norte,PORTO,1312,4142.02,216606,15790,15193,11280,9409,10044,19453,30733,45926,61716,5229.5,1490.0,1108.79,741.98
20-05-2021,PORTO DE MÓS,5,0,21,"[0,120]",Baixo a Moderado,,,,5,Centro,LEIRIA,1016,26183.41,23275,1355,1210,1034,888,872,1760,2794,4004,5359,88.89,20.47,15.29,10.67
20-05-2021,PORTO MONIZ,1,0,43,"[0,120]",Baixo a Moderado,,,,1,Madeira,MADEIRA,3106,8293.38,2342,143,130,95,98,120,218,313,443,586,28.24,7.07,5.34,3.77
20-05-2021,PORTO SANTO,0,0,0,"[0,120]",Baixo a Moderado,,,,0,Madeira,MADEIRA,3201,4300.7,5202,240,157,134,110,68,178,312,469,709,120.95,16.48,10.9,7.25
20-05-2021,PÓVOA DE LANHOSO,9,1,42,"[0,120]",Baixo a Moderado,,,,9,Norte,BRAGA,0309,13465.29,21499,1175,909,732,673,624,1297,2029,2938,4113,159.67,30.55,21.82,15.07
20-05-2021,PÓVOA DE VARZIM,15,1,24,"[0,120]",Baixo a Moderado,,,,15,Norte,PORTO,1313,8220.59,62784,3712,3120,2134,1594,1305,2899,5033,8153,11865,763.7,144.33,99.17,61.22
20-05-2021,POVOAÇÃO,2,0,34,"[0,120]",Baixo a Moderado,,,,2,Açores,AÇORES,4204,10640.77,5927,293,212,191,144,134,278,469,681,974,55.7,9.15,6.4,4.41
20-05-2021,VILA DA PRAIA DA VITÓRIA,2,0,9,"[0,120]",Baixo a Moderado,,,,2,Açores,AÇORES,4302,16127.06,21317,1133,789,619,436,336,772,1391,2180,3313,132.18,20.54,13.52,8.63
20-05-2021,PROENÇA-A-NOVA,0,0,0,"[0,120]",Baixo a Moderado,,,,0,Centro,CASTELO BRANCO,0508,39539.96,7298,508,465,389,400,560,960,1349,1814,2322,18.46,5.87,4.59,3.41
20-05-2021,REDONDO,0,0,0,"[0,120]",Baixo a Moderado,,,,0,Alentejo,ÉVORA,0710,36950.87,6353,349,325,288,288,354,642,930,1255,1604,17.19,4.34,3.4,2.52
20-05-2021,REGUENGOS DE MONSARAZ,0,0,0,"[0,120]",Baixo a Moderado,,,,0,Alentejo,ÉVORA,0711,46399.72,10015,602,511,455,462,473,935,1390,1901,2503,21.58,5.39,4.1,3.0
20-05-2021,RESENDE,6,0,59,"[0,120]",Baixo a Moderado,,,,6,Norte,VISEU,1813,12334.93,10137,560,493,448,433,422,855,1303,1796,2356,82.18,19.1,14.56,10.56
20-05-2021,RIBEIRA BRAVA,22,2,177,"[120,240]",Moderado,,,,22,Madeira,MADEIRA,3107,6544.88,12435,648,500,411,311,287,598,1009,1509,2157,189.99,32.96,23.06,15.42
20-05-2021,RIBEIRA DE PENA,2,0,33,"[0,120]",Baixo a Moderado,,,,2,Norte,VILA REAL,1709,21745.98,6016,371,301,290,310,368,678,968,1269,1640,27.66,7.54,5.84,4.45
20-05-2021,RIBEIRA GRANDE,203,15,619,"[480,960]",Muito Elevado,,,,203,Açores,AÇORES,4205,18015.13,32811,1163,689,512,345,253,598,1110,1799,2962,182.13,16.44,9.99,6.16
20-05-2021,RIO MAIOR,8,1,39,"[0,120]",Baixo a Moderado,,,,8,Lisboa e Vale do Tejo,SANTARÉM,1414,27276.45,20379,1251,1144,941,795,648,1443,2384,3528,4779,74.71,17.52,12.93,8.74
20-05-2021,SABROSA,1,0,17,"[0,120]",Baixo a Moderado,,,,1,Norte,VILA REAL,1710,15692.45,5918,393,314,304,302,350,652,956,1270,1663,37.71,10.6,8.09,6.09
20-05-2021,SABUGAL,1,0,9,"[0,120]",Baixo a Moderado,,,,1,Centro,GUARDA,0911,82269.82,10585,724,707,694,796,1009,1805,2499,3206,3930,12.87,4.78,3.9,3.04
20-05-2021,SALVATERRA DE MAGOS,2,0,9,"[0,120]",Baixo a Moderado,,,,2,Lisboa e Vale do Tejo,SANTARÉM,1415,24393.2,21295,1275,1181,1060,799,772,1571,2631,3812,5087,87.3,20.85,15.63,10.79
20-05-2021,SANTA COMBA DÃO,15,1,144,"[120,240]",Moderado,,,,15,Centro,VISEU,1814,11194.77,10452,732,684,569,538,464,1002,1571,2255,2987,93.36,26.68,20.14,14.03
20-05-2021,SANTA CRUZ,38,3,84,"[0,120]",Baixo a Moderado,,,,38,Madeira,MADEIRA,3108,8150.28,45281,1817,1301,974,716,523,1239,2213,3514,5331,555.6,65.41,43.12,27.15
20-05-2021,SANTA CRUZ DA GRACIOSA,0,0,0,"[0,120]",Baixo a Moderado,,,,0,Açores,AÇORES,4401,6065.78,4208,228,180,163,124,145,269,432,612,840,69.37,13.85,10.09,7.12
20-05-2021,SANTA CRUZ DAS FLORES,0,0,0,"[0,120]",Baixo a Moderado,,,,0,Açores,AÇORES,4802,7091.44,2165,125,98,74,56,51,107,181,279,404,30.53,5.7,3.93,2.55
20-05-2021,SANTA MARIA DA FEIRA,42,3,30,"[0,120]",Baixo a Moderado,,,,42,Norte,AVEIRO,0109,21587.65,138636,8182,6743,4771,3856,3079,6935,11706,18449,26631,642.19,123.36,85.46,54.22
20-05-2021,SANTA MARTA DE PENAGUIÃO,3,0,45,"[0,120]",Baixo a Moderado,,,,3,Norte,VILA REAL,1711,6928.13,6599,483,373,337,316,317,633,970,1343,1826,95.25,26.36,19.39,14.0
20-05-2021,SANTANA,2,0,30,"[0,120]",Baixo a Moderado,,,,2,Madeira,MADEIRA,3109,9547.3,6711,418,353,343,282,277,559,902,1255,1673,70.29,17.52,13.15,9.45
20-05-2021,SANTARÉM,8,1,14,"[0,120]",Baixo a Moderado,,,,8,Lisboa e Vale do Tejo,SANTARÉM,1416,55253.58,57421,3654,3441,2760,2466,2206,4672,7432,10873,14527,103.92,26.29,19.68,13.45
20-05-2021,SANTIAGO DO CACÉM,8,1,28,"[0,120]",Baixo a Moderado,,,,8,Alentejo,SETÚBAL,1509,105969.29,28791,2144,1689,1472,1295,1215,2510,3982,5671,7815,27.17,7.37,5.35,3.76
20-05-2021,SANTO TIRSO,29,2,43,"[0,120]",Baixo a Moderado,,,,29,Norte,PORTO,1314,13655.52,68055,4911,3935,2761,2257,1810,4067,6828,10763,15674,498.35,114.78,78.82,50.0
20-05-2021,SÃO BRÁS DE ALPORTEL,2,0,19,"[0,120]",Baixo a Moderado,,,,2,Algarve,FARO,0812,15336.92,10416,596,468,467,404,401,805,1272,1740,2336,67.91,15.23,11.35,8.29
20-05-2021,SÃO JOÃO DA MADEIRA,6,0,27,"[0,120]",Baixo a Moderado,,,,6,Norte,AVEIRO,0116,794.3,21958,1347,1069,796,601,593,1194,1990,3059,4406,2765.49,554.91,385.26,250.63
20-05-2021,SÃO JOÃO DA PESQUEIRA,1,0,14,"[0,120]",Baixo a Moderado,,,,1,Norte,VISEU,1815,26610.85,7125,417,330,294,328,328,656,950,1280,1697,26.77,6.38,4.81,3.57
20-05-2021,SÃO PEDRO DO SUL,5,0,32,"[0,120]",Baixo a Moderado,,,,5,Centro,VISEU,1816,34895.09,15403,990,962,861,759,909,1668,2529,3491,4481,44.14,12.84,10.0,7.25
20-05-2021,SÃO ROQUE DO PICO,0,0,0,"[0,120]",Baixo a Moderado,,,,0,Açores,AÇORES,4603,14236.1,3266,199,141,93,96,113,209,302,443,642,22.94,4.51,3.11,2.12
20-05-2021,SÃO VICENTE,6,0,117,"[0,120]",Baixo a Moderado,,,,6,Madeira,MADEIRA,3110,7883.71,5143,272,264,266,225,280,505,771,1035,1307,65.23,16.58,13.13,9.78
20-05-2021,SARDOAL,0,0,0,"[0,120]",Baixo a Moderado,,,,0,Lisboa e Vale do Tejo,SANTARÉM,1417,9214.72,3741,227,178,148,165,248,413,561,739,966,40.6,10.48,8.02,6.09
20-05-2021,SÁTÃO,4,0,35,"[0,120]",Baixo a Moderado,,,,4,Centro,VISEU,1817,20194.11,11580,765,671,515,465,476,941,1456,2127,2892,57.34,14.32,10.53,7.21
20-05-2021,SEIA,14,1,63,"[0,120]",Baixo a Moderado,,,,14,Centro,GUARDA,0912,43568.83,22234,1807,1589,1238,1122,721,1843,3081,4670,6477,51.03,14.87,10.72,7.07
20-05-2021,SEIXAL,50,4,30,"[0,120]",Baixo a Moderado,,,,50,Lisboa e Vale do Tejo,SETÚBAL,1510,9545.17,167752,10586,9270,6661,4391,2930,7321,13982,23252,33838,1757.49,354.51,243.6,146.49
20-05-2021,SERNANCELHE,0,0,0,"[0,120]",Baixo a Moderado,,,,0,Norte,VISEU,1818,22861.22,5396,305,293,286,273,260,533,819,1112,1417,23.6,6.2,4.86,3.58
20-05-2021,SERPA,2,0,14,"[0,120]",Baixo a Moderado,,,,2,Alentejo,BEJA,0213,110563.34,14304,903,761,719,697,626,1323,2042,2803,3706,12.94,3.35,2.54,1.85
20-05-2021,SERTÃ,0,0,0,"[0,120]",Baixo a Moderado,,,,0,Centro,CASTELO BRANCO,0509,44673.17,14577,870,779,790,767,1020,1787,2577,3356,4226,32.63,9.46,7.51,5.77
20-05-2021,SESIMBRA,10,1,19,"[0,120]",Baixo a Moderado,,,,10,Lisboa e Vale do Tejo,SETÚBAL,1511,19571.75,51858,2400,2321,1853,1257,1083,2340,4193,6514,8914,264.96,45.54,33.28,21.42
20-05-2021,SETÚBAL,41,3,36,"[0,120]",Baixo a Moderado,,,,41,Lisboa e Vale do Tejo,SETÚBAL,1512,23032.5,115126,7425,6929,5075,3775,2655,6430,11505,18434,25859,499.83,112.27,80.03,49.95
20-05-2021,SEVER DO VOUGA,7,1,62,"[0,120]",Baixo a Moderado,,,,7,Centro,AVEIRO,0117,12987.56,11331,766,637,568,540,567,1107,1675,2312,3078,87.24,23.7,17.8,12.9
20-05-2021,SILVES,21,2,58,"[0,120]",Baixo a Moderado,,,,21,Algarve,FARO,0813,68006.23,36226,2137,1869,1610,1423,1600,3023,4633,6502,8639,53.27,12.7,9.56,6.81
20-05-2021,SINES,3,0,22,"[0,120]",Baixo a Moderado,,,,3,Alentejo,SETÚBAL,1513,20330.17,13715,888,791,551,416,268,684,1235,2026,2914,67.46,14.33,9.97,6.07
20-05-2021,SINTRA,157,11,40,"[0,120]",Baixo a Moderado,,,,157,Lisboa e Vale do Tejo,LISBOA,1111,31922.73,391402,20490,18316,13545,9137,7284,16421,29966,48282,68772,1226.08,215.43,151.25,93.87
20-05-2021,SOBRAL DE MONTE AGRAÇO,2,0,19,"[0,120]",Baixo a Moderado,,,,2,Lisboa e Vale do Tejo,LISBOA,1112,5210.32,10651,564,507,352,272,212,484,836,1343,1907,204.43,36.6,25.78,16.05
20-05-2021,SOURE,2,0,12,"[0,120]",Baixo a Moderado,,,,2,Centro,COIMBRA,0615,26506.07,17120,1173,1142,1004,883,987,1870,2874,4016,5189,64.59,19.58,15.15,10.84
20-05-2021,SOUSEL,0,0,0,"[0,120]",Baixo a Moderado,,,,0,Alentejo,PORTALEGRE,1215,27932.18,4412,261,274,208,302,292,594,802,1076,1337,15.8,4.79,3.85,2.87
20-05-2021,TÁBUA,8,1,70,"[0,120]",Baixo a Moderado,,,,8,Centro,COIMBRA,0616,19978.58,11368,729,584,524,430,464,894,1418,2002,2731,56.9,13.67,10.02,7.1
20-05-2021,TABUAÇO,1,0,17,"[0,120]",Baixo a Moderado,,,,1,Norte,VISEU,1819,13385.67,6033,372,314,217,282,363,645,862,1176,1548,45.07,11.56,8.79,6.44
20-05-2021,TAROUCA,6,0,77,"[0,120]",Baixo a Moderado,,,,6,Norte,VISEU,1820,10008.49,7804,405,335,313,277,324,601,914,1249,1654,77.98,16.53,12.48,9.13
20-05-2021,TAVIRA,34,2,139,"[120,240]",Moderado,,,,34,Algarve,FARO,0814,60696.7,24530,1493,1415,1252,1066,1277,2343,3595,5010,6503,40.41,10.71,8.25,5.92
20-05-2021,TERRAS DE BOURO,1,0,16,"[0,120]",Baixo a Moderado,,,,1,Norte,BRAGA,0310,27746.07,6361,391,372,296,319,340,659,955,1327,1718,22.93,6.19,4.78,3.44
20-05-2021,TOMAR,8,1,22,"[0,120]",Baixo a Moderado,,,,8,Lisboa e Vale do Tejo,SANTARÉM,1418,35120.44,36748,2403,2189,1868,1853,1822,3675,5543,7732,10135,104.64,28.86,22.02,15.78
20-05-2021,TONDELA,3,0,11,"[0,120]",Baixo a Moderado,,,,3,Centro,VISEU,1821,37121.73,26357,1768,1722,1518,1475,1417,2892,4410,6132,7900,71.0,21.28,16.52,11.88
20-05-2021,TORRE DE MONCORVO,0,0,0,"[0,120]",Baixo a Moderado,,,,0,Norte,BRAGANÇA,0409,53155.67,7695,556,478,488,551,719,1270,1758,2236,2792,14.48,5.25,4.21,3.31
20-05-2021,TORRES NOVAS,11,1,31,"[0,120]",Baixo a Moderado,,,,11,Lisboa e Vale do Tejo,SANTARÉM,1419,26999.68,34933,2324,1979,1738,1406,1475,2881,4619,6598,8922,129.38,33.04,24.44,17.11
20-05-2021,TORRES VEDRAS,66,5,84,"[0,120]",Baixo a Moderado,,,,66,Lisboa e Vale do Tejo,LISBOA,1113,40714.89,78530,4513,3945,3447,2628,2104,4732,8179,12124,16637,192.88,40.86,29.78,20.09
20-05-2021,TRANCOSO,0,0,0,"[0,120]",Baixo a Moderado,,,,0,Centro,GUARDA,0913,36152.47,8875,581,557,542,586,496,1082,1624,2181,2762,24.55,7.64,6.03,4.49
20-05-2021,TROFA,12,1,31,"[0,120]",Baixo a Moderado,,,,12,Norte,PORTO,1318,7201.76,38418,2336,1894,1231,939,684,1623,2854,4748,7084,533.44,98.36,65.93,39.63
20-05-2021,VAGOS,2,0,9,"[0,120]",Baixo a Moderado,,,,2,Centro,AVEIRO,0118,16491.5,22740,1320,1205,922,784,724,1508,2430,3635,4955,137.89,30.04,22.04,14.73
20-05-2021,VALE DE CAMBRA,20,1,94,"[0,120]",Baixo a Moderado,,,,20,Norte,AVEIRO,0119,14733.47,21327,1491,1363,1005,831,798,1629,2634,3997,5488,144.76,37.25,27.13,17.88
20-05-2021,VALENÇA,3,0,23,"[0,120]",Baixo a Moderado,,,,3,Norte,VIANA DO CASTELO,1608,11712.86,13290,867,791,582,582,503,1085,1667,2458,3325,113.46,28.39,20.99,14.23
20-05-2021,VALONGO,55,4,56,"[0,120]",Baixo a Moderado,,,,55,Norte,PORTO,1315,7512.45,97444,5629,4696,3207,2462,1829,4291,7498,12194,17823,1297.18,237.26,162.33,99.81
20-05-2021,VALPAÇOS,9,1,61,"[0,120]",Baixo a Moderado,,,,9,Norte,VILA REAL,1712,54873.93,14818,1217,1118,999,928,997,1925,2924,4042,5259,27.0,9.58,7.37,5.33
20-05-2021,VELAS,0,0,0,"[0,120]",Baixo a Moderado,,,,0,Açores,AÇORES,4502,11738.38,5093,278,208,166,153,113,266,432,640,918,43.39,7.82,5.45,3.68
20-05-2021,VENDAS NOVAS,11,1,98,"[0,120]",Baixo a Moderado,,,,11,Alentejo,ÉVORA,0712,22238.88,11255,677,768,655,501,532,1033,1688,2456,3133,50.61,14.09,11.04,7.59
20-05-2021,VIANA DO ALENTEJO,0,0,0,"[0,120]",Baixo a Moderado,,,,0,Alentejo,ÉVORA,0713,39367.29,5145,245,208,235,210,214,424,659,867,1112,13.07,2.82,2.2,1.67
20-05-2021,VIANA DO CASTELO,79,6,94,"[0,120]",Baixo a Moderado,,,,79,Norte,VIANA DO CASTELO,1609,31902.01,84417,5470,4433,3591,3061,2982,6043,9634,14067,19537,264.61,61.24,44.09,30.2
20-05-2021,VIDIGUEIRA,1,0,18,"[0,120]",Baixo a Moderado,,,,1,Alentejo,BEJA,0214,31661.09,5510,300,248,215,233,275,508,723,971,1271,17.4,4.01,3.07,2.28
20-05-2021,VIEIRA DO MINHO,0,0,0,"[0,120]",Baixo a Moderado,,,,0,Norte,BRAGA,0311,21644.35,11842,703,594,525,548,482,1030,1555,2149,2852,54.71,13.18,9.93,7.18
20-05-2021,VILA DE REI,0,0,0,"[0,120]",Baixo a Moderado,,,,0,Centro,CASTELO BRANCO,0510,19154.6,3323,169,128,172,247,302,549,721,849,1018,17.35,5.31,4.43,3.76
20-05-2021,VILA DO BISPO,12,1,233,"[120,240]",Moderado,,,,12,Algarve,FARO,0815,17906.06,5154,302,302,314,232,233,465,779,1081,1383,28.78,7.72,6.04,4.35
20-05-2021,VILA DO CONDE,32,2,40,"[0,120]",Baixo a Moderado,,,,32,Norte,PORTO,1316,14902.77,79899,4726,3875,2819,2070,1743,3813,6632,10507,15233,536.13,102.21,70.5,44.5
20-05-2021,VILA DO PORTO,0,0,0,"[0,120]",Baixo a Moderado,,,,0,Açores,AÇORES,4101,9688.74,5616,274,212,135,96,123,219,354,566,840,57.96,8.67,5.84,3.65
20-05-2021,VILA FLOR,1,0,17,"[0,120]",Baixo a Moderado,,,,1,Norte,BRAGANÇA,0410,26581.14,6044,429,362,422,294,331,625,1047,1409,1838,22.74,6.91,5.3,3.94
20-05-2021,VILA FRANCA DE XIRA,35,3,25,"[0,120]",Baixo a Moderado,,,,35,Lisboa e Vale do Tejo,LISBOA,1114,31819.39,141957,8501,6852,4869,3425,2472,5897,10766,17618,26119,446.14,82.09,55.37,33.84
20-05-2021,VILA FRANCA DO CAMPO,20,1,181,"[120,240]",Moderado,,,,20,Açores,AÇORES,4206,7796.82,11051,450,344,248,217,154,371,619,963,1413,141.73,18.12,12.35,7.94
20-05-2021,VILA NOVA DA BARQUINHA,5,0,67,"[0,120]",Baixo a Moderado,,,,5,Lisboa e Vale do Tejo,SANTARÉM,1420,4952.97,7461,415,406,392,364,338,702,1094,1500,1915,150.64,38.66,30.28,22.09
20-05-2021,VILA NOVA DE CERVEIRA,0,0,0,"[0,120]",Baixo a Moderado,,,,0,Norte,VIANA DO CASTELO,1610,10846.66,8910,531,444,410,384,334,718,1128,1572,2103,82.14,19.39,14.49,10.4
20-05-2021,VILA NOVA DE FAMALICÃO,62,4,47,"[0,120]",Baixo a Moderado,,,,62,Norte,BRAGA,0312,20159.26,131676,7817,6164,4202,3282,2749,6031,10233,16397,24214,653.19,120.12,81.34,50.76
20-05-2021,VILA NOVA DE FOZ CÔA,3,0,46,"[0,120]",Baixo a Moderado,,,,3,Centro,GUARDA,0914,39815.18,6503,442,385,390,398,429,827,1217,1602,2044,16.33,5.13,4.02,3.06
20-05-2021,VILA NOVA DE GAIA,141,10,47,"[0,120]",Baixo a Moderado,,,,141,Norte,PORTO,1317,16846.43,300472,18349,15568,10972,8224,6281,14505,25477,41045,59394,1783.64,352.57,243.65,151.23
20-05-2021,VILA NOVA DE PAIVA,7,0,149,"[120,240]",Moderado,,,,7,Centro,VISEU,1822,17553.28,4687,289,272,233,217,241,458,691,963,1252,26.7,7.13,5.49,3.94
20-05-2021,VILA NOVA DE POIARES,7,1,101,"[0,120]",Baixo a Moderado,,,,7,Centro,COIMBRA,0617,8445.3,6939,380,284,262,235,182,417,679,963,1343,82.17,15.9,11.4,8.04
20-05-2021,VILA POUCA DE AGUIAR,2,0,17,"[0,120]",Baixo a Moderado,,,,2,Norte,VILA REAL,1713,43706.62,11961,860,817,733,601,627,1228,1961,2778,3638,27.37,8.32,6.36,4.49
20-05-2021,VILA REAL,5,0,10,"[0,120]",Baixo a Moderado,,,,5,Norte,VILA REAL,1714,37880.28,49962,3025,2498,2065,1579,1466,3045,5110,7608,10633,131.9,28.07,20.08,13.49
20-05-2021,VILA REAL DE SANTO ANTÓNIO,5,0,27,"[0,120]",Baixo a Moderado,,,,5,Algarve,FARO,0816,6125.0,18749,1172,1069,811,569,586,1155,1966,3035,4207,306.11,68.69,49.55,32.1
20-05-2021,VILA VELHA DE RÓDÃO,0,0,0,"[0,120]",Baixo a Moderado,,,,0,Centro,CASTELO BRANCO,0511,32991.16,3144,209,229,180,283,306,589,769,998,1207,9.53,3.66,3.03,2.33
20-05-2021,VILA VERDE,49,3,104,"[0,120]",Baixo a Moderado,,,,49,Norte,BRAGA,0313,22866.52,46911,2365,2063,1667,1494,1437,2931,4598,6661,9026,205.15,39.47,29.13,20.11
20-05-2021,VILA VIÇOSA,0,0,0,"[0,120]",Baixo a Moderado,,,,0,Alentejo,ÉVORA,0714,19485.89,7656,487,379,342,345,324,669,1011,1390,1877,39.29,9.63,7.13,5.19
20-05-2021,VIMIOSO,1,0,25,"[0,120]",Baixo a Moderado,,,,1,Norte,BRAGANÇA,0411,48158.51,4023,274,230,261,293,335,628,889,1119,1393,8.35,2.89,2.32,1.85
20-05-2021,VINHAIS,1,0,13,"[0,120]",Baixo a Moderado,,,,1,Norte,BRAGANÇA,0412,69475.09,7746,599,577,636,641,815,1456,2092,2669,3268,11.15,4.7,3.84,3.01
20-05-2021,VISEU,31,2,32,"[0,120]",Baixo a Moderado,,,,31,Centro,VISEU,1823,50710.14,97249,5769,5038,4140,3158,2710,5868,10008,15046,20815,191.77,41.05,29.67,19.74
20-05-2021,VIZELA,3,0,13,"[0,120]",Baixo a Moderado,,,,3,Norte,BRAGA,0314,2469.83,23897,1258,928,655,509,371,880,1535,2463,3721,967.49,150.65,99.72,62.15
20-05-2021,VOUZELA,0,0,0,"[0,120]",Baixo a Moderado,,,,0,Centro,VISEU,1824,19369.46,9619,626,605,554,532,507,1039,1593,2198,2824,49.66,14.58,11.35,8.22
27-05-2021,ABRANTES,5,0,14,"[0,120]",Baixo a Moderado,,,,5,Lisboa e Vale do Tejo,SANTARÉM,1401,71469.08,35130,2473,2213,1730,1748,2021,3769,5499,7712,10185,49.15,14.25,10.79,7.69
27-05-2021,ÁGUEDA,26,2,56,"[0,120]",Baixo a Moderado,,,,26,Centro,AVEIRO,0101,33527.44,46075,3237,2713,2090,1635,1496,3131,5221,7934,11171,137.43,33.32,23.66,15.57
27-05-2021,AGUIAR DA BEIRA,1,0,21,"[0,120]",Baixo a Moderado,,,,1,Centro,GUARDA,0901,20676.57,4652,304,281,235,239,148,387,622,903,1207,22.5,5.84,4.37,3.01
27-05-2021,ALANDROAL,0,0,0,"[0,120]",Baixo a Moderado,,,,0,Alentejo,ÉVORA,0701,54267.81,4992,307,256,296,299,377,676,972,1228,1535,9.2,2.83,2.26,1.79
27-05-2021,ALBERGARIA-A-VELHA,3,0,12,"[0,120]",Baixo a Moderado,,,,3,Centro,AVEIRO,0102,15882.5,24144,1550,1298,996,687,680,1367,2363,3661,5211,152.02,32.81,23.05,14.88
27-05-2021,ALBUFEIRA,18,1,43,"[0,120]",Baixo a Moderado,,,,18,Algarve,FARO,0801,14066.42,41528,2067,1717,1425,985,858,1843,3268,4985,7052,295.24,50.14,35.44,23.23
27-05-2021,ALCÁCER DO SAL,0,0,0,"[0,120]",Baixo a Moderado,,,,0,Alentejo,SETÚBAL,1501,149987.3,11659,884,814,623,623,602,1225,1848,2662,3546,7.77,2.36,1.77,1.23
27-05-2021,ALCANENA,6,0,47,"[0,120]",Baixo a Moderado,,,,6,Lisboa e Vale do Tejo,SANTARÉM,1402,12732.86,12809,891,744,628,536,588,1124,1752,2496,3387,100.6,26.6,19.6,13.76
27-05-2021,ALCOBAÇA,6,0,11,"[0,120]",Baixo a Moderado,,,,6,Lisboa e Vale do Tejo,LEIRIA,1001,40814.09,53555,3420,2927,2466,2059,1676,3735,6201,9128,12548,131.22,30.74,22.36,15.19
27-05-2021,ALCOCHETE,10,1,51,"[0,120]",Baixo a Moderado,,,,10,Lisboa e Vale do Tejo,SETÚBAL,1502,12836.48,19787,857,834,691,476,447,923,1614,2448,3305,154.15,25.75,19.07,12.57
27-05-2021,ALCOUTIM,0,0,0,"[0,120]",Baixo a Moderado,,,,0,Algarve,FARO,0802,57536.33,2159,191,188,163,190,267,457,620,808,999,3.75,1.74,1.4,1.08
27-05-2021,ALENQUER,37,3,84,"[0,120]",Baixo a Moderado,,,,37,Lisboa e Vale do Tejo,LISBOA,1101,30421.92,44052,2298,2062,1629,1330,1155,2485,4114,6176,8474,144.8,27.85,20.3,13.52
27-05-2021,ALFÂNDEGA DA FÉ,0,0,0,"[0,120]",Baixo a Moderado,,,,0,Norte,BRAGANÇA,0401,32194.64,4550,325,277,301,274,325,599,900,1177,1502,14.13,4.67,3.66,2.8
27-05-2021,ALIJÓ,6,0,56,"[0,120]",Baixo a Moderado,,,,6,Norte,VILA REAL,1701,29759.89,10625,766,687,635,542,666,1208,1843,2530,3296,35.7,11.08,8.5,6.19
27-05-2021,ALJEZUR,4,0,72,"[0,120]",Baixo a Moderado,,,,4,Algarve,FARO,0803,32349.95,5594,316,336,335,320,410,730,1065,1401,1717,17.29,5.31,4.33,3.29
27-05-2021,ALJUSTREL,0,0,0,"[0,120]",Baixo a Moderado,,,,0,Alentejo,BEJA,0201,45847.41,8247,635,521,443,347,358,705,1148,1669,2304,17.99,5.03,3.64,2.5
27-05-2021,ALMADA,78,6,46,"[0,120]",Baixo a Moderado,,,,78,Lisboa e Vale do Tejo,SETÚBAL,1503,7000.89,169039,10469,9777,7876,6144,5111,11255,19131,28908,39377,2414.5,562.45,412.91,273.26
27-05-2021,ALMEIDA,1,0,17,"[0,120]",Baixo a Moderado,,,,1,Centro,GUARDA,0902,51798.46,5830,441,419,396,458,393,851,1247,1666,2107,11.26,4.07,3.22,2.41
27-05-2021,ALMEIRIM,4,0,18,"[0,120]",Baixo a Moderado,,,,4,Lisboa e Vale do Tejo,SANTARÉM,1403,22212.05,22546,1342,1353,1106,866,843,1709,2815,4168,5510,101.5,24.81,18.76,12.67
27-05-2021,ALMODÔVAR,1,0,15,"[0,120]",Baixo a Moderado,,,,1,Alentejo,BEJA,0202,77788.03,6725,414,443,396,373,328,701,1097,1540,1954,8.65,2.51,1.98,1.41
27-05-2021,ALPIARÇA,0,0,0,"[0,120]",Baixo a Moderado,,,,0,Lisboa e Vale do Tejo,SANTARÉM,1404,9536.33,7059,515,486,363,333,274,607,970,1456,1971,74.02,20.67,15.27,10.17
27-05-2021,ALTER DO CHÃO,0,0,0,"[0,120]",Baixo a Moderado,,,,0,Alentejo,PORTALEGRE,1201,36206.62,3165,201,163,136,208,187,395,531,694,895,8.74,2.47,1.92,1.47
27-05-2021,ALVAIÁZERE,1,0,15,"[0,120]",Baixo a Moderado,,,,1,Centro,LEIRIA,1002,16047.76,6597,419,389,346,406,539,945,1291,1680,2099,41.11,13.08,10.47,8.04
27-05-2021,ALVITO,0,0,0,"[0,120]",Baixo a Moderado,,,,0,Alentejo,BEJA,0203,26485.32,2477,145,110,105,111,89,200,305,415,560,9.35,2.11,1.57,1.15
27-05-2021,AMADORA,112,8,61,"[0,120]",Baixo a Moderado,,,,112,Lisboa e Vale do Tejo,LISBOA,1115,2378.47,184106,11186,10936,8780,6460,5890,12350,21130,32066,43252,7742.05,1818.84,1348.44,888.56
27-05-2021,AMARANTE,15,1,28,"[0,120]",Baixo a Moderado,,,,15,Norte,PORTO,1301,30133.15,53193,3086,2413,1812,1643,1311,2954,4766,7179,10265,176.53,34.07,23.82,15.82
27-05-2021,AMARES,7,1,39,"[0,120]",Baixo a Moderado,,,,7,Norte,BRAGA,0301,8195.41,18129,1001,829,622,489,524,1013,1635,2464,3465,221.22,42.28,30.07,19.95
27-05-2021,ANADIA,8,1,29,"[0,120]",Baixo a Moderado,,,,8,Centro,AVEIRO,0103,21663.48,27258,1931,1698,1376,1208,1262,2470,3846,5544,7475,125.83,34.51,25.59,17.75
27-05-2021,ANGRA DO HEROÍSMO,1,0,3,"[0,120]",Baixo a Moderado,,,,1,Açores,AÇORES,4301,23899.66,33807,2006,1473,1122,768,635,1403,2525,3998,6004,141.45,25.12,16.73,10.56
27-05-2021,ANSIÃO,2,0,17,"[0,120]",Baixo a Moderado,,,,2,Centro,LEIRIA,1003,17609.42,12039,727,709,646,694,530,1224,1870,2579,3306,68.37,18.77,14.65,10.62
27-05-2021,ARCOS DE VALDEVEZ,25,2,119,"[0,120]",Baixo a Moderado,,,,25,Norte,VIANA DO CASTELO,1601,44759.64,20926,1329,1338,1282,1343,1515,2858,4140,5478,6807,46.75,15.21,12.24,9.25
27-05-2021,ARGANIL,30,2,272,"[240,480]",Elevado,,,,30,Centro,COIMBRA,0601,33283.93,11014,672,648,612,559,596,1155,1767,2415,3087,33.09,9.27,7.26,5.31
27-05-2021,ARMAMAR,0,0,0,"[0,120]",Baixo a Moderado,,,,0,Norte,VISEU,1801,11723.73,5769,357,305,309,285,310,595,904,1209,1566,49.21,13.36,10.31,7.71
27-05-2021,AROUCA,7,1,34,"[0,120]",Baixo a Moderado,,,,7,Norte,AVEIRO,0104,32910.52,20720,1306,1047,753,683,683,1366,2119,3166,4472,62.96,13.59,9.62,6.44
27-05-2021,ARRAIOLOS,4,0,58,"[0,120]",Baixo a Moderado,,,,4,Alentejo,ÉVORA,0702,68374.55,6928,435,384,283,367,480,847,1130,1514,1949,10.13,2.85,2.21,1.65
27-05-2021,ARRONCHES,2,0,71,"[0,120]",Baixo a Moderado,,,,2,Alentejo,PORTALEGRE,1202,31464.72,2820,155,142,162,187,179,366,528,670,825,8.96,2.62,2.13,1.68
27-05-2021,ARRUDA DOS VINHOS,10,1,65,"[0,120]",Baixo a Moderado,,,,10,Lisboa e Vale do Tejo,LISBOA,1102,7795.93,15412,738,738,562,509,438,947,1509,2247,2985,197.69,38.29,28.82,19.36
27-05-2021,AVEIRO,18,1,23,"[0,120]",Baixo a Moderado,,,,18,Centro,AVEIRO,0105,19757.57,78734,4520,4004,3050,2250,2103,4353,7403,11407,15927,398.49,80.61,57.73,37.47
27-05-2021,AVIS,1,0,24,"[0,120]",Baixo a Moderado,,,,1,Alentejo,PORTALEGRE,1203,60596.51,4247,315,225,206,251,273,524,730,955,1270,7.01,2.1,1.58,1.2
27-05-2021,AZAMBUJA,14,1,62,"[0,120]",Baixo a Moderado,,,,14,Lisboa e Vale do Tejo,LISBOA,1103,26265.65,22716,1322,1171,1070,798,618,1416,2486,3657,4979,86.48,18.96,13.92,9.46
27-05-2021,BAIÃO,14,1,75,"[0,120]",Baixo a Moderado,,,,14,Norte,PORTO,1302,17452.83,18748,1070,862,714,686,725,1411,2125,2987,4057,107.42,23.25,17.11,12.18
27-05-2021,BARCELOS,62,4,53,"[0,120]",Baixo a Moderado,,,,62,Norte,BRAGA,0302,37890.14,116187,6721,5325,3619,2991,2562,5553,9172,14497,21218,306.64,56.0,38.26,24.21
27-05-2021,BARRANCOS,0,0,0,"[0,120]",Baixo a Moderado,,,,0,Alentejo,BEJA,0204,16841.73,1634,90,65,65,94,61,155,220,285,375,9.7,2.23,1.69,1.31
27-05-2021,BARREIRO,47,3,63,"[0,120]",Baixo a Moderado,,,,47,Lisboa e Vale do Tejo,SETÚBAL,1504,3639.07,75147,5194,5565,4459,3105,1767,4872,9331,14896,20090,2065.05,552.07,409.34,256.42
27-05-2021,BATALHA,3,0,19,"[0,120]",Baixo a Moderado,,,,3,Centro,LEIRIA,1004,10341.6,15963,873,762,649,529,549,1078,1727,2489,3362,154.35,32.51,24.07,16.7
27-05-2021,BEJA,13,1,39,"[0,120]",Baixo a Moderado,,,,13,Alentejo,BEJA,0205,114647.55,33579,2005,1840,1386,1272,1039,2311,3697,5537,7542,29.29,6.58,4.83,3.22
27-05-2021,BELMONTE,1,0,16,"[0,120]",Baixo a Moderado,,,,1,Centro,CASTELO BRANCO,0501,11875.91,6398,444,321,325,310,355,665,990,1311,1755,53.87,14.78,11.04,8.34
27-05-2021,BENAVENTE,12,1,39,"[0,120]",Baixo a Moderado,,,,12,Lisboa e Vale do Tejo,SANTARÉM,1405,52138.39,30602,1468,1376,1141,876,643,1519,2660,4036,5504,58.69,10.56,7.74,5.1
27-05-2021,BOMBARRAL,0,0,0,"[0,120]",Baixo a Moderado,,,,0,Lisboa e Vale do Tejo,LEIRIA,1005,9128.55,12558,875,714,561,491,429,920,1481,2195,3070,137.56,33.63,24.04,16.22
27-05-2021,BORBA,2,0,30,"[0,120]",Baixo a Moderado,,,,2,Alentejo,ÉVORA,0703,14518.65,6736,430,375,279,436,392,828,1107,1482,1912,46.39,13.17,10.21,7.62
27-05-2021,BOTICAS,0,0,0,"[0,120]",Baixo a Moderado,,,,0,Norte,VILA REAL,1702,32195.66,4998,347,306,311,305,380,685,996,1302,1649,15.52,5.12,4.04,3.09
27-05-2021,BRAGA,197,14,108,"[0,120]",Baixo a Moderado,,,,197,Norte,BRAGA,0303,18339.95,182679,10029,7963,5241,4320,3671,7991,13232,21195,31224,996.07,170.25,115.57,72.15
27-05-2021,BRAGANÇA,40,3,119,"[0,120]",Baixo a Moderado,,,,40,Norte,BRAGANÇA,0402,117357.27,33607,2402,1855,1652,1393,1163,2556,4208,6063,8465,28.64,7.21,5.17,3.59
27-05-2021,CABECEIRAS DE BASTO,7,1,45,"[0,120]",Baixo a Moderado,,,,7,Norte,BRAGA,0304,24182.16,15628,774,594,544,575,574,1149,1693,2287,3061,64.63,12.66,9.46,7.0
27-05-2021,CADAVAL,2,0,15,"[0,120]",Baixo a Moderado,,,,2,Lisboa e Vale do Tejo,LISBOA,1104,17489.3,13673,813,796,756,621,625,1246,2002,2798,3611,78.18,20.65,16.0,11.45
27-05-2021,CALDAS DA RAINHA,7,0,13,"[0,120]",Baixo a Moderado,,,,7,Lisboa e Vale do Tejo,LEIRIA,1006,25569.47,51912,3035,2684,2186,1899,1705,3604,5790,8474,11509,203.03,45.01,33.14,22.64
27-05-2021,CALHETA,4,0,37,"[0,120]",Baixo a Moderado,,,,4,Madeira,MADEIRA,3101,11150.43,10867,576,497,507,399,415,814,1321,1818,2394,97.46,21.47,16.3,11.85
27-05-2021,CALHETA (AÇORES),0,0,0,"[0,120]",Baixo a Moderado,,,,0,Açores,AÇORES,4501,12626.4,3184,215,159,141,139,122,261,402,561,776,25.22,6.15,4.44,3.18
27-05-2021,CÂMARA DE LOBOS,21,1,62,"[0,120]",Baixo a Moderado,,,,21,Madeira,MADEIRA,3102,5216.67,33675,1396,1059,834,545,381,926,1760,2819,4215,645.49,80.79,54.03,33.74
27-05-2021,CAMINHA,2,0,13,"[0,120]",Baixo a Moderado,,,,2,Norte,VIANA DO CASTELO,1602,13652.14,15877,1046,944,818,646,656,1302,2120,3064,4110,116.3,30.11,22.44,15.53
27-05-2021,CAMPO MAIOR,6,0,76,"[0,120]",Baixo a Moderado,,,,6,Alentejo,PORTALEGRE,1204,24720.16,7874,471,364,351,279,327,606,957,1321,1792,31.85,7.25,5.34,3.87
27-05-2021,CANTANHEDE,39,3,111,"[0,120]",Baixo a Moderado,,,,39,Centro,COIMBRA,0602,39088.02,35011,2346,2096,1880,1709,1451,3160,5040,7136,9482,89.57,24.26,18.26,12.89
27-05-2021,CARRAZEDA DE ANSIÃES,1,0,18,"[0,120]",Baixo a Moderado,,,,1,Norte,BRAGANÇA,0403,27924.09,5666,424,389,391,312,465,777,1168,1557,1981,20.29,7.09,5.58,4.18
27-05-2021,CARREGAL DO SAL,0,0,0,"[0,120]",Baixo a Moderado,,,,0,Centro,VISEU,1802,11689.21,9271,587,562,486,462,376,838,1324,1886,2473,79.31,21.16,16.13,11.33
27-05-2021,CARTAXO,17,1,71,"[0,120]",Baixo a Moderado,,,,17,Lisboa e Vale do Tejo,SANTARÉM,1406,15817.28,23843,1415,1376,1142,861,632,1493,2635,4011,5426,150.74,34.3,25.36,16.66
27-05-2021,CASCAIS,167,12,78,"[0,120]",Baixo a Moderado,,,,167,Lisboa e Vale do Tejo,LISBOA,1105,9740.17,213608,12151,11444,8680,6469,5248,11717,20397,31841,43992,2193.1,451.66,326.91,209.41
27-05-2021,CASTANHEIRA DE PÊRA,0,0,0,"[0,120]",Baixo a Moderado,,,,0,Centro,LEIRIA,1007,6677.45,2614,233,195,157,190,187,377,534,729,962,39.15,14.41,10.92,8.0
27-05-2021,CASTELO BRANCO,4,0,8,"[0,120]",Baixo a Moderado,,,,4,Centro,CASTELO BRANCO,0502,143819.15,51987,3528,3042,2499,2229,2225,4454,6953,9995,13523,36.15,9.4,6.95,4.83
27-05-2021,CASTELO DE PAIVA,18,1,116,"[0,120]",Baixo a Moderado,,,,18,Norte,AVEIRO,0106,11500.53,15454,881,697,545,420,431,851,1396,2093,2974,134.37,25.86,18.2,12.14
27-05-2021,CASTELO DE VIDE,0,0,0,"[0,120]",Baixo a Moderado,,,,0,Alentejo,PORTALEGRE,1205,26491.24,2919,204,173,179,147,170,317,496,669,873,11.02,3.3,2.53,1.87
27-05-2021,CASTRO DAIRE,0,0,0,"[0,120]",Baixo a Moderado,,,,0,Centro,VISEU,1803,37904.13,13823,942,857,765,732,773,1505,2270,3127,4069,36.47,10.74,8.25,5.99
27-05-2021,CASTRO MARIM,3,0,48,"[0,120]",Baixo a Moderado,,,,3,Algarve,FARO,0804,30084.37,6237,370,345,334,322,344,666,1000,1345,1715,20.73,5.7,4.47,3.32
27-05-2021,CASTRO VERDE,1,0,14,"[0,120]",Baixo a Moderado,,,,1,Alentejo,BEJA,0206,56944.23,6949,437,347,303,275,227,502,805,1152,1589,12.2,2.79,2.02,1.41
27-05-2021,CELORICO DA BEIRA,0,0,0,"[0,120]",Baixo a Moderado,,,,0,Centro,GUARDA,0903,24721.63,6928,430,416,363,369,535,904,1267,1683,2113,28.02,8.55,6.81,5.12
27-05-2021,CELORICO DE BASTO,4,0,21,"[0,120]",Baixo a Moderado,,,,4,Norte,BRAGA,0305,18107.02,19040,1001,802,668,728,729,1457,2125,2927,3928,105.15,21.69,16.17,11.74
27-05-2021,CHAMUSCA,15,1,163,"[120,240]",Moderado,,,,15,Lisboa e Vale do Tejo,SANTARÉM,1407,74600.54,9197,629,583,553,465,579,1044,1597,2180,2809,12.33,3.77,2.92,2.14
27-05-2021,CHAVES,20,1,51,"[0,120]",Baixo a Moderado,,,,20,Norte,VILA REAL,1703,59122.95,39343,2676,2429,1991,1886,1918,3804,5795,8224,10900,66.54,18.44,13.91,9.8
27-05-2021,CINFÃES,13,1,71,"[0,120]",Baixo a Moderado,,,,13,Norte,VISEU,1804,23928.76,18244,1067,902,779,734,758,1492,2271,3173,4240,76.24,17.72,13.26,9.49
27-05-2021,COIMBRA,42,3,31,"[0,120]",Baixo a Moderado,,,,42,Centro,COIMBRA,0603,31939.94,134166,9489,8734,6353,5139,5074,10213,16566,25300,34789,420.06,108.92,79.21,51.87
27-05-2021,CONDEIXA-A-NOVA,5,0,28,"[0,120]",Baixo a Moderado,,,,5,Centro,COIMBRA,0604,13867.47,17733,871,809,717,583,490,1073,1790,2599,3470,127.88,25.02,18.74,12.91
27-05-2021,CONSTÂNCIA,2,0,50,"[0,120]",Baixo a Moderado,,,,2,Lisboa e Vale do Tejo,SANTARÉM,1408,8036.58,4030,211,183,187,148,155,303,490,673,884,50.14,11.0,8.37,6.1
27-05-2021,CORUCHE,3,0,17,"[0,120]",Baixo a Moderado,,,,3,Lisboa e Vale do Tejo,SANTARÉM,1409,111572.03,17471,1294,1090,1095,1096,1019,2115,3210,4300,5594,15.66,5.01,3.85,2.88
27-05-2021,CORVO,0,0,0,"[0,120]",Baixo a Moderado,,,,0,Açores,AÇORES,4901,1711.45,464,22,21,11,13,19,32,43,64,86,27.12,5.03,3.74,2.51
27-05-2021,COVILHÃ,4,0,9,"[0,120]",Baixo a Moderado,,,,4,Centro,CASTELO BRANCO,0503,55560.06,46787,3533,2998,2365,2111,2193,4304,6669,9667,13200,84.21,23.76,17.4,12.0
27-05-2021,CRATO,0,0,0,"[0,120]",Baixo a Moderado,,,,0,Alentejo,PORTALEGRE,1206,39806.88,3129,229,258,163,182,228,410,573,831,1060,7.86,2.66,2.09,1.44
27-05-2021,CUBA,2,0,44,"[0,120]",Baixo a Moderado,,,,2,Alentejo,BEJA,0207,17208.72,4595,255,233,206,190,143,333,539,772,1027,26.7,5.97,4.49,3.13
27-05-2021,ELVAS,8,1,39,"[0,120]",Baixo a Moderado,,,,8,Alentejo,PORTALEGRE,1207,63128.86,20528,1057,1145,902,852,810,1662,2564,3709,4766,32.52,7.55,5.88,4.06
27-05-2021,ENTRONCAMENTO,14,1,65,"[0,120]",Baixo a Moderado,,,,14,Lisboa e Vale do Tejo,SANTARÉM,1410,1372.81,21558,1066,930,868,695,592,1287,2155,3085,4151,1570.14,302.33,224.69,156.96
27-05-2021,ESPINHO,9,1,30,"[0,120]",Baixo a Moderado,,,,9,Norte,AVEIRO,0107,2105.68,29516,2205,1993,1430,1177,960,2137,3567,5560,7765,1401.52,368.71,264.01,169.37
27-05-2021,ESPOSENDE,12,1,35,"[0,120]",Baixo a Moderado,,,,12,Norte,BRAGA,0306,9540.98,34177,1831,1522,1095,894,723,1617,2712,4234,6065,358.21,63.57,44.38,28.42
27-05-2021,ESTARREJA,3,0,12,"[0,120]",Baixo a Moderado,,,,3,Centro,AVEIRO,0108,10817.33,26006,1503,1399,1106,953,728,1681,2787,4186,5689,240.42,52.59,38.7,25.76
27-05-2021,ESTREMOZ,0,0,0,"[0,120]",Baixo a Moderado,,,,0,Alentejo,ÉVORA,0704,51379.95,12728,789,613,697,786,877,1663,2360,2973,3762,24.77,7.32,5.79,4.59
27-05-2021,ÉVORA,33,2,63,"[0,120]",Baixo a Moderado,,,,33,Alentejo,ÉVORA,0705,130707.58,52428,3569,2852,2176,1966,1803,3769,5945,8797,12366,40.11,9.46,6.73,4.55
27-05-2021,FAFE,50,4,104,"[0,120]",Baixo a Moderado,,,,50,Norte,BRAGA,0307,21908.11,48060,3044,2455,1679,1403,1208,2611,4290,6745,9789,219.37,44.68,30.79,19.58
27-05-2021,FARO,33,2,54,"[0,120]",Baixo a Moderado,,,,33,Algarve,FARO,0805,20256.79,61015,3847,3364,2604,2055,1601,3656,6260,9624,13471,301.2,66.5,47.51,30.9
27-05-2021,FELGUEIRAS,29,2,51,"[0,120]",Baixo a Moderado,,,,29,Norte,PORTO,1303,11573.75,56422,2951,2302,1601,1316,973,2289,3890,6192,9143,487.49,79.0,53.5,33.61
27-05-2021,FERREIRA DO ALENTEJO,3,0,38,"[0,120]",Baixo a Moderado,,,,3,Alentejo,BEJA,0208,64820.68,7845,515,414,372,343,345,688,1060,1474,1989,12.1,3.07,2.27,1.64
27-05-2021,FERREIRA DO ZÊZERE,0,0,0,"[0,120]",Baixo a Moderado,,,,0,Lisboa e Vale do Tejo,SANTARÉM,1411,19038.03,7959,470,370,416,465,456,921,1337,1707,2177,41.81,11.44,8.97,7.02
27-05-2021,FIGUEIRA DA FOZ,13,1,22,"[0,120]",Baixo a Moderado,,,,13,Centro,COIMBRA,0605,37905.26,58747,4032,3597,2887,2495,2043,4538,7425,11022,15054,154.98,39.72,29.08,19.59
27-05-2021,FIGUEIRA DE CASTELO RODRIGO,0,0,0,"[0,120]",Baixo a Moderado,,,,0,Centro,GUARDA,0904,50857.46,5584,347,352,290,352,391,743,1033,1385,1732,10.98,3.41,2.72,2.03
27-05-2021,FIGUEIRÓ DOS VINHOS,1,0,18,"[0,120]",Baixo a Moderado,,,,1,Centro,LEIRIA,1008,17344.0,5568,402,386,322,309,351,660,982,1368,1770,32.1,10.21,7.89,5.66
27-05-2021,FORNOS DE ALGODRES,0,0,0,"[0,120]",Baixo a Moderado,,,,0,Centro,GUARDA,0905,13145.05,4528,261,218,247,256,232,488,735,953,1214,34.45,9.24,7.25,5.59
27-05-2021,FREIXO DE ESPADA À CINTA,0,0,0,"[0,120]",Baixo a Moderado,,,,0,Norte,BRAGANÇA,0404,24414.29,3298,211,177,231,196,189,385,616,793,1004,13.51,4.11,3.25,2.52
27-05-2021,FRONTEIRA,2,0,67,"[0,120]",Baixo a Moderado,,,,2,Alentejo,PORTALEGRE,1208,24859.58,2974,213,182,149,156,168,324,473,655,868,11.96,3.49,2.63,1.9
27-05-2021,FUNCHAL,169,12,162,"[120,240]",Moderado,,,,169,Madeira,MADEIRA,3103,7616.2,104024,6382,5086,3643,2821,1990,4811,8454,13540,19922,1365.86,261.58,177.78,111.0
27-05-2021,FUNDÃO,1,0,4,"[0,120]",Baixo a Moderado,,,,1,Centro,CASTELO BRANCO,0504,70019.79,26495,1781,1464,1432,1357,1643,3000,4432,5896,7677,37.84,10.96,8.42,6.33
27-05-2021,GAVIÃO,0,0,0,"[0,120]",Baixo a Moderado,,,,0,Alentejo,PORTALEGRE,1209,29459.45,3263,189,186,222,263,293,556,778,964,1153,11.08,3.91,3.27,2.64
27-05-2021,GÓIS,3,0,79,"[0,120]",Baixo a Moderado,,,,3,Centro,COIMBRA,0606,26330.19,3805,235,199,240,233,244,477,717,916,1151,14.45,4.37,3.48,2.72
27-05-2021,GOLEGÃ,14,1,262,"[240,480]",Elevado,,,,14,Lisboa e Vale do Tejo,SANTARÉM,1412,8431.67,5339,356,299,281,243,255,498,779,1078,1434,63.32,17.01,12.78,9.24
27-05-2021,GONDOMAR,61,4,37,"[0,120]",Baixo a Moderado,,,,61,Norte,PORTO,1304,13191.76,165985,10555,8755,6222,4450,3364,7814,14036,22791,33346,1258.22,252.77,172.76,106.4
27-05-2021,GOUVEIA,13,1,105,"[0,120]",Baixo a Moderado,,,,13,Centro,GUARDA,0906,30061.17,12387,871,931,780,783,810,1593,2373,3304,4175,41.21,13.89,10.99,7.89
27-05-2021,GRÂNDOLA,4,0,27,"[0,120]",Baixo a Moderado,,,,4,Alentejo,SETÚBAL,1505,82593.66,14639,834,834,708,688,672,1360,2068,2902,3736,17.72,4.52,3.51,2.5
27-05-2021,GUARDA,12,1,31,"[0,120]",Baixo a Moderado,,,,12,Centro,GUARDA,0907,71209.58,38969,2477,2041,1686,1415,1474,2889,4575,6616,9093,54.72,12.77,9.29,6.42
27-05-2021,GUIMARÃES,23,2,15,"[0,120]",Baixo a Moderado,,,,23,Norte,BRAGA,0308,24099.96,152309,9394,7074,4809,3877,2948,6825,11634,18708,28102,631.99,116.61,77.63,48.27
27-05-2021,HORTA,1,0,7,"[0,120]",Baixo a Moderado,,,,1,Açores,AÇORES,4701,17305.53,14521,818,658,468,352,302,654,1122,1780,2598,83.91,15.01,10.29,6.48
27-05-2021,IDANHA-A-NOVA,1,0,12,"[0,120]",Baixo a Moderado,,,,1,Centro,CASTELO BRANCO,0505,141633.51,8043,518,490,519,672,974,1646,2165,2655,3173,5.68,2.24,1.87,1.53
27-05-2021,ÍLHAVO,11,1,28,"[0,120]",Baixo a Moderado,,,,11,Centro,AVEIRO,0110,7347.55,38699,2227,1943,1444,1193,850,2043,3487,5430,7657,526.66,104.21,73.9,47.46
27-05-2021,LAGOA (FARO),20,1,88,"[0,120]",Baixo a Moderado,,,,20,Algarve,FARO,0806,8825.45,22762,1314,1168,919,749,670,1419,2338,3506,4820,257.93,54.62,39.73,26.49
27-05-2021,LAGOA,7,1,48,"[0,120]",Baixo a Moderado,,,,7,Açores,AÇORES,4201,4559.32,14721,536,458,349,238,235,473,822,1280,1816,322.9,39.83,28.08,18.03
27-05-2021,LAGOS,15,1,49,"[0,120]",Baixo a Moderado,,,,15,Algarve,FARO,0807,21299.27,30374,1744,1434,1247,1053,1029,2082,3329,4763,6507,142.61,30.55,22.36,15.63
27-05-2021,LAJES DAS FLORES,0,0,0,"[0,120]",Baixo a Moderado,,,,0,Açores,AÇORES,4801,7004.79,1463,88,53,62,46,54,100,162,215,303,20.89,4.33,3.07,2.31
27-05-2021,LAJES DO PICO,0,0,0,"[0,120]",Baixo a Moderado,,,,0,Açores,AÇORES,4601,15531.09,4490,304,231,223,159,162,321,544,775,1079,28.91,6.95,4.99,3.5
27-05-2021,LAMEGO,29,2,116,"[0,120]",Baixo a Moderado,,,,29,Norte,VISEU,1805,16542.11,24895,1639,1284,1124,898,783,1681,2805,4089,5728,150.5,34.63,24.72,16.96
27-05-2021,LEIRIA,39,3,31,"[0,120]",Baixo a Moderado,,,,39,Centro,LEIRIA,1009,56508.83,125267,7389,6366,5090,3902,3159,7061,12151,18517,25906,221.68,45.84,32.77,21.5
27-05-2021,LISBOA,780,56,153,"[120,240]",Moderado,,,,780,Lisboa e Vale do Tejo,LISBOA,1106,10005.43,509515,33197,33340,27706,23037,26770,49807,77513,110853,144050,5092.6,1439.78,1107.98,774.74
27-05-2021,LOULÉ,50,4,73,"[0,120]",Baixo a Moderado,,,,50,Algarve,FARO,0808,76366.91,68697,3890,3350,2780,2358,2251,4609,7389,10739,14629,89.96,19.16,14.06,9.68
27-05-2021,LOURES,118,8,55,"[0,120]",Baixo a Moderado,,,,118,Lisboa e Vale do Tejo,LISBOA,1107,16723.99,213687,12746,12794,9644,6669,5033,11702,21346,34140,46886,1277.73,280.35,204.14,127.64
27-05-2021,LOURINHÃ,11,1,43,"[0,120]",Baixo a Moderado,,,,11,Lisboa e Vale do Tejo,LISBOA,1108,14717.2,25855,1584,1243,992,842,645,1487,2479,3722,5306,175.68,36.05,25.29,16.84
27-05-2021,LOUSÃ,9,1,52,"[0,120]",Baixo a Moderado,,,,9,Centro,COIMBRA,0607,13840.01,17158,946,866,658,528,450,978,1636,2502,3448,123.97,24.91,18.08,11.82
27-05-2021,LOUSADA,25,2,53,"[0,120]",Baixo a Moderado,,,,25,Norte,PORTO,1305,9608.01,46755,2289,1698,1176,853,621,1474,2650,4348,6637,486.63,69.08,45.25,27.58
27-05-2021,MAÇÃO,0,0,0,"[0,120]",Baixo a Moderado,,,,0,Lisboa e Vale do Tejo,SANTARÉM,1413,39997.98,6267,386,362,390,440,657,1097,1487,1849,2235,15.67,5.59,4.62,3.72
27-05-2021,MACEDO DE CAVALEIROS,9,1,62,"[0,120]",Baixo a Moderado,,,,9,Norte,BRAGANÇA,0405,69914.08,14516,1082,889,878,823,938,1761,2639,3528,4610,20.76,6.59,5.05,3.77
27-05-2021,MACHICO,22,2,110,"[0,120]",Baixo a Moderado,,,,22,Madeira,MADEIRA,3104,6825.1,19981,1197,860,662,455,331,786,1448,2308,3505,292.76,51.36,33.82,21.22
27-05-2021,MADALENA,0,0,0,"[0,120]",Baixo a Moderado,,,,0,Açores,AÇORES,4602,14712.33,5895,334,256,173,190,179,369,542,798,1132,40.07,7.69,5.42,3.68
27-05-2021,MAFRA,49,4,58,"[0,120]",Baixo a Moderado,,,,49,Lisboa e Vale do Tejo,LISBOA,1109,29165.5,84816,3613,3334,2839,2089,1899,3988,6827,10161,13774,290.81,47.23,34.84,23.41
27-05-2021,MAIA,56,4,40,"[0,120]",Baixo a Moderado,,,,56,Norte,PORTO,1306,8293.94,138971,7801,6617,4512,3339,2631,5970,10482,17099,24900,1675.56,300.22,206.16,126.38
27-05-2021,MANGUALDE,11,1,59,"[0,120]",Baixo a Moderado,,,,11,Centro,VISEU,1806,21925.56,18510,1198,1128,885,852,743,1595,2480,3608,4806,84.42,21.92,16.46,11.31
27-05-2021,MANTEIGAS,0,0,0,"[0,120]",Baixo a Moderado,,,,0,Centro,GUARDA,0908,12197.55,3007,258,197,159,167,146,313,472,669,927,24.65,7.6,5.48,3.87
27-05-2021,MARCO DE CANAVESES,12,1,23,"[0,120]",Baixo a Moderado,,,,12,Norte,PORTO,1307,20188.98,51496,2678,2060,1488,1265,1023,2288,3776,5836,8514,255.07,42.17,28.91,18.7
27-05-2021,MARINHA GRANDE,3,0,8,"[0,120]",Baixo a Moderado,,,,3,Centro,LEIRIA,1010,18725.19,38508,2365,2302,1638,1359,1058,2417,4055,6357,8722,205.65,46.58,33.95,21.66
27-05-2021,MARVÃO,0,0,0,"[0,120]",Baixo a Moderado,,,,0,Alentejo,PORTALEGRE,1210,15489.9,3005,198,185,142,197,237,434,576,761,959,19.4,6.19,4.91,3.72
27-05-2021,MATOSINHOS,114,8,65,"[0,120]",Baixo a Moderado,,,,114,Norte,PORTO,1308,6241.97,175357,11850,9977,7023,5024,3884,8908,15931,25908,37758,2809.31,604.9,415.06,255.22
27-05-2021,MEALHADA,4,0,20,"[0,120]",Baixo a Moderado,,,,4,Centro,AVEIRO,0111,11065.66,19914,1163,1039,810,828,831,1659,2469,3508,4671,179.96,42.21,31.7,22.31
27-05-2021,MÊDA,1,0,22,"[0,120]",Baixo a Moderado,,,,1,Centro,GUARDA,0909,28604.92,4587,343,306,290,288,443,731,1021,1327,1670,16.04,5.84,4.64,3.57
27-05-2021,MELGAÇO,1,0,12,"[0,120]",Baixo a Moderado,,,,1,Norte,VIANA DO CASTELO,1603,23824.58,8093,507,567,578,614,675,1289,1867,2434,2941,33.97,12.34,10.22,7.84
27-05-2021,MÉRTOLA,0,0,0,"[0,120]",Baixo a Moderado,,,,0,Alentejo,BEJA,0209,129287.34,6142,400,390,378,423,600,1023,1401,1791,2191,4.75,1.69,1.39,1.08
27-05-2021,MESÃO FRIO,0,0,0,"[0,120]",Baixo a Moderado,,,,0,Norte,VILA REAL,1704,2664.87,3964,265,205,168,157,120,277,445,650,915,148.74,34.33,24.39,16.7
27-05-2021,MIRA,6,0,51,"[0,120]",Baixo a Moderado,,,,6,Centro,COIMBRA,0608,12403.38,11832,727,729,659,550,466,1016,1675,2404,3131,95.4,25.24,19.38,13.5
27-05-2021,MIRANDA DO CORVO,3,0,24,"[0,120]",Baixo a Moderado,,,,3,Centro,COIMBRA,0609,12637.79,12708,706,659,568,498,404,902,1470,2129,2835,100.55,22.43,16.85,11.63
27-05-2021,MIRANDA DO DOURO,1,0,15,"[0,120]",Baixo a Moderado,,,,1,Norte,BRAGANÇA,0406,48718.31,6830,482,429,442,463,470,933,1375,1804,2286,14.02,4.69,3.7,2.82
27-05-2021,MIRANDELA,3,0,14,"[0,120]",Baixo a Moderado,,,,3,Norte,BRAGANÇA,0407,65895.67,21754,1640,1315,1204,1078,947,2025,3229,4544,6184,33.01,9.38,6.9,4.9
27-05-2021,MOGADOURO,0,0,0,"[0,120]",Baixo a Moderado,,,,0,Norte,BRAGANÇA,0408,76064.93,8392,589,529,576,630,655,1285,1861,2390,2979,11.03,3.92,3.14,2.45
27-05-2021,MOIMENTA DA BEIRA,1,0,10,"[0,120]",Baixo a Moderado,,,,1,Norte,VISEU,1807,21996.9,9736,576,514,471,416,461,877,1348,1862,2438,44.26,11.08,8.46,6.13
27-05-2021,MOITA,48,3,75,"[0,120]",Baixo a Moderado,,,,48,Lisboa e Vale do Tejo,SETÚBAL,1506,5525.98,64407,4226,3646,2623,1801,1425,3226,5849,9495,13721,1165.53,248.3,171.82,105.85
27-05-2021,MONÇÃO,7,0,39,"[0,120]",Baixo a Moderado,,,,7,Norte,VIANA DO CASTELO,1604,21130.85,17869,1161,1105,1031,1006,972,1978,3009,4114,5275,84.56,24.96,19.47,14.24
27-05-2021,MONCHIQUE,0,0,0,"[0,120]",Baixo a Moderado,,,,0,Algarve,FARO,0809,39530.43,5077,353,384,321,355,392,747,1068,1452,1805,12.84,4.57,3.67,2.7
27-05-2021,MONDIM DE BASTO,2,0,29,"[0,120]",Baixo a Moderado,,,,2,Norte,VILA REAL,1705,17207.52,6946,395,300,314,284,283,567,881,1181,1576,40.36,9.16,6.86,5.12
27-05-2021,MONFORTE,0,0,0,"[0,120]",Baixo a Moderado,,,,0,Alentejo,PORTALEGRE,1211,42024.82,2975,139,115,117,192,168,360,477,592,731,7.08,1.74,1.41,1.14
27-05-2021,MONTALEGRE,20,1,222,"[120,240]",Moderado,,,,20,Norte,VILA REAL,1706,80545.71,8997,699,628,595,603,730,1333,1928,2556,3255,11.17,4.04,3.17,2.39
27-05-2021,MONTEMOR-O-NOVO,4,0,26,"[0,120]",Baixo a Moderado,,,,4,Alentejo,ÉVORA,0706,123296.65,15647,991,953,868,878,971,1849,2717,3670,4661,12.69,3.78,2.98,2.2
27-05-2021,MONTEMOR-O-VELHO,12,1,48,"[0,120]",Baixo a Moderado,,,,12,Centro,COIMBRA,0610,22896.23,25224,1496,1397,1217,1057,988,2045,3262,4659,6155,110.17,26.88,20.35,14.25
27-05-2021,MONTIJO,34,2,59,"[0,120]",Baixo a Moderado,,,,34,Lisboa e Vale do Tejo,SETÚBAL,1507,34861.64,57614,2771,2441,1990,1554,1109,2663,4653,7094,9865,165.26,28.3,20.35,13.35
27-05-2021,MORA,0,0,0,"[0,120]",Baixo a Moderado,,,,0,Alentejo,ÉVORA,0707,44395.02,4138,336,275,252,238,257,495,747,1022,1358,9.32,3.06,2.3,1.68
27-05-2021,MORTÁGUA,0,0,0,"[0,120]",Baixo a Moderado,,,,0,Centro,VISEU,1808,25117.82,8803,638,584,535,499,460,959,1494,2078,2716,35.05,10.81,8.27,5.95
27-05-2021,MOURA,1,0,7,"[0,120]",Baixo a Moderado,,,,1,Alentejo,BEJA,0210,95845.55,13718,817,656,665,542,461,1003,1668,2324,3141,14.31,3.28,2.42,1.74
27-05-2021,MOURÃO,0,0,0,"[0,120]",Baixo a Moderado,,,,0,Alentejo,ÉVORA,0708,27862.98,2450,139,108,80,104,109,213,293,401,540,8.79,1.94,1.44,1.05
27-05-2021,MURÇA,0,0,0,"[0,120]",Baixo a Moderado,,,,0,Norte,VILA REAL,1707,18937.11,5463,384,341,307,306,319,625,932,1273,1657,28.85,8.75,6.72,4.92
27-05-2021,MURTOSA,2,0,19,"[0,120]",Baixo a Moderado,,,,2,Centro,AVEIRO,0112,7308.78,10279,509,473,403,353,409,762,1165,1638,2147,140.63,29.37,22.41,15.94
27-05-2021,NAZARÉ,5,0,35,"[0,120]",Baixo a Moderado,,,,5,Lisboa e Vale do Tejo,LEIRIA,1011,8243.43,14165,967,903,670,420,396,816,1486,2389,3356,171.84,40.71,28.98,18.03
27-05-2021,NELAS,6,0,46,"[0,120]",Baixo a Moderado,,,,6,Centro,VISEU,1809,12571.48,12974,924,787,668,604,583,1187,1855,2642,3566,103.21,28.37,21.02,14.76
27-05-2021,NISA,0,0,0,"[0,120]",Baixo a Moderado,,,,0,Alentejo,PORTALEGRE,1212,57567.84,6061,405,389,355,483,478,961,1316,1705,2110,10.53,3.67,2.96,2.29
27-05-2021,NORDESTE,16,1,329,"[240,480]",Elevado,,,,16,Açores,AÇORES,4202,10146.8,4862,246,180,124,161,162,323,447,627,873,47.92,8.6,6.18,4.41
27-05-2021,ÓBIDOS,1,0,8,"[0,120]",Baixo a Moderado,,,,1,Lisboa e Vale do Tejo,LEIRIA,1012,14155.44,11850,743,650,574,452,436,888,1462,2112,2855,83.72,20.17,14.92,10.33
27-05-2021,ODEMIRA,90,6,364,"[240,480]",Elevado,,,,90,Alentejo,BEJA,0211,172060.15,24717,1475,1317,1225,1397,1349,2746,3971,5288,6763,14.37,3.93,3.07,2.31
27-05-2021,ODIVELAS,133,9,82,"[0,120]",Baixo a Moderado,,,,133,Lisboa e Vale do Tejo,LISBOA,1116,2654.36,161774,9562,9038,6952,4641,3812,8453,15405,24443,34005,6095.48,1281.27,920.99,580.44
27-05-2021,OEIRAS,94,7,53,"[0,120]",Baixo a Moderado,,,,94,Lisboa e Vale do Tejo,LISBOA,1110,4588.31,177408,11580,11575,8566,6211,5855,12066,20632,32207,43787,3866.78,954.38,701.98,449.69
27-05-2021,OLEIROS,0,0,0,"[0,120]",Baixo a Moderado,,,,0,Centro,CASTELO BRANCO,0506,47109.31,5003,384,341,366,397,487,884,1250,1591,1975,10.62,4.19,3.38,2.65
27-05-2021,OLHÃO,11,1,25,"[0,120]",Baixo a Moderado,,,,11,Algarve,FARO,0810,13086.38,44405,2455,2309,1689,1342,1268,2610,4299,6608,9063,339.33,69.26,50.5,32.85
27-05-2021,OLIVEIRA DE AZEMÉIS,29,2,44,"[0,120]",Baixo a Moderado,,,,29,Norte,AVEIRO,0113,16110.41,66011,4155,3614,2794,2183,1738,3921,6715,10329,14484,409.75,89.91,64.12,41.68
27-05-2021,OLIVEIRA DE FRADES,9,1,91,"[0,120]",Baixo a Moderado,,,,9,Centro,VISEU,1810,14534.62,9936,553,475,438,359,415,774,1212,1687,2240,68.36,15.41,11.61,8.34
27-05-2021,OLIVEIRA DO BAIRRO,8,1,33,"[0,120]",Baixo a Moderado,,,,8,Centro,AVEIRO,0114,8731.99,24277,1327,1182,999,786,810,1596,2595,3777,5104,278.02,58.45,43.25,29.72
27-05-2021,OLIVEIRA DO HOSPITAL,9,1,47,"[0,120]",Baixo a Moderado,,,,9,Centro,COIMBRA,0611,23451.66,19253,1161,1097,962,924,960,1884,2846,3943,5104,82.1,21.76,16.81,12.14
27-05-2021,OURÉM,20,1,45,"[0,120]",Baixo a Moderado,,,,20,Lisboa e Vale do Tejo,SANTARÉM,1421,41668.03,44044,2463,2069,1899,1817,1603,3420,5319,7388,9851,105.7,23.64,17.73,12.77
27-05-2021,OURIQUE,1,0,22,"[0,120]",Baixo a Moderado,,,,1,Alentejo,BEJA,0212,66331.36,4607,313,287,284,268,227,495,779,1066,1379,6.95,2.08,1.61,1.17
27-05-2021,OVAR,19,1,35,"[0,120]",Baixo a Moderado,,,,19,Centro,AVEIRO,0115,14770.25,54260,3294,2709,1994,1636,1234,2870,4864,7573,10867,367.37,73.57,51.27,32.93
27-05-2021,PAÇOS DE FERREIRA,29,2,51,"[0,120]",Baixo a Moderado,,,,29,Norte,PORTO,1309,7099.29,56728,2903,2193,1518,1135,664,1799,3317,5510,8413,799.1,118.51,77.62,46.72
27-05-2021,PALMELA,19,1,30,"[0,120]",Baixo a Moderado,,,,19,Lisboa e Vale do Tejo,SETÚBAL,1508,46512.01,64269,3402,3244,2635,1846,1391,3237,5872,9116,12518,138.18,26.91,19.6,12.62
27-05-2021,PAMPILHOSA DA SERRA,1,0,25,"[0,120]",Baixo a Moderado,,,,1,Centro,COIMBRA,0612,39646.24,4037,238,254,295,339,423,762,1057,1311,1549,10.18,3.91,3.31,2.67
27-05-2021,PAREDES,27,2,31,"[0,120]",Baixo a Moderado,,,,27,Norte,PORTO,1310,15675.69,86067,4272,3532,2412,1717,1258,2975,5387,8919,13191,549.04,84.15,56.9,34.36
27-05-2021,PAREDES DE COURA,1,0,12,"[0,120]",Baixo a Moderado,,,,1,Norte,VIANA DO CASTELO,1605,13818.59,8535,466,528,407,465,515,980,1387,1915,2381,61.76,17.23,13.86,10.04
27-05-2021,PEDRÓGÃO GRANDE,0,0,0,"[0,120]",Baixo a Moderado,,,,0,Centro,LEIRIA,1013,12874.75,3410,175,173,196,221,252,473,669,842,1017,26.49,7.9,6.54,5.2
27-05-2021,PENACOVA,9,1,66,"[0,120]",Baixo a Moderado,,,,9,Centro,COIMBRA,0613,21673.23,13694,968,923,745,621,703,1324,2069,2992,3960,63.18,18.27,13.81,9.55
27-05-2021,PENAFIEL,56,4,80,"[0,120]",Baixo a Moderado,,,,56,Norte,PORTO,1311,21224.27,69772,3648,2823,2032,1663,1230,2893,4925,7748,11396,328.74,53.69,36.51,23.2
27-05-2021,PENALVA DO CASTELO,4,0,56,"[0,120]",Baixo a Moderado,,,,4,Centro,VISEU,1811,13433.92,7115,449,457,413,391,426,817,1230,1687,2136,52.96,15.9,12.56,9.16
27-05-2021,PENAMACOR,1,0,21,"[0,120]",Baixo a Moderado,,,,1,Centro,CASTELO BRANCO,0507,56370.69,4755,262,248,273,451,633,1084,1357,1605,1867,8.44,3.31,2.85,2.41
27-05-2021,PENEDONO,0,0,0,"[0,120]",Baixo a Moderado,,,,0,Norte,VISEU,1812,13370.75,2591,172,113,129,156,138,294,423,536,708,19.38,5.3,4.01,3.16
27-05-2021,PENELA,0,0,0,"[0,120]",Baixo a Moderado,,,,0,Centro,COIMBRA,0614,13480.0,5397,314,324,274,359,344,703,977,1301,1615,40.04,11.98,9.65,7.25
27-05-2021,PENICHE,9,1,34,"[0,120]",Baixo a Moderado,,,,9,Lisboa e Vale do Tejo,LEIRIA,1014,7754.98,26501,1746,1504,1203,926,707,1633,2836,4340,6086,341.73,78.48,55.96,36.57
27-05-2021,PESO DA RÉGUA,2,0,13,"[0,120]",Baixo a Moderado,,,,2,Norte,VILA REAL,1708,9486.01,15773,1076,843,650,659,455,1114,1764,2607,3683,166.28,38.83,27.48,18.6
27-05-2021,PINHEL,2,0,23,"[0,120]",Baixo a Moderado,,,,2,Centro,GUARDA,0910,48452.12,8511,577,566,551,538,689,1227,1778,2344,2921,17.57,6.03,4.84,3.67
27-05-2021,POMBAL,18,1,35,"[0,120]",Baixo a Moderado,,,,18,Centro,LEIRIA,1015,62600.28,51461,3187,2791,2494,2328,2027,4355,6849,9640,12827,82.21,20.49,15.4,10.94
27-05-2021,PONTA DELGADA,61,4,90,"[0,120]",Baixo a Moderado,,,,61,Açores,AÇORES,4203,23298.65,67935,3108,2435,1726,1133,902,2035,3761,6196,9304,291.58,39.93,26.59,16.14
27-05-2021,PONTA DO SOL,13,1,151,"[120,240]",Moderado,,,,13,Madeira,MADEIRA,3105,4622.03,8593,319,283,347,208,221,429,776,1059,1378,185.92,29.81,22.91,16.79
27-05-2021,PONTE DA BARCA,3,0,27,"[0,120]",Baixo a Moderado,,,,3,Norte,VIANA DO CASTELO,1606,18211.37,11180,635,576,517,554,490,1044,1561,2137,2772,61.39,15.22,11.73,8.57
27-05-2021,PONTE DE LIMA,2,0,5,"[0,120]",Baixo a Moderado,,,,2,Norte,VIANA DO CASTELO,1607,32025.46,41315,2321,2022,1720,1596,1462,3058,4778,6800,9121,129.01,28.48,21.23,14.92
27-05-2021,PONTE DE SOR,4,0,27,"[0,120]",Baixo a Moderado,,,,4,Alentejo,PORTALEGRE,1213,83971.16,14994,939,800,716,739,831,1570,2286,3086,4025,17.86,4.79,3.68,2.72
27-05-2021,PORTALEGRE,0,0,0,"[0,120]",Baixo a Moderado,,,,0,Alentejo,PORTALEGRE,1214,44713.64,22172,1577,1351,1137,993,984,1977,3114,4465,6042,49.59,13.51,9.99,6.96
27-05-2021,PORTEL,0,0,0,"[0,120]",Baixo a Moderado,,,,0,Alentejo,ÉVORA,0709,60100.57,5828,336,358,283,331,305,636,919,1277,1613,9.7,2.68,2.12,1.53
27-05-2021,PORTIMÃO,40,3,72,"[0,120]",Baixo a Moderado,,,,40,Algarve,FARO,0811,18206.29,55483,3182,2927,2116,1582,1400,2982,5098,8025,11207,304.75,61.56,44.08,28.0
27-05-2021,PORTO,162,12,75,"[0,120]",Baixo a Moderado,,,,162,Norte,PORTO,1312,4142.02,216606,15790,15193,11280,9409,10044,19453,30733,45926,61716,5229.5,1490.0,1108.79,741.98
27-05-2021,PORTO DE MÓS,5,0,21,"[0,120]",Baixo a Moderado,,,,5,Centro,LEIRIA,1016,26183.41,23275,1355,1210,1034,888,872,1760,2794,4004,5359,88.89,20.47,15.29,10.67
27-05-2021,PORTO MONIZ,1,0,43,"[0,120]",Baixo a Moderado,,,,1,Madeira,MADEIRA,3106,8293.38,2342,143,130,95,98,120,218,313,443,586,28.24,7.07,5.34,3.77
27-05-2021,PORTO SANTO,1,0,19,"[0,120]",Baixo a Moderado,,,,1,Madeira,MADEIRA,3201,4300.7,5202,240,157,134,110,68,178,312,469,709,120.95,16.48,10.9,7.25
27-05-2021,PÓVOA DE LANHOSO,14,1,65,"[0,120]",Baixo a Moderado,,,,14,Norte,BRAGA,0309,13465.29,21499,1175,909,732,673,624,1297,2029,2938,4113,159.67,30.55,21.82,15.07
27-05-2021,PÓVOA DE VARZIM,27,2,43,"[0,120]",Baixo a Moderado,,,,27,Norte,PORTO,1313,8220.59,62784,3712,3120,2134,1594,1305,2899,5033,8153,11865,763.7,144.33,99.17,61.22
27-05-2021,POVOAÇÃO,1,0,17,"[0,120]",Baixo a Moderado,,,,1,Açores,AÇORES,4204,10640.77,5927,293,212,191,144,134,278,469,681,974,55.7,9.15,6.4,4.41
27-05-2021,VILA DA PRAIA DA VITÓRIA,1,0,5,"[0,120]",Baixo a Moderado,,,,1,Açores,AÇORES,4302,16127.06,21317,1133,789,619,436,336,772,1391,2180,3313,132.18,20.54,13.52,8.63
27-05-2021,PROENÇA-A-NOVA,1,0,14,"[0,120]",Baixo a Moderado,,,,1,Centro,CASTELO BRANCO,0508,39539.96,7298,508,465,389,400,560,960,1349,1814,2322,18.46,5.87,4.59,3.41
27-05-2021,REDONDO,0,0,0,"[0,120]",Baixo a Moderado,,,,0,Alentejo,ÉVORA,0710,36950.87,6353,349,325,288,288,354,642,930,1255,1604,17.19,4.34,3.4,2.52
27-05-2021,REGUENGOS DE MONSARAZ,0,0,0,"[0,120]",Baixo a Moderado,,,,0,Alentejo,ÉVORA,0711,46399.72,10015,602,511,455,462,473,935,1390,1901,2503,21.58,5.39,4.1,3.0
27-05-2021,RESENDE,1,0,10,"[0,120]",Baixo a Moderado,,,,1,Norte,VISEU,1813,12334.93,10137,560,493,448,433,422,855,1303,1796,2356,82.18,19.1,14.56,10.56
27-05-2021,RIBEIRA BRAVA,25,2,201,"[120,240]",Moderado,,,,25,Madeira,MADEIRA,3107,6544.88,12435,648,500,411,311,287,598,1009,1509,2157,189.99,32.96,23.06,15.42
27-05-2021,RIBEIRA DE PENA,1,0,17,"[0,120]",Baixo a Moderado,,,,1,Norte,VILA REAL,1709,21745.98,6016,371,301,290,310,368,678,968,1269,1640,27.66,7.54,5.84,4.45
27-05-2021,RIBEIRA GRANDE,203,15,619,"[480,960]",Muito Elevado,,,,203,Açores,AÇORES,4205,18015.13,32811,1163,689,512,345,253,598,1110,1799,2962,182.13,16.44,9.99,6.16
27-05-2021,RIO MAIOR,15,1,74,"[0,120]",Baixo a Moderado,,,,15,Lisboa e Vale do Tejo,SANTARÉM,1414,27276.45,20379,1251,1144,941,795,648,1443,2384,3528,4779,74.71,17.52,12.93,8.74
27-05-2021,SABROSA,1,0,17,"[0,120]",Baixo a Moderado,,,,1,Norte,VILA REAL,1710,15692.45,5918,393,314,304,302,350,652,956,1270,1663,37.71,10.6,8.09,6.09
27-05-2021,SABUGAL,6,0,57,"[0,120]",Baixo a Moderado,,,,6,Centro,GUARDA,0911,82269.82,10585,724,707,694,796,1009,1805,2499,3206,3930,12.87,4.78,3.9,3.04
27-05-2021,SALVATERRA DE MAGOS,28,2,131,"[120,240]",Moderado,,,,28,Lisboa e Vale do Tejo,SANTARÉM,1415,24393.2,21295,1275,1181,1060,799,772,1571,2631,3812,5087,87.3,20.85,15.63,10.79
27-05-2021,SANTA COMBA DÃO,11,1,105,"[0,120]",Baixo a Moderado,,,,11,Centro,VISEU,1814,11194.77,10452,732,684,569,538,464,1002,1571,2255,2987,93.36,26.68,20.14,14.03
27-05-2021,SANTA CRUZ,38,3,84,"[0,120]",Baixo a Moderado,,,,38,Madeira,MADEIRA,3108,8150.28,45281,1817,1301,974,716,523,1239,2213,3514,5331,555.6,65.41,43.12,27.15
27-05-2021,SANTA CRUZ DA GRACIOSA,0,0,0,"[0,120]",Baixo a Moderado,,,,0,Açores,AÇORES,4401,6065.78,4208,228,180,163,124,145,269,432,612,840,69.37,13.85,10.09,7.12
27-05-2021,SANTA CRUZ DAS FLORES,0,0,0,"[0,120]",Baixo a Moderado,,,,0,Açores,AÇORES,4802,7091.44,2165,125,98,74,56,51,107,181,279,404,30.53,5.7,3.93,2.55
27-05-2021,SANTA MARIA DA FEIRA,85,6,61,"[0,120]",Baixo a Moderado,,,,85,Norte,AVEIRO,0109,21587.65,138636,8182,6743,4771,3856,3079,6935,11706,18449,26631,642.19,123.36,85.46,54.22
27-05-2021,SANTA MARTA DE PENAGUIÃO,1,0,15,"[0,120]",Baixo a Moderado,,,,1,Norte,VILA REAL,1711,6928.13,6599,483,373,337,316,317,633,970,1343,1826,95.25,26.36,19.39,14.0
27-05-2021,SANTANA,10,1,149,"[120,240]",Moderado,,,,10,Madeira,MADEIRA,3109,9547.3,6711,418,353,343,282,277,559,902,1255,1673,70.29,17.52,13.15,9.45
27-05-2021,SANTARÉM,10,1,17,"[0,120]",Baixo a Moderado,,,,10,Lisboa e Vale do Tejo,SANTARÉM,1416,55253.58,57421,3654,3441,2760,2466,2206,4672,7432,10873,14527,103.92,26.29,19.68,13.45
27-05-2021,SANTIAGO DO CACÉM,8,1,28,"[0,120]",Baixo a Moderado,,,,8,Alentejo,SETÚBAL,1509,105969.29,28791,2144,1689,1472,1295,1215,2510,3982,5671,7815,27.17,7.37,5.35,3.76
27-05-2021,SANTO TIRSO,41,3,60,"[0,120]",Baixo a Moderado,,,,41,Norte,PORTO,1314,13655.52,68055,4911,3935,2761,2257,1810,4067,6828,10763,15674,498.35,114.78,78.82,50.0
27-05-2021,SÃO BRÁS DE ALPORTEL,2,0,19,"[0,120]",Baixo a Moderado,,,,2,Algarve,FARO,0812,15336.92,10416,596,468,467,404,401,805,1272,1740,2336,67.91,15.23,11.35,8.29
27-05-2021,SÃO JOÃO DA MADEIRA,11,1,50,"[0,120]",Baixo a Moderado,,,,11,Norte,AVEIRO,0116,794.3,21958,1347,1069,796,601,593,1194,1990,3059,4406,2765.49,554.91,385.26,250.63
27-05-2021,SÃO JOÃO DA PESQUEIRA,2,0,28,"[0,120]",Baixo a Moderado,,,,2,Norte,VISEU,1815,26610.85,7125,417,330,294,328,328,656,950,1280,1697,26.77,6.38,4.81,3.57
27-05-2021,SÃO PEDRO DO SUL,1,0,6,"[0,120]",Baixo a Moderado,,,,1,Centro,VISEU,1816,34895.09,15403,990,962,861,759,909,1668,2529,3491,4481,44.14,12.84,10.0,7.25
27-05-2021,SÃO ROQUE DO PICO,1,0,31,"[0,120]",Baixo a Moderado,,,,1,Açores,AÇORES,4603,14236.1,3266,199,141,93,96,113,209,302,443,642,22.94,4.51,3.11,2.12
27-05-2021,SÃO VICENTE,3,0,58,"[0,120]",Baixo a Moderado,,,,3,Madeira,MADEIRA,3110,7883.71,5143,272,264,266,225,280,505,771,1035,1307,65.23,16.58,13.13,9.78
27-05-2021,SARDOAL,0,0,0,"[0,120]",Baixo a Moderado,,,,0,Lisboa e Vale do Tejo,SANTARÉM,1417,9214.72,3741,227,178,148,165,248,413,561,739,966,40.6,10.48,8.02,6.09
27-05-2021,SÁTÃO,5,0,43,"[0,120]",Baixo a Moderado,,,,5,Centro,VISEU,1817,20194.11,11580,765,671,515,465,476,941,1456,2127,2892,57.34,14.32,10.53,7.21
27-05-2021,SEIA,15,1,67,"[0,120]",Baixo a Moderado,,,,15,Centro,GUARDA,0912,43568.83,22234,1807,1589,1238,1122,721,1843,3081,4670,6477,51.03,14.87,10.72,7.07
27-05-2021,SEIXAL,59,4,35,"[0,120]",Baixo a Moderado,,,,59,Lisboa e Vale do Tejo,SETÚBAL,1510,9545.17,167752,10586,9270,6661,4391,2930,7321,13982,23252,33838,1757.49,354.51,243.6,146.49
27-05-2021,SERNANCELHE,0,0,0,"[0,120]",Baixo a Moderado,,,,0,Norte,VISEU,1818,22861.22,5396,305,293,286,273,260,533,819,1112,1417,23.6,6.2,4.86,3.58
27-05-2021,SERPA,2,0,14,"[0,120]",Baixo a Moderado,,,,2,Alentejo,BEJA,0213,110563.34,14304,903,761,719,697,626,1323,2042,2803,3706,12.94,3.35,2.54,1.85
27-05-2021,SERTÃ,0,0,0,"[0,120]",Baixo a Moderado,,,,0,Centro,CASTELO BRANCO,0509,44673.17,14577,870,779,790,767,1020,1787,2577,3356,4226,32.63,9.46,7.51,5.77
27-05-2021,SESIMBRA,23,2,44,"[0,120]",Baixo a Moderado,,,,23,Lisboa e Vale do Tejo,SETÚBAL,1511,19571.75,51858,2400,2321,1853,1257,1083,2340,4193,6514,8914,264.96,45.54,33.28,21.42
27-05-2021,SETÚBAL,58,4,50,"[0,120]",Baixo a Moderado,,,,58,Lisboa e Vale do Tejo,SETÚBAL,1512,23032.5,115126,7425,6929,5075,3775,2655,6430,11505,18434,25859,499.83,112.27,80.03,49.95
27-05-2021,SEVER DO VOUGA,6,0,53,"[0,120]",Baixo a Moderado,,,,6,Centro,AVEIRO,0117,12987.56,11331,766,637,568,540,567,1107,1675,2312,3078,87.24,23.7,17.8,12.9
27-05-2021,SILVES,10,1,28,"[0,120]",Baixo a Moderado,,,,10,Algarve,FARO,0813,68006.23,36226,2137,1869,1610,1423,1600,3023,4633,6502,8639,53.27,12.7,9.56,6.81
27-05-2021,SINES,2,0,15,"[0,120]",Baixo a Moderado,,,,2,Alentejo,SETÚBAL,1513,20330.17,13715,888,791,551,416,268,684,1235,2026,2914,67.46,14.33,9.97,6.07
27-05-2021,SINTRA,223,16,57,"[0,120]",Baixo a Moderado,,,,223,Lisboa e Vale do Tejo,LISBOA,1111,31922.73,391402,20490,18316,13545,9137,7284,16421,29966,48282,68772,1226.08,215.43,151.25,93.87
27-05-2021,SOBRAL DE MONTE AGRAÇO,9,1,84,"[0,120]",Baixo a Moderado,,,,9,Lisboa e Vale do Tejo,LISBOA,1112,5210.32,10651,564,507,352,272,212,484,836,1343,1907,204.43,36.6,25.78,16.05
27-05-2021,SOURE,12,1,70,"[0,120]",Baixo a Moderado,,,,12,Centro,COIMBRA,0615,26506.07,17120,1173,1142,1004,883,987,1870,2874,4016,5189,64.59,19.58,15.15,10.84
27-05-2021,SOUSEL,0,0,0,"[0,120]",Baixo a Moderado,,,,0,Alentejo,PORTALEGRE,1215,27932.18,4412,261,274,208,302,292,594,802,1076,1337,15.8,4.79,3.85,2.87
27-05-2021,TÁBUA,4,0,35,"[0,120]",Baixo a Moderado,,,,4,Centro,COIMBRA,0616,19978.58,11368,729,584,524,430,464,894,1418,2002,2731,56.9,13.67,10.02,7.1
27-05-2021,TABUAÇO,1,0,17,"[0,120]",Baixo a Moderado,,,,1,Norte,VISEU,1819,13385.67,6033,372,314,217,282,363,645,862,1176,1548,45.07,11.56,8.79,6.44
27-05-2021,TAROUCA,2,0,26,"[0,120]",Baixo a Moderado,,,,2,Norte,VISEU,1820,10008.49,7804,405,335,313,277,324,601,914,1249,1654,77.98,16.53,12.48,9.13
27-05-2021,TAVIRA,34,2,139,"[120,240]",Moderado,,,,34,Algarve,FARO,0814,60696.7,24530,1493,1415,1252,1066,1277,2343,3595,5010,6503,40.41,10.71,8.25,5.92
27-05-2021,TERRAS DE BOURO,1,0,16,"[0,120]",Baixo a Moderado,,,,1,Norte,BRAGA,0310,27746.07,6361,391,372,296,319,340,659,955,1327,1718,22.93,6.19,4.78,3.44
27-05-2021,TOMAR,4,0,11,"[0,120]",Baixo a Moderado,,,,4,Lisboa e Vale do Tejo,SANTARÉM,1418,35120.44,36748,2403,2189,1868,1853,1822,3675,5543,7732,10135,104.64,28.86,22.02,15.78
27-05-2021,TONDELA,5,0,19,"[0,120]",Baixo a Moderado,,,,5,Centro,VISEU,1821,37121.73,26357,1768,1722,1518,1475,1417,2892,4410,6132,7900,71.0,21.28,16.52,11.88
27-05-2021,TORRE DE MONCORVO,1,0,13,"[0,120]",Baixo a Moderado,,,,1,Norte,BRAGANÇA,0409,53155.67,7695,556,478,488,551,719,1270,1758,2236,2792,14.48,5.25,4.21,3.31
27-05-2021,TORRES NOVAS,19,1,54,"[0,120]",Baixo a Moderado,,,,19,Lisboa e Vale do Tejo,SANTARÉM,1419,26999.68,34933,2324,1979,1738,1406,1475,2881,4619,6598,8922,129.38,33.04,24.44,17.11
27-05-2021,TORRES VEDRAS,49,3,62,"[0,120]",Baixo a Moderado,,,,49,Lisboa e Vale do Tejo,LISBOA,1113,40714.89,78530,4513,3945,3447,2628,2104,4732,8179,12124,16637,192.88,40.86,29.78,20.09
27-05-2021,TRANCOSO,0,0,0,"[0,120]",Baixo a Moderado,,,,0,Centro,GUARDA,0913,36152.47,8875,581,557,542,586,496,1082,1624,2181,2762,24.55,7.64,6.03,4.49
27-05-2021,TROFA,19,1,49,"[0,120]",Baixo a Moderado,,,,19,Norte,PORTO,1318,7201.76,38418,2336,1894,1231,939,684,1623,2854,4748,7084,533.44,98.36,65.93,39.63
27-05-2021,VAGOS,4,0,18,"[0,120]",Baixo a Moderado,,,,4,Centro,AVEIRO,0118,16491.5,22740,1320,1205,922,784,724,1508,2430,3635,4955,137.89,30.04,22.04,14.73
27-05-2021,VALE DE CAMBRA,30,2,141,"[120,240]",Moderado,,,,30,Norte,AVEIRO,0119,14733.47,21327,1491,1363,1005,831,798,1629,2634,3997,5488,144.76,37.25,27.13,17.88
27-05-2021,VALENÇA,3,0,23,"[0,120]",Baixo a Moderado,,,,3,Norte,VIANA DO CASTELO,1608,11712.86,13290,867,791,582,582,503,1085,1667,2458,3325,113.46,28.39,20.99,14.23
27-05-2021,VALONGO,40,3,41,"[0,120]",Baixo a Moderado,,,,40,Norte,PORTO,1315,7512.45,97444,5629,4696,3207,2462,1829,4291,7498,12194,17823,1297.18,237.26,162.33,99.81
27-05-2021,VALPAÇOS,11,1,74,"[0,120]",Baixo a Moderado,,,,11,Norte,VILA REAL,1712,54873.93,14818,1217,1118,999,928,997,1925,2924,4042,5259,27.0,9.58,7.37,5.33
27-05-2021,VELAS,1,0,20,"[0,120]",Baixo a Moderado,,,,1,Açores,AÇORES,4502,11738.38,5093,278,208,166,153,113,266,432,640,918,43.39,7.82,5.45,3.68
27-05-2021,VENDAS NOVAS,5,0,44,"[0,120]",Baixo a Moderado,,,,5,Alentejo,ÉVORA,0712,22238.88,11255,677,768,655,501,532,1033,1688,2456,3133,50.61,14.09,11.04,7.59
27-05-2021,VIANA DO ALENTEJO,1,0,19,"[0,120]",Baixo a Moderado,,,,1,Alentejo,ÉVORA,0713,39367.29,5145,245,208,235,210,214,424,659,867,1112,13.07,2.82,2.2,1.67
27-05-2021,VIANA DO CASTELO,75,5,89,"[0,120]",Baixo a Moderado,,,,75,Norte,VIANA DO CASTELO,1609,31902.01,84417,5470,4433,3591,3061,2982,6043,9634,14067,19537,264.61,61.24,44.09,30.2
27-05-2021,VIDIGUEIRA,1,0,18,"[0,120]",Baixo a Moderado,,,,1,Alentejo,BEJA,0214,31661.09,5510,300,248,215,233,275,508,723,971,1271,17.4,4.01,3.07,2.28
27-05-2021,VIEIRA DO MINHO,0,0,0,"[0,120]",Baixo a Moderado,,,,0,Norte,BRAGA,0311,21644.35,11842,703,594,525,548,482,1030,1555,2149,2852,54.71,13.18,9.93,7.18
27-05-2021,VILA DE REI,1,0,30,"[0,120]",Baixo a Moderado,,,,1,Centro,CASTELO BRANCO,0510,19154.6,3323,169,128,172,247,302,549,721,849,1018,17.35,5.31,4.43,3.76
27-05-2021,VILA DO BISPO,14,1,272,"[240,480]",Elevado,,,,14,Algarve,FARO,0815,17906.06,5154,302,302,314,232,233,465,779,1081,1383,28.78,7.72,6.04,4.35
27-05-2021,VILA DO CONDE,54,4,68,"[0,120]",Baixo a Moderado,,,,54,Norte,PORTO,1316,14902.77,79899,4726,3875,2819,2070,1743,3813,6632,10507,15233,536.13,102.21,70.5,44.5
27-05-2021,VILA DO PORTO,0,0,0,"[0,120]",Baixo a Moderado,,,,0,Açores,AÇORES,4101,9688.74,5616,274,212,135,96,123,219,354,566,840,57.96,8.67,5.84,3.65
27-05-2021,VILA FLOR,1,0,17,"[0,120]",Baixo a Moderado,,,,1,Norte,BRAGANÇA,0410,26581.14,6044,429,362,422,294,331,625,1047,1409,1838,22.74,6.91,5.3,3.94
27-05-2021,VILA FRANCA DE XIRA,45,3,32,"[0,120]",Baixo a Moderado,,,,45,Lisboa e Vale do Tejo,LISBOA,1114,31819.39,141957,8501,6852,4869,3425,2472,5897,10766,17618,26119,446.14,82.09,55.37,33.84
27-05-2021,VILA FRANCA DO CAMPO,36,3,326,"[240,480]",Elevado,,,,36,Açores,AÇORES,4206,7796.82,11051,450,344,248,217,154,371,619,963,1413,141.73,18.12,12.35,7.94
27-05-2021,VILA NOVA DA BARQUINHA,6,0,80,"[0,120]",Baixo a Moderado,,,,6,Lisboa e Vale do Tejo,SANTARÉM,1420,4952.97,7461,415,406,392,364,338,702,1094,1500,1915,150.64,38.66,30.28,22.09
27-05-2021,VILA NOVA DE CERVEIRA,0,0,0,"[0,120]",Baixo a Moderado,,,,0,Norte,VIANA DO CASTELO,1610,10846.66,8910,531,444,410,384,334,718,1128,1572,2103,82.14,19.39,14.49,10.4
27-05-2021,VILA NOVA DE FAMALICÃO,49,3,37,"[0,120]",Baixo a Moderado,,,,49,Norte,BRAGA,0312,20159.26,131676,7817,6164,4202,3282,2749,6031,10233,16397,24214,653.19,120.12,81.34,50.76
27-05-2021,VILA NOVA DE FOZ CÔA,2,0,31,"[0,120]",Baixo a Moderado,,,,2,Centro,GUARDA,0914,39815.18,6503,442,385,390,398,429,827,1217,1602,2044,16.33,5.13,4.02,3.06
27-05-2021,VILA NOVA DE GAIA,144,10,48,"[0,120]",Baixo a Moderado,,,,144,Norte,PORTO,1317,16846.43,300472,18349,15568,10972,8224,6281,14505,25477,41045,59394,1783.64,352.57,243.65,151.23
27-05-2021,VILA NOVA DE PAIVA,8,1,171,"[120,240]",Moderado,,,,8,Centro,VISEU,1822,17553.28,4687,289,272,233,217,241,458,691,963,1252,26.7,7.13,5.49,3.94
27-05-2021,VILA NOVA DE POIARES,4,0,58,"[0,120]",Baixo a Moderado,,,,4,Centro,COIMBRA,0617,8445.3,6939,380,284,262,235,182,417,679,963,1343,82.17,15.9,11.4,8.04
27-05-2021,VILA POUCA DE AGUIAR,3,0,25,"[0,120]",Baixo a Moderado,,,,3,Norte,VILA REAL,1713,43706.62,11961,860,817,733,601,627,1228,1961,2778,3638,27.37,8.32,6.36,4.49
27-05-2021,VILA REAL,8,1,16,"[0,120]",Baixo a Moderado,,,,8,Norte,VILA REAL,1714,37880.28,49962,3025,2498,2065,1579,1466,3045,5110,7608,10633,131.9,28.07,20.08,13.49
27-05-2021,VILA REAL DE SANTO ANTÓNIO,1,0,5,"[0,120]",Baixo a Moderado,,,,1,Algarve,FARO,0816,6125.0,18749,1172,1069,811,569,586,1155,1966,3035,4207,306.11,68.69,49.55,32.1
27-05-2021,VILA VELHA DE RÓDÃO,0,0,0,"[0,120]",Baixo a Moderado,,,,0,Centro,CASTELO BRANCO,0511,32991.16,3144,209,229,180,283,306,589,769,998,1207,9.53,3.66,3.03,2.33
27-05-2021,VILA VERDE,48,3,102,"[0,120]",Baixo a Moderado,,,,48,Norte,BRAGA,0313,22866.52,46911,2365,2063,1667,1494,1437,2931,4598,6661,9026,205.15,39.47,29.13,20.11
27-05-2021,VILA VIÇOSA,0,0,0,"[0,120]",Baixo a Moderado,,,,0,Alentejo,ÉVORA,0714,19485.89,7656,487,379,342,345,324,669,1011,1390,1877,39.29,9.63,7.13,5.19
27-05-2021,VIMIOSO,2,0,50,"[0,120]",Baixo a Moderado,,,,2,Norte,BRAGANÇA,0411,48158.51,4023,274,230,261,293,335,628,889,1119,1393,8.35,2.89,2.32,1.85
27-05-2021,VINHAIS,2,0,26,"[0,120]",Baixo a Moderado,,,,2,Norte,BRAGANÇA,0412,69475.09,7746,599,577,636,641,815,1456,2092,2669,3268,11.15,4.7,3.84,3.01
27-05-2021,VISEU,31,2,32,"[0,120]",Baixo a Moderado,,,,31,Centro,VISEU,1823,50710.14,97249,5769,5038,4140,3158,2710,5868,10008,15046,20815,191.77,41.05,29.67,19.74
27-05-2021,VIZELA,3,0,13,"[0,120]",Baixo a Moderado,,,,3,Norte,BRAGA,0314,2469.83,23897,1258,928,655,509,371,880,1535,2463,3721,967.49,150.65,99.72,62.15
27-05-2021,VOUZELA,0,0,0,"[0,120]",Baixo a Moderado,,,,0,Centro,VISEU,1824,19369.46,9619,626,605,554,532,507,1039,1593,2198,2824,49.66,14.58,11.35,8.22
02-06-2021,ABRANTES,5,0,14,"[0,120]",Baixo a Moderado,,,,5,Lisboa e Vale do Tejo,SANTARÉM,1401,71469.08,35130,2473,2213,1730,1748,2021,3769,5499,7712,10185,49.15,14.25,10.79,7.69
02-06-2021,ÁGUEDA,31,2,67,"[0,120]",Baixo a Moderado,,,,31,Centro,AVEIRO,0101,33527.44,46075,3237,2713,2090,1635,1496,3131,5221,7934,11171,137.43,33.32,23.66,15.57
02-06-2021,AGUIAR DA BEIRA,1,0,21,"[0,120]",Baixo a Moderado,,,,1,Centro,GUARDA,0901,20676.57,4652,304,281,235,239,148,387,622,903,1207,22.5,5.84,4.37,3.01
02-06-2021,ALANDROAL,0,0,0,"[0,120]",Baixo a Moderado,,,,0,Alentejo,ÉVORA,0701,54267.81,4992,307,256,296,299,377,676,972,1228,1535,9.2,2.83,2.26,1.79
02-06-2021,ALBERGARIA-A-VELHA,6,0,25,"[0,120]",Baixo a Moderado,,,,6,Centro,AVEIRO,0102,15882.5,24144,1550,1298,996,687,680,1367,2363,3661,5211,152.02,32.81,23.05,14.88
02-06-2021,ALBUFEIRA,33,2,79,"[0,120]",Baixo a Moderado,,,,33,Algarve,FARO,0801,14066.42,41528,2067,1717,1425,985,858,1843,3268,4985,7052,295.24,50.14,35.44,23.23
02-06-2021,ALCÁCER DO SAL,1,0,9,"[0,120]",Baixo a Moderado,,,,1,Alentejo,SETÚBAL,1501,149987.3,11659,884,814,623,623,602,1225,1848,2662,3546,7.77,2.36,1.77,1.23
02-06-2021,ALCANENA,10,1,78,"[0,120]",Baixo a Moderado,,,,10,Lisboa e Vale do Tejo,SANTARÉM,1402,12732.86,12809,891,744,628,536,588,1124,1752,2496,3387,100.6,26.6,19.6,13.76
02-06-2021,ALCOBAÇA,2,0,4,"[0,120]",Baixo a Moderado,,,,2,Lisboa e Vale do Tejo,LEIRIA,1001,40814.09,53555,3420,2927,2466,2059,1676,3735,6201,9128,12548,131.22,30.74,22.36,15.19
02-06-2021,ALCOCHETE,11,1,56,"[0,120]",Baixo a Moderado,,,,11,Lisboa e Vale do Tejo,SETÚBAL,1502,12836.48,19787,857,834,691,476,447,923,1614,2448,3305,154.15,25.75,19.07,12.57
02-06-2021,ALCOUTIM,0,0,0,"[0,120]",Baixo a Moderado,,,,0,Algarve,FARO,0802,57536.33,2159,191,188,163,190,267,457,620,808,999,3.75,1.74,1.4,1.08
02-06-2021,ALENQUER,47,3,107,"[0,120]",Baixo a Moderado,,,,47,Lisboa e Vale do Tejo,LISBOA,1101,30421.92,44052,2298,2062,1629,1330,1155,2485,4114,6176,8474,144.8,27.85,20.3,13.52
02-06-2021,ALFÂNDEGA DA FÉ,0,0,0,"[0,120]",Baixo a Moderado,,,,0,Norte,BRAGANÇA,0401,32194.64,4550,325,277,301,274,325,599,900,1177,1502,14.13,4.67,3.66,2.8
02-06-2021,ALIJÓ,2,0,19,"[0,120]",Baixo a Moderado,,,,2,Norte,VILA REAL,1701,29759.89,10625,766,687,635,542,666,1208,1843,2530,3296,35.7,11.08,8.5,6.19
02-06-2021,ALJEZUR,5,0,89,"[0,120]",Baixo a Moderado,,,,5,Algarve,FARO,0803,32349.95,5594,316,336,335,320,410,730,1065,1401,1717,17.29,5.31,4.33,3.29
02-06-2021,ALJUSTREL,0,0,0,"[0,120]",Baixo a Moderado,,,,0,Alentejo,BEJA,0201,45847.41,8247,635,521,443,347,358,705,1148,1669,2304,17.99,5.03,3.64,2.5
02-06-2021,ALMADA,135,10,80,"[0,120]",Baixo a Moderado,,,,135,Lisboa e Vale do Tejo,SETÚBAL,1503,7000.89,169039,10469,9777,7876,6144,5111,11255,19131,28908,39377,2414.5,562.45,412.91,273.26
02-06-2021,ALMEIDA,0,0,0,"[0,120]",Baixo a Moderado,,,,0,Centro,GUARDA,0902,51798.46,5830,441,419,396,458,393,851,1247,1666,2107,11.26,4.07,3.22,2.41
02-06-2021,ALMEIRIM,7,0,31,"[0,120]",Baixo a Moderado,,,,7,Lisboa e Vale do Tejo,SANTARÉM,1403,22212.05,22546,1342,1353,1106,866,843,1709,2815,4168,5510,101.5,24.81,18.76,12.67
02-06-2021,ALMODÔVAR,0,0,0,"[0,120]",Baixo a Moderado,,,,0,Alentejo,BEJA,0202,77788.03,6725,414,443,396,373,328,701,1097,1540,1954,8.65,2.51,1.98,1.41
02-06-2021,ALPIARÇA,2,0,28,"[0,120]",Baixo a Moderado,,,,2,Lisboa e Vale do Tejo,SANTARÉM,1404,9536.33,7059,515,486,363,333,274,607,970,1456,1971,74.02,20.67,15.27,10.17
02-06-2021,ALTER DO CHÃO,1,0,32,"[0,120]",Baixo a Moderado,,,,1,Alentejo,PORTALEGRE,1201,36206.62,3165,201,163,136,208,187,395,531,694,895,8.74,2.47,1.92,1.47
02-06-2021,ALVAIÁZERE,0,0,0,"[0,120]",Baixo a Moderado,,,,0,Centro,LEIRIA,1002,16047.76,6597,419,389,346,406,539,945,1291,1680,2099,41.11,13.08,10.47,8.04
02-06-2021,ALVITO,1,0,40,"[0,120]",Baixo a Moderado,,,,1,Alentejo,BEJA,0203,26485.32,2477,145,110,105,111,89,200,305,415,560,9.35,2.11,1.57,1.15
02-06-2021,AMADORA,153,11,83,"[0,120]",Baixo a Moderado,,,,153,Lisboa e Vale do Tejo,LISBOA,1115,2378.47,184106,11186,10936,8780,6460,5890,12350,21130,32066,43252,7742.05,1818.84,1348.44,888.56
02-06-2021,AMARANTE,24,2,45,"[0,120]",Baixo a Moderado,,,,24,Norte,PORTO,1301,30133.15,53193,3086,2413,1812,1643,1311,2954,4766,7179,10265,176.53,34.07,23.82,15.82
02-06-2021,AMARES,11,1,61,"[0,120]",Baixo a Moderado,,,,11,Norte,BRAGA,0301,8195.41,18129,1001,829,622,489,524,1013,1635,2464,3465,221.22,42.28,30.07,19.95
02-06-2021,ANADIA,9,1,33,"[0,120]",Baixo a Moderado,,,,9,Centro,AVEIRO,0103,21663.48,27258,1931,1698,1376,1208,1262,2470,3846,5544,7475,125.83,34.51,25.59,17.75
02-06-2021,ANGRA DO HEROÍSMO,1,0,3,"[0,120]",Baixo a Moderado,,,,1,Açores,AÇORES,4301,23899.66,33807,2006,1473,1122,768,635,1403,2525,3998,6004,141.45,25.12,16.73,10.56
02-06-2021,ANSIÃO,2,0,17,"[0,120]",Baixo a Moderado,,,,2,Centro,LEIRIA,1003,17609.42,12039,727,709,646,694,530,1224,1870,2579,3306,68.37,18.77,14.65,10.62
02-06-2021,ARCOS DE VALDEVEZ,23,2,110,"[0,120]",Baixo a Moderado,,,,23,Norte,VIANA DO CASTELO,1601,44759.64,20926,1329,1338,1282,1343,1515,2858,4140,5478,6807,46.75,15.21,12.24,9.25
02-06-2021,ARGANIL,17,1,154,"[120,240]",Moderado,,,,17,Centro,COIMBRA,0601,33283.93,11014,672,648,612,559,596,1155,1767,2415,3087,33.09,9.27,7.26,5.31
02-06-2021,ARMAMAR,1,0,17,"[0,120]",Baixo a Moderado,,,,1,Norte,VISEU,1801,11723.73,5769,357,305,309,285,310,595,904,1209,1566,49.21,13.36,10.31,7.71
02-06-2021,AROUCA,8,1,39,"[0,120]",Baixo a Moderado,,,,8,Norte,AVEIRO,0104,32910.52,20720,1306,1047,753,683,683,1366,2119,3166,4472,62.96,13.59,9.62,6.44
02-06-2021,ARRAIOLOS,4,0,58,"[0,120]",Baixo a Moderado,,,,4,Alentejo,ÉVORA,0702,68374.55,6928,435,384,283,367,480,847,1130,1514,1949,10.13,2.85,2.21,1.65
02-06-2021,ARRONCHES,2,0,71,"[0,120]",Baixo a Moderado,,,,2,Alentejo,PORTALEGRE,1202,31464.72,2820,155,142,162,187,179,366,528,670,825,8.96,2.62,2.13,1.68
02-06-2021,ARRUDA DOS VINHOS,11,1,71,"[0,120]",Baixo a Moderado,,,,11,Lisboa e Vale do Tejo,LISBOA,1102,7795.93,15412,738,738,562,509,438,947,1509,2247,2985,197.69,38.29,28.82,19.36
02-06-2021,AVEIRO,13,1,17,"[0,120]",Baixo a Moderado,,,,13,Centro,AVEIRO,0105,19757.57,78734,4520,4004,3050,2250,2103,4353,7403,11407,15927,398.49,80.61,57.73,37.47
02-06-2021,AVIS,1,0,24,"[0,120]",Baixo a Moderado,,,,1,Alentejo,PORTALEGRE,1203,60596.51,4247,315,225,206,251,273,524,730,955,1270,7.01,2.1,1.58,1.2
02-06-2021,AZAMBUJA,13,1,57,"[0,120]",Baixo a Moderado,,,,13,Lisboa e Vale do Tejo,LISBOA,1103,26265.65,22716,1322,1171,1070,798,618,1416,2486,3657,4979,86.48,18.96,13.92,9.46
02-06-2021,BAIÃO,21,1,112,"[0,120]",Baixo a Moderado,,,,21,Norte,PORTO,1302,17452.83,18748,1070,862,714,686,725,1411,2125,2987,4057,107.42,23.25,17.11,12.18
02-06-2021,BARCELOS,76,5,65,"[0,120]",Baixo a Moderado,,,,76,Norte,BRAGA,0302,37890.14,116187,6721,5325,3619,2991,2562,5553,9172,14497,21218,306.64,56.0,38.26,24.21
02-06-2021,BARRANCOS,0,0,0,"[0,120]",Baixo a Moderado,,,,0,Alentejo,BEJA,0204,16841.73,1634,90,65,65,94,61,155,220,285,375,9.7,2.23,1.69,1.31
02-06-2021,BARREIRO,61,4,81,"[0,120]",Baixo a Moderado,,,,61,Lisboa e Vale do Tejo,SETÚBAL,1504,3639.07,75147,5194,5565,4459,3105,1767,4872,9331,14896,20090,2065.05,552.07,409.34,256.42
02-06-2021,BATALHA,1,0,6,"[0,120]",Baixo a Moderado,,,,1,Centro,LEIRIA,1004,10341.6,15963,873,762,649,529,549,1078,1727,2489,3362,154.35,32.51,24.07,16.7
02-06-2021,BEJA,12,1,36,"[0,120]",Baixo a Moderado,,,,12,Alentejo,BEJA,0205,114647.55,33579,2005,1840,1386,1272,1039,2311,3697,5537,7542,29.29,6.58,4.83,3.22
02-06-2021,BELMONTE,1,0,16,"[0,120]",Baixo a Moderado,,,,1,Centro,CASTELO BRANCO,0501,11875.91,6398,444,321,325,310,355,665,990,1311,1755,53.87,14.78,11.04,8.34
02-06-2021,BENAVENTE,17,1,56,"[0,120]",Baixo a Moderado,,,,17,Lisboa e Vale do Tejo,SANTARÉM,1405,52138.39,30602,1468,1376,1141,876,643,1519,2660,4036,5504,58.69,10.56,7.74,5.1
02-06-2021,BOMBARRAL,1,0,8,"[0,120]",Baixo a Moderado,,,,1,Lisboa e Vale do Tejo,LEIRIA,1005,9128.55,12558,875,714,561,491,429,920,1481,2195,3070,137.56,33.63,24.04,16.22
02-06-2021,BORBA,2,0,30,"[0,120]",Baixo a Moderado,,,,2,Alentejo,ÉVORA,0703,14518.65,6736,430,375,279,436,392,828,1107,1482,1912,46.39,13.17,10.21,7.62
02-06-2021,BOTICAS,0,0,0,"[0,120]",Baixo a Moderado,,,,0,Norte,VILA REAL,1702,32195.66,4998,347,306,311,305,380,685,996,1302,1649,15.52,5.12,4.04,3.09
02-06-2021,BRAGA,269,19,147,"[120,240]",Moderado,,,,269,Norte,BRAGA,0303,18339.95,182679,10029,7963,5241,4320,3671,7991,13232,21195,31224,996.07,170.25,115.57,72.15
02-06-2021,BRAGANÇA,19,1,57,"[0,120]",Baixo a Moderado,,,,19,Norte,BRAGANÇA,0402,117357.27,33607,2402,1855,1652,1393,1163,2556,4208,6063,8465,28.64,7.21,5.17,3.59
02-06-2021,CABECEIRAS DE BASTO,3,0,19,"[0,120]",Baixo a Moderado,,,,3,Norte,BRAGA,0304,24182.16,15628,774,594,544,575,574,1149,1693,2287,3061,64.63,12.66,9.46,7.0
02-06-2021,CADAVAL,4,0,29,"[0,120]",Baixo a Moderado,,,,4,Lisboa e Vale do Tejo,LISBOA,1104,17489.3,13673,813,796,756,621,625,1246,2002,2798,3611,78.18,20.65,16.0,11.45
02-06-2021,CALDAS DA RAINHA,6,0,12,"[0,120]",Baixo a Moderado,,,,6,Lisboa e Vale do Tejo,LEIRIA,1006,25569.47,51912,3035,2684,2186,1899,1705,3604,5790,8474,11509,203.03,45.01,33.14,22.64
02-06-2021,CALHETA,4,0,37,"[0,120]",Baixo a Moderado,,,,4,Madeira,MADEIRA,3101,11150.43,10867,576,497,507,399,415,814,1321,1818,2394,97.46,21.47,16.3,11.85
02-06-2021,CALHETA (AÇORES),0,0,0,"[0,120]",Baixo a Moderado,,,,0,Açores,AÇORES,4501,12626.4,3184,215,159,141,139,122,261,402,561,776,25.22,6.15,4.44,3.18
02-06-2021,CÂMARA DE LOBOS,23,2,68,"[0,120]",Baixo a Moderado,,,,23,Madeira,MADEIRA,3102,5216.67,33675,1396,1059,834,545,381,926,1760,2819,4215,645.49,80.79,54.03,33.74
02-06-2021,CAMINHA,2,0,13,"[0,120]",Baixo a Moderado,,,,2,Norte,VIANA DO CASTELO,1602,13652.14,15877,1046,944,818,646,656,1302,2120,3064,4110,116.3,30.11,22.44,15.53
02-06-2021,CAMPO MAIOR,5,0,64,"[0,120]",Baixo a Moderado,,,,5,Alentejo,PORTALEGRE,1204,24720.16,7874,471,364,351,279,327,606,957,1321,1792,31.85,7.25,5.34,3.87
02-06-2021,CANTANHEDE,51,4,146,"[120,240]",Moderado,,,,51,Centro,COIMBRA,0602,39088.02,35011,2346,2096,1880,1709,1451,3160,5040,7136,9482,89.57,24.26,18.26,12.89
02-06-2021,CARRAZEDA DE ANSIÃES,0,0,0,"[0,120]",Baixo a Moderado,,,,0,Norte,BRAGANÇA,0403,27924.09,5666,424,389,391,312,465,777,1168,1557,1981,20.29,7.09,5.58,4.18
02-06-2021,CARREGAL DO SAL,0,0,0,"[0,120]",Baixo a Moderado,,,,0,Centro,VISEU,1802,11689.21,9271,587,562,486,462,376,838,1324,1886,2473,79.31,21.16,16.13,11.33
02-06-2021,CARTAXO,10,1,42,"[0,120]",Baixo a Moderado,,,,10,Lisboa e Vale do Tejo,SANTARÉM,1406,15817.28,23843,1415,1376,1142,861,632,1493,2635,4011,5426,150.74,34.3,25.36,16.66
02-06-2021,CASCAIS,216,15,101,"[0,120]",Baixo a Moderado,,,,216,Lisboa e Vale do Tejo,LISBOA,1105,9740.17,213608,12151,11444,8680,6469,5248,11717,20397,31841,43992,2193.1,451.66,326.91,209.41
02-06-2021,CASTANHEIRA DE PÊRA,0,0,0,"[0,120]",Baixo a Moderado,,,,0,Centro,LEIRIA,1007,6677.45,2614,233,195,157,190,187,377,534,729,962,39.15,14.41,10.92,8.0
02-06-2021,CASTELO BRANCO,5,0,10,"[0,120]",Baixo a Moderado,,,,5,Centro,CASTELO BRANCO,0502,143819.15,51987,3528,3042,2499,2229,2225,4454,6953,9995,13523,36.15,9.4,6.95,4.83
02-06-2021,CASTELO DE PAIVA,22,2,142,"[120,240]",Moderado,,,,22,Norte,AVEIRO,0106,11500.53,15454,881,697,545,420,431,851,1396,2093,2974,134.37,25.86,18.2,12.14
02-06-2021,CASTELO DE VIDE,0,0,0,"[0,120]",Baixo a Moderado,,,,0,Alentejo,PORTALEGRE,1205,26491.24,2919,204,173,179,147,170,317,496,669,873,11.02,3.3,2.53,1.87
02-06-2021,CASTRO DAIRE,4,0,29,"[0,120]",Baixo a Moderado,,,,4,Centro,VISEU,1803,37904.13,13823,942,857,765,732,773,1505,2270,3127,4069,36.47,10.74,8.25,5.99
02-06-2021,CASTRO MARIM,0,0,0,"[0,120]",Baixo a Moderado,,,,0,Algarve,FARO,0804,30084.37,6237,370,345,334,322,344,666,1000,1345,1715,20.73,5.7,4.47,3.32
02-06-2021,CASTRO VERDE,2,0,29,"[0,120]",Baixo a Moderado,,,,2,Alentejo,BEJA,0206,56944.23,6949,437,347,303,275,227,502,805,1152,1589,12.2,2.79,2.02,1.41
02-06-2021,CELORICO DA BEIRA,0,0,0,"[0,120]",Baixo a Moderado,,,,0,Centro,GUARDA,0903,24721.63,6928,430,416,363,369,535,904,1267,1683,2113,28.02,8.55,6.81,5.12
02-06-2021,CELORICO DE BASTO,2,0,11,"[0,120]",Baixo a Moderado,,,,2,Norte,BRAGA,0305,18107.02,19040,1001,802,668,728,729,1457,2125,2927,3928,105.15,21.69,16.17,11.74
02-06-2021,CHAMUSCA,12,1,130,"[120,240]",Moderado,,,,12,Lisboa e Vale do Tejo,SANTARÉM,1407,74600.54,9197,629,583,553,465,579,1044,1597,2180,2809,12.33,3.77,2.92,2.14
02-06-2021,CHAVES,25,2,64,"[0,120]",Baixo a Moderado,,,,25,Norte,VILA REAL,1703,59122.95,39343,2676,2429,1991,1886,1918,3804,5795,8224,10900,66.54,18.44,13.91,9.8
02-06-2021,CINFÃES,10,1,55,"[0,120]",Baixo a Moderado,,,,10,Norte,VISEU,1804,23928.76,18244,1067,902,779,734,758,1492,2271,3173,4240,76.24,17.72,13.26,9.49
02-06-2021,COIMBRA,71,5,53,"[0,120]",Baixo a Moderado,,,,71,Centro,COIMBRA,0603,31939.94,134166,9489,8734,6353,5139,5074,10213,16566,25300,34789,420.06,108.92,79.21,51.87
02-06-2021,CONDEIXA-A-NOVA,6,0,34,"[0,120]",Baixo a Moderado,,,,6,Centro,COIMBRA,0604,13867.47,17733,871,809,717,583,490,1073,1790,2599,3470,127.88,25.02,18.74,12.91
02-06-2021,CONSTÂNCIA,0,0,0,"[0,120]",Baixo a Moderado,,,,0,Lisboa e Vale do Tejo,SANTARÉM,1408,8036.58,4030,211,183,187,148,155,303,490,673,884,50.14,11.0,8.37,6.1
02-06-2021,CORUCHE,2,0,11,"[0,120]",Baixo a Moderado,,,,2,Lisboa e Vale do Tejo,SANTARÉM,1409,111572.03,17471,1294,1090,1095,1096,1019,2115,3210,4300,5594,15.66,5.01,3.85,2.88
02-06-2021,CORVO,0,0,0,"[0,120]",Baixo a Moderado,,,,0,Açores,AÇORES,4901,1711.45,464,22,21,11,13,19,32,43,64,86,27.12,5.03,3.74,2.51
02-06-2021,COVILHÃ,4,0,9,"[0,120]",Baixo a Moderado,,,,4,Centro,CASTELO BRANCO,0503,55560.06,46787,3533,2998,2365,2111,2193,4304,6669,9667,13200,84.21,23.76,17.4,12.0
02-06-2021,CRATO,0,0,0,"[0,120]",Baixo a Moderado,,,,0,Alentejo,PORTALEGRE,1206,39806.88,3129,229,258,163,182,228,410,573,831,1060,7.86,2.66,2.09,1.44
02-06-2021,CUBA,4,0,87,"[0,120]",Baixo a Moderado,,,,4,Alentejo,BEJA,0207,17208.72,4595,255,233,206,190,143,333,539,772,1027,26.7,5.97,4.49,3.13
02-06-2021,ELVAS,5,0,24,"[0,120]",Baixo a Moderado,,,,5,Alentejo,PORTALEGRE,1207,63128.86,20528,1057,1145,902,852,810,1662,2564,3709,4766,32.52,7.55,5.88,4.06
02-06-2021,ENTRONCAMENTO,12,1,56,"[0,120]",Baixo a Moderado,,,,12,Lisboa e Vale do Tejo,SANTARÉM,1410,1372.81,21558,1066,930,868,695,592,1287,2155,3085,4151,1570.14,302.33,224.69,156.96
02-06-2021,ESPINHO,19,1,64,"[0,120]",Baixo a Moderado,,,,19,Norte,AVEIRO,0107,2105.68,29516,2205,1993,1430,1177,960,2137,3567,5560,7765,1401.52,368.71,264.01,169.37
02-06-2021,ESPOSENDE,9,1,26,"[0,120]",Baixo a Moderado,,,,9,Norte,BRAGA,0306,9540.98,34177,1831,1522,1095,894,723,1617,2712,4234,6065,358.21,63.57,44.38,28.42
02-06-2021,ESTARREJA,3,0,12,"[0,120]",Baixo a Moderado,,,,3,Centro,AVEIRO,0108,10817.33,26006,1503,1399,1106,953,728,1681,2787,4186,5689,240.42,52.59,38.7,25.76
02-06-2021,ESTREMOZ,0,0,0,"[0,120]",Baixo a Moderado,,,,0,Alentejo,ÉVORA,0704,51379.95,12728,789,613,697,786,877,1663,2360,2973,3762,24.77,7.32,5.79,4.59
02-06-2021,ÉVORA,37,3,71,"[0,120]",Baixo a Moderado,,,,37,Alentejo,ÉVORA,0705,130707.58,52428,3569,2852,2176,1966,1803,3769,5945,8797,12366,40.11,9.46,6.73,4.55
02-06-2021,FAFE,28,2,58,"[0,120]",Baixo a Moderado,,,,28,Norte,BRAGA,0307,21908.11,48060,3044,2455,1679,1403,1208,2611,4290,6745,9789,219.37,44.68,30.79,19.58
02-06-2021,FARO,44,3,72,"[0,120]",Baixo a Moderado,,,,44,Algarve,FARO,0805,20256.79,61015,3847,3364,2604,2055,1601,3656,6260,9624,13471,301.2,66.5,47.51,30.9
02-06-2021,FELGUEIRAS,29,2,51,"[0,120]",Baixo a Moderado,,,,29,Norte,PORTO,1303,11573.75,56422,2951,2302,1601,1316,973,2289,3890,6192,9143,487.49,79.0,53.5,33.61
02-06-2021,FERREIRA DO ALENTEJO,2,0,25,"[0,120]",Baixo a Moderado,,,,2,Alentejo,BEJA,0208,64820.68,7845,515,414,372,343,345,688,1060,1474,1989,12.1,3.07,2.27,1.64
02-06-2021,FERREIRA DO ZÊZERE,0,0,0,"[0,120]",Baixo a Moderado,,,,0,Lisboa e Vale do Tejo,SANTARÉM,1411,19038.03,7959,470,370,416,465,456,921,1337,1707,2177,41.81,11.44,8.97,7.02
02-06-2021,FIGUEIRA DA FOZ,12,1,20,"[0,120]",Baixo a Moderado,,,,12,Centro,COIMBRA,0605,37905.26,58747,4032,3597,2887,2495,2043,4538,7425,11022,15054,154.98,39.72,29.08,19.59
02-06-2021,FIGUEIRA DE CASTELO RODRIGO,1,0,18,"[0,120]",Baixo a Moderado,,,,1,Centro,GUARDA,0904,50857.46,5584,347,352,290,352,391,743,1033,1385,1732,10.98,3.41,2.72,2.03
02-06-2021,FIGUEIRÓ DOS VINHOS,2,0,36,"[0,120]",Baixo a Moderado,,,,2,Centro,LEIRIA,1008,17344.0,5568,402,386,322,309,351,660,982,1368,1770,32.1,10.21,7.89,5.66
02-06-2021,FORNOS DE ALGODRES,0,0,0,"[0,120]",Baixo a Moderado,,,,0,Centro,GUARDA,0905,13145.05,4528,261,218,247,256,232,488,735,953,1214,34.45,9.24,7.25,5.59
02-06-2021,FREIXO DE ESPADA À CINTA,0,0,0,"[0,120]",Baixo a Moderado,,,,0,Norte,BRAGANÇA,0404,24414.29,3298,211,177,231,196,189,385,616,793,1004,13.51,4.11,3.25,2.52
02-06-2021,FRONTEIRA,5,0,168,"[120,240]",Moderado,,,,5,Alentejo,PORTALEGRE,1208,24859.58,2974,213,182,149,156,168,324,473,655,868,11.96,3.49,2.63,1.9
02-06-2021,FUNCHAL,122,9,117,"[0,120]",Baixo a Moderado,,,,122,Madeira,MADEIRA,3103,7616.2,104024,6382,5086,3643,2821,1990,4811,8454,13540,19922,1365.86,261.58,177.78,111.0
02-06-2021,FUNDÃO,2,0,8,"[0,120]",Baixo a Moderado,,,,2,Centro,CASTELO BRANCO,0504,70019.79,26495,1781,1464,1432,1357,1643,3000,4432,5896,7677,37.84,10.96,8.42,6.33
02-06-2021,GAVIÃO,0,0,0,"[0,120]",Baixo a Moderado,,,,0,Alentejo,PORTALEGRE,1209,29459.45,3263,189,186,222,263,293,556,778,964,1153,11.08,3.91,3.27,2.64
02-06-2021,GÓIS,0,0,0,"[0,120]",Baixo a Moderado,,,,0,Centro,COIMBRA,0606,26330.19,3805,235,199,240,233,244,477,717,916,1151,14.45,4.37,3.48,2.72
02-06-2021,GOLEGÃ,17,1,318,"[240,480]",Elevado,,,,17,Lisboa e Vale do Tejo,SANTARÉM,1412,8431.67,5339,356,299,281,243,255,498,779,1078,1434,63.32,17.01,12.78,9.24
02-06-2021,GONDOMAR,43,3,26,"[0,120]",Baixo a Moderado,,,,43,Norte,PORTO,1304,13191.76,165985,10555,8755,6222,4450,3364,7814,14036,22791,33346,1258.22,252.77,172.76,106.4
02-06-2021,GOUVEIA,9,1,73,"[0,120]",Baixo a Moderado,,,,9,Centro,GUARDA,0906,30061.17,12387,871,931,780,783,810,1593,2373,3304,4175,41.21,13.89,10.99,7.89
02-06-2021,GRÂNDOLA,1,0,7,"[0,120]",Baixo a Moderado,,,,1,Alentejo,SETÚBAL,1505,82593.66,14639,834,834,708,688,672,1360,2068,2902,3736,17.72,4.52,3.51,2.5
02-06-2021,GUARDA,12,1,31,"[0,120]",Baixo a Moderado,,,,12,Centro,GUARDA,0907,71209.58,38969,2477,2041,1686,1415,1474,2889,4575,6616,9093,54.72,12.77,9.29,6.42
02-06-2021,GUIMARÃES,37,3,24,"[0,120]",Baixo a Moderado,,,,37,Norte,BRAGA,0308,24099.96,152309,9394,7074,4809,3877,2948,6825,11634,18708,28102,631.99,116.61,77.63,48.27
02-06-2021,HORTA,2,0,14,"[0,120]",Baixo a Moderado,,,,2,Açores,AÇORES,4701,17305.53,14521,818,658,468,352,302,654,1122,1780,2598,83.91,15.01,10.29,6.48
02-06-2021,IDANHA-A-NOVA,1,0,12,"[0,120]",Baixo a Moderado,,,,1,Centro,CASTELO BRANCO,0505,141633.51,8043,518,490,519,672,974,1646,2165,2655,3173,5.68,2.24,1.87,1.53
02-06-2021,ÍLHAVO,8,1,21,"[0,120]",Baixo a Moderado,,,,8,Centro,AVEIRO,0110,7347.55,38699,2227,1943,1444,1193,850,2043,3487,5430,7657,526.66,104.21,73.9,47.46
02-06-2021,LAGOA (FARO),12,1,53,"[0,120]",Baixo a Moderado,,,,12,Algarve,FARO,0806,8825.45,22762,1314,1168,919,749,670,1419,2338,3506,4820,257.93,54.62,39.73,26.49
02-06-2021,LAGOA,14,1,95,"[0,120]",Baixo a Moderado,,,,14,Açores,AÇORES,4201,4559.32,14721,536,458,349,238,235,473,822,1280,1816,322.9,39.83,28.08,18.03
02-06-2021,LAGOS,16,1,53,"[0,120]",Baixo a Moderado,,,,16,Algarve,FARO,0807,21299.27,30374,1744,1434,1247,1053,1029,2082,3329,4763,6507,142.61,30.55,22.36,15.63
02-06-2021,LAJES DAS FLORES,0,0,0,"[0,120]",Baixo a Moderado,,,,0,Açores,AÇORES,4801,7004.79,1463,88,53,62,46,54,100,162,215,303,20.89,4.33,3.07,2.31
02-06-2021,LAJES DO PICO,0,0,0,"[0,120]",Baixo a Moderado,,,,0,Açores,AÇORES,4601,15531.09,4490,304,231,223,159,162,321,544,775,1079,28.91,6.95,4.99,3.5
02-06-2021,LAMEGO,14,1,56,"[0,120]",Baixo a Moderado,,,,14,Norte,VISEU,1805,16542.11,24895,1639,1284,1124,898,783,1681,2805,4089,5728,150.5,34.63,24.72,16.96
02-06-2021,LEIRIA,31,2,25,"[0,120]",Baixo a Moderado,,,,31,Centro,LEIRIA,1009,56508.83,125267,7389,6366,5090,3902,3159,7061,12151,18517,25906,221.68,45.84,32.77,21.5
02-06-2021,LISBOA,922,66,181,"[120,240]",Moderado,,,,922,Lisboa e Vale do Tejo,LISBOA,1106,10005.43,509515,33197,33340,27706,23037,26770,49807,77513,110853,144050,5092.6,1439.78,1107.98,774.74
02-06-2021,LOULÉ,71,5,103,"[0,120]",Baixo a Moderado,,,,71,Algarve,FARO,0808,76366.91,68697,3890,3350,2780,2358,2251,4609,7389,10739,14629,89.96,19.16,14.06,9.68
02-06-2021,LOURES,175,13,82,"[0,120]",Baixo a Moderado,,,,175,Lisboa e Vale do Tejo,LISBOA,1107,16723.99,213687,12746,12794,9644,6669,5033,11702,21346,34140,46886,1277.73,280.35,204.14,127.64
02-06-2021,LOURINHÃ,12,1,46,"[0,120]",Baixo a Moderado,,,,12,Lisboa e Vale do Tejo,LISBOA,1108,14717.2,25855,1584,1243,992,842,645,1487,2479,3722,5306,175.68,36.05,25.29,16.84
02-06-2021,LOUSÃ,6,0,35,"[0,120]",Baixo a Moderado,,,,6,Centro,COIMBRA,0607,13840.01,17158,946,866,658,528,450,978,1636,2502,3448,123.97,24.91,18.08,11.82
02-06-2021,LOUSADA,21,2,45,"[0,120]",Baixo a Moderado,,,,21,Norte,PORTO,1305,9608.01,46755,2289,1698,1176,853,621,1474,2650,4348,6637,486.63,69.08,45.25,27.58
02-06-2021,MAÇÃO,0,0,0,"[0,120]",Baixo a Moderado,,,,0,Lisboa e Vale do Tejo,SANTARÉM,1413,39997.98,6267,386,362,390,440,657,1097,1487,1849,2235,15.67,5.59,4.62,3.72
02-06-2021,MACEDO DE CAVALEIROS,6,0,41,"[0,120]",Baixo a Moderado,,,,6,Norte,BRAGANÇA,0405,69914.08,14516,1082,889,878,823,938,1761,2639,3528,4610,20.76,6.59,5.05,3.77
02-06-2021,MACHICO,17,1,85,"[0,120]",Baixo a Moderado,,,,17,Madeira,MADEIRA,3104,6825.1,19981,1197,860,662,455,331,786,1448,2308,3505,292.76,51.36,33.82,21.22
02-06-2021,MADALENA,0,0,0,"[0,120]",Baixo a Moderado,,,,0,Açores,AÇORES,4602,14712.33,5895,334,256,173,190,179,369,542,798,1132,40.07,7.69,5.42,3.68
02-06-2021,MAFRA,71,5,84,"[0,120]",Baixo a Moderado,,,,71,Lisboa e Vale do Tejo,LISBOA,1109,29165.5,84816,3613,3334,2839,2089,1899,3988,6827,10161,13774,290.81,47.23,34.84,23.41
02-06-2021,MAIA,64,5,46,"[0,120]",Baixo a Moderado,,,,64,Norte,PORTO,1306,8293.94,138971,7801,6617,4512,3339,2631,5970,10482,17099,24900,1675.56,300.22,206.16,126.38
02-06-2021,MANGUALDE,14,1,76,"[0,120]",Baixo a Moderado,,,,14,Centro,VISEU,1806,21925.56,18510,1198,1128,885,852,743,1595,2480,3608,4806,84.42,21.92,16.46,11.31
02-06-2021,MANTEIGAS,0,0,0,"[0,120]",Baixo a Moderado,,,,0,Centro,GUARDA,0908,12197.55,3007,258,197,159,167,146,313,472,669,927,24.65,7.6,5.48,3.87
02-06-2021,MARCO DE CANAVESES,8,1,16,"[0,120]",Baixo a Moderado,,,,8,Norte,PORTO,1307,20188.98,51496,2678,2060,1488,1265,1023,2288,3776,5836,8514,255.07,42.17,28.91,18.7
02-06-2021,MARINHA GRANDE,6,0,16,"[0,120]",Baixo a Moderado,,,,6,Centro,LEIRIA,1010,18725.19,38508,2365,2302,1638,1359,1058,2417,4055,6357,8722,205.65,46.58,33.95,21.66
02-06-2021,MARVÃO,0,0,0,"[0,120]",Baixo a Moderado,,,,0,Alentejo,PORTALEGRE,1210,15489.9,3005,198,185,142,197,237,434,576,761,959,19.4,6.19,4.91,3.72
02-06-2021,MATOSINHOS,119,9,68,"[0,120]",Baixo a Moderado,,,,119,Norte,PORTO,1308,6241.97,175357,11850,9977,7023,5024,3884,8908,15931,25908,37758,2809.31,604.9,415.06,255.22
02-06-2021,MEALHADA,3,0,15,"[0,120]",Baixo a Moderado,,,,3,Centro,AVEIRO,0111,11065.66,19914,1163,1039,810,828,831,1659,2469,3508,4671,179.96,42.21,31.7,22.31
02-06-2021,MÊDA,0,0,0,"[0,120]",Baixo a Moderado,,,,0,Centro,GUARDA,0909,28604.92,4587,343,306,290,288,443,731,1021,1327,1670,16.04,5.84,4.64,3.57
02-06-2021,MELGAÇO,2,0,25,"[0,120]",Baixo a Moderado,,,,2,Norte,VIANA DO CASTELO,1603,23824.58,8093,507,567,578,614,675,1289,1867,2434,2941,33.97,12.34,10.22,7.84
02-06-2021,MÉRTOLA,0,0,0,"[0,120]",Baixo a Moderado,,,,0,Alentejo,BEJA,0209,129287.34,6142,400,390,378,423,600,1023,1401,1791,2191,4.75,1.69,1.39,1.08
02-06-2021,MESÃO FRIO,1,0,25,"[0,120]",Baixo a Moderado,,,,1,Norte,VILA REAL,1704,2664.87,3964,265,205,168,157,120,277,445,650,915,148.74,34.33,24.39,16.7
02-06-2021,MIRA,6,0,51,"[0,120]",Baixo a Moderado,,,,6,Centro,COIMBRA,0608,12403.38,11832,727,729,659,550,466,1016,1675,2404,3131,95.4,25.24,19.38,13.5
02-06-2021,MIRANDA DO CORVO,2,0,16,"[0,120]",Baixo a Moderado,,,,2,Centro,COIMBRA,0609,12637.79,12708,706,659,568,498,404,902,1470,2129,2835,100.55,22.43,16.85,11.63
02-06-2021,MIRANDA DO DOURO,2,0,29,"[0,120]",Baixo a Moderado,,,,2,Norte,BRAGANÇA,0406,48718.31,6830,482,429,442,463,470,933,1375,1804,2286,14.02,4.69,3.7,2.82
02-06-2021,MIRANDELA,4,0,18,"[0,120]",Baixo a Moderado,,,,4,Norte,BRAGANÇA,0407,65895.67,21754,1640,1315,1204,1078,947,2025,3229,4544,6184,33.01,9.38,6.9,4.9
02-06-2021,MOGADOURO,0,0,0,"[0,120]",Baixo a Moderado,,,,0,Norte,BRAGANÇA,0408,76064.93,8392,589,529,576,630,655,1285,1861,2390,2979,11.03,3.92,3.14,2.45
02-06-2021,MOIMENTA DA BEIRA,0,0,0,"[0,120]",Baixo a Moderado,,,,0,Norte,VISEU,1807,21996.9,9736,576,514,471,416,461,877,1348,1862,2438,44.26,11.08,8.46,6.13
02-06-2021,MOITA,75,5,116,"[0,120]",Baixo a Moderado,,,,75,Lisboa e Vale do Tejo,SETÚBAL,1506,5525.98,64407,4226,3646,2623,1801,1425,3226,5849,9495,13721,1165.53,248.3,171.82,105.85
02-06-2021,MONÇÃO,6,0,34,"[0,120]",Baixo a Moderado,,,,6,Norte,VIANA DO CASTELO,1604,21130.85,17869,1161,1105,1031,1006,972,1978,3009,4114,5275,84.56,24.96,19.47,14.24
02-06-2021,MONCHIQUE,0,0,0,"[0,120]",Baixo a Moderado,,,,0,Algarve,FARO,0809,39530.43,5077,353,384,321,355,392,747,1068,1452,1805,12.84,4.57,3.67,2.7
02-06-2021,MONDIM DE BASTO,5,0,72,"[0,120]",Baixo a Moderado,,,,5,Norte,VILA REAL,1705,17207.52,6946,395,300,314,284,283,567,881,1181,1576,40.36,9.16,6.86,5.12
02-06-2021,MONFORTE,2,0,67,"[0,120]",Baixo a Moderado,,,,2,Alentejo,PORTALEGRE,1211,42024.82,2975,139,115,117,192,168,360,477,592,731,7.08,1.74,1.41,1.14
02-06-2021,MONTALEGRE,12,1,133,"[120,240]",Moderado,,,,12,Norte,VILA REAL,1706,80545.71,8997,699,628,595,603,730,1333,1928,2556,3255,11.17,4.04,3.17,2.39
02-06-2021,MONTEMOR-O-NOVO,5,0,32,"[0,120]",Baixo a Moderado,,,,5,Alentejo,ÉVORA,0706,123296.65,15647,991,953,868,878,971,1849,2717,3670,4661,12.69,3.78,2.98,2.2
02-06-2021,MONTEMOR-O-VELHO,23,2,91,"[0,120]",Baixo a Moderado,,,,23,Centro,COIMBRA,0610,22896.23,25224,1496,1397,1217,1057,988,2045,3262,4659,6155,110.17,26.88,20.35,14.25
02-06-2021,MONTIJO,29,2,50,"[0,120]",Baixo a Moderado,,,,29,Lisboa e Vale do Tejo,SETÚBAL,1507,34861.64,57614,2771,2441,1990,1554,1109,2663,4653,7094,9865,165.26,28.3,20.35,13.35
02-06-2021,MORA,0,0,0,"[0,120]",Baixo a Moderado,,,,0,Alentejo,ÉVORA,0707,44395.02,4138,336,275,252,238,257,495,747,1022,1358,9.32,3.06,2.3,1.68
02-06-2021,MORTÁGUA,0,0,0,"[0,120]",Baixo a Moderado,,,,0,Centro,VISEU,1808,25117.82,8803,638,584,535,499,460,959,1494,2078,2716,35.05,10.81,8.27,5.95
02-06-2021,MOURA,1,0,7,"[0,120]",Baixo a Moderado,,,,1,Alentejo,BEJA,0210,95845.55,13718,817,656,665,542,461,1003,1668,2324,3141,14.31,3.28,2.42,1.74
02-06-2021,MOURÃO,0,0,0,"[0,120]",Baixo a Moderado,,,,0,Alentejo,ÉVORA,0708,27862.98,2450,139,108,80,104,109,213,293,401,540,8.79,1.94,1.44,1.05
02-06-2021,MURÇA,0,0,0,"[0,120]",Baixo a Moderado,,,,0,Norte,VILA REAL,1707,18937.11,5463,384,341,307,306,319,625,932,1273,1657,28.85,8.75,6.72,4.92
02-06-2021,MURTOSA,2,0,19,"[0,120]",Baixo a Moderado,,,,2,Centro,AVEIRO,0112,7308.78,10279,509,473,403,353,409,762,1165,1638,2147,140.63,29.37,22.41,15.94
02-06-2021,NAZARÉ,2,0,14,"[0,120]",Baixo a Moderado,,,,2,Lisboa e Vale do Tejo,LEIRIA,1011,8243.43,14165,967,903,670,420,396,816,1486,2389,3356,171.84,40.71,28.98,18.03
02-06-2021,NELAS,7,1,54,"[0,120]",Baixo a Moderado,,,,7,Centro,VISEU,1809,12571.48,12974,924,787,668,604,583,1187,1855,2642,3566,103.21,28.37,21.02,14.76
02-06-2021,NISA,0,0,0,"[0,120]",Baixo a Moderado,,,,0,Alentejo,PORTALEGRE,1212,57567.84,6061,405,389,355,483,478,961,1316,1705,2110,10.53,3.67,2.96,2.29
02-06-2021,NORDESTE,14,1,288,"[240,480]",Elevado,,,,14,Açores,AÇORES,4202,10146.8,4862,246,180,124,161,162,323,447,627,873,47.92,8.6,6.18,4.41
02-06-2021,ÓBIDOS,1,0,8,"[0,120]",Baixo a Moderado,,,,1,Lisboa e Vale do Tejo,LEIRIA,1012,14155.44,11850,743,650,574,452,436,888,1462,2112,2855,83.72,20.17,14.92,10.33
02-06-2021,ODEMIRA,111,8,449,"[240,480]",Elevado,,,,111,Alentejo,BEJA,0211,172060.15,24717,1475,1317,1225,1397,1349,2746,3971,5288,6763,14.37,3.93,3.07,2.31
02-06-2021,ODIVELAS,163,12,101,"[0,120]",Baixo a Moderado,,,,163,Lisboa e Vale do Tejo,LISBOA,1116,2654.36,161774,9562,9038,6952,4641,3812,8453,15405,24443,34005,6095.48,1281.27,920.99,580.44
02-06-2021,OEIRAS,105,7,59,"[0,120]",Baixo a Moderado,,,,105,Lisboa e Vale do Tejo,LISBOA,1110,4588.31,177408,11580,11575,8566,6211,5855,12066,20632,32207,43787,3866.78,954.38,701.98,449.69
02-06-2021,OLEIROS,0,0,0,"[0,120]",Baixo a Moderado,,,,0,Centro,CASTELO BRANCO,0506,47109.31,5003,384,341,366,397,487,884,1250,1591,1975,10.62,4.19,3.38,2.65
02-06-2021,OLHÃO,12,1,27,"[0,120]",Baixo a Moderado,,,,12,Algarve,FARO,0810,13086.38,44405,2455,2309,1689,1342,1268,2610,4299,6608,9063,339.33,69.26,50.5,32.85
02-06-2021,OLIVEIRA DE AZEMÉIS,28,2,42,"[0,120]",Baixo a Moderado,,,,28,Norte,AVEIRO,0113,16110.41,66011,4155,3614,2794,2183,1738,3921,6715,10329,14484,409.75,89.91,64.12,41.68
02-06-2021,OLIVEIRA DE FRADES,10,1,101,"[0,120]",Baixo a Moderado,,,,10,Centro,VISEU,1810,14534.62,9936,553,475,438,359,415,774,1212,1687,2240,68.36,15.41,11.61,8.34
02-06-2021,OLIVEIRA DO BAIRRO,13,1,54,"[0,120]",Baixo a Moderado,,,,13,Centro,AVEIRO,0114,8731.99,24277,1327,1182,999,786,810,1596,2595,3777,5104,278.02,58.45,43.25,29.72
02-06-2021,OLIVEIRA DO HOSPITAL,9,1,47,"[0,120]",Baixo a Moderado,,,,9,Centro,COIMBRA,0611,23451.66,19253,1161,1097,962,924,960,1884,2846,3943,5104,82.1,21.76,16.81,12.14
02-06-2021,OURÉM,22,2,50,"[0,120]",Baixo a Moderado,,,,22,Lisboa e Vale do Tejo,SANTARÉM,1421,41668.03,44044,2463,2069,1899,1817,1603,3420,5319,7388,9851,105.7,23.64,17.73,12.77
02-06-2021,OURIQUE,1,0,22,"[0,120]",Baixo a Moderado,,,,1,Alentejo,BEJA,0212,66331.36,4607,313,287,284,268,227,495,779,1066,1379,6.95,2.08,1.61,1.17
02-06-2021,OVAR,20,1,37,"[0,120]",Baixo a Moderado,,,,20,Centro,AVEIRO,0115,14770.25,54260,3294,2709,1994,1636,1234,2870,4864,7573,10867,367.37,73.57,51.27,32.93
02-06-2021,PAÇOS DE FERREIRA,37,3,65,"[0,120]",Baixo a Moderado,,,,37,Norte,PORTO,1309,7099.29,56728,2903,2193,1518,1135,664,1799,3317,5510,8413,799.1,118.51,77.62,46.72
02-06-2021,PALMELA,36,3,56,"[0,120]",Baixo a Moderado,,,,36,Lisboa e Vale do Tejo,SETÚBAL,1508,46512.01,64269,3402,3244,2635,1846,1391,3237,5872,9116,12518,138.18,26.91,19.6,12.62
02-06-2021,PAMPILHOSA DA SERRA,0,0,0,"[0,120]",Baixo a Moderado,,,,0,Centro,COIMBRA,0612,39646.24,4037,238,254,295,339,423,762,1057,1311,1549,10.18,3.91,3.31,2.67
02-06-2021,PAREDES,35,3,41,"[0,120]",Baixo a Moderado,,,,35,Norte,PORTO,1310,15675.69,86067,4272,3532,2412,1717,1258,2975,5387,8919,13191,549.04,84.15,56.9,34.36
02-06-2021,PAREDES DE COURA,16,1,187,"[120,240]",Moderado,,,,16,Norte,VIANA DO CASTELO,1605,13818.59,8535,466,528,407,465,515,980,1387,1915,2381,61.76,17.23,13.86,10.04
02-06-2021,PEDRÓGÃO GRANDE,0,0,0,"[0,120]",Baixo a Moderado,,,,0,Centro,LEIRIA,1013,12874.75,3410,175,173,196,221,252,473,669,842,1017,26.49,7.9,6.54,5.2
02-06-2021,PENACOVA,8,1,58,"[0,120]",Baixo a Moderado,,,,8,Centro,COIMBRA,0613,21673.23,13694,968,923,745,621,703,1324,2069,2992,3960,63.18,18.27,13.81,9.55
02-06-2021,PENAFIEL,66,5,95,"[0,120]",Baixo a Moderado,,,,66,Norte,PORTO,1311,21224.27,69772,3648,2823,2032,1663,1230,2893,4925,7748,11396,328.74,53.69,36.51,23.2
02-06-2021,PENALVA DO CASTELO,4,0,56,"[0,120]",Baixo a Moderado,,,,4,Centro,VISEU,1811,13433.92,7115,449,457,413,391,426,817,1230,1687,2136,52.96,15.9,12.56,9.16
02-06-2021,PENAMACOR,1,0,21,"[0,120]",Baixo a Moderado,,,,1,Centro,CASTELO BRANCO,0507,56370.69,4755,262,248,273,451,633,1084,1357,1605,1867,8.44,3.31,2.85,2.41
02-06-2021,PENEDONO,0,0,0,"[0,120]",Baixo a Moderado,,,,0,Norte,VISEU,1812,13370.75,2591,172,113,129,156,138,294,423,536,708,19.38,5.3,4.01,3.16
02-06-2021,PENELA,0,0,0,"[0,120]",Baixo a Moderado,,,,0,Centro,COIMBRA,0614,13480.0,5397,314,324,274,359,344,703,977,1301,1615,40.04,11.98,9.65,7.25
02-06-2021,PENICHE,3,0,11,"[0,120]",Baixo a Moderado,,,,3,Lisboa e Vale do Tejo,LEIRIA,1014,7754.98,26501,1746,1504,1203,926,707,1633,2836,4340,6086,341.73,78.48,55.96,36.57
02-06-2021,PESO DA RÉGUA,1,0,6,"[0,120]",Baixo a Moderado,,,,1,Norte,VILA REAL,1708,9486.01,15773,1076,843,650,659,455,1114,1764,2607,3683,166.28,38.83,27.48,18.6
02-06-2021,PINHEL,1,0,12,"[0,120]",Baixo a Moderado,,,,1,Centro,GUARDA,0910,48452.12,8511,577,566,551,538,689,1227,1778,2344,2921,17.57,6.03,4.84,3.67
02-06-2021,POMBAL,26,2,51,"[0,120]",Baixo a Moderado,,,,26,Centro,LEIRIA,1015,62600.28,51461,3187,2791,2494,2328,2027,4355,6849,9640,12827,82.21,20.49,15.4,10.94
02-06-2021,PONTA DELGADA,99,7,146,"[120,240]",Moderado,,,,99,Açores,AÇORES,4203,23298.65,67935,3108,2435,1726,1133,902,2035,3761,6196,9304,291.58,39.93,26.59,16.14
02-06-2021,PONTA DO SOL,7,0,81,"[0,120]",Baixo a Moderado,,,,7,Madeira,MADEIRA,3105,4622.03,8593,319,283,347,208,221,429,776,1059,1378,185.92,29.81,22.91,16.79
02-06-2021,PONTE DA BARCA,3,0,27,"[0,120]",Baixo a Moderado,,,,3,Norte,VIANA DO CASTELO,1606,18211.37,11180,635,576,517,554,490,1044,1561,2137,2772,61.39,15.22,11.73,8.57
02-06-2021,PONTE DE LIMA,13,1,31,"[0,120]",Baixo a Moderado,,,,13,Norte,VIANA DO CASTELO,1607,32025.46,41315,2321,2022,1720,1596,1462,3058,4778,6800,9121,129.01,28.48,21.23,14.92
02-06-2021,PONTE DE SOR,1,0,7,"[0,120]",Baixo a Moderado,,,,1,Alentejo,PORTALEGRE,1213,83971.16,14994,939,800,716,739,831,1570,2286,3086,4025,17.86,4.79,3.68,2.72
02-06-2021,PORTALEGRE,6,0,27,"[0,120]",Baixo a Moderado,,,,6,Alentejo,PORTALEGRE,1214,44713.64,22172,1577,1351,1137,993,984,1977,3114,4465,6042,49.59,13.51,9.99,6.96
02-06-2021,PORTEL,0,0,0,"[0,120]",Baixo a Moderado,,,,0,Alentejo,ÉVORA,0709,60100.57,5828,336,358,283,331,305,636,919,1277,1613,9.7,2.68,2.12,1.53
02-06-2021,PORTIMÃO,36,3,65,"[0,120]",Baixo a Moderado,,,,36,Algarve,FARO,0811,18206.29,55483,3182,2927,2116,1582,1400,2982,5098,8025,11207,304.75,61.56,44.08,28.0
02-06-2021,PORTO,139,10,64,"[0,120]",Baixo a Moderado,,,,139,Norte,PORTO,1312,4142.02,216606,15790,15193,11280,9409,10044,19453,30733,45926,61716,5229.5,1490.0,1108.79,741.98
02-06-2021,PORTO DE MÓS,6,0,26,"[0,120]",Baixo a Moderado,,,,6,Centro,LEIRIA,1016,26183.41,23275,1355,1210,1034,888,872,1760,2794,4004,5359,88.89,20.47,15.29,10.67
02-06-2021,PORTO MONIZ,1,0,43,"[0,120]",Baixo a Moderado,,,,1,Madeira,MADEIRA,3106,8293.38,2342,143,130,95,98,120,218,313,443,586,28.24,7.07,5.34,3.77
02-06-2021,PORTO SANTO,0,0,0,"[0,120]",Baixo a Moderado,,,,0,Madeira,MADEIRA,3201,4300.7,5202,240,157,134,110,68,178,312,469,709,120.95,16.48,10.9,7.25
02-06-2021,PÓVOA DE LANHOSO,28,2,130,"[120,240]",Moderado,,,,28,Norte,BRAGA,0309,13465.29,21499,1175,909,732,673,624,1297,2029,2938,4113,159.67,30.55,21.82,15.07
02-06-2021,PÓVOA DE VARZIM,24,2,38,"[0,120]",Baixo a Moderado,,,,24,Norte,PORTO,1313,8220.59,62784,3712,3120,2134,1594,1305,2899,5033,8153,11865,763.7,144.33,99.17,61.22
02-06-2021,POVOAÇÃO,0,0,0,"[0,120]",Baixo a Moderado,,,,0,Açores,AÇORES,4204,10640.77,5927,293,212,191,144,134,278,469,681,974,55.7,9.15,6.4,4.41
02-06-2021,VILA DA PRAIA DA VITÓRIA,0,0,0,"[0,120]",Baixo a Moderado,,,,0,Açores,AÇORES,4302,16127.06,21317,1133,789,619,436,336,772,1391,2180,3313,132.18,20.54,13.52,8.63
02-06-2021,PROENÇA-A-NOVA,1,0,14,"[0,120]",Baixo a Moderado,,,,1,Centro,CASTELO BRANCO,0508,39539.96,7298,508,465,389,400,560,960,1349,1814,2322,18.46,5.87,4.59,3.41
02-06-2021,REDONDO,0,0,0,"[0,120]",Baixo a Moderado,,,,0,Alentejo,ÉVORA,0710,36950.87,6353,349,325,288,288,354,642,930,1255,1604,17.19,4.34,3.4,2.52
02-06-2021,REGUENGOS DE MONSARAZ,0,0,0,"[0,120]",Baixo a Moderado,,,,0,Alentejo,ÉVORA,0711,46399.72,10015,602,511,455,462,473,935,1390,1901,2503,21.58,5.39,4.1,3.0
02-06-2021,RESENDE,1,0,10,"[0,120]",Baixo a Moderado,,,,1,Norte,VISEU,1813,12334.93,10137,560,493,448,433,422,855,1303,1796,2356,82.18,19.1,14.56,10.56
02-06-2021,RIBEIRA BRAVA,9,1,72,"[0,120]",Baixo a Moderado,,,,9,Madeira,MADEIRA,3107,6544.88,12435,648,500,411,311,287,598,1009,1509,2157,189.99,32.96,23.06,15.42
02-06-2021,RIBEIRA DE PENA,1,0,17,"[0,120]",Baixo a Moderado,,,,1,Norte,VILA REAL,1709,21745.98,6016,371,301,290,310,368,678,968,1269,1640,27.66,7.54,5.84,4.45
02-06-2021,RIBEIRA GRANDE,179,13,546,"[480,960]",Muito Elevado,,,,179,Açores,AÇORES,4205,18015.13,32811,1163,689,512,345,253,598,1110,1799,2962,182.13,16.44,9.99,6.16
02-06-2021,RIO MAIOR,10,1,49,"[0,120]",Baixo a Moderado,,,,10,Lisboa e Vale do Tejo,SANTARÉM,1414,27276.45,20379,1251,1144,941,795,648,1443,2384,3528,4779,74.71,17.52,12.93,8.74
02-06-2021,SABROSA,0,0,0,"[0,120]",Baixo a Moderado,,,,0,Norte,VILA REAL,1710,15692.45,5918,393,314,304,302,350,652,956,1270,1663,37.71,10.6,8.09,6.09
02-06-2021,SABUGAL,7,0,66,"[0,120]",Baixo a Moderado,,,,7,Centro,GUARDA,0911,82269.82,10585,724,707,694,796,1009,1805,2499,3206,3930,12.87,4.78,3.9,3.04
02-06-2021,SALVATERRA DE MAGOS,34,2,160,"[120,240]",Moderado,,,,34,Lisboa e Vale do Tejo,SANTARÉM,1415,24393.2,21295,1275,1181,1060,799,772,1571,2631,3812,5087,87.3,20.85,15.63,10.79
02-06-2021,SANTA COMBA DÃO,5,0,48,"[0,120]",Baixo a Moderado,,,,5,Centro,VISEU,1814,11194.77,10452,732,684,569,538,464,1002,1571,2255,2987,93.36,26.68,20.14,14.03
02-06-2021,SANTA CRUZ,23,2,51,"[0,120]",Baixo a Moderado,,,,23,Madeira,MADEIRA,3108,8150.28,45281,1817,1301,974,716,523,1239,2213,3514,5331,555.6,65.41,43.12,27.15
02-06-2021,SANTA CRUZ DA GRACIOSA,0,0,0,"[0,120]",Baixo a Moderado,,,,0,Açores,AÇORES,4401,6065.78,4208,228,180,163,124,145,269,432,612,840,69.37,13.85,10.09,7.12
02-06-2021,SANTA CRUZ DAS FLORES,0,0,0,"[0,120]",Baixo a Moderado,,,,0,Açores,AÇORES,4802,7091.44,2165,125,98,74,56,51,107,181,279,404,30.53,5.7,3.93,2.55
02-06-2021,SANTA MARIA DA FEIRA,105,8,76,"[0,120]",Baixo a Moderado,,,,105,Norte,AVEIRO,0109,21587.65,138636,8182,6743,4771,3856,3079,6935,11706,18449,26631,642.19,123.36,85.46,54.22
02-06-2021,SANTA MARTA DE PENAGUIÃO,0,0,0,"[0,120]",Baixo a Moderado,,,,0,Norte,VILA REAL,1711,6928.13,6599,483,373,337,316,317,633,970,1343,1826,95.25,26.36,19.39,14.0
02-06-2021,SANTANA,12,1,179,"[120,240]",Moderado,,,,12,Madeira,MADEIRA,3109,9547.3,6711,418,353,343,282,277,559,902,1255,1673,70.29,17.52,13.15,9.45
02-06-2021,SANTARÉM,55,4,96,"[0,120]",Baixo a Moderado,,,,55,Lisboa e Vale do Tejo,SANTARÉM,1416,55253.58,57421,3654,3441,2760,2466,2206,4672,7432,10873,14527,103.92,26.29,19.68,13.45
02-06-2021,SANTIAGO DO CACÉM,5,0,17,"[0,120]",Baixo a Moderado,,,,5,Alentejo,SETÚBAL,1509,105969.29,28791,2144,1689,1472,1295,1215,2510,3982,5671,7815,27.17,7.37,5.35,3.76
02-06-2021,SANTO TIRSO,27,2,40,"[0,120]",Baixo a Moderado,,,,27,Norte,PORTO,1314,13655.52,68055,4911,3935,2761,2257,1810,4067,6828,10763,15674,498.35,114.78,78.82,50.0
02-06-2021,SÃO BRÁS DE ALPORTEL,5,0,48,"[0,120]",Baixo a Moderado,,,,5,Algarve,FARO,0812,15336.92,10416,596,468,467,404,401,805,1272,1740,2336,67.91,15.23,11.35,8.29
02-06-2021,SÃO JOÃO DA MADEIRA,14,1,64,"[0,120]",Baixo a Moderado,,,,14,Norte,AVEIRO,0116,794.3,21958,1347,1069,796,601,593,1194,1990,3059,4406,2765.49,554.91,385.26,250.63
02-06-2021,SÃO JOÃO DA PESQUEIRA,5,0,70,"[0,120]",Baixo a Moderado,,,,5,Norte,VISEU,1815,26610.85,7125,417,330,294,328,328,656,950,1280,1697,26.77,6.38,4.81,3.57
02-06-2021,SÃO PEDRO DO SUL,2,0,13,"[0,120]",Baixo a Moderado,,,,2,Centro,VISEU,1816,34895.09,15403,990,962,861,759,909,1668,2529,3491,4481,44.14,12.84,10.0,7.25
02-06-2021,SÃO ROQUE DO PICO,1,0,31,"[0,120]",Baixo a Moderado,,,,1,Açores,AÇORES,4603,14236.1,3266,199,141,93,96,113,209,302,443,642,22.94,4.51,3.11,2.12
02-06-2021,SÃO VICENTE,2,0,39,"[0,120]",Baixo a Moderado,,,,2,Madeira,MADEIRA,3110,7883.71,5143,272,264,266,225,280,505,771,1035,1307,65.23,16.58,13.13,9.78
02-06-2021,SARDOAL,0,0,0,"[0,120]",Baixo a Moderado,,,,0,Lisboa e Vale do Tejo,SANTARÉM,1417,9214.72,3741,227,178,148,165,248,413,561,739,966,40.6,10.48,8.02,6.09
02-06-2021,SÁTÃO,4,0,35,"[0,120]",Baixo a Moderado,,,,4,Centro,VISEU,1817,20194.11,11580,765,671,515,465,476,941,1456,2127,2892,57.34,14.32,10.53,7.21
02-06-2021,SEIA,8,1,36,"[0,120]",Baixo a Moderado,,,,8,Centro,GUARDA,0912,43568.83,22234,1807,1589,1238,1122,721,1843,3081,4670,6477,51.03,14.87,10.72,7.07
02-06-2021,SEIXAL,116,8,69,"[0,120]",Baixo a Moderado,,,,116,Lisboa e Vale do Tejo,SETÚBAL,1510,9545.17,167752,10586,9270,6661,4391,2930,7321,13982,23252,33838,1757.49,354.51,243.6,146.49
02-06-2021,SERNANCELHE,0,0,0,"[0,120]",Baixo a Moderado,,,,0,Norte,VISEU,1818,22861.22,5396,305,293,286,273,260,533,819,1112,1417,23.6,6.2,4.86,3.58
02-06-2021,SERPA,3,0,21,"[0,120]",Baixo a Moderado,,,,3,Alentejo,BEJA,0213,110563.34,14304,903,761,719,697,626,1323,2042,2803,3706,12.94,3.35,2.54,1.85
02-06-2021,SERTÃ,18,1,123,"[120,240]",Moderado,,,,18,Centro,CASTELO BRANCO,0509,44673.17,14577,870,779,790,767,1020,1787,2577,3356,4226,32.63,9.46,7.51,5.77
02-06-2021,SESIMBRA,53,4,102,"[0,120]",Baixo a Moderado,,,,53,Lisboa e Vale do Tejo,SETÚBAL,1511,19571.75,51858,2400,2321,1853,1257,1083,2340,4193,6514,8914,264.96,45.54,33.28,21.42
02-06-2021,SETÚBAL,85,6,74,"[0,120]",Baixo a Moderado,,,,85,Lisboa e Vale do Tejo,SETÚBAL,1512,23032.5,115126,7425,6929,5075,3775,2655,6430,11505,18434,25859,499.83,112.27,80.03,49.95
02-06-2021,SEVER DO VOUGA,5,0,44,"[0,120]",Baixo a Moderado,,,,5,Centro,AVEIRO,0117,12987.56,11331,766,637,568,540,567,1107,1675,2312,3078,87.24,23.7,17.8,12.9
02-06-2021,SILVES,10,1,28,"[0,120]",Baixo a Moderado,,,,10,Algarve,FARO,0813,68006.23,36226,2137,1869,1610,1423,1600,3023,4633,6502,8639,53.27,12.7,9.56,6.81
02-06-2021,SINES,4,0,29,"[0,120]",Baixo a Moderado,,,,4,Alentejo,SETÚBAL,1513,20330.17,13715,888,791,551,416,268,684,1235,2026,2914,67.46,14.33,9.97,6.07
02-06-2021,SINTRA,301,22,77,"[0,120]",Baixo a Moderado,,,,301,Lisboa e Vale do Tejo,LISBOA,1111,31922.73,391402,20490,18316,13545,9137,7284,16421,29966,48282,68772,1226.08,215.43,151.25,93.87
02-06-2021,SOBRAL DE MONTE AGRAÇO,8,1,75,"[0,120]",Baixo a Moderado,,,,8,Lisboa e Vale do Tejo,LISBOA,1112,5210.32,10651,564,507,352,272,212,484,836,1343,1907,204.43,36.6,25.78,16.05
02-06-2021,SOURE,17,1,99,"[0,120]",Baixo a Moderado,,,,17,Centro,COIMBRA,0615,26506.07,17120,1173,1142,1004,883,987,1870,2874,4016,5189,64.59,19.58,15.15,10.84
02-06-2021,SOUSEL,0,0,0,"[0,120]",Baixo a Moderado,,,,0,Alentejo,PORTALEGRE,1215,27932.18,4412,261,274,208,302,292,594,802,1076,1337,15.8,4.79,3.85,2.87
02-06-2021,TÁBUA,4,0,35,"[0,120]",Baixo a Moderado,,,,4,Centro,COIMBRA,0616,19978.58,11368,729,584,524,430,464,894,1418,2002,2731,56.9,13.67,10.02,7.1
02-06-2021,TABUAÇO,1,0,17,"[0,120]",Baixo a Moderado,,,,1,Norte,VISEU,1819,13385.67,6033,372,314,217,282,363,645,862,1176,1548,45.07,11.56,8.79,6.44
02-06-2021,TAROUCA,0,0,0,"[0,120]",Baixo a Moderado,,,,0,Norte,VISEU,1820,10008.49,7804,405,335,313,277,324,601,914,1249,1654,77.98,16.53,12.48,9.13
02-06-2021,TAVIRA,15,1,61,"[0,120]",Baixo a Moderado,,,,15,Algarve,FARO,0814,60696.7,24530,1493,1415,1252,1066,1277,2343,3595,5010,6503,40.41,10.71,8.25,5.92
02-06-2021,TERRAS DE BOURO,1,0,16,"[0,120]",Baixo a Moderado,,,,1,Norte,BRAGA,0310,27746.07,6361,391,372,296,319,340,659,955,1327,1718,22.93,6.19,4.78,3.44
02-06-2021,TOMAR,4,0,11,"[0,120]",Baixo a Moderado,,,,4,Lisboa e Vale do Tejo,SANTARÉM,1418,35120.44,36748,2403,2189,1868,1853,1822,3675,5543,7732,10135,104.64,28.86,22.02,15.78
02-06-2021,TONDELA,2,0,8,"[0,120]",Baixo a Moderado,,,,2,Centro,VISEU,1821,37121.73,26357,1768,1722,1518,1475,1417,2892,4410,6132,7900,71.0,21.28,16.52,11.88
02-06-2021,TORRE DE MONCORVO,2,0,26,"[0,120]",Baixo a Moderado,,,,2,Norte,BRAGANÇA,0409,53155.67,7695,556,478,488,551,719,1270,1758,2236,2792,14.48,5.25,4.21,3.31
02-06-2021,TORRES NOVAS,14,1,40,"[0,120]",Baixo a Moderado,,,,14,Lisboa e Vale do Tejo,SANTARÉM,1419,26999.68,34933,2324,1979,1738,1406,1475,2881,4619,6598,8922,129.38,33.04,24.44,17.11
02-06-2021,TORRES VEDRAS,66,5,84,"[0,120]",Baixo a Moderado,,,,66,Lisboa e Vale do Tejo,LISBOA,1113,40714.89,78530,4513,3945,3447,2628,2104,4732,8179,12124,16637,192.88,40.86,29.78,20.09
02-06-2021,TRANCOSO,0,0,0,"[0,120]",Baixo a Moderado,,,,0,Centro,GUARDA,0913,36152.47,8875,581,557,542,586,496,1082,1624,2181,2762,24.55,7.64,6.03,4.49
02-06-2021,TROFA,20,1,52,"[0,120]",Baixo a Moderado,,,,20,Norte,PORTO,1318,7201.76,38418,2336,1894,1231,939,684,1623,2854,4748,7084,533.44,98.36,65.93,39.63
02-06-2021,VAGOS,2,0,9,"[0,120]",Baixo a Moderado,,,,2,Centro,AVEIRO,0118,16491.5,22740,1320,1205,922,784,724,1508,2430,3635,4955,137.89,30.04,22.04,14.73
02-06-2021,VALE DE CAMBRA,37,3,173,"[120,240]",Moderado,,,,37,Norte,AVEIRO,0119,14733.47,21327,1491,1363,1005,831,798,1629,2634,3997,5488,144.76,37.25,27.13,17.88
02-06-2021,VALENÇA,1,0,8,"[0,120]",Baixo a Moderado,,,,1,Norte,VIANA DO CASTELO,1608,11712.86,13290,867,791,582,582,503,1085,1667,2458,3325,113.46,28.39,20.99,14.23
02-06-2021,VALONGO,45,3,46,"[0,120]",Baixo a Moderado,,,,45,Norte,PORTO,1315,7512.45,97444,5629,4696,3207,2462,1829,4291,7498,12194,17823,1297.18,237.26,162.33,99.81
02-06-2021,VALPAÇOS,6,0,40,"[0,120]",Baixo a Moderado,,,,6,Norte,VILA REAL,1712,54873.93,14818,1217,1118,999,928,997,1925,2924,4042,5259,27.0,9.58,7.37,5.33
02-06-2021,VELAS,0,0,0,"[0,120]",Baixo a Moderado,,,,0,Açores,AÇORES,4502,11738.38,5093,278,208,166,153,113,266,432,640,918,43.39,7.82,5.45,3.68
02-06-2021,VENDAS NOVAS,2,0,18,"[0,120]",Baixo a Moderado,,,,2,Alentejo,ÉVORA,0712,22238.88,11255,677,768,655,501,532,1033,1688,2456,3133,50.61,14.09,11.04,7.59
02-06-2021,VIANA DO ALENTEJO,4,0,78,"[0,120]",Baixo a Moderado,,,,4,Alentejo,ÉVORA,0713,39367.29,5145,245,208,235,210,214,424,659,867,1112,13.07,2.82,2.2,1.67
02-06-2021,VIANA DO CASTELO,61,4,72,"[0,120]",Baixo a Moderado,,,,61,Norte,VIANA DO CASTELO,1609,31902.01,84417,5470,4433,3591,3061,2982,6043,9634,14067,19537,264.61,61.24,44.09,30.2
02-06-2021,VIDIGUEIRA,1,0,18,"[0,120]",Baixo a Moderado,,,,1,Alentejo,BEJA,0214,31661.09,5510,300,248,215,233,275,508,723,971,1271,17.4,4.01,3.07,2.28
02-06-2021,VIEIRA DO MINHO,0,0,0,"[0,120]",Baixo a Moderado,,,,0,Norte,BRAGA,0311,21644.35,11842,703,594,525,548,482,1030,1555,2149,2852,54.71,13.18,9.93,7.18
02-06-2021,VILA DE REI,1,0,30,"[0,120]",Baixo a Moderado,,,,1,Centro,CASTELO BRANCO,0510,19154.6,3323,169,128,172,247,302,549,721,849,1018,17.35,5.31,4.43,3.76
02-06-2021,VILA DO BISPO,4,0,78,"[0,120]",Baixo a Moderado,,,,4,Algarve,FARO,0815,17906.06,5154,302,302,314,232,233,465,779,1081,1383,28.78,7.72,6.04,4.35
02-06-2021,VILA DO CONDE,55,4,69,"[0,120]",Baixo a Moderado,,,,55,Norte,PORTO,1316,14902.77,79899,4726,3875,2819,2070,1743,3813,6632,10507,15233,536.13,102.21,70.5,44.5
02-06-2021,VILA DO PORTO,0,0,0,"[0,120]",Baixo a Moderado,,,,0,Açores,AÇORES,4101,9688.74,5616,274,212,135,96,123,219,354,566,840,57.96,8.67,5.84,3.65
02-06-2021,VILA FLOR,1,0,17,"[0,120]",Baixo a Moderado,,,,1,Norte,BRAGANÇA,0410,26581.14,6044,429,362,422,294,331,625,1047,1409,1838,22.74,6.91,5.3,3.94
02-06-2021,VILA FRANCA DE XIRA,77,5,54,"[0,120]",Baixo a Moderado,,,,77,Lisboa e Vale do Tejo,LISBOA,1114,31819.39,141957,8501,6852,4869,3425,2472,5897,10766,17618,26119,446.14,82.09,55.37,33.84
02-06-2021,VILA FRANCA DO CAMPO,33,2,299,"[240,480]",Elevado,,,,33,Açores,AÇORES,4206,7796.82,11051,450,344,248,217,154,371,619,963,1413,141.73,18.12,12.35,7.94
02-06-2021,VILA NOVA DA BARQUINHA,2,0,27,"[0,120]",Baixo a Moderado,,,,2,Lisboa e Vale do Tejo,SANTARÉM,1420,4952.97,7461,415,406,392,364,338,702,1094,1500,1915,150.64,38.66,30.28,22.09
02-06-2021,VILA NOVA DE CERVEIRA,1,0,11,"[0,120]",Baixo a Moderado,,,,1,Norte,VIANA DO CASTELO,1610,10846.66,8910,531,444,410,384,334,718,1128,1572,2103,82.14,19.39,14.49,10.4
02-06-2021,VILA NOVA DE FAMALICÃO,49,3,37,"[0,120]",Baixo a Moderado,,,,49,Norte,BRAGA,0312,20159.26,131676,7817,6164,4202,3282,2749,6031,10233,16397,24214,653.19,120.12,81.34,50.76
02-06-2021,VILA NOVA DE FOZ CÔA,4,0,62,"[0,120]",Baixo a Moderado,,,,4,Centro,GUARDA,0914,39815.18,6503,442,385,390,398,429,827,1217,1602,2044,16.33,5.13,4.02,3.06
02-06-2021,VILA NOVA DE GAIA,156,11,52,"[0,120]",Baixo a Moderado,,,,156,Norte,PORTO,1317,16846.43,300472,18349,15568,10972,8224,6281,14505,25477,41045,59394,1783.64,352.57,243.65,151.23
02-06-2021,VILA NOVA DE PAIVA,5,0,107,"[0,120]",Baixo a Moderado,,,,5,Centro,VISEU,1822,17553.28,4687,289,272,233,217,241,458,691,963,1252,26.7,7.13,5.49,3.94
02-06-2021,VILA NOVA DE POIARES,4,0,58,"[0,120]",Baixo a Moderado,,,,4,Centro,COIMBRA,0617,8445.3,6939,380,284,262,235,182,417,679,963,1343,82.17,15.9,11.4,8.04
02-06-2021,VILA POUCA DE AGUIAR,2,0,17,"[0,120]",Baixo a Moderado,,,,2,Norte,VILA REAL,1713,43706.62,11961,860,817,733,601,627,1228,1961,2778,3638,27.37,8.32,6.36,4.49
02-06-2021,VILA REAL,12,1,24,"[0,120]",Baixo a Moderado,,,,12,Norte,VILA REAL,1714,37880.28,49962,3025,2498,2065,1579,1466,3045,5110,7608,10633,131.9,28.07,20.08,13.49
02-06-2021,VILA REAL DE SANTO ANTÓNIO,2,0,11,"[0,120]",Baixo a Moderado,,,,2,Algarve,FARO,0816,6125.0,18749,1172,1069,811,569,586,1155,1966,3035,4207,306.11,68.69,49.55,32.1
02-06-2021,VILA VELHA DE RÓDÃO,0,0,0,"[0,120]",Baixo a Moderado,,,,0,Centro,CASTELO BRANCO,0511,32991.16,3144,209,229,180,283,306,589,769,998,1207,9.53,3.66,3.03,2.33
02-06-2021,VILA VERDE,51,4,109,"[0,120]",Baixo a Moderado,,,,51,Norte,BRAGA,0313,22866.52,46911,2365,2063,1667,1494,1437,2931,4598,6661,9026,205.15,39.47,29.13,20.11
02-06-2021,VILA VIÇOSA,0,0,0,"[0,120]",Baixo a Moderado,,,,0,Alentejo,ÉVORA,0714,19485.89,7656,487,379,342,345,324,669,1011,1390,1877,39.29,9.63,7.13,5.19
02-06-2021,VIMIOSO,3,0,75,"[0,120]",Baixo a Moderado,,,,3,Norte,BRAGANÇA,0411,48158.51,4023,274,230,261,293,335,628,889,1119,1393,8.35,2.89,2.32,1.85
02-06-2021,VINHAIS,2,0,26,"[0,120]",Baixo a Moderado,,,,2,Norte,BRAGANÇA,0412,69475.09,7746,599,577,636,641,815,1456,2092,2669,3268,11.15,4.7,3.84,3.01
02-06-2021,VISEU,35,3,36,"[0,120]",Baixo a Moderado,,,,35,Centro,VISEU,1823,50710.14,97249,5769,5038,4140,3158,2710,5868,10008,15046,20815,191.77,41.05,29.67,19.74
02-06-2021,VIZELA,4,0,17,"[0,120]",Baixo a Moderado,,,,4,Norte,BRAGA,0314,2469.83,23897,1258,928,655,509,371,880,1535,2463,3721,967.49,150.65,99.72,62.15
02-06-2021,VOUZELA,0,0,0,"[0,120]",Baixo a Moderado,,,,0,Centro,VISEU,1824,19369.46,9619,626,605,554,532,507,1039,1593,2198,2824,49.66,14.58,11.35,8.22
09-06-2021,ABRANTES,26,2,74,"[0,120]",Baixo a Moderado,,,,26,Lisboa e Vale do Tejo,SANTARÉM,1401,71469.08,35130,2473,2213,1730,1748,2021,3769,5499,7712,10185,49.15,14.25,10.79,7.69
09-06-2021,ÁGUEDA,44,3,95,"[0,120]",Baixo a Moderado,,,,44,Centro,AVEIRO,0101,33527.44,46075,3237,2713,2090,1635,1496,3131,5221,7934,11171,137.43,33.32,23.66,15.57
09-06-2021,AGUIAR DA BEIRA,1,0,21,"[0,120]",Baixo a Moderado,,,,1,Centro,GUARDA,0901,20676.57,4652,304,281,235,239,148,387,622,903,1207,22.5,5.84,4.37,3.01
09-06-2021,ALANDROAL,0,0,0,"[0,120]",Baixo a Moderado,,,,0,Alentejo,ÉVORA,0701,54267.81,4992,307,256,296,299,377,676,972,1228,1535,9.2,2.83,2.26,1.79
09-06-2021,ALBERGARIA-A-VELHA,6,0,25,"[0,120]",Baixo a Moderado,,,,6,Centro,AVEIRO,0102,15882.5,24144,1550,1298,996,687,680,1367,2363,3661,5211,152.02,32.81,23.05,14.88
09-06-2021,ALBUFEIRA,59,4,142,"[120,240]",Moderado,,,,59,Algarve,FARO,0801,14066.42,41528,2067,1717,1425,985,858,1843,3268,4985,7052,295.24,50.14,35.44,23.23
09-06-2021,ALCÁCER DO SAL,5,0,43,"[0,120]",Baixo a Moderado,,,,5,Alentejo,SETÚBAL,1501,149987.3,11659,884,814,623,623,602,1225,1848,2662,3546,7.77,2.36,1.77,1.23
09-06-2021,ALCANENA,16,1,125,"[120,240]",Moderado,,,,16,Lisboa e Vale do Tejo,SANTARÉM,1402,12732.86,12809,891,744,628,536,588,1124,1752,2496,3387,100.6,26.6,19.6,13.76
09-06-2021,ALCOBAÇA,2,0,4,"[0,120]",Baixo a Moderado,,,,2,Lisboa e Vale do Tejo,LEIRIA,1001,40814.09,53555,3420,2927,2466,2059,1676,3735,6201,9128,12548,131.22,30.74,22.36,15.19
09-06-2021,ALCOCHETE,18,1,91,"[0,120]",Baixo a Moderado,,,,18,Lisboa e Vale do Tejo,SETÚBAL,1502,12836.48,19787,857,834,691,476,447,923,1614,2448,3305,154.15,25.75,19.07,12.57
09-06-2021,ALCOUTIM,0,0,0,"[0,120]",Baixo a Moderado,,,,0,Algarve,FARO,0802,57536.33,2159,191,188,163,190,267,457,620,808,999,3.75,1.74,1.4,1.08
09-06-2021,ALENQUER,46,3,104,"[0,120]",Baixo a Moderado,,,,46,Lisboa e Vale do Tejo,LISBOA,1101,30421.92,44052,2298,2062,1629,1330,1155,2485,4114,6176,8474,144.8,27.85,20.3,13.52
09-06-2021,ALFÂNDEGA DA FÉ,0,0,0,"[0,120]",Baixo a Moderado,,,,0,Norte,BRAGANÇA,0401,32194.64,4550,325,277,301,274,325,599,900,1177,1502,14.13,4.67,3.66,2.8
09-06-2021,ALIJÓ,1,0,9,"[0,120]",Baixo a Moderado,,,,1,Norte,VILA REAL,1701,29759.89,10625,766,687,635,542,666,1208,1843,2530,3296,35.7,11.08,8.5,6.19
09-06-2021,ALJEZUR,9,1,161,"[120,240]",Moderado,,,,9,Algarve,FARO,0803,32349.95,5594,316,336,335,320,410,730,1065,1401,1717,17.29,5.31,4.33,3.29
09-06-2021,ALJUSTREL,1,0,12,"[0,120]",Baixo a Moderado,,,,1,Alentejo,BEJA,0201,45847.41,8247,635,521,443,347,358,705,1148,1669,2304,17.99,5.03,3.64,2.5
09-06-2021,ALMADA,179,13,106,"[0,120]",Baixo a Moderado,,,,179,Lisboa e Vale do Tejo,SETÚBAL,1503,7000.89,169039,10469,9777,7876,6144,5111,11255,19131,28908,39377,2414.5,562.45,412.91,273.26
09-06-2021,ALMEIDA,0,0,0,"[0,120]",Baixo a Moderado,,,,0,Centro,GUARDA,0902,51798.46,5830,441,419,396,458,393,851,1247,1666,2107,11.26,4.07,3.22,2.41
09-06-2021,ALMEIRIM,12,1,53,"[0,120]",Baixo a Moderado,,,,12,Lisboa e Vale do Tejo,SANTARÉM,1403,22212.05,22546,1342,1353,1106,866,843,1709,2815,4168,5510,101.5,24.81,18.76,12.67
09-06-2021,ALMODÔVAR,0,0,0,"[0,120]",Baixo a Moderado,,,,0,Alentejo,BEJA,0202,77788.03,6725,414,443,396,373,328,701,1097,1540,1954,8.65,2.51,1.98,1.41
09-06-2021,ALPIARÇA,3,0,42,"[0,120]",Baixo a Moderado,,,,3,Lisboa e Vale do Tejo,SANTARÉM,1404,9536.33,7059,515,486,363,333,274,607,970,1456,1971,74.02,20.67,15.27,10.17
09-06-2021,ALTER DO CHÃO,0,0,0,"[0,120]",Baixo a Moderado,,,,0,Alentejo,PORTALEGRE,1201,36206.62,3165,201,163,136,208,187,395,531,694,895,8.74,2.47,1.92,1.47
09-06-2021,ALVAIÁZERE,0,0,0,"[0,120]",Baixo a Moderado,,,,0,Centro,LEIRIA,1002,16047.76,6597,419,389,346,406,539,945,1291,1680,2099,41.11,13.08,10.47,8.04
09-06-2021,ALVITO,0,0,0,"[0,120]",Baixo a Moderado,,,,0,Alentejo,BEJA,0203,26485.32,2477,145,110,105,111,89,200,305,415,560,9.35,2.11,1.57,1.15
09-06-2021,AMADORA,177,13,96,"[0,120]",Baixo a Moderado,,,,177,Lisboa e Vale do Tejo,LISBOA,1115,2378.47,184106,11186,10936,8780,6460,5890,12350,21130,32066,43252,7742.05,1818.84,1348.44,888.56
09-06-2021,AMARANTE,31,2,58,"[0,120]",Baixo a Moderado,,,,31,Norte,PORTO,1301,30133.15,53193,3086,2413,1812,1643,1311,2954,4766,7179,10265,176.53,34.07,23.82,15.82
09-06-2021,AMARES,8,1,44,"[0,120]",Baixo a Moderado,,,,8,Norte,BRAGA,0301,8195.41,18129,1001,829,622,489,524,1013,1635,2464,3465,221.22,42.28,30.07,19.95
09-06-2021,ANADIA,10,1,37,"[0,120]",Baixo a Moderado,,,,10,Centro,AVEIRO,0103,21663.48,27258,1931,1698,1376,1208,1262,2470,3846,5544,7475,125.83,34.51,25.59,17.75
09-06-2021,ANGRA DO HEROÍSMO,1,0,3,"[0,120]",Baixo a Moderado,,,,1,Açores,AÇORES,4301,23899.66,33807,2006,1473,1122,768,635,1403,2525,3998,6004,141.45,25.12,16.73,10.56
09-06-2021,ANSIÃO,4,0,33,"[0,120]",Baixo a Moderado,,,,4,Centro,LEIRIA,1003,17609.42,12039,727,709,646,694,530,1224,1870,2579,3306,68.37,18.77,14.65,10.62
09-06-2021,ARCOS DE VALDEVEZ,13,1,62,"[0,120]",Baixo a Moderado,,,,13,Norte,VIANA DO CASTELO,1601,44759.64,20926,1329,1338,1282,1343,1515,2858,4140,5478,6807,46.75,15.21,12.24,9.25
09-06-2021,ARGANIL,3,0,27,"[0,120]",Baixo a Moderado,,,,3,Centro,COIMBRA,0601,33283.93,11014,672,648,612,559,596,1155,1767,2415,3087,33.09,9.27,7.26,5.31
09-06-2021,ARMAMAR,2,0,35,"[0,120]",Baixo a Moderado,,,,2,Norte,VISEU,1801,11723.73,5769,357,305,309,285,310,595,904,1209,1566,49.21,13.36,10.31,7.71
09-06-2021,AROUCA,10,1,48,"[0,120]",Baixo a Moderado,,,,10,Norte,AVEIRO,0104,32910.52,20720,1306,1047,753,683,683,1366,2119,3166,4472,62.96,13.59,9.62,6.44
09-06-2021,ARRAIOLOS,4,0,58,"[0,120]",Baixo a Moderado,,,,4,Alentejo,ÉVORA,0702,68374.55,6928,435,384,283,367,480,847,1130,1514,1949,10.13,2.85,2.21,1.65
09-06-2021,ARRONCHES,1,0,35,"[0,120]",Baixo a Moderado,,,,1,Alentejo,PORTALEGRE,1202,31464.72,2820,155,142,162,187,179,366,528,670,825,8.96,2.62,2.13,1.68
09-06-2021,ARRUDA DOS VINHOS,25,2,162,"[120,240]",Moderado,,,,25,Lisboa e Vale do Tejo,LISBOA,1102,7795.93,15412,738,738,562,509,438,947,1509,2247,2985,197.69,38.29,28.82,19.36
09-06-2021,AVEIRO,18,1,23,"[0,120]",Baixo a Moderado,,,,18,Centro,AVEIRO,0105,19757.57,78734,4520,4004,3050,2250,2103,4353,7403,11407,15927,398.49,80.61,57.73,37.47
09-06-2021,AVIS,0,0,0,"[0,120]",Baixo a Moderado,,,,0,Alentejo,PORTALEGRE,1203,60596.51,4247,315,225,206,251,273,524,730,955,1270,7.01,2.1,1.58,1.2
09-06-2021,AZAMBUJA,8,1,35,"[0,120]",Baixo a Moderado,,,,8,Lisboa e Vale do Tejo,LISBOA,1103,26265.65,22716,1322,1171,1070,798,618,1416,2486,3657,4979,86.48,18.96,13.92,9.46
09-06-2021,BAIÃO,14,1,75,"[0,120]",Baixo a Moderado,,,,14,Norte,PORTO,1302,17452.83,18748,1070,862,714,686,725,1411,2125,2987,4057,107.42,23.25,17.11,12.18
09-06-2021,BARCELOS,77,5,66,"[0,120]",Baixo a Moderado,,,,77,Norte,BRAGA,0302,37890.14,116187,6721,5325,3619,2991,2562,5553,9172,14497,21218,306.64,56.0,38.26,24.21
09-06-2021,BARRANCOS,0,0,0,"[0,120]",Baixo a Moderado,,,,0,Alentejo,BEJA,0204,16841.73,1634,90,65,65,94,61,155,220,285,375,9.7,2.23,1.69,1.31
09-06-2021,BARREIRO,83,6,110,"[0,120]",Baixo a Moderado,,,,83,Lisboa e Vale do Tejo,SETÚBAL,1504,3639.07,75147,5194,5565,4459,3105,1767,4872,9331,14896,20090,2065.05,552.07,409.34,256.42
09-06-2021,BATALHA,1,0,6,"[0,120]",Baixo a Moderado,,,,1,Centro,LEIRIA,1004,10341.6,15963,873,762,649,529,549,1078,1727,2489,3362,154.35,32.51,24.07,16.7
09-06-2021,BEJA,3,0,9,"[0,120]",Baixo a Moderado,,,,3,Alentejo,BEJA,0205,114647.55,33579,2005,1840,1386,1272,1039,2311,3697,5537,7542,29.29,6.58,4.83,3.22
09-06-2021,BELMONTE,0,0,0,"[0,120]",Baixo a Moderado,,,,0,Centro,CASTELO BRANCO,0501,11875.91,6398,444,321,325,310,355,665,990,1311,1755,53.87,14.78,11.04,8.34
09-06-2021,BENAVENTE,18,1,59,"[0,120]",Baixo a Moderado,,,,18,Lisboa e Vale do Tejo,SANTARÉM,1405,52138.39,30602,1468,1376,1141,876,643,1519,2660,4036,5504,58.69,10.56,7.74,5.1
09-06-2021,BOMBARRAL,3,0,24,"[0,120]",Baixo a Moderado,,,,3,Lisboa e Vale do Tejo,LEIRIA,1005,9128.55,12558,875,714,561,491,429,920,1481,2195,3070,137.56,33.63,24.04,16.22
09-06-2021,BORBA,4,0,59,"[0,120]",Baixo a Moderado,,,,4,Alentejo,ÉVORA,0703,14518.65,6736,430,375,279,436,392,828,1107,1482,1912,46.39,13.17,10.21,7.62
09-06-2021,BOTICAS,0,0,0,"[0,120]",Baixo a Moderado,,,,0,Norte,VILA REAL,1702,32195.66,4998,347,306,311,305,380,685,996,1302,1649,15.52,5.12,4.04,3.09
09-06-2021,BRAGA,323,23,177,"[120,240]",Moderado,,,,323,Norte,BRAGA,0303,18339.95,182679,10029,7963,5241,4320,3671,7991,13232,21195,31224,996.07,170.25,115.57,72.15
09-06-2021,BRAGANÇA,5,0,15,"[0,120]",Baixo a Moderado,,,,5,Norte,BRAGANÇA,0402,117357.27,33607,2402,1855,1652,1393,1163,2556,4208,6063,8465,28.64,7.21,5.17,3.59
09-06-2021,CABECEIRAS DE BASTO,2,0,13,"[0,120]",Baixo a Moderado,,,,2,Norte,BRAGA,0304,24182.16,15628,774,594,544,575,574,1149,1693,2287,3061,64.63,12.66,9.46,7.0
09-06-2021,CADAVAL,9,1,66,"[0,120]",Baixo a Moderado,,,,9,Lisboa e Vale do Tejo,LISBOA,1104,17489.3,13673,813,796,756,621,625,1246,2002,2798,3611,78.18,20.65,16.0,11.45
09-06-2021,CALDAS DA RAINHA,20,1,39,"[0,120]",Baixo a Moderado,,,,20,Lisboa e Vale do Tejo,LEIRIA,1006,25569.47,51912,3035,2684,2186,1899,1705,3604,5790,8474,11509,203.03,45.01,33.14,22.64
09-06-2021,CALHETA,2,0,18,"[0,120]",Baixo a Moderado,,,,2,Madeira,MADEIRA,3101,11150.43,10867,576,497,507,399,415,814,1321,1818,2394,97.46,21.47,16.3,11.85
09-06-2021,CALHETA (AÇORES),0,0,0,"[0,120]",Baixo a Moderado,,,,0,Açores,AÇORES,4501,12626.4,3184,215,159,141,139,122,261,402,561,776,25.22,6.15,4.44,3.18
09-06-2021,CÂMARA DE LOBOS,19,1,56,"[0,120]",Baixo a Moderado,,,,19,Madeira,MADEIRA,3102,5216.67,33675,1396,1059,834,545,381,926,1760,2819,4215,645.49,80.79,54.03,33.74
09-06-2021,CAMINHA,0,0,0,"[0,120]",Baixo a Moderado,,,,0,Norte,VIANA DO CASTELO,1602,13652.14,15877,1046,944,818,646,656,1302,2120,3064,4110,116.3,30.11,22.44,15.53
09-06-2021,CAMPO MAIOR,2,0,25,"[0,120]",Baixo a Moderado,,,,2,Alentejo,PORTALEGRE,1204,24720.16,7874,471,364,351,279,327,606,957,1321,1792,31.85,7.25,5.34,3.87
09-06-2021,CANTANHEDE,33,2,94,"[0,120]",Baixo a Moderado,,,,33,Centro,COIMBRA,0602,39088.02,35011,2346,2096,1880,1709,1451,3160,5040,7136,9482,89.57,24.26,18.26,12.89
09-06-2021,CARRAZEDA DE ANSIÃES,0,0,0,"[0,120]",Baixo a Moderado,,,,0,Norte,BRAGANÇA,0403,27924.09,5666,424,389,391,312,465,777,1168,1557,1981,20.29,7.09,5.58,4.18
09-06-2021,CARREGAL DO SAL,1,0,11,"[0,120]",Baixo a Moderado,,,,1,Centro,VISEU,1802,11689.21,9271,587,562,486,462,376,838,1324,1886,2473,79.31,21.16,16.13,11.33
09-06-2021,CARTAXO,13,1,55,"[0,120]",Baixo a Moderado,,,,13,Lisboa e Vale do Tejo,SANTARÉM,1406,15817.28,23843,1415,1376,1142,861,632,1493,2635,4011,5426,150.74,34.3,25.36,16.66
09-06-2021,CASCAIS,297,21,139,"[120,240]",Moderado,,,,297,Lisboa e Vale do Tejo,LISBOA,1105,9740.17,213608,12151,11444,8680,6469,5248,11717,20397,31841,43992,2193.1,451.66,326.91,209.41
09-06-2021,CASTANHEIRA DE PÊRA,1,0,38,"[0,120]",Baixo a Moderado,,,,1,Centro,LEIRIA,1007,6677.45,2614,233,195,157,190,187,377,534,729,962,39.15,14.41,10.92,8.0
09-06-2021,CASTELO BRANCO,6,0,12,"[0,120]",Baixo a Moderado,,,,6,Centro,CASTELO BRANCO,0502,143819.15,51987,3528,3042,2499,2229,2225,4454,6953,9995,13523,36.15,9.4,6.95,4.83
09-06-2021,CASTELO DE PAIVA,17,1,110,"[0,120]",Baixo a Moderado,,,,17,Norte,AVEIRO,0106,11500.53,15454,881,697,545,420,431,851,1396,2093,2974,134.37,25.86,18.2,12.14
09-06-2021,CASTELO DE VIDE,0,0,0,"[0,120]",Baixo a Moderado,,,,0,Alentejo,PORTALEGRE,1205,26491.24,2919,204,173,179,147,170,317,496,669,873,11.02,3.3,2.53,1.87
09-06-2021,CASTRO DAIRE,4,0,29,"[0,120]",Baixo a Moderado,,,,4,Centro,VISEU,1803,37904.13,13823,942,857,765,732,773,1505,2270,3127,4069,36.47,10.74,8.25,5.99
09-06-2021,CASTRO MARIM,0,0,0,"[0,120]",Baixo a Moderado,,,,0,Algarve,FARO,0804,30084.37,6237,370,345,334,322,344,666,1000,1345,1715,20.73,5.7,4.47,3.32
09-06-2021,CASTRO VERDE,2,0,29,"[0,120]",Baixo a Moderado,,,,2,Alentejo,BEJA,0206,56944.23,6949,437,347,303,275,227,502,805,1152,1589,12.2,2.79,2.02,1.41
09-06-2021,CELORICO DA BEIRA,0,0,0,"[0,120]",Baixo a Moderado,,,,0,Centro,GUARDA,0903,24721.63,6928,430,416,363,369,535,904,1267,1683,2113,28.02,8.55,6.81,5.12
09-06-2021,CELORICO DE BASTO,2,0,11,"[0,120]",Baixo a Moderado,,,,2,Norte,BRAGA,0305,18107.02,19040,1001,802,668,728,729,1457,2125,2927,3928,105.15,21.69,16.17,11.74
09-06-2021,CHAMUSCA,2,0,22,"[0,120]",Baixo a Moderado,,,,2,Lisboa e Vale do Tejo,SANTARÉM,1407,74600.54,9197,629,583,553,465,579,1044,1597,2180,2809,12.33,3.77,2.92,2.14
09-06-2021,CHAVES,30,2,76,"[0,120]",Baixo a Moderado,,,,30,Norte,VILA REAL,1703,59122.95,39343,2676,2429,1991,1886,1918,3804,5795,8224,10900,66.54,18.44,13.91,9.8
09-06-2021,CINFÃES,5,0,27,"[0,120]",Baixo a Moderado,,,,5,Norte,VISEU,1804,23928.76,18244,1067,902,779,734,758,1492,2271,3173,4240,76.24,17.72,13.26,9.49
09-06-2021,COIMBRA,72,5,54,"[0,120]",Baixo a Moderado,,,,72,Centro,COIMBRA,0603,31939.94,134166,9489,8734,6353,5139,5074,10213,16566,25300,34789,420.06,108.92,79.21,51.87
09-06-2021,CONDEIXA-A-NOVA,5,0,28,"[0,120]",Baixo a Moderado,,,,5,Centro,COIMBRA,0604,13867.47,17733,871,809,717,583,490,1073,1790,2599,3470,127.88,25.02,18.74,12.91
09-06-2021,CONSTÂNCIA,2,0,50,"[0,120]",Baixo a Moderado,,,,2,Lisboa e Vale do Tejo,SANTARÉM,1408,8036.58,4030,211,183,187,148,155,303,490,673,884,50.14,11.0,8.37,6.1
09-06-2021,CORUCHE,4,0,23,"[0,120]",Baixo a Moderado,,,,4,Lisboa e Vale do Tejo,SANTARÉM,1409,111572.03,17471,1294,1090,1095,1096,1019,2115,3210,4300,5594,15.66,5.01,3.85,2.88
09-06-2021,CORVO,0,0,0,"[0,120]",Baixo a Moderado,,,,0,Açores,AÇORES,4901,1711.45,464,22,21,11,13,19,32,43,64,86,27.12,5.03,3.74,2.51
09-06-2021,COVILHÃ,6,0,13,"[0,120]",Baixo a Moderado,,,,6,Centro,CASTELO BRANCO,0503,55560.06,46787,3533,2998,2365,2111,2193,4304,6669,9667,13200,84.21,23.76,17.4,12.0
09-06-2021,CRATO,0,0,0,"[0,120]",Baixo a Moderado,,,,0,Alentejo,PORTALEGRE,1206,39806.88,3129,229,258,163,182,228,410,573,831,1060,7.86,2.66,2.09,1.44
09-06-2021,CUBA,4,0,87,"[0,120]",Baixo a Moderado,,,,4,Alentejo,BEJA,0207,17208.72,4595,255,233,206,190,143,333,539,772,1027,26.7,5.97,4.49,3.13
09-06-2021,ELVAS,5,0,24,"[0,120]",Baixo a Moderado,,,,5,Alentejo,PORTALEGRE,1207,63128.86,20528,1057,1145,902,852,810,1662,2564,3709,4766,32.52,7.55,5.88,4.06
09-06-2021,ENTRONCAMENTO,11,1,51,"[0,120]",Baixo a Moderado,,,,11,Lisboa e Vale do Tejo,SANTARÉM,1410,1372.81,21558,1066,930,868,695,592,1287,2155,3085,4151,1570.14,302.33,224.69,156.96
09-06-2021,ESPINHO,18,1,61,"[0,120]",Baixo a Moderado,,,,18,Norte,AVEIRO,0107,2105.68,29516,2205,1993,1430,1177,960,2137,3567,5560,7765,1401.52,368.71,264.01,169.37
09-06-2021,ESPOSENDE,12,1,35,"[0,120]",Baixo a Moderado,,,,12,Norte,BRAGA,0306,9540.98,34177,1831,1522,1095,894,723,1617,2712,4234,6065,358.21,63.57,44.38,28.42
09-06-2021,ESTARREJA,2,0,8,"[0,120]",Baixo a Moderado,,,,2,Centro,AVEIRO,0108,10817.33,26006,1503,1399,1106,953,728,1681,2787,4186,5689,240.42,52.59,38.7,25.76
09-06-2021,ESTREMOZ,1,0,8,"[0,120]",Baixo a Moderado,,,,1,Alentejo,ÉVORA,0704,51379.95,12728,789,613,697,786,877,1663,2360,2973,3762,24.77,7.32,5.79,4.59
09-06-2021,ÉVORA,28,2,53,"[0,120]",Baixo a Moderado,,,,28,Alentejo,ÉVORA,0705,130707.58,52428,3569,2852,2176,1966,1803,3769,5945,8797,12366,40.11,9.46,6.73,4.55
09-06-2021,FAFE,12,1,25,"[0,120]",Baixo a Moderado,,,,12,Norte,BRAGA,0307,21908.11,48060,3044,2455,1679,1403,1208,2611,4290,6745,9789,219.37,44.68,30.79,19.58
09-06-2021,FARO,56,4,92,"[0,120]",Baixo a Moderado,,,,56,Algarve,FARO,0805,20256.79,61015,3847,3364,2604,2055,1601,3656,6260,9624,13471,301.2,66.5,47.51,30.9
09-06-2021,FELGUEIRAS,21,1,37,"[0,120]",Baixo a Moderado,,,,21,Norte,PORTO,1303,11573.75,56422,2951,2302,1601,1316,973,2289,3890,6192,9143,487.49,79.0,53.5,33.61
09-06-2021,FERREIRA DO ALENTEJO,0,0,0,"[0,120]",Baixo a Moderado,,,,0,Alentejo,BEJA,0208,64820.68,7845,515,414,372,343,345,688,1060,1474,1989,12.1,3.07,2.27,1.64
09-06-2021,FERREIRA DO ZÊZERE,0,0,0,"[0,120]",Baixo a Moderado,,,,0,Lisboa e Vale do Tejo,SANTARÉM,1411,19038.03,7959,470,370,416,465,456,921,1337,1707,2177,41.81,11.44,8.97,7.02
09-06-2021,FIGUEIRA DA FOZ,20,1,34,"[0,120]",Baixo a Moderado,,,,20,Centro,COIMBRA,0605,37905.26,58747,4032,3597,2887,2495,2043,4538,7425,11022,15054,154.98,39.72,29.08,19.59
09-06-2021,FIGUEIRA DE CASTELO RODRIGO,1,0,18,"[0,120]",Baixo a Moderado,,,,1,Centro,GUARDA,0904,50857.46,5584,347,352,290,352,391,743,1033,1385,1732,10.98,3.41,2.72,2.03
09-06-2021,FIGUEIRÓ DOS VINHOS,6,0,108,"[0,120]",Baixo a Moderado,,,,6,Centro,LEIRIA,1008,17344.0,5568,402,386,322,309,351,660,982,1368,1770,32.1,10.21,7.89,5.66
09-06-2021,FORNOS DE ALGODRES,0,0,0,"[0,120]",Baixo a Moderado,,,,0,Centro,GUARDA,0905,13145.05,4528,261,218,247,256,232,488,735,953,1214,34.45,9.24,7.25,5.59
09-06-2021,FREIXO DE ESPADA À CINTA,0,0,0,"[0,120]",Baixo a Moderado,,,,0,Norte,BRAGANÇA,0404,24414.29,3298,211,177,231,196,189,385,616,793,1004,13.51,4.11,3.25,2.52
09-06-2021,FRONTEIRA,5,0,168,"[120,240]",Moderado,,,,5,Alentejo,PORTALEGRE,1208,24859.58,2974,213,182,149,156,168,324,473,655,868,11.96,3.49,2.63,1.9
09-06-2021,FUNCHAL,92,7,88,"[0,120]",Baixo a Moderado,,,,92,Madeira,MADEIRA,3103,7616.2,104024,6382,5086,3643,2821,1990,4811,8454,13540,19922,1365.86,261.58,177.78,111.0
09-06-2021,FUNDÃO,6,0,23,"[0,120]",Baixo a Moderado,,,,6,Centro,CASTELO BRANCO,0504,70019.79,26495,1781,1464,1432,1357,1643,3000,4432,5896,7677,37.84,10.96,8.42,6.33
09-06-2021,GAVIÃO,0,0,0,"[0,120]",Baixo a Moderado,,,,0,Alentejo,PORTALEGRE,1209,29459.45,3263,189,186,222,263,293,556,778,964,1153,11.08,3.91,3.27,2.64
09-06-2021,GÓIS,0,0,0,"[0,120]",Baixo a Moderado,,,,0,Centro,COIMBRA,0606,26330.19,3805,235,199,240,233,244,477,717,916,1151,14.45,4.37,3.48,2.72
09-06-2021,GOLEGÃ,4,0,75,"[0,120]",Baixo a Moderado,,,,4,Lisboa e Vale do Tejo,SANTARÉM,1412,8431.67,5339,356,299,281,243,255,498,779,1078,1434,63.32,17.01,12.78,9.24
09-06-2021,GONDOMAR,53,4,32,"[0,120]",Baixo a Moderado,,,,53,Norte,PORTO,1304,13191.76,165985,10555,8755,6222,4450,3364,7814,14036,22791,33346,1258.22,252.77,172.76,106.4
09-06-2021,GOUVEIA,5,0,40,"[0,120]",Baixo a Moderado,,,,5,Centro,GUARDA,0906,30061.17,12387,871,931,780,783,810,1593,2373,3304,4175,41.21,13.89,10.99,7.89
09-06-2021,GRÂNDOLA,0,0,0,"[0,120]",Baixo a Moderado,,,,0,Alentejo,SETÚBAL,1505,82593.66,14639,834,834,708,688,672,1360,2068,2902,3736,17.72,4.52,3.51,2.5
09-06-2021,GUARDA,9,1,23,"[0,120]",Baixo a Moderado,,,,9,Centro,GUARDA,0907,71209.58,38969,2477,2041,1686,1415,1474,2889,4575,6616,9093,54.72,12.77,9.29,6.42
09-06-2021,GUIMARÃES,49,3,32,"[0,120]",Baixo a Moderado,,,,49,Norte,BRAGA,0308,24099.96,152309,9394,7074,4809,3877,2948,6825,11634,18708,28102,631.99,116.61,77.63,48.27
09-06-2021,HORTA,1,0,7,"[0,120]",Baixo a Moderado,,,,1,Açores,AÇORES,4701,17305.53,14521,818,658,468,352,302,654,1122,1780,2598,83.91,15.01,10.29,6.48
09-06-2021,IDANHA-A-NOVA,1,0,12,"[0,120]",Baixo a Moderado,,,,1,Centro,CASTELO BRANCO,0505,141633.51,8043,518,490,519,672,974,1646,2165,2655,3173,5.68,2.24,1.87,1.53
09-06-2021,ÍLHAVO,6,0,16,"[0,120]",Baixo a Moderado,,,,6,Centro,AVEIRO,0110,7347.55,38699,2227,1943,1444,1193,850,2043,3487,5430,7657,526.66,104.21,73.9,47.46
09-06-2021,LAGOA (FARO),5,0,22,"[0,120]",Baixo a Moderado,,,,5,Algarve,FARO,0806,8825.45,22762,1314,1168,919,749,670,1419,2338,3506,4820,257.93,54.62,39.73,26.49
09-06-2021,LAGOA,16,1,109,"[0,120]",Baixo a Moderado,,,,16,Açores,AÇORES,4201,4559.32,14721,536,458,349,238,235,473,822,1280,1816,322.9,39.83,28.08,18.03
09-06-2021,LAGOS,20,1,66,"[0,120]",Baixo a Moderado,,,,20,Algarve,FARO,0807,21299.27,30374,1744,1434,1247,1053,1029,2082,3329,4763,6507,142.61,30.55,22.36,15.63
09-06-2021,LAJES DAS FLORES,0,0,0,"[0,120]",Baixo a Moderado,,,,0,Açores,AÇORES,4801,7004.79,1463,88,53,62,46,54,100,162,215,303,20.89,4.33,3.07,2.31
09-06-2021,LAJES DO PICO,0,0,0,"[0,120]",Baixo a Moderado,,,,0,Açores,AÇORES,4601,15531.09,4490,304,231,223,159,162,321,544,775,1079,28.91,6.95,4.99,3.5
09-06-2021,LAMEGO,5,0,20,"[0,120]",Baixo a Moderado,,,,5,Norte,VISEU,1805,16542.11,24895,1639,1284,1124,898,783,1681,2805,4089,5728,150.5,34.63,24.72,16.96
09-06-2021,LEIRIA,26,2,21,"[0,120]",Baixo a Moderado,,,,26,Centro,LEIRIA,1009,56508.83,125267,7389,6366,5090,3902,3159,7061,12151,18517,25906,221.68,45.84,32.77,21.5
09-06-2021,LISBOA,1131,81,222,"[120,240]",Moderado,,,,1131,Lisboa e Vale do Tejo,LISBOA,1106,10005.43,509515,33197,33340,27706,23037,26770,49807,77513,110853,144050,5092.6,1439.78,1107.98,774.74
09-06-2021,LOULÉ,83,6,121,"[120,240]",Moderado,,,,83,Algarve,FARO,0808,76366.91,68697,3890,3350,2780,2358,2251,4609,7389,10739,14629,89.96,19.16,14.06,9.68
09-06-2021,LOURES,227,16,106,"[0,120]",Baixo a Moderado,,,,227,Lisboa e Vale do Tejo,LISBOA,1107,16723.99,213687,12746,12794,9644,6669,5033,11702,21346,34140,46886,1277.73,280.35,204.14,127.64
09-06-2021,LOURINHÃ,9,1,35,"[0,120]",Baixo a Moderado,,,,9,Lisboa e Vale do Tejo,LISBOA,1108,14717.2,25855,1584,1243,992,842,645,1487,2479,3722,5306,175.68,36.05,25.29,16.84
09-06-2021,LOUSÃ,0,0,0,"[0,120]",Baixo a Moderado,,,,0,Centro,COIMBRA,0607,13840.01,17158,946,866,658,528,450,978,1636,2502,3448,123.97,24.91,18.08,11.82
09-06-2021,LOUSADA,49,4,105,"[0,120]",Baixo a Moderado,,,,49,Norte,PORTO,1305,9608.01,46755,2289,1698,1176,853,621,1474,2650,4348,6637,486.63,69.08,45.25,27.58
09-06-2021,MAÇÃO,0,0,0,"[0,120]",Baixo a Moderado,,,,0,Lisboa e Vale do Tejo,SANTARÉM,1413,39997.98,6267,386,362,390,440,657,1097,1487,1849,2235,15.67,5.59,4.62,3.72
09-06-2021,MACEDO DE CAVALEIROS,2,0,14,"[0,120]",Baixo a Moderado,,,,2,Norte,BRAGANÇA,0405,69914.08,14516,1082,889,878,823,938,1761,2639,3528,4610,20.76,6.59,5.05,3.77
09-06-2021,MACHICO,2,0,10,"[0,120]",Baixo a Moderado,,,,2,Madeira,MADEIRA,3104,6825.1,19981,1197,860,662,455,331,786,1448,2308,3505,292.76,51.36,33.82,21.22
09-06-2021,MADALENA,0,0,0,"[0,120]",Baixo a Moderado,,,,0,Açores,AÇORES,4602,14712.33,5895,334,256,173,190,179,369,542,798,1132,40.07,7.69,5.42,3.68
09-06-2021,MAFRA,93,7,110,"[0,120]",Baixo a Moderado,,,,93,Lisboa e Vale do Tejo,LISBOA,1109,29165.5,84816,3613,3334,2839,2089,1899,3988,6827,10161,13774,290.81,47.23,34.84,23.41
09-06-2021,MAIA,68,5,49,"[0,120]",Baixo a Moderado,,,,68,Norte,PORTO,1306,8293.94,138971,7801,6617,4512,3339,2631,5970,10482,17099,24900,1675.56,300.22,206.16,126.38
09-06-2021,MANGUALDE,7,1,38,"[0,120]",Baixo a Moderado,,,,7,Centro,VISEU,1806,21925.56,18510,1198,1128,885,852,743,1595,2480,3608,4806,84.42,21.92,16.46,11.31
09-06-2021,MANTEIGAS,1,0,33,"[0,120]",Baixo a Moderado,,,,1,Centro,GUARDA,0908,12197.55,3007,258,197,159,167,146,313,472,669,927,24.65,7.6,5.48,3.87
09-06-2021,MARCO DE CANAVESES,6,0,12,"[0,120]",Baixo a Moderado,,,,6,Norte,PORTO,1307,20188.98,51496,2678,2060,1488,1265,1023,2288,3776,5836,8514,255.07,42.17,28.91,18.7
09-06-2021,MARINHA GRANDE,7,0,18,"[0,120]",Baixo a Moderado,,,,7,Centro,LEIRIA,1010,18725.19,38508,2365,2302,1638,1359,1058,2417,4055,6357,8722,205.65,46.58,33.95,21.66
09-06-2021,MARVÃO,2,0,67,"[0,120]",Baixo a Moderado,,,,2,Alentejo,PORTALEGRE,1210,15489.9,3005,198,185,142,197,237,434,576,761,959,19.4,6.19,4.91,3.72
09-06-2021,MATOSINHOS,125,9,71,"[0,120]",Baixo a Moderado,,,,125,Norte,PORTO,1308,6241.97,175357,11850,9977,7023,5024,3884,8908,15931,25908,37758,2809.31,604.9,415.06,255.22
09-06-2021,MEALHADA,3,0,15,"[0,120]",Baixo a Moderado,,,,3,Centro,AVEIRO,0111,11065.66,19914,1163,1039,810,828,831,1659,2469,3508,4671,179.96,42.21,31.7,22.31
09-06-2021,MÊDA,0,0,0,"[0,120]",Baixo a Moderado,,,,0,Centro,GUARDA,0909,28604.92,4587,343,306,290,288,443,731,1021,1327,1670,16.04,5.84,4.64,3.57
09-06-2021,MELGAÇO,1,0,12,"[0,120]",Baixo a Moderado,,,,1,Norte,VIANA DO CASTELO,1603,23824.58,8093,507,567,578,614,675,1289,1867,2434,2941,33.97,12.34,10.22,7.84
09-06-2021,MÉRTOLA,0,0,0,"[0,120]",Baixo a Moderado,,,,0,Alentejo,BEJA,0209,129287.34,6142,400,390,378,423,600,1023,1401,1791,2191,4.75,1.69,1.39,1.08
09-06-2021,MESÃO FRIO,1,0,25,"[0,120]",Baixo a Moderado,,,,1,Norte,VILA REAL,1704,2664.87,3964,265,205,168,157,120,277,445,650,915,148.74,34.33,24.39,16.7
09-06-2021,MIRA,1,0,8,"[0,120]",Baixo a Moderado,,,,1,Centro,COIMBRA,0608,12403.38,11832,727,729,659,550,466,1016,1675,2404,3131,95.4,25.24,19.38,13.5
09-06-2021,MIRANDA DO CORVO,0,0,0,"[0,120]",Baixo a Moderado,,,,0,Centro,COIMBRA,0609,12637.79,12708,706,659,568,498,404,902,1470,2129,2835,100.55,22.43,16.85,11.63
09-06-2021,MIRANDA DO DOURO,2,0,29,"[0,120]",Baixo a Moderado,,,,2,Norte,BRAGANÇA,0406,48718.31,6830,482,429,442,463,470,933,1375,1804,2286,14.02,4.69,3.7,2.82
09-06-2021,MIRANDELA,1,0,5,"[0,120]",Baixo a Moderado,,,,1,Norte,BRAGANÇA,0407,65895.67,21754,1640,1315,1204,1078,947,2025,3229,4544,6184,33.01,9.38,6.9,4.9
09-06-2021,MOGADOURO,0,0,0,"[0,120]",Baixo a Moderado,,,,0,Norte,BRAGANÇA,0408,76064.93,8392,589,529,576,630,655,1285,1861,2390,2979,11.03,3.92,3.14,2.45
09-06-2021,MOIMENTA DA BEIRA,0,0,0,"[0,120]",Baixo a Moderado,,,,0,Norte,VISEU,1807,21996.9,9736,576,514,471,416,461,877,1348,1862,2438,44.26,11.08,8.46,6.13
09-06-2021,MOITA,72,5,112,"[0,120]",Baixo a Moderado,,,,72,Lisboa e Vale do Tejo,SETÚBAL,1506,5525.98,64407,4226,3646,2623,1801,1425,3226,5849,9495,13721,1165.53,248.3,171.82,105.85
09-06-2021,MONÇÃO,3,0,17,"[0,120]",Baixo a Moderado,,,,3,Norte,VIANA DO CASTELO,1604,21130.85,17869,1161,1105,1031,1006,972,1978,3009,4114,5275,84.56,24.96,19.47,14.24
09-06-2021,MONCHIQUE,0,0,0,"[0,120]",Baixo a Moderado,,,,0,Algarve,FARO,0809,39530.43,5077,353,384,321,355,392,747,1068,1452,1805,12.84,4.57,3.67,2.7
09-06-2021,MONDIM DE BASTO,3,0,43,"[0,120]",Baixo a Moderado,,,,3,Norte,VILA REAL,1705,17207.52,6946,395,300,314,284,283,567,881,1181,1576,40.36,9.16,6.86,5.12
09-06-2021,MONFORTE,5,0,168,"[120,240]",Moderado,,,,5,Alentejo,PORTALEGRE,1211,42024.82,2975,139,115,117,192,168,360,477,592,731,7.08,1.74,1.41,1.14
09-06-2021,MONTALEGRE,8,1,89,"[0,120]",Baixo a Moderado,,,,8,Norte,VILA REAL,1706,80545.71,8997,699,628,595,603,730,1333,1928,2556,3255,11.17,4.04,3.17,2.39
09-06-2021,MONTEMOR-O-NOVO,5,0,32,"[0,120]",Baixo a Moderado,,,,5,Alentejo,ÉVORA,0706,123296.65,15647,991,953,868,878,971,1849,2717,3670,4661,12.69,3.78,2.98,2.2
09-06-2021,MONTEMOR-O-VELHO,22,2,87,"[0,120]",Baixo a Moderado,,,,22,Centro,COIMBRA,0610,22896.23,25224,1496,1397,1217,1057,988,2045,3262,4659,6155,110.17,26.88,20.35,14.25
09-06-2021,MONTIJO,45,3,78,"[0,120]",Baixo a Moderado,,,,45,Lisboa e Vale do Tejo,SETÚBAL,1507,34861.64,57614,2771,2441,1990,1554,1109,2663,4653,7094,9865,165.26,28.3,20.35,13.35
09-06-2021,MORA,0,0,0,"[0,120]",Baixo a Moderado,,,,0,Alentejo,ÉVORA,0707,44395.02,4138,336,275,252,238,257,495,747,1022,1358,9.32,3.06,2.3,1.68
09-06-2021,MORTÁGUA,0,0,0,"[0,120]",Baixo a Moderado,,,,0,Centro,VISEU,1808,25117.82,8803,638,584,535,499,460,959,1494,2078,2716,35.05,10.81,8.27,5.95
09-06-2021,MOURA,1,0,7,"[0,120]",Baixo a Moderado,,,,1,Alentejo,BEJA,0210,95845.55,13718,817,656,665,542,461,1003,1668,2324,3141,14.31,3.28,2.42,1.74
09-06-2021,MOURÃO,0,0,0,"[0,120]",Baixo a Moderado,,,,0,Alentejo,ÉVORA,0708,27862.98,2450,139,108,80,104,109,213,293,401,540,8.79,1.94,1.44,1.05
09-06-2021,MURÇA,0,0,0,"[0,120]",Baixo a Moderado,,,,0,Norte,VILA REAL,1707,18937.11,5463,384,341,307,306,319,625,932,1273,1657,28.85,8.75,6.72,4.92
09-06-2021,MURTOSA,1,0,10,"[0,120]",Baixo a Moderado,,,,1,Centro,AVEIRO,0112,7308.78,10279,509,473,403,353,409,762,1165,1638,2147,140.63,29.37,22.41,15.94
09-06-2021,NAZARÉ,0,0,0,"[0,120]",Baixo a Moderado,,,,0,Lisboa e Vale do Tejo,LEIRIA,1011,8243.43,14165,967,903,670,420,396,816,1486,2389,3356,171.84,40.71,28.98,18.03
09-06-2021,NELAS,4,0,31,"[0,120]",Baixo a Moderado,,,,4,Centro,VISEU,1809,12571.48,12974,924,787,668,604,583,1187,1855,2642,3566,103.21,28.37,21.02,14.76
09-06-2021,NISA,2,0,33,"[0,120]",Baixo a Moderado,,,,2,Alentejo,PORTALEGRE,1212,57567.84,6061,405,389,355,483,478,961,1316,1705,2110,10.53,3.67,2.96,2.29
09-06-2021,NORDESTE,2,0,41,"[0,120]",Baixo a Moderado,,,,2,Açores,AÇORES,4202,10146.8,4862,246,180,124,161,162,323,447,627,873,47.92,8.6,6.18,4.41
09-06-2021,ÓBIDOS,1,0,8,"[0,120]",Baixo a Moderado,,,,1,Lisboa e Vale do Tejo,LEIRIA,1012,14155.44,11850,743,650,574,452,436,888,1462,2112,2855,83.72,20.17,14.92,10.33
09-06-2021,ODEMIRA,118,8,477,"[240,480]",Elevado,,,,118,Alentejo,BEJA,0211,172060.15,24717,1475,1317,1225,1397,1349,2746,3971,5288,6763,14.37,3.93,3.07,2.31
09-06-2021,ODIVELAS,191,14,118,"[0,120]",Baixo a Moderado,,,,191,Lisboa e Vale do Tejo,LISBOA,1116,2654.36,161774,9562,9038,6952,4641,3812,8453,15405,24443,34005,6095.48,1281.27,920.99,580.44
09-06-2021,OEIRAS,170,12,96,"[0,120]",Baixo a Moderado,,,,170,Lisboa e Vale do Tejo,LISBOA,1110,4588.31,177408,11580,11575,8566,6211,5855,12066,20632,32207,43787,3866.78,954.38,701.98,449.69
09-06-2021,OLEIROS,1,0,20,"[0,120]",Baixo a Moderado,,,,1,Centro,CASTELO BRANCO,0506,47109.31,5003,384,341,366,397,487,884,1250,1591,1975,10.62,4.19,3.38,2.65
09-06-2021,OLHÃO,16,1,36,"[0,120]",Baixo a Moderado,,,,16,Algarve,FARO,0810,13086.38,44405,2455,2309,1689,1342,1268,2610,4299,6608,9063,339.33,69.26,50.5,32.85
09-06-2021,OLIVEIRA DE AZEMÉIS,16,1,24,"[0,120]",Baixo a Moderado,,,,16,Norte,AVEIRO,0113,16110.41,66011,4155,3614,2794,2183,1738,3921,6715,10329,14484,409.75,89.91,64.12,41.68
09-06-2021,OLIVEIRA DE FRADES,10,1,101,"[0,120]",Baixo a Moderado,,,,10,Centro,VISEU,1810,14534.62,9936,553,475,438,359,415,774,1212,1687,2240,68.36,15.41,11.61,8.34
09-06-2021,OLIVEIRA DO BAIRRO,7,1,29,"[0,120]",Baixo a Moderado,,,,7,Centro,AVEIRO,0114,8731.99,24277,1327,1182,999,786,810,1596,2595,3777,5104,278.02,58.45,43.25,29.72
09-06-2021,OLIVEIRA DO HOSPITAL,6,0,31,"[0,120]",Baixo a Moderado,,,,6,Centro,COIMBRA,0611,23451.66,19253,1161,1097,962,924,960,1884,2846,3943,5104,82.1,21.76,16.81,12.14
09-06-2021,OURÉM,10,1,23,"[0,120]",Baixo a Moderado,,,,10,Lisboa e Vale do Tejo,SANTARÉM,1421,41668.03,44044,2463,2069,1899,1817,1603,3420,5319,7388,9851,105.7,23.64,17.73,12.77
09-06-2021,OURIQUE,1,0,22,"[0,120]",Baixo a Moderado,,,,1,Alentejo,BEJA,0212,66331.36,4607,313,287,284,268,227,495,779,1066,1379,6.95,2.08,1.61,1.17
09-06-2021,OVAR,31,2,57,"[0,120]",Baixo a Moderado,,,,31,Centro,AVEIRO,0115,14770.25,54260,3294,2709,1994,1636,1234,2870,4864,7573,10867,367.37,73.57,51.27,32.93
09-06-2021,PAÇOS DE FERREIRA,40,3,71,"[0,120]",Baixo a Moderado,,,,40,Norte,PORTO,1309,7099.29,56728,2903,2193,1518,1135,664,1799,3317,5510,8413,799.1,118.51,77.62,46.72
09-06-2021,PALMELA,66,5,103,"[0,120]",Baixo a Moderado,,,,66,Lisboa e Vale do Tejo,SETÚBAL,1508,46512.01,64269,3402,3244,2635,1846,1391,3237,5872,9116,12518,138.18,26.91,19.6,12.62
09-06-2021,PAMPILHOSA DA SERRA,1,0,25,"[0,120]",Baixo a Moderado,,,,1,Centro,COIMBRA,0612,39646.24,4037,238,254,295,339,423,762,1057,1311,1549,10.18,3.91,3.31,2.67
09-06-2021,PAREDES,28,2,33,"[0,120]",Baixo a Moderado,,,,28,Norte,PORTO,1310,15675.69,86067,4272,3532,2412,1717,1258,2975,5387,8919,13191,549.04,84.15,56.9,34.36
09-06-2021,PAREDES DE COURA,27,2,316,"[240,480]",Elevado,,,,27,Norte,VIANA DO CASTELO,1605,13818.59,8535,466,528,407,465,515,980,1387,1915,2381,61.76,17.23,13.86,10.04
09-06-2021,PEDRÓGÃO GRANDE,0,0,0,"[0,120]",Baixo a Moderado,,,,0,Centro,LEIRIA,1013,12874.75,3410,175,173,196,221,252,473,669,842,1017,26.49,7.9,6.54,5.2
09-06-2021,PENACOVA,9,1,66,"[0,120]",Baixo a Moderado,,,,9,Centro,COIMBRA,0613,21673.23,13694,968,923,745,621,703,1324,2069,2992,3960,63.18,18.27,13.81,9.55
09-06-2021,PENAFIEL,44,3,63,"[0,120]",Baixo a Moderado,,,,44,Norte,PORTO,1311,21224.27,69772,3648,2823,2032,1663,1230,2893,4925,7748,11396,328.74,53.69,36.51,23.2
09-06-2021,PENALVA DO CASTELO,0,0,0,"[0,120]",Baixo a Moderado,,,,0,Centro,VISEU,1811,13433.92,7115,449,457,413,391,426,817,1230,1687,2136,52.96,15.9,12.56,9.16
09-06-2021,PENAMACOR,1,0,21,"[0,120]",Baixo a Moderado,,,,1,Centro,CASTELO BRANCO,0507,56370.69,4755,262,248,273,451,633,1084,1357,1605,1867,8.44,3.31,2.85,2.41
09-06-2021,PENEDONO,0,0,0,"[0,120]",Baixo a Moderado,,,,0,Norte,VISEU,1812,13370.75,2591,172,113,129,156,138,294,423,536,708,19.38,5.3,4.01,3.16
09-06-2021,PENELA,1,0,19,"[0,120]",Baixo a Moderado,,,,1,Centro,COIMBRA,0614,13480.0,5397,314,324,274,359,344,703,977,1301,1615,40.04,11.98,9.65,7.25
09-06-2021,PENICHE,8,1,30,"[0,120]",Baixo a Moderado,,,,8,Lisboa e Vale do Tejo,LEIRIA,1014,7754.98,26501,1746,1504,1203,926,707,1633,2836,4340,6086,341.73,78.48,55.96,36.57
09-06-2021,PESO DA RÉGUA,1,0,6,"[0,120]",Baixo a Moderado,,,,1,Norte,VILA REAL,1708,9486.01,15773,1076,843,650,659,455,1114,1764,2607,3683,166.28,38.83,27.48,18.6
09-06-2021,PINHEL,2,0,23,"[0,120]",Baixo a Moderado,,,,2,Centro,GUARDA,0910,48452.12,8511,577,566,551,538,689,1227,1778,2344,2921,17.57,6.03,4.84,3.67
09-06-2021,POMBAL,29,2,56,"[0,120]",Baixo a Moderado,,,,29,Centro,LEIRIA,1015,62600.28,51461,3187,2791,2494,2328,2027,4355,6849,9640,12827,82.21,20.49,15.4,10.94
09-06-2021,PONTA DELGADA,127,9,187,"[120,240]",Moderado,,,,127,Açores,AÇORES,4203,23298.65,67935,3108,2435,1726,1133,902,2035,3761,6196,9304,291.58,39.93,26.59,16.14
09-06-2021,PONTA DO SOL,4,0,47,"[0,120]",Baixo a Moderado,,,,4,Madeira,MADEIRA,3105,4622.03,8593,319,283,347,208,221,429,776,1059,1378,185.92,29.81,22.91,16.79
09-06-2021,PONTE DA BARCA,10,1,89,"[0,120]",Baixo a Moderado,,,,10,Norte,VIANA DO CASTELO,1606,18211.37,11180,635,576,517,554,490,1044,1561,2137,2772,61.39,15.22,11.73,8.57
09-06-2021,PONTE DE LIMA,36,3,87,"[0,120]",Baixo a Moderado,,,,36,Norte,VIANA DO CASTELO,1607,32025.46,41315,2321,2022,1720,1596,1462,3058,4778,6800,9121,129.01,28.48,21.23,14.92
09-06-2021,PONTE DE SOR,3,0,20,"[0,120]",Baixo a Moderado,,,,3,Alentejo,PORTALEGRE,1213,83971.16,14994,939,800,716,739,831,1570,2286,3086,4025,17.86,4.79,3.68,2.72
09-06-2021,PORTALEGRE,17,1,77,"[0,120]",Baixo a Moderado,,,,17,Alentejo,PORTALEGRE,1214,44713.64,22172,1577,1351,1137,993,984,1977,3114,4465,6042,49.59,13.51,9.99,6.96
09-06-2021,PORTEL,1,0,17,"[0,120]",Baixo a Moderado,,,,1,Alentejo,ÉVORA,0709,60100.57,5828,336,358,283,331,305,636,919,1277,1613,9.7,2.68,2.12,1.53
09-06-2021,PORTIMÃO,31,2,56,"[0,120]",Baixo a Moderado,,,,31,Algarve,FARO,0811,18206.29,55483,3182,2927,2116,1582,1400,2982,5098,8025,11207,304.75,61.56,44.08,28.0
09-06-2021,PORTO,165,12,76,"[0,120]",Baixo a Moderado,,,,165,Norte,PORTO,1312,4142.02,216606,15790,15193,11280,9409,10044,19453,30733,45926,61716,5229.5,1490.0,1108.79,741.98
09-06-2021,PORTO DE MÓS,4,0,17,"[0,120]",Baixo a Moderado,,,,4,Centro,LEIRIA,1016,26183.41,23275,1355,1210,1034,888,872,1760,2794,4004,5359,88.89,20.47,15.29,10.67
09-06-2021,PORTO MONIZ,0,0,0,"[0,120]",Baixo a Moderado,,,,0,Madeira,MADEIRA,3106,8293.38,2342,143,130,95,98,120,218,313,443,586,28.24,7.07,5.34,3.77
09-06-2021,PORTO SANTO,0,0,0,"[0,120]",Baixo a Moderado,,,,0,Madeira,MADEIRA,3201,4300.7,5202,240,157,134,110,68,178,312,469,709,120.95,16.48,10.9,7.25
09-06-2021,PÓVOA DE LANHOSO,18,1,84,"[0,120]",Baixo a Moderado,,,,18,Norte,BRAGA,0309,13465.29,21499,1175,909,732,673,624,1297,2029,2938,4113,159.67,30.55,21.82,15.07
09-06-2021,PÓVOA DE VARZIM,20,1,32,"[0,120]",Baixo a Moderado,,,,20,Norte,PORTO,1313,8220.59,62784,3712,3120,2134,1594,1305,2899,5033,8153,11865,763.7,144.33,99.17,61.22
09-06-2021,POVOAÇÃO,1,0,17,"[0,120]",Baixo a Moderado,,,,1,Açores,AÇORES,4204,10640.77,5927,293,212,191,144,134,278,469,681,974,55.7,9.15,6.4,4.41
09-06-2021,VILA DA PRAIA DA VITÓRIA,0,0,0,"[0,120]",Baixo a Moderado,,,,0,Açores,AÇORES,4302,16127.06,21317,1133,789,619,436,336,772,1391,2180,3313,132.18,20.54,13.52,8.63
09-06-2021,PROENÇA-A-NOVA,1,0,14,"[0,120]",Baixo a Moderado,,,,1,Centro,CASTELO BRANCO,0508,39539.96,7298,508,465,389,400,560,960,1349,1814,2322,18.46,5.87,4.59,3.41
09-06-2021,REDONDO,0,0,0,"[0,120]",Baixo a Moderado,,,,0,Alentejo,ÉVORA,0710,36950.87,6353,349,325,288,288,354,642,930,1255,1604,17.19,4.34,3.4,2.52
09-06-2021,REGUENGOS DE MONSARAZ,1,0,10,"[0,120]",Baixo a Moderado,,,,1,Alentejo,ÉVORA,0711,46399.72,10015,602,511,455,462,473,935,1390,1901,2503,21.58,5.39,4.1,3.0
09-06-2021,RESENDE,1,0,10,"[0,120]",Baixo a Moderado,,,,1,Norte,VISEU,1813,12334.93,10137,560,493,448,433,422,855,1303,1796,2356,82.18,19.1,14.56,10.56
09-06-2021,RIBEIRA BRAVA,3,0,24,"[0,120]",Baixo a Moderado,,,,3,Madeira,MADEIRA,3107,6544.88,12435,648,500,411,311,287,598,1009,1509,2157,189.99,32.96,23.06,15.42
09-06-2021,RIBEIRA DE PENA,0,0,0,"[0,120]",Baixo a Moderado,,,,0,Norte,VILA REAL,1709,21745.98,6016,371,301,290,310,368,678,968,1269,1640,27.66,7.54,5.84,4.45
09-06-2021,RIBEIRA GRANDE,172,12,524,"[480,960]",Muito Elevado,,,,172,Açores,AÇORES,4205,18015.13,32811,1163,689,512,345,253,598,1110,1799,2962,182.13,16.44,9.99,6.16
09-06-2021,RIO MAIOR,6,0,29,"[0,120]",Baixo a Moderado,,,,6,Lisboa e Vale do Tejo,SANTARÉM,1414,27276.45,20379,1251,1144,941,795,648,1443,2384,3528,4779,74.71,17.52,12.93,8.74
09-06-2021,SABROSA,1,0,17,"[0,120]",Baixo a Moderado,,,,1,Norte,VILA REAL,1710,15692.45,5918,393,314,304,302,350,652,956,1270,1663,37.71,10.6,8.09,6.09
09-06-2021,SABUGAL,1,0,9,"[0,120]",Baixo a Moderado,,,,1,Centro,GUARDA,0911,82269.82,10585,724,707,694,796,1009,1805,2499,3206,3930,12.87,4.78,3.9,3.04
09-06-2021,SALVATERRA DE MAGOS,17,1,80,"[0,120]",Baixo a Moderado,,,,17,Lisboa e Vale do Tejo,SANTARÉM,1415,24393.2,21295,1275,1181,1060,799,772,1571,2631,3812,5087,87.3,20.85,15.63,10.79
09-06-2021,SANTA COMBA DÃO,0,0,0,"[0,120]",Baixo a Moderado,,,,0,Centro,VISEU,1814,11194.77,10452,732,684,569,538,464,1002,1571,2255,2987,93.36,26.68,20.14,14.03
09-06-2021,SANTA CRUZ,10,1,22,"[0,120]",Baixo a Moderado,,,,10,Madeira,MADEIRA,3108,8150.28,45281,1817,1301,974,716,523,1239,2213,3514,5331,555.6,65.41,43.12,27.15
09-06-2021,SANTA CRUZ DA GRACIOSA,0,0,0,"[0,120]",Baixo a Moderado,,,,0,Açores,AÇORES,4401,6065.78,4208,228,180,163,124,145,269,432,612,840,69.37,13.85,10.09,7.12
09-06-2021,SANTA CRUZ DAS FLORES,0,0,0,"[0,120]",Baixo a Moderado,,,,0,Açores,AÇORES,4802,7091.44,2165,125,98,74,56,51,107,181,279,404,30.53,5.7,3.93,2.55
09-06-2021,SANTA MARIA DA FEIRA,91,7,66,"[0,120]",Baixo a Moderado,,,,91,Norte,AVEIRO,0109,21587.65,138636,8182,6743,4771,3856,3079,6935,11706,18449,26631,642.19,123.36,85.46,54.22
09-06-2021,SANTA MARTA DE PENAGUIÃO,0,0,0,"[0,120]",Baixo a Moderado,,,,0,Norte,VILA REAL,1711,6928.13,6599,483,373,337,316,317,633,970,1343,1826,95.25,26.36,19.39,14.0
09-06-2021,SANTANA,4,0,60,"[0,120]",Baixo a Moderado,,,,4,Madeira,MADEIRA,3109,9547.3,6711,418,353,343,282,277,559,902,1255,1673,70.29,17.52,13.15,9.45
09-06-2021,SANTARÉM,82,6,143,"[120,240]",Moderado,,,,82,Lisboa e Vale do Tejo,SANTARÉM,1416,55253.58,57421,3654,3441,2760,2466,2206,4672,7432,10873,14527,103.92,26.29,19.68,13.45
09-06-2021,SANTIAGO DO CACÉM,3,0,10,"[0,120]",Baixo a Moderado,,,,3,Alentejo,SETÚBAL,1509,105969.29,28791,2144,1689,1472,1295,1215,2510,3982,5671,7815,27.17,7.37,5.35,3.76
09-06-2021,SANTO TIRSO,27,2,40,"[0,120]",Baixo a Moderado,,,,27,Norte,PORTO,1314,13655.52,68055,4911,3935,2761,2257,1810,4067,6828,10763,15674,498.35,114.78,78.82,50.0
09-06-2021,SÃO BRÁS DE ALPORTEL,4,0,38,"[0,120]",Baixo a Moderado,,,,4,Algarve,FARO,0812,15336.92,10416,596,468,467,404,401,805,1272,1740,2336,67.91,15.23,11.35,8.29
09-06-2021,SÃO JOÃO DA MADEIRA,16,1,73,"[0,120]",Baixo a Moderado,,,,16,Norte,AVEIRO,0116,794.3,21958,1347,1069,796,601,593,1194,1990,3059,4406,2765.49,554.91,385.26,250.63
09-06-2021,SÃO JOÃO DA PESQUEIRA,7,0,98,"[0,120]",Baixo a Moderado,,,,7,Norte,VISEU,1815,26610.85,7125,417,330,294,328,328,656,950,1280,1697,26.77,6.38,4.81,3.57
09-06-2021,SÃO PEDRO DO SUL,4,0,26,"[0,120]",Baixo a Moderado,,,,4,Centro,VISEU,1816,34895.09,15403,990,962,861,759,909,1668,2529,3491,4481,44.14,12.84,10.0,7.25
09-06-2021,SÃO ROQUE DO PICO,0,0,0,"[0,120]",Baixo a Moderado,,,,0,Açores,AÇORES,4603,14236.1,3266,199,141,93,96,113,209,302,443,642,22.94,4.51,3.11,2.12
09-06-2021,SÃO VICENTE,1,0,19,"[0,120]",Baixo a Moderado,,,,1,Madeira,MADEIRA,3110,7883.71,5143,272,264,266,225,280,505,771,1035,1307,65.23,16.58,13.13,9.78
09-06-2021,SARDOAL,1,0,27,"[0,120]",Baixo a Moderado,,,,1,Lisboa e Vale do Tejo,SANTARÉM,1417,9214.72,3741,227,178,148,165,248,413,561,739,966,40.6,10.48,8.02,6.09
09-06-2021,SÁTÃO,0,0,0,"[0,120]",Baixo a Moderado,,,,0,Centro,VISEU,1817,20194.11,11580,765,671,515,465,476,941,1456,2127,2892,57.34,14.32,10.53,7.21
09-06-2021,SEIA,11,1,49,"[0,120]",Baixo a Moderado,,,,11,Centro,GUARDA,0912,43568.83,22234,1807,1589,1238,1122,721,1843,3081,4670,6477,51.03,14.87,10.72,7.07
09-06-2021,SEIXAL,159,11,95,"[0,120]",Baixo a Moderado,,,,159,Lisboa e Vale do Tejo,SETÚBAL,1510,9545.17,167752,10586,9270,6661,4391,2930,7321,13982,23252,33838,1757.49,354.51,243.6,146.49
09-06-2021,SERNANCELHE,0,0,0,"[0,120]",Baixo a Moderado,,,,0,Norte,VISEU,1818,22861.22,5396,305,293,286,273,260,533,819,1112,1417,23.6,6.2,4.86,3.58
09-06-2021,SERPA,5,0,35,"[0,120]",Baixo a Moderado,,,,5,Alentejo,BEJA,0213,110563.34,14304,903,761,719,697,626,1323,2042,2803,3706,12.94,3.35,2.54,1.85
09-06-2021,SERTÃ,56,4,384,"[240,480]",Elevado,,,,56,Centro,CASTELO BRANCO,0509,44673.17,14577,870,779,790,767,1020,1787,2577,3356,4226,32.63,9.46,7.51,5.77
09-06-2021,SESIMBRA,135,10,260,"[240,480]",Elevado,,,,135,Lisboa e Vale do Tejo,SETÚBAL,1511,19571.75,51858,2400,2321,1853,1257,1083,2340,4193,6514,8914,264.96,45.54,33.28,21.42
09-06-2021,SETÚBAL,117,8,102,"[0,120]",Baixo a Moderado,,,,117,Lisboa e Vale do Tejo,SETÚBAL,1512,23032.5,115126,7425,6929,5075,3775,2655,6430,11505,18434,25859,499.83,112.27,80.03,49.95
09-06-2021,SEVER DO VOUGA,2,0,18,"[0,120]",Baixo a Moderado,,,,2,Centro,AVEIRO,0117,12987.56,11331,766,637,568,540,567,1107,1675,2312,3078,87.24,23.7,17.8,12.9
09-06-2021,SILVES,12,1,33,"[0,120]",Baixo a Moderado,,,,12,Algarve,FARO,0813,68006.23,36226,2137,1869,1610,1423,1600,3023,4633,6502,8639,53.27,12.7,9.56,6.81
09-06-2021,SINES,2,0,15,"[0,120]",Baixo a Moderado,,,,2,Alentejo,SETÚBAL,1513,20330.17,13715,888,791,551,416,268,684,1235,2026,2914,67.46,14.33,9.97,6.07
09-06-2021,SINTRA,517,37,132,"[120,240]",Moderado,,,,517,Lisboa e Vale do Tejo,LISBOA,1111,31922.73,391402,20490,18316,13545,9137,7284,16421,29966,48282,68772,1226.08,215.43,151.25,93.87
09-06-2021,SOBRAL DE MONTE AGRAÇO,4,0,38,"[0,120]",Baixo a Moderado,,,,4,Lisboa e Vale do Tejo,LISBOA,1112,5210.32,10651,564,507,352,272,212,484,836,1343,1907,204.43,36.6,25.78,16.05
09-06-2021,SOURE,16,1,93,"[0,120]",Baixo a Moderado,,,,16,Centro,COIMBRA,0615,26506.07,17120,1173,1142,1004,883,987,1870,2874,4016,5189,64.59,19.58,15.15,10.84
09-06-2021,SOUSEL,0,0,0,"[0,120]",Baixo a Moderado,,,,0,Alentejo,PORTALEGRE,1215,27932.18,4412,261,274,208,302,292,594,802,1076,1337,15.8,4.79,3.85,2.87
09-06-2021,TÁBUA,8,1,70,"[0,120]",Baixo a Moderado,,,,8,Centro,COIMBRA,0616,19978.58,11368,729,584,524,430,464,894,1418,2002,2731,56.9,13.67,10.02,7.1
09-06-2021,TABUAÇO,1,0,17,"[0,120]",Baixo a Moderado,,,,1,Norte,VISEU,1819,13385.67,6033,372,314,217,282,363,645,862,1176,1548,45.07,11.56,8.79,6.44
09-06-2021,TAROUCA,0,0,0,"[0,120]",Baixo a Moderado,,,,0,Norte,VISEU,1820,10008.49,7804,405,335,313,277,324,601,914,1249,1654,77.98,16.53,12.48,9.13
09-06-2021,TAVIRA,12,1,49,"[0,120]",Baixo a Moderado,,,,12,Algarve,FARO,0814,60696.7,24530,1493,1415,1252,1066,1277,2343,3595,5010,6503,40.41,10.71,8.25,5.92
09-06-2021,TERRAS DE BOURO,1,0,16,"[0,120]",Baixo a Moderado,,,,1,Norte,BRAGA,0310,27746.07,6361,391,372,296,319,340,659,955,1327,1718,22.93,6.19,4.78,3.44
09-06-2021,TOMAR,9,1,24,"[0,120]",Baixo a Moderado,,,,9,Lisboa e Vale do Tejo,SANTARÉM,1418,35120.44,36748,2403,2189,1868,1853,1822,3675,5543,7732,10135,104.64,28.86,22.02,15.78
09-06-2021,TONDELA,5,0,19,"[0,120]",Baixo a Moderado,,,,5,Centro,VISEU,1821,37121.73,26357,1768,1722,1518,1475,1417,2892,4410,6132,7900,71.0,21.28,16.52,11.88
09-06-2021,TORRE DE MONCORVO,0,0,0,"[0,120]",Baixo a Moderado,,,,0,Norte,BRAGANÇA,0409,53155.67,7695,556,478,488,551,719,1270,1758,2236,2792,14.48,5.25,4.21,3.31
09-06-2021,TORRES NOVAS,5,0,14,"[0,120]",Baixo a Moderado,,,,5,Lisboa e Vale do Tejo,SANTARÉM,1419,26999.68,34933,2324,1979,1738,1406,1475,2881,4619,6598,8922,129.38,33.04,24.44,17.11
09-06-2021,TORRES VEDRAS,54,4,69,"[0,120]",Baixo a Moderado,,,,54,Lisboa e Vale do Tejo,LISBOA,1113,40714.89,78530,4513,3945,3447,2628,2104,4732,8179,12124,16637,192.88,40.86,29.78,20.09
09-06-2021,TRANCOSO,0,0,0,"[0,120]",Baixo a Moderado,,,,0,Centro,GUARDA,0913,36152.47,8875,581,557,542,586,496,1082,1624,2181,2762,24.55,7.64,6.03,4.49
09-06-2021,TROFA,10,1,26,"[0,120]",Baixo a Moderado,,,,10,Norte,PORTO,1318,7201.76,38418,2336,1894,1231,939,684,1623,2854,4748,7084,533.44,98.36,65.93,39.63
09-06-2021,VAGOS,1,0,4,"[0,120]",Baixo a Moderado,,,,1,Centro,AVEIRO,0118,16491.5,22740,1320,1205,922,784,724,1508,2430,3635,4955,137.89,30.04,22.04,14.73
09-06-2021,VALE DE CAMBRA,29,2,136,"[120,240]",Moderado,,,,29,Norte,AVEIRO,0119,14733.47,21327,1491,1363,1005,831,798,1629,2634,3997,5488,144.76,37.25,27.13,17.88
09-06-2021,VALENÇA,2,0,15,"[0,120]",Baixo a Moderado,,,,2,Norte,VIANA DO CASTELO,1608,11712.86,13290,867,791,582,582,503,1085,1667,2458,3325,113.46,28.39,20.99,14.23
09-06-2021,VALONGO,44,3,45,"[0,120]",Baixo a Moderado,,,,44,Norte,PORTO,1315,7512.45,97444,5629,4696,3207,2462,1829,4291,7498,12194,17823,1297.18,237.26,162.33,99.81
09-06-2021,VALPAÇOS,6,0,40,"[0,120]",Baixo a Moderado,,,,6,Norte,VILA REAL,1712,54873.93,14818,1217,1118,999,928,997,1925,2924,4042,5259,27.0,9.58,7.37,5.33
09-06-2021,VELAS,0,0,0,"[0,120]",Baixo a Moderado,,,,0,Açores,AÇORES,4502,11738.38,5093,278,208,166,153,113,266,432,640,918,43.39,7.82,5.45,3.68
09-06-2021,VENDAS NOVAS,0,0,0,"[0,120]",Baixo a Moderado,,,,0,Alentejo,ÉVORA,0712,22238.88,11255,677,768,655,501,532,1033,1688,2456,3133,50.61,14.09,11.04,7.59
09-06-2021,VIANA DO ALENTEJO,4,0,78,"[0,120]",Baixo a Moderado,,,,4,Alentejo,ÉVORA,0713,39367.29,5145,245,208,235,210,214,424,659,867,1112,13.07,2.82,2.2,1.67
09-06-2021,VIANA DO CASTELO,31,2,37,"[0,120]",Baixo a Moderado,,,,31,Norte,VIANA DO CASTELO,1609,31902.01,84417,5470,4433,3591,3061,2982,6043,9634,14067,19537,264.61,61.24,44.09,30.2
09-06-2021,VIDIGUEIRA,0,0,0,"[0,120]",Baixo a Moderado,,,,0,Alentejo,BEJA,0214,31661.09,5510,300,248,215,233,275,508,723,971,1271,17.4,4.01,3.07,2.28
09-06-2021,VIEIRA DO MINHO,3,0,25,"[0,120]",Baixo a Moderado,,,,3,Norte,BRAGA,0311,21644.35,11842,703,594,525,548,482,1030,1555,2149,2852,54.71,13.18,9.93,7.18
09-06-2021,VILA DE REI,0,0,0,"[0,120]",Baixo a Moderado,,,,0,Centro,CASTELO BRANCO,0510,19154.6,3323,169,128,172,247,302,549,721,849,1018,17.35,5.31,4.43,3.76
09-06-2021,VILA DO BISPO,0,0,0,"[0,120]",Baixo a Moderado,,,,0,Algarve,FARO,0815,17906.06,5154,302,302,314,232,233,465,779,1081,1383,28.78,7.72,6.04,4.35
09-06-2021,VILA DO CONDE,58,4,73,"[0,120]",Baixo a Moderado,,,,58,Norte,PORTO,1316,14902.77,79899,4726,3875,2819,2070,1743,3813,6632,10507,15233,536.13,102.21,70.5,44.5
09-06-2021,VILA DO PORTO,0,0,0,"[0,120]",Baixo a Moderado,,,,0,Açores,AÇORES,4101,9688.74,5616,274,212,135,96,123,219,354,566,840,57.96,8.67,5.84,3.65
09-06-2021,VILA FLOR,2,0,33,"[0,120]",Baixo a Moderado,,,,2,Norte,BRAGANÇA,0410,26581.14,6044,429,362,422,294,331,625,1047,1409,1838,22.74,6.91,5.3,3.94
09-06-2021,VILA FRANCA DE XIRA,141,10,99,"[0,120]",Baixo a Moderado,,,,141,Lisboa e Vale do Tejo,LISBOA,1114,31819.39,141957,8501,6852,4869,3425,2472,5897,10766,17618,26119,446.14,82.09,55.37,33.84
09-06-2021,VILA FRANCA DO CAMPO,16,1,145,"[120,240]",Moderado,,,,16,Açores,AÇORES,4206,7796.82,11051,450,344,248,217,154,371,619,963,1413,141.73,18.12,12.35,7.94
09-06-2021,VILA NOVA DA BARQUINHA,3,0,40,"[0,120]",Baixo a Moderado,,,,3,Lisboa e Vale do Tejo,SANTARÉM,1420,4952.97,7461,415,406,392,364,338,702,1094,1500,1915,150.64,38.66,30.28,22.09
09-06-2021,VILA NOVA DE CERVEIRA,2,0,22,"[0,120]",Baixo a Moderado,,,,2,Norte,VIANA DO CASTELO,1610,10846.66,8910,531,444,410,384,334,718,1128,1572,2103,82.14,19.39,14.49,10.4
09-06-2021,VILA NOVA DE FAMALICÃO,53,4,40,"[0,120]",Baixo a Moderado,,,,53,Norte,BRAGA,0312,20159.26,131676,7817,6164,4202,3282,2749,6031,10233,16397,24214,653.19,120.12,81.34,50.76
09-06-2021,VILA NOVA DE FOZ CÔA,3,0,46,"[0,120]",Baixo a Moderado,,,,3,Centro,GUARDA,0914,39815.18,6503,442,385,390,398,429,827,1217,1602,2044,16.33,5.13,4.02,3.06
09-06-2021,VILA NOVA DE GAIA,156,11,52,"[0,120]",Baixo a Moderado,,,,156,Norte,PORTO,1317,16846.43,300472,18349,15568,10972,8224,6281,14505,25477,41045,59394,1783.64,352.57,243.65,151.23
09-06-2021,VILA NOVA DE PAIVA,5,0,107,"[0,120]",Baixo a Moderado,,,,5,Centro,VISEU,1822,17553.28,4687,289,272,233,217,241,458,691,963,1252,26.7,7.13,5.49,3.94
09-06-2021,VILA NOVA DE POIARES,2,0,29,"[0,120]",Baixo a Moderado,,,,2,Centro,COIMBRA,0617,8445.3,6939,380,284,262,235,182,417,679,963,1343,82.17,15.9,11.4,8.04
09-06-2021,VILA POUCA DE AGUIAR,2,0,17,"[0,120]",Baixo a Moderado,,,,2,Norte,VILA REAL,1713,43706.62,11961,860,817,733,601,627,1228,1961,2778,3638,27.37,8.32,6.36,4.49
09-06-2021,VILA REAL,30,2,60,"[0,120]",Baixo a Moderado,,,,30,Norte,VILA REAL,1714,37880.28,49962,3025,2498,2065,1579,1466,3045,5110,7608,10633,131.9,28.07,20.08,13.49
09-06-2021,VILA REAL DE SANTO ANTÓNIO,8,1,43,"[0,120]",Baixo a Moderado,,,,8,Algarve,FARO,0816,6125.0,18749,1172,1069,811,569,586,1155,1966,3035,4207,306.11,68.69,49.55,32.1
09-06-2021,VILA VELHA DE RÓDÃO,0,0,0,"[0,120]",Baixo a Moderado,,,,0,Centro,CASTELO BRANCO,0511,32991.16,3144,209,229,180,283,306,589,769,998,1207,9.53,3.66,3.03,2.33
09-06-2021,VILA VERDE,60,4,128,"[120,240]",Moderado,,,,60,Norte,BRAGA,0313,22866.52,46911,2365,2063,1667,1494,1437,2931,4598,6661,9026,205.15,39.47,29.13,20.11
09-06-2021,VILA VIÇOSA,4,0,52,"[0,120]",Baixo a Moderado,,,,4,Alentejo,ÉVORA,0714,19485.89,7656,487,379,342,345,324,669,1011,1390,1877,39.29,9.63,7.13,5.19
09-06-2021,VIMIOSO,5,0,124,"[120,240]",Moderado,,,,5,Norte,BRAGANÇA,0411,48158.51,4023,274,230,261,293,335,628,889,1119,1393,8.35,2.89,2.32,1.85
09-06-2021,VINHAIS,2,0,26,"[0,120]",Baixo a Moderado,,,,2,Norte,BRAGANÇA,0412,69475.09,7746,599,577,636,641,815,1456,2092,2669,3268,11.15,4.7,3.84,3.01
09-06-2021,VISEU,60,4,62,"[0,120]",Baixo a Moderado,,,,60,Centro,VISEU,1823,50710.14,97249,5769,5038,4140,3158,2710,5868,10008,15046,20815,191.77,41.05,29.67,19.74
09-06-2021,VIZELA,4,0,17,"[0,120]",Baixo a Moderado,,,,4,Norte,BRAGA,0314,2469.83,23897,1258,928,655,509,371,880,1535,2463,3721,967.49,150.65,99.72,62.15
09-06-2021,VOUZELA,2,0,21,"[0,120]",Baixo a Moderado,,,,2,Centro,VISEU,1824,19369.46,9619,626,605,554,532,507,1039,1593,2198,2824,49.66,14.58,11.35,8.22
16-06-2021,ABRANTES,38,3,108,"[0,120]",Baixo a Moderado,,,,38,Lisboa e Vale do Tejo,SANTARÉM,1401,71469.08,35130,2473,2213,1730,1748,2021,3769,5499,7712,10185,49.15,14.25,10.79,7.69
16-06-2021,ÁGUEDA,56,4,122,"[120,240]",Moderado,,,,56,Centro,AVEIRO,0101,33527.44,46075,3237,2713,2090,1635,1496,3131,5221,7934,11171,137.43,33.32,23.66,15.57
16-06-2021,AGUIAR DA BEIRA,1,0,21,"[0,120]",Baixo a Moderado,,,,1,Centro,GUARDA,0901,20676.57,4652,304,281,235,239,148,387,622,903,1207,22.5,5.84,4.37,3.01
16-06-2021,ALANDROAL,1,0,20,"[0,120]",Baixo a Moderado,,,,1,Alentejo,ÉVORA,0701,54267.81,4992,307,256,296,299,377,676,972,1228,1535,9.2,2.83,2.26,1.79
16-06-2021,ALBERGARIA-A-VELHA,4,0,17,"[0,120]",Baixo a Moderado,,,,4,Centro,AVEIRO,0102,15882.5,24144,1550,1298,996,687,680,1367,2363,3661,5211,152.02,32.81,23.05,14.88
16-06-2021,ALBUFEIRA,110,8,265,"[240,480]",Elevado,,,,110,Algarve,FARO,0801,14066.42,41528,2067,1717,1425,985,858,1843,3268,4985,7052,295.24,50.14,35.44,23.23
16-06-2021,ALCÁCER DO SAL,6,0,51,"[0,120]",Baixo a Moderado,,,,6,Alentejo,SETÚBAL,1501,149987.3,11659,884,814,623,623,602,1225,1848,2662,3546,7.77,2.36,1.77,1.23
16-06-2021,ALCANENA,5,0,39,"[0,120]",Baixo a Moderado,,,,5,Lisboa e Vale do Tejo,SANTARÉM,1402,12732.86,12809,891,744,628,536,588,1124,1752,2496,3387,100.6,26.6,19.6,13.76
16-06-2021,ALCOBAÇA,25,2,47,"[0,120]",Baixo a Moderado,,,,25,Lisboa e Vale do Tejo,LEIRIA,1001,40814.09,53555,3420,2927,2466,2059,1676,3735,6201,9128,12548,131.22,30.74,22.36,15.19
16-06-2021,ALCOCHETE,29,2,147,"[120,240]",Moderado,,,,29,Lisboa e Vale do Tejo,SETÚBAL,1502,12836.48,19787,857,834,691,476,447,923,1614,2448,3305,154.15,25.75,19.07,12.57
16-06-2021,ALCOUTIM,0,0,0,"[0,120]",Baixo a Moderado,,,,0,Algarve,FARO,0802,57536.33,2159,191,188,163,190,267,457,620,808,999,3.75,1.74,1.4,1.08
16-06-2021,ALENQUER,46,3,104,"[0,120]",Baixo a Moderado,,,,46,Lisboa e Vale do Tejo,LISBOA,1101,30421.92,44052,2298,2062,1629,1330,1155,2485,4114,6176,8474,144.8,27.85,20.3,13.52
16-06-2021,ALFÂNDEGA DA FÉ,0,0,0,"[0,120]",Baixo a Moderado,,,,0,Norte,BRAGANÇA,0401,32194.64,4550,325,277,301,274,325,599,900,1177,1502,14.13,4.67,3.66,2.8
16-06-2021,ALIJÓ,1,0,9,"[0,120]",Baixo a Moderado,,,,1,Norte,VILA REAL,1701,29759.89,10625,766,687,635,542,666,1208,1843,2530,3296,35.7,11.08,8.5,6.19
16-06-2021,ALJEZUR,3,0,54,"[0,120]",Baixo a Moderado,,,,3,Algarve,FARO,0803,32349.95,5594,316,336,335,320,410,730,1065,1401,1717,17.29,5.31,4.33,3.29
16-06-2021,ALJUSTREL,1,0,12,"[0,120]",Baixo a Moderado,,,,1,Alentejo,BEJA,0201,45847.41,8247,635,521,443,347,358,705,1148,1669,2304,17.99,5.03,3.64,2.5
16-06-2021,ALMADA,281,20,166,"[120,240]",Moderado,,,,281,Lisboa e Vale do Tejo,SETÚBAL,1503,7000.89,169039,10469,9777,7876,6144,5111,11255,19131,28908,39377,2414.5,562.45,412.91,273.26
16-06-2021,ALMEIDA,1,0,17,"[0,120]",Baixo a Moderado,,,,1,Centro,GUARDA,0902,51798.46,5830,441,419,396,458,393,851,1247,1666,2107,11.26,4.07,3.22,2.41
16-06-2021,ALMEIRIM,14,1,62,"[0,120]",Baixo a Moderado,,,,14,Lisboa e Vale do Tejo,SANTARÉM,1403,22212.05,22546,1342,1353,1106,866,843,1709,2815,4168,5510,101.5,24.81,18.76,12.67
16-06-2021,ALMODÔVAR,0,0,0,"[0,120]",Baixo a Moderado,,,,0,Alentejo,BEJA,0202,77788.03,6725,414,443,396,373,328,701,1097,1540,1954,8.65,2.51,1.98,1.41
16-06-2021,ALPIARÇA,7,0,99,"[0,120]",Baixo a Moderado,,,,7,Lisboa e Vale do Tejo,SANTARÉM,1404,9536.33,7059,515,486,363,333,274,607,970,1456,1971,74.02,20.67,15.27,10.17
16-06-2021,ALTER DO CHÃO,0,0,0,"[0,120]",Baixo a Moderado,,,,0,Alentejo,PORTALEGRE,1201,36206.62,3165,201,163,136,208,187,395,531,694,895,8.74,2.47,1.92,1.47
16-06-2021,ALVAIÁZERE,2,0,30,"[0,120]",Baixo a Moderado,,,,2,Centro,LEIRIA,1002,16047.76,6597,419,389,346,406,539,945,1291,1680,2099,41.11,13.08,10.47,8.04
16-06-2021,ALVITO,1,0,40,"[0,120]",Baixo a Moderado,,,,1,Alentejo,BEJA,0203,26485.32,2477,145,110,105,111,89,200,305,415,560,9.35,2.11,1.57,1.15
16-06-2021,AMADORA,293,21,159,"[120,240]",Moderado,,,,293,Lisboa e Vale do Tejo,LISBOA,1115,2378.47,184106,11186,10936,8780,6460,5890,12350,21130,32066,43252,7742.05,1818.84,1348.44,888.56
16-06-2021,AMARANTE,28,2,53,"[0,120]",Baixo a Moderado,,,,28,Norte,PORTO,1301,30133.15,53193,3086,2413,1812,1643,1311,2954,4766,7179,10265,176.53,34.07,23.82,15.82
16-06-2021,AMARES,6,0,33,"[0,120]",Baixo a Moderado,,,,6,Norte,BRAGA,0301,8195.41,18129,1001,829,622,489,524,1013,1635,2464,3465,221.22,42.28,30.07,19.95
16-06-2021,ANADIA,13,1,48,"[0,120]",Baixo a Moderado,,,,13,Centro,AVEIRO,0103,21663.48,27258,1931,1698,1376,1208,1262,2470,3846,5544,7475,125.83,34.51,25.59,17.75
16-06-2021,ANGRA DO HEROÍSMO,8,1,24,"[0,120]",Baixo a Moderado,,,,8,Açores,AÇORES,4301,23899.66,33807,2006,1473,1122,768,635,1403,2525,3998,6004,141.45,25.12,16.73,10.56
16-06-2021,ANSIÃO,6,0,50,"[0,120]",Baixo a Moderado,,,,6,Centro,LEIRIA,1003,17609.42,12039,727,709,646,694,530,1224,1870,2579,3306,68.37,18.77,14.65,10.62
16-06-2021,ARCOS DE VALDEVEZ,7,0,33,"[0,120]",Baixo a Moderado,,,,7,Norte,VIANA DO CASTELO,1601,44759.64,20926,1329,1338,1282,1343,1515,2858,4140,5478,6807,46.75,15.21,12.24,9.25
16-06-2021,ARGANIL,3,0,27,"[0,120]",Baixo a Moderado,,,,3,Centro,COIMBRA,0601,33283.93,11014,672,648,612,559,596,1155,1767,2415,3087,33.09,9.27,7.26,5.31
16-06-2021,ARMAMAR,0,0,0,"[0,120]",Baixo a Moderado,,,,0,Norte,VISEU,1801,11723.73,5769,357,305,309,285,310,595,904,1209,1566,49.21,13.36,10.31,7.71
16-06-2021,AROUCA,12,1,58,"[0,120]",Baixo a Moderado,,,,12,Norte,AVEIRO,0104,32910.52,20720,1306,1047,753,683,683,1366,2119,3166,4472,62.96,13.59,9.62,6.44
16-06-2021,ARRAIOLOS,2,0,29,"[0,120]",Baixo a Moderado,,,,2,Alentejo,ÉVORA,0702,68374.55,6928,435,384,283,367,480,847,1130,1514,1949,10.13,2.85,2.21,1.65
16-06-2021,ARRONCHES,1,0,35,"[0,120]",Baixo a Moderado,,,,1,Alentejo,PORTALEGRE,1202,31464.72,2820,155,142,162,187,179,366,528,670,825,8.96,2.62,2.13,1.68
16-06-2021,ARRUDA DOS VINHOS,35,2,227,"[120,240]",Moderado,,,,35,Lisboa e Vale do Tejo,LISBOA,1102,7795.93,15412,738,738,562,509,438,947,1509,2247,2985,197.69,38.29,28.82,19.36
16-06-2021,AVEIRO,54,4,69,"[0,120]",Baixo a Moderado,,,,54,Centro,AVEIRO,0105,19757.57,78734,4520,4004,3050,2250,2103,4353,7403,11407,15927,398.49,80.61,57.73,37.47
16-06-2021,AVIS,1,0,24,"[0,120]",Baixo a Moderado,,,,1,Alentejo,PORTALEGRE,1203,60596.51,4247,315,225,206,251,273,524,730,955,1270,7.01,2.1,1.58,1.2
16-06-2021,AZAMBUJA,12,1,53,"[0,120]",Baixo a Moderado,,,,12,Lisboa e Vale do Tejo,LISBOA,1103,26265.65,22716,1322,1171,1070,798,618,1416,2486,3657,4979,86.48,18.96,13.92,9.46
16-06-2021,BAIÃO,3,0,16,"[0,120]",Baixo a Moderado,,,,3,Norte,PORTO,1302,17452.83,18748,1070,862,714,686,725,1411,2125,2987,4057,107.42,23.25,17.11,12.18
16-06-2021,BARCELOS,82,6,71,"[0,120]",Baixo a Moderado,,,,82,Norte,BRAGA,0302,37890.14,116187,6721,5325,3619,2991,2562,5553,9172,14497,21218,306.64,56.0,38.26,24.21
16-06-2021,BARRANCOS,0,0,0,"[0,120]",Baixo a Moderado,,,,0,Alentejo,BEJA,0204,16841.73,1634,90,65,65,94,61,155,220,285,375,9.7,2.23,1.69,1.31
16-06-2021,BARREIRO,153,11,204,"[120,240]",Moderado,,,,153,Lisboa e Vale do Tejo,SETÚBAL,1504,3639.07,75147,5194,5565,4459,3105,1767,4872,9331,14896,20090,2065.05,552.07,409.34,256.42
16-06-2021,BATALHA,3,0,19,"[0,120]",Baixo a Moderado,,,,3,Centro,LEIRIA,1004,10341.6,15963,873,762,649,529,549,1078,1727,2489,3362,154.35,32.51,24.07,16.7
16-06-2021,BEJA,3,0,9,"[0,120]",Baixo a Moderado,,,,3,Alentejo,BEJA,0205,114647.55,33579,2005,1840,1386,1272,1039,2311,3697,5537,7542,29.29,6.58,4.83,3.22
16-06-2021,BELMONTE,0,0,0,"[0,120]",Baixo a Moderado,,,,0,Centro,CASTELO BRANCO,0501,11875.91,6398,444,321,325,310,355,665,990,1311,1755,53.87,14.78,11.04,8.34
16-06-2021,BENAVENTE,24,2,78,"[0,120]",Baixo a Moderado,,,,24,Lisboa e Vale do Tejo,SANTARÉM,1405,52138.39,30602,1468,1376,1141,876,643,1519,2660,4036,5504,58.69,10.56,7.74,5.1
16-06-2021,BOMBARRAL,4,0,32,"[0,120]",Baixo a Moderado,,,,4,Lisboa e Vale do Tejo,LEIRIA,1005,9128.55,12558,875,714,561,491,429,920,1481,2195,3070,137.56,33.63,24.04,16.22
16-06-2021,BORBA,4,0,59,"[0,120]",Baixo a Moderado,,,,4,Alentejo,ÉVORA,0703,14518.65,6736,430,375,279,436,392,828,1107,1482,1912,46.39,13.17,10.21,7.62
16-06-2021,BOTICAS,0,0,0,"[0,120]",Baixo a Moderado,,,,0,Norte,VILA REAL,1702,32195.66,4998,347,306,311,305,380,685,996,1302,1649,15.52,5.12,4.04,3.09
16-06-2021,BRAGA,311,22,170,"[120,240]",Moderado,,,,311,Norte,BRAGA,0303,18339.95,182679,10029,7963,5241,4320,3671,7991,13232,21195,31224,996.07,170.25,115.57,72.15
16-06-2021,BRAGANÇA,2,0,6,"[0,120]",Baixo a Moderado,,,,2,Norte,BRAGANÇA,0402,117357.27,33607,2402,1855,1652,1393,1163,2556,4208,6063,8465,28.64,7.21,5.17,3.59
16-06-2021,CABECEIRAS DE BASTO,2,0,13,"[0,120]",Baixo a Moderado,,,,2,Norte,BRAGA,0304,24182.16,15628,774,594,544,575,574,1149,1693,2287,3061,64.63,12.66,9.46,7.0
16-06-2021,CADAVAL,8,1,59,"[0,120]",Baixo a Moderado,,,,8,Lisboa e Vale do Tejo,LISBOA,1104,17489.3,13673,813,796,756,621,625,1246,2002,2798,3611,78.18,20.65,16.0,11.45
16-06-2021,CALDAS DA RAINHA,41,3,79,"[0,120]",Baixo a Moderado,,,,41,Lisboa e Vale do Tejo,LEIRIA,1006,25569.47,51912,3035,2684,2186,1899,1705,3604,5790,8474,11509,203.03,45.01,33.14,22.64
16-06-2021,CALHETA,1,0,9,"[0,120]",Baixo a Moderado,,,,1,Madeira,MADEIRA,3101,11150.43,10867,576,497,507,399,415,814,1321,1818,2394,97.46,21.47,16.3,11.85
16-06-2021,CALHETA (AÇORES),0,0,0,"[0,120]",Baixo a Moderado,,,,0,Açores,AÇORES,4501,12626.4,3184,215,159,141,139,122,261,402,561,776,25.22,6.15,4.44,3.18
16-06-2021,CÂMARA DE LOBOS,13,1,39,"[0,120]",Baixo a Moderado,,,,13,Madeira,MADEIRA,3102,5216.67,33675,1396,1059,834,545,381,926,1760,2819,4215,645.49,80.79,54.03,33.74
16-06-2021,CAMINHA,0,0,0,"[0,120]",Baixo a Moderado,,,,0,Norte,VIANA DO CASTELO,1602,13652.14,15877,1046,944,818,646,656,1302,2120,3064,4110,116.3,30.11,22.44,15.53
16-06-2021,CAMPO MAIOR,2,0,25,"[0,120]",Baixo a Moderado,,,,2,Alentejo,PORTALEGRE,1204,24720.16,7874,471,364,351,279,327,606,957,1321,1792,31.85,7.25,5.34,3.87
16-06-2021,CANTANHEDE,13,1,37,"[0,120]",Baixo a Moderado,,,,13,Centro,COIMBRA,0602,39088.02,35011,2346,2096,1880,1709,1451,3160,5040,7136,9482,89.57,24.26,18.26,12.89
16-06-2021,CARRAZEDA DE ANSIÃES,0,0,0,"[0,120]",Baixo a Moderado,,,,0,Norte,BRAGANÇA,0403,27924.09,5666,424,389,391,312,465,777,1168,1557,1981,20.29,7.09,5.58,4.18
16-06-2021,CARREGAL DO SAL,1,0,11,"[0,120]",Baixo a Moderado,,,,1,Centro,VISEU,1802,11689.21,9271,587,562,486,462,376,838,1324,1886,2473,79.31,21.16,16.13,11.33
16-06-2021,CARTAXO,21,1,88,"[0,120]",Baixo a Moderado,,,,21,Lisboa e Vale do Tejo,SANTARÉM,1406,15817.28,23843,1415,1376,1142,861,632,1493,2635,4011,5426,150.74,34.3,25.36,16.66
16-06-2021,CASCAIS,464,33,217,"[120,240]",Moderado,,,,464,Lisboa e Vale do Tejo,LISBOA,1105,9740.17,213608,12151,11444,8680,6469,5248,11717,20397,31841,43992,2193.1,451.66,326.91,209.41
16-06-2021,CASTANHEIRA DE PÊRA,1,0,38,"[0,120]",Baixo a Moderado,,,,1,Centro,LEIRIA,1007,6677.45,2614,233,195,157,190,187,377,534,729,962,39.15,14.41,10.92,8.0
16-06-2021,CASTELO BRANCO,11,1,21,"[0,120]",Baixo a Moderado,,,,11,Centro,CASTELO BRANCO,0502,143819.15,51987,3528,3042,2499,2229,2225,4454,6953,9995,13523,36.15,9.4,6.95,4.83
16-06-2021,CASTELO DE PAIVA,8,1,52,"[0,120]",Baixo a Moderado,,,,8,Norte,AVEIRO,0106,11500.53,15454,881,697,545,420,431,851,1396,2093,2974,134.37,25.86,18.2,12.14
16-06-2021,CASTELO DE VIDE,0,0,0,"[0,120]",Baixo a Moderado,,,,0,Alentejo,PORTALEGRE,1205,26491.24,2919,204,173,179,147,170,317,496,669,873,11.02,3.3,2.53,1.87
16-06-2021,CASTRO DAIRE,10,1,72,"[0,120]",Baixo a Moderado,,,,10,Centro,VISEU,1803,37904.13,13823,942,857,765,732,773,1505,2270,3127,4069,36.47,10.74,8.25,5.99
16-06-2021,CASTRO MARIM,2,0,32,"[0,120]",Baixo a Moderado,,,,2,Algarve,FARO,0804,30084.37,6237,370,345,334,322,344,666,1000,1345,1715,20.73,5.7,4.47,3.32
16-06-2021,CASTRO VERDE,0,0,0,"[0,120]",Baixo a Moderado,,,,0,Alentejo,BEJA,0206,56944.23,6949,437,347,303,275,227,502,805,1152,1589,12.2,2.79,2.02,1.41
16-06-2021,CELORICO DA BEIRA,0,0,0,"[0,120]",Baixo a Moderado,,,,0,Centro,GUARDA,0903,24721.63,6928,430,416,363,369,535,904,1267,1683,2113,28.02,8.55,6.81,5.12
16-06-2021,CELORICO DE BASTO,2,0,11,"[0,120]",Baixo a Moderado,,,,2,Norte,BRAGA,0305,18107.02,19040,1001,802,668,728,729,1457,2125,2927,3928,105.15,21.69,16.17,11.74
16-06-2021,CHAMUSCA,6,0,65,"[0,120]",Baixo a Moderado,,,,6,Lisboa e Vale do Tejo,SANTARÉM,1407,74600.54,9197,629,583,553,465,579,1044,1597,2180,2809,12.33,3.77,2.92,2.14
16-06-2021,CHAVES,19,1,48,"[0,120]",Baixo a Moderado,,,,19,Norte,VILA REAL,1703,59122.95,39343,2676,2429,1991,1886,1918,3804,5795,8224,10900,66.54,18.44,13.91,9.8
16-06-2021,CINFÃES,12,1,66,"[0,120]",Baixo a Moderado,,,,12,Norte,VISEU,1804,23928.76,18244,1067,902,779,734,758,1492,2271,3173,4240,76.24,17.72,13.26,9.49
16-06-2021,COIMBRA,71,5,53,"[0,120]",Baixo a Moderado,,,,71,Centro,COIMBRA,0603,31939.94,134166,9489,8734,6353,5139,5074,10213,16566,25300,34789,420.06,108.92,79.21,51.87
16-06-2021,CONDEIXA-A-NOVA,4,0,23,"[0,120]",Baixo a Moderado,,,,4,Centro,COIMBRA,0604,13867.47,17733,871,809,717,583,490,1073,1790,2599,3470,127.88,25.02,18.74,12.91
16-06-2021,CONSTÂNCIA,5,0,124,"[120,240]",Moderado,,,,5,Lisboa e Vale do Tejo,SANTARÉM,1408,8036.58,4030,211,183,187,148,155,303,490,673,884,50.14,11.0,8.37,6.1
16-06-2021,CORUCHE,8,1,46,"[0,120]",Baixo a Moderado,,,,8,Lisboa e Vale do Tejo,SANTARÉM,1409,111572.03,17471,1294,1090,1095,1096,1019,2115,3210,4300,5594,15.66,5.01,3.85,2.88
16-06-2021,CORVO,0,0,0,"[0,120]",Baixo a Moderado,,,,0,Açores,AÇORES,4901,1711.45,464,22,21,11,13,19,32,43,64,86,27.12,5.03,3.74,2.51
16-06-2021,COVILHÃ,7,1,15,"[0,120]",Baixo a Moderado,,,,7,Centro,CASTELO BRANCO,0503,55560.06,46787,3533,2998,2365,2111,2193,4304,6669,9667,13200,84.21,23.76,17.4,12.0
16-06-2021,CRATO,0,0,0,"[0,120]",Baixo a Moderado,,,,0,Alentejo,PORTALEGRE,1206,39806.88,3129,229,258,163,182,228,410,573,831,1060,7.86,2.66,2.09,1.44
16-06-2021,CUBA,2,0,44,"[0,120]",Baixo a Moderado,,,,2,Alentejo,BEJA,0207,17208.72,4595,255,233,206,190,143,333,539,772,1027,26.7,5.97,4.49,3.13
16-06-2021,ELVAS,4,0,19,"[0,120]",Baixo a Moderado,,,,4,Alentejo,PORTALEGRE,1207,63128.86,20528,1057,1145,902,852,810,1662,2564,3709,4766,32.52,7.55,5.88,4.06
16-06-2021,ENTRONCAMENTO,6,0,28,"[0,120]",Baixo a Moderado,,,,6,Lisboa e Vale do Tejo,SANTARÉM,1410,1372.81,21558,1066,930,868,695,592,1287,2155,3085,4151,1570.14,302.33,224.69,156.96
16-06-2021,ESPINHO,8,1,27,"[0,120]",Baixo a Moderado,,,,8,Norte,AVEIRO,0107,2105.68,29516,2205,1993,1430,1177,960,2137,3567,5560,7765,1401.52,368.71,264.01,169.37
16-06-2021,ESPOSENDE,25,2,73,"[0,120]",Baixo a Moderado,,,,25,Norte,BRAGA,0306,9540.98,34177,1831,1522,1095,894,723,1617,2712,4234,6065,358.21,63.57,44.38,28.42
16-06-2021,ESTARREJA,1,0,4,"[0,120]",Baixo a Moderado,,,,1,Centro,AVEIRO,0108,10817.33,26006,1503,1399,1106,953,728,1681,2787,4186,5689,240.42,52.59,38.7,25.76
16-06-2021,ESTREMOZ,2,0,16,"[0,120]",Baixo a Moderado,,,,2,Alentejo,ÉVORA,0704,51379.95,12728,789,613,697,786,877,1663,2360,2973,3762,24.77,7.32,5.79,4.59
16-06-2021,ÉVORA,19,1,36,"[0,120]",Baixo a Moderado,,,,19,Alentejo,ÉVORA,0705,130707.58,52428,3569,2852,2176,1966,1803,3769,5945,8797,12366,40.11,9.46,6.73,4.55
16-06-2021,FAFE,16,1,33,"[0,120]",Baixo a Moderado,,,,16,Norte,BRAGA,0307,21908.11,48060,3044,2455,1679,1403,1208,2611,4290,6745,9789,219.37,44.68,30.79,19.58
16-06-2021,FARO,70,5,115,"[0,120]",Baixo a Moderado,,,,70,Algarve,FARO,0805,20256.79,61015,3847,3364,2604,2055,1601,3656,6260,9624,13471,301.2,66.5,47.51,30.9
16-06-2021,FELGUEIRAS,24,2,43,"[0,120]",Baixo a Moderado,,,,24,Norte,PORTO,1303,11573.75,56422,2951,2302,1601,1316,973,2289,3890,6192,9143,487.49,79.0,53.5,33.61
16-06-2021,FERREIRA DO ALENTEJO,1,0,13,"[0,120]",Baixo a Moderado,,,,1,Alentejo,BEJA,0208,64820.68,7845,515,414,372,343,345,688,1060,1474,1989,12.1,3.07,2.27,1.64
16-06-2021,FERREIRA DO ZÊZERE,0,0,0,"[0,120]",Baixo a Moderado,,,,0,Lisboa e Vale do Tejo,SANTARÉM,1411,19038.03,7959,470,370,416,465,456,921,1337,1707,2177,41.81,11.44,8.97,7.02
16-06-2021,FIGUEIRA DA FOZ,37,3,63,"[0,120]",Baixo a Moderado,,,,37,Centro,COIMBRA,0605,37905.26,58747,4032,3597,2887,2495,2043,4538,7425,11022,15054,154.98,39.72,29.08,19.59
16-06-2021,FIGUEIRA DE CASTELO RODRIGO,1,0,18,"[0,120]",Baixo a Moderado,,,,1,Centro,GUARDA,0904,50857.46,5584,347,352,290,352,391,743,1033,1385,1732,10.98,3.41,2.72,2.03
16-06-2021,FIGUEIRÓ DOS VINHOS,4,0,72,"[0,120]",Baixo a Moderado,,,,4,Centro,LEIRIA,1008,17344.0,5568,402,386,322,309,351,660,982,1368,1770,32.1,10.21,7.89,5.66
16-06-2021,FORNOS DE ALGODRES,0,0,0,"[0,120]",Baixo a Moderado,,,,0,Centro,GUARDA,0905,13145.05,4528,261,218,247,256,232,488,735,953,1214,34.45,9.24,7.25,5.59
16-06-2021,FREIXO DE ESPADA À CINTA,0,0,0,"[0,120]",Baixo a Moderado,,,,0,Norte,BRAGANÇA,0404,24414.29,3298,211,177,231,196,189,385,616,793,1004,13.51,4.11,3.25,2.52
16-06-2021,FRONTEIRA,4,0,134,"[120,240]",Moderado,,,,4,Alentejo,PORTALEGRE,1208,24859.58,2974,213,182,149,156,168,324,473,655,868,11.96,3.49,2.63,1.9
16-06-2021,FUNCHAL,101,7,97,"[0,120]",Baixo a Moderado,,,,101,Madeira,MADEIRA,3103,7616.2,104024,6382,5086,3643,2821,1990,4811,8454,13540,19922,1365.86,261.58,177.78,111.0
16-06-2021,FUNDÃO,8,1,30,"[0,120]",Baixo a Moderado,,,,8,Centro,CASTELO BRANCO,0504,70019.79,26495,1781,1464,1432,1357,1643,3000,4432,5896,7677,37.84,10.96,8.42,6.33
16-06-2021,GAVIÃO,0,0,0,"[0,120]",Baixo a Moderado,,,,0,Alentejo,PORTALEGRE,1209,29459.45,3263,189,186,222,263,293,556,778,964,1153,11.08,3.91,3.27,2.64
16-06-2021,GÓIS,0,0,0,"[0,120]",Baixo a Moderado,,,,0,Centro,COIMBRA,0606,26330.19,3805,235,199,240,233,244,477,717,916,1151,14.45,4.37,3.48,2.72
16-06-2021,GOLEGÃ,0,0,0,"[0,120]",Baixo a Moderado,,,,0,Lisboa e Vale do Tejo,SANTARÉM,1412,8431.67,5339,356,299,281,243,255,498,779,1078,1434,63.32,17.01,12.78,9.24
16-06-2021,GONDOMAR,101,7,61,"[0,120]",Baixo a Moderado,,,,101,Norte,PORTO,1304,13191.76,165985,10555,8755,6222,4450,3364,7814,14036,22791,33346,1258.22,252.77,172.76,106.4
16-06-2021,GOUVEIA,0,0,0,"[0,120]",Baixo a Moderado,,,,0,Centro,GUARDA,0906,30061.17,12387,871,931,780,783,810,1593,2373,3304,4175,41.21,13.89,10.99,7.89
16-06-2021,GRÂNDOLA,37,3,253,"[240,480]",Elevado,,,,37,Alentejo,SETÚBAL,1505,82593.66,14639,834,834,708,688,672,1360,2068,2902,3736,17.72,4.52,3.51,2.5
16-06-2021,GUARDA,26,2,67,"[0,120]",Baixo a Moderado,,,,26,Centro,GUARDA,0907,71209.58,38969,2477,2041,1686,1415,1474,2889,4575,6616,9093,54.72,12.77,9.29,6.42
16-06-2021,GUIMARÃES,88,6,58,"[0,120]",Baixo a Moderado,,,,88,Norte,BRAGA,0308,24099.96,152309,9394,7074,4809,3877,2948,6825,11634,18708,28102,631.99,116.61,77.63,48.27
16-06-2021,HORTA,1,0,7,"[0,120]",Baixo a Moderado,,,,1,Açores,AÇORES,4701,17305.53,14521,818,658,468,352,302,654,1122,1780,2598,83.91,15.01,10.29,6.48
16-06-2021,IDANHA-A-NOVA,6,0,75,"[0,120]",Baixo a Moderado,,,,6,Centro,CASTELO BRANCO,0505,141633.51,8043,518,490,519,672,974,1646,2165,2655,3173,5.68,2.24,1.87,1.53
16-06-2021,ÍLHAVO,12,1,31,"[0,120]",Baixo a Moderado,,,,12,Centro,AVEIRO,0110,7347.55,38699,2227,1943,1444,1193,850,2043,3487,5430,7657,526.66,104.21,73.9,47.46
16-06-2021,LAGOA (FARO),18,1,79,"[0,120]",Baixo a Moderado,,,,18,Algarve,FARO,0806,8825.45,22762,1314,1168,919,749,670,1419,2338,3506,4820,257.93,54.62,39.73,26.49
16-06-2021,LAGOA,35,3,238,"[120,240]",Moderado,,,,35,Açores,AÇORES,4201,4559.32,14721,536,458,349,238,235,473,822,1280,1816,322.9,39.83,28.08,18.03
16-06-2021,LAGOS,47,3,155,"[120,240]",Moderado,,,,47,Algarve,FARO,0807,21299.27,30374,1744,1434,1247,1053,1029,2082,3329,4763,6507,142.61,30.55,22.36,15.63
16-06-2021,LAJES DAS FLORES,1,0,68,"[0,120]",Baixo a Moderado,,,,1,Açores,AÇORES,4801,7004.79,1463,88,53,62,46,54,100,162,215,303,20.89,4.33,3.07,2.31
16-06-2021,LAJES DO PICO,0,0,0,"[0,120]",Baixo a Moderado,,,,0,Açores,AÇORES,4601,15531.09,4490,304,231,223,159,162,321,544,775,1079,28.91,6.95,4.99,3.5
16-06-2021,LAMEGO,5,0,20,"[0,120]",Baixo a Moderado,,,,5,Norte,VISEU,1805,16542.11,24895,1639,1284,1124,898,783,1681,2805,4089,5728,150.5,34.63,24.72,16.96
16-06-2021,LEIRIA,49,3,39,"[0,120]",Baixo a Moderado,,,,49,Centro,LEIRIA,1009,56508.83,125267,7389,6366,5090,3902,3159,7061,12151,18517,25906,221.68,45.84,32.77,21.5
16-06-2021,LISBOA,1559,111,306,"[240,480]",Elevado,,,,1559,Lisboa e Vale do Tejo,LISBOA,1106,10005.43,509515,33197,33340,27706,23037,26770,49807,77513,110853,144050,5092.6,1439.78,1107.98,774.74
16-06-2021,LOULÉ,93,7,135,"[120,240]",Moderado,,,,93,Algarve,FARO,0808,76366.91,68697,3890,3350,2780,2358,2251,4609,7389,10739,14629,89.96,19.16,14.06,9.68
16-06-2021,LOURES,325,23,152,"[120,240]",Moderado,,,,325,Lisboa e Vale do Tejo,LISBOA,1107,16723.99,213687,12746,12794,9644,6669,5033,11702,21346,34140,46886,1277.73,280.35,204.14,127.64
16-06-2021,LOURINHÃ,9,1,35,"[0,120]",Baixo a Moderado,,,,9,Lisboa e Vale do Tejo,LISBOA,1108,14717.2,25855,1584,1243,992,842,645,1487,2479,3722,5306,175.68,36.05,25.29,16.84
16-06-2021,LOUSÃ,3,0,17,"[0,120]",Baixo a Moderado,,,,3,Centro,COIMBRA,0607,13840.01,17158,946,866,658,528,450,978,1636,2502,3448,123.97,24.91,18.08,11.82
16-06-2021,LOUSADA,42,3,90,"[0,120]",Baixo a Moderado,,,,42,Norte,PORTO,1305,9608.01,46755,2289,1698,1176,853,621,1474,2650,4348,6637,486.63,69.08,45.25,27.58
16-06-2021,MAÇÃO,1,0,16,"[0,120]",Baixo a Moderado,,,,1,Lisboa e Vale do Tejo,SANTARÉM,1413,39997.98,6267,386,362,390,440,657,1097,1487,1849,2235,15.67,5.59,4.62,3.72
16-06-2021,MACEDO DE CAVALEIROS,4,0,28,"[0,120]",Baixo a Moderado,,,,4,Norte,BRAGANÇA,0405,69914.08,14516,1082,889,878,823,938,1761,2639,3528,4610,20.76,6.59,5.05,3.77
16-06-2021,MACHICO,3,0,15,"[0,120]",Baixo a Moderado,,,,3,Madeira,MADEIRA,3104,6825.1,19981,1197,860,662,455,331,786,1448,2308,3505,292.76,51.36,33.82,21.22
16-06-2021,MADALENA,1,0,17,"[0,120]",Baixo a Moderado,,,,1,Açores,AÇORES,4602,14712.33,5895,334,256,173,190,179,369,542,798,1132,40.07,7.69,5.42,3.68
16-06-2021,MAFRA,157,11,185,"[120,240]",Moderado,,,,157,Lisboa e Vale do Tejo,LISBOA,1109,29165.5,84816,3613,3334,2839,2089,1899,3988,6827,10161,13774,290.81,47.23,34.84,23.41
16-06-2021,MAIA,65,5,47,"[0,120]",Baixo a Moderado,,,,65,Norte,PORTO,1306,8293.94,138971,7801,6617,4512,3339,2631,5970,10482,17099,24900,1675.56,300.22,206.16,126.38
16-06-2021,MANGUALDE,4,0,22,"[0,120]",Baixo a Moderado,,,,4,Centro,VISEU,1806,21925.56,18510,1198,1128,885,852,743,1595,2480,3608,4806,84.42,21.92,16.46,11.31
16-06-2021,MANTEIGAS,1,0,33,"[0,120]",Baixo a Moderado,,,,1,Centro,GUARDA,0908,12197.55,3007,258,197,159,167,146,313,472,669,927,24.65,7.6,5.48,3.87
16-06-2021,MARCO DE CANAVESES,11,1,21,"[0,120]",Baixo a Moderado,,,,11,Norte,PORTO,1307,20188.98,51496,2678,2060,1488,1265,1023,2288,3776,5836,8514,255.07,42.17,28.91,18.7
16-06-2021,MARINHA GRANDE,8,1,21,"[0,120]",Baixo a Moderado,,,,8,Centro,LEIRIA,1010,18725.19,38508,2365,2302,1638,1359,1058,2417,4055,6357,8722,205.65,46.58,33.95,21.66
16-06-2021,MARVÃO,2,0,67,"[0,120]",Baixo a Moderado,,,,2,Alentejo,PORTALEGRE,1210,15489.9,3005,198,185,142,197,237,434,576,761,959,19.4,6.19,4.91,3.72
16-06-2021,MATOSINHOS,117,8,67,"[0,120]",Baixo a Moderado,,,,117,Norte,PORTO,1308,6241.97,175357,11850,9977,7023,5024,3884,8908,15931,25908,37758,2809.31,604.9,415.06,255.22
16-06-2021,MEALHADA,1,0,5,"[0,120]",Baixo a Moderado,,,,1,Centro,AVEIRO,0111,11065.66,19914,1163,1039,810,828,831,1659,2469,3508,4671,179.96,42.21,31.7,22.31
16-06-2021,MÊDA,2,0,44,"[0,120]",Baixo a Moderado,,,,2,Centro,GUARDA,0909,28604.92,4587,343,306,290,288,443,731,1021,1327,1670,16.04,5.84,4.64,3.57
16-06-2021,MELGAÇO,0,0,0,"[0,120]",Baixo a Moderado,,,,0,Norte,VIANA DO CASTELO,1603,23824.58,8093,507,567,578,614,675,1289,1867,2434,2941,33.97,12.34,10.22,7.84
16-06-2021,MÉRTOLA,0,0,0,"[0,120]",Baixo a Moderado,,,,0,Alentejo,BEJA,0209,129287.34,6142,400,390,378,423,600,1023,1401,1791,2191,4.75,1.69,1.39,1.08
16-06-2021,MESÃO FRIO,0,0,0,"[0,120]",Baixo a Moderado,,,,0,Norte,VILA REAL,1704,2664.87,3964,265,205,168,157,120,277,445,650,915,148.74,34.33,24.39,16.7
16-06-2021,MIRA,9,1,76,"[0,120]",Baixo a Moderado,,,,9,Centro,COIMBRA,0608,12403.38,11832,727,729,659,550,466,1016,1675,2404,3131,95.4,25.24,19.38,13.5
16-06-2021,MIRANDA DO CORVO,2,0,16,"[0,120]",Baixo a Moderado,,,,2,Centro,COIMBRA,0609,12637.79,12708,706,659,568,498,404,902,1470,2129,2835,100.55,22.43,16.85,11.63
16-06-2021,MIRANDA DO DOURO,1,0,15,"[0,120]",Baixo a Moderado,,,,1,Norte,BRAGANÇA,0406,48718.31,6830,482,429,442,463,470,933,1375,1804,2286,14.02,4.69,3.7,2.82
16-06-2021,MIRANDELA,2,0,9,"[0,120]",Baixo a Moderado,,,,2,Norte,BRAGANÇA,0407,65895.67,21754,1640,1315,1204,1078,947,2025,3229,4544,6184,33.01,9.38,6.9,4.9
16-06-2021,MOGADOURO,0,0,0,"[0,120]",Baixo a Moderado,,,,0,Norte,BRAGANÇA,0408,76064.93,8392,589,529,576,630,655,1285,1861,2390,2979,11.03,3.92,3.14,2.45
16-06-2021,MOIMENTA DA BEIRA,2,0,21,"[0,120]",Baixo a Moderado,,,,2,Norte,VISEU,1807,21996.9,9736,576,514,471,416,461,877,1348,1862,2438,44.26,11.08,8.46,6.13
16-06-2021,MOITA,112,8,174,"[120,240]",Moderado,,,,112,Lisboa e Vale do Tejo,SETÚBAL,1506,5525.98,64407,4226,3646,2623,1801,1425,3226,5849,9495,13721,1165.53,248.3,171.82,105.85
16-06-2021,MONÇÃO,3,0,17,"[0,120]",Baixo a Moderado,,,,3,Norte,VIANA DO CASTELO,1604,21130.85,17869,1161,1105,1031,1006,972,1978,3009,4114,5275,84.56,24.96,19.47,14.24
16-06-2021,MONCHIQUE,0,0,0,"[0,120]",Baixo a Moderado,,,,0,Algarve,FARO,0809,39530.43,5077,353,384,321,355,392,747,1068,1452,1805,12.84,4.57,3.67,2.7
16-06-2021,MONDIM DE BASTO,1,0,14,"[0,120]",Baixo a Moderado,,,,1,Norte,VILA REAL,1705,17207.52,6946,395,300,314,284,283,567,881,1181,1576,40.36,9.16,6.86,5.12
16-06-2021,MONFORTE,4,0,134,"[120,240]",Moderado,,,,4,Alentejo,PORTALEGRE,1211,42024.82,2975,139,115,117,192,168,360,477,592,731,7.08,1.74,1.41,1.14
16-06-2021,MONTALEGRE,10,1,111,"[0,120]",Baixo a Moderado,,,,10,Norte,VILA REAL,1706,80545.71,8997,699,628,595,603,730,1333,1928,2556,3255,11.17,4.04,3.17,2.39
16-06-2021,MONTEMOR-O-NOVO,4,0,26,"[0,120]",Baixo a Moderado,,,,4,Alentejo,ÉVORA,0706,123296.65,15647,991,953,868,878,971,1849,2717,3670,4661,12.69,3.78,2.98,2.2
16-06-2021,MONTEMOR-O-VELHO,19,1,75,"[0,120]",Baixo a Moderado,,,,19,Centro,COIMBRA,0610,22896.23,25224,1496,1397,1217,1057,988,2045,3262,4659,6155,110.17,26.88,20.35,14.25
16-06-2021,MONTIJO,94,7,163,"[120,240]",Moderado,,,,94,Lisboa e Vale do Tejo,SETÚBAL,1507,34861.64,57614,2771,2441,1990,1554,1109,2663,4653,7094,9865,165.26,28.3,20.35,13.35
16-06-2021,MORA,1,0,24,"[0,120]",Baixo a Moderado,,,,1,Alentejo,ÉVORA,0707,44395.02,4138,336,275,252,238,257,495,747,1022,1358,9.32,3.06,2.3,1.68
16-06-2021,MORTÁGUA,0,0,0,"[0,120]",Baixo a Moderado,,,,0,Centro,VISEU,1808,25117.82,8803,638,584,535,499,460,959,1494,2078,2716,35.05,10.81,8.27,5.95
16-06-2021,MOURA,5,0,36,"[0,120]",Baixo a Moderado,,,,5,Alentejo,BEJA,0210,95845.55,13718,817,656,665,542,461,1003,1668,2324,3141,14.31,3.28,2.42,1.74
16-06-2021,MOURÃO,0,0,0,"[0,120]",Baixo a Moderado,,,,0,Alentejo,ÉVORA,0708,27862.98,2450,139,108,80,104,109,213,293,401,540,8.79,1.94,1.44,1.05
16-06-2021,MURÇA,0,0,0,"[0,120]",Baixo a Moderado,,,,0,Norte,VILA REAL,1707,18937.11,5463,384,341,307,306,319,625,932,1273,1657,28.85,8.75,6.72,4.92
16-06-2021,MURTOSA,0,0,0,"[0,120]",Baixo a Moderado,,,,0,Centro,AVEIRO,0112,7308.78,10279,509,473,403,353,409,762,1165,1638,2147,140.63,29.37,22.41,15.94
16-06-2021,NAZARÉ,2,0,14,"[0,120]",Baixo a Moderado,,,,2,Lisboa e Vale do Tejo,LEIRIA,1011,8243.43,14165,967,903,670,420,396,816,1486,2389,3356,171.84,40.71,28.98,18.03
16-06-2021,NELAS,10,1,77,"[0,120]",Baixo a Moderado,,,,10,Centro,VISEU,1809,12571.48,12974,924,787,668,604,583,1187,1855,2642,3566,103.21,28.37,21.02,14.76
16-06-2021,NISA,4,0,66,"[0,120]",Baixo a Moderado,,,,4,Alentejo,PORTALEGRE,1212,57567.84,6061,405,389,355,483,478,961,1316,1705,2110,10.53,3.67,2.96,2.29
16-06-2021,NORDESTE,2,0,41,"[0,120]",Baixo a Moderado,,,,2,Açores,AÇORES,4202,10146.8,4862,246,180,124,161,162,323,447,627,873,47.92,8.6,6.18,4.41
16-06-2021,ÓBIDOS,2,0,17,"[0,120]",Baixo a Moderado,,,,2,Lisboa e Vale do Tejo,LEIRIA,1012,14155.44,11850,743,650,574,452,436,888,1462,2112,2855,83.72,20.17,14.92,10.33
16-06-2021,ODEMIRA,125,9,506,"[480,960]",Muito Elevado,,,,125,Alentejo,BEJA,0211,172060.15,24717,1475,1317,1225,1397,1349,2746,3971,5288,6763,14.37,3.93,3.07,2.31
16-06-2021,ODIVELAS,311,22,192,"[120,240]",Moderado,,,,311,Lisboa e Vale do Tejo,LISBOA,1116,2654.36,161774,9562,9038,6952,4641,3812,8453,15405,24443,34005,6095.48,1281.27,920.99,580.44
16-06-2021,OEIRAS,353,25,199,"[120,240]",Moderado,,,,353,Lisboa e Vale do Tejo,LISBOA,1110,4588.31,177408,11580,11575,8566,6211,5855,12066,20632,32207,43787,3866.78,954.38,701.98,449.69
16-06-2021,OLEIROS,2,0,40,"[0,120]",Baixo a Moderado,,,,2,Centro,CASTELO BRANCO,0506,47109.31,5003,384,341,366,397,487,884,1250,1591,1975,10.62,4.19,3.38,2.65
16-06-2021,OLHÃO,36,3,81,"[0,120]",Baixo a Moderado,,,,36,Algarve,FARO,0810,13086.38,44405,2455,2309,1689,1342,1268,2610,4299,6608,9063,339.33,69.26,50.5,32.85
16-06-2021,OLIVEIRA DE AZEMÉIS,27,2,41,"[0,120]",Baixo a Moderado,,,,27,Norte,AVEIRO,0113,16110.41,66011,4155,3614,2794,2183,1738,3921,6715,10329,14484,409.75,89.91,64.12,41.68
16-06-2021,OLIVEIRA DE FRADES,10,1,101,"[0,120]",Baixo a Moderado,,,,10,Centro,VISEU,1810,14534.62,9936,553,475,438,359,415,774,1212,1687,2240,68.36,15.41,11.61,8.34
16-06-2021,OLIVEIRA DO BAIRRO,3,0,12,"[0,120]",Baixo a Moderado,,,,3,Centro,AVEIRO,0114,8731.99,24277,1327,1182,999,786,810,1596,2595,3777,5104,278.02,58.45,43.25,29.72
16-06-2021,OLIVEIRA DO HOSPITAL,2,0,10,"[0,120]",Baixo a Moderado,,,,2,Centro,COIMBRA,0611,23451.66,19253,1161,1097,962,924,960,1884,2846,3943,5104,82.1,21.76,16.81,12.14
16-06-2021,OURÉM,8,1,18,"[0,120]",Baixo a Moderado,,,,8,Lisboa e Vale do Tejo,SANTARÉM,1421,41668.03,44044,2463,2069,1899,1817,1603,3420,5319,7388,9851,105.7,23.64,17.73,12.77
16-06-2021,OURIQUE,0,0,0,"[0,120]",Baixo a Moderado,,,,0,Alentejo,BEJA,0212,66331.36,4607,313,287,284,268,227,495,779,1066,1379,6.95,2.08,1.61,1.17
16-06-2021,OVAR,24,2,44,"[0,120]",Baixo a Moderado,,,,24,Centro,AVEIRO,0115,14770.25,54260,3294,2709,1994,1636,1234,2870,4864,7573,10867,367.37,73.57,51.27,32.93
16-06-2021,PAÇOS DE FERREIRA,29,2,51,"[0,120]",Baixo a Moderado,,,,29,Norte,PORTO,1309,7099.29,56728,2903,2193,1518,1135,664,1799,3317,5510,8413,799.1,118.51,77.62,46.72
16-06-2021,PALMELA,103,7,160,"[120,240]",Moderado,,,,103,Lisboa e Vale do Tejo,SETÚBAL,1508,46512.01,64269,3402,3244,2635,1846,1391,3237,5872,9116,12518,138.18,26.91,19.6,12.62
16-06-2021,PAMPILHOSA DA SERRA,1,0,25,"[0,120]",Baixo a Moderado,,,,1,Centro,COIMBRA,0612,39646.24,4037,238,254,295,339,423,762,1057,1311,1549,10.18,3.91,3.31,2.67
16-06-2021,PAREDES,28,2,33,"[0,120]",Baixo a Moderado,,,,28,Norte,PORTO,1310,15675.69,86067,4272,3532,2412,1717,1258,2975,5387,8919,13191,549.04,84.15,56.9,34.36
16-06-2021,PAREDES DE COURA,11,1,129,"[120,240]",Moderado,,,,11,Norte,VIANA DO CASTELO,1605,13818.59,8535,466,528,407,465,515,980,1387,1915,2381,61.76,17.23,13.86,10.04
16-06-2021,PEDRÓGÃO GRANDE,1,0,29,"[0,120]",Baixo a Moderado,,,,1,Centro,LEIRIA,1013,12874.75,3410,175,173,196,221,252,473,669,842,1017,26.49,7.9,6.54,5.2
16-06-2021,PENACOVA,9,1,66,"[0,120]",Baixo a Moderado,,,,9,Centro,COIMBRA,0613,21673.23,13694,968,923,745,621,703,1324,2069,2992,3960,63.18,18.27,13.81,9.55
16-06-2021,PENAFIEL,22,2,32,"[0,120]",Baixo a Moderado,,,,22,Norte,PORTO,1311,21224.27,69772,3648,2823,2032,1663,1230,2893,4925,7748,11396,328.74,53.69,36.51,23.2
16-06-2021,PENALVA DO CASTELO,3,0,42,"[0,120]",Baixo a Moderado,,,,3,Centro,VISEU,1811,13433.92,7115,449,457,413,391,426,817,1230,1687,2136,52.96,15.9,12.56,9.16
16-06-2021,PENAMACOR,0,0,0,"[0,120]",Baixo a Moderado,,,,0,Centro,CASTELO BRANCO,0507,56370.69,4755,262,248,273,451,633,1084,1357,1605,1867,8.44,3.31,2.85,2.41
16-06-2021,PENEDONO,0,0,0,"[0,120]",Baixo a Moderado,,,,0,Norte,VISEU,1812,13370.75,2591,172,113,129,156,138,294,423,536,708,19.38,5.3,4.01,3.16
16-06-2021,PENELA,2,0,37,"[0,120]",Baixo a Moderado,,,,2,Centro,COIMBRA,0614,13480.0,5397,314,324,274,359,344,703,977,1301,1615,40.04,11.98,9.65,7.25
16-06-2021,PENICHE,22,2,83,"[0,120]",Baixo a Moderado,,,,22,Lisboa e Vale do Tejo,LEIRIA,1014,7754.98,26501,1746,1504,1203,926,707,1633,2836,4340,6086,341.73,78.48,55.96,36.57
16-06-2021,PESO DA RÉGUA,3,0,19,"[0,120]",Baixo a Moderado,,,,3,Norte,VILA REAL,1708,9486.01,15773,1076,843,650,659,455,1114,1764,2607,3683,166.28,38.83,27.48,18.6
16-06-2021,PINHEL,2,0,23,"[0,120]",Baixo a Moderado,,,,2,Centro,GUARDA,0910,48452.12,8511,577,566,551,538,689,1227,1778,2344,2921,17.57,6.03,4.84,3.67
16-06-2021,POMBAL,35,2,68,"[0,120]",Baixo a Moderado,,,,35,Centro,LEIRIA,1015,62600.28,51461,3187,2791,2494,2328,2027,4355,6849,9640,12827,82.21,20.49,15.4,10.94
16-06-2021,PONTA DELGADA,138,10,203,"[120,240]",Moderado,,,,138,Açores,AÇORES,4203,23298.65,67935,3108,2435,1726,1133,902,2035,3761,6196,9304,291.58,39.93,26.59,16.14
16-06-2021,PONTA DO SOL,4,0,47,"[0,120]",Baixo a Moderado,,,,4,Madeira,MADEIRA,3105,4622.03,8593,319,283,347,208,221,429,776,1059,1378,185.92,29.81,22.91,16.79
16-06-2021,PONTE DA BARCA,9,1,81,"[0,120]",Baixo a Moderado,,,,9,Norte,VIANA DO CASTELO,1606,18211.37,11180,635,576,517,554,490,1044,1561,2137,2772,61.39,15.22,11.73,8.57
16-06-2021,PONTE DE LIMA,22,2,53,"[0,120]",Baixo a Moderado,,,,22,Norte,VIANA DO CASTELO,1607,32025.46,41315,2321,2022,1720,1596,1462,3058,4778,6800,9121,129.01,28.48,21.23,14.92
16-06-2021,PONTE DE SOR,2,0,13,"[0,120]",Baixo a Moderado,,,,2,Alentejo,PORTALEGRE,1213,83971.16,14994,939,800,716,739,831,1570,2286,3086,4025,17.86,4.79,3.68,2.72
16-06-2021,PORTALEGRE,36,3,162,"[120,240]",Moderado,,,,36,Alentejo,PORTALEGRE,1214,44713.64,22172,1577,1351,1137,993,984,1977,3114,4465,6042,49.59,13.51,9.99,6.96
16-06-2021,PORTEL,2,0,34,"[0,120]",Baixo a Moderado,,,,2,Alentejo,ÉVORA,0709,60100.57,5828,336,358,283,331,305,636,919,1277,1613,9.7,2.68,2.12,1.53
16-06-2021,PORTIMÃO,50,4,90,"[0,120]",Baixo a Moderado,,,,50,Algarve,FARO,0811,18206.29,55483,3182,2927,2116,1582,1400,2982,5098,8025,11207,304.75,61.56,44.08,28.0
16-06-2021,PORTO,204,15,94,"[0,120]",Baixo a Moderado,,,,204,Norte,PORTO,1312,4142.02,216606,15790,15193,11280,9409,10044,19453,30733,45926,61716,5229.5,1490.0,1108.79,741.98
16-06-2021,PORTO DE MÓS,8,1,34,"[0,120]",Baixo a Moderado,,,,8,Centro,LEIRIA,1016,26183.41,23275,1355,1210,1034,888,872,1760,2794,4004,5359,88.89,20.47,15.29,10.67
16-06-2021,PORTO MONIZ,1,0,43,"[0,120]",Baixo a Moderado,,,,1,Madeira,MADEIRA,3106,8293.38,2342,143,130,95,98,120,218,313,443,586,28.24,7.07,5.34,3.77
16-06-2021,PORTO SANTO,0,0,0,"[0,120]",Baixo a Moderado,,,,0,Madeira,MADEIRA,3201,4300.7,5202,240,157,134,110,68,178,312,469,709,120.95,16.48,10.9,7.25
16-06-2021,PÓVOA DE LANHOSO,5,0,23,"[0,120]",Baixo a Moderado,,,,5,Norte,BRAGA,0309,13465.29,21499,1175,909,732,673,624,1297,2029,2938,4113,159.67,30.55,21.82,15.07
16-06-2021,PÓVOA DE VARZIM,15,1,24,"[0,120]",Baixo a Moderado,,,,15,Norte,PORTO,1313,8220.59,62784,3712,3120,2134,1594,1305,2899,5033,8153,11865,763.7,144.33,99.17,61.22
16-06-2021,POVOAÇÃO,1,0,17,"[0,120]",Baixo a Moderado,,,,1,Açores,AÇORES,4204,10640.77,5927,293,212,191,144,134,278,469,681,974,55.7,9.15,6.4,4.41
16-06-2021,VILA DA PRAIA DA VITÓRIA,2,0,9,"[0,120]",Baixo a Moderado,,,,2,Açores,AÇORES,4302,16127.06,21317,1133,789,619,436,336,772,1391,2180,3313,132.18,20.54,13.52,8.63
16-06-2021,PROENÇA-A-NOVA,1,0,14,"[0,120]",Baixo a Moderado,,,,1,Centro,CASTELO BRANCO,0508,39539.96,7298,508,465,389,400,560,960,1349,1814,2322,18.46,5.87,4.59,3.41
16-06-2021,REDONDO,0,0,0,"[0,120]",Baixo a Moderado,,,,0,Alentejo,ÉVORA,0710,36950.87,6353,349,325,288,288,354,642,930,1255,1604,17.19,4.34,3.4,2.52
16-06-2021,REGUENGOS DE MONSARAZ,8,1,80,"[0,120]",Baixo a Moderado,,,,8,Alentejo,ÉVORA,0711,46399.72,10015,602,511,455,462,473,935,1390,1901,2503,21.58,5.39,4.1,3.0
16-06-2021,RESENDE,3,0,30,"[0,120]",Baixo a Moderado,,,,3,Norte,VISEU,1813,12334.93,10137,560,493,448,433,422,855,1303,1796,2356,82.18,19.1,14.56,10.56
16-06-2021,RIBEIRA BRAVA,0,0,0,"[0,120]",Baixo a Moderado,,,,0,Madeira,MADEIRA,3107,6544.88,12435,648,500,411,311,287,598,1009,1509,2157,189.99,32.96,23.06,15.42
16-06-2021,RIBEIRA DE PENA,1,0,17,"[0,120]",Baixo a Moderado,,,,1,Norte,VILA REAL,1709,21745.98,6016,371,301,290,310,368,678,968,1269,1640,27.66,7.54,5.84,4.45
16-06-2021,RIBEIRA GRANDE,162,12,494,"[480,960]",Muito Elevado,,,,162,Açores,AÇORES,4205,18015.13,32811,1163,689,512,345,253,598,1110,1799,2962,182.13,16.44,9.99,6.16
16-06-2021,RIO MAIOR,11,1,54,"[0,120]",Baixo a Moderado,,,,11,Lisboa e Vale do Tejo,SANTARÉM,1414,27276.45,20379,1251,1144,941,795,648,1443,2384,3528,4779,74.71,17.52,12.93,8.74
16-06-2021,SABROSA,1,0,17,"[0,120]",Baixo a Moderado,,,,1,Norte,VILA REAL,1710,15692.45,5918,393,314,304,302,350,652,956,1270,1663,37.71,10.6,8.09,6.09
16-06-2021,SABUGAL,0,0,0,"[0,120]",Baixo a Moderado,,,,0,Centro,GUARDA,0911,82269.82,10585,724,707,694,796,1009,1805,2499,3206,3930,12.87,4.78,3.9,3.04
16-06-2021,SALVATERRA DE MAGOS,14,1,66,"[0,120]",Baixo a Moderado,,,,14,Lisboa e Vale do Tejo,SANTARÉM,1415,24393.2,21295,1275,1181,1060,799,772,1571,2631,3812,5087,87.3,20.85,15.63,10.79
16-06-2021,SANTA COMBA DÃO,0,0,0,"[0,120]",Baixo a Moderado,,,,0,Centro,VISEU,1814,11194.77,10452,732,684,569,538,464,1002,1571,2255,2987,93.36,26.68,20.14,14.03
16-06-2021,SANTA CRUZ,14,1,31,"[0,120]",Baixo a Moderado,,,,14,Madeira,MADEIRA,3108,8150.28,45281,1817,1301,974,716,523,1239,2213,3514,5331,555.6,65.41,43.12,27.15
16-06-2021,SANTA CRUZ DA GRACIOSA,3,0,71,"[0,120]",Baixo a Moderado,,,,3,Açores,AÇORES,4401,6065.78,4208,228,180,163,124,145,269,432,612,840,69.37,13.85,10.09,7.12
16-06-2021,SANTA CRUZ DAS FLORES,0,0,0,"[0,120]",Baixo a Moderado,,,,0,Açores,AÇORES,4802,7091.44,2165,125,98,74,56,51,107,181,279,404,30.53,5.7,3.93,2.55
16-06-2021,SANTA MARIA DA FEIRA,75,5,54,"[0,120]",Baixo a Moderado,,,,75,Norte,AVEIRO,0109,21587.65,138636,8182,6743,4771,3856,3079,6935,11706,18449,26631,642.19,123.36,85.46,54.22
16-06-2021,SANTA MARTA DE PENAGUIÃO,2,0,30,"[0,120]",Baixo a Moderado,,,,2,Norte,VILA REAL,1711,6928.13,6599,483,373,337,316,317,633,970,1343,1826,95.25,26.36,19.39,14.0
16-06-2021,SANTANA,1,0,15,"[0,120]",Baixo a Moderado,,,,1,Madeira,MADEIRA,3109,9547.3,6711,418,353,343,282,277,559,902,1255,1673,70.29,17.52,13.15,9.45
16-06-2021,SANTARÉM,58,4,101,"[0,120]",Baixo a Moderado,,,,58,Lisboa e Vale do Tejo,SANTARÉM,1416,55253.58,57421,3654,3441,2760,2466,2206,4672,7432,10873,14527,103.92,26.29,19.68,13.45
16-06-2021,SANTIAGO DO CACÉM,2,0,7,"[0,120]",Baixo a Moderado,,,,2,Alentejo,SETÚBAL,1509,105969.29,28791,2144,1689,1472,1295,1215,2510,3982,5671,7815,27.17,7.37,5.35,3.76
16-06-2021,SANTO TIRSO,46,3,68,"[0,120]",Baixo a Moderado,,,,46,Norte,PORTO,1314,13655.52,68055,4911,3935,2761,2257,1810,4067,6828,10763,15674,498.35,114.78,78.82,50.0
16-06-2021,SÃO BRÁS DE ALPORTEL,8,1,77,"[0,120]",Baixo a Moderado,,,,8,Algarve,FARO,0812,15336.92,10416,596,468,467,404,401,805,1272,1740,2336,67.91,15.23,11.35,8.29
16-06-2021,SÃO JOÃO DA MADEIRA,11,1,50,"[0,120]",Baixo a Moderado,,,,11,Norte,AVEIRO,0116,794.3,21958,1347,1069,796,601,593,1194,1990,3059,4406,2765.49,554.91,385.26,250.63
16-06-2021,SÃO JOÃO DA PESQUEIRA,3,0,42,"[0,120]",Baixo a Moderado,,,,3,Norte,VISEU,1815,26610.85,7125,417,330,294,328,328,656,950,1280,1697,26.77,6.38,4.81,3.57
16-06-2021,SÃO PEDRO DO SUL,1,0,6,"[0,120]",Baixo a Moderado,,,,1,Centro,VISEU,1816,34895.09,15403,990,962,861,759,909,1668,2529,3491,4481,44.14,12.84,10.0,7.25
16-06-2021,SÃO ROQUE DO PICO,0,0,0,"[0,120]",Baixo a Moderado,,,,0,Açores,AÇORES,4603,14236.1,3266,199,141,93,96,113,209,302,443,642,22.94,4.51,3.11,2.12
16-06-2021,SÃO VICENTE,2,0,39,"[0,120]",Baixo a Moderado,,,,2,Madeira,MADEIRA,3110,7883.71,5143,272,264,266,225,280,505,771,1035,1307,65.23,16.58,13.13,9.78
16-06-2021,SARDOAL,14,1,374,"[240,480]",Elevado,,,,14,Lisboa e Vale do Tejo,SANTARÉM,1417,9214.72,3741,227,178,148,165,248,413,561,739,966,40.6,10.48,8.02,6.09
16-06-2021,SÁTÃO,0,0,0,"[0,120]",Baixo a Moderado,,,,0,Centro,VISEU,1817,20194.11,11580,765,671,515,465,476,941,1456,2127,2892,57.34,14.32,10.53,7.21
16-06-2021,SEIA,10,1,45,"[0,120]",Baixo a Moderado,,,,10,Centro,GUARDA,0912,43568.83,22234,1807,1589,1238,1122,721,1843,3081,4670,6477,51.03,14.87,10.72,7.07
16-06-2021,SEIXAL,277,20,165,"[120,240]",Moderado,,,,277,Lisboa e Vale do Tejo,SETÚBAL,1510,9545.17,167752,10586,9270,6661,4391,2930,7321,13982,23252,33838,1757.49,354.51,243.6,146.49
16-06-2021,SERNANCELHE,1,0,19,"[0,120]",Baixo a Moderado,,,,1,Norte,VISEU,1818,22861.22,5396,305,293,286,273,260,533,819,1112,1417,23.6,6.2,4.86,3.58
16-06-2021,SERPA,6,0,42,"[0,120]",Baixo a Moderado,,,,6,Alentejo,BEJA,0213,110563.34,14304,903,761,719,697,626,1323,2042,2803,3706,12.94,3.35,2.54,1.85
16-06-2021,SERTÃ,46,3,316,"[240,480]",Elevado,,,,46,Centro,CASTELO BRANCO,0509,44673.17,14577,870,779,790,767,1020,1787,2577,3356,4226,32.63,9.46,7.51,5.77
16-06-2021,SESIMBRA,175,12,337,"[240,480]",Elevado,,,,175,Lisboa e Vale do Tejo,SETÚBAL,1511,19571.75,51858,2400,2321,1853,1257,1083,2340,4193,6514,8914,264.96,45.54,33.28,21.42
16-06-2021,SETÚBAL,174,12,151,"[120,240]",Moderado,,,,174,Lisboa e Vale do Tejo,SETÚBAL,1512,23032.5,115126,7425,6929,5075,3775,2655,6430,11505,18434,25859,499.83,112.27,80.03,49.95
16-06-2021,SEVER DO VOUGA,6,0,53,"[0,120]",Baixo a Moderado,,,,6,Centro,AVEIRO,0117,12987.56,11331,766,637,568,540,567,1107,1675,2312,3078,87.24,23.7,17.8,12.9
16-06-2021,SILVES,27,2,75,"[0,120]",Baixo a Moderado,,,,27,Algarve,FARO,0813,68006.23,36226,2137,1869,1610,1423,1600,3023,4633,6502,8639,53.27,12.7,9.56,6.81
16-06-2021,SINES,22,2,160,"[120,240]",Moderado,,,,22,Alentejo,SETÚBAL,1513,20330.17,13715,888,791,551,416,268,684,1235,2026,2914,67.46,14.33,9.97,6.07
16-06-2021,SINTRA,779,56,199,"[120,240]",Moderado,,,,779,Lisboa e Vale do Tejo,LISBOA,1111,31922.73,391402,20490,18316,13545,9137,7284,16421,29966,48282,68772,1226.08,215.43,151.25,93.87
16-06-2021,SOBRAL DE MONTE AGRAÇO,22,2,207,"[120,240]",Moderado,,,,22,Lisboa e Vale do Tejo,LISBOA,1112,5210.32,10651,564,507,352,272,212,484,836,1343,1907,204.43,36.6,25.78,16.05
16-06-2021,SOURE,5,0,29,"[0,120]",Baixo a Moderado,,,,5,Centro,COIMBRA,0615,26506.07,17120,1173,1142,1004,883,987,1870,2874,4016,5189,64.59,19.58,15.15,10.84
16-06-2021,SOUSEL,1,0,23,"[0,120]",Baixo a Moderado,,,,1,Alentejo,PORTALEGRE,1215,27932.18,4412,261,274,208,302,292,594,802,1076,1337,15.8,4.79,3.85,2.87
16-06-2021,TÁBUA,4,0,35,"[0,120]",Baixo a Moderado,,,,4,Centro,COIMBRA,0616,19978.58,11368,729,584,524,430,464,894,1418,2002,2731,56.9,13.67,10.02,7.1
16-06-2021,TABUAÇO,1,0,17,"[0,120]",Baixo a Moderado,,,,1,Norte,VISEU,1819,13385.67,6033,372,314,217,282,363,645,862,1176,1548,45.07,11.56,8.79,6.44
16-06-2021,TAROUCA,0,0,0,"[0,120]",Baixo a Moderado,,,,0,Norte,VISEU,1820,10008.49,7804,405,335,313,277,324,601,914,1249,1654,77.98,16.53,12.48,9.13
16-06-2021,TAVIRA,12,1,49,"[0,120]",Baixo a Moderado,,,,12,Algarve,FARO,0814,60696.7,24530,1493,1415,1252,1066,1277,2343,3595,5010,6503,40.41,10.71,8.25,5.92
16-06-2021,TERRAS DE BOURO,0,0,0,"[0,120]",Baixo a Moderado,,,,0,Norte,BRAGA,0310,27746.07,6361,391,372,296,319,340,659,955,1327,1718,22.93,6.19,4.78,3.44
16-06-2021,TOMAR,12,1,33,"[0,120]",Baixo a Moderado,,,,12,Lisboa e Vale do Tejo,SANTARÉM,1418,35120.44,36748,2403,2189,1868,1853,1822,3675,5543,7732,10135,104.64,28.86,22.02,15.78
16-06-2021,TONDELA,12,1,46,"[0,120]",Baixo a Moderado,,,,12,Centro,VISEU,1821,37121.73,26357,1768,1722,1518,1475,1417,2892,4410,6132,7900,71.0,21.28,16.52,11.88
16-06-2021,TORRE DE MONCORVO,0,0,0,"[0,120]",Baixo a Moderado,,,,0,Norte,BRAGANÇA,0409,53155.67,7695,556,478,488,551,719,1270,1758,2236,2792,14.48,5.25,4.21,3.31
16-06-2021,TORRES NOVAS,5,0,14,"[0,120]",Baixo a Moderado,,,,5,Lisboa e Vale do Tejo,SANTARÉM,1419,26999.68,34933,2324,1979,1738,1406,1475,2881,4619,6598,8922,129.38,33.04,24.44,17.11
16-06-2021,TORRES VEDRAS,52,4,66,"[0,120]",Baixo a Moderado,,,,52,Lisboa e Vale do Tejo,LISBOA,1113,40714.89,78530,4513,3945,3447,2628,2104,4732,8179,12124,16637,192.88,40.86,29.78,20.09
16-06-2021,TRANCOSO,14,1,158,"[120,240]",Moderado,,,,14,Centro,GUARDA,0913,36152.47,8875,581,557,542,586,496,1082,1624,2181,2762,24.55,7.64,6.03,4.49
16-06-2021,TROFA,19,1,49,"[0,120]",Baixo a Moderado,,,,19,Norte,PORTO,1318,7201.76,38418,2336,1894,1231,939,684,1623,2854,4748,7084,533.44,98.36,65.93,39.63
16-06-2021,VAGOS,5,0,22,"[0,120]",Baixo a Moderado,,,,5,Centro,AVEIRO,0118,16491.5,22740,1320,1205,922,784,724,1508,2430,3635,4955,137.89,30.04,22.04,14.73
16-06-2021,VALE DE CAMBRA,12,1,56,"[0,120]",Baixo a Moderado,,,,12,Norte,AVEIRO,0119,14733.47,21327,1491,1363,1005,831,798,1629,2634,3997,5488,144.76,37.25,27.13,17.88
16-06-2021,VALENÇA,1,0,8,"[0,120]",Baixo a Moderado,,,,1,Norte,VIANA DO CASTELO,1608,11712.86,13290,867,791,582,582,503,1085,1667,2458,3325,113.46,28.39,20.99,14.23
16-06-2021,VALONGO,21,2,22,"[0,120]",Baixo a Moderado,,,,21,Norte,PORTO,1315,7512.45,97444,5629,4696,3207,2462,1829,4291,7498,12194,17823,1297.18,237.26,162.33,99.81
16-06-2021,VALPAÇOS,12,1,81,"[0,120]",Baixo a Moderado,,,,12,Norte,VILA REAL,1712,54873.93,14818,1217,1118,999,928,997,1925,2924,4042,5259,27.0,9.58,7.37,5.33
16-06-2021,VELAS,0,0,0,"[0,120]",Baixo a Moderado,,,,0,Açores,AÇORES,4502,11738.38,5093,278,208,166,153,113,266,432,640,918,43.39,7.82,5.45,3.68
16-06-2021,VENDAS NOVAS,2,0,18,"[0,120]",Baixo a Moderado,,,,2,Alentejo,ÉVORA,0712,22238.88,11255,677,768,655,501,532,1033,1688,2456,3133,50.61,14.09,11.04,7.59
16-06-2021,VIANA DO ALENTEJO,0,0,0,"[0,120]",Baixo a Moderado,,,,0,Alentejo,ÉVORA,0713,39367.29,5145,245,208,235,210,214,424,659,867,1112,13.07,2.82,2.2,1.67
16-06-2021,VIANA DO CASTELO,20,1,24,"[0,120]",Baixo a Moderado,,,,20,Norte,VIANA DO CASTELO,1609,31902.01,84417,5470,4433,3591,3061,2982,6043,9634,14067,19537,264.61,61.24,44.09,30.2
16-06-2021,VIDIGUEIRA,0,0,0,"[0,120]",Baixo a Moderado,,,,0,Alentejo,BEJA,0214,31661.09,5510,300,248,215,233,275,508,723,971,1271,17.4,4.01,3.07,2.28
16-06-2021,VIEIRA DO MINHO,4,0,34,"[0,120]",Baixo a Moderado,,,,4,Norte,BRAGA,0311,21644.35,11842,703,594,525,548,482,1030,1555,2149,2852,54.71,13.18,9.93,7.18
16-06-2021,VILA DE REI,0,0,0,"[0,120]",Baixo a Moderado,,,,0,Centro,CASTELO BRANCO,0510,19154.6,3323,169,128,172,247,302,549,721,849,1018,17.35,5.31,4.43,3.76
16-06-2021,VILA DO BISPO,0,0,0,"[0,120]",Baixo a Moderado,,,,0,Algarve,FARO,0815,17906.06,5154,302,302,314,232,233,465,779,1081,1383,28.78,7.72,6.04,4.35
16-06-2021,VILA DO CONDE,39,3,49,"[0,120]",Baixo a Moderado,,,,39,Norte,PORTO,1316,14902.77,79899,4726,3875,2819,2070,1743,3813,6632,10507,15233,536.13,102.21,70.5,44.5
16-06-2021,VILA DO PORTO,0,0,0,"[0,120]",Baixo a Moderado,,,,0,Açores,AÇORES,4101,9688.74,5616,274,212,135,96,123,219,354,566,840,57.96,8.67,5.84,3.65
16-06-2021,VILA FLOR,1,0,17,"[0,120]",Baixo a Moderado,,,,1,Norte,BRAGANÇA,0410,26581.14,6044,429,362,422,294,331,625,1047,1409,1838,22.74,6.91,5.3,3.94
16-06-2021,VILA FRANCA DE XIRA,231,17,163,"[120,240]",Moderado,,,,231,Lisboa e Vale do Tejo,LISBOA,1114,31819.39,141957,8501,6852,4869,3425,2472,5897,10766,17618,26119,446.14,82.09,55.37,33.84
16-06-2021,VILA FRANCA DO CAMPO,5,0,45,"[0,120]",Baixo a Moderado,,,,5,Açores,AÇORES,4206,7796.82,11051,450,344,248,217,154,371,619,963,1413,141.73,18.12,12.35,7.94
16-06-2021,VILA NOVA DA BARQUINHA,6,0,80,"[0,120]",Baixo a Moderado,,,,6,Lisboa e Vale do Tejo,SANTARÉM,1420,4952.97,7461,415,406,392,364,338,702,1094,1500,1915,150.64,38.66,30.28,22.09
16-06-2021,VILA NOVA DE CERVEIRA,1,0,11,"[0,120]",Baixo a Moderado,,,,1,Norte,VIANA DO CASTELO,1610,10846.66,8910,531,444,410,384,334,718,1128,1572,2103,82.14,19.39,14.49,10.4
16-06-2021,VILA NOVA DE FAMALICÃO,86,6,65,"[0,120]",Baixo a Moderado,,,,86,Norte,BRAGA,0312,20159.26,131676,7817,6164,4202,3282,2749,6031,10233,16397,24214,653.19,120.12,81.34,50.76
16-06-2021,VILA NOVA DE FOZ CÔA,1,0,15,"[0,120]",Baixo a Moderado,,,,1,Centro,GUARDA,0914,39815.18,6503,442,385,390,398,429,827,1217,1602,2044,16.33,5.13,4.02,3.06
16-06-2021,VILA NOVA DE GAIA,192,14,64,"[0,120]",Baixo a Moderado,,,,192,Norte,PORTO,1317,16846.43,300472,18349,15568,10972,8224,6281,14505,25477,41045,59394,1783.64,352.57,243.65,151.23
16-06-2021,VILA NOVA DE PAIVA,0,0,0,"[0,120]",Baixo a Moderado,,,,0,Centro,VISEU,1822,17553.28,4687,289,272,233,217,241,458,691,963,1252,26.7,7.13,5.49,3.94
16-06-2021,VILA NOVA DE POIARES,0,0,0,"[0,120]",Baixo a Moderado,,,,0,Centro,COIMBRA,0617,8445.3,6939,380,284,262,235,182,417,679,963,1343,82.17,15.9,11.4,8.04
16-06-2021,VILA POUCA DE AGUIAR,1,0,8,"[0,120]",Baixo a Moderado,,,,1,Norte,VILA REAL,1713,43706.62,11961,860,817,733,601,627,1228,1961,2778,3638,27.37,8.32,6.36,4.49
16-06-2021,VILA REAL,56,4,112,"[0,120]",Baixo a Moderado,,,,56,Norte,VILA REAL,1714,37880.28,49962,3025,2498,2065,1579,1466,3045,5110,7608,10633,131.9,28.07,20.08,13.49
16-06-2021,VILA REAL DE SANTO ANTÓNIO,10,1,53,"[0,120]",Baixo a Moderado,,,,10,Algarve,FARO,0816,6125.0,18749,1172,1069,811,569,586,1155,1966,3035,4207,306.11,68.69,49.55,32.1
16-06-2021,VILA VELHA DE RÓDÃO,0,0,0,"[0,120]",Baixo a Moderado,,,,0,Centro,CASTELO BRANCO,0511,32991.16,3144,209,229,180,283,306,589,769,998,1207,9.53,3.66,3.03,2.33
16-06-2021,VILA VERDE,36,3,77,"[0,120]",Baixo a Moderado,,,,36,Norte,BRAGA,0313,22866.52,46911,2365,2063,1667,1494,1437,2931,4598,6661,9026,205.15,39.47,29.13,20.11
16-06-2021,VILA VIÇOSA,6,0,78,"[0,120]",Baixo a Moderado,,,,6,Alentejo,ÉVORA,0714,19485.89,7656,487,379,342,345,324,669,1011,1390,1877,39.29,9.63,7.13,5.19
16-06-2021,VIMIOSO,5,0,124,"[120,240]",Moderado,,,,5,Norte,BRAGANÇA,0411,48158.51,4023,274,230,261,293,335,628,889,1119,1393,8.35,2.89,2.32,1.85
16-06-2021,VINHAIS,2,0,26,"[0,120]",Baixo a Moderado,,,,2,Norte,BRAGANÇA,0412,69475.09,7746,599,577,636,641,815,1456,2092,2669,3268,11.15,4.7,3.84,3.01
16-06-2021,VISEU,62,4,64,"[0,120]",Baixo a Moderado,,,,62,Centro,VISEU,1823,50710.14,97249,5769,5038,4140,3158,2710,5868,10008,15046,20815,191.77,41.05,29.67,19.74
16-06-2021,VIZELA,5,0,21,"[0,120]",Baixo a Moderado,,,,5,Norte,BRAGA,0314,2469.83,23897,1258,928,655,509,371,880,1535,2463,3721,967.49,150.65,99.72,62.15
16-06-2021,VOUZELA,5,0,52,"[0,120]",Baixo a Moderado,,,,5,Centro,VISEU,1824,19369.46,9619,626,605,554,532,507,1039,1593,2198,2824,49.66,14.58,11.35,8.22
24-06-2021,ABRANTES,37,3,105,"[0,120]",Baixo a Moderado,,,,37,Lisboa e Vale do Tejo,SANTARÉM,1401,71469.08,35130,2473,2213,1730,1748,2021,3769,5499,7712,10185,49.15,14.25,10.79,7.69
24-06-2021,ÁGUEDA,29,2,63,"[0,120]",Baixo a Moderado,,,,29,Centro,AVEIRO,0101,33527.44,46075,3237,2713,2090,1635,1496,3131,5221,7934,11171,137.43,33.32,23.66,15.57
24-06-2021,AGUIAR DA BEIRA,1,0,21,"[0,120]",Baixo a Moderado,,,,1,Centro,GUARDA,0901,20676.57,4652,304,281,235,239,148,387,622,903,1207,22.5,5.84,4.37,3.01
24-06-2021,ALANDROAL,1,0,20,"[0,120]",Baixo a Moderado,,,,1,Alentejo,ÉVORA,0701,54267.81,4992,307,256,296,299,377,676,972,1228,1535,9.2,2.83,2.26,1.79
24-06-2021,ALBERGARIA-A-VELHA,13,1,54,"[0,120]",Baixo a Moderado,,,,13,Centro,AVEIRO,0102,15882.5,24144,1550,1298,996,687,680,1367,2363,3661,5211,152.02,32.81,23.05,14.88
24-06-2021,ALBUFEIRA,205,15,494,"[480,960]",Muito Elevado,,,,205,Algarve,FARO,0801,14066.42,41528,2067,1717,1425,985,858,1843,3268,4985,7052,295.24,50.14,35.44,23.23
24-06-2021,ALCÁCER DO SAL,7,0,60,"[0,120]",Baixo a Moderado,,,,7,Alentejo,SETÚBAL,1501,149987.3,11659,884,814,623,623,602,1225,1848,2662,3546,7.77,2.36,1.77,1.23
24-06-2021,ALCANENA,6,0,47,"[0,120]",Baixo a Moderado,,,,6,Lisboa e Vale do Tejo,SANTARÉM,1402,12732.86,12809,891,744,628,536,588,1124,1752,2496,3387,100.6,26.6,19.6,13.76
24-06-2021,ALCOBAÇA,37,3,69,"[0,120]",Baixo a Moderado,,,,37,Lisboa e Vale do Tejo,LEIRIA,1001,40814.09,53555,3420,2927,2466,2059,1676,3735,6201,9128,12548,131.22,30.74,22.36,15.19
24-06-2021,ALCOCHETE,37,3,187,"[120,240]",Moderado,,,,37,Lisboa e Vale do Tejo,SETÚBAL,1502,12836.48,19787,857,834,691,476,447,923,1614,2448,3305,154.15,25.75,19.07,12.57
24-06-2021,ALCOUTIM,0,0,0,"[0,120]",Baixo a Moderado,,,,0,Algarve,FARO,0802,57536.33,2159,191,188,163,190,267,457,620,808,999,3.75,1.74,1.4,1.08
24-06-2021,ALENQUER,56,4,127,"[120,240]",Moderado,,,,56,Lisboa e Vale do Tejo,LISBOA,1101,30421.92,44052,2298,2062,1629,1330,1155,2485,4114,6176,8474,144.8,27.85,20.3,13.52
24-06-2021,ALFÂNDEGA DA FÉ,0,0,0,"[0,120]",Baixo a Moderado,,,,0,Norte,BRAGANÇA,0401,32194.64,4550,325,277,301,274,325,599,900,1177,1502,14.13,4.67,3.66,2.8
24-06-2021,ALIJÓ,2,0,19,"[0,120]",Baixo a Moderado,,,,2,Norte,VILA REAL,1701,29759.89,10625,766,687,635,542,666,1208,1843,2530,3296,35.7,11.08,8.5,6.19
24-06-2021,ALJEZUR,6,0,107,"[0,120]",Baixo a Moderado,,,,6,Algarve,FARO,0803,32349.95,5594,316,336,335,320,410,730,1065,1401,1717,17.29,5.31,4.33,3.29
24-06-2021,ALJUSTREL,0,0,0,"[0,120]",Baixo a Moderado,,,,0,Alentejo,BEJA,0201,45847.41,8247,635,521,443,347,358,705,1148,1669,2304,17.99,5.03,3.64,2.5
24-06-2021,ALMADA,433,31,256,"[240,480]",Elevado,,,,433,Lisboa e Vale do Tejo,SETÚBAL,1503,7000.89,169039,10469,9777,7876,6144,5111,11255,19131,28908,39377,2414.5,562.45,412.91,273.26
24-06-2021,ALMEIDA,0,0,0,"[0,120]",Baixo a Moderado,,,,0,Centro,GUARDA,0902,51798.46,5830,441,419,396,458,393,851,1247,1666,2107,11.26,4.07,3.22,2.41
24-06-2021,ALMEIRIM,19,1,84,"[0,120]",Baixo a Moderado,,,,19,Lisboa e Vale do Tejo,SANTARÉM,1403,22212.05,22546,1342,1353,1106,866,843,1709,2815,4168,5510,101.5,24.81,18.76,12.67
24-06-2021,ALMODÔVAR,0,0,0,"[0,120]",Baixo a Moderado,,,,0,Alentejo,BEJA,0202,77788.03,6725,414,443,396,373,328,701,1097,1540,1954,8.65,2.51,1.98,1.41
24-06-2021,ALPIARÇA,5,0,71,"[0,120]",Baixo a Moderado,,,,5,Lisboa e Vale do Tejo,SANTARÉM,1404,9536.33,7059,515,486,363,333,274,607,970,1456,1971,74.02,20.67,15.27,10.17
24-06-2021,ALTER DO CHÃO,0,0,0,"[0,120]",Baixo a Moderado,,,,0,Alentejo,PORTALEGRE,1201,36206.62,3165,201,163,136,208,187,395,531,694,895,8.74,2.47,1.92,1.47
24-06-2021,ALVAIÁZERE,8,1,121,"[120,240]",Moderado,,,,8,Centro,LEIRIA,1002,16047.76,6597,419,389,346,406,539,945,1291,1680,2099,41.11,13.08,10.47,8.04
24-06-2021,ALVITO,2,0,81,"[0,120]",Baixo a Moderado,,,,2,Alentejo,BEJA,0203,26485.32,2477,145,110,105,111,89,200,305,415,560,9.35,2.11,1.57,1.15
24-06-2021,AMADORA,503,36,273,"[240,480]",Elevado,,,,503,Lisboa e Vale do Tejo,LISBOA,1115,2378.47,184106,11186,10936,8780,6460,5890,12350,21130,32066,43252,7742.05,1818.84,1348.44,888.56
24-06-2021,AMARANTE,15,1,28,"[0,120]",Baixo a Moderado,,,,15,Norte,PORTO,1301,30133.15,53193,3086,2413,1812,1643,1311,2954,4766,7179,10265,176.53,34.07,23.82,15.82
24-06-2021,AMARES,4,0,22,"[0,120]",Baixo a Moderado,,,,4,Norte,BRAGA,0301,8195.41,18129,1001,829,622,489,524,1013,1635,2464,3465,221.22,42.28,30.07,19.95
24-06-2021,ANADIA,12,1,44,"[0,120]",Baixo a Moderado,,,,12,Centro,AVEIRO,0103,21663.48,27258,1931,1698,1376,1208,1262,2470,3846,5544,7475,125.83,34.51,25.59,17.75
24-06-2021,ANGRA DO HEROÍSMO,7,1,21,"[0,120]",Baixo a Moderado,,,,7,Açores,AÇORES,4301,23899.66,33807,2006,1473,1122,768,635,1403,2525,3998,6004,141.45,25.12,16.73,10.56
24-06-2021,ANSIÃO,5,0,42,"[0,120]",Baixo a Moderado,,,,5,Centro,LEIRIA,1003,17609.42,12039,727,709,646,694,530,1224,1870,2579,3306,68.37,18.77,14.65,10.62
24-06-2021,ARCOS DE VALDEVEZ,4,0,19,"[0,120]",Baixo a Moderado,,,,4,Norte,VIANA DO CASTELO,1601,44759.64,20926,1329,1338,1282,1343,1515,2858,4140,5478,6807,46.75,15.21,12.24,9.25
24-06-2021,ARGANIL,4,0,36,"[0,120]",Baixo a Moderado,,,,4,Centro,COIMBRA,0601,33283.93,11014,672,648,612,559,596,1155,1767,2415,3087,33.09,9.27,7.26,5.31
24-06-2021,ARMAMAR,1,0,17,"[0,120]",Baixo a Moderado,,,,1,Norte,VISEU,1801,11723.73,5769,357,305,309,285,310,595,904,1209,1566,49.21,13.36,10.31,7.71
24-06-2021,AROUCA,16,1,77,"[0,120]",Baixo a Moderado,,,,16,Norte,AVEIRO,0104,32910.52,20720,1306,1047,753,683,683,1366,2119,3166,4472,62.96,13.59,9.62,6.44
24-06-2021,ARRAIOLOS,2,0,29,"[0,120]",Baixo a Moderado,,,,2,Alentejo,ÉVORA,0702,68374.55,6928,435,384,283,367,480,847,1130,1514,1949,10.13,2.85,2.21,1.65
24-06-2021,ARRONCHES,2,0,71,"[0,120]",Baixo a Moderado,,,,2,Alentejo,PORTALEGRE,1202,31464.72,2820,155,142,162,187,179,366,528,670,825,8.96,2.62,2.13,1.68
24-06-2021,ARRUDA DOS VINHOS,30,2,195,"[120,240]",Moderado,,,,30,Lisboa e Vale do Tejo,LISBOA,1102,7795.93,15412,738,738,562,509,438,947,1509,2247,2985,197.69,38.29,28.82,19.36
24-06-2021,AVEIRO,84,6,107,"[0,120]",Baixo a Moderado,,,,84,Centro,AVEIRO,0105,19757.57,78734,4520,4004,3050,2250,2103,4353,7403,11407,15927,398.49,80.61,57.73,37.47
24-06-2021,AVIS,15,1,353,"[240,480]",Elevado,,,,15,Alentejo,PORTALEGRE,1203,60596.51,4247,315,225,206,251,273,524,730,955,1270,7.01,2.1,1.58,1.2
24-06-2021,AZAMBUJA,18,1,79,"[0,120]",Baixo a Moderado,,,,18,Lisboa e Vale do Tejo,LISBOA,1103,26265.65,22716,1322,1171,1070,798,618,1416,2486,3657,4979,86.48,18.96,13.92,9.46
24-06-2021,BAIÃO,1,0,5,"[0,120]",Baixo a Moderado,,,,1,Norte,PORTO,1302,17452.83,18748,1070,862,714,686,725,1411,2125,2987,4057,107.42,23.25,17.11,12.18
24-06-2021,BARCELOS,92,7,79,"[0,120]",Baixo a Moderado,,,,92,Norte,BRAGA,0302,37890.14,116187,6721,5325,3619,2991,2562,5553,9172,14497,21218,306.64,56.0,38.26,24.21
24-06-2021,BARRANCOS,1,0,61,"[0,120]",Baixo a Moderado,,,,1,Alentejo,BEJA,0204,16841.73,1634,90,65,65,94,61,155,220,285,375,9.7,2.23,1.69,1.31
24-06-2021,BARREIRO,221,16,294,"[240,480]",Elevado,,,,221,Lisboa e Vale do Tejo,SETÚBAL,1504,3639.07,75147,5194,5565,4459,3105,1767,4872,9331,14896,20090,2065.05,552.07,409.34,256.42
24-06-2021,BATALHA,9,1,56,"[0,120]",Baixo a Moderado,,,,9,Centro,LEIRIA,1004,10341.6,15963,873,762,649,529,549,1078,1727,2489,3362,154.35,32.51,24.07,16.7
24-06-2021,BEJA,9,1,27,"[0,120]",Baixo a Moderado,,,,9,Alentejo,BEJA,0205,114647.55,33579,2005,1840,1386,1272,1039,2311,3697,5537,7542,29.29,6.58,4.83,3.22
24-06-2021,BELMONTE,0,0,0,"[0,120]",Baixo a Moderado,,,,0,Centro,CASTELO BRANCO,0501,11875.91,6398,444,321,325,310,355,665,990,1311,1755,53.87,14.78,11.04,8.34
24-06-2021,BENAVENTE,27,2,88,"[0,120]",Baixo a Moderado,,,,27,Lisboa e Vale do Tejo,SANTARÉM,1405,52138.39,30602,1468,1376,1141,876,643,1519,2660,4036,5504,58.69,10.56,7.74,5.1
24-06-2021,BOMBARRAL,7,1,56,"[0,120]",Baixo a Moderado,,,,7,Lisboa e Vale do Tejo,LEIRIA,1005,9128.55,12558,875,714,561,491,429,920,1481,2195,3070,137.56,33.63,24.04,16.22
24-06-2021,BORBA,3,0,45,"[0,120]",Baixo a Moderado,,,,3,Alentejo,ÉVORA,0703,14518.65,6736,430,375,279,436,392,828,1107,1482,1912,46.39,13.17,10.21,7.62
24-06-2021,BOTICAS,1,0,20,"[0,120]",Baixo a Moderado,,,,1,Norte,VILA REAL,1702,32195.66,4998,347,306,311,305,380,685,996,1302,1649,15.52,5.12,4.04,3.09
24-06-2021,BRAGA,232,17,127,"[120,240]",Moderado,,,,232,Norte,BRAGA,0303,18339.95,182679,10029,7963,5241,4320,3671,7991,13232,21195,31224,996.07,170.25,115.57,72.15
24-06-2021,BRAGANÇA,7,1,21,"[0,120]",Baixo a Moderado,,,,7,Norte,BRAGANÇA,0402,117357.27,33607,2402,1855,1652,1393,1163,2556,4208,6063,8465,28.64,7.21,5.17,3.59
24-06-2021,CABECEIRAS DE BASTO,0,0,0,"[0,120]",Baixo a Moderado,,,,0,Norte,BRAGA,0304,24182.16,15628,774,594,544,575,574,1149,1693,2287,3061,64.63,12.66,9.46,7.0
24-06-2021,CADAVAL,4,0,29,"[0,120]",Baixo a Moderado,,,,4,Lisboa e Vale do Tejo,LISBOA,1104,17489.3,13673,813,796,756,621,625,1246,2002,2798,3611,78.18,20.65,16.0,11.45
24-06-2021,CALDAS DA RAINHA,49,3,94,"[0,120]",Baixo a Moderado,,,,49,Lisboa e Vale do Tejo,LEIRIA,1006,25569.47,51912,3035,2684,2186,1899,1705,3604,5790,8474,11509,203.03,45.01,33.14,22.64
24-06-2021,CALHETA,14,1,129,"[120,240]",Moderado,,,,14,Madeira,MADEIRA,3101,11150.43,10867,576,497,507,399,415,814,1321,1818,2394,97.46,21.47,16.3,11.85
24-06-2021,CALHETA (AÇORES),0,0,0,"[0,120]",Baixo a Moderado,,,,0,Açores,AÇORES,4501,12626.4,3184,215,159,141,139,122,261,402,561,776,25.22,6.15,4.44,3.18
24-06-2021,CÂMARA DE LOBOS,6,0,18,"[0,120]",Baixo a Moderado,,,,6,Madeira,MADEIRA,3102,5216.67,33675,1396,1059,834,545,381,926,1760,2819,4215,645.49,80.79,54.03,33.74
24-06-2021,CAMINHA,1,0,6,"[0,120]",Baixo a Moderado,,,,1,Norte,VIANA DO CASTELO,1602,13652.14,15877,1046,944,818,646,656,1302,2120,3064,4110,116.3,30.11,22.44,15.53
24-06-2021,CAMPO MAIOR,1,0,13,"[0,120]",Baixo a Moderado,,,,1,Alentejo,PORTALEGRE,1204,24720.16,7874,471,364,351,279,327,606,957,1321,1792,31.85,7.25,5.34,3.87
24-06-2021,CANTANHEDE,17,1,49,"[0,120]",Baixo a Moderado,,,,17,Centro,COIMBRA,0602,39088.02,35011,2346,2096,1880,1709,1451,3160,5040,7136,9482,89.57,24.26,18.26,12.89
24-06-2021,CARRAZEDA DE ANSIÃES,0,0,0,"[0,120]",Baixo a Moderado,,,,0,Norte,BRAGANÇA,0403,27924.09,5666,424,389,391,312,465,777,1168,1557,1981,20.29,7.09,5.58,4.18
24-06-2021,CARREGAL DO SAL,1,0,11,"[0,120]",Baixo a Moderado,,,,1,Centro,VISEU,1802,11689.21,9271,587,562,486,462,376,838,1324,1886,2473,79.31,21.16,16.13,11.33
24-06-2021,CARTAXO,25,2,105,"[0,120]",Baixo a Moderado,,,,25,Lisboa e Vale do Tejo,SANTARÉM,1406,15817.28,23843,1415,1376,1142,861,632,1493,2635,4011,5426,150.74,34.3,25.36,16.66
24-06-2021,CASCAIS,602,43,282,"[240,480]",Elevado,,,,602,Lisboa e Vale do Tejo,LISBOA,1105,9740.17,213608,12151,11444,8680,6469,5248,11717,20397,31841,43992,2193.1,451.66,326.91,209.41
24-06-2021,CASTANHEIRA DE PÊRA,0,0,0,"[0,120]",Baixo a Moderado,,,,0,Centro,LEIRIA,1007,6677.45,2614,233,195,157,190,187,377,534,729,962,39.15,14.41,10.92,8.0
24-06-2021,CASTELO BRANCO,40,3,77,"[0,120]",Baixo a Moderado,,,,40,Centro,CASTELO BRANCO,0502,143819.15,51987,3528,3042,2499,2229,2225,4454,6953,9995,13523,36.15,9.4,6.95,4.83
24-06-2021,CASTELO DE PAIVA,5,0,32,"[0,120]",Baixo a Moderado,,,,5,Norte,AVEIRO,0106,11500.53,15454,881,697,545,420,431,851,1396,2093,2974,134.37,25.86,18.2,12.14
24-06-2021,CASTELO DE VIDE,8,1,274,"[240,480]",Elevado,,,,8,Alentejo,PORTALEGRE,1205,26491.24,2919,204,173,179,147,170,317,496,669,873,11.02,3.3,2.53,1.87
24-06-2021,CASTRO DAIRE,19,1,137,"[120,240]",Moderado,,,,19,Centro,VISEU,1803,37904.13,13823,942,857,765,732,773,1505,2270,3127,4069,36.47,10.74,8.25,5.99
24-06-2021,CASTRO MARIM,1,0,16,"[0,120]",Baixo a Moderado,,,,1,Algarve,FARO,0804,30084.37,6237,370,345,334,322,344,666,1000,1345,1715,20.73,5.7,4.47,3.32
24-06-2021,CASTRO VERDE,0,0,0,"[0,120]",Baixo a Moderado,,,,0,Alentejo,BEJA,0206,56944.23,6949,437,347,303,275,227,502,805,1152,1589,12.2,2.79,2.02,1.41
24-06-2021,CELORICO DA BEIRA,0,0,0,"[0,120]",Baixo a Moderado,,,,0,Centro,GUARDA,0903,24721.63,6928,430,416,363,369,535,904,1267,1683,2113,28.02,8.55,6.81,5.12
24-06-2021,CELORICO DE BASTO,3,0,16,"[0,120]",Baixo a Moderado,,,,3,Norte,BRAGA,0305,18107.02,19040,1001,802,668,728,729,1457,2125,2927,3928,105.15,21.69,16.17,11.74
24-06-2021,CHAMUSCA,11,1,120,"[120,240]",Moderado,,,,11,Lisboa e Vale do Tejo,SANTARÉM,1407,74600.54,9197,629,583,553,465,579,1044,1597,2180,2809,12.33,3.77,2.92,2.14
24-06-2021,CHAVES,16,1,41,"[0,120]",Baixo a Moderado,,,,16,Norte,VILA REAL,1703,59122.95,39343,2676,2429,1991,1886,1918,3804,5795,8224,10900,66.54,18.44,13.91,9.8
24-06-2021,CINFÃES,10,1,55,"[0,120]",Baixo a Moderado,,,,10,Norte,VISEU,1804,23928.76,18244,1067,902,779,734,758,1492,2271,3173,4240,76.24,17.72,13.26,9.49
24-06-2021,COIMBRA,101,7,75,"[0,120]",Baixo a Moderado,,,,101,Centro,COIMBRA,0603,31939.94,134166,9489,8734,6353,5139,5074,10213,16566,25300,34789,420.06,108.92,79.21,51.87
24-06-2021,CONDEIXA-A-NOVA,6,0,34,"[0,120]",Baixo a Moderado,,,,6,Centro,COIMBRA,0604,13867.47,17733,871,809,717,583,490,1073,1790,2599,3470,127.88,25.02,18.74,12.91
24-06-2021,CONSTÂNCIA,20,1,496,"[480,960]",Muito Elevado,,,,20,Lisboa e Vale do Tejo,SANTARÉM,1408,8036.58,4030,211,183,187,148,155,303,490,673,884,50.14,11.0,8.37,6.1
24-06-2021,CORUCHE,9,1,52,"[0,120]",Baixo a Moderado,,,,9,Lisboa e Vale do Tejo,SANTARÉM,1409,111572.03,17471,1294,1090,1095,1096,1019,2115,3210,4300,5594,15.66,5.01,3.85,2.88
24-06-2021,CORVO,0,0,0,"[0,120]",Baixo a Moderado,,,,0,Açores,AÇORES,4901,1711.45,464,22,21,11,13,19,32,43,64,86,27.12,5.03,3.74,2.51
24-06-2021,COVILHÃ,6,0,13,"[0,120]",Baixo a Moderado,,,,6,Centro,CASTELO BRANCO,0503,55560.06,46787,3533,2998,2365,2111,2193,4304,6669,9667,13200,84.21,23.76,17.4,12.0
24-06-2021,CRATO,0,0,0,"[0,120]",Baixo a Moderado,,,,0,Alentejo,PORTALEGRE,1206,39806.88,3129,229,258,163,182,228,410,573,831,1060,7.86,2.66,2.09,1.44
24-06-2021,CUBA,3,0,65,"[0,120]",Baixo a Moderado,,,,3,Alentejo,BEJA,0207,17208.72,4595,255,233,206,190,143,333,539,772,1027,26.7,5.97,4.49,3.13
24-06-2021,ELVAS,10,1,49,"[0,120]",Baixo a Moderado,,,,10,Alentejo,PORTALEGRE,1207,63128.86,20528,1057,1145,902,852,810,1662,2564,3709,4766,32.52,7.55,5.88,4.06
24-06-2021,ENTRONCAMENTO,6,0,28,"[0,120]",Baixo a Moderado,,,,6,Lisboa e Vale do Tejo,SANTARÉM,1410,1372.81,21558,1066,930,868,695,592,1287,2155,3085,4151,1570.14,302.33,224.69,156.96
24-06-2021,ESPINHO,11,1,37,"[0,120]",Baixo a Moderado,,,,11,Norte,AVEIRO,0107,2105.68,29516,2205,1993,1430,1177,960,2137,3567,5560,7765,1401.52,368.71,264.01,169.37
24-06-2021,ESPOSENDE,27,2,79,"[0,120]",Baixo a Moderado,,,,27,Norte,BRAGA,0306,9540.98,34177,1831,1522,1095,894,723,1617,2712,4234,6065,358.21,63.57,44.38,28.42
24-06-2021,ESTARREJA,4,0,15,"[0,120]",Baixo a Moderado,,,,4,Centro,AVEIRO,0108,10817.33,26006,1503,1399,1106,953,728,1681,2787,4186,5689,240.42,52.59,38.7,25.76
24-06-2021,ESTREMOZ,4,0,31,"[0,120]",Baixo a Moderado,,,,4,Alentejo,ÉVORA,0704,51379.95,12728,789,613,697,786,877,1663,2360,2973,3762,24.77,7.32,5.79,4.59
24-06-2021,ÉVORA,40,3,76,"[0,120]",Baixo a Moderado,,,,40,Alentejo,ÉVORA,0705,130707.58,52428,3569,2852,2176,1966,1803,3769,5945,8797,12366,40.11,9.46,6.73,4.55
24-06-2021,FAFE,49,4,102,"[0,120]",Baixo a Moderado,,,,49,Norte,BRAGA,0307,21908.11,48060,3044,2455,1679,1403,1208,2611,4290,6745,9789,219.37,44.68,30.79,19.58
24-06-2021,FARO,116,8,190,"[120,240]",Moderado,,,,116,Algarve,FARO,0805,20256.79,61015,3847,3364,2604,2055,1601,3656,6260,9624,13471,301.2,66.5,47.51,30.9
24-06-2021,FELGUEIRAS,22,2,39,"[0,120]",Baixo a Moderado,,,,22,Norte,PORTO,1303,11573.75,56422,2951,2302,1601,1316,973,2289,3890,6192,9143,487.49,79.0,53.5,33.61
24-06-2021,FERREIRA DO ALENTEJO,1,0,13,"[0,120]",Baixo a Moderado,,,,1,Alentejo,BEJA,0208,64820.68,7845,515,414,372,343,345,688,1060,1474,1989,12.1,3.07,2.27,1.64
24-06-2021,FERREIRA DO ZÊZERE,0,0,0,"[0,120]",Baixo a Moderado,,,,0,Lisboa e Vale do Tejo,SANTARÉM,1411,19038.03,7959,470,370,416,465,456,921,1337,1707,2177,41.81,11.44,8.97,7.02
24-06-2021,FIGUEIRA DA FOZ,34,2,58,"[0,120]",Baixo a Moderado,,,,34,Centro,COIMBRA,0605,37905.26,58747,4032,3597,2887,2495,2043,4538,7425,11022,15054,154.98,39.72,29.08,19.59
24-06-2021,FIGUEIRA DE CASTELO RODRIGO,1,0,18,"[0,120]",Baixo a Moderado,,,,1,Centro,GUARDA,0904,50857.46,5584,347,352,290,352,391,743,1033,1385,1732,10.98,3.41,2.72,2.03
24-06-2021,FIGUEIRÓ DOS VINHOS,0,0,0,"[0,120]",Baixo a Moderado,,,,0,Centro,LEIRIA,1008,17344.0,5568,402,386,322,309,351,660,982,1368,1770,32.1,10.21,7.89,5.66
24-06-2021,FORNOS DE ALGODRES,0,0,0,"[0,120]",Baixo a Moderado,,,,0,Centro,GUARDA,0905,13145.05,4528,261,218,247,256,232,488,735,953,1214,34.45,9.24,7.25,5.59
24-06-2021,FREIXO DE ESPADA À CINTA,0,0,0,"[0,120]",Baixo a Moderado,,,,0,Norte,BRAGANÇA,0404,24414.29,3298,211,177,231,196,189,385,616,793,1004,13.51,4.11,3.25,2.52
24-06-2021,FRONTEIRA,0,0,0,"[0,120]",Baixo a Moderado,,,,0,Alentejo,PORTALEGRE,1208,24859.58,2974,213,182,149,156,168,324,473,655,868,11.96,3.49,2.63,1.9
24-06-2021,FUNCHAL,99,7,95,"[0,120]",Baixo a Moderado,,,,99,Madeira,MADEIRA,3103,7616.2,104024,6382,5086,3643,2821,1990,4811,8454,13540,19922,1365.86,261.58,177.78,111.0
24-06-2021,FUNDÃO,6,0,23,"[0,120]",Baixo a Moderado,,,,6,Centro,CASTELO BRANCO,0504,70019.79,26495,1781,1464,1432,1357,1643,3000,4432,5896,7677,37.84,10.96,8.42,6.33
24-06-2021,GAVIÃO,2,0,61,"[0,120]",Baixo a Moderado,,,,2,Alentejo,PORTALEGRE,1209,29459.45,3263,189,186,222,263,293,556,778,964,1153,11.08,3.91,3.27,2.64
24-06-2021,GÓIS,1,0,26,"[0,120]",Baixo a Moderado,,,,1,Centro,COIMBRA,0606,26330.19,3805,235,199,240,233,244,477,717,916,1151,14.45,4.37,3.48,2.72
24-06-2021,GOLEGÃ,3,0,56,"[0,120]",Baixo a Moderado,,,,3,Lisboa e Vale do Tejo,SANTARÉM,1412,8431.67,5339,356,299,281,243,255,498,779,1078,1434,63.32,17.01,12.78,9.24
24-06-2021,GONDOMAR,139,10,84,"[0,120]",Baixo a Moderado,,,,139,Norte,PORTO,1304,13191.76,165985,10555,8755,6222,4450,3364,7814,14036,22791,33346,1258.22,252.77,172.76,106.4
24-06-2021,GOUVEIA,2,0,16,"[0,120]",Baixo a Moderado,,,,2,Centro,GUARDA,0906,30061.17,12387,871,931,780,783,810,1593,2373,3304,4175,41.21,13.89,10.99,7.89
24-06-2021,GRÂNDOLA,60,4,410,"[240,480]",Elevado,,,,60,Alentejo,SETÚBAL,1505,82593.66,14639,834,834,708,688,672,1360,2068,2902,3736,17.72,4.52,3.51,2.5
24-06-2021,GUARDA,28,2,72,"[0,120]",Baixo a Moderado,,,,28,Centro,GUARDA,0907,71209.58,38969,2477,2041,1686,1415,1474,2889,4575,6616,9093,54.72,12.77,9.29,6.42
24-06-2021,GUIMARÃES,93,7,61,"[0,120]",Baixo a Moderado,,,,93,Norte,BRAGA,0308,24099.96,152309,9394,7074,4809,3877,2948,6825,11634,18708,28102,631.99,116.61,77.63,48.27
24-06-2021,HORTA,6,0,41,"[0,120]",Baixo a Moderado,,,,6,Açores,AÇORES,4701,17305.53,14521,818,658,468,352,302,654,1122,1780,2598,83.91,15.01,10.29,6.48
24-06-2021,IDANHA-A-NOVA,13,1,162,"[120,240]",Moderado,,,,13,Centro,CASTELO BRANCO,0505,141633.51,8043,518,490,519,672,974,1646,2165,2655,3173,5.68,2.24,1.87,1.53
24-06-2021,ÍLHAVO,28,2,72,"[0,120]",Baixo a Moderado,,,,28,Centro,AVEIRO,0110,7347.55,38699,2227,1943,1444,1193,850,2043,3487,5430,7657,526.66,104.21,73.9,47.46
24-06-2021,LAGOA (FARO),33,2,145,"[120,240]",Moderado,,,,33,Algarve,FARO,0806,8825.45,22762,1314,1168,919,749,670,1419,2338,3506,4820,257.93,54.62,39.73,26.49
24-06-2021,LAGOA,78,6,530,"[480,960]",Muito Elevado,,,,78,Açores,AÇORES,4201,4559.32,14721,536,458,349,238,235,473,822,1280,1816,322.9,39.83,28.08,18.03
24-06-2021,LAGOS,72,5,237,"[120,240]",Moderado,,,,72,Algarve,FARO,0807,21299.27,30374,1744,1434,1247,1053,1029,2082,3329,4763,6507,142.61,30.55,22.36,15.63
24-06-2021,LAJES DAS FLORES,0,0,0,"[0,120]",Baixo a Moderado,,,,0,Açores,AÇORES,4801,7004.79,1463,88,53,62,46,54,100,162,215,303,20.89,4.33,3.07,2.31
24-06-2021,LAJES DO PICO,0,0,0,"[0,120]",Baixo a Moderado,,,,0,Açores,AÇORES,4601,15531.09,4490,304,231,223,159,162,321,544,775,1079,28.91,6.95,4.99,3.5
24-06-2021,LAMEGO,5,0,20,"[0,120]",Baixo a Moderado,,,,5,Norte,VISEU,1805,16542.11,24895,1639,1284,1124,898,783,1681,2805,4089,5728,150.5,34.63,24.72,16.96
24-06-2021,LEIRIA,64,5,51,"[0,120]",Baixo a Moderado,,,,64,Centro,LEIRIA,1009,56508.83,125267,7389,6366,5090,3902,3159,7061,12151,18517,25906,221.68,45.84,32.77,21.5
24-06-2021,LISBOA,2232,159,438,"[240,480]",Elevado,,,,2232,Lisboa e Vale do Tejo,LISBOA,1106,10005.43,509515,33197,33340,27706,23037,26770,49807,77513,110853,144050,5092.6,1439.78,1107.98,774.74
24-06-2021,LOULÉ,197,14,287,"[240,480]",Elevado,,,,197,Algarve,FARO,0808,76366.91,68697,3890,3350,2780,2358,2251,4609,7389,10739,14629,89.96,19.16,14.06,9.68
24-06-2021,LOURES,543,39,254,"[240,480]",Elevado,,,,543,Lisboa e Vale do Tejo,LISBOA,1107,16723.99,213687,12746,12794,9644,6669,5033,11702,21346,34140,46886,1277.73,280.35,204.14,127.64
24-06-2021,LOURINHÃ,18,1,70,"[0,120]",Baixo a Moderado,,,,18,Lisboa e Vale do Tejo,LISBOA,1108,14717.2,25855,1584,1243,992,842,645,1487,2479,3722,5306,175.68,36.05,25.29,16.84
24-06-2021,LOUSÃ,16,1,93,"[0,120]",Baixo a Moderado,,,,16,Centro,COIMBRA,0607,13840.01,17158,946,866,658,528,450,978,1636,2502,3448,123.97,24.91,18.08,11.82
24-06-2021,LOUSADA,24,2,51,"[0,120]",Baixo a Moderado,,,,24,Norte,PORTO,1305,9608.01,46755,2289,1698,1176,853,621,1474,2650,4348,6637,486.63,69.08,45.25,27.58
24-06-2021,MAÇÃO,3,0,48,"[0,120]",Baixo a Moderado,,,,3,Lisboa e Vale do Tejo,SANTARÉM,1413,39997.98,6267,386,362,390,440,657,1097,1487,1849,2235,15.67,5.59,4.62,3.72
24-06-2021,MACEDO DE CAVALEIROS,2,0,14,"[0,120]",Baixo a Moderado,,,,2,Norte,BRAGANÇA,0405,69914.08,14516,1082,889,878,823,938,1761,2639,3528,4610,20.76,6.59,5.05,3.77
24-06-2021,MACHICO,3,0,15,"[0,120]",Baixo a Moderado,,,,3,Madeira,MADEIRA,3104,6825.1,19981,1197,860,662,455,331,786,1448,2308,3505,292.76,51.36,33.82,21.22
24-06-2021,MADALENA,1,0,17,"[0,120]",Baixo a Moderado,,,,1,Açores,AÇORES,4602,14712.33,5895,334,256,173,190,179,369,542,798,1132,40.07,7.69,5.42,3.68
24-06-2021,MAFRA,246,18,290,"[240,480]",Elevado,,,,246,Lisboa e Vale do Tejo,LISBOA,1109,29165.5,84816,3613,3334,2839,2089,1899,3988,6827,10161,13774,290.81,47.23,34.84,23.41
24-06-2021,MAIA,64,5,46,"[0,120]",Baixo a Moderado,,,,64,Norte,PORTO,1306,8293.94,138971,7801,6617,4512,3339,2631,5970,10482,17099,24900,1675.56,300.22,206.16,126.38
24-06-2021,MANGUALDE,5,0,27,"[0,120]",Baixo a Moderado,,,,5,Centro,VISEU,1806,21925.56,18510,1198,1128,885,852,743,1595,2480,3608,4806,84.42,21.92,16.46,11.31
24-06-2021,MANTEIGAS,0,0,0,"[0,120]",Baixo a Moderado,,,,0,Centro,GUARDA,0908,12197.55,3007,258,197,159,167,146,313,472,669,927,24.65,7.6,5.48,3.87
24-06-2021,MARCO DE CANAVESES,15,1,29,"[0,120]",Baixo a Moderado,,,,15,Norte,PORTO,1307,20188.98,51496,2678,2060,1488,1265,1023,2288,3776,5836,8514,255.07,42.17,28.91,18.7
24-06-2021,MARINHA GRANDE,22,2,57,"[0,120]",Baixo a Moderado,,,,22,Centro,LEIRIA,1010,18725.19,38508,2365,2302,1638,1359,1058,2417,4055,6357,8722,205.65,46.58,33.95,21.66
24-06-2021,MARVÃO,0,0,0,"[0,120]",Baixo a Moderado,,,,0,Alentejo,PORTALEGRE,1210,15489.9,3005,198,185,142,197,237,434,576,761,959,19.4,6.19,4.91,3.72
24-06-2021,MATOSINHOS,130,9,74,"[0,120]",Baixo a Moderado,,,,130,Norte,PORTO,1308,6241.97,175357,11850,9977,7023,5024,3884,8908,15931,25908,37758,2809.31,604.9,415.06,255.22
24-06-2021,MEALHADA,7,0,35,"[0,120]",Baixo a Moderado,,,,7,Centro,AVEIRO,0111,11065.66,19914,1163,1039,810,828,831,1659,2469,3508,4671,179.96,42.21,31.7,22.31
24-06-2021,MÊDA,1,0,22,"[0,120]",Baixo a Moderado,,,,1,Centro,GUARDA,0909,28604.92,4587,343,306,290,288,443,731,1021,1327,1670,16.04,5.84,4.64,3.57
24-06-2021,MELGAÇO,1,0,12,"[0,120]",Baixo a Moderado,,,,1,Norte,VIANA DO CASTELO,1603,23824.58,8093,507,567,578,614,675,1289,1867,2434,2941,33.97,12.34,10.22,7.84
24-06-2021,MÉRTOLA,0,0,0,"[0,120]",Baixo a Moderado,,,,0,Alentejo,BEJA,0209,129287.34,6142,400,390,378,423,600,1023,1401,1791,2191,4.75,1.69,1.39,1.08
24-06-2021,MESÃO FRIO,0,0,0,"[0,120]",Baixo a Moderado,,,,0,Norte,VILA REAL,1704,2664.87,3964,265,205,168,157,120,277,445,650,915,148.74,34.33,24.39,16.7
24-06-2021,MIRA,33,2,279,"[240,480]",Elevado,,,,33,Centro,COIMBRA,0608,12403.38,11832,727,729,659,550,466,1016,1675,2404,3131,95.4,25.24,19.38,13.5
24-06-2021,MIRANDA DO CORVO,8,1,63,"[0,120]",Baixo a Moderado,,,,8,Centro,COIMBRA,0609,12637.79,12708,706,659,568,498,404,902,1470,2129,2835,100.55,22.43,16.85,11.63
24-06-2021,MIRANDA DO DOURO,1,0,15,"[0,120]",Baixo a Moderado,,,,1,Norte,BRAGANÇA,0406,48718.31,6830,482,429,442,463,470,933,1375,1804,2286,14.02,4.69,3.7,2.82
24-06-2021,MIRANDELA,3,0,14,"[0,120]",Baixo a Moderado,,,,3,Norte,BRAGANÇA,0407,65895.67,21754,1640,1315,1204,1078,947,2025,3229,4544,6184,33.01,9.38,6.9,4.9
24-06-2021,MOGADOURO,0,0,0,"[0,120]",Baixo a Moderado,,,,0,Norte,BRAGANÇA,0408,76064.93,8392,589,529,576,630,655,1285,1861,2390,2979,11.03,3.92,3.14,2.45
24-06-2021,MOIMENTA DA BEIRA,2,0,21,"[0,120]",Baixo a Moderado,,,,2,Norte,VISEU,1807,21996.9,9736,576,514,471,416,461,877,1348,1862,2438,44.26,11.08,8.46,6.13
24-06-2021,MOITA,209,15,324,"[240,480]",Elevado,,,,209,Lisboa e Vale do Tejo,SETÚBAL,1506,5525.98,64407,4226,3646,2623,1801,1425,3226,5849,9495,13721,1165.53,248.3,171.82,105.85
24-06-2021,MONÇÃO,2,0,11,"[0,120]",Baixo a Moderado,,,,2,Norte,VIANA DO CASTELO,1604,21130.85,17869,1161,1105,1031,1006,972,1978,3009,4114,5275,84.56,24.96,19.47,14.24
24-06-2021,MONCHIQUE,1,0,20,"[0,120]",Baixo a Moderado,,,,1,Algarve,FARO,0809,39530.43,5077,353,384,321,355,392,747,1068,1452,1805,12.84,4.57,3.67,2.7
24-06-2021,MONDIM DE BASTO,1,0,14,"[0,120]",Baixo a Moderado,,,,1,Norte,VILA REAL,1705,17207.52,6946,395,300,314,284,283,567,881,1181,1576,40.36,9.16,6.86,5.12
24-06-2021,MONFORTE,1,0,34,"[0,120]",Baixo a Moderado,,,,1,Alentejo,PORTALEGRE,1211,42024.82,2975,139,115,117,192,168,360,477,592,731,7.08,1.74,1.41,1.14
24-06-2021,MONTALEGRE,15,1,167,"[120,240]",Moderado,,,,15,Norte,VILA REAL,1706,80545.71,8997,699,628,595,603,730,1333,1928,2556,3255,11.17,4.04,3.17,2.39
24-06-2021,MONTEMOR-O-NOVO,7,1,45,"[0,120]",Baixo a Moderado,,,,7,Alentejo,ÉVORA,0706,123296.65,15647,991,953,868,878,971,1849,2717,3670,4661,12.69,3.78,2.98,2.2
24-06-2021,MONTEMOR-O-VELHO,20,1,79,"[0,120]",Baixo a Moderado,,,,20,Centro,COIMBRA,0610,22896.23,25224,1496,1397,1217,1057,988,2045,3262,4659,6155,110.17,26.88,20.35,14.25
24-06-2021,MONTIJO,108,8,187,"[120,240]",Moderado,,,,108,Lisboa e Vale do Tejo,SETÚBAL,1507,34861.64,57614,2771,2441,1990,1554,1109,2663,4653,7094,9865,165.26,28.3,20.35,13.35
24-06-2021,MORA,2,0,48,"[0,120]",Baixo a Moderado,,,,2,Alentejo,ÉVORA,0707,44395.02,4138,336,275,252,238,257,495,747,1022,1358,9.32,3.06,2.3,1.68
24-06-2021,MORTÁGUA,1,0,11,"[0,120]",Baixo a Moderado,,,,1,Centro,VISEU,1808,25117.82,8803,638,584,535,499,460,959,1494,2078,2716,35.05,10.81,8.27,5.95
24-06-2021,MOURA,9,1,66,"[0,120]",Baixo a Moderado,,,,9,Alentejo,BEJA,0210,95845.55,13718,817,656,665,542,461,1003,1668,2324,3141,14.31,3.28,2.42,1.74
24-06-2021,MOURÃO,0,0,0,"[0,120]",Baixo a Moderado,,,,0,Alentejo,ÉVORA,0708,27862.98,2450,139,108,80,104,109,213,293,401,540,8.79,1.94,1.44,1.05
24-06-2021,MURÇA,0,0,0,"[0,120]",Baixo a Moderado,,,,0,Norte,VILA REAL,1707,18937.11,5463,384,341,307,306,319,625,932,1273,1657,28.85,8.75,6.72,4.92
24-06-2021,MURTOSA,1,0,10,"[0,120]",Baixo a Moderado,,,,1,Centro,AVEIRO,0112,7308.78,10279,509,473,403,353,409,762,1165,1638,2147,140.63,29.37,22.41,15.94
24-06-2021,NAZARÉ,7,0,49,"[0,120]",Baixo a Moderado,,,,7,Lisboa e Vale do Tejo,LEIRIA,1011,8243.43,14165,967,903,670,420,396,816,1486,2389,3356,171.84,40.71,28.98,18.03
24-06-2021,NELAS,11,1,85,"[0,120]",Baixo a Moderado,,,,11,Centro,VISEU,1809,12571.48,12974,924,787,668,604,583,1187,1855,2642,3566,103.21,28.37,21.02,14.76
24-06-2021,NISA,2,0,33,"[0,120]",Baixo a Moderado,,,,2,Alentejo,PORTALEGRE,1212,57567.84,6061,405,389,355,483,478,961,1316,1705,2110,10.53,3.67,2.96,2.29
24-06-2021,NORDESTE,0,0,0,"[0,120]",Baixo a Moderado,,,,0,Açores,AÇORES,4202,10146.8,4862,246,180,124,161,162,323,447,627,873,47.92,8.6,6.18,4.41
24-06-2021,ÓBIDOS,6,0,51,"[0,120]",Baixo a Moderado,,,,6,Lisboa e Vale do Tejo,LEIRIA,1012,14155.44,11850,743,650,574,452,436,888,1462,2112,2855,83.72,20.17,14.92,10.33
24-06-2021,ODEMIRA,78,6,316,"[240,480]",Elevado,,,,78,Alentejo,BEJA,0211,172060.15,24717,1475,1317,1225,1397,1349,2746,3971,5288,6763,14.37,3.93,3.07,2.31
24-06-2021,ODIVELAS,461,33,285,"[240,480]",Elevado,,,,461,Lisboa e Vale do Tejo,LISBOA,1116,2654.36,161774,9562,9038,6952,4641,3812,8453,15405,24443,34005,6095.48,1281.27,920.99,580.44
24-06-2021,OEIRAS,516,37,291,"[240,480]",Elevado,,,,516,Lisboa e Vale do Tejo,LISBOA,1110,4588.31,177408,11580,11575,8566,6211,5855,12066,20632,32207,43787,3866.78,954.38,701.98,449.69
24-06-2021,OLEIROS,2,0,40,"[0,120]",Baixo a Moderado,,,,2,Centro,CASTELO BRANCO,0506,47109.31,5003,384,341,366,397,487,884,1250,1591,1975,10.62,4.19,3.38,2.65
24-06-2021,OLHÃO,109,8,245,"[240,480]",Elevado,,,,109,Algarve,FARO,0810,13086.38,44405,2455,2309,1689,1342,1268,2610,4299,6608,9063,339.33,69.26,50.5,32.85
24-06-2021,OLIVEIRA DE AZEMÉIS,25,2,38,"[0,120]",Baixo a Moderado,,,,25,Norte,AVEIRO,0113,16110.41,66011,4155,3614,2794,2183,1738,3921,6715,10329,14484,409.75,89.91,64.12,41.68
24-06-2021,OLIVEIRA DE FRADES,20,1,201,"[120,240]",Moderado,,,,20,Centro,VISEU,1810,14534.62,9936,553,475,438,359,415,774,1212,1687,2240,68.36,15.41,11.61,8.34
24-06-2021,OLIVEIRA DO BAIRRO,12,1,49,"[0,120]",Baixo a Moderado,,,,12,Centro,AVEIRO,0114,8731.99,24277,1327,1182,999,786,810,1596,2595,3777,5104,278.02,58.45,43.25,29.72
24-06-2021,OLIVEIRA DO HOSPITAL,9,1,47,"[0,120]",Baixo a Moderado,,,,9,Centro,COIMBRA,0611,23451.66,19253,1161,1097,962,924,960,1884,2846,3943,5104,82.1,21.76,16.81,12.14
24-06-2021,OURÉM,22,2,50,"[0,120]",Baixo a Moderado,,,,22,Lisboa e Vale do Tejo,SANTARÉM,1421,41668.03,44044,2463,2069,1899,1817,1603,3420,5319,7388,9851,105.7,23.64,17.73,12.77
24-06-2021,OURIQUE,0,0,0,"[0,120]",Baixo a Moderado,,,,0,Alentejo,BEJA,0212,66331.36,4607,313,287,284,268,227,495,779,1066,1379,6.95,2.08,1.61,1.17
24-06-2021,OVAR,25,2,46,"[0,120]",Baixo a Moderado,,,,25,Centro,AVEIRO,0115,14770.25,54260,3294,2709,1994,1636,1234,2870,4864,7573,10867,367.37,73.57,51.27,32.93
24-06-2021,PAÇOS DE FERREIRA,29,2,51,"[0,120]",Baixo a Moderado,,,,29,Norte,PORTO,1309,7099.29,56728,2903,2193,1518,1135,664,1799,3317,5510,8413,799.1,118.51,77.62,46.72
24-06-2021,PALMELA,124,9,193,"[120,240]",Moderado,,,,124,Lisboa e Vale do Tejo,SETÚBAL,1508,46512.01,64269,3402,3244,2635,1846,1391,3237,5872,9116,12518,138.18,26.91,19.6,12.62
24-06-2021,PAMPILHOSA DA SERRA,1,0,25,"[0,120]",Baixo a Moderado,,,,1,Centro,COIMBRA,0612,39646.24,4037,238,254,295,339,423,762,1057,1311,1549,10.18,3.91,3.31,2.67
24-06-2021,PAREDES,32,2,37,"[0,120]",Baixo a Moderado,,,,32,Norte,PORTO,1310,15675.69,86067,4272,3532,2412,1717,1258,2975,5387,8919,13191,549.04,84.15,56.9,34.36
24-06-2021,PAREDES DE COURA,21,1,246,"[240,480]",Elevado,,,,21,Norte,VIANA DO CASTELO,1605,13818.59,8535,466,528,407,465,515,980,1387,1915,2381,61.76,17.23,13.86,10.04
24-06-2021,PEDRÓGÃO GRANDE,2,0,59,"[0,120]",Baixo a Moderado,,,,2,Centro,LEIRIA,1013,12874.75,3410,175,173,196,221,252,473,669,842,1017,26.49,7.9,6.54,5.2
24-06-2021,PENACOVA,22,2,161,"[120,240]",Moderado,,,,22,Centro,COIMBRA,0613,21673.23,13694,968,923,745,621,703,1324,2069,2992,3960,63.18,18.27,13.81,9.55
24-06-2021,PENAFIEL,32,2,46,"[0,120]",Baixo a Moderado,,,,32,Norte,PORTO,1311,21224.27,69772,3648,2823,2032,1663,1230,2893,4925,7748,11396,328.74,53.69,36.51,23.2
24-06-2021,PENALVA DO CASTELO,6,0,84,"[0,120]",Baixo a Moderado,,,,6,Centro,VISEU,1811,13433.92,7115,449,457,413,391,426,817,1230,1687,2136,52.96,15.9,12.56,9.16
24-06-2021,PENAMACOR,0,0,0,"[0,120]",Baixo a Moderado,,,,0,Centro,CASTELO BRANCO,0507,56370.69,4755,262,248,273,451,633,1084,1357,1605,1867,8.44,3.31,2.85,2.41
24-06-2021,PENEDONO,0,0,0,"[0,120]",Baixo a Moderado,,,,0,Norte,VISEU,1812,13370.75,2591,172,113,129,156,138,294,423,536,708,19.38,5.3,4.01,3.16
24-06-2021,PENELA,4,0,74,"[0,120]",Baixo a Moderado,,,,4,Centro,COIMBRA,0614,13480.0,5397,314,324,274,359,344,703,977,1301,1615,40.04,11.98,9.65,7.25
24-06-2021,PENICHE,16,1,60,"[0,120]",Baixo a Moderado,,,,16,Lisboa e Vale do Tejo,LEIRIA,1014,7754.98,26501,1746,1504,1203,926,707,1633,2836,4340,6086,341.73,78.48,55.96,36.57
24-06-2021,PESO DA RÉGUA,2,0,13,"[0,120]",Baixo a Moderado,,,,2,Norte,VILA REAL,1708,9486.01,15773,1076,843,650,659,455,1114,1764,2607,3683,166.28,38.83,27.48,18.6
24-06-2021,PINHEL,2,0,23,"[0,120]",Baixo a Moderado,,,,2,Centro,GUARDA,0910,48452.12,8511,577,566,551,538,689,1227,1778,2344,2921,17.57,6.03,4.84,3.67
24-06-2021,POMBAL,22,2,43,"[0,120]",Baixo a Moderado,,,,22,Centro,LEIRIA,1015,62600.28,51461,3187,2791,2494,2328,2027,4355,6849,9640,12827,82.21,20.49,15.4,10.94
24-06-2021,PONTA DELGADA,134,10,197,"[120,240]",Moderado,,,,134,Açores,AÇORES,4203,23298.65,67935,3108,2435,1726,1133,902,2035,3761,6196,9304,291.58,39.93,26.59,16.14
24-06-2021,PONTA DO SOL,2,0,23,"[0,120]",Baixo a Moderado,,,,2,Madeira,MADEIRA,3105,4622.03,8593,319,283,347,208,221,429,776,1059,1378,185.92,29.81,22.91,16.79
24-06-2021,PONTE DA BARCA,5,0,45,"[0,120]",Baixo a Moderado,,,,5,Norte,VIANA DO CASTELO,1606,18211.37,11180,635,576,517,554,490,1044,1561,2137,2772,61.39,15.22,11.73,8.57
24-06-2021,PONTE DE LIMA,11,1,27,"[0,120]",Baixo a Moderado,,,,11,Norte,VIANA DO CASTELO,1607,32025.46,41315,2321,2022,1720,1596,1462,3058,4778,6800,9121,129.01,28.48,21.23,14.92
24-06-2021,PONTE DE SOR,13,1,87,"[0,120]",Baixo a Moderado,,,,13,Alentejo,PORTALEGRE,1213,83971.16,14994,939,800,716,739,831,1570,2286,3086,4025,17.86,4.79,3.68,2.72
24-06-2021,PORTALEGRE,30,2,135,"[120,240]",Moderado,,,,30,Alentejo,PORTALEGRE,1214,44713.64,22172,1577,1351,1137,993,984,1977,3114,4465,6042,49.59,13.51,9.99,6.96
24-06-2021,PORTEL,1,0,17,"[0,120]",Baixo a Moderado,,,,1,Alentejo,ÉVORA,0709,60100.57,5828,336,358,283,331,305,636,919,1277,1613,9.7,2.68,2.12,1.53
24-06-2021,PORTIMÃO,84,6,151,"[120,240]",Moderado,,,,84,Algarve,FARO,0811,18206.29,55483,3182,2927,2116,1582,1400,2982,5098,8025,11207,304.75,61.56,44.08,28.0
24-06-2021,PORTO,271,19,125,"[120,240]",Moderado,,,,271,Norte,PORTO,1312,4142.02,216606,15790,15193,11280,9409,10044,19453,30733,45926,61716,5229.5,1490.0,1108.79,741.98
24-06-2021,PORTO DE MÓS,9,1,39,"[0,120]",Baixo a Moderado,,,,9,Centro,LEIRIA,1016,26183.41,23275,1355,1210,1034,888,872,1760,2794,4004,5359,88.89,20.47,15.29,10.67
24-06-2021,PORTO MONIZ,1,0,43,"[0,120]",Baixo a Moderado,,,,1,Madeira,MADEIRA,3106,8293.38,2342,143,130,95,98,120,218,313,443,586,28.24,7.07,5.34,3.77
24-06-2021,PORTO SANTO,0,0,0,"[0,120]",Baixo a Moderado,,,,0,Madeira,MADEIRA,3201,4300.7,5202,240,157,134,110,68,178,312,469,709,120.95,16.48,10.9,7.25
24-06-2021,PÓVOA DE LANHOSO,4,0,19,"[0,120]",Baixo a Moderado,,,,4,Norte,BRAGA,0309,13465.29,21499,1175,909,732,673,624,1297,2029,2938,4113,159.67,30.55,21.82,15.07
24-06-2021,PÓVOA DE VARZIM,19,1,30,"[0,120]",Baixo a Moderado,,,,19,Norte,PORTO,1313,8220.59,62784,3712,3120,2134,1594,1305,2899,5033,8153,11865,763.7,144.33,99.17,61.22
24-06-2021,POVOAÇÃO,0,0,0,"[0,120]",Baixo a Moderado,,,,0,Açores,AÇORES,4204,10640.77,5927,293,212,191,144,134,278,469,681,974,55.7,9.15,6.4,4.41
24-06-2021,VILA DA PRAIA DA VITÓRIA,4,0,19,"[0,120]",Baixo a Moderado,,,,4,Açores,AÇORES,4302,16127.06,21317,1133,789,619,436,336,772,1391,2180,3313,132.18,20.54,13.52,8.63
24-06-2021,PROENÇA-A-NOVA,1,0,14,"[0,120]",Baixo a Moderado,,,,1,Centro,CASTELO BRANCO,0508,39539.96,7298,508,465,389,400,560,960,1349,1814,2322,18.46,5.87,4.59,3.41
24-06-2021,REDONDO,1,0,16,"[0,120]",Baixo a Moderado,,,,1,Alentejo,ÉVORA,0710,36950.87,6353,349,325,288,288,354,642,930,1255,1604,17.19,4.34,3.4,2.52
24-06-2021,REGUENGOS DE MONSARAZ,10,1,100,"[0,120]",Baixo a Moderado,,,,10,Alentejo,ÉVORA,0711,46399.72,10015,602,511,455,462,473,935,1390,1901,2503,21.58,5.39,4.1,3.0
24-06-2021,RESENDE,4,0,39,"[0,120]",Baixo a Moderado,,,,4,Norte,VISEU,1813,12334.93,10137,560,493,448,433,422,855,1303,1796,2356,82.18,19.1,14.56,10.56
24-06-2021,RIBEIRA BRAVA,0,0,0,"[0,120]",Baixo a Moderado,,,,0,Madeira,MADEIRA,3107,6544.88,12435,648,500,411,311,287,598,1009,1509,2157,189.99,32.96,23.06,15.42
24-06-2021,RIBEIRA DE PENA,4,0,66,"[0,120]",Baixo a Moderado,,,,4,Norte,VILA REAL,1709,21745.98,6016,371,301,290,310,368,678,968,1269,1640,27.66,7.54,5.84,4.45
24-06-2021,RIBEIRA GRANDE,139,10,424,"[240,480]",Elevado,,,,139,Açores,AÇORES,4205,18015.13,32811,1163,689,512,345,253,598,1110,1799,2962,182.13,16.44,9.99,6.16
24-06-2021,RIO MAIOR,48,3,236,"[120,240]",Moderado,,,,48,Lisboa e Vale do Tejo,SANTARÉM,1414,27276.45,20379,1251,1144,941,795,648,1443,2384,3528,4779,74.71,17.52,12.93,8.74
24-06-2021,SABROSA,3,0,51,"[0,120]",Baixo a Moderado,,,,3,Norte,VILA REAL,1710,15692.45,5918,393,314,304,302,350,652,956,1270,1663,37.71,10.6,8.09,6.09
24-06-2021,SABUGAL,1,0,9,"[0,120]",Baixo a Moderado,,,,1,Centro,GUARDA,0911,82269.82,10585,724,707,694,796,1009,1805,2499,3206,3930,12.87,4.78,3.9,3.04
24-06-2021,SALVATERRA DE MAGOS,25,2,117,"[0,120]",Baixo a Moderado,,,,25,Lisboa e Vale do Tejo,SANTARÉM,1415,24393.2,21295,1275,1181,1060,799,772,1571,2631,3812,5087,87.3,20.85,15.63,10.79
24-06-2021,SANTA COMBA DÃO,1,0,10,"[0,120]",Baixo a Moderado,,,,1,Centro,VISEU,1814,11194.77,10452,732,684,569,538,464,1002,1571,2255,2987,93.36,26.68,20.14,14.03
24-06-2021,SANTA CRUZ,15,1,33,"[0,120]",Baixo a Moderado,,,,15,Madeira,MADEIRA,3108,8150.28,45281,1817,1301,974,716,523,1239,2213,3514,5331,555.6,65.41,43.12,27.15
24-06-2021,SANTA CRUZ DA GRACIOSA,3,0,71,"[0,120]",Baixo a Moderado,,,,3,Açores,AÇORES,4401,6065.78,4208,228,180,163,124,145,269,432,612,840,69.37,13.85,10.09,7.12
24-06-2021,SANTA CRUZ DAS FLORES,0,0,0,"[0,120]",Baixo a Moderado,,,,0,Açores,AÇORES,4802,7091.44,2165,125,98,74,56,51,107,181,279,404,30.53,5.7,3.93,2.55
24-06-2021,SANTA MARIA DA FEIRA,69,5,50,"[0,120]",Baixo a Moderado,,,,69,Norte,AVEIRO,0109,21587.65,138636,8182,6743,4771,3856,3079,6935,11706,18449,26631,642.19,123.36,85.46,54.22
24-06-2021,SANTA MARTA DE PENAGUIÃO,3,0,45,"[0,120]",Baixo a Moderado,,,,3,Norte,VILA REAL,1711,6928.13,6599,483,373,337,316,317,633,970,1343,1826,95.25,26.36,19.39,14.0
24-06-2021,SANTANA,2,0,30,"[0,120]",Baixo a Moderado,,,,2,Madeira,MADEIRA,3109,9547.3,6711,418,353,343,282,277,559,902,1255,1673,70.29,17.52,13.15,9.45
24-06-2021,SANTARÉM,77,5,134,"[120,240]",Moderado,,,,77,Lisboa e Vale do Tejo,SANTARÉM,1416,55253.58,57421,3654,3441,2760,2466,2206,4672,7432,10873,14527,103.92,26.29,19.68,13.45
24-06-2021,SANTIAGO DO CACÉM,26,2,90,"[0,120]",Baixo a Moderado,,,,26,Alentejo,SETÚBAL,1509,105969.29,28791,2144,1689,1472,1295,1215,2510,3982,5671,7815,27.17,7.37,5.35,3.76
24-06-2021,SANTO TIRSO,77,5,113,"[0,120]",Baixo a Moderado,,,,77,Norte,PORTO,1314,13655.52,68055,4911,3935,2761,2257,1810,4067,6828,10763,15674,498.35,114.78,78.82,50.0
24-06-2021,SÃO BRÁS DE ALPORTEL,24,2,230,"[120,240]",Moderado,,,,24,Algarve,FARO,0812,15336.92,10416,596,468,467,404,401,805,1272,1740,2336,67.91,15.23,11.35,8.29
24-06-2021,SÃO JOÃO DA MADEIRA,6,0,27,"[0,120]",Baixo a Moderado,,,,6,Norte,AVEIRO,0116,794.3,21958,1347,1069,796,601,593,1194,1990,3059,4406,2765.49,554.91,385.26,250.63
24-06-2021,SÃO JOÃO DA PESQUEIRA,0,0,0,"[0,120]",Baixo a Moderado,,,,0,Norte,VISEU,1815,26610.85,7125,417,330,294,328,328,656,950,1280,1697,26.77,6.38,4.81,3.57
24-06-2021,SÃO PEDRO DO SUL,2,0,13,"[0,120]",Baixo a Moderado,,,,2,Centro,VISEU,1816,34895.09,15403,990,962,861,759,909,1668,2529,3491,4481,44.14,12.84,10.0,7.25
24-06-2021,SÃO ROQUE DO PICO,0,0,0,"[0,120]",Baixo a Moderado,,,,0,Açores,AÇORES,4603,14236.1,3266,199,141,93,96,113,209,302,443,642,22.94,4.51,3.11,2.12
24-06-2021,SÃO VICENTE,1,0,19,"[0,120]",Baixo a Moderado,,,,1,Madeira,MADEIRA,3110,7883.71,5143,272,264,266,225,280,505,771,1035,1307,65.23,16.58,13.13,9.78
24-06-2021,SARDOAL,17,1,454,"[240,480]",Elevado,,,,17,Lisboa e Vale do Tejo,SANTARÉM,1417,9214.72,3741,227,178,148,165,248,413,561,739,966,40.6,10.48,8.02,6.09
24-06-2021,SÁTÃO,1,0,9,"[0,120]",Baixo a Moderado,,,,1,Centro,VISEU,1817,20194.11,11580,765,671,515,465,476,941,1456,2127,2892,57.34,14.32,10.53,7.21
24-06-2021,SEIA,9,1,40,"[0,120]",Baixo a Moderado,,,,9,Centro,GUARDA,0912,43568.83,22234,1807,1589,1238,1122,721,1843,3081,4670,6477,51.03,14.87,10.72,7.07
24-06-2021,SEIXAL,485,35,289,"[240,480]",Elevado,,,,485,Lisboa e Vale do Tejo,SETÚBAL,1510,9545.17,167752,10586,9270,6661,4391,2930,7321,13982,23252,33838,1757.49,354.51,243.6,146.49
24-06-2021,SERNANCELHE,1,0,19,"[0,120]",Baixo a Moderado,,,,1,Norte,VISEU,1818,22861.22,5396,305,293,286,273,260,533,819,1112,1417,23.6,6.2,4.86,3.58
24-06-2021,SERPA,3,0,21,"[0,120]",Baixo a Moderado,,,,3,Alentejo,BEJA,0213,110563.34,14304,903,761,719,697,626,1323,2042,2803,3706,12.94,3.35,2.54,1.85
24-06-2021,SERTÃ,16,1,110,"[0,120]",Baixo a Moderado,,,,16,Centro,CASTELO BRANCO,0509,44673.17,14577,870,779,790,767,1020,1787,2577,3356,4226,32.63,9.46,7.51,5.77
24-06-2021,SESIMBRA,203,14,391,"[240,480]",Elevado,,,,203,Lisboa e Vale do Tejo,SETÚBAL,1511,19571.75,51858,2400,2321,1853,1257,1083,2340,4193,6514,8914,264.96,45.54,33.28,21.42
24-06-2021,SETÚBAL,208,15,181,"[120,240]",Moderado,,,,208,Lisboa e Vale do Tejo,SETÚBAL,1512,23032.5,115126,7425,6929,5075,3775,2655,6430,11505,18434,25859,499.83,112.27,80.03,49.95
24-06-2021,SEVER DO VOUGA,4,0,35,"[0,120]",Baixo a Moderado,,,,4,Centro,AVEIRO,0117,12987.56,11331,766,637,568,540,567,1107,1675,2312,3078,87.24,23.7,17.8,12.9
24-06-2021,SILVES,45,3,124,"[120,240]",Moderado,,,,45,Algarve,FARO,0813,68006.23,36226,2137,1869,1610,1423,1600,3023,4633,6502,8639,53.27,12.7,9.56,6.81
24-06-2021,SINES,33,2,241,"[240,480]",Elevado,,,,33,Alentejo,SETÚBAL,1513,20330.17,13715,888,791,551,416,268,684,1235,2026,2914,67.46,14.33,9.97,6.07
24-06-2021,SINTRA,975,70,249,"[240,480]",Elevado,,,,975,Lisboa e Vale do Tejo,LISBOA,1111,31922.73,391402,20490,18316,13545,9137,7284,16421,29966,48282,68772,1226.08,215.43,151.25,93.87
24-06-2021,SOBRAL DE MONTE AGRAÇO,30,2,282,"[240,480]",Elevado,,,,30,Lisboa e Vale do Tejo,LISBOA,1112,5210.32,10651,564,507,352,272,212,484,836,1343,1907,204.43,36.6,25.78,16.05
24-06-2021,SOURE,2,0,12,"[0,120]",Baixo a Moderado,,,,2,Centro,COIMBRA,0615,26506.07,17120,1173,1142,1004,883,987,1870,2874,4016,5189,64.59,19.58,15.15,10.84
24-06-2021,SOUSEL,15,1,340,"[240,480]",Elevado,,,,15,Alentejo,PORTALEGRE,1215,27932.18,4412,261,274,208,302,292,594,802,1076,1337,15.8,4.79,3.85,2.87
24-06-2021,TÁBUA,3,0,26,"[0,120]",Baixo a Moderado,,,,3,Centro,COIMBRA,0616,19978.58,11368,729,584,524,430,464,894,1418,2002,2731,56.9,13.67,10.02,7.1
24-06-2021,TABUAÇO,1,0,17,"[0,120]",Baixo a Moderado,,,,1,Norte,VISEU,1819,13385.67,6033,372,314,217,282,363,645,862,1176,1548,45.07,11.56,8.79,6.44
24-06-2021,TAROUCA,1,0,13,"[0,120]",Baixo a Moderado,,,,1,Norte,VISEU,1820,10008.49,7804,405,335,313,277,324,601,914,1249,1654,77.98,16.53,12.48,9.13
24-06-2021,TAVIRA,11,1,45,"[0,120]",Baixo a Moderado,,,,11,Algarve,FARO,0814,60696.7,24530,1493,1415,1252,1066,1277,2343,3595,5010,6503,40.41,10.71,8.25,5.92
24-06-2021,TERRAS DE BOURO,1,0,16,"[0,120]",Baixo a Moderado,,,,1,Norte,BRAGA,0310,27746.07,6361,391,372,296,319,340,659,955,1327,1718,22.93,6.19,4.78,3.44
24-06-2021,TOMAR,13,1,35,"[0,120]",Baixo a Moderado,,,,13,Lisboa e Vale do Tejo,SANTARÉM,1418,35120.44,36748,2403,2189,1868,1853,1822,3675,5543,7732,10135,104.64,28.86,22.02,15.78
24-06-2021,TONDELA,22,2,83,"[0,120]",Baixo a Moderado,,,,22,Centro,VISEU,1821,37121.73,26357,1768,1722,1518,1475,1417,2892,4410,6132,7900,71.0,21.28,16.52,11.88
24-06-2021,TORRE DE MONCORVO,6,0,78,"[0,120]",Baixo a Moderado,,,,6,Norte,BRAGANÇA,0409,53155.67,7695,556,478,488,551,719,1270,1758,2236,2792,14.48,5.25,4.21,3.31
24-06-2021,TORRES NOVAS,16,1,46,"[0,120]",Baixo a Moderado,,,,16,Lisboa e Vale do Tejo,SANTARÉM,1419,26999.68,34933,2324,1979,1738,1406,1475,2881,4619,6598,8922,129.38,33.04,24.44,17.11
24-06-2021,TORRES VEDRAS,100,7,127,"[120,240]",Moderado,,,,100,Lisboa e Vale do Tejo,LISBOA,1113,40714.89,78530,4513,3945,3447,2628,2104,4732,8179,12124,16637,192.88,40.86,29.78,20.09
24-06-2021,TRANCOSO,18,1,203,"[120,240]",Moderado,,,,18,Centro,GUARDA,0913,36152.47,8875,581,557,542,586,496,1082,1624,2181,2762,24.55,7.64,6.03,4.49
24-06-2021,TROFA,37,3,96,"[0,120]",Baixo a Moderado,,,,37,Norte,PORTO,1318,7201.76,38418,2336,1894,1231,939,684,1623,2854,4748,7084,533.44,98.36,65.93,39.63
24-06-2021,VAGOS,17,1,75,"[0,120]",Baixo a Moderado,,,,17,Centro,AVEIRO,0118,16491.5,22740,1320,1205,922,784,724,1508,2430,3635,4955,137.89,30.04,22.04,14.73
24-06-2021,VALE DE CAMBRA,5,0,23,"[0,120]",Baixo a Moderado,,,,5,Norte,AVEIRO,0119,14733.47,21327,1491,1363,1005,831,798,1629,2634,3997,5488,144.76,37.25,27.13,17.88
24-06-2021,VALENÇA,0,0,0,"[0,120]",Baixo a Moderado,,,,0,Norte,VIANA DO CASTELO,1608,11712.86,13290,867,791,582,582,503,1085,1667,2458,3325,113.46,28.39,20.99,14.23
24-06-2021,VALONGO,35,3,36,"[0,120]",Baixo a Moderado,,,,35,Norte,PORTO,1315,7512.45,97444,5629,4696,3207,2462,1829,4291,7498,12194,17823,1297.18,237.26,162.33,99.81
24-06-2021,VALPAÇOS,9,1,61,"[0,120]",Baixo a Moderado,,,,9,Norte,VILA REAL,1712,54873.93,14818,1217,1118,999,928,997,1925,2924,4042,5259,27.0,9.58,7.37,5.33
24-06-2021,VELAS,1,0,20,"[0,120]",Baixo a Moderado,,,,1,Açores,AÇORES,4502,11738.38,5093,278,208,166,153,113,266,432,640,918,43.39,7.82,5.45,3.68
24-06-2021,VENDAS NOVAS,3,0,27,"[0,120]",Baixo a Moderado,,,,3,Alentejo,ÉVORA,0712,22238.88,11255,677,768,655,501,532,1033,1688,2456,3133,50.61,14.09,11.04,7.59
24-06-2021,VIANA DO ALENTEJO,1,0,19,"[0,120]",Baixo a Moderado,,,,1,Alentejo,ÉVORA,0713,39367.29,5145,245,208,235,210,214,424,659,867,1112,13.07,2.82,2.2,1.67
24-06-2021,VIANA DO CASTELO,24,2,28,"[0,120]",Baixo a Moderado,,,,24,Norte,VIANA DO CASTELO,1609,31902.01,84417,5470,4433,3591,3061,2982,6043,9634,14067,19537,264.61,61.24,44.09,30.2
24-06-2021,VIDIGUEIRA,1,0,18,"[0,120]",Baixo a Moderado,,,,1,Alentejo,BEJA,0214,31661.09,5510,300,248,215,233,275,508,723,971,1271,17.4,4.01,3.07,2.28
24-06-2021,VIEIRA DO MINHO,2,0,17,"[0,120]",Baixo a Moderado,,,,2,Norte,BRAGA,0311,21644.35,11842,703,594,525,548,482,1030,1555,2149,2852,54.71,13.18,9.93,7.18
24-06-2021,VILA DE REI,2,0,60,"[0,120]",Baixo a Moderado,,,,2,Centro,CASTELO BRANCO,0510,19154.6,3323,169,128,172,247,302,549,721,849,1018,17.35,5.31,4.43,3.76
24-06-2021,VILA DO BISPO,3,0,58,"[0,120]",Baixo a Moderado,,,,3,Algarve,FARO,0815,17906.06,5154,302,302,314,232,233,465,779,1081,1383,28.78,7.72,6.04,4.35
24-06-2021,VILA DO CONDE,29,2,36,"[0,120]",Baixo a Moderado,,,,29,Norte,PORTO,1316,14902.77,79899,4726,3875,2819,2070,1743,3813,6632,10507,15233,536.13,102.21,70.5,44.5
24-06-2021,VILA DO PORTO,1,0,18,"[0,120]",Baixo a Moderado,,,,1,Açores,AÇORES,4101,9688.74,5616,274,212,135,96,123,219,354,566,840,57.96,8.67,5.84,3.65
24-06-2021,VILA FLOR,1,0,17,"[0,120]",Baixo a Moderado,,,,1,Norte,BRAGANÇA,0410,26581.14,6044,429,362,422,294,331,625,1047,1409,1838,22.74,6.91,5.3,3.94
24-06-2021,VILA FRANCA DE XIRA,305,22,215,"[120,240]",Moderado,,,,305,Lisboa e Vale do Tejo,LISBOA,1114,31819.39,141957,8501,6852,4869,3425,2472,5897,10766,17618,26119,446.14,82.09,55.37,33.84
24-06-2021,VILA FRANCA DO CAMPO,6,0,54,"[0,120]",Baixo a Moderado,,,,6,Açores,AÇORES,4206,7796.82,11051,450,344,248,217,154,371,619,963,1413,141.73,18.12,12.35,7.94
24-06-2021,VILA NOVA DA BARQUINHA,5,0,67,"[0,120]",Baixo a Moderado,,,,5,Lisboa e Vale do Tejo,SANTARÉM,1420,4952.97,7461,415,406,392,364,338,702,1094,1500,1915,150.64,38.66,30.28,22.09
24-06-2021,VILA NOVA DE CERVEIRA,1,0,11,"[0,120]",Baixo a Moderado,,,,1,Norte,VIANA DO CASTELO,1610,10846.66,8910,531,444,410,384,334,718,1128,1572,2103,82.14,19.39,14.49,10.4
24-06-2021,VILA NOVA DE FAMALICÃO,119,8,90,"[0,120]",Baixo a Moderado,,,,119,Norte,BRAGA,0312,20159.26,131676,7817,6164,4202,3282,2749,6031,10233,16397,24214,653.19,120.12,81.34,50.76
24-06-2021,VILA NOVA DE FOZ CÔA,2,0,31,"[0,120]",Baixo a Moderado,,,,2,Centro,GUARDA,0914,39815.18,6503,442,385,390,398,429,827,1217,1602,2044,16.33,5.13,4.02,3.06
24-06-2021,VILA NOVA DE GAIA,291,21,97,"[0,120]",Baixo a Moderado,,,,291,Norte,PORTO,1317,16846.43,300472,18349,15568,10972,8224,6281,14505,25477,41045,59394,1783.64,352.57,243.65,151.23
24-06-2021,VILA NOVA DE PAIVA,0,0,0,"[0,120]",Baixo a Moderado,,,,0,Centro,VISEU,1822,17553.28,4687,289,272,233,217,241,458,691,963,1252,26.7,7.13,5.49,3.94
24-06-2021,VILA NOVA DE POIARES,2,0,29,"[0,120]",Baixo a Moderado,,,,2,Centro,COIMBRA,0617,8445.3,6939,380,284,262,235,182,417,679,963,1343,82.17,15.9,11.4,8.04
24-06-2021,VILA POUCA DE AGUIAR,6,0,50,"[0,120]",Baixo a Moderado,,,,6,Norte,VILA REAL,1713,43706.62,11961,860,817,733,601,627,1228,1961,2778,3638,27.37,8.32,6.36,4.49
24-06-2021,VILA REAL,46,3,92,"[0,120]",Baixo a Moderado,,,,46,Norte,VILA REAL,1714,37880.28,49962,3025,2498,2065,1579,1466,3045,5110,7608,10633,131.9,28.07,20.08,13.49
24-06-2021,VILA REAL DE SANTO ANTÓNIO,5,0,27,"[0,120]",Baixo a Moderado,,,,5,Algarve,FARO,0816,6125.0,18749,1172,1069,811,569,586,1155,1966,3035,4207,306.11,68.69,49.55,32.1
24-06-2021,VILA VELHA DE RÓDÃO,0,0,0,"[0,120]",Baixo a Moderado,,,,0,Centro,CASTELO BRANCO,0511,32991.16,3144,209,229,180,283,306,589,769,998,1207,9.53,3.66,3.03,2.33
24-06-2021,VILA VERDE,34,2,72,"[0,120]",Baixo a Moderado,,,,34,Norte,BRAGA,0313,22866.52,46911,2365,2063,1667,1494,1437,2931,4598,6661,9026,205.15,39.47,29.13,20.11
24-06-2021,VILA VIÇOSA,3,0,39,"[0,120]",Baixo a Moderado,,,,3,Alentejo,ÉVORA,0714,19485.89,7656,487,379,342,345,324,669,1011,1390,1877,39.29,9.63,7.13,5.19
24-06-2021,VIMIOSO,3,0,75,"[0,120]",Baixo a Moderado,,,,3,Norte,BRAGANÇA,0411,48158.51,4023,274,230,261,293,335,628,889,1119,1393,8.35,2.89,2.32,1.85
24-06-2021,VINHAIS,0,0,0,"[0,120]",Baixo a Moderado,,,,0,Norte,BRAGANÇA,0412,69475.09,7746,599,577,636,641,815,1456,2092,2669,3268,11.15,4.7,3.84,3.01
24-06-2021,VISEU,75,5,77,"[0,120]",Baixo a Moderado,,,,75,Centro,VISEU,1823,50710.14,97249,5769,5038,4140,3158,2710,5868,10008,15046,20815,191.77,41.05,29.67,19.74
24-06-2021,VIZELA,4,0,17,"[0,120]",Baixo a Moderado,,,,4,Norte,BRAGA,0314,2469.83,23897,1258,928,655,509,371,880,1535,2463,3721,967.49,150.65,99.72,62.15
24-06-2021,VOUZELA,6,0,62,"[0,120]",Baixo a Moderado,,,,6,Centro,VISEU,1824,19369.46,9619,626,605,554,532,507,1039,1593,2198,2824,49.66,14.58,11.35,8.22
01-07-2021,ABRANTES,42,3,120,"[120,240]",Moderado,,,,42,Lisboa e Vale do Tejo,SANTARÉM,1401,71469.08,35130,2473,2213,1730,1748,2021,3769,5499,7712,10185,49.15,14.25,10.79,7.69
01-07-2021,ÁGUEDA,46,3,99,"[0,120]",Baixo a Moderado,,,,46,Centro,AVEIRO,0101,33527.44,46075,3237,2713,2090,1635,1496,3131,5221,7934,11171,137.43,33.32,23.66,15.57
01-07-2021,AGUIAR DA BEIRA,0,0,0,"[0,120]",Baixo a Moderado,,,,0,Centro,GUARDA,0901,20676.57,4652,304,281,235,239,148,387,622,903,1207,22.5,5.84,4.37,3.01
01-07-2021,ALANDROAL,1,0,20,"[0,120]",Baixo a Moderado,,,,1,Alentejo,ÉVORA,0701,54267.81,4992,307,256,296,299,377,676,972,1228,1535,9.2,2.83,2.26,1.79
01-07-2021,ALBERGARIA-A-VELHA,30,2,123,"[120,240]",Moderado,,,,30,Centro,AVEIRO,0102,15882.5,24144,1550,1298,996,687,680,1367,2363,3661,5211,152.02,32.81,23.05,14.88
01-07-2021,ALBUFEIRA,342,24,823,"[480,960]",Muito Elevado,,,,342,Algarve,FARO,0801,14066.42,41528,2067,1717,1425,985,858,1843,3268,4985,7052,295.24,50.14,35.44,23.23
01-07-2021,ALCÁCER DO SAL,6,0,52,"[0,120]",Baixo a Moderado,,,,6,Alentejo,SETÚBAL,1501,149987.3,11659,884,814,623,623,602,1225,1848,2662,3546,7.77,2.36,1.77,1.23
01-07-2021,ALCANENA,11,1,85,"[0,120]",Baixo a Moderado,,,,11,Lisboa e Vale do Tejo,SANTARÉM,1402,12732.86,12809,891,744,628,536,588,1124,1752,2496,3387,100.6,26.6,19.6,13.76
01-07-2021,ALCOBAÇA,42,3,78,"[0,120]",Baixo a Moderado,,,,42,Lisboa e Vale do Tejo,LEIRIA,1001,40814.09,53555,3420,2927,2466,2059,1676,3735,6201,9128,12548,131.22,30.74,22.36,15.19
01-07-2021,ALCOCHETE,49,3,246,"[240,480]",Elevado,,,,49,Lisboa e Vale do Tejo,SETÚBAL,1502,12836.48,19787,857,834,691,476,447,923,1614,2448,3305,154.15,25.75,19.07,12.57
01-07-2021,ALCOUTIM,0,0,0,"[0,120]",Baixo a Moderado,,,,0,Algarve,FARO,0802,57536.33,2159,191,188,163,190,267,457,620,808,999,3.75,1.74,1.4,1.08
01-07-2021,ALENQUER,76,5,172,"[120,240]",Moderado,,,,76,Lisboa e Vale do Tejo,LISBOA,1101,30421.92,44052,2298,2062,1629,1330,1155,2485,4114,6176,8474,144.8,27.85,20.3,13.52
01-07-2021,ALFÂNDEGA DA FÉ,0,0,0,"[0,120]",Baixo a Moderado,,,,0,Norte,BRAGANÇA,0401,32194.64,4550,325,277,301,274,325,599,900,1177,1502,14.13,4.67,3.66,2.8
01-07-2021,ALIJÓ,2,0,19,"[0,120]",Baixo a Moderado,,,,2,Norte,VILA REAL,1701,29759.89,10625,766,687,635,542,666,1208,1843,2530,3296,35.7,11.08,8.5,6.19
01-07-2021,ALJEZUR,7,0,125,"[120,240]",Moderado,,,,7,Algarve,FARO,0803,32349.95,5594,316,336,335,320,410,730,1065,1401,1717,17.29,5.31,4.33,3.29
01-07-2021,ALJUSTREL,1,0,12,"[0,120]",Baixo a Moderado,,,,1,Alentejo,BEJA,0201,45847.41,8247,635,521,443,347,358,705,1148,1669,2304,17.99,5.03,3.64,2.5
01-07-2021,ALMADA,654,47,387,"[240,480]",Elevado,,,,654,Lisboa e Vale do Tejo,SETÚBAL,1503,7000.89,169039,10469,9777,7876,6144,5111,11255,19131,28908,39377,2414.5,562.45,412.91,273.26
01-07-2021,ALMEIDA,1,0,17,"[0,120]",Baixo a Moderado,,,,1,Centro,GUARDA,0902,51798.46,5830,441,419,396,458,393,851,1247,1666,2107,11.26,4.07,3.22,2.41
01-07-2021,ALMEIRIM,22,2,98,"[0,120]",Baixo a Moderado,,,,22,Lisboa e Vale do Tejo,SANTARÉM,1403,22212.05,22546,1342,1353,1106,866,843,1709,2815,4168,5510,101.5,24.81,18.76,12.67
01-07-2021,ALMODÔVAR,3,0,45,"[0,120]",Baixo a Moderado,,,,3,Alentejo,BEJA,0202,77788.03,6725,414,443,396,373,328,701,1097,1540,1954,8.65,2.51,1.98,1.41
01-07-2021,ALPIARÇA,8,1,115,"[0,120]",Baixo a Moderado,,,,8,Lisboa e Vale do Tejo,SANTARÉM,1404,9536.33,7059,515,486,363,333,274,607,970,1456,1971,74.02,20.67,15.27,10.17
01-07-2021,ALTER DO CHÃO,0,0,0,"[0,120]",Baixo a Moderado,,,,0,Alentejo,PORTALEGRE,1201,36206.62,3165,201,163,136,208,187,395,531,694,895,8.74,2.47,1.92,1.47
01-07-2021,ALVAIÁZERE,8,1,121,"[120,240]",Moderado,,,,8,Centro,LEIRIA,1002,16047.76,6597,419,389,346,406,539,945,1291,1680,2099,41.11,13.08,10.47,8.04
01-07-2021,ALVITO,1,0,41,"[0,120]",Baixo a Moderado,,,,1,Alentejo,BEJA,0203,26485.32,2477,145,110,105,111,89,200,305,415,560,9.35,2.11,1.57,1.15
01-07-2021,AMADORA,690,49,375,"[240,480]",Elevado,,,,690,Lisboa e Vale do Tejo,LISBOA,1115,2378.47,184106,11186,10936,8780,6460,5890,12350,21130,32066,43252,7742.05,1818.84,1348.44,888.56
01-07-2021,AMARANTE,23,2,43,"[0,120]",Baixo a Moderado,,,,23,Norte,PORTO,1301,30133.15,53193,3086,2413,1812,1643,1311,2954,4766,7179,10265,176.53,34.07,23.82,15.82
01-07-2021,AMARES,1,0,6,"[0,120]",Baixo a Moderado,,,,1,Norte,BRAGA,0301,8195.41,18129,1001,829,622,489,524,1013,1635,2464,3465,221.22,42.28,30.07,19.95
01-07-2021,ANADIA,12,1,44,"[0,120]",Baixo a Moderado,,,,12,Centro,AVEIRO,0103,21663.48,27258,1931,1698,1376,1208,1262,2470,3846,5544,7475,125.83,34.51,25.59,17.75
01-07-2021,ANGRA DO HEROÍSMO,1,0,3,"[0,120]",Baixo a Moderado,,,,1,Açores,AÇORES,4301,23899.66,33807,2006,1473,1122,768,635,1403,2525,3998,6004,141.45,25.12,16.73,10.56
01-07-2021,ANSIÃO,6,0,50,"[0,120]",Baixo a Moderado,,,,6,Centro,LEIRIA,1003,17609.42,12039,727,709,646,694,530,1224,1870,2579,3306,68.37,18.77,14.65,10.62
01-07-2021,ARCOS DE VALDEVEZ,1,0,5,"[0,120]",Baixo a Moderado,,,,1,Norte,VIANA DO CASTELO,1601,44759.64,20926,1329,1338,1282,1343,1515,2858,4140,5478,6807,46.75,15.21,12.24,9.25
01-07-2021,ARGANIL,2,0,18,"[0,120]",Baixo a Moderado,,,,2,Centro,COIMBRA,0601,33283.93,11014,672,648,612,559,596,1155,1767,2415,3087,33.09,9.27,7.26,5.31
01-07-2021,ARMAMAR,2,0,35,"[0,120]",Baixo a Moderado,,,,2,Norte,VISEU,1801,11723.73,5769,357,305,309,285,310,595,904,1209,1566,49.21,13.36,10.31,7.71
01-07-2021,AROUCA,36,3,175,"[120,240]",Moderado,,,,36,Norte,AVEIRO,0104,32910.52,20720,1306,1047,753,683,683,1366,2119,3166,4472,62.96,13.59,9.62,6.44
01-07-2021,ARRAIOLOS,3,0,44,"[0,120]",Baixo a Moderado,,,,3,Alentejo,ÉVORA,0702,68374.55,6928,435,384,283,367,480,847,1130,1514,1949,10.13,2.85,2.21,1.65
01-07-2021,ARRONCHES,0,0,0,"[0,120]",Baixo a Moderado,,,,0,Alentejo,PORTALEGRE,1202,31464.72,2820,155,142,162,187,179,366,528,670,825,8.96,2.62,2.13,1.68
01-07-2021,ARRUDA DOS VINHOS,40,3,260,"[240,480]",Elevado,,,,40,Lisboa e Vale do Tejo,LISBOA,1102,7795.93,15412,738,738,562,509,438,947,1509,2247,2985,197.69,38.29,28.82,19.36
01-07-2021,AVEIRO,130,9,165,"[120,240]",Moderado,,,,130,Centro,AVEIRO,0105,19757.57,78734,4520,4004,3050,2250,2103,4353,7403,11407,15927,398.49,80.61,57.73,37.47
01-07-2021,AVIS,30,2,715,"[480,960]",Muito Elevado,,,,30,Alentejo,PORTALEGRE,1203,60596.51,4247,315,225,206,251,273,524,730,955,1270,7.01,2.1,1.58,1.2
01-07-2021,AZAMBUJA,29,2,127,"[120,240]",Moderado,,,,29,Lisboa e Vale do Tejo,LISBOA,1103,26265.65,22716,1322,1171,1070,798,618,1416,2486,3657,4979,86.48,18.96,13.92,9.46
01-07-2021,BAIÃO,1,0,5,"[0,120]",Baixo a Moderado,,,,1,Norte,PORTO,1302,17452.83,18748,1070,862,714,686,725,1411,2125,2987,4057,107.42,23.25,17.11,12.18
01-07-2021,BARCELOS,91,6,78,"[0,120]",Baixo a Moderado,,,,91,Norte,BRAGA,0302,37890.14,116187,6721,5325,3619,2991,2562,5553,9172,14497,21218,306.64,56.0,38.26,24.21
01-07-2021,BARRANCOS,1,0,62,"[0,120]",Baixo a Moderado,,,,1,Alentejo,BEJA,0204,16841.73,1634,90,65,65,94,61,155,220,285,375,9.7,2.23,1.69,1.31
01-07-2021,BARREIRO,240,17,320,"[240,480]",Elevado,,,,240,Lisboa e Vale do Tejo,SETÚBAL,1504,3639.07,75147,5194,5565,4459,3105,1767,4872,9331,14896,20090,2065.05,552.07,409.34,256.42
01-07-2021,BATALHA,16,1,99,"[0,120]",Baixo a Moderado,,,,16,Centro,LEIRIA,1004,10341.6,15963,873,762,649,529,549,1078,1727,2489,3362,154.35,32.51,24.07,16.7
01-07-2021,BEJA,18,1,54,"[0,120]",Baixo a Moderado,,,,18,Alentejo,BEJA,0205,114647.55,33579,2005,1840,1386,1272,1039,2311,3697,5537,7542,29.29,6.58,4.83,3.22
01-07-2021,BELMONTE,0,0,0,"[0,120]",Baixo a Moderado,,,,0,Centro,CASTELO BRANCO,0501,11875.91,6398,444,321,325,310,355,665,990,1311,1755,53.87,14.78,11.04,8.34
01-07-2021,BENAVENTE,36,3,117,"[0,120]",Baixo a Moderado,,,,36,Lisboa e Vale do Tejo,SANTARÉM,1405,52138.39,30602,1468,1376,1141,876,643,1519,2660,4036,5504,58.69,10.56,7.74,5.1
01-07-2021,BOMBARRAL,20,1,158,"[120,240]",Moderado,,,,20,Lisboa e Vale do Tejo,LEIRIA,1005,9128.55,12558,875,714,561,491,429,920,1481,2195,3070,137.56,33.63,24.04,16.22
01-07-2021,BORBA,3,0,45,"[0,120]",Baixo a Moderado,,,,3,Alentejo,ÉVORA,0703,14518.65,6736,430,375,279,436,392,828,1107,1482,1912,46.39,13.17,10.21,7.62
01-07-2021,BOTICAS,2,0,41,"[0,120]",Baixo a Moderado,,,,2,Norte,VILA REAL,1702,32195.66,4998,347,306,311,305,380,685,996,1302,1649,15.52,5.12,4.04,3.09
01-07-2021,BRAGA,221,16,121,"[120,240]",Moderado,,,,221,Norte,BRAGA,0303,18339.95,182679,10029,7963,5241,4320,3671,7991,13232,21195,31224,996.07,170.25,115.57,72.15
01-07-2021,BRAGANÇA,8,1,24,"[0,120]",Baixo a Moderado,,,,8,Norte,BRAGANÇA,0402,117357.27,33607,2402,1855,1652,1393,1163,2556,4208,6063,8465,28.64,7.21,5.17,3.59
01-07-2021,CABECEIRAS DE BASTO,5,0,32,"[0,120]",Baixo a Moderado,,,,5,Norte,BRAGA,0304,24182.16,15628,774,594,544,575,574,1149,1693,2287,3061,64.63,12.66,9.46,7.0
01-07-2021,CADAVAL,3,0,22,"[0,120]",Baixo a Moderado,,,,3,Lisboa e Vale do Tejo,LISBOA,1104,17489.3,13673,813,796,756,621,625,1246,2002,2798,3611,78.18,20.65,16.0,11.45
01-07-2021,CALDAS DA RAINHA,58,4,111,"[0,120]",Baixo a Moderado,,,,58,Lisboa e Vale do Tejo,LEIRIA,1006,25569.47,51912,3035,2684,2186,1899,1705,3604,5790,8474,11509,203.03,45.01,33.14,22.64
01-07-2021,CALHETA,24,2,222,"[120,240]",Moderado,,,,24,Madeira,MADEIRA,3101,11150.43,10867,576,497,507,399,415,814,1321,1818,2394,97.46,21.47,16.3,11.85
01-07-2021,CALHETA (AÇORES),0,0,0,"[0,120]",Baixo a Moderado,,,,0,Açores,AÇORES,4501,12626.4,3184,215,159,141,139,122,261,402,561,776,25.22,6.15,4.44,3.18
01-07-2021,CÂMARA DE LOBOS,7,1,21,"[0,120]",Baixo a Moderado,,,,7,Madeira,MADEIRA,3102,5216.67,33675,1396,1059,834,545,381,926,1760,2819,4215,645.49,80.79,54.03,33.74
01-07-2021,CAMINHA,5,0,32,"[0,120]",Baixo a Moderado,,,,5,Norte,VIANA DO CASTELO,1602,13652.14,15877,1046,944,818,646,656,1302,2120,3064,4110,116.3,30.11,22.44,15.53
01-07-2021,CAMPO MAIOR,0,0,0,"[0,120]",Baixo a Moderado,,,,0,Alentejo,PORTALEGRE,1204,24720.16,7874,471,364,351,279,327,606,957,1321,1792,31.85,7.25,5.34,3.87
01-07-2021,CANTANHEDE,35,3,100,"[0,120]",Baixo a Moderado,,,,35,Centro,COIMBRA,0602,39088.02,35011,2346,2096,1880,1709,1451,3160,5040,7136,9482,89.57,24.26,18.26,12.89
01-07-2021,CARRAZEDA DE ANSIÃES,0,0,0,"[0,120]",Baixo a Moderado,,,,0,Norte,BRAGANÇA,0403,27924.09,5666,424,389,391,312,465,777,1168,1557,1981,20.29,7.09,5.58,4.18
01-07-2021,CARREGAL DO SAL,12,1,129,"[120,240]",Moderado,,,,12,Centro,VISEU,1802,11689.21,9271,587,562,486,462,376,838,1324,1886,2473,79.31,21.16,16.13,11.33
01-07-2021,CARTAXO,30,2,126,"[120,240]",Moderado,,,,30,Lisboa e Vale do Tejo,SANTARÉM,1406,15817.28,23843,1415,1376,1142,861,632,1493,2635,4011,5426,150.74,34.3,25.36,16.66
01-07-2021,CASCAIS,792,57,371,"[240,480]",Elevado,,,,792,Lisboa e Vale do Tejo,LISBOA,1105,9740.17,213608,12151,11444,8680,6469,5248,11717,20397,31841,43992,2193.1,451.66,326.91,209.41
01-07-2021,CASTANHEIRA DE PÊRA,0,0,0,"[0,120]",Baixo a Moderado,,,,0,Centro,LEIRIA,1007,6677.45,2614,233,195,157,190,187,377,534,729,962,39.15,14.41,10.92,8.0
01-07-2021,CASTELO BRANCO,56,4,108,"[0,120]",Baixo a Moderado,,,,56,Centro,CASTELO BRANCO,0502,143819.15,51987,3528,3042,2499,2229,2225,4454,6953,9995,13523,36.15,9.4,6.95,4.83
01-07-2021,CASTELO DE PAIVA,2,0,13,"[0,120]",Baixo a Moderado,,,,2,Norte,AVEIRO,0106,11500.53,15454,881,697,545,420,431,851,1396,2093,2974,134.37,25.86,18.2,12.14
01-07-2021,CASTELO DE VIDE,8,1,277,"[240,480]",Elevado,,,,8,Alentejo,PORTALEGRE,1205,26491.24,2919,204,173,179,147,170,317,496,669,873,11.02,3.3,2.53,1.87
01-07-2021,CASTRO DAIRE,19,1,138,"[120,240]",Moderado,,,,19,Centro,VISEU,1803,37904.13,13823,942,857,765,732,773,1505,2270,3127,4069,36.47,10.74,8.25,5.99
01-07-2021,CASTRO MARIM,6,0,97,"[0,120]",Baixo a Moderado,,,,6,Algarve,FARO,0804,30084.37,6237,370,345,334,322,344,666,1000,1345,1715,20.73,5.7,4.47,3.32
01-07-2021,CASTRO VERDE,4,0,58,"[0,120]",Baixo a Moderado,,,,4,Alentejo,BEJA,0206,56944.23,6949,437,347,303,275,227,502,805,1152,1589,12.2,2.79,2.02,1.41
01-07-2021,CELORICO DA BEIRA,0,0,0,"[0,120]",Baixo a Moderado,,,,0,Centro,GUARDA,0903,24721.63,6928,430,416,363,369,535,904,1267,1683,2113,28.02,8.55,6.81,5.12
01-07-2021,CELORICO DE BASTO,3,0,16,"[0,120]",Baixo a Moderado,,,,3,Norte,BRAGA,0305,18107.02,19040,1001,802,668,728,729,1457,2125,2927,3928,105.15,21.69,16.17,11.74
01-07-2021,CHAMUSCA,16,1,176,"[120,240]",Moderado,,,,16,Lisboa e Vale do Tejo,SANTARÉM,1407,74600.54,9197,629,583,553,465,579,1044,1597,2180,2809,12.33,3.77,2.92,2.14
01-07-2021,CHAVES,35,3,89,"[0,120]",Baixo a Moderado,,,,35,Norte,VILA REAL,1703,59122.95,39343,2676,2429,1991,1886,1918,3804,5795,8224,10900,66.54,18.44,13.91,9.8
01-07-2021,CINFÃES,20,1,111,"[0,120]",Baixo a Moderado,,,,20,Norte,VISEU,1804,23928.76,18244,1067,902,779,734,758,1492,2271,3173,4240,76.24,17.72,13.26,9.49
01-07-2021,COIMBRA,125,9,93,"[0,120]",Baixo a Moderado,,,,125,Centro,COIMBRA,0603,31939.94,134166,9489,8734,6353,5139,5074,10213,16566,25300,34789,420.06,108.92,79.21,51.87
01-07-2021,CONDEIXA-A-NOVA,9,1,50,"[0,120]",Baixo a Moderado,,,,9,Centro,COIMBRA,0604,13867.47,17733,871,809,717,583,490,1073,1790,2599,3470,127.88,25.02,18.74,12.91
01-07-2021,CONSTÂNCIA,29,2,716,"[480,960]",Muito Elevado,,,,29,Lisboa e Vale do Tejo,SANTARÉM,1408,8036.58,4030,211,183,187,148,155,303,490,673,884,50.14,11.0,8.37,6.1
01-07-2021,CORUCHE,10,1,58,"[0,120]",Baixo a Moderado,,,,10,Lisboa e Vale do Tejo,SANTARÉM,1409,111572.03,17471,1294,1090,1095,1096,1019,2115,3210,4300,5594,15.66,5.01,3.85,2.88
01-07-2021,CORVO,0,0,0,"[0,120]",Baixo a Moderado,,,,0,Açores,AÇORES,4901,1711.45,464,22,21,11,13,19,32,43,64,86,27.12,5.03,3.74,2.51
01-07-2021,COVILHÃ,8,1,17,"[0,120]",Baixo a Moderado,,,,8,Centro,CASTELO BRANCO,0503,55560.06,46787,3533,2998,2365,2111,2193,4304,6669,9667,13200,84.21,23.76,17.4,12.0
01-07-2021,CRATO,0,0,0,"[0,120]",Baixo a Moderado,,,,0,Alentejo,PORTALEGRE,1206,39806.88,3129,229,258,163,182,228,410,573,831,1060,7.86,2.66,2.09,1.44
01-07-2021,CUBA,2,0,44,"[0,120]",Baixo a Moderado,,,,2,Alentejo,BEJA,0207,17208.72,4595,255,233,206,190,143,333,539,772,1027,26.7,5.97,4.49,3.13
01-07-2021,ELVAS,42,3,207,"[120,240]",Moderado,,,,42,Alentejo,PORTALEGRE,1207,63128.86,20528,1057,1145,902,852,810,1662,2564,3709,4766,32.52,7.55,5.88,4.06
01-07-2021,ENTRONCAMENTO,10,1,46,"[0,120]",Baixo a Moderado,,,,10,Lisboa e Vale do Tejo,SANTARÉM,1410,1372.81,21558,1066,930,868,695,592,1287,2155,3085,4151,1570.14,302.33,224.69,156.96
01-07-2021,ESPINHO,22,2,75,"[0,120]",Baixo a Moderado,,,,22,Norte,AVEIRO,0107,2105.68,29516,2205,1993,1430,1177,960,2137,3567,5560,7765,1401.52,368.71,264.01,169.37
01-07-2021,ESPOSENDE,26,2,76,"[0,120]",Baixo a Moderado,,,,26,Norte,BRAGA,0306,9540.98,34177,1831,1522,1095,894,723,1617,2712,4234,6065,358.21,63.57,44.38,28.42
01-07-2021,ESTARREJA,8,1,31,"[0,120]",Baixo a Moderado,,,,8,Centro,AVEIRO,0108,10817.33,26006,1503,1399,1106,953,728,1681,2787,4186,5689,240.42,52.59,38.7,25.76
01-07-2021,ESTREMOZ,5,0,40,"[0,120]",Baixo a Moderado,,,,5,Alentejo,ÉVORA,0704,51379.95,12728,789,613,697,786,877,1663,2360,2973,3762,24.77,7.32,5.79,4.59
01-07-2021,ÉVORA,58,4,111,"[0,120]",Baixo a Moderado,,,,58,Alentejo,ÉVORA,0705,130707.58,52428,3569,2852,2176,1966,1803,3769,5945,8797,12366,40.11,9.46,6.73,4.55
01-07-2021,FAFE,74,5,155,"[120,240]",Moderado,,,,74,Norte,BRAGA,0307,21908.11,48060,3044,2455,1679,1403,1208,2611,4290,6745,9789,219.37,44.68,30.79,19.58
01-07-2021,FARO,258,18,423,"[240,480]",Elevado,,,,258,Algarve,FARO,0805,20256.79,61015,3847,3364,2604,2055,1601,3656,6260,9624,13471,301.2,66.5,47.51,30.9
01-07-2021,FELGUEIRAS,25,2,45,"[0,120]",Baixo a Moderado,,,,25,Norte,PORTO,1303,11573.75,56422,2951,2302,1601,1316,973,2289,3890,6192,9143,487.49,79.0,53.5,33.61
01-07-2021,FERREIRA DO ALENTEJO,2,0,26,"[0,120]",Baixo a Moderado,,,,2,Alentejo,BEJA,0208,64820.68,7845,515,414,372,343,345,688,1060,1474,1989,12.1,3.07,2.27,1.64
01-07-2021,FERREIRA DO ZÊZERE,2,0,25,"[0,120]",Baixo a Moderado,,,,2,Lisboa e Vale do Tejo,SANTARÉM,1411,19038.03,7959,470,370,416,465,456,921,1337,1707,2177,41.81,11.44,8.97,7.02
01-07-2021,FIGUEIRA DA FOZ,63,4,107,"[0,120]",Baixo a Moderado,,,,63,Centro,COIMBRA,0605,37905.26,58747,4032,3597,2887,2495,2043,4538,7425,11022,15054,154.98,39.72,29.08,19.59
01-07-2021,FIGUEIRA DE CASTELO RODRIGO,0,0,0,"[0,120]",Baixo a Moderado,,,,0,Centro,GUARDA,0904,50857.46,5584,347,352,290,352,391,743,1033,1385,1732,10.98,3.41,2.72,2.03
01-07-2021,FIGUEIRÓ DOS VINHOS,0,0,0,"[0,120]",Baixo a Moderado,,,,0,Centro,LEIRIA,1008,17344.0,5568,402,386,322,309,351,660,982,1368,1770,32.1,10.21,7.89,5.66
01-07-2021,FORNOS DE ALGODRES,2,0,44,"[0,120]",Baixo a Moderado,,,,2,Centro,GUARDA,0905,13145.05,4528,261,218,247,256,232,488,735,953,1214,34.45,9.24,7.25,5.59
01-07-2021,FREIXO DE ESPADA À CINTA,0,0,0,"[0,120]",Baixo a Moderado,,,,0,Norte,BRAGANÇA,0404,24414.29,3298,211,177,231,196,189,385,616,793,1004,13.51,4.11,3.25,2.52
01-07-2021,FRONTEIRA,0,0,0,"[0,120]",Baixo a Moderado,,,,0,Alentejo,PORTALEGRE,1208,24859.58,2974,213,182,149,156,168,324,473,655,868,11.96,3.49,2.63,1.9
01-07-2021,FUNCHAL,89,6,86,"[0,120]",Baixo a Moderado,,,,89,Madeira,MADEIRA,3103,7616.2,104024,6382,5086,3643,2821,1990,4811,8454,13540,19922,1365.86,261.58,177.78,111.0
01-07-2021,FUNDÃO,12,1,45,"[0,120]",Baixo a Moderado,,,,12,Centro,CASTELO BRANCO,0504,70019.79,26495,1781,1464,1432,1357,1643,3000,4432,5896,7677,37.84,10.96,8.42,6.33
01-07-2021,GAVIÃO,3,0,94,"[0,120]",Baixo a Moderado,,,,3,Alentejo,PORTALEGRE,1209,29459.45,3263,189,186,222,263,293,556,778,964,1153,11.08,3.91,3.27,2.64
01-07-2021,GÓIS,2,0,53,"[0,120]",Baixo a Moderado,,,,2,Centro,COIMBRA,0606,26330.19,3805,235,199,240,233,244,477,717,916,1151,14.45,4.37,3.48,2.72
01-07-2021,GOLEGÃ,4,0,76,"[0,120]",Baixo a Moderado,,,,4,Lisboa e Vale do Tejo,SANTARÉM,1412,8431.67,5339,356,299,281,243,255,498,779,1078,1434,63.32,17.01,12.78,9.24
01-07-2021,GONDOMAR,198,14,119,"[0,120]",Baixo a Moderado,,,,198,Norte,PORTO,1304,13191.76,165985,10555,8755,6222,4450,3364,7814,14036,22791,33346,1258.22,252.77,172.76,106.4
01-07-2021,GOUVEIA,6,0,49,"[0,120]",Baixo a Moderado,,,,6,Centro,GUARDA,0906,30061.17,12387,871,931,780,783,810,1593,2373,3304,4175,41.21,13.89,10.99,7.89
01-07-2021,GRÂNDOLA,35,3,240,"[240,480]",Elevado,,,,35,Alentejo,SETÚBAL,1505,82593.66,14639,834,834,708,688,672,1360,2068,2902,3736,17.72,4.52,3.51,2.5
01-07-2021,GUARDA,25,2,64,"[0,120]",Baixo a Moderado,,,,25,Centro,GUARDA,0907,71209.58,38969,2477,2041,1686,1415,1474,2889,4575,6616,9093,54.72,12.77,9.29,6.42
01-07-2021,GUIMARÃES,104,7,68,"[0,120]",Baixo a Moderado,,,,104,Norte,BRAGA,0308,24099.96,152309,9394,7074,4809,3877,2948,6825,11634,18708,28102,631.99,116.61,77.63,48.27
01-07-2021,HORTA,6,0,42,"[0,120]",Baixo a Moderado,,,,6,Açores,AÇORES,4701,17305.53,14521,818,658,468,352,302,654,1122,1780,2598,83.91,15.01,10.29,6.48
01-07-2021,IDANHA-A-NOVA,20,1,252,"[240,480]",Elevado,,,,20,Centro,CASTELO BRANCO,0505,141633.51,8043,518,490,519,672,974,1646,2165,2655,3173,5.68,2.24,1.87,1.53
01-07-2021,ÍLHAVO,68,5,176,"[120,240]",Moderado,,,,68,Centro,AVEIRO,0110,7347.55,38699,2227,1943,1444,1193,850,2043,3487,5430,7657,526.66,104.21,73.9,47.46
01-07-2021,LAGOA (FARO),39,3,171,"[120,240]",Moderado,,,,39,Algarve,FARO,0806,8825.45,22762,1314,1168,919,749,670,1419,2338,3506,4820,257.93,54.62,39.73,26.49
01-07-2021,LAGOA,109,8,739,"[480,960]",Muito Elevado,,,,109,Açores,AÇORES,4201,4559.32,14721,536,458,349,238,235,473,822,1280,1816,322.9,39.83,28.08,18.03
01-07-2021,LAGOS,128,9,423,"[240,480]",Elevado,,,,128,Algarve,FARO,0807,21299.27,30374,1744,1434,1247,1053,1029,2082,3329,4763,6507,142.61,30.55,22.36,15.63
01-07-2021,LAJES DAS FLORES,0,0,0,"[0,120]",Baixo a Moderado,,,,0,Açores,AÇORES,4801,7004.79,1463,88,53,62,46,54,100,162,215,303,20.89,4.33,3.07,2.31
01-07-2021,LAJES DO PICO,1,0,22,"[0,120]",Baixo a Moderado,,,,1,Açores,AÇORES,4601,15531.09,4490,304,231,223,159,162,321,544,775,1079,28.91,6.95,4.99,3.5
01-07-2021,LAMEGO,6,0,24,"[0,120]",Baixo a Moderado,,,,6,Norte,VISEU,1805,16542.11,24895,1639,1284,1124,898,783,1681,2805,4089,5728,150.5,34.63,24.72,16.96
01-07-2021,LEIRIA,108,8,86,"[0,120]",Baixo a Moderado,,,,108,Centro,LEIRIA,1009,56508.83,125267,7389,6366,5090,3902,3159,7061,12151,18517,25906,221.68,45.84,32.77,21.5
01-07-2021,LISBOA,3032,217,595,"[480,960]",Muito Elevado,,,,3032,Lisboa e Vale do Tejo,LISBOA,1106,10005.43,509515,33197,33340,27706,23037,26770,49807,77513,110853,144050,5092.6,1439.78,1107.98,774.74
01-07-2021,LOULÉ,448,32,652,"[480,960]",Muito Elevado,,,,448,Algarve,FARO,0808,76366.91,68697,3890,3350,2780,2358,2251,4609,7389,10739,14629,89.96,19.16,14.06,9.68
01-07-2021,LOURES,722,52,338,"[240,480]",Elevado,,,,722,Lisboa e Vale do Tejo,LISBOA,1107,16723.99,213687,12746,12794,9644,6669,5033,11702,21346,34140,46886,1277.73,280.35,204.14,127.64
01-07-2021,LOURINHÃ,68,5,264,"[240,480]",Elevado,,,,68,Lisboa e Vale do Tejo,LISBOA,1108,14717.2,25855,1584,1243,992,842,645,1487,2479,3722,5306,175.68,36.05,25.29,16.84
01-07-2021,LOUSÃ,16,1,93,"[0,120]",Baixo a Moderado,,,,16,Centro,COIMBRA,0607,13840.01,17158,946,866,658,528,450,978,1636,2502,3448,123.97,24.91,18.08,11.82
01-07-2021,LOUSADA,41,3,88,"[0,120]",Baixo a Moderado,,,,41,Norte,PORTO,1305,9608.01,46755,2289,1698,1176,853,621,1474,2650,4348,6637,486.63,69.08,45.25,27.58
01-07-2021,MAÇÃO,4,0,65,"[0,120]",Baixo a Moderado,,,,4,Lisboa e Vale do Tejo,SANTARÉM,1413,39997.98,6267,386,362,390,440,657,1097,1487,1849,2235,15.67,5.59,4.62,3.72
01-07-2021,MACEDO DE CAVALEIROS,1,0,7,"[0,120]",Baixo a Moderado,,,,1,Norte,BRAGANÇA,0405,69914.08,14516,1082,889,878,823,938,1761,2639,3528,4610,20.76,6.59,5.05,3.77
01-07-2021,MACHICO,6,0,30,"[0,120]",Baixo a Moderado,,,,6,Madeira,MADEIRA,3104,6825.1,19981,1197,860,662,455,331,786,1448,2308,3505,292.76,51.36,33.82,21.22
01-07-2021,MADALENA,0,0,0,"[0,120]",Baixo a Moderado,,,,0,Açores,AÇORES,4602,14712.33,5895,334,256,173,190,179,369,542,798,1132,40.07,7.69,5.42,3.68
01-07-2021,MAFRA,328,23,387,"[240,480]",Elevado,,,,328,Lisboa e Vale do Tejo,LISBOA,1109,29165.5,84816,3613,3334,2839,2089,1899,3988,6827,10161,13774,290.81,47.23,34.84,23.41
01-07-2021,MAIA,128,9,92,"[0,120]",Baixo a Moderado,,,,128,Norte,PORTO,1306,8293.94,138971,7801,6617,4512,3339,2631,5970,10482,17099,24900,1675.56,300.22,206.16,126.38
01-07-2021,MANGUALDE,13,1,70,"[0,120]",Baixo a Moderado,,,,13,Centro,VISEU,1806,21925.56,18510,1198,1128,885,852,743,1595,2480,3608,4806,84.42,21.92,16.46,11.31
01-07-2021,MANTEIGAS,0,0,0,"[0,120]",Baixo a Moderado,,,,0,Centro,GUARDA,0908,12197.55,3007,258,197,159,167,146,313,472,669,927,24.65,7.6,5.48,3.87
01-07-2021,MARCO DE CANAVESES,27,2,53,"[0,120]",Baixo a Moderado,,,,27,Norte,PORTO,1307,20188.98,51496,2678,2060,1488,1265,1023,2288,3776,5836,8514,255.07,42.17,28.91,18.7
01-07-2021,MARINHA GRANDE,27,2,69,"[0,120]",Baixo a Moderado,,,,27,Centro,LEIRIA,1010,18725.19,38508,2365,2302,1638,1359,1058,2417,4055,6357,8722,205.65,46.58,33.95,21.66
01-07-2021,MARVÃO,1,0,34,"[0,120]",Baixo a Moderado,,,,1,Alentejo,PORTALEGRE,1210,15489.9,3005,198,185,142,197,237,434,576,761,959,19.4,6.19,4.91,3.72
01-07-2021,MATOSINHOS,268,19,153,"[120,240]",Moderado,,,,268,Norte,PORTO,1308,6241.97,175357,11850,9977,7023,5024,3884,8908,15931,25908,37758,2809.31,604.9,415.06,255.22
01-07-2021,MEALHADA,15,1,75,"[0,120]",Baixo a Moderado,,,,15,Centro,AVEIRO,0111,11065.66,19914,1163,1039,810,828,831,1659,2469,3508,4671,179.96,42.21,31.7,22.31
01-07-2021,MÊDA,0,0,0,"[0,120]",Baixo a Moderado,,,,0,Centro,GUARDA,0909,28604.92,4587,343,306,290,288,443,731,1021,1327,1670,16.04,5.84,4.64,3.57
01-07-2021,MELGAÇO,2,0,25,"[0,120]",Baixo a Moderado,,,,2,Norte,VIANA DO CASTELO,1603,23824.58,8093,507,567,578,614,675,1289,1867,2434,2941,33.97,12.34,10.22,7.84
01-07-2021,MÉRTOLA,0,0,0,"[0,120]",Baixo a Moderado,,,,0,Alentejo,BEJA,0209,129287.34,6142,400,390,378,423,600,1023,1401,1791,2191,4.75,1.69,1.39,1.08
01-07-2021,MESÃO FRIO,0,0,0,"[0,120]",Baixo a Moderado,,,,0,Norte,VILA REAL,1704,2664.87,3964,265,205,168,157,120,277,445,650,915,148.74,34.33,24.39,16.7
01-07-2021,MIRA,57,4,480,"[480,960]",Muito Elevado,,,,57,Centro,COIMBRA,0608,12403.38,11832,727,729,659,550,466,1016,1675,2404,3131,95.4,25.24,19.38,13.5
01-07-2021,MIRANDA DO CORVO,8,1,63,"[0,120]",Baixo a Moderado,,,,8,Centro,COIMBRA,0609,12637.79,12708,706,659,568,498,404,902,1470,2129,2835,100.55,22.43,16.85,11.63
01-07-2021,MIRANDA DO DOURO,0,0,0,"[0,120]",Baixo a Moderado,,,,0,Norte,BRAGANÇA,0406,48718.31,6830,482,429,442,463,470,933,1375,1804,2286,14.02,4.69,3.7,2.82
01-07-2021,MIRANDELA,4,0,19,"[0,120]",Baixo a Moderado,,,,4,Norte,BRAGANÇA,0407,65895.67,21754,1640,1315,1204,1078,947,2025,3229,4544,6184,33.01,9.38,6.9,4.9
01-07-2021,MOGADOURO,0,0,0,"[0,120]",Baixo a Moderado,,,,0,Norte,BRAGANÇA,0408,76064.93,8392,589,529,576,630,655,1285,1861,2390,2979,11.03,3.92,3.14,2.45
01-07-2021,MOIMENTA DA BEIRA,2,0,21,"[0,120]",Baixo a Moderado,,,,2,Norte,VISEU,1807,21996.9,9736,576,514,471,416,461,877,1348,1862,2438,44.26,11.08,8.46,6.13
01-07-2021,MOITA,226,16,351,"[240,480]",Elevado,,,,226,Lisboa e Vale do Tejo,SETÚBAL,1506,5525.98,64407,4226,3646,2623,1801,1425,3226,5849,9495,13721,1165.53,248.3,171.82,105.85
01-07-2021,MONÇÃO,2,0,11,"[0,120]",Baixo a Moderado,,,,2,Norte,VIANA DO CASTELO,1604,21130.85,17869,1161,1105,1031,1006,972,1978,3009,4114,5275,84.56,24.96,19.47,14.24
01-07-2021,MONCHIQUE,5,0,100,"[0,120]",Baixo a Moderado,,,,5,Algarve,FARO,0809,39530.43,5077,353,384,321,355,392,747,1068,1452,1805,12.84,4.57,3.67,2.7
01-07-2021,MONDIM DE BASTO,0,0,0,"[0,120]",Baixo a Moderado,,,,0,Norte,VILA REAL,1705,17207.52,6946,395,300,314,284,283,567,881,1181,1576,40.36,9.16,6.86,5.12
01-07-2021,MONFORTE,0,0,0,"[0,120]",Baixo a Moderado,,,,0,Alentejo,PORTALEGRE,1211,42024.82,2975,139,115,117,192,168,360,477,592,731,7.08,1.74,1.41,1.14
01-07-2021,MONTALEGRE,11,1,124,"[120,240]",Moderado,,,,11,Norte,VILA REAL,1706,80545.71,8997,699,628,595,603,730,1333,1928,2556,3255,11.17,4.04,3.17,2.39
01-07-2021,MONTEMOR-O-NOVO,15,1,97,"[0,120]",Baixo a Moderado,,,,15,Alentejo,ÉVORA,0706,123296.65,15647,991,953,868,878,971,1849,2717,3670,4661,12.69,3.78,2.98,2.2
01-07-2021,MONTEMOR-O-VELHO,21,1,83,"[0,120]",Baixo a Moderado,,,,21,Centro,COIMBRA,0610,22896.23,25224,1496,1397,1217,1057,988,2045,3262,4659,6155,110.17,26.88,20.35,14.25
01-07-2021,MONTIJO,165,12,286,"[240,480]",Elevado,,,,165,Lisboa e Vale do Tejo,SETÚBAL,1507,34861.64,57614,2771,2441,1990,1554,1109,2663,4653,7094,9865,165.26,28.3,20.35,13.35
01-07-2021,MORA,4,0,99,"[0,120]",Baixo a Moderado,,,,4,Alentejo,ÉVORA,0707,44395.02,4138,336,275,252,238,257,495,747,1022,1358,9.32,3.06,2.3,1.68
01-07-2021,MORTÁGUA,1,0,11,"[0,120]",Baixo a Moderado,,,,1,Centro,VISEU,1808,25117.82,8803,638,584,535,499,460,959,1494,2078,2716,35.05,10.81,8.27,5.95
01-07-2021,MOURA,8,1,59,"[0,120]",Baixo a Moderado,,,,8,Alentejo,BEJA,0210,95845.55,13718,817,656,665,542,461,1003,1668,2324,3141,14.31,3.28,2.42,1.74
01-07-2021,MOURÃO,12,1,493,"[480,960]",Muito Elevado,,,,12,Alentejo,ÉVORA,0708,27862.98,2450,139,108,80,104,109,213,293,401,540,8.79,1.94,1.44,1.05
01-07-2021,MURÇA,1,0,19,"[0,120]",Baixo a Moderado,,,,1,Norte,VILA REAL,1707,18937.11,5463,384,341,307,306,319,625,932,1273,1657,28.85,8.75,6.72,4.92
01-07-2021,MURTOSA,7,0,67,"[0,120]",Baixo a Moderado,,,,7,Centro,AVEIRO,0112,7308.78,10279,509,473,403,353,409,762,1165,1638,2147,140.63,29.37,22.41,15.94
01-07-2021,NAZARÉ,45,3,316,"[240,480]",Elevado,,,,45,Lisboa e Vale do Tejo,LEIRIA,1011,8243.43,14165,967,903,670,420,396,816,1486,2389,3356,171.84,40.71,28.98,18.03
01-07-2021,NELAS,8,1,62,"[0,120]",Baixo a Moderado,,,,8,Centro,VISEU,1809,12571.48,12974,924,787,668,604,583,1187,1855,2642,3566,103.21,28.37,21.02,14.76
01-07-2021,NISA,1,0,17,"[0,120]",Baixo a Moderado,,,,1,Alentejo,PORTALEGRE,1212,57567.84,6061,405,389,355,483,478,961,1316,1705,2110,10.53,3.67,2.96,2.29
01-07-2021,NORDESTE,1,0,21,"[0,120]",Baixo a Moderado,,,,1,Açores,AÇORES,4202,10146.8,4862,246,180,124,161,162,323,447,627,873,47.92,8.6,6.18,4.41
01-07-2021,ÓBIDOS,15,1,125,"[120,240]",Moderado,,,,15,Lisboa e Vale do Tejo,LEIRIA,1012,14155.44,11850,743,650,574,452,436,888,1462,2112,2855,83.72,20.17,14.92,10.33
01-07-2021,ODEMIRA,77,6,313,"[240,480]",Elevado,,,,77,Alentejo,BEJA,0211,172060.15,24717,1475,1317,1225,1397,1349,2746,3971,5288,6763,14.37,3.93,3.07,2.31
01-07-2021,ODIVELAS,561,40,347,"[240,480]",Elevado,,,,561,Lisboa e Vale do Tejo,LISBOA,1116,2654.36,161774,9562,9038,6952,4641,3812,8453,15405,24443,34005,6095.48,1281.27,920.99,580.44
01-07-2021,OEIRAS,596,43,336,"[240,480]",Elevado,,,,596,Lisboa e Vale do Tejo,LISBOA,1110,4588.31,177408,11580,11575,8566,6211,5855,12066,20632,32207,43787,3866.78,954.38,701.98,449.69
01-07-2021,OLEIROS,1,0,20,"[0,120]",Baixo a Moderado,,,,1,Centro,CASTELO BRANCO,0506,47109.31,5003,384,341,366,397,487,884,1250,1591,1975,10.62,4.19,3.38,2.65
01-07-2021,OLHÃO,227,16,512,"[480,960]",Muito Elevado,,,,227,Algarve,FARO,0810,13086.38,44405,2455,2309,1689,1342,1268,2610,4299,6608,9063,339.33,69.26,50.5,32.85
01-07-2021,OLIVEIRA DE AZEMÉIS,25,2,38,"[0,120]",Baixo a Moderado,,,,25,Norte,AVEIRO,0113,16110.41,66011,4155,3614,2794,2183,1738,3921,6715,10329,14484,409.75,89.91,64.12,41.68
01-07-2021,OLIVEIRA DE FRADES,21,1,210,"[120,240]",Moderado,,,,21,Centro,VISEU,1810,14534.62,9936,553,475,438,359,415,774,1212,1687,2240,68.36,15.41,11.61,8.34
01-07-2021,OLIVEIRA DO BAIRRO,25,2,105,"[0,120]",Baixo a Moderado,,,,25,Centro,AVEIRO,0114,8731.99,24277,1327,1182,999,786,810,1596,2595,3777,5104,278.02,58.45,43.25,29.72
01-07-2021,OLIVEIRA DO HOSPITAL,25,2,130,"[120,240]",Moderado,,,,25,Centro,COIMBRA,0611,23451.66,19253,1161,1097,962,924,960,1884,2846,3943,5104,82.1,21.76,16.81,12.14
01-07-2021,OURÉM,35,2,79,"[0,120]",Baixo a Moderado,,,,35,Lisboa e Vale do Tejo,SANTARÉM,1421,41668.03,44044,2463,2069,1899,1817,1603,3420,5319,7388,9851,105.7,23.64,17.73,12.77
01-07-2021,OURIQUE,1,0,22,"[0,120]",Baixo a Moderado,,,,1,Alentejo,BEJA,0212,66331.36,4607,313,287,284,268,227,495,779,1066,1379,6.95,2.08,1.61,1.17
01-07-2021,OVAR,37,3,68,"[0,120]",Baixo a Moderado,,,,37,Centro,AVEIRO,0115,14770.25,54260,3294,2709,1994,1636,1234,2870,4864,7573,10867,367.37,73.57,51.27,32.93
01-07-2021,PAÇOS DE FERREIRA,28,2,50,"[0,120]",Baixo a Moderado,,,,28,Norte,PORTO,1309,7099.29,56728,2903,2193,1518,1135,664,1799,3317,5510,8413,799.1,118.51,77.62,46.72
01-07-2021,PALMELA,147,11,229,"[120,240]",Moderado,,,,147,Lisboa e Vale do Tejo,SETÚBAL,1508,46512.01,64269,3402,3244,2635,1846,1391,3237,5872,9116,12518,138.18,26.91,19.6,12.62
01-07-2021,PAMPILHOSA DA SERRA,1,0,25,"[0,120]",Baixo a Moderado,,,,1,Centro,COIMBRA,0612,39646.24,4037,238,254,295,339,423,762,1057,1311,1549,10.18,3.91,3.31,2.67
01-07-2021,PAREDES,32,2,37,"[0,120]",Baixo a Moderado,,,,32,Norte,PORTO,1310,15675.69,86067,4272,3532,2412,1717,1258,2975,5387,8919,13191,549.04,84.15,56.9,34.36
01-07-2021,PAREDES DE COURA,27,2,319,"[240,480]",Elevado,,,,27,Norte,VIANA DO CASTELO,1605,13818.59,8535,466,528,407,465,515,980,1387,1915,2381,61.76,17.23,13.86,10.04
01-07-2021,PEDRÓGÃO GRANDE,2,0,59,"[0,120]",Baixo a Moderado,,,,2,Centro,LEIRIA,1013,12874.75,3410,175,173,196,221,252,473,669,842,1017,26.49,7.9,6.54,5.2
01-07-2021,PENACOVA,12,1,88,"[0,120]",Baixo a Moderado,,,,12,Centro,COIMBRA,0613,21673.23,13694,968,923,745,621,703,1324,2069,2992,3960,63.18,18.27,13.81,9.55
01-07-2021,PENAFIEL,33,2,48,"[0,120]",Baixo a Moderado,,,,33,Norte,PORTO,1311,21224.27,69772,3648,2823,2032,1663,1230,2893,4925,7748,11396,328.74,53.69,36.51,23.2
01-07-2021,PENALVA DO CASTELO,7,0,98,"[0,120]",Baixo a Moderado,,,,7,Centro,VISEU,1811,13433.92,7115,449,457,413,391,426,817,1230,1687,2136,52.96,15.9,12.56,9.16
01-07-2021,PENAMACOR,0,0,0,"[0,120]",Baixo a Moderado,,,,0,Centro,CASTELO BRANCO,0507,56370.69,4755,262,248,273,451,633,1084,1357,1605,1867,8.44,3.31,2.85,2.41
01-07-2021,PENEDONO,0,0,0,"[0,120]",Baixo a Moderado,,,,0,Norte,VISEU,1812,13370.75,2591,172,113,129,156,138,294,423,536,708,19.38,5.3,4.01,3.16
01-07-2021,PENELA,5,0,93,"[0,120]",Baixo a Moderado,,,,5,Centro,COIMBRA,0614,13480.0,5397,314,324,274,359,344,703,977,1301,1615,40.04,11.98,9.65,7.25
01-07-2021,PENICHE,29,2,109,"[0,120]",Baixo a Moderado,,,,29,Lisboa e Vale do Tejo,LEIRIA,1014,7754.98,26501,1746,1504,1203,926,707,1633,2836,4340,6086,341.73,78.48,55.96,36.57
01-07-2021,PESO DA RÉGUA,3,0,19,"[0,120]",Baixo a Moderado,,,,3,Norte,VILA REAL,1708,9486.01,15773,1076,843,650,659,455,1114,1764,2607,3683,166.28,38.83,27.48,18.6
01-07-2021,PINHEL,1,0,12,"[0,120]",Baixo a Moderado,,,,1,Centro,GUARDA,0910,48452.12,8511,577,566,551,538,689,1227,1778,2344,2921,17.57,6.03,4.84,3.67
01-07-2021,POMBAL,29,2,56,"[0,120]",Baixo a Moderado,,,,29,Centro,LEIRIA,1015,62600.28,51461,3187,2791,2494,2328,2027,4355,6849,9640,12827,82.21,20.49,15.4,10.94
01-07-2021,PONTA DELGADA,107,8,158,"[120,240]",Moderado,,,,107,Açores,AÇORES,4203,23298.65,67935,3108,2435,1726,1133,902,2035,3761,6196,9304,291.58,39.93,26.59,16.14
01-07-2021,PONTA DO SOL,3,0,35,"[0,120]",Baixo a Moderado,,,,3,Madeira,MADEIRA,3105,4622.03,8593,319,283,347,208,221,429,776,1059,1378,185.92,29.81,22.91,16.79
01-07-2021,PONTE DA BARCA,6,0,54,"[0,120]",Baixo a Moderado,,,,6,Norte,VIANA DO CASTELO,1606,18211.37,11180,635,576,517,554,490,1044,1561,2137,2772,61.39,15.22,11.73,8.57
01-07-2021,PONTE DE LIMA,18,1,44,"[0,120]",Baixo a Moderado,,,,18,Norte,VIANA DO CASTELO,1607,32025.46,41315,2321,2022,1720,1596,1462,3058,4778,6800,9121,129.01,28.48,21.23,14.92
01-07-2021,PONTE DE SOR,19,1,128,"[120,240]",Moderado,,,,19,Alentejo,PORTALEGRE,1213,83971.16,14994,939,800,716,739,831,1570,2286,3086,4025,17.86,4.79,3.68,2.72
01-07-2021,PORTALEGRE,11,1,50,"[0,120]",Baixo a Moderado,,,,11,Alentejo,PORTALEGRE,1214,44713.64,22172,1577,1351,1137,993,984,1977,3114,4465,6042,49.59,13.51,9.99,6.96
01-07-2021,PORTEL,1,0,17,"[0,120]",Baixo a Moderado,,,,1,Alentejo,ÉVORA,0709,60100.57,5828,336,358,283,331,305,636,919,1277,1613,9.7,2.68,2.12,1.53
01-07-2021,PORTIMÃO,133,9,239,"[120,240]",Moderado,,,,133,Algarve,FARO,0811,18206.29,55483,3182,2927,2116,1582,1400,2982,5098,8025,11207,304.75,61.56,44.08,28.0
01-07-2021,PORTO,539,39,249,"[240,480]",Elevado,,,,539,Norte,PORTO,1312,4142.02,216606,15790,15193,11280,9409,10044,19453,30733,45926,61716,5229.5,1490.0,1108.79,741.98
01-07-2021,PORTO DE MÓS,11,1,47,"[0,120]",Baixo a Moderado,,,,11,Centro,LEIRIA,1016,26183.41,23275,1355,1210,1034,888,872,1760,2794,4004,5359,88.89,20.47,15.29,10.67
01-07-2021,PORTO MONIZ,0,0,0,"[0,120]",Baixo a Moderado,,,,0,Madeira,MADEIRA,3106,8293.38,2342,143,130,95,98,120,218,313,443,586,28.24,7.07,5.34,3.77
01-07-2021,PORTO SANTO,2,0,38,"[0,120]",Baixo a Moderado,,,,2,Madeira,MADEIRA,3201,4300.7,5202,240,157,134,110,68,178,312,469,709,120.95,16.48,10.9,7.25
01-07-2021,PÓVOA DE LANHOSO,5,0,23,"[0,120]",Baixo a Moderado,,,,5,Norte,BRAGA,0309,13465.29,21499,1175,909,732,673,624,1297,2029,2938,4113,159.67,30.55,21.82,15.07
01-07-2021,PÓVOA DE VARZIM,45,3,72,"[0,120]",Baixo a Moderado,,,,45,Norte,PORTO,1313,8220.59,62784,3712,3120,2134,1594,1305,2899,5033,8153,11865,763.7,144.33,99.17,61.22
01-07-2021,POVOAÇÃO,2,0,34,"[0,120]",Baixo a Moderado,,,,2,Açores,AÇORES,4204,10640.77,5927,293,212,191,144,134,278,469,681,974,55.7,9.15,6.4,4.41
01-07-2021,VILA DA PRAIA DA VITÓRIA,3,0,14,"[0,120]",Baixo a Moderado,,,,3,Açores,AÇORES,4302,16127.06,21317,1133,789,619,436,336,772,1391,2180,3313,132.18,20.54,13.52,8.63
01-07-2021,PROENÇA-A-NOVA,4,0,55,"[0,120]",Baixo a Moderado,,,,4,Centro,CASTELO BRANCO,0508,39539.96,7298,508,465,389,400,560,960,1349,1814,2322,18.46,5.87,4.59,3.41
01-07-2021,REDONDO,1,0,16,"[0,120]",Baixo a Moderado,,,,1,Alentejo,ÉVORA,0710,36950.87,6353,349,325,288,288,354,642,930,1255,1604,17.19,4.34,3.4,2.52
01-07-2021,REGUENGOS DE MONSARAZ,14,1,141,"[120,240]",Moderado,,,,14,Alentejo,ÉVORA,0711,46399.72,10015,602,511,455,462,473,935,1390,1901,2503,21.58,5.39,4.1,3.0
01-07-2021,RESENDE,1,0,10,"[0,120]",Baixo a Moderado,,,,1,Norte,VISEU,1813,12334.93,10137,560,493,448,433,422,855,1303,1796,2356,82.18,19.1,14.56,10.56
01-07-2021,RIBEIRA BRAVA,9,1,73,"[0,120]",Baixo a Moderado,,,,9,Madeira,MADEIRA,3107,6544.88,12435,648,500,411,311,287,598,1009,1509,2157,189.99,32.96,23.06,15.42
01-07-2021,RIBEIRA DE PENA,4,0,67,"[0,120]",Baixo a Moderado,,,,4,Norte,VILA REAL,1709,21745.98,6016,371,301,290,310,368,678,968,1269,1640,27.66,7.54,5.84,4.45
01-07-2021,RIBEIRA GRANDE,92,7,280,"[240,480]",Elevado,,,,92,Açores,AÇORES,4205,18015.13,32811,1163,689,512,345,253,598,1110,1799,2962,182.13,16.44,9.99,6.16
01-07-2021,RIO MAIOR,67,5,330,"[240,480]",Elevado,,,,67,Lisboa e Vale do Tejo,SANTARÉM,1414,27276.45,20379,1251,1144,941,795,648,1443,2384,3528,4779,74.71,17.52,12.93,8.74
01-07-2021,SABROSA,5,0,85,"[0,120]",Baixo a Moderado,,,,5,Norte,VILA REAL,1710,15692.45,5918,393,314,304,302,350,652,956,1270,1663,37.71,10.6,8.09,6.09
01-07-2021,SABUGAL,1,0,10,"[0,120]",Baixo a Moderado,,,,1,Centro,GUARDA,0911,82269.82,10585,724,707,694,796,1009,1805,2499,3206,3930,12.87,4.78,3.9,3.04
01-07-2021,SALVATERRA DE MAGOS,29,2,137,"[120,240]",Moderado,,,,29,Lisboa e Vale do Tejo,SANTARÉM,1415,24393.2,21295,1275,1181,1060,799,772,1571,2631,3812,5087,87.3,20.85,15.63,10.79
01-07-2021,SANTA COMBA DÃO,9,1,86,"[0,120]",Baixo a Moderado,,,,9,Centro,VISEU,1814,11194.77,10452,732,684,569,538,464,1002,1571,2255,2987,93.36,26.68,20.14,14.03
01-07-2021,SANTA CRUZ,9,1,20,"[0,120]",Baixo a Moderado,,,,9,Madeira,MADEIRA,3108,8150.28,45281,1817,1301,974,716,523,1239,2213,3514,5331,555.6,65.41,43.12,27.15
01-07-2021,SANTA CRUZ DA GRACIOSA,1,0,24,"[0,120]",Baixo a Moderado,,,,1,Açores,AÇORES,4401,6065.78,4208,228,180,163,124,145,269,432,612,840,69.37,13.85,10.09,7.12
01-07-2021,SANTA CRUZ DAS FLORES,0,0,0,"[0,120]",Baixo a Moderado,,,,0,Açores,AÇORES,4802,7091.44,2165,125,98,74,56,51,107,181,279,404,30.53,5.7,3.93,2.55
01-07-2021,SANTA MARIA DA FEIRA,68,5,49,"[0,120]",Baixo a Moderado,,,,68,Norte,AVEIRO,0109,21587.65,138636,8182,6743,4771,3856,3079,6935,11706,18449,26631,642.19,123.36,85.46,54.22
01-07-2021,SANTA MARTA DE PENAGUIÃO,4,0,61,"[0,120]",Baixo a Moderado,,,,4,Norte,VILA REAL,1711,6928.13,6599,483,373,337,316,317,633,970,1343,1826,95.25,26.36,19.39,14.0
01-07-2021,SANTANA,2,0,30,"[0,120]",Baixo a Moderado,,,,2,Madeira,MADEIRA,3109,9547.3,6711,418,353,343,282,277,559,902,1255,1673,70.29,17.52,13.15,9.45
01-07-2021,SANTARÉM,109,8,189,"[120,240]",Moderado,,,,109,Lisboa e Vale do Tejo,SANTARÉM,1416,55253.58,57421,3654,3441,2760,2466,2206,4672,7432,10873,14527,103.92,26.29,19.68,13.45
01-07-2021,SANTIAGO DO CACÉM,61,4,213,"[120,240]",Moderado,,,,61,Alentejo,SETÚBAL,1509,105969.29,28791,2144,1689,1472,1295,1215,2510,3982,5671,7815,27.17,7.37,5.35,3.76
01-07-2021,SANTO TIRSO,165,12,243,"[240,480]",Elevado,,,,165,Norte,PORTO,1314,13655.52,68055,4911,3935,2761,2257,1810,4067,6828,10763,15674,498.35,114.78,78.82,50.0
01-07-2021,SÃO BRÁS DE ALPORTEL,45,3,434,"[240,480]",Elevado,,,,45,Algarve,FARO,0812,15336.92,10416,596,468,467,404,401,805,1272,1740,2336,67.91,15.23,11.35,8.29
01-07-2021,SÃO JOÃO DA MADEIRA,7,1,32,"[0,120]",Baixo a Moderado,,,,7,Norte,AVEIRO,0116,794.3,21958,1347,1069,796,601,593,1194,1990,3059,4406,2765.49,554.91,385.26,250.63
01-07-2021,SÃO JOÃO DA PESQUEIRA,0,0,0,"[0,120]",Baixo a Moderado,,,,0,Norte,VISEU,1815,26610.85,7125,417,330,294,328,328,656,950,1280,1697,26.77,6.38,4.81,3.57
01-07-2021,SÃO PEDRO DO SUL,13,1,84,"[0,120]",Baixo a Moderado,,,,13,Centro,VISEU,1816,34895.09,15403,990,962,861,759,909,1668,2529,3491,4481,44.14,12.84,10.0,7.25
01-07-2021,SÃO ROQUE DO PICO,0,0,0,"[0,120]",Baixo a Moderado,,,,0,Açores,AÇORES,4603,14236.1,3266,199,141,93,96,113,209,302,443,642,22.94,4.51,3.11,2.12
01-07-2021,SÃO VICENTE,0,0,0,"[0,120]",Baixo a Moderado,,,,0,Madeira,MADEIRA,3110,7883.71,5143,272,264,266,225,280,505,771,1035,1307,65.23,16.58,13.13,9.78
01-07-2021,SARDOAL,10,1,269,"[240,480]",Elevado,,,,10,Lisboa e Vale do Tejo,SANTARÉM,1417,9214.72,3741,227,178,148,165,248,413,561,739,966,40.6,10.48,8.02,6.09
01-07-2021,SÁTÃO,6,0,52,"[0,120]",Baixo a Moderado,,,,6,Centro,VISEU,1817,20194.11,11580,765,671,515,465,476,941,1456,2127,2892,57.34,14.32,10.53,7.21
01-07-2021,SEIA,14,1,63,"[0,120]",Baixo a Moderado,,,,14,Centro,GUARDA,0912,43568.83,22234,1807,1589,1238,1122,721,1843,3081,4670,6477,51.03,14.87,10.72,7.07
01-07-2021,SEIXAL,619,44,369,"[240,480]",Elevado,,,,619,Lisboa e Vale do Tejo,SETÚBAL,1510,9545.17,167752,10586,9270,6661,4391,2930,7321,13982,23252,33838,1757.49,354.51,243.6,146.49
01-07-2021,SERNANCELHE,0,0,0,"[0,120]",Baixo a Moderado,,,,0,Norte,VISEU,1818,22861.22,5396,305,293,286,273,260,533,819,1112,1417,23.6,6.2,4.86,3.58
01-07-2021,SERPA,2,0,14,"[0,120]",Baixo a Moderado,,,,2,Alentejo,BEJA,0213,110563.34,14304,903,761,719,697,626,1323,2042,2803,3706,12.94,3.35,2.54,1.85
01-07-2021,SERTÃ,9,1,62,"[0,120]",Baixo a Moderado,,,,9,Centro,CASTELO BRANCO,0509,44673.17,14577,870,779,790,767,1020,1787,2577,3356,4226,32.63,9.46,7.51,5.77
01-07-2021,SESIMBRA,245,18,473,"[240,480]",Elevado,,,,245,Lisboa e Vale do Tejo,SETÚBAL,1511,19571.75,51858,2400,2321,1853,1257,1083,2340,4193,6514,8914,264.96,45.54,33.28,21.42
01-07-2021,SETÚBAL,266,19,231,"[120,240]",Moderado,,,,266,Lisboa e Vale do Tejo,SETÚBAL,1512,23032.5,115126,7425,6929,5075,3775,2655,6430,11505,18434,25859,499.83,112.27,80.03,49.95
01-07-2021,SEVER DO VOUGA,0,0,0,"[0,120]",Baixo a Moderado,,,,0,Centro,AVEIRO,0117,12987.56,11331,766,637,568,540,567,1107,1675,2312,3078,87.24,23.7,17.8,12.9
01-07-2021,SILVES,92,7,254,"[240,480]",Elevado,,,,92,Algarve,FARO,0813,68006.23,36226,2137,1869,1610,1423,1600,3023,4633,6502,8639,53.27,12.7,9.56,6.81
01-07-2021,SINES,21,1,153,"[120,240]",Moderado,,,,21,Alentejo,SETÚBAL,1513,20330.17,13715,888,791,551,416,268,684,1235,2026,2914,67.46,14.33,9.97,6.07
01-07-2021,SINTRA,1280,91,327,"[240,480]",Elevado,,,,1280,Lisboa e Vale do Tejo,LISBOA,1111,31922.73,391402,20490,18316,13545,9137,7284,16421,29966,48282,68772,1226.08,215.43,151.25,93.87
01-07-2021,SOBRAL DE MONTE AGRAÇO,41,3,388,"[240,480]",Elevado,,,,41,Lisboa e Vale do Tejo,LISBOA,1112,5210.32,10651,564,507,352,272,212,484,836,1343,1907,204.43,36.6,25.78,16.05
01-07-2021,SOURE,11,1,64,"[0,120]",Baixo a Moderado,,,,11,Centro,COIMBRA,0615,26506.07,17120,1173,1142,1004,883,987,1870,2874,4016,5189,64.59,19.58,15.15,10.84
01-07-2021,SOUSEL,16,1,370,"[240,480]",Elevado,,,,16,Alentejo,PORTALEGRE,1215,27932.18,4412,261,274,208,302,292,594,802,1076,1337,15.8,4.79,3.85,2.87
01-07-2021,TÁBUA,4,0,35,"[0,120]",Baixo a Moderado,,,,4,Centro,COIMBRA,0616,19978.58,11368,729,584,524,430,464,894,1418,2002,2731,56.9,13.67,10.02,7.1
01-07-2021,TABUAÇO,1,0,17,"[0,120]",Baixo a Moderado,,,,1,Norte,VISEU,1819,13385.67,6033,372,314,217,282,363,645,862,1176,1548,45.07,11.56,8.79,6.44
01-07-2021,TAROUCA,1,0,13,"[0,120]",Baixo a Moderado,,,,1,Norte,VISEU,1820,10008.49,7804,405,335,313,277,324,601,914,1249,1654,77.98,16.53,12.48,9.13
01-07-2021,TAVIRA,29,2,119,"[0,120]",Baixo a Moderado,,,,29,Algarve,FARO,0814,60696.7,24530,1493,1415,1252,1066,1277,2343,3595,5010,6503,40.41,10.71,8.25,5.92
01-07-2021,TERRAS DE BOURO,2,0,32,"[0,120]",Baixo a Moderado,,,,2,Norte,BRAGA,0310,27746.07,6361,391,372,296,319,340,659,955,1327,1718,22.93,6.19,4.78,3.44
01-07-2021,TOMAR,14,1,38,"[0,120]",Baixo a Moderado,,,,14,Lisboa e Vale do Tejo,SANTARÉM,1418,35120.44,36748,2403,2189,1868,1853,1822,3675,5543,7732,10135,104.64,28.86,22.02,15.78
01-07-2021,TONDELA,40,3,152,"[120,240]",Moderado,,,,40,Centro,VISEU,1821,37121.73,26357,1768,1722,1518,1475,1417,2892,4410,6132,7900,71.0,21.28,16.52,11.88
01-07-2021,TORRE DE MONCORVO,15,1,197,"[120,240]",Moderado,,,,15,Norte,BRAGANÇA,0409,53155.67,7695,556,478,488,551,719,1270,1758,2236,2792,14.48,5.25,4.21,3.31
01-07-2021,TORRES NOVAS,31,2,88,"[0,120]",Baixo a Moderado,,,,31,Lisboa e Vale do Tejo,SANTARÉM,1419,26999.68,34933,2324,1979,1738,1406,1475,2881,4619,6598,8922,129.38,33.04,24.44,17.11
01-07-2021,TORRES VEDRAS,186,13,237,"[120,240]",Moderado,,,,186,Lisboa e Vale do Tejo,LISBOA,1113,40714.89,78530,4513,3945,3447,2628,2104,4732,8179,12124,16637,192.88,40.86,29.78,20.09
01-07-2021,TRANCOSO,26,2,292,"[240,480]",Elevado,,,,26,Centro,GUARDA,0913,36152.47,8875,581,557,542,586,496,1082,1624,2181,2762,24.55,7.64,6.03,4.49
01-07-2021,TROFA,53,4,138,"[120,240]",Moderado,,,,53,Norte,PORTO,1318,7201.76,38418,2336,1894,1231,939,684,1623,2854,4748,7084,533.44,98.36,65.93,39.63
01-07-2021,VAGOS,58,4,257,"[240,480]",Elevado,,,,58,Centro,AVEIRO,0118,16491.5,22740,1320,1205,922,784,724,1508,2430,3635,4955,137.89,30.04,22.04,14.73
01-07-2021,VALE DE CAMBRA,9,1,42,"[0,120]",Baixo a Moderado,,,,9,Norte,AVEIRO,0119,14733.47,21327,1491,1363,1005,831,798,1629,2634,3997,5488,144.76,37.25,27.13,17.88
01-07-2021,VALENÇA,2,0,15,"[0,120]",Baixo a Moderado,,,,2,Norte,VIANA DO CASTELO,1608,11712.86,13290,867,791,582,582,503,1085,1667,2458,3325,113.46,28.39,20.99,14.23
01-07-2021,VALONGO,67,5,69,"[0,120]",Baixo a Moderado,,,,67,Norte,PORTO,1315,7512.45,97444,5629,4696,3207,2462,1829,4291,7498,12194,17823,1297.18,237.26,162.33,99.81
01-07-2021,VALPAÇOS,3,0,20,"[0,120]",Baixo a Moderado,,,,3,Norte,VILA REAL,1712,54873.93,14818,1217,1118,999,928,997,1925,2924,4042,5259,27.0,9.58,7.37,5.33
01-07-2021,VELAS,1,0,20,"[0,120]",Baixo a Moderado,,,,1,Açores,AÇORES,4502,11738.38,5093,278,208,166,153,113,266,432,640,918,43.39,7.82,5.45,3.68
01-07-2021,VENDAS NOVAS,3,0,27,"[0,120]",Baixo a Moderado,,,,3,Alentejo,ÉVORA,0712,22238.88,11255,677,768,655,501,532,1033,1688,2456,3133,50.61,14.09,11.04,7.59
01-07-2021,VIANA DO ALENTEJO,17,1,333,"[240,480]",Elevado,,,,17,Alentejo,ÉVORA,0713,39367.29,5145,245,208,235,210,214,424,659,867,1112,13.07,2.82,2.2,1.67
01-07-2021,VIANA DO CASTELO,41,3,49,"[0,120]",Baixo a Moderado,,,,41,Norte,VIANA DO CASTELO,1609,31902.01,84417,5470,4433,3591,3061,2982,6043,9634,14067,19537,264.61,61.24,44.09,30.2
01-07-2021,VIDIGUEIRA,1,0,18,"[0,120]",Baixo a Moderado,,,,1,Alentejo,BEJA,0214,31661.09,5510,300,248,215,233,275,508,723,971,1271,17.4,4.01,3.07,2.28
01-07-2021,VIEIRA DO MINHO,5,0,42,"[0,120]",Baixo a Moderado,,,,5,Norte,BRAGA,0311,21644.35,11842,703,594,525,548,482,1030,1555,2149,2852,54.71,13.18,9.93,7.18
01-07-2021,VILA DE REI,2,0,60,"[0,120]",Baixo a Moderado,,,,2,Centro,CASTELO BRANCO,0510,19154.6,3323,169,128,172,247,302,549,721,849,1018,17.35,5.31,4.43,3.76
01-07-2021,VILA DO BISPO,3,0,58,"[0,120]",Baixo a Moderado,,,,3,Algarve,FARO,0815,17906.06,5154,302,302,314,232,233,465,779,1081,1383,28.78,7.72,6.04,4.35
01-07-2021,VILA DO CONDE,44,3,55,"[0,120]",Baixo a Moderado,,,,44,Norte,PORTO,1316,14902.77,79899,4726,3875,2819,2070,1743,3813,6632,10507,15233,536.13,102.21,70.5,44.5
01-07-2021,VILA DO PORTO,4,0,71,"[0,120]",Baixo a Moderado,,,,4,Açores,AÇORES,4101,9688.74,5616,274,212,135,96,123,219,354,566,840,57.96,8.67,5.84,3.65
01-07-2021,VILA FLOR,1,0,17,"[0,120]",Baixo a Moderado,,,,1,Norte,BRAGANÇA,0410,26581.14,6044,429,362,422,294,331,625,1047,1409,1838,22.74,6.91,5.3,3.94
01-07-2021,VILA FRANCA DE XIRA,449,32,316,"[240,480]",Elevado,,,,449,Lisboa e Vale do Tejo,LISBOA,1114,31819.39,141957,8501,6852,4869,3425,2472,5897,10766,17618,26119,446.14,82.09,55.37,33.84
01-07-2021,VILA FRANCA DO CAMPO,7,1,64,"[0,120]",Baixo a Moderado,,,,7,Açores,AÇORES,4206,7796.82,11051,450,344,248,217,154,371,619,963,1413,141.73,18.12,12.35,7.94
01-07-2021,VILA NOVA DA BARQUINHA,8,1,106,"[0,120]",Baixo a Moderado,,,,8,Lisboa e Vale do Tejo,SANTARÉM,1420,4952.97,7461,415,406,392,364,338,702,1094,1500,1915,150.64,38.66,30.28,22.09
01-07-2021,VILA NOVA DE CERVEIRA,0,0,0,"[0,120]",Baixo a Moderado,,,,0,Norte,VIANA DO CASTELO,1610,10846.66,8910,531,444,410,384,334,718,1128,1572,2103,82.14,19.39,14.49,10.4
01-07-2021,VILA NOVA DE FAMALICÃO,162,12,123,"[120,240]",Moderado,,,,162,Norte,BRAGA,0312,20159.26,131676,7817,6164,4202,3282,2749,6031,10233,16397,24214,653.19,120.12,81.34,50.76
01-07-2021,VILA NOVA DE FOZ CÔA,1,0,16,"[0,120]",Baixo a Moderado,,,,1,Centro,GUARDA,0914,39815.18,6503,442,385,390,398,429,827,1217,1602,2044,16.33,5.13,4.02,3.06
01-07-2021,VILA NOVA DE GAIA,484,35,161,"[120,240]",Moderado,,,,484,Norte,PORTO,1317,16846.43,300472,18349,15568,10972,8224,6281,14505,25477,41045,59394,1783.64,352.57,243.65,151.23
01-07-2021,VILA NOVA DE PAIVA,1,0,21,"[0,120]",Baixo a Moderado,,,,1,Centro,VISEU,1822,17553.28,4687,289,272,233,217,241,458,691,963,1252,26.7,7.13,5.49,3.94
01-07-2021,VILA NOVA DE POIARES,4,0,57,"[0,120]",Baixo a Moderado,,,,4,Centro,COIMBRA,0617,8445.3,6939,380,284,262,235,182,417,679,963,1343,82.17,15.9,11.4,8.04
01-07-2021,VILA POUCA DE AGUIAR,11,1,93,"[0,120]",Baixo a Moderado,,,,11,Norte,VILA REAL,1713,43706.62,11961,860,817,733,601,627,1228,1961,2778,3638,27.37,8.32,6.36,4.49
01-07-2021,VILA REAL,59,4,118,"[0,120]",Baixo a Moderado,,,,59,Norte,VILA REAL,1714,37880.28,49962,3025,2498,2065,1579,1466,3045,5110,7608,10633,131.9,28.07,20.08,13.49
01-07-2021,VILA REAL DE SANTO ANTÓNIO,11,1,59,"[0,120]",Baixo a Moderado,,,,11,Algarve,FARO,0816,6125.0,18749,1172,1069,811,569,586,1155,1966,3035,4207,306.11,68.69,49.55,32.1
01-07-2021,VILA VELHA DE RÓDÃO,0,0,0,"[0,120]",Baixo a Moderado,,,,0,Centro,CASTELO BRANCO,0511,32991.16,3144,209,229,180,283,306,589,769,998,1207,9.53,3.66,3.03,2.33
01-07-2021,VILA VERDE,45,3,96,"[0,120]",Baixo a Moderado,,,,45,Norte,BRAGA,0313,22866.52,46911,2365,2063,1667,1494,1437,2931,4598,6661,9026,205.15,39.47,29.13,20.11
01-07-2021,VILA VIÇOSA,4,0,53,"[0,120]",Baixo a Moderado,,,,4,Alentejo,ÉVORA,0714,19485.89,7656,487,379,342,345,324,669,1011,1390,1877,39.29,9.63,7.13,5.19
01-07-2021,VIMIOSO,1,0,25,"[0,120]",Baixo a Moderado,,,,1,Norte,BRAGANÇA,0411,48158.51,4023,274,230,261,293,335,628,889,1119,1393,8.35,2.89,2.32,1.85
01-07-2021,VINHAIS,0,0,0,"[0,120]",Baixo a Moderado,,,,0,Norte,BRAGANÇA,0412,69475.09,7746,599,577,636,641,815,1456,2092,2669,3268,11.15,4.7,3.84,3.01
01-07-2021,VISEU,160,11,165,"[120,240]",Moderado,,,,160,Centro,VISEU,1823,50710.14,97249,5769,5038,4140,3158,2710,5868,10008,15046,20815,191.77,41.05,29.67,19.74
01-07-2021,VIZELA,12,1,50,"[0,120]",Baixo a Moderado,,,,12,Norte,BRAGA,0314,2469.83,23897,1258,928,655,509,371,880,1535,2463,3721,967.49,150.65,99.72,62.15
01-07-2021,VOUZELA,9,1,94,"[0,120]",Baixo a Moderado,,,,9,Centro,VISEU,1824,19369.46,9619,626,605,554,532,507,1039,1593,2198,2824,49.66,14.58,11.35,8.22
08-07-2021,ABRANTES,30,2,86,"[0,120]",Baixo a Moderado,,,,30,Lisboa e Vale do Tejo,SANTARÉM,1401,71469.08,35130,2473,2213,1730,1748,2021,3769,5499,7712,10185,49.15,14.25,10.79,7.69
08-07-2021,ÁGUEDA,55,4,119,"[0,120]",Baixo a Moderado,,,,55,Centro,AVEIRO,0101,33527.44,46075,3237,2713,2090,1635,1496,3131,5221,7934,11171,137.43,33.32,23.66,15.57
08-07-2021,AGUIAR DA BEIRA,0,0,0,"[0,120]",Baixo a Moderado,,,,0,Centro,GUARDA,0901,20676.57,4652,304,281,235,239,148,387,622,903,1207,22.5,5.84,4.37,3.01
08-07-2021,ALANDROAL,2,0,41,"[0,120]",Baixo a Moderado,,,,2,Alentejo,ÉVORA,0701,54267.81,4992,307,256,296,299,377,676,972,1228,1535,9.2,2.83,2.26,1.79
08-07-2021,ALBERGARIA-A-VELHA,65,5,268,"[240,480]",Elevado,,,,65,Centro,AVEIRO,0102,15882.5,24144,1550,1298,996,687,680,1367,2363,3661,5211,152.02,32.81,23.05,14.88
08-07-2021,ALBUFEIRA,414,30,997,"[960,Max]",Extremamente Elevado,,,,414,Algarve,FARO,0801,14066.42,41528,2067,1717,1425,985,858,1843,3268,4985,7052,295.24,50.14,35.44,23.23
08-07-2021,ALCÁCER DO SAL,5,0,43,"[0,120]",Baixo a Moderado,,,,5,Alentejo,SETÚBAL,1501,149987.3,11659,884,814,623,623,602,1225,1848,2662,3546,7.77,2.36,1.77,1.23
08-07-2021,ALCANENA,12,1,93,"[0,120]",Baixo a Moderado,,,,12,Lisboa e Vale do Tejo,SANTARÉM,1402,12732.86,12809,891,744,628,536,588,1124,1752,2496,3387,100.6,26.6,19.6,13.76
08-07-2021,ALCOBAÇA,72,5,134,"[120,240]",Moderado,,,,72,Lisboa e Vale do Tejo,LEIRIA,1001,40814.09,53555,3420,2927,2466,2059,1676,3735,6201,9128,12548,131.22,30.74,22.36,15.19
08-07-2021,ALCOCHETE,53,4,266,"[240,480]",Elevado,,,,53,Lisboa e Vale do Tejo,SETÚBAL,1502,12836.48,19787,857,834,691,476,447,923,1614,2448,3305,154.15,25.75,19.07,12.57
08-07-2021,ALCOUTIM,1,0,48,"[0,120]",Baixo a Moderado,,,,1,Algarve,FARO,0802,57536.33,2159,191,188,163,190,267,457,620,808,999,3.75,1.74,1.4,1.08
08-07-2021,ALENQUER,103,7,233,"[120,240]",Moderado,,,,103,Lisboa e Vale do Tejo,LISBOA,1101,30421.92,44052,2298,2062,1629,1330,1155,2485,4114,6176,8474,144.8,27.85,20.3,13.52
08-07-2021,ALFÂNDEGA DA FÉ,0,0,0,"[0,120]",Baixo a Moderado,,,,0,Norte,BRAGANÇA,0401,32194.64,4550,325,277,301,274,325,599,900,1177,1502,14.13,4.67,3.66,2.8
08-07-2021,ALIJÓ,1,0,9,"[0,120]",Baixo a Moderado,,,,1,Norte,VILA REAL,1701,29759.89,10625,766,687,635,542,666,1208,1843,2530,3296,35.7,11.08,8.5,6.19
08-07-2021,ALJEZUR,9,1,161,"[120,240]",Moderado,,,,9,Algarve,FARO,0803,32349.95,5594,316,336,335,320,410,730,1065,1401,1717,17.29,5.31,4.33,3.29
08-07-2021,ALJUSTREL,11,1,135,"[120,240]",Moderado,,,,11,Alentejo,BEJA,0201,45847.41,8247,635,521,443,347,358,705,1148,1669,2304,17.99,5.03,3.64,2.5
08-07-2021,ALMADA,887,63,525,"[480,960]",Muito Elevado,,,,887,Lisboa e Vale do Tejo,SETÚBAL,1503,7000.89,169039,10469,9777,7876,6144,5111,11255,19131,28908,39377,2414.5,562.45,412.91,273.26
08-07-2021,ALMEIDA,2,0,35,"[0,120]",Baixo a Moderado,,,,2,Centro,GUARDA,0902,51798.46,5830,441,419,396,458,393,851,1247,1666,2107,11.26,4.07,3.22,2.41
08-07-2021,ALMEIRIM,14,1,62,"[0,120]",Baixo a Moderado,,,,14,Lisboa e Vale do Tejo,SANTARÉM,1403,22212.05,22546,1342,1353,1106,866,843,1709,2815,4168,5510,101.5,24.81,18.76,12.67
08-07-2021,ALMODÔVAR,10,1,150,"[120,240]",Moderado,,,,10,Alentejo,BEJA,0202,77788.03,6725,414,443,396,373,328,701,1097,1540,1954,8.65,2.51,1.98,1.41
08-07-2021,ALPIARÇA,9,1,129,"[120,240]",Moderado,,,,9,Lisboa e Vale do Tejo,SANTARÉM,1404,9536.33,7059,515,486,363,333,274,607,970,1456,1971,74.02,20.67,15.27,10.17
08-07-2021,ALTER DO CHÃO,2,0,64,"[0,120]",Baixo a Moderado,,,,2,Alentejo,PORTALEGRE,1201,36206.62,3165,201,163,136,208,187,395,531,694,895,8.74,2.47,1.92,1.47
08-07-2021,ALVAIÁZERE,1,0,15,"[0,120]",Baixo a Moderado,,,,1,Centro,LEIRIA,1002,16047.76,6597,419,389,346,406,539,945,1291,1680,2099,41.11,13.08,10.47,8.04
08-07-2021,ALVITO,1,0,41,"[0,120]",Baixo a Moderado,,,,1,Alentejo,BEJA,0203,26485.32,2477,145,110,105,111,89,200,305,415,560,9.35,2.11,1.57,1.15
08-07-2021,AMADORA,893,64,485,"[480,960]",Muito Elevado,,,,893,Lisboa e Vale do Tejo,LISBOA,1115,2378.47,184106,11186,10936,8780,6460,5890,12350,21130,32066,43252,7742.05,1818.84,1348.44,888.56
08-07-2021,AMARANTE,59,4,110,"[0,120]",Baixo a Moderado,,,,59,Norte,PORTO,1301,30133.15,53193,3086,2413,1812,1643,1311,2954,4766,7179,10265,176.53,34.07,23.82,15.82
08-07-2021,AMARES,6,0,33,"[0,120]",Baixo a Moderado,,,,6,Norte,BRAGA,0301,8195.41,18129,1001,829,622,489,524,1013,1635,2464,3465,221.22,42.28,30.07,19.95
08-07-2021,ANADIA,29,2,106,"[0,120]",Baixo a Moderado,,,,29,Centro,AVEIRO,0103,21663.48,27258,1931,1698,1376,1208,1262,2470,3846,5544,7475,125.83,34.51,25.59,17.75
08-07-2021,ANGRA DO HEROÍSMO,6,0,18,"[0,120]",Baixo a Moderado,,,,6,Açores,AÇORES,4301,23899.66,33807,2006,1473,1122,768,635,1403,2525,3998,6004,141.45,25.12,16.73,10.56
08-07-2021,ANSIÃO,10,1,83,"[0,120]",Baixo a Moderado,,,,10,Centro,LEIRIA,1003,17609.42,12039,727,709,646,694,530,1224,1870,2579,3306,68.37,18.77,14.65,10.62
08-07-2021,ARCOS DE VALDEVEZ,6,0,29,"[0,120]",Baixo a Moderado,,,,6,Norte,VIANA DO CASTELO,1601,44759.64,20926,1329,1338,1282,1343,1515,2858,4140,5478,6807,46.75,15.21,12.24,9.25
08-07-2021,ARGANIL,1,0,9,"[0,120]",Baixo a Moderado,,,,1,Centro,COIMBRA,0601,33283.93,11014,672,648,612,559,596,1155,1767,2415,3087,33.09,9.27,7.26,5.31
08-07-2021,ARMAMAR,2,0,35,"[0,120]",Baixo a Moderado,,,,2,Norte,VISEU,1801,11723.73,5769,357,305,309,285,310,595,904,1209,1566,49.21,13.36,10.31,7.71
08-07-2021,AROUCA,71,5,345,"[240,480]",Elevado,,,,71,Norte,AVEIRO,0104,32910.52,20720,1306,1047,753,683,683,1366,2119,3166,4472,62.96,13.59,9.62,6.44
08-07-2021,ARRAIOLOS,22,2,320,"[240,480]",Elevado,,,,22,Alentejo,ÉVORA,0702,68374.55,6928,435,384,283,367,480,847,1130,1514,1949,10.13,2.85,2.21,1.65
08-07-2021,ARRONCHES,0,0,0,"[0,120]",Baixo a Moderado,,,,0,Alentejo,PORTALEGRE,1202,31464.72,2820,155,142,162,187,179,366,528,670,825,8.96,2.62,2.13,1.68
08-07-2021,ARRUDA DOS VINHOS,44,3,285,"[240,480]",Elevado,,,,44,Lisboa e Vale do Tejo,LISBOA,1102,7795.93,15412,738,738,562,509,438,947,1509,2247,2985,197.69,38.29,28.82,19.36
08-07-2021,AVEIRO,213,15,270,"[240,480]",Elevado,,,,213,Centro,AVEIRO,0105,19757.57,78734,4520,4004,3050,2250,2103,4353,7403,11407,15927,398.49,80.61,57.73,37.47
08-07-2021,AVIS,33,2,787,"[480,960]",Muito Elevado,,,,33,Alentejo,PORTALEGRE,1203,60596.51,4247,315,225,206,251,273,524,730,955,1270,7.01,2.1,1.58,1.2
08-07-2021,AZAMBUJA,54,4,237,"[120,240]",Moderado,,,,54,Lisboa e Vale do Tejo,LISBOA,1103,26265.65,22716,1322,1171,1070,798,618,1416,2486,3657,4979,86.48,18.96,13.92,9.46
08-07-2021,BAIÃO,8,1,43,"[0,120]",Baixo a Moderado,,,,8,Norte,PORTO,1302,17452.83,18748,1070,862,714,686,725,1411,2125,2987,4057,107.42,23.25,17.11,12.18
08-07-2021,BARCELOS,157,11,135,"[120,240]",Moderado,,,,157,Norte,BRAGA,0302,37890.14,116187,6721,5325,3619,2991,2562,5553,9172,14497,21218,306.64,56.0,38.26,24.21
08-07-2021,BARRANCOS,1,0,62,"[0,120]",Baixo a Moderado,,,,1,Alentejo,BEJA,0204,16841.73,1634,90,65,65,94,61,155,220,285,375,9.7,2.23,1.69,1.31
08-07-2021,BARREIRO,327,23,435,"[240,480]",Elevado,,,,327,Lisboa e Vale do Tejo,SETÚBAL,1504,3639.07,75147,5194,5565,4459,3105,1767,4872,9331,14896,20090,2065.05,552.07,409.34,256.42
08-07-2021,BATALHA,29,2,179,"[120,240]",Moderado,,,,29,Centro,LEIRIA,1004,10341.6,15963,873,762,649,529,549,1078,1727,2489,3362,154.35,32.51,24.07,16.7
08-07-2021,BEJA,37,3,111,"[0,120]",Baixo a Moderado,,,,37,Alentejo,BEJA,0205,114647.55,33579,2005,1840,1386,1272,1039,2311,3697,5537,7542,29.29,6.58,4.83,3.22
08-07-2021,BELMONTE,3,0,47,"[0,120]",Baixo a Moderado,,,,3,Centro,CASTELO BRANCO,0501,11875.91,6398,444,321,325,310,355,665,990,1311,1755,53.87,14.78,11.04,8.34
08-07-2021,BENAVENTE,82,6,267,"[240,480]",Elevado,,,,82,Lisboa e Vale do Tejo,SANTARÉM,1405,52138.39,30602,1468,1376,1141,876,643,1519,2660,4036,5504,58.69,10.56,7.74,5.1
08-07-2021,BOMBARRAL,26,2,205,"[120,240]",Moderado,,,,26,Lisboa e Vale do Tejo,LEIRIA,1005,9128.55,12558,875,714,561,491,429,920,1481,2195,3070,137.56,33.63,24.04,16.22
08-07-2021,BORBA,3,0,45,"[0,120]",Baixo a Moderado,,,,3,Alentejo,ÉVORA,0703,14518.65,6736,430,375,279,436,392,828,1107,1482,1912,46.39,13.17,10.21,7.62
08-07-2021,BOTICAS,1,0,20,"[0,120]",Baixo a Moderado,,,,1,Norte,VILA REAL,1702,32195.66,4998,347,306,311,305,380,685,996,1302,1649,15.52,5.12,4.04,3.09
08-07-2021,BRAGA,314,22,172,"[120,240]",Moderado,,,,314,Norte,BRAGA,0303,18339.95,182679,10029,7963,5241,4320,3671,7991,13232,21195,31224,996.07,170.25,115.57,72.15
08-07-2021,BRAGANÇA,32,2,96,"[0,120]",Baixo a Moderado,,,,32,Norte,BRAGANÇA,0402,117357.27,33607,2402,1855,1652,1393,1163,2556,4208,6063,8465,28.64,7.21,5.17,3.59
08-07-2021,CABECEIRAS DE BASTO,12,1,77,"[0,120]",Baixo a Moderado,,,,12,Norte,BRAGA,0304,24182.16,15628,774,594,544,575,574,1149,1693,2287,3061,64.63,12.66,9.46,7.0
08-07-2021,CADAVAL,10,1,73,"[0,120]",Baixo a Moderado,,,,10,Lisboa e Vale do Tejo,LISBOA,1104,17489.3,13673,813,796,756,621,625,1246,2002,2798,3611,78.18,20.65,16.0,11.45
08-07-2021,CALDAS DA RAINHA,66,5,128,"[120,240]",Moderado,,,,66,Lisboa e Vale do Tejo,LEIRIA,1006,25569.47,51912,3035,2684,2186,1899,1705,3604,5790,8474,11509,203.03,45.01,33.14,22.64
08-07-2021,CALHETA,18,1,166,"[120,240]",Moderado,,,,18,Madeira,MADEIRA,3101,11150.43,10867,576,497,507,399,415,814,1321,1818,2394,97.46,21.47,16.3,11.85
08-07-2021,CALHETA (AÇORES),0,0,0,"[0,120]",Baixo a Moderado,,,,0,Açores,AÇORES,4501,12626.4,3184,215,159,141,139,122,261,402,561,776,25.22,6.15,4.44,3.18
08-07-2021,CÂMARA DE LOBOS,10,1,30,"[0,120]",Baixo a Moderado,,,,10,Madeira,MADEIRA,3102,5216.67,33675,1396,1059,834,545,381,926,1760,2819,4215,645.49,80.79,54.03,33.74
08-07-2021,CAMINHA,5,0,32,"[0,120]",Baixo a Moderado,,,,5,Norte,VIANA DO CASTELO,1602,13652.14,15877,1046,944,818,646,656,1302,2120,3064,4110,116.3,30.11,22.44,15.53
08-07-2021,CAMPO MAIOR,2,0,26,"[0,120]",Baixo a Moderado,,,,2,Alentejo,PORTALEGRE,1204,24720.16,7874,471,364,351,279,327,606,957,1321,1792,31.85,7.25,5.34,3.87
08-07-2021,CANTANHEDE,67,5,191,"[120,240]",Moderado,,,,67,Centro,COIMBRA,0602,39088.02,35011,2346,2096,1880,1709,1451,3160,5040,7136,9482,89.57,24.26,18.26,12.89
08-07-2021,CARRAZEDA DE ANSIÃES,2,0,36,"[0,120]",Baixo a Moderado,,,,2,Norte,BRAGANÇA,0403,27924.09,5666,424,389,391,312,465,777,1168,1557,1981,20.29,7.09,5.58,4.18
08-07-2021,CARREGAL DO SAL,26,2,279,"[240,480]",Elevado,,,,26,Centro,VISEU,1802,11689.21,9271,587,562,486,462,376,838,1324,1886,2473,79.31,21.16,16.13,11.33
08-07-2021,CARTAXO,29,2,122,"[120,240]",Moderado,,,,29,Lisboa e Vale do Tejo,SANTARÉM,1406,15817.28,23843,1415,1376,1142,861,632,1493,2635,4011,5426,150.74,34.3,25.36,16.66
08-07-2021,CASCAIS,966,69,452,"[240,480]",Elevado,,,,966,Lisboa e Vale do Tejo,LISBOA,1105,9740.17,213608,12151,11444,8680,6469,5248,11717,20397,31841,43992,2193.1,451.66,326.91,209.41
08-07-2021,CASTANHEIRA DE PÊRA,0,0,0,"[0,120]",Baixo a Moderado,,,,0,Centro,LEIRIA,1007,6677.45,2614,233,195,157,190,187,377,534,729,962,39.15,14.41,10.92,8.0
08-07-2021,CASTELO BRANCO,36,3,69,"[0,120]",Baixo a Moderado,,,,36,Centro,CASTELO BRANCO,0502,143819.15,51987,3528,3042,2499,2229,2225,4454,6953,9995,13523,36.15,9.4,6.95,4.83
08-07-2021,CASTELO DE PAIVA,11,1,72,"[0,120]",Baixo a Moderado,,,,11,Norte,AVEIRO,0106,11500.53,15454,881,697,545,420,431,851,1396,2093,2974,134.37,25.86,18.2,12.14
08-07-2021,CASTELO DE VIDE,3,0,104,"[0,120]",Baixo a Moderado,,,,3,Alentejo,PORTALEGRE,1205,26491.24,2919,204,173,179,147,170,317,496,669,873,11.02,3.3,2.53,1.87
08-07-2021,CASTRO DAIRE,16,1,116,"[0,120]",Baixo a Moderado,,,,16,Centro,VISEU,1803,37904.13,13823,942,857,765,732,773,1505,2270,3127,4069,36.47,10.74,8.25,5.99
08-07-2021,CASTRO MARIM,19,1,307,"[240,480]",Elevado,,,,19,Algarve,FARO,0804,30084.37,6237,370,345,334,322,344,666,1000,1345,1715,20.73,5.7,4.47,3.32
08-07-2021,CASTRO VERDE,11,1,160,"[120,240]",Moderado,,,,11,Alentejo,BEJA,0206,56944.23,6949,437,347,303,275,227,502,805,1152,1589,12.2,2.79,2.02,1.41
08-07-2021,CELORICO DA BEIRA,5,0,72,"[0,120]",Baixo a Moderado,,,,5,Centro,GUARDA,0903,24721.63,6928,430,416,363,369,535,904,1267,1683,2113,28.02,8.55,6.81,5.12
08-07-2021,CELORICO DE BASTO,9,1,48,"[0,120]",Baixo a Moderado,,,,9,Norte,BRAGA,0305,18107.02,19040,1001,802,668,728,729,1457,2125,2927,3928,105.15,21.69,16.17,11.74
08-07-2021,CHAMUSCA,19,1,210,"[120,240]",Moderado,,,,19,Lisboa e Vale do Tejo,SANTARÉM,1407,74600.54,9197,629,583,553,465,579,1044,1597,2180,2809,12.33,3.77,2.92,2.14
08-07-2021,CHAVES,104,7,265,"[240,480]",Elevado,,,,104,Norte,VILA REAL,1703,59122.95,39343,2676,2429,1991,1886,1918,3804,5795,8224,10900,66.54,18.44,13.91,9.8
08-07-2021,CINFÃES,32,2,178,"[120,240]",Moderado,,,,32,Norte,VISEU,1804,23928.76,18244,1067,902,779,734,758,1492,2271,3173,4240,76.24,17.72,13.26,9.49
08-07-2021,COIMBRA,173,12,129,"[120,240]",Moderado,,,,173,Centro,COIMBRA,0603,31939.94,134166,9489,8734,6353,5139,5074,10213,16566,25300,34789,420.06,108.92,79.21,51.87
08-07-2021,CONDEIXA-A-NOVA,17,1,95,"[0,120]",Baixo a Moderado,,,,17,Centro,COIMBRA,0604,13867.47,17733,871,809,717,583,490,1073,1790,2599,3470,127.88,25.02,18.74,12.91
08-07-2021,CONSTÂNCIA,18,1,444,"[240,480]",Elevado,,,,18,Lisboa e Vale do Tejo,SANTARÉM,1408,8036.58,4030,211,183,187,148,155,303,490,673,884,50.14,11.0,8.37,6.1
08-07-2021,CORUCHE,13,1,76,"[0,120]",Baixo a Moderado,,,,13,Lisboa e Vale do Tejo,SANTARÉM,1409,111572.03,17471,1294,1090,1095,1096,1019,2115,3210,4300,5594,15.66,5.01,3.85,2.88
08-07-2021,CORVO,0,0,0,"[0,120]",Baixo a Moderado,,,,0,Açores,AÇORES,4901,1711.45,464,22,21,11,13,19,32,43,64,86,27.12,5.03,3.74,2.51
08-07-2021,COVILHÃ,16,1,34,"[0,120]",Baixo a Moderado,,,,16,Centro,CASTELO BRANCO,0503,55560.06,46787,3533,2998,2365,2111,2193,4304,6669,9667,13200,84.21,23.76,17.4,12.0
08-07-2021,CRATO,1,0,33,"[0,120]",Baixo a Moderado,,,,1,Alentejo,PORTALEGRE,1206,39806.88,3129,229,258,163,182,228,410,573,831,1060,7.86,2.66,2.09,1.44
08-07-2021,CUBA,2,0,44,"[0,120]",Baixo a Moderado,,,,2,Alentejo,BEJA,0207,17208.72,4595,255,233,206,190,143,333,539,772,1027,26.7,5.97,4.49,3.13
08-07-2021,ELVAS,106,8,518,"[480,960]",Muito Elevado,,,,106,Alentejo,PORTALEGRE,1207,63128.86,20528,1057,1145,902,852,810,1662,2564,3709,4766,32.52,7.55,5.88,4.06
08-07-2021,ENTRONCAMENTO,18,1,82,"[0,120]",Baixo a Moderado,,,,18,Lisboa e Vale do Tejo,SANTARÉM,1410,1372.81,21558,1066,930,868,695,592,1287,2155,3085,4151,1570.14,302.33,224.69,156.96
08-07-2021,ESPINHO,44,3,150,"[120,240]",Moderado,,,,44,Norte,AVEIRO,0107,2105.68,29516,2205,1993,1430,1177,960,2137,3567,5560,7765,1401.52,368.71,264.01,169.37
08-07-2021,ESPOSENDE,28,2,82,"[0,120]",Baixo a Moderado,,,,28,Norte,BRAGA,0306,9540.98,34177,1831,1522,1095,894,723,1617,2712,4234,6065,358.21,63.57,44.38,28.42
08-07-2021,ESTARREJA,16,1,61,"[0,120]",Baixo a Moderado,,,,16,Centro,AVEIRO,0108,10817.33,26006,1503,1399,1106,953,728,1681,2787,4186,5689,240.42,52.59,38.7,25.76
08-07-2021,ESTREMOZ,5,0,40,"[0,120]",Baixo a Moderado,,,,5,Alentejo,ÉVORA,0704,51379.95,12728,789,613,697,786,877,1663,2360,2973,3762,24.77,7.32,5.79,4.59
08-07-2021,ÉVORA,71,5,136,"[120,240]",Moderado,,,,71,Alentejo,ÉVORA,0705,130707.58,52428,3569,2852,2176,1966,1803,3769,5945,8797,12366,40.11,9.46,6.73,4.55
08-07-2021,FAFE,88,6,184,"[120,240]",Moderado,,,,88,Norte,BRAGA,0307,21908.11,48060,3044,2455,1679,1403,1208,2611,4290,6745,9789,219.37,44.68,30.79,19.58
08-07-2021,FARO,436,31,714,"[480,960]",Muito Elevado,,,,436,Algarve,FARO,0805,20256.79,61015,3847,3364,2604,2055,1601,3656,6260,9624,13471,301.2,66.5,47.51,30.9
08-07-2021,FELGUEIRAS,49,4,87,"[0,120]",Baixo a Moderado,,,,49,Norte,PORTO,1303,11573.75,56422,2951,2302,1601,1316,973,2289,3890,6192,9143,487.49,79.0,53.5,33.61
08-07-2021,FERREIRA DO ALENTEJO,3,0,38,"[0,120]",Baixo a Moderado,,,,3,Alentejo,BEJA,0208,64820.68,7845,515,414,372,343,345,688,1060,1474,1989,12.1,3.07,2.27,1.64
08-07-2021,FERREIRA DO ZÊZERE,6,0,75,"[0,120]",Baixo a Moderado,,,,6,Lisboa e Vale do Tejo,SANTARÉM,1411,19038.03,7959,470,370,416,465,456,921,1337,1707,2177,41.81,11.44,8.97,7.02
08-07-2021,FIGUEIRA DA FOZ,93,7,158,"[120,240]",Moderado,,,,93,Centro,COIMBRA,0605,37905.26,58747,4032,3597,2887,2495,2043,4538,7425,11022,15054,154.98,39.72,29.08,19.59
08-07-2021,FIGUEIRA DE CASTELO RODRIGO,0,0,0,"[0,120]",Baixo a Moderado,,,,0,Centro,GUARDA,0904,50857.46,5584,347,352,290,352,391,743,1033,1385,1732,10.98,3.41,2.72,2.03
08-07-2021,FIGUEIRÓ DOS VINHOS,0,0,0,"[0,120]",Baixo a Moderado,,,,0,Centro,LEIRIA,1008,17344.0,5568,402,386,322,309,351,660,982,1368,1770,32.1,10.21,7.89,5.66
08-07-2021,FORNOS DE ALGODRES,4,0,88,"[0,120]",Baixo a Moderado,,,,4,Centro,GUARDA,0905,13145.05,4528,261,218,247,256,232,488,735,953,1214,34.45,9.24,7.25,5.59
08-07-2021,FREIXO DE ESPADA À CINTA,0,0,0,"[0,120]",Baixo a Moderado,,,,0,Norte,BRAGANÇA,0404,24414.29,3298,211,177,231,196,189,385,616,793,1004,13.51,4.11,3.25,2.52
08-07-2021,FRONTEIRA,0,0,0,"[0,120]",Baixo a Moderado,,,,0,Alentejo,PORTALEGRE,1208,24859.58,2974,213,182,149,156,168,324,473,655,868,11.96,3.49,2.63,1.9
08-07-2021,FUNCHAL,101,7,97,"[0,120]",Baixo a Moderado,,,,101,Madeira,MADEIRA,3103,7616.2,104024,6382,5086,3643,2821,1990,4811,8454,13540,19922,1365.86,261.58,177.78,111.0
08-07-2021,FUNDÃO,12,1,45,"[0,120]",Baixo a Moderado,,,,12,Centro,CASTELO BRANCO,0504,70019.79,26495,1781,1464,1432,1357,1643,3000,4432,5896,7677,37.84,10.96,8.42,6.33
08-07-2021,GAVIÃO,5,0,157,"[120,240]",Moderado,,,,5,Alentejo,PORTALEGRE,1209,29459.45,3263,189,186,222,263,293,556,778,964,1153,11.08,3.91,3.27,2.64
08-07-2021,GÓIS,1,0,27,"[0,120]",Baixo a Moderado,,,,1,Centro,COIMBRA,0606,26330.19,3805,235,199,240,233,244,477,717,916,1151,14.45,4.37,3.48,2.72
08-07-2021,GOLEGÃ,4,0,76,"[0,120]",Baixo a Moderado,,,,4,Lisboa e Vale do Tejo,SANTARÉM,1412,8431.67,5339,356,299,281,243,255,498,779,1078,1434,63.32,17.01,12.78,9.24
08-07-2021,GONDOMAR,377,27,227,"[120,240]",Moderado,,,,377,Norte,PORTO,1304,13191.76,165985,10555,8755,6222,4450,3364,7814,14036,22791,33346,1258.22,252.77,172.76,106.4
08-07-2021,GOUVEIA,21,2,170,"[120,240]",Moderado,,,,21,Centro,GUARDA,0906,30061.17,12387,871,931,780,783,810,1593,2373,3304,4175,41.21,13.89,10.99,7.89
08-07-2021,GRÂNDOLA,18,1,123,"[120,240]",Moderado,,,,18,Alentejo,SETÚBAL,1505,82593.66,14639,834,834,708,688,672,1360,2068,2902,3736,17.72,4.52,3.51,2.5
08-07-2021,GUARDA,86,6,221,"[120,240]",Moderado,,,,86,Centro,GUARDA,0907,71209.58,38969,2477,2041,1686,1415,1474,2889,4575,6616,9093,54.72,12.77,9.29,6.42
08-07-2021,GUIMARÃES,203,14,133,"[120,240]",Moderado,,,,203,Norte,BRAGA,0308,24099.96,152309,9394,7074,4809,3877,2948,6825,11634,18708,28102,631.99,116.61,77.63,48.27
08-07-2021,HORTA,4,0,28,"[0,120]",Baixo a Moderado,,,,4,Açores,AÇORES,4701,17305.53,14521,818,658,468,352,302,654,1122,1780,2598,83.91,15.01,10.29,6.48
08-07-2021,IDANHA-A-NOVA,12,1,151,"[120,240]",Moderado,,,,12,Centro,CASTELO BRANCO,0505,141633.51,8043,518,490,519,672,974,1646,2165,2655,3173,5.68,2.24,1.87,1.53
08-07-2021,ÍLHAVO,97,7,250,"[240,480]",Elevado,,,,97,Centro,AVEIRO,0110,7347.55,38699,2227,1943,1444,1193,850,2043,3487,5430,7657,526.66,104.21,73.9,47.46
08-07-2021,LAGOA (FARO),66,5,290,"[240,480]",Elevado,,,,66,Algarve,FARO,0806,8825.45,22762,1314,1168,919,749,670,1419,2338,3506,4820,257.93,54.62,39.73,26.49
08-07-2021,LAGOA,127,9,861,"[480,960]",Muito Elevado,,,,127,Açores,AÇORES,4201,4559.32,14721,536,458,349,238,235,473,822,1280,1816,322.9,39.83,28.08,18.03
08-07-2021,LAGOS,213,15,700,"[480,960]",Muito Elevado,,,,213,Algarve,FARO,0807,21299.27,30374,1744,1434,1247,1053,1029,2082,3329,4763,6507,142.61,30.55,22.36,15.63
08-07-2021,LAJES DAS FLORES,0,0,0,"[0,120]",Baixo a Moderado,,,,0,Açores,AÇORES,4801,7004.79,1463,88,53,62,46,54,100,162,215,303,20.89,4.33,3.07,2.31
08-07-2021,LAJES DO PICO,1,0,22,"[0,120]",Baixo a Moderado,,,,1,Açores,AÇORES,4601,15531.09,4490,304,231,223,159,162,321,544,775,1079,28.91,6.95,4.99,3.5
08-07-2021,LAMEGO,11,1,44,"[0,120]",Baixo a Moderado,,,,11,Norte,VISEU,1805,16542.11,24895,1639,1284,1124,898,783,1681,2805,4089,5728,150.5,34.63,24.72,16.96
08-07-2021,LEIRIA,178,13,142,"[120,240]",Moderado,,,,178,Centro,LEIRIA,1009,56508.83,125267,7389,6366,5090,3902,3159,7061,12151,18517,25906,221.68,45.84,32.77,21.5
08-07-2021,LISBOA,3816,273,749,"[480,960]",Muito Elevado,,,,3816,Lisboa e Vale do Tejo,LISBOA,1106,10005.43,509515,33197,33340,27706,23037,26770,49807,77513,110853,144050,5092.6,1439.78,1107.98,774.74
08-07-2021,LOULÉ,698,50,1016,"[960,Max]",Extremamente Elevado,,,,698,Algarve,FARO,0808,76366.91,68697,3890,3350,2780,2358,2251,4609,7389,10739,14629,89.96,19.16,14.06,9.68
08-07-2021,LOURES,878,63,411,"[240,480]",Elevado,,,,878,Lisboa e Vale do Tejo,LISBOA,1107,16723.99,213687,12746,12794,9644,6669,5033,11702,21346,34140,46886,1277.73,280.35,204.14,127.64
08-07-2021,LOURINHÃ,133,10,516,"[480,960]",Muito Elevado,,,,133,Lisboa e Vale do Tejo,LISBOA,1108,14717.2,25855,1584,1243,992,842,645,1487,2479,3722,5306,175.68,36.05,25.29,16.84
08-07-2021,LOUSÃ,12,1,69,"[0,120]",Baixo a Moderado,,,,12,Centro,COIMBRA,0607,13840.01,17158,946,866,658,528,450,978,1636,2502,3448,123.97,24.91,18.08,11.82
08-07-2021,LOUSADA,101,7,215,"[120,240]",Moderado,,,,101,Norte,PORTO,1305,9608.01,46755,2289,1698,1176,853,621,1474,2650,4348,6637,486.63,69.08,45.25,27.58
08-07-2021,MAÇÃO,9,1,145,"[120,240]",Moderado,,,,9,Lisboa e Vale do Tejo,SANTARÉM,1413,39997.98,6267,386,362,390,440,657,1097,1487,1849,2235,15.67,5.59,4.62,3.72
08-07-2021,MACEDO DE CAVALEIROS,3,0,21,"[0,120]",Baixo a Moderado,,,,3,Norte,BRAGANÇA,0405,69914.08,14516,1082,889,878,823,938,1761,2639,3528,4610,20.76,6.59,5.05,3.77
08-07-2021,MACHICO,9,1,45,"[0,120]",Baixo a Moderado,,,,9,Madeira,MADEIRA,3104,6825.1,19981,1197,860,662,455,331,786,1448,2308,3505,292.76,51.36,33.82,21.22
08-07-2021,MADALENA,0,0,0,"[0,120]",Baixo a Moderado,,,,0,Açores,AÇORES,4602,14712.33,5895,334,256,173,190,179,369,542,798,1132,40.07,7.69,5.42,3.68
08-07-2021,MAFRA,416,30,490,"[480,960]",Muito Elevado,,,,416,Lisboa e Vale do Tejo,LISBOA,1109,29165.5,84816,3613,3334,2839,2089,1899,3988,6827,10161,13774,290.81,47.23,34.84,23.41
08-07-2021,MAIA,281,20,202,"[120,240]",Moderado,,,,281,Norte,PORTO,1306,8293.94,138971,7801,6617,4512,3339,2631,5970,10482,17099,24900,1675.56,300.22,206.16,126.38
08-07-2021,MANGUALDE,26,2,140,"[120,240]",Moderado,,,,26,Centro,VISEU,1806,21925.56,18510,1198,1128,885,852,743,1595,2480,3608,4806,84.42,21.92,16.46,11.31
08-07-2021,MANTEIGAS,2,0,67,"[0,120]",Baixo a Moderado,,,,2,Centro,GUARDA,0908,12197.55,3007,258,197,159,167,146,313,472,669,927,24.65,7.6,5.48,3.87
08-07-2021,MARCO DE CANAVESES,58,4,113,"[0,120]",Baixo a Moderado,,,,58,Norte,PORTO,1307,20188.98,51496,2678,2060,1488,1265,1023,2288,3776,5836,8514,255.07,42.17,28.91,18.7
08-07-2021,MARINHA GRANDE,24,2,62,"[0,120]",Baixo a Moderado,,,,24,Centro,LEIRIA,1010,18725.19,38508,2365,2302,1638,1359,1058,2417,4055,6357,8722,205.65,46.58,33.95,21.66
08-07-2021,MARVÃO,1,0,34,"[0,120]",Baixo a Moderado,,,,1,Alentejo,PORTALEGRE,1210,15489.9,3005,198,185,142,197,237,434,576,761,959,19.4,6.19,4.91,3.72
08-07-2021,MATOSINHOS,593,42,338,"[240,480]",Elevado,,,,593,Norte,PORTO,1308,6241.97,175357,11850,9977,7023,5024,3884,8908,15931,25908,37758,2809.31,604.9,415.06,255.22
08-07-2021,MEALHADA,17,1,85,"[0,120]",Baixo a Moderado,,,,17,Centro,AVEIRO,0111,11065.66,19914,1163,1039,810,828,831,1659,2469,3508,4671,179.96,42.21,31.7,22.31
08-07-2021,MÊDA,2,0,44,"[0,120]",Baixo a Moderado,,,,2,Centro,GUARDA,0909,28604.92,4587,343,306,290,288,443,731,1021,1327,1670,16.04,5.84,4.64,3.57
08-07-2021,MELGAÇO,1,0,13,"[0,120]",Baixo a Moderado,,,,1,Norte,VIANA DO CASTELO,1603,23824.58,8093,507,567,578,614,675,1289,1867,2434,2941,33.97,12.34,10.22,7.84
08-07-2021,MÉRTOLA,3,0,50,"[0,120]",Baixo a Moderado,,,,3,Alentejo,BEJA,0209,129287.34,6142,400,390,378,423,600,1023,1401,1791,2191,4.75,1.69,1.39,1.08
08-07-2021,MESÃO FRIO,1,0,25,"[0,120]",Baixo a Moderado,,,,1,Norte,VILA REAL,1704,2664.87,3964,265,205,168,157,120,277,445,650,915,148.74,34.33,24.39,16.7
08-07-2021,MIRA,64,5,539,"[480,960]",Muito Elevado,,,,64,Centro,COIMBRA,0608,12403.38,11832,727,729,659,550,466,1016,1675,2404,3131,95.4,25.24,19.38,13.5
08-07-2021,MIRANDA DO CORVO,2,0,16,"[0,120]",Baixo a Moderado,,,,2,Centro,COIMBRA,0609,12637.79,12708,706,659,568,498,404,902,1470,2129,2835,100.55,22.43,16.85,11.63
08-07-2021,MIRANDA DO DOURO,4,0,59,"[0,120]",Baixo a Moderado,,,,4,Norte,BRAGANÇA,0406,48718.31,6830,482,429,442,463,470,933,1375,1804,2286,14.02,4.69,3.7,2.82
08-07-2021,MIRANDELA,16,1,74,"[0,120]",Baixo a Moderado,,,,16,Norte,BRAGANÇA,0407,65895.67,21754,1640,1315,1204,1078,947,2025,3229,4544,6184,33.01,9.38,6.9,4.9
08-07-2021,MOGADOURO,2,0,24,"[0,120]",Baixo a Moderado,,,,2,Norte,BRAGANÇA,0408,76064.93,8392,589,529,576,630,655,1285,1861,2390,2979,11.03,3.92,3.14,2.45
08-07-2021,MOIMENTA DA BEIRA,6,0,62,"[0,120]",Baixo a Moderado,,,,6,Norte,VISEU,1807,21996.9,9736,576,514,471,416,461,877,1348,1862,2438,44.26,11.08,8.46,6.13
08-07-2021,MOITA,298,21,463,"[240,480]",Elevado,,,,298,Lisboa e Vale do Tejo,SETÚBAL,1506,5525.98,64407,4226,3646,2623,1801,1425,3226,5849,9495,13721,1165.53,248.3,171.82,105.85
08-07-2021,MONÇÃO,9,1,51,"[0,120]",Baixo a Moderado,,,,9,Norte,VIANA DO CASTELO,1604,21130.85,17869,1161,1105,1031,1006,972,1978,3009,4114,5275,84.56,24.96,19.47,14.24
08-07-2021,MONCHIQUE,12,1,241,"[240,480]",Elevado,,,,12,Algarve,FARO,0809,39530.43,5077,353,384,321,355,392,747,1068,1452,1805,12.84,4.57,3.67,2.7
08-07-2021,MONDIM DE BASTO,0,0,0,"[0,120]",Baixo a Moderado,,,,0,Norte,VILA REAL,1705,17207.52,6946,395,300,314,284,283,567,881,1181,1576,40.36,9.16,6.86,5.12
08-07-2021,MONFORTE,0,0,0,"[0,120]",Baixo a Moderado,,,,0,Alentejo,PORTALEGRE,1211,42024.82,2975,139,115,117,192,168,360,477,592,731,7.08,1.74,1.41,1.14
08-07-2021,MONTALEGRE,12,1,135,"[120,240]",Moderado,,,,12,Norte,VILA REAL,1706,80545.71,8997,699,628,595,603,730,1333,1928,2556,3255,11.17,4.04,3.17,2.39
08-07-2021,MONTEMOR-O-NOVO,45,3,285,"[240,480]",Elevado,,,,45,Alentejo,ÉVORA,0706,123296.65,15647,991,953,868,878,971,1849,2717,3670,4661,12.69,3.78,2.98,2.2
08-07-2021,MONTEMOR-O-VELHO,28,2,111,"[0,120]",Baixo a Moderado,,,,28,Centro,COIMBRA,0610,22896.23,25224,1496,1397,1217,1057,988,2045,3262,4659,6155,110.17,26.88,20.35,14.25
08-07-2021,MONTIJO,215,15,374,"[240,480]",Elevado,,,,215,Lisboa e Vale do Tejo,SETÚBAL,1507,34861.64,57614,2771,2441,1990,1554,1109,2663,4653,7094,9865,165.26,28.3,20.35,13.35
08-07-2021,MORA,3,0,74,"[0,120]",Baixo a Moderado,,,,3,Alentejo,ÉVORA,0707,44395.02,4138,336,275,252,238,257,495,747,1022,1358,9.32,3.06,2.3,1.68
08-07-2021,MORTÁGUA,1,0,11,"[0,120]",Baixo a Moderado,,,,1,Centro,VISEU,1808,25117.82,8803,638,584,535,499,460,959,1494,2078,2716,35.05,10.81,8.27,5.95
08-07-2021,MOURA,19,1,140,"[120,240]",Moderado,,,,19,Alentejo,BEJA,0210,95845.55,13718,817,656,665,542,461,1003,1668,2324,3141,14.31,3.28,2.42,1.74
08-07-2021,MOURÃO,16,1,658,"[480,960]",Muito Elevado,,,,16,Alentejo,ÉVORA,0708,27862.98,2450,139,108,80,104,109,213,293,401,540,8.79,1.94,1.44,1.05
08-07-2021,MURÇA,7,1,130,"[120,240]",Moderado,,,,7,Norte,VILA REAL,1707,18937.11,5463,384,341,307,306,319,625,932,1273,1657,28.85,8.75,6.72,4.92
08-07-2021,MURTOSA,10,1,96,"[0,120]",Baixo a Moderado,,,,10,Centro,AVEIRO,0112,7308.78,10279,509,473,403,353,409,762,1165,1638,2147,140.63,29.37,22.41,15.94
08-07-2021,NAZARÉ,86,6,610,"[480,960]",Muito Elevado,,,,86,Lisboa e Vale do Tejo,LEIRIA,1011,8243.43,14165,967,903,670,420,396,816,1486,2389,3356,171.84,40.71,28.98,18.03
08-07-2021,NELAS,10,1,77,"[0,120]",Baixo a Moderado,,,,10,Centro,VISEU,1809,12571.48,12974,924,787,668,604,583,1187,1855,2642,3566,103.21,28.37,21.02,14.76
08-07-2021,NISA,4,0,67,"[0,120]",Baixo a Moderado,,,,4,Alentejo,PORTALEGRE,1212,57567.84,6061,405,389,355,483,478,961,1316,1705,2110,10.53,3.67,2.96,2.29
08-07-2021,NORDESTE,2,0,42,"[0,120]",Baixo a Moderado,,,,2,Açores,AÇORES,4202,10146.8,4862,246,180,124,161,162,323,447,627,873,47.92,8.6,6.18,4.41
08-07-2021,ÓBIDOS,22,2,183,"[120,240]",Moderado,,,,22,Lisboa e Vale do Tejo,LEIRIA,1012,14155.44,11850,743,650,574,452,436,888,1462,2112,2855,83.72,20.17,14.92,10.33
08-07-2021,ODEMIRA,56,4,227,"[120,240]",Moderado,,,,56,Alentejo,BEJA,0211,172060.15,24717,1475,1317,1225,1397,1349,2746,3971,5288,6763,14.37,3.93,3.07,2.31
08-07-2021,ODIVELAS,710,51,439,"[240,480]",Elevado,,,,710,Lisboa e Vale do Tejo,LISBOA,1116,2654.36,161774,9562,9038,6952,4641,3812,8453,15405,24443,34005,6095.48,1281.27,920.99,580.44
08-07-2021,OEIRAS,775,55,437,"[240,480]",Elevado,,,,775,Lisboa e Vale do Tejo,LISBOA,1110,4588.31,177408,11580,11575,8566,6211,5855,12066,20632,32207,43787,3866.78,954.38,701.98,449.69
08-07-2021,OLEIROS,0,0,0,"[0,120]",Baixo a Moderado,,,,0,Centro,CASTELO BRANCO,0506,47109.31,5003,384,341,366,397,487,884,1250,1591,1975,10.62,4.19,3.38,2.65
08-07-2021,OLHÃO,278,20,627,"[480,960]",Muito Elevado,,,,278,Algarve,FARO,0810,13086.38,44405,2455,2309,1689,1342,1268,2610,4299,6608,9063,339.33,69.26,50.5,32.85
08-07-2021,OLIVEIRA DE AZEMÉIS,37,3,56,"[0,120]",Baixo a Moderado,,,,37,Norte,AVEIRO,0113,16110.41,66011,4155,3614,2794,2183,1738,3921,6715,10329,14484,409.75,89.91,64.12,41.68
08-07-2021,OLIVEIRA DE FRADES,8,1,80,"[0,120]",Baixo a Moderado,,,,8,Centro,VISEU,1810,14534.62,9936,553,475,438,359,415,774,1212,1687,2240,68.36,15.41,11.61,8.34
08-07-2021,OLIVEIRA DO BAIRRO,60,4,247,"[240,480]",Elevado,,,,60,Centro,AVEIRO,0114,8731.99,24277,1327,1182,999,786,810,1596,2595,3777,5104,278.02,58.45,43.25,29.72
08-07-2021,OLIVEIRA DO HOSPITAL,36,3,187,"[120,240]",Moderado,,,,36,Centro,COIMBRA,0611,23451.66,19253,1161,1097,962,924,960,1884,2846,3943,5104,82.1,21.76,16.81,12.14
08-07-2021,OURÉM,47,3,106,"[0,120]",Baixo a Moderado,,,,47,Lisboa e Vale do Tejo,SANTARÉM,1421,41668.03,44044,2463,2069,1899,1817,1603,3420,5319,7388,9851,105.7,23.64,17.73,12.77
08-07-2021,OURIQUE,3,0,66,"[0,120]",Baixo a Moderado,,,,3,Alentejo,BEJA,0212,66331.36,4607,313,287,284,268,227,495,779,1066,1379,6.95,2.08,1.61,1.17
08-07-2021,OVAR,47,3,86,"[0,120]",Baixo a Moderado,,,,47,Centro,AVEIRO,0115,14770.25,54260,3294,2709,1994,1636,1234,2870,4864,7573,10867,367.37,73.57,51.27,32.93
08-07-2021,PAÇOS DE FERREIRA,29,2,51,"[0,120]",Baixo a Moderado,,,,29,Norte,PORTO,1309,7099.29,56728,2903,2193,1518,1135,664,1799,3317,5510,8413,799.1,118.51,77.62,46.72
08-07-2021,PALMELA,195,14,303,"[240,480]",Elevado,,,,195,Lisboa e Vale do Tejo,SETÚBAL,1508,46512.01,64269,3402,3244,2635,1846,1391,3237,5872,9116,12518,138.18,26.91,19.6,12.62
08-07-2021,PAMPILHOSA DA SERRA,3,0,74,"[0,120]",Baixo a Moderado,,,,3,Centro,COIMBRA,0612,39646.24,4037,238,254,295,339,423,762,1057,1311,1549,10.18,3.91,3.31,2.67
08-07-2021,PAREDES,114,8,132,"[120,240]",Moderado,,,,114,Norte,PORTO,1310,15675.69,86067,4272,3532,2412,1717,1258,2975,5387,8919,13191,549.04,84.15,56.9,34.36
08-07-2021,PAREDES DE COURA,21,2,248,"[240,480]",Elevado,,,,21,Norte,VIANA DO CASTELO,1605,13818.59,8535,466,528,407,465,515,980,1387,1915,2381,61.76,17.23,13.86,10.04
08-07-2021,PEDRÓGÃO GRANDE,9,1,264,"[240,480]",Elevado,,,,9,Centro,LEIRIA,1013,12874.75,3410,175,173,196,221,252,473,669,842,1017,26.49,7.9,6.54,5.2
08-07-2021,PENACOVA,7,0,51,"[0,120]",Baixo a Moderado,,,,7,Centro,COIMBRA,0613,21673.23,13694,968,923,745,621,703,1324,2069,2992,3960,63.18,18.27,13.81,9.55
08-07-2021,PENAFIEL,78,6,112,"[0,120]",Baixo a Moderado,,,,78,Norte,PORTO,1311,21224.27,69772,3648,2823,2032,1663,1230,2893,4925,7748,11396,328.74,53.69,36.51,23.2
08-07-2021,PENALVA DO CASTELO,5,0,70,"[0,120]",Baixo a Moderado,,,,5,Centro,VISEU,1811,13433.92,7115,449,457,413,391,426,817,1230,1687,2136,52.96,15.9,12.56,9.16
08-07-2021,PENAMACOR,0,0,0,"[0,120]",Baixo a Moderado,,,,0,Centro,CASTELO BRANCO,0507,56370.69,4755,262,248,273,451,633,1084,1357,1605,1867,8.44,3.31,2.85,2.41
08-07-2021,PENEDONO,2,0,78,"[0,120]",Baixo a Moderado,,,,2,Norte,VISEU,1812,13370.75,2591,172,113,129,156,138,294,423,536,708,19.38,5.3,4.01,3.16
08-07-2021,PENELA,5,0,93,"[0,120]",Baixo a Moderado,,,,5,Centro,COIMBRA,0614,13480.0,5397,314,324,274,359,344,703,977,1301,1615,40.04,11.98,9.65,7.25
08-07-2021,PENICHE,68,5,258,"[240,480]",Elevado,,,,68,Lisboa e Vale do Tejo,LEIRIA,1014,7754.98,26501,1746,1504,1203,926,707,1633,2836,4340,6086,341.73,78.48,55.96,36.57
08-07-2021,PESO DA RÉGUA,15,1,96,"[0,120]",Baixo a Moderado,,,,15,Norte,VILA REAL,1708,9486.01,15773,1076,843,650,659,455,1114,1764,2607,3683,166.28,38.83,27.48,18.6
08-07-2021,PINHEL,1,0,12,"[0,120]",Baixo a Moderado,,,,1,Centro,GUARDA,0910,48452.12,8511,577,566,551,538,689,1227,1778,2344,2921,17.57,6.03,4.84,3.67
08-07-2021,POMBAL,40,3,77,"[0,120]",Baixo a Moderado,,,,40,Centro,LEIRIA,1015,62600.28,51461,3187,2791,2494,2328,2027,4355,6849,9640,12827,82.21,20.49,15.4,10.94
08-07-2021,PONTA DELGADA,99,7,146,"[120,240]",Moderado,,,,99,Açores,AÇORES,4203,23298.65,67935,3108,2435,1726,1133,902,2035,3761,6196,9304,291.58,39.93,26.59,16.14
08-07-2021,PONTA DO SOL,5,0,58,"[0,120]",Baixo a Moderado,,,,5,Madeira,MADEIRA,3105,4622.03,8593,319,283,347,208,221,429,776,1059,1378,185.92,29.81,22.91,16.79
08-07-2021,PONTE DA BARCA,4,0,36,"[0,120]",Baixo a Moderado,,,,4,Norte,VIANA DO CASTELO,1606,18211.37,11180,635,576,517,554,490,1044,1561,2137,2772,61.39,15.22,11.73,8.57
08-07-2021,PONTE DE LIMA,23,2,56,"[0,120]",Baixo a Moderado,,,,23,Norte,VIANA DO CASTELO,1607,32025.46,41315,2321,2022,1720,1596,1462,3058,4778,6800,9121,129.01,28.48,21.23,14.92
08-07-2021,PONTE DE SOR,9,1,61,"[0,120]",Baixo a Moderado,,,,9,Alentejo,PORTALEGRE,1213,83971.16,14994,939,800,716,739,831,1570,2286,3086,4025,17.86,4.79,3.68,2.72
08-07-2021,PORTALEGRE,15,1,68,"[0,120]",Baixo a Moderado,,,,15,Alentejo,PORTALEGRE,1214,44713.64,22172,1577,1351,1137,993,984,1977,3114,4465,6042,49.59,13.51,9.99,6.96
08-07-2021,PORTEL,10,1,173,"[120,240]",Moderado,,,,10,Alentejo,ÉVORA,0709,60100.57,5828,336,358,283,331,305,636,919,1277,1613,9.7,2.68,2.12,1.53
08-07-2021,PORTIMÃO,326,23,588,"[480,960]",Muito Elevado,,,,326,Algarve,FARO,0811,18206.29,55483,3182,2927,2116,1582,1400,2982,5098,8025,11207,304.75,61.56,44.08,28.0
08-07-2021,PORTO,1048,75,484,"[480,960]",Muito Elevado,,,,1048,Norte,PORTO,1312,4142.02,216606,15790,15193,11280,9409,10044,19453,30733,45926,61716,5229.5,1490.0,1108.79,741.98
08-07-2021,PORTO DE MÓS,33,2,141,"[120,240]",Moderado,,,,33,Centro,LEIRIA,1016,26183.41,23275,1355,1210,1034,888,872,1760,2794,4004,5359,88.89,20.47,15.29,10.67
08-07-2021,PORTO MONIZ,1,0,43,"[0,120]",Baixo a Moderado,,,,1,Madeira,MADEIRA,3106,8293.38,2342,143,130,95,98,120,218,313,443,586,28.24,7.07,5.34,3.77
08-07-2021,PORTO SANTO,6,0,115,"[0,120]",Baixo a Moderado,,,,6,Madeira,MADEIRA,3201,4300.7,5202,240,157,134,110,68,178,312,469,709,120.95,16.48,10.9,7.25
08-07-2021,PÓVOA DE LANHOSO,10,1,47,"[0,120]",Baixo a Moderado,,,,10,Norte,BRAGA,0309,13465.29,21499,1175,909,732,673,624,1297,2029,2938,4113,159.67,30.55,21.82,15.07
08-07-2021,PÓVOA DE VARZIM,107,8,170,"[120,240]",Moderado,,,,107,Norte,PORTO,1313,8220.59,62784,3712,3120,2134,1594,1305,2899,5033,8153,11865,763.7,144.33,99.17,61.22
08-07-2021,POVOAÇÃO,2,0,34,"[0,120]",Baixo a Moderado,,,,2,Açores,AÇORES,4204,10640.77,5927,293,212,191,144,134,278,469,681,974,55.7,9.15,6.4,4.41
08-07-2021,VILA DA PRAIA DA VITÓRIA,2,0,9,"[0,120]",Baixo a Moderado,,,,2,Açores,AÇORES,4302,16127.06,21317,1133,789,619,436,336,772,1391,2180,3313,132.18,20.54,13.52,8.63
08-07-2021,PROENÇA-A-NOVA,2,0,28,"[0,120]",Baixo a Moderado,,,,2,Centro,CASTELO BRANCO,0508,39539.96,7298,508,465,389,400,560,960,1349,1814,2322,18.46,5.87,4.59,3.41
08-07-2021,REDONDO,1,0,16,"[0,120]",Baixo a Moderado,,,,1,Alentejo,ÉVORA,0710,36950.87,6353,349,325,288,288,354,642,930,1255,1604,17.19,4.34,3.4,2.52
08-07-2021,REGUENGOS DE MONSARAZ,25,2,252,"[240,480]",Elevado,,,,25,Alentejo,ÉVORA,0711,46399.72,10015,602,511,455,462,473,935,1390,1901,2503,21.58,5.39,4.1,3.0
08-07-2021,RESENDE,2,0,20,"[0,120]",Baixo a Moderado,,,,2,Norte,VISEU,1813,12334.93,10137,560,493,448,433,422,855,1303,1796,2356,82.18,19.1,14.56,10.56
08-07-2021,RIBEIRA BRAVA,17,1,138,"[120,240]",Moderado,,,,17,Madeira,MADEIRA,3107,6544.88,12435,648,500,411,311,287,598,1009,1509,2157,189.99,32.96,23.06,15.42
08-07-2021,RIBEIRA DE PENA,7,1,117,"[0,120]",Baixo a Moderado,,,,7,Norte,VILA REAL,1709,21745.98,6016,371,301,290,310,368,678,968,1269,1640,27.66,7.54,5.84,4.45
08-07-2021,RIBEIRA GRANDE,96,7,292,"[240,480]",Elevado,,,,96,Açores,AÇORES,4205,18015.13,32811,1163,689,512,345,253,598,1110,1799,2962,182.13,16.44,9.99,6.16
08-07-2021,RIO MAIOR,44,3,217,"[120,240]",Moderado,,,,44,Lisboa e Vale do Tejo,SANTARÉM,1414,27276.45,20379,1251,1144,941,795,648,1443,2384,3528,4779,74.71,17.52,12.93,8.74
08-07-2021,SABROSA,4,0,68,"[0,120]",Baixo a Moderado,,,,4,Norte,VILA REAL,1710,15692.45,5918,393,314,304,302,350,652,956,1270,1663,37.71,10.6,8.09,6.09
08-07-2021,SABUGAL,2,0,19,"[0,120]",Baixo a Moderado,,,,2,Centro,GUARDA,0911,82269.82,10585,724,707,694,796,1009,1805,2499,3206,3930,12.87,4.78,3.9,3.04
08-07-2021,SALVATERRA DE MAGOS,30,2,142,"[120,240]",Moderado,,,,30,Lisboa e Vale do Tejo,SANTARÉM,1415,24393.2,21295,1275,1181,1060,799,772,1571,2631,3812,5087,87.3,20.85,15.63,10.79
08-07-2021,SANTA COMBA DÃO,9,1,86,"[0,120]",Baixo a Moderado,,,,9,Centro,VISEU,1814,11194.77,10452,732,684,569,538,464,1002,1571,2255,2987,93.36,26.68,20.14,14.03
08-07-2021,SANTA CRUZ,12,1,26,"[0,120]",Baixo a Moderado,,,,12,Madeira,MADEIRA,3108,8150.28,45281,1817,1301,974,716,523,1239,2213,3514,5331,555.6,65.41,43.12,27.15
08-07-2021,SANTA CRUZ DA GRACIOSA,1,0,24,"[0,120]",Baixo a Moderado,,,,1,Açores,AÇORES,4401,6065.78,4208,228,180,163,124,145,269,432,612,840,69.37,13.85,10.09,7.12
08-07-2021,SANTA CRUZ DAS FLORES,0,0,0,"[0,120]",Baixo a Moderado,,,,0,Açores,AÇORES,4802,7091.44,2165,125,98,74,56,51,107,181,279,404,30.53,5.7,3.93,2.55
08-07-2021,SANTA MARIA DA FEIRA,111,8,80,"[0,120]",Baixo a Moderado,,,,111,Norte,AVEIRO,0109,21587.65,138636,8182,6743,4771,3856,3079,6935,11706,18449,26631,642.19,123.36,85.46,54.22
08-07-2021,SANTA MARTA DE PENAGUIÃO,8,1,122,"[120,240]",Moderado,,,,8,Norte,VILA REAL,1711,6928.13,6599,483,373,337,316,317,633,970,1343,1826,95.25,26.36,19.39,14.0
08-07-2021,SANTANA,4,0,60,"[0,120]",Baixo a Moderado,,,,4,Madeira,MADEIRA,3109,9547.3,6711,418,353,343,282,277,559,902,1255,1673,70.29,17.52,13.15,9.45
08-07-2021,SANTARÉM,102,7,177,"[120,240]",Moderado,,,,102,Lisboa e Vale do Tejo,SANTARÉM,1416,55253.58,57421,3654,3441,2760,2466,2206,4672,7432,10873,14527,103.92,26.29,19.68,13.45
08-07-2021,SANTIAGO DO CACÉM,75,5,262,"[240,480]",Elevado,,,,75,Alentejo,SETÚBAL,1509,105969.29,28791,2144,1689,1472,1295,1215,2510,3982,5671,7815,27.17,7.37,5.35,3.76
08-07-2021,SANTO TIRSO,233,17,342,"[240,480]",Elevado,,,,233,Norte,PORTO,1314,13655.52,68055,4911,3935,2761,2257,1810,4067,6828,10763,15674,498.35,114.78,78.82,50.0
08-07-2021,SÃO BRÁS DE ALPORTEL,44,3,424,"[240,480]",Elevado,,,,44,Algarve,FARO,0812,15336.92,10416,596,468,467,404,401,805,1272,1740,2336,67.91,15.23,11.35,8.29
08-07-2021,SÃO JOÃO DA MADEIRA,19,1,86,"[0,120]",Baixo a Moderado,,,,19,Norte,AVEIRO,0116,794.3,21958,1347,1069,796,601,593,1194,1990,3059,4406,2765.49,554.91,385.26,250.63
08-07-2021,SÃO JOÃO DA PESQUEIRA,6,0,85,"[0,120]",Baixo a Moderado,,,,6,Norte,VISEU,1815,26610.85,7125,417,330,294,328,328,656,950,1280,1697,26.77,6.38,4.81,3.57
08-07-2021,SÃO PEDRO DO SUL,16,1,104,"[0,120]",Baixo a Moderado,,,,16,Centro,VISEU,1816,34895.09,15403,990,962,861,759,909,1668,2529,3491,4481,44.14,12.84,10.0,7.25
08-07-2021,SÃO ROQUE DO PICO,0,0,0,"[0,120]",Baixo a Moderado,,,,0,Açores,AÇORES,4603,14236.1,3266,199,141,93,96,113,209,302,443,642,22.94,4.51,3.11,2.12
08-07-2021,SÃO VICENTE,2,0,39,"[0,120]",Baixo a Moderado,,,,2,Madeira,MADEIRA,3110,7883.71,5143,272,264,266,225,280,505,771,1035,1307,65.23,16.58,13.13,9.78
08-07-2021,SARDOAL,7,1,188,"[120,240]",Moderado,,,,7,Lisboa e Vale do Tejo,SANTARÉM,1417,9214.72,3741,227,178,148,165,248,413,561,739,966,40.6,10.48,8.02,6.09
08-07-2021,SÁTÃO,9,1,77,"[0,120]",Baixo a Moderado,,,,9,Centro,VISEU,1817,20194.11,11580,765,671,515,465,476,941,1456,2127,2892,57.34,14.32,10.53,7.21
08-07-2021,SEIA,18,1,81,"[0,120]",Baixo a Moderado,,,,18,Centro,GUARDA,0912,43568.83,22234,1807,1589,1238,1122,721,1843,3081,4670,6477,51.03,14.87,10.72,7.07
08-07-2021,SEIXAL,723,52,431,"[240,480]",Elevado,,,,723,Lisboa e Vale do Tejo,SETÚBAL,1510,9545.17,167752,10586,9270,6661,4391,2930,7321,13982,23252,33838,1757.49,354.51,243.6,146.49
08-07-2021,SERNANCELHE,3,0,56,"[0,120]",Baixo a Moderado,,,,3,Norte,VISEU,1818,22861.22,5396,305,293,286,273,260,533,819,1112,1417,23.6,6.2,4.86,3.58
08-07-2021,SERPA,20,1,141,"[120,240]",Moderado,,,,20,Alentejo,BEJA,0213,110563.34,14304,903,761,719,697,626,1323,2042,2803,3706,12.94,3.35,2.54,1.85
08-07-2021,SERTÃ,9,1,62,"[0,120]",Baixo a Moderado,,,,9,Centro,CASTELO BRANCO,0509,44673.17,14577,870,779,790,767,1020,1787,2577,3356,4226,32.63,9.46,7.51,5.77
08-07-2021,SESIMBRA,257,18,495,"[480,960]",Muito Elevado,,,,257,Lisboa e Vale do Tejo,SETÚBAL,1511,19571.75,51858,2400,2321,1853,1257,1083,2340,4193,6514,8914,264.96,45.54,33.28,21.42
08-07-2021,SETÚBAL,319,23,277,"[240,480]",Elevado,,,,319,Lisboa e Vale do Tejo,SETÚBAL,1512,23032.5,115126,7425,6929,5075,3775,2655,6430,11505,18434,25859,499.83,112.27,80.03,49.95
08-07-2021,SEVER DO VOUGA,2,0,18,"[0,120]",Baixo a Moderado,,,,2,Centro,AVEIRO,0117,12987.56,11331,766,637,568,540,567,1107,1675,2312,3078,87.24,23.7,17.8,12.9
08-07-2021,SILVES,187,13,516,"[480,960]",Muito Elevado,,,,187,Algarve,FARO,0813,68006.23,36226,2137,1869,1610,1423,1600,3023,4633,6502,8639,53.27,12.7,9.56,6.81
08-07-2021,SINES,62,4,452,"[240,480]",Elevado,,,,62,Alentejo,SETÚBAL,1513,20330.17,13715,888,791,551,416,268,684,1235,2026,2914,67.46,14.33,9.97,6.07
08-07-2021,SINTRA,1683,120,430,"[240,480]",Elevado,,,,1683,Lisboa e Vale do Tejo,LISBOA,1111,31922.73,391402,20490,18316,13545,9137,7284,16421,29966,48282,68772,1226.08,215.43,151.25,93.87
08-07-2021,SOBRAL DE MONTE AGRAÇO,71,5,665,"[480,960]",Muito Elevado,,,,71,Lisboa e Vale do Tejo,LISBOA,1112,5210.32,10651,564,507,352,272,212,484,836,1343,1907,204.43,36.6,25.78,16.05
08-07-2021,SOURE,23,2,135,"[120,240]",Moderado,,,,23,Centro,COIMBRA,0615,26506.07,17120,1173,1142,1004,883,987,1870,2874,4016,5189,64.59,19.58,15.15,10.84
08-07-2021,SOUSEL,3,0,69,"[0,120]",Baixo a Moderado,,,,3,Alentejo,PORTALEGRE,1215,27932.18,4412,261,274,208,302,292,594,802,1076,1337,15.8,4.79,3.85,2.87
08-07-2021,TÁBUA,1,0,9,"[0,120]",Baixo a Moderado,,,,1,Centro,COIMBRA,0616,19978.58,11368,729,584,524,430,464,894,1418,2002,2731,56.9,13.67,10.02,7.1
08-07-2021,TABUAÇO,1,0,17,"[0,120]",Baixo a Moderado,,,,1,Norte,VISEU,1819,13385.67,6033,372,314,217,282,363,645,862,1176,1548,45.07,11.56,8.79,6.44
08-07-2021,TAROUCA,7,1,90,"[0,120]",Baixo a Moderado,,,,7,Norte,VISEU,1820,10008.49,7804,405,335,313,277,324,601,914,1249,1654,77.98,16.53,12.48,9.13
08-07-2021,TAVIRA,49,3,198,"[120,240]",Moderado,,,,49,Algarve,FARO,0814,60696.7,24530,1493,1415,1252,1066,1277,2343,3595,5010,6503,40.41,10.71,8.25,5.92
08-07-2021,TERRAS DE BOURO,3,0,48,"[0,120]",Baixo a Moderado,,,,3,Norte,BRAGA,0310,27746.07,6361,391,372,296,319,340,659,955,1327,1718,22.93,6.19,4.78,3.44
08-07-2021,TOMAR,20,1,54,"[0,120]",Baixo a Moderado,,,,20,Lisboa e Vale do Tejo,SANTARÉM,1418,35120.44,36748,2403,2189,1868,1853,1822,3675,5543,7732,10135,104.64,28.86,22.02,15.78
08-07-2021,TONDELA,40,3,152,"[120,240]",Moderado,,,,40,Centro,VISEU,1821,37121.73,26357,1768,1722,1518,1475,1417,2892,4410,6132,7900,71.0,21.28,16.52,11.88
08-07-2021,TORRE DE MONCORVO,9,1,118,"[0,120]",Baixo a Moderado,,,,9,Norte,BRAGANÇA,0409,53155.67,7695,556,478,488,551,719,1270,1758,2236,2792,14.48,5.25,4.21,3.31
08-07-2021,TORRES NOVAS,30,2,85,"[0,120]",Baixo a Moderado,,,,30,Lisboa e Vale do Tejo,SANTARÉM,1419,26999.68,34933,2324,1979,1738,1406,1475,2881,4619,6598,8922,129.38,33.04,24.44,17.11
08-07-2021,TORRES VEDRAS,202,14,257,"[240,480]",Elevado,,,,202,Lisboa e Vale do Tejo,LISBOA,1113,40714.89,78530,4513,3945,3447,2628,2104,4732,8179,12124,16637,192.88,40.86,29.78,20.09
08-07-2021,TRANCOSO,38,3,427,"[240,480]",Elevado,,,,38,Centro,GUARDA,0913,36152.47,8875,581,557,542,586,496,1082,1624,2181,2762,24.55,7.64,6.03,4.49
08-07-2021,TROFA,58,4,151,"[120,240]",Moderado,,,,58,Norte,PORTO,1318,7201.76,38418,2336,1894,1231,939,684,1623,2854,4748,7084,533.44,98.36,65.93,39.63
08-07-2021,VAGOS,99,7,435,"[240,480]",Elevado,,,,99,Centro,AVEIRO,0118,16491.5,22740,1320,1205,922,784,724,1508,2430,3635,4955,137.89,30.04,22.04,14.73
08-07-2021,VALE DE CAMBRA,11,1,52,"[0,120]",Baixo a Moderado,,,,11,Norte,AVEIRO,0119,14733.47,21327,1491,1363,1005,831,798,1629,2634,3997,5488,144.76,37.25,27.13,17.88
08-07-2021,VALENÇA,5,0,38,"[0,120]",Baixo a Moderado,,,,5,Norte,VIANA DO CASTELO,1608,11712.86,13290,867,791,582,582,503,1085,1667,2458,3325,113.46,28.39,20.99,14.23
08-07-2021,VALONGO,187,13,192,"[120,240]",Moderado,,,,187,Norte,PORTO,1315,7512.45,97444,5629,4696,3207,2462,1829,4291,7498,12194,17823,1297.18,237.26,162.33,99.81
08-07-2021,VALPAÇOS,21,2,143,"[120,240]",Moderado,,,,21,Norte,VILA REAL,1712,54873.93,14818,1217,1118,999,928,997,1925,2924,4042,5259,27.0,9.58,7.37,5.33
08-07-2021,VELAS,0,0,0,"[0,120]",Baixo a Moderado,,,,0,Açores,AÇORES,4502,11738.38,5093,278,208,166,153,113,266,432,640,918,43.39,7.82,5.45,3.68
08-07-2021,VENDAS NOVAS,13,1,116,"[0,120]",Baixo a Moderado,,,,13,Alentejo,ÉVORA,0712,22238.88,11255,677,768,655,501,532,1033,1688,2456,3133,50.61,14.09,11.04,7.59
08-07-2021,VIANA DO ALENTEJO,39,3,764,"[480,960]",Muito Elevado,,,,39,Alentejo,ÉVORA,0713,39367.29,5145,245,208,235,210,214,424,659,867,1112,13.07,2.82,2.2,1.67
08-07-2021,VIANA DO CASTELO,78,6,92,"[0,120]",Baixo a Moderado,,,,78,Norte,VIANA DO CASTELO,1609,31902.01,84417,5470,4433,3591,3061,2982,6043,9634,14067,19537,264.61,61.24,44.09,30.2
08-07-2021,VIDIGUEIRA,3,0,55,"[0,120]",Baixo a Moderado,,,,3,Alentejo,BEJA,0214,31661.09,5510,300,248,215,233,275,508,723,971,1271,17.4,4.01,3.07,2.28
08-07-2021,VIEIRA DO MINHO,8,1,68,"[0,120]",Baixo a Moderado,,,,8,Norte,BRAGA,0311,21644.35,11842,703,594,525,548,482,1030,1555,2149,2852,54.71,13.18,9.93,7.18
08-07-2021,VILA DE REI,2,0,60,"[0,120]",Baixo a Moderado,,,,2,Centro,CASTELO BRANCO,0510,19154.6,3323,169,128,172,247,302,549,721,849,1018,17.35,5.31,4.43,3.76
08-07-2021,VILA DO BISPO,17,1,330,"[240,480]",Elevado,,,,17,Algarve,FARO,0815,17906.06,5154,302,302,314,232,233,465,779,1081,1383,28.78,7.72,6.04,4.35
08-07-2021,VILA DO CONDE,71,5,89,"[0,120]",Baixo a Moderado,,,,71,Norte,PORTO,1316,14902.77,79899,4726,3875,2819,2070,1743,3813,6632,10507,15233,536.13,102.21,70.5,44.5
08-07-2021,VILA DO PORTO,4,0,71,"[0,120]",Baixo a Moderado,,,,4,Açores,AÇORES,4101,9688.74,5616,274,212,135,96,123,219,354,566,840,57.96,8.67,5.84,3.65
08-07-2021,VILA FLOR,4,0,67,"[0,120]",Baixo a Moderado,,,,4,Norte,BRAGANÇA,0410,26581.14,6044,429,362,422,294,331,625,1047,1409,1838,22.74,6.91,5.3,3.94
08-07-2021,VILA FRANCA DE XIRA,654,47,461,"[240,480]",Elevado,,,,654,Lisboa e Vale do Tejo,LISBOA,1114,31819.39,141957,8501,6852,4869,3425,2472,5897,10766,17618,26119,446.14,82.09,55.37,33.84
08-07-2021,VILA FRANCA DO CAMPO,9,1,82,"[0,120]",Baixo a Moderado,,,,9,Açores,AÇORES,4206,7796.82,11051,450,344,248,217,154,371,619,963,1413,141.73,18.12,12.35,7.94
08-07-2021,VILA NOVA DA BARQUINHA,8,1,106,"[0,120]",Baixo a Moderado,,,,8,Lisboa e Vale do Tejo,SANTARÉM,1420,4952.97,7461,415,406,392,364,338,702,1094,1500,1915,150.64,38.66,30.28,22.09
08-07-2021,VILA NOVA DE CERVEIRA,2,0,22,"[0,120]",Baixo a Moderado,,,,2,Norte,VIANA DO CASTELO,1610,10846.66,8910,531,444,410,384,334,718,1128,1572,2103,82.14,19.39,14.49,10.4
08-07-2021,VILA NOVA DE FAMALICÃO,236,17,179,"[120,240]",Moderado,,,,236,Norte,BRAGA,0312,20159.26,131676,7817,6164,4202,3282,2749,6031,10233,16397,24214,653.19,120.12,81.34,50.76
08-07-2021,VILA NOVA DE FOZ CÔA,3,0,47,"[0,120]",Baixo a Moderado,,,,3,Centro,GUARDA,0914,39815.18,6503,442,385,390,398,429,827,1217,1602,2044,16.33,5.13,4.02,3.06
08-07-2021,VILA NOVA DE GAIA,968,69,322,"[240,480]",Elevado,,,,968,Norte,PORTO,1317,16846.43,300472,18349,15568,10972,8224,6281,14505,25477,41045,59394,1783.64,352.57,243.65,151.23
08-07-2021,VILA NOVA DE PAIVA,2,0,43,"[0,120]",Baixo a Moderado,,,,2,Centro,VISEU,1822,17553.28,4687,289,272,233,217,241,458,691,963,1252,26.7,7.13,5.49,3.94
08-07-2021,VILA NOVA DE POIARES,2,0,29,"[0,120]",Baixo a Moderado,,,,2,Centro,COIMBRA,0617,8445.3,6939,380,284,262,235,182,417,679,963,1343,82.17,15.9,11.4,8.04
08-07-2021,VILA POUCA DE AGUIAR,12,1,101,"[0,120]",Baixo a Moderado,,,,12,Norte,VILA REAL,1713,43706.62,11961,860,817,733,601,627,1228,1961,2778,3638,27.37,8.32,6.36,4.49
08-07-2021,VILA REAL,104,7,209,"[120,240]",Moderado,,,,104,Norte,VILA REAL,1714,37880.28,49962,3025,2498,2065,1579,1466,3045,5110,7608,10633,131.9,28.07,20.08,13.49
08-07-2021,VILA REAL DE SANTO ANTÓNIO,40,3,215,"[120,240]",Moderado,,,,40,Algarve,FARO,0816,6125.0,18749,1172,1069,811,569,586,1155,1966,3035,4207,306.11,68.69,49.55,32.1
08-07-2021,VILA VELHA DE RÓDÃO,0,0,0,"[0,120]",Baixo a Moderado,,,,0,Centro,CASTELO BRANCO,0511,32991.16,3144,209,229,180,283,306,589,769,998,1207,9.53,3.66,3.03,2.33
08-07-2021,VILA VERDE,46,3,98,"[0,120]",Baixo a Moderado,,,,46,Norte,BRAGA,0313,22866.52,46911,2365,2063,1667,1494,1437,2931,4598,6661,9026,205.15,39.47,29.13,20.11
08-07-2021,VILA VIÇOSA,12,1,159,"[120,240]",Moderado,,,,12,Alentejo,ÉVORA,0714,19485.89,7656,487,379,342,345,324,669,1011,1390,1877,39.29,9.63,7.13,5.19
08-07-2021,VIMIOSO,1,0,25,"[0,120]",Baixo a Moderado,,,,1,Norte,BRAGANÇA,0411,48158.51,4023,274,230,261,293,335,628,889,1119,1393,8.35,2.89,2.32,1.85
08-07-2021,VINHAIS,8,1,105,"[0,120]",Baixo a Moderado,,,,8,Norte,BRAGANÇA,0412,69475.09,7746,599,577,636,641,815,1456,2092,2669,3268,11.15,4.7,3.84,3.01
08-07-2021,VISEU,377,27,388,"[240,480]",Elevado,,,,377,Centro,VISEU,1823,50710.14,97249,5769,5038,4140,3158,2710,5868,10008,15046,20815,191.77,41.05,29.67,19.74
08-07-2021,VIZELA,26,2,109,"[0,120]",Baixo a Moderado,,,,26,Norte,BRAGA,0314,2469.83,23897,1258,928,655,509,371,880,1535,2463,3721,967.49,150.65,99.72,62.15
08-07-2021,VOUZELA,12,1,125,"[120,240]",Moderado,,,,12,Centro,VISEU,1824,19369.46,9619,626,605,554,532,507,1039,1593,2198,2824,49.66,14.58,11.35,8.22
15-07-2021,ABRANTES,23,2,66,"[0,120]",Baixo a Moderado,,,,23,Lisboa e Vale do Tejo,SANTARÉM,1401,71469.08,35130,2473,2213,1730,1748,2021,3769,5499,7712,10185,49.15,14.25,10.79,7.69
15-07-2021,ÁGUEDA,97,7,211,"[120,240]",Moderado,,,,97,Centro,AVEIRO,0101,33527.44,46075,3237,2713,2090,1635,1496,3131,5221,7934,11171,137.43,33.32,23.66,15.57
15-07-2021,AGUIAR DA BEIRA,0,0,0,"[0,120]",Baixo a Moderado,,,,0,Centro,GUARDA,0901,20676.57,4652,304,281,235,239,148,387,622,903,1207,22.5,5.84,4.37,3.01
15-07-2021,ALANDROAL,2,0,41,"[0,120]",Baixo a Moderado,,,,2,Alentejo,ÉVORA,0701,54267.81,4992,307,256,296,299,377,676,972,1228,1535,9.2,2.83,2.26,1.79
15-07-2021,ALBERGARIA-A-VELHA,108,8,449,"[240,480]",Elevado,,,,108,Centro,AVEIRO,0102,15882.5,24144,1550,1298,996,687,680,1367,2363,3661,5211,152.02,32.81,23.05,14.88
15-07-2021,ALBUFEIRA,536,38,1291,"[960,Max]",Extremamente Elevado,,,,536,Algarve,FARO,0801,14066.42,41528,2067,1717,1425,985,858,1843,3268,4985,7052,295.24,50.14,35.44,23.23
15-07-2021,ALCÁCER DO SAL,6,0,52,"[0,120]",Baixo a Moderado,,,,6,Alentejo,SETÚBAL,1501,149987.3,11659,884,814,623,623,602,1225,1848,2662,3546,7.77,2.36,1.77,1.23
15-07-2021,ALCANENA,12,1,93,"[0,120]",Baixo a Moderado,,,,12,Lisboa e Vale do Tejo,SANTARÉM,1402,12732.86,12809,891,744,628,536,588,1124,1752,2496,3387,100.6,26.6,19.6,13.76
15-07-2021,ALCOBAÇA,88,6,164,"[120,240]",Moderado,,,,88,Lisboa e Vale do Tejo,LEIRIA,1001,40814.09,53555,3420,2927,2466,2059,1676,3735,6201,9128,12548,131.22,30.74,22.36,15.19
15-07-2021,ALCOCHETE,53,4,266,"[240,480]",Elevado,,,,53,Lisboa e Vale do Tejo,SETÚBAL,1502,12836.48,19787,857,834,691,476,447,923,1614,2448,3305,154.15,25.75,19.07,12.57
15-07-2021,ALCOUTIM,5,0,241,"[240,480]",Elevado,,,,5,Algarve,FARO,0802,57536.33,2159,191,188,163,190,267,457,620,808,999,3.75,1.74,1.4,1.08
15-07-2021,ALENQUER,140,10,318,"[240,480]",Elevado,,,,140,Lisboa e Vale do Tejo,LISBOA,1101,30421.92,44052,2298,2062,1629,1330,1155,2485,4114,6176,8474,144.8,27.85,20.3,13.52
15-07-2021,ALFÂNDEGA DA FÉ,1,0,22,"[0,120]",Baixo a Moderado,,,,1,Norte,BRAGANÇA,0401,32194.64,4550,325,277,301,274,325,599,900,1177,1502,14.13,4.67,3.66,2.8
15-07-2021,ALIJÓ,12,1,114,"[0,120]",Baixo a Moderado,,,,12,Norte,VILA REAL,1701,29759.89,10625,766,687,635,542,666,1208,1843,2530,3296,35.7,11.08,8.5,6.19
15-07-2021,ALJEZUR,10,1,179,"[120,240]",Moderado,,,,10,Algarve,FARO,0803,32349.95,5594,316,336,335,320,410,730,1065,1401,1717,17.29,5.31,4.33,3.29
15-07-2021,ALJUSTREL,43,3,516,"[480,960]",Muito Elevado,,,,43,Alentejo,BEJA,0201,45847.41,8247,635,521,443,347,358,705,1148,1669,2304,17.99,5.03,3.64,2.5
15-07-2021,ALMADA,933,67,552,"[480,960]",Muito Elevado,,,,933,Lisboa e Vale do Tejo,SETÚBAL,1503,7000.89,169039,10469,9777,7876,6144,5111,11255,19131,28908,39377,2414.5,562.45,412.91,273.26
15-07-2021,ALMEIDA,7,1,121,"[120,240]",Moderado,,,,7,Centro,GUARDA,0902,51798.46,5830,441,419,396,458,393,851,1247,1666,2107,11.26,4.07,3.22,2.41
15-07-2021,ALMEIRIM,20,1,89,"[0,120]",Baixo a Moderado,,,,20,Lisboa e Vale do Tejo,SANTARÉM,1403,22212.05,22546,1342,1353,1106,866,843,1709,2815,4168,5510,101.5,24.81,18.76,12.67
15-07-2021,ALMODÔVAR,13,1,195,"[120,240]",Moderado,,,,13,Alentejo,BEJA,0202,77788.03,6725,414,443,396,373,328,701,1097,1540,1954,8.65,2.51,1.98,1.41
15-07-2021,ALPIARÇA,10,1,143,"[120,240]",Moderado,,,,10,Lisboa e Vale do Tejo,SANTARÉM,1404,9536.33,7059,515,486,363,333,274,607,970,1456,1971,74.02,20.67,15.27,10.17
15-07-2021,ALTER DO CHÃO,3,0,96,"[0,120]",Baixo a Moderado,,,,3,Alentejo,PORTALEGRE,1201,36206.62,3165,201,163,136,208,187,395,531,694,895,8.74,2.47,1.92,1.47
15-07-2021,ALVAIÁZERE,8,1,121,"[120,240]",Moderado,,,,8,Centro,LEIRIA,1002,16047.76,6597,419,389,346,406,539,945,1291,1680,2099,41.11,13.08,10.47,8.04
15-07-2021,ALVITO,2,0,81,"[0,120]",Baixo a Moderado,,,,2,Alentejo,BEJA,0203,26485.32,2477,145,110,105,111,89,200,305,415,560,9.35,2.11,1.57,1.15
15-07-2021,AMADORA,943,67,512,"[480,960]",Muito Elevado,,,,943,Lisboa e Vale do Tejo,LISBOA,1115,2378.47,184106,11186,10936,8780,6460,5890,12350,21130,32066,43252,7742.05,1818.84,1348.44,888.56
15-07-2021,AMARANTE,114,8,214,"[120,240]",Moderado,,,,114,Norte,PORTO,1301,30133.15,53193,3086,2413,1812,1643,1311,2954,4766,7179,10265,176.53,34.07,23.82,15.82
15-07-2021,AMARES,20,1,111,"[0,120]",Baixo a Moderado,,,,20,Norte,BRAGA,0301,8195.41,18129,1001,829,622,489,524,1013,1635,2464,3465,221.22,42.28,30.07,19.95
15-07-2021,ANADIA,43,3,157,"[120,240]",Moderado,,,,43,Centro,AVEIRO,0103,21663.48,27258,1931,1698,1376,1208,1262,2470,3846,5544,7475,125.83,34.51,25.59,17.75
15-07-2021,ANGRA DO HEROÍSMO,12,1,36,"[0,120]",Baixo a Moderado,,,,12,Açores,AÇORES,4301,23899.66,33807,2006,1473,1122,768,635,1403,2525,3998,6004,141.45,25.12,16.73,10.56
15-07-2021,ANSIÃO,8,1,66,"[0,120]",Baixo a Moderado,,,,8,Centro,LEIRIA,1003,17609.42,12039,727,709,646,694,530,1224,1870,2579,3306,68.37,18.77,14.65,10.62
15-07-2021,ARCOS DE VALDEVEZ,15,1,72,"[0,120]",Baixo a Moderado,,,,15,Norte,VIANA DO CASTELO,1601,44759.64,20926,1329,1338,1282,1343,1515,2858,4140,5478,6807,46.75,15.21,12.24,9.25
15-07-2021,ARGANIL,3,0,27,"[0,120]",Baixo a Moderado,,,,3,Centro,COIMBRA,0601,33283.93,11014,672,648,612,559,596,1155,1767,2415,3087,33.09,9.27,7.26,5.31
15-07-2021,ARMAMAR,3,0,52,"[0,120]",Baixo a Moderado,,,,3,Norte,VISEU,1801,11723.73,5769,357,305,309,285,310,595,904,1209,1566,49.21,13.36,10.31,7.71
15-07-2021,AROUCA,68,5,330,"[240,480]",Elevado,,,,68,Norte,AVEIRO,0104,32910.52,20720,1306,1047,753,683,683,1366,2119,3166,4472,62.96,13.59,9.62,6.44
15-07-2021,ARRAIOLOS,39,3,568,"[480,960]",Muito Elevado,,,,39,Alentejo,ÉVORA,0702,68374.55,6928,435,384,283,367,480,847,1130,1514,1949,10.13,2.85,2.21,1.65
15-07-2021,ARRONCHES,1,0,36,"[0,120]",Baixo a Moderado,,,,1,Alentejo,PORTALEGRE,1202,31464.72,2820,155,142,162,187,179,366,528,670,825,8.96,2.62,2.13,1.68
15-07-2021,ARRUDA DOS VINHOS,31,2,203,"[120,240]",Moderado,,,,31,Lisboa e Vale do Tejo,LISBOA,1102,7795.93,15412,738,738,562,509,438,947,1509,2247,2985,197.69,38.29,28.82,19.36
15-07-2021,AVEIRO,309,22,393,"[240,480]",Elevado,,,,309,Centro,AVEIRO,0105,19757.57,78734,4520,4004,3050,2250,2103,4353,7403,11407,15927,398.49,80.61,57.73,37.47
15-07-2021,AVIS,31,2,739,"[480,960]",Muito Elevado,,,,31,Alentejo,PORTALEGRE,1203,60596.51,4247,315,225,206,251,273,524,730,955,1270,7.01,2.1,1.58,1.2
15-07-2021,AZAMBUJA,81,6,355,"[240,480]",Elevado,,,,81,Lisboa e Vale do Tejo,LISBOA,1103,26265.65,22716,1322,1171,1070,798,618,1416,2486,3657,4979,86.48,18.96,13.92,9.46
15-07-2021,BAIÃO,20,1,108,"[0,120]",Baixo a Moderado,,,,20,Norte,PORTO,1302,17452.83,18748,1070,862,714,686,725,1411,2125,2987,4057,107.42,23.25,17.11,12.18
15-07-2021,BARCELOS,207,15,178,"[120,240]",Moderado,,,,207,Norte,BRAGA,0302,37890.14,116187,6721,5325,3619,2991,2562,5553,9172,14497,21218,306.64,56.0,38.26,24.21
15-07-2021,BARRANCOS,1,0,62,"[0,120]",Baixo a Moderado,,,,1,Alentejo,BEJA,0204,16841.73,1634,90,65,65,94,61,155,220,285,375,9.7,2.23,1.69,1.31
15-07-2021,BARREIRO,457,33,608,"[480,960]",Muito Elevado,,,,457,Lisboa e Vale do Tejo,SETÚBAL,1504,3639.07,75147,5194,5565,4459,3105,1767,4872,9331,14896,20090,2065.05,552.07,409.34,256.42
15-07-2021,BATALHA,42,3,260,"[240,480]",Elevado,,,,42,Centro,LEIRIA,1004,10341.6,15963,873,762,649,529,549,1078,1727,2489,3362,154.35,32.51,24.07,16.7
15-07-2021,BEJA,66,5,198,"[120,240]",Moderado,,,,66,Alentejo,BEJA,0205,114647.55,33579,2005,1840,1386,1272,1039,2311,3697,5537,7542,29.29,6.58,4.83,3.22
15-07-2021,BELMONTE,4,0,63,"[0,120]",Baixo a Moderado,,,,4,Centro,CASTELO BRANCO,0501,11875.91,6398,444,321,325,310,355,665,990,1311,1755,53.87,14.78,11.04,8.34
15-07-2021,BENAVENTE,133,10,436,"[240,480]",Elevado,,,,133,Lisboa e Vale do Tejo,SANTARÉM,1405,52138.39,30602,1468,1376,1141,876,643,1519,2660,4036,5504,58.69,10.56,7.74,5.1
15-07-2021,BOMBARRAL,21,1,166,"[120,240]",Moderado,,,,21,Lisboa e Vale do Tejo,LEIRIA,1005,9128.55,12558,875,714,561,491,429,920,1481,2195,3070,137.56,33.63,24.04,16.22
15-07-2021,BORBA,5,0,75,"[0,120]",Baixo a Moderado,,,,5,Alentejo,ÉVORA,0703,14518.65,6736,430,375,279,436,392,828,1107,1482,1912,46.39,13.17,10.21,7.62
15-07-2021,BOTICAS,0,0,0,"[0,120]",Baixo a Moderado,,,,0,Norte,VILA REAL,1702,32195.66,4998,347,306,311,305,380,685,996,1302,1649,15.52,5.12,4.04,3.09
15-07-2021,BRAGA,384,27,210,"[120,240]",Moderado,,,,384,Norte,BRAGA,0303,18339.95,182679,10029,7963,5241,4320,3671,7991,13232,21195,31224,996.07,170.25,115.57,72.15
15-07-2021,BRAGANÇA,70,5,209,"[120,240]",Moderado,,,,70,Norte,BRAGANÇA,0402,117357.27,33607,2402,1855,1652,1393,1163,2556,4208,6063,8465,28.64,7.21,5.17,3.59
15-07-2021,CABECEIRAS DE BASTO,18,1,116,"[0,120]",Baixo a Moderado,,,,18,Norte,BRAGA,0304,24182.16,15628,774,594,544,575,574,1149,1693,2287,3061,64.63,12.66,9.46,7.0
15-07-2021,CADAVAL,31,2,226,"[120,240]",Moderado,,,,31,Lisboa e Vale do Tejo,LISBOA,1104,17489.3,13673,813,796,756,621,625,1246,2002,2798,3611,78.18,20.65,16.0,11.45
15-07-2021,CALDAS DA RAINHA,81,6,156,"[120,240]",Moderado,,,,81,Lisboa e Vale do Tejo,LEIRIA,1006,25569.47,51912,3035,2684,2186,1899,1705,3604,5790,8474,11509,203.03,45.01,33.14,22.64
15-07-2021,CALHETA,14,1,129,"[120,240]",Moderado,,,,14,Madeira,MADEIRA,3101,11150.43,10867,576,497,507,399,415,814,1321,1818,2394,97.46,21.47,16.3,11.85
15-07-2021,CALHETA (AÇORES),0,0,0,"[0,120]",Baixo a Moderado,,,,0,Açores,AÇORES,4501,12626.4,3184,215,159,141,139,122,261,402,561,776,25.22,6.15,4.44,3.18
15-07-2021,CÂMARA DE LOBOS,17,1,51,"[0,120]",Baixo a Moderado,,,,17,Madeira,MADEIRA,3102,5216.67,33675,1396,1059,834,545,381,926,1760,2819,4215,645.49,80.79,54.03,33.74
15-07-2021,CAMINHA,5,0,32,"[0,120]",Baixo a Moderado,,,,5,Norte,VIANA DO CASTELO,1602,13652.14,15877,1046,944,818,646,656,1302,2120,3064,4110,116.3,30.11,22.44,15.53
15-07-2021,CAMPO MAIOR,6,0,77,"[0,120]",Baixo a Moderado,,,,6,Alentejo,PORTALEGRE,1204,24720.16,7874,471,364,351,279,327,606,957,1321,1792,31.85,7.25,5.34,3.87
15-07-2021,CANTANHEDE,78,6,222,"[120,240]",Moderado,,,,78,Centro,COIMBRA,0602,39088.02,35011,2346,2096,1880,1709,1451,3160,5040,7136,9482,89.57,24.26,18.26,12.89
15-07-2021,CARRAZEDA DE ANSIÃES,3,0,53,"[0,120]",Baixo a Moderado,,,,3,Norte,BRAGANÇA,0403,27924.09,5666,424,389,391,312,465,777,1168,1557,1981,20.29,7.09,5.58,4.18
15-07-2021,CARREGAL DO SAL,21,1,225,"[120,240]",Moderado,,,,21,Centro,VISEU,1802,11689.21,9271,587,562,486,462,376,838,1324,1886,2473,79.31,21.16,16.13,11.33
15-07-2021,CARTAXO,33,2,139,"[120,240]",Moderado,,,,33,Lisboa e Vale do Tejo,SANTARÉM,1406,15817.28,23843,1415,1376,1142,861,632,1493,2635,4011,5426,150.74,34.3,25.36,16.66
15-07-2021,CASCAIS,1186,85,555,"[480,960]",Muito Elevado,,,,1186,Lisboa e Vale do Tejo,LISBOA,1105,9740.17,213608,12151,11444,8680,6469,5248,11717,20397,31841,43992,2193.1,451.66,326.91,209.41
15-07-2021,CASTANHEIRA DE PÊRA,0,0,0,"[0,120]",Baixo a Moderado,,,,0,Centro,LEIRIA,1007,6677.45,2614,233,195,157,190,187,377,534,729,962,39.15,14.41,10.92,8.0
15-07-2021,CASTELO BRANCO,33,2,63,"[0,120]",Baixo a Moderado,,,,33,Centro,CASTELO BRANCO,0502,143819.15,51987,3528,3042,2499,2229,2225,4454,6953,9995,13523,36.15,9.4,6.95,4.83
15-07-2021,CASTELO DE PAIVA,26,2,170,"[120,240]",Moderado,,,,26,Norte,AVEIRO,0106,11500.53,15454,881,697,545,420,431,851,1396,2093,2974,134.37,25.86,18.2,12.14
15-07-2021,CASTELO DE VIDE,3,0,104,"[0,120]",Baixo a Moderado,,,,3,Alentejo,PORTALEGRE,1205,26491.24,2919,204,173,179,147,170,317,496,669,873,11.02,3.3,2.53,1.87
15-07-2021,CASTRO DAIRE,15,1,109,"[0,120]",Baixo a Moderado,,,,15,Centro,VISEU,1803,37904.13,13823,942,857,765,732,773,1505,2270,3127,4069,36.47,10.74,8.25,5.99
15-07-2021,CASTRO MARIM,21,2,339,"[240,480]",Elevado,,,,21,Algarve,FARO,0804,30084.37,6237,370,345,334,322,344,666,1000,1345,1715,20.73,5.7,4.47,3.32
15-07-2021,CASTRO VERDE,8,1,116,"[0,120]",Baixo a Moderado,,,,8,Alentejo,BEJA,0206,56944.23,6949,437,347,303,275,227,502,805,1152,1589,12.2,2.79,2.02,1.41
15-07-2021,CELORICO DA BEIRA,11,1,159,"[120,240]",Moderado,,,,11,Centro,GUARDA,0903,24721.63,6928,430,416,363,369,535,904,1267,1683,2113,28.02,8.55,6.81,5.12
15-07-2021,CELORICO DE BASTO,30,2,159,"[120,240]",Moderado,,,,30,Norte,BRAGA,0305,18107.02,19040,1001,802,668,728,729,1457,2125,2927,3928,105.15,21.69,16.17,11.74
15-07-2021,CHAMUSCA,15,1,165,"[120,240]",Moderado,,,,15,Lisboa e Vale do Tejo,SANTARÉM,1407,74600.54,9197,629,583,553,465,579,1044,1597,2180,2809,12.33,3.77,2.92,2.14
15-07-2021,CHAVES,166,12,423,"[240,480]",Elevado,,,,166,Norte,VILA REAL,1703,59122.95,39343,2676,2429,1991,1886,1918,3804,5795,8224,10900,66.54,18.44,13.91,9.8
15-07-2021,CINFÃES,40,3,217,"[120,240]",Moderado,,,,40,Norte,VISEU,1804,23928.76,18244,1067,902,779,734,758,1492,2271,3173,4240,76.24,17.72,13.26,9.49
15-07-2021,COIMBRA,224,16,167,"[120,240]",Moderado,,,,224,Centro,COIMBRA,0603,31939.94,134166,9489,8734,6353,5139,5074,10213,16566,25300,34789,420.06,108.92,79.21,51.87
15-07-2021,CONDEIXA-A-NOVA,19,1,106,"[0,120]",Baixo a Moderado,,,,19,Centro,COIMBRA,0604,13867.47,17733,871,809,717,583,490,1073,1790,2599,3470,127.88,25.02,18.74,12.91
15-07-2021,CONSTÂNCIA,18,1,444,"[240,480]",Elevado,,,,18,Lisboa e Vale do Tejo,SANTARÉM,1408,8036.58,4030,211,183,187,148,155,303,490,673,884,50.14,11.0,8.37,6.1
15-07-2021,CORUCHE,18,1,105,"[0,120]",Baixo a Moderado,,,,18,Lisboa e Vale do Tejo,SANTARÉM,1409,111572.03,17471,1294,1090,1095,1096,1019,2115,3210,4300,5594,15.66,5.01,3.85,2.88
15-07-2021,CORVO,0,0,0,"[0,120]",Baixo a Moderado,,,,0,Açores,AÇORES,4901,1711.45,464,22,21,11,13,19,32,43,64,86,27.12,5.03,3.74,2.51
15-07-2021,COVILHÃ,23,2,49,"[0,120]",Baixo a Moderado,,,,23,Centro,CASTELO BRANCO,0503,55560.06,46787,3533,2998,2365,2111,2193,4304,6669,9667,13200,84.21,23.76,17.4,12.0
15-07-2021,CRATO,2,0,65,"[0,120]",Baixo a Moderado,,,,2,Alentejo,PORTALEGRE,1206,39806.88,3129,229,258,163,182,228,410,573,831,1060,7.86,2.66,2.09,1.44
15-07-2021,CUBA,8,1,176,"[120,240]",Moderado,,,,8,Alentejo,BEJA,0207,17208.72,4595,255,233,206,190,143,333,539,772,1027,26.7,5.97,4.49,3.13
15-07-2021,ELVAS,103,7,503,"[480,960]",Muito Elevado,,,,103,Alentejo,PORTALEGRE,1207,63128.86,20528,1057,1145,902,852,810,1662,2564,3709,4766,32.52,7.55,5.88,4.06
15-07-2021,ENTRONCAMENTO,17,1,78,"[0,120]",Baixo a Moderado,,,,17,Lisboa e Vale do Tejo,SANTARÉM,1410,1372.81,21558,1066,930,868,695,592,1287,2155,3085,4151,1570.14,302.33,224.69,156.96
15-07-2021,ESPINHO,88,6,299,"[240,480]",Elevado,,,,88,Norte,AVEIRO,0107,2105.68,29516,2205,1993,1430,1177,960,2137,3567,5560,7765,1401.52,368.71,264.01,169.37
15-07-2021,ESPOSENDE,34,2,100,"[0,120]",Baixo a Moderado,,,,34,Norte,BRAGA,0306,9540.98,34177,1831,1522,1095,894,723,1617,2712,4234,6065,358.21,63.57,44.38,28.42
15-07-2021,ESTARREJA,50,4,191,"[120,240]",Moderado,,,,50,Centro,AVEIRO,0108,10817.33,26006,1503,1399,1106,953,728,1681,2787,4186,5689,240.42,52.59,38.7,25.76
15-07-2021,ESTREMOZ,12,1,95,"[0,120]",Baixo a Moderado,,,,12,Alentejo,ÉVORA,0704,51379.95,12728,789,613,697,786,877,1663,2360,2973,3762,24.77,7.32,5.79,4.59
15-07-2021,ÉVORA,120,9,228,"[120,240]",Moderado,,,,120,Alentejo,ÉVORA,0705,130707.58,52428,3569,2852,2176,1966,1803,3769,5945,8797,12366,40.11,9.46,6.73,4.55
15-07-2021,FAFE,139,10,289,"[240,480]",Elevado,,,,139,Norte,BRAGA,0307,21908.11,48060,3044,2455,1679,1403,1208,2611,4290,6745,9789,219.37,44.68,30.79,19.58
15-07-2021,FARO,542,39,888,"[480,960]",Muito Elevado,,,,542,Algarve,FARO,0805,20256.79,61015,3847,3364,2604,2055,1601,3656,6260,9624,13471,301.2,66.5,47.51,30.9
15-07-2021,FELGUEIRAS,133,9,235,"[120,240]",Moderado,,,,133,Norte,PORTO,1303,11573.75,56422,2951,2302,1601,1316,973,2289,3890,6192,9143,487.49,79.0,53.5,33.61
15-07-2021,FERREIRA DO ALENTEJO,5,0,64,"[0,120]",Baixo a Moderado,,,,5,Alentejo,BEJA,0208,64820.68,7845,515,414,372,343,345,688,1060,1474,1989,12.1,3.07,2.27,1.64
15-07-2021,FERREIRA DO ZÊZERE,4,0,50,"[0,120]",Baixo a Moderado,,,,4,Lisboa e Vale do Tejo,SANTARÉM,1411,19038.03,7959,470,370,416,465,456,921,1337,1707,2177,41.81,11.44,8.97,7.02
15-07-2021,FIGUEIRA DA FOZ,74,5,126,"[120,240]",Moderado,,,,74,Centro,COIMBRA,0605,37905.26,58747,4032,3597,2887,2495,2043,4538,7425,11022,15054,154.98,39.72,29.08,19.59
15-07-2021,FIGUEIRA DE CASTELO RODRIGO,2,0,36,"[0,120]",Baixo a Moderado,,,,2,Centro,GUARDA,0904,50857.46,5584,347,352,290,352,391,743,1033,1385,1732,10.98,3.41,2.72,2.03
15-07-2021,FIGUEIRÓ DOS VINHOS,0,0,0,"[0,120]",Baixo a Moderado,,,,0,Centro,LEIRIA,1008,17344.0,5568,402,386,322,309,351,660,982,1368,1770,32.1,10.21,7.89,5.66
15-07-2021,FORNOS DE ALGODRES,3,0,66,"[0,120]",Baixo a Moderado,,,,3,Centro,GUARDA,0905,13145.05,4528,261,218,247,256,232,488,735,953,1214,34.45,9.24,7.25,5.59
15-07-2021,FREIXO DE ESPADA À CINTA,5,0,154,"[120,240]",Moderado,,,,5,Norte,BRAGANÇA,0404,24414.29,3298,211,177,231,196,189,385,616,793,1004,13.51,4.11,3.25,2.52
15-07-2021,FRONTEIRA,2,0,68,"[0,120]",Baixo a Moderado,,,,2,Alentejo,PORTALEGRE,1208,24859.58,2974,213,182,149,156,168,324,473,655,868,11.96,3.49,2.63,1.9
15-07-2021,FUNCHAL,129,9,124,"[120,240]",Moderado,,,,129,Madeira,MADEIRA,3103,7616.2,104024,6382,5086,3643,2821,1990,4811,8454,13540,19922,1365.86,261.58,177.78,111.0
15-07-2021,FUNDÃO,10,1,38,"[0,120]",Baixo a Moderado,,,,10,Centro,CASTELO BRANCO,0504,70019.79,26495,1781,1464,1432,1357,1643,3000,4432,5896,7677,37.84,10.96,8.42,6.33
15-07-2021,GAVIÃO,4,0,126,"[120,240]",Moderado,,,,4,Alentejo,PORTALEGRE,1209,29459.45,3263,189,186,222,263,293,556,778,964,1153,11.08,3.91,3.27,2.64
15-07-2021,GÓIS,1,0,27,"[0,120]",Baixo a Moderado,,,,1,Centro,COIMBRA,0606,26330.19,3805,235,199,240,233,244,477,717,916,1151,14.45,4.37,3.48,2.72
15-07-2021,GOLEGÃ,7,1,132,"[120,240]",Moderado,,,,7,Lisboa e Vale do Tejo,SANTARÉM,1412,8431.67,5339,356,299,281,243,255,498,779,1078,1434,63.32,17.01,12.78,9.24
15-07-2021,GONDOMAR,795,57,479,"[240,480]",Elevado,,,,795,Norte,PORTO,1304,13191.76,165985,10555,8755,6222,4450,3364,7814,14036,22791,33346,1258.22,252.77,172.76,106.4
15-07-2021,GOUVEIA,28,2,227,"[120,240]",Moderado,,,,28,Centro,GUARDA,0906,30061.17,12387,871,931,780,783,810,1593,2373,3304,4175,41.21,13.89,10.99,7.89
15-07-2021,GRÂNDOLA,15,1,103,"[0,120]",Baixo a Moderado,,,,15,Alentejo,SETÚBAL,1505,82593.66,14639,834,834,708,688,672,1360,2068,2902,3736,17.72,4.52,3.51,2.5
15-07-2021,GUARDA,136,10,349,"[240,480]",Elevado,,,,136,Centro,GUARDA,0907,71209.58,38969,2477,2041,1686,1415,1474,2889,4575,6616,9093,54.72,12.77,9.29,6.42
15-07-2021,GUIMARÃES,321,23,211,"[120,240]",Moderado,,,,321,Norte,BRAGA,0308,24099.96,152309,9394,7074,4809,3877,2948,6825,11634,18708,28102,631.99,116.61,77.63,48.27
15-07-2021,HORTA,10,1,69,"[0,120]",Baixo a Moderado,,,,10,Açores,AÇORES,4701,17305.53,14521,818,658,468,352,302,654,1122,1780,2598,83.91,15.01,10.29,6.48
15-07-2021,IDANHA-A-NOVA,2,0,25,"[0,120]",Baixo a Moderado,,,,2,Centro,CASTELO BRANCO,0505,141633.51,8043,518,490,519,672,974,1646,2165,2655,3173,5.68,2.24,1.87,1.53
15-07-2021,ÍLHAVO,95,7,245,"[240,480]",Elevado,,,,95,Centro,AVEIRO,0110,7347.55,38699,2227,1943,1444,1193,850,2043,3487,5430,7657,526.66,104.21,73.9,47.46
15-07-2021,LAGOA (FARO),119,9,523,"[480,960]",Muito Elevado,,,,119,Algarve,FARO,0806,8825.45,22762,1314,1168,919,749,670,1419,2338,3506,4820,257.93,54.62,39.73,26.49
15-07-2021,LAGOA,148,11,1003,"[960,Max]",Extremamente Elevado,,,,148,Açores,AÇORES,4201,4559.32,14721,536,458,349,238,235,473,822,1280,1816,322.9,39.83,28.08,18.03
15-07-2021,LAGOS,277,20,912,"[480,960]",Muito Elevado,,,,277,Algarve,FARO,0807,21299.27,30374,1744,1434,1247,1053,1029,2082,3329,4763,6507,142.61,30.55,22.36,15.63
15-07-2021,LAJES DAS FLORES,1,0,68,"[0,120]",Baixo a Moderado,,,,1,Açores,AÇORES,4801,7004.79,1463,88,53,62,46,54,100,162,215,303,20.89,4.33,3.07,2.31
15-07-2021,LAJES DO PICO,0,0,0,"[0,120]",Baixo a Moderado,,,,0,Açores,AÇORES,4601,15531.09,4490,304,231,223,159,162,321,544,775,1079,28.91,6.95,4.99,3.5
15-07-2021,LAMEGO,14,1,57,"[0,120]",Baixo a Moderado,,,,14,Norte,VISEU,1805,16542.11,24895,1639,1284,1124,898,783,1681,2805,4089,5728,150.5,34.63,24.72,16.96
15-07-2021,LEIRIA,238,17,190,"[120,240]",Moderado,,,,238,Centro,LEIRIA,1009,56508.83,125267,7389,6366,5090,3902,3159,7061,12151,18517,25906,221.68,45.84,32.77,21.5
15-07-2021,LISBOA,4234,302,831,"[480,960]",Muito Elevado,,,,4234,Lisboa e Vale do Tejo,LISBOA,1106,10005.43,509515,33197,33340,27706,23037,26770,49807,77513,110853,144050,5092.6,1439.78,1107.98,774.74
15-07-2021,LOULÉ,808,58,1176,"[960,Max]",Extremamente Elevado,,,,808,Algarve,FARO,0808,76366.91,68697,3890,3350,2780,2358,2251,4609,7389,10739,14629,89.96,19.16,14.06,9.68
15-07-2021,LOURES,1056,75,494,"[480,960]",Muito Elevado,,,,1056,Lisboa e Vale do Tejo,LISBOA,1107,16723.99,213687,12746,12794,9644,6669,5033,11702,21346,34140,46886,1277.73,280.35,204.14,127.64
15-07-2021,LOURINHÃ,141,10,546,"[480,960]",Muito Elevado,,,,141,Lisboa e Vale do Tejo,LISBOA,1108,14717.2,25855,1584,1243,992,842,645,1487,2479,3722,5306,175.68,36.05,25.29,16.84
15-07-2021,LOUSÃ,14,1,81,"[0,120]",Baixo a Moderado,,,,14,Centro,COIMBRA,0607,13840.01,17158,946,866,658,528,450,978,1636,2502,3448,123.97,24.91,18.08,11.82
15-07-2021,LOUSADA,182,13,389,"[240,480]",Elevado,,,,182,Norte,PORTO,1305,9608.01,46755,2289,1698,1176,853,621,1474,2650,4348,6637,486.63,69.08,45.25,27.58
15-07-2021,MAÇÃO,13,1,210,"[120,240]",Moderado,,,,13,Lisboa e Vale do Tejo,SANTARÉM,1413,39997.98,6267,386,362,390,440,657,1097,1487,1849,2235,15.67,5.59,4.62,3.72
15-07-2021,MACEDO DE CAVALEIROS,3,0,21,"[0,120]",Baixo a Moderado,,,,3,Norte,BRAGANÇA,0405,69914.08,14516,1082,889,878,823,938,1761,2639,3528,4610,20.76,6.59,5.05,3.77
15-07-2021,MACHICO,8,1,40,"[0,120]",Baixo a Moderado,,,,8,Madeira,MADEIRA,3104,6825.1,19981,1197,860,662,455,331,786,1448,2308,3505,292.76,51.36,33.82,21.22
15-07-2021,MADALENA,3,0,51,"[0,120]",Baixo a Moderado,,,,3,Açores,AÇORES,4602,14712.33,5895,334,256,173,190,179,369,542,798,1132,40.07,7.69,5.42,3.68
15-07-2021,MAFRA,420,30,495,"[480,960]",Muito Elevado,,,,420,Lisboa e Vale do Tejo,LISBOA,1109,29165.5,84816,3613,3334,2839,2089,1899,3988,6827,10161,13774,290.81,47.23,34.84,23.41
15-07-2021,MAIA,545,39,392,"[240,480]",Elevado,,,,545,Norte,PORTO,1306,8293.94,138971,7801,6617,4512,3339,2631,5970,10482,17099,24900,1675.56,300.22,206.16,126.38
15-07-2021,MANGUALDE,31,2,167,"[120,240]",Moderado,,,,31,Centro,VISEU,1806,21925.56,18510,1198,1128,885,852,743,1595,2480,3608,4806,84.42,21.92,16.46,11.31
15-07-2021,MANTEIGAS,4,0,134,"[120,240]",Moderado,,,,4,Centro,GUARDA,0908,12197.55,3007,258,197,159,167,146,313,472,669,927,24.65,7.6,5.48,3.87
15-07-2021,MARCO DE CANAVESES,93,7,180,"[120,240]",Moderado,,,,93,Norte,PORTO,1307,20188.98,51496,2678,2060,1488,1265,1023,2288,3776,5836,8514,255.07,42.17,28.91,18.7
15-07-2021,MARINHA GRANDE,50,4,129,"[120,240]",Moderado,,,,50,Centro,LEIRIA,1010,18725.19,38508,2365,2302,1638,1359,1058,2417,4055,6357,8722,205.65,46.58,33.95,21.66
15-07-2021,MARVÃO,2,0,68,"[0,120]",Baixo a Moderado,,,,2,Alentejo,PORTALEGRE,1210,15489.9,3005,198,185,142,197,237,434,576,761,959,19.4,6.19,4.91,3.72
15-07-2021,MATOSINHOS,950,68,542,"[480,960]",Muito Elevado,,,,950,Norte,PORTO,1308,6241.97,175357,11850,9977,7023,5024,3884,8908,15931,25908,37758,2809.31,604.9,415.06,255.22
15-07-2021,MEALHADA,22,2,110,"[0,120]",Baixo a Moderado,,,,22,Centro,AVEIRO,0111,11065.66,19914,1163,1039,810,828,831,1659,2469,3508,4671,179.96,42.21,31.7,22.31
15-07-2021,MÊDA,9,1,197,"[120,240]",Moderado,,,,9,Centro,GUARDA,0909,28604.92,4587,343,306,290,288,443,731,1021,1327,1670,16.04,5.84,4.64,3.57
15-07-2021,MELGAÇO,0,0,0,"[0,120]",Baixo a Moderado,,,,0,Norte,VIANA DO CASTELO,1603,23824.58,8093,507,567,578,614,675,1289,1867,2434,2941,33.97,12.34,10.22,7.84
15-07-2021,MÉRTOLA,5,0,83,"[0,120]",Baixo a Moderado,,,,5,Alentejo,BEJA,0209,129287.34,6142,400,390,378,423,600,1023,1401,1791,2191,4.75,1.69,1.39,1.08
15-07-2021,MESÃO FRIO,5,0,127,"[120,240]",Moderado,,,,5,Norte,VILA REAL,1704,2664.87,3964,265,205,168,157,120,277,445,650,915,148.74,34.33,24.39,16.7
15-07-2021,MIRA,51,4,429,"[240,480]",Elevado,,,,51,Centro,COIMBRA,0608,12403.38,11832,727,729,659,550,466,1016,1675,2404,3131,95.4,25.24,19.38,13.5
15-07-2021,MIRANDA DO CORVO,1,0,8,"[0,120]",Baixo a Moderado,,,,1,Centro,COIMBRA,0609,12637.79,12708,706,659,568,498,404,902,1470,2129,2835,100.55,22.43,16.85,11.63
15-07-2021,MIRANDA DO DOURO,12,1,177,"[120,240]",Moderado,,,,12,Norte,BRAGANÇA,0406,48718.31,6830,482,429,442,463,470,933,1375,1804,2286,14.02,4.69,3.7,2.82
15-07-2021,MIRANDELA,41,3,190,"[120,240]",Moderado,,,,41,Norte,BRAGANÇA,0407,65895.67,21754,1640,1315,1204,1078,947,2025,3229,4544,6184,33.01,9.38,6.9,4.9
15-07-2021,MOGADOURO,22,2,266,"[240,480]",Elevado,,,,22,Norte,BRAGANÇA,0408,76064.93,8392,589,529,576,630,655,1285,1861,2390,2979,11.03,3.92,3.14,2.45
15-07-2021,MOIMENTA DA BEIRA,7,1,72,"[0,120]",Baixo a Moderado,,,,7,Norte,VISEU,1807,21996.9,9736,576,514,471,416,461,877,1348,1862,2438,44.26,11.08,8.46,6.13
15-07-2021,MOITA,442,32,687,"[480,960]",Muito Elevado,,,,442,Lisboa e Vale do Tejo,SETÚBAL,1506,5525.98,64407,4226,3646,2623,1801,1425,3226,5849,9495,13721,1165.53,248.3,171.82,105.85
15-07-2021,MONÇÃO,13,1,73,"[0,120]",Baixo a Moderado,,,,13,Norte,VIANA DO CASTELO,1604,21130.85,17869,1161,1105,1031,1006,972,1978,3009,4114,5275,84.56,24.96,19.47,14.24
15-07-2021,MONCHIQUE,15,1,301,"[240,480]",Elevado,,,,15,Algarve,FARO,0809,39530.43,5077,353,384,321,355,392,747,1068,1452,1805,12.84,4.57,3.67,2.7
15-07-2021,MONDIM DE BASTO,7,1,102,"[0,120]",Baixo a Moderado,,,,7,Norte,VILA REAL,1705,17207.52,6946,395,300,314,284,283,567,881,1181,1576,40.36,9.16,6.86,5.12
15-07-2021,MONFORTE,0,0,0,"[0,120]",Baixo a Moderado,,,,0,Alentejo,PORTALEGRE,1211,42024.82,2975,139,115,117,192,168,360,477,592,731,7.08,1.74,1.41,1.14
15-07-2021,MONTALEGRE,13,1,146,"[120,240]",Moderado,,,,13,Norte,VILA REAL,1706,80545.71,8997,699,628,595,603,730,1333,1928,2556,3255,11.17,4.04,3.17,2.39
15-07-2021,MONTEMOR-O-NOVO,59,4,376,"[240,480]",Elevado,,,,59,Alentejo,ÉVORA,0706,123296.65,15647,991,953,868,878,971,1849,2717,3670,4661,12.69,3.78,2.98,2.2
15-07-2021,MONTEMOR-O-VELHO,31,2,123,"[120,240]",Moderado,,,,31,Centro,COIMBRA,0610,22896.23,25224,1496,1397,1217,1057,988,2045,3262,4659,6155,110.17,26.88,20.35,14.25
15-07-2021,MONTIJO,228,16,396,"[240,480]",Elevado,,,,228,Lisboa e Vale do Tejo,SETÚBAL,1507,34861.64,57614,2771,2441,1990,1554,1109,2663,4653,7094,9865,165.26,28.3,20.35,13.35
15-07-2021,MORA,4,0,99,"[0,120]",Baixo a Moderado,,,,4,Alentejo,ÉVORA,0707,44395.02,4138,336,275,252,238,257,495,747,1022,1358,9.32,3.06,2.3,1.68
15-07-2021,MORTÁGUA,5,0,57,"[0,120]",Baixo a Moderado,,,,5,Centro,VISEU,1808,25117.82,8803,638,584,535,499,460,959,1494,2078,2716,35.05,10.81,8.27,5.95
15-07-2021,MOURA,25,2,184,"[120,240]",Moderado,,,,25,Alentejo,BEJA,0210,95845.55,13718,817,656,665,542,461,1003,1668,2324,3141,14.31,3.28,2.42,1.74
15-07-2021,MOURÃO,5,0,206,"[120,240]",Moderado,,,,5,Alentejo,ÉVORA,0708,27862.98,2450,139,108,80,104,109,213,293,401,540,8.79,1.94,1.44,1.05
15-07-2021,MURÇA,6,0,111,"[0,120]",Baixo a Moderado,,,,6,Norte,VILA REAL,1707,18937.11,5463,384,341,307,306,319,625,932,1273,1657,28.85,8.75,6.72,4.92
15-07-2021,MURTOSA,24,2,231,"[120,240]",Moderado,,,,24,Centro,AVEIRO,0112,7308.78,10279,509,473,403,353,409,762,1165,1638,2147,140.63,29.37,22.41,15.94
15-07-2021,NAZARÉ,78,6,554,"[480,960]",Muito Elevado,,,,78,Lisboa e Vale do Tejo,LEIRIA,1011,8243.43,14165,967,903,670,420,396,816,1486,2389,3356,171.84,40.71,28.98,18.03
15-07-2021,NELAS,12,1,92,"[0,120]",Baixo a Moderado,,,,12,Centro,VISEU,1809,12571.48,12974,924,787,668,604,583,1187,1855,2642,3566,103.21,28.37,21.02,14.76
15-07-2021,NISA,4,0,67,"[0,120]",Baixo a Moderado,,,,4,Alentejo,PORTALEGRE,1212,57567.84,6061,405,389,355,483,478,961,1316,1705,2110,10.53,3.67,2.96,2.29
15-07-2021,NORDESTE,1,0,21,"[0,120]",Baixo a Moderado,,,,1,Açores,AÇORES,4202,10146.8,4862,246,180,124,161,162,323,447,627,873,47.92,8.6,6.18,4.41
15-07-2021,ÓBIDOS,15,1,125,"[120,240]",Moderado,,,,15,Lisboa e Vale do Tejo,LEIRIA,1012,14155.44,11850,743,650,574,452,436,888,1462,2112,2855,83.72,20.17,14.92,10.33
15-07-2021,ODEMIRA,55,4,223,"[120,240]",Moderado,,,,55,Alentejo,BEJA,0211,172060.15,24717,1475,1317,1225,1397,1349,2746,3971,5288,6763,14.37,3.93,3.07,2.31
15-07-2021,ODIVELAS,869,62,537,"[480,960]",Muito Elevado,,,,869,Lisboa e Vale do Tejo,LISBOA,1116,2654.36,161774,9562,9038,6952,4641,3812,8453,15405,24443,34005,6095.48,1281.27,920.99,580.44
15-07-2021,OEIRAS,899,64,507,"[480,960]",Muito Elevado,,,,899,Lisboa e Vale do Tejo,LISBOA,1110,4588.31,177408,11580,11575,8566,6211,5855,12066,20632,32207,43787,3866.78,954.38,701.98,449.69
15-07-2021,OLEIROS,2,0,40,"[0,120]",Baixo a Moderado,,,,2,Centro,CASTELO BRANCO,0506,47109.31,5003,384,341,366,397,487,884,1250,1591,1975,10.62,4.19,3.38,2.65
15-07-2021,OLHÃO,342,24,770,"[480,960]",Muito Elevado,,,,342,Algarve,FARO,0810,13086.38,44405,2455,2309,1689,1342,1268,2610,4299,6608,9063,339.33,69.26,50.5,32.85
15-07-2021,OLIVEIRA DE AZEMÉIS,55,4,84,"[0,120]",Baixo a Moderado,,,,55,Norte,AVEIRO,0113,16110.41,66011,4155,3614,2794,2183,1738,3921,6715,10329,14484,409.75,89.91,64.12,41.68
15-07-2021,OLIVEIRA DE FRADES,11,1,110,"[0,120]",Baixo a Moderado,,,,11,Centro,VISEU,1810,14534.62,9936,553,475,438,359,415,774,1212,1687,2240,68.36,15.41,11.61,8.34
15-07-2021,OLIVEIRA DO BAIRRO,108,8,445,"[240,480]",Elevado,,,,108,Centro,AVEIRO,0114,8731.99,24277,1327,1182,999,786,810,1596,2595,3777,5104,278.02,58.45,43.25,29.72
15-07-2021,OLIVEIRA DO HOSPITAL,39,3,203,"[120,240]",Moderado,,,,39,Centro,COIMBRA,0611,23451.66,19253,1161,1097,962,924,960,1884,2846,3943,5104,82.1,21.76,16.81,12.14
15-07-2021,OURÉM,74,5,167,"[120,240]",Moderado,,,,74,Lisboa e Vale do Tejo,SANTARÉM,1421,41668.03,44044,2463,2069,1899,1817,1603,3420,5319,7388,9851,105.7,23.64,17.73,12.77
15-07-2021,OURIQUE,7,1,154,"[120,240]",Moderado,,,,7,Alentejo,BEJA,0212,66331.36,4607,313,287,284,268,227,495,779,1066,1379,6.95,2.08,1.61,1.17
15-07-2021,OVAR,88,6,163,"[120,240]",Moderado,,,,88,Centro,AVEIRO,0115,14770.25,54260,3294,2709,1994,1636,1234,2870,4864,7573,10867,367.37,73.57,51.27,32.93
15-07-2021,PAÇOS DE FERREIRA,111,8,195,"[120,240]",Moderado,,,,111,Norte,PORTO,1309,7099.29,56728,2903,2193,1518,1135,664,1799,3317,5510,8413,799.1,118.51,77.62,46.72
15-07-2021,PALMELA,202,14,315,"[240,480]",Elevado,,,,202,Lisboa e Vale do Tejo,SETÚBAL,1508,46512.01,64269,3402,3244,2635,1846,1391,3237,5872,9116,12518,138.18,26.91,19.6,12.62
15-07-2021,PAMPILHOSA DA SERRA,5,0,124,"[120,240]",Moderado,,,,5,Centro,COIMBRA,0612,39646.24,4037,238,254,295,339,423,762,1057,1311,1549,10.18,3.91,3.31,2.67
15-07-2021,PAREDES,309,22,359,"[240,480]",Elevado,,,,309,Norte,PORTO,1310,15675.69,86067,4272,3532,2412,1717,1258,2975,5387,8919,13191,549.04,84.15,56.9,34.36
15-07-2021,PAREDES DE COURA,24,2,283,"[240,480]",Elevado,,,,24,Norte,VIANA DO CASTELO,1605,13818.59,8535,466,528,407,465,515,980,1387,1915,2381,61.76,17.23,13.86,10.04
15-07-2021,PEDRÓGÃO GRANDE,25,2,732,"[480,960]",Muito Elevado,,,,25,Centro,LEIRIA,1013,12874.75,3410,175,173,196,221,252,473,669,842,1017,26.49,7.9,6.54,5.2
15-07-2021,PENACOVA,5,0,37,"[0,120]",Baixo a Moderado,,,,5,Centro,COIMBRA,0613,21673.23,13694,968,923,745,621,703,1324,2069,2992,3960,63.18,18.27,13.81,9.55
15-07-2021,PENAFIEL,149,11,213,"[120,240]",Moderado,,,,149,Norte,PORTO,1311,21224.27,69772,3648,2823,2032,1663,1230,2893,4925,7748,11396,328.74,53.69,36.51,23.2
15-07-2021,PENALVA DO CASTELO,3,0,42,"[0,120]",Baixo a Moderado,,,,3,Centro,VISEU,1811,13433.92,7115,449,457,413,391,426,817,1230,1687,2136,52.96,15.9,12.56,9.16
15-07-2021,PENAMACOR,1,0,21,"[0,120]",Baixo a Moderado,,,,1,Centro,CASTELO BRANCO,0507,56370.69,4755,262,248,273,451,633,1084,1357,1605,1867,8.44,3.31,2.85,2.41
15-07-2021,PENEDONO,2,0,78,"[0,120]",Baixo a Moderado,,,,2,Norte,VISEU,1812,13370.75,2591,172,113,129,156,138,294,423,536,708,19.38,5.3,4.01,3.16
15-07-2021,PENELA,6,0,111,"[0,120]",Baixo a Moderado,,,,6,Centro,COIMBRA,0614,13480.0,5397,314,324,274,359,344,703,977,1301,1615,40.04,11.98,9.65,7.25
15-07-2021,PENICHE,89,6,337,"[240,480]",Elevado,,,,89,Lisboa e Vale do Tejo,LEIRIA,1014,7754.98,26501,1746,1504,1203,926,707,1633,2836,4340,6086,341.73,78.48,55.96,36.57
15-07-2021,PESO DA RÉGUA,23,2,147,"[120,240]",Moderado,,,,23,Norte,VILA REAL,1708,9486.01,15773,1076,843,650,659,455,1114,1764,2607,3683,166.28,38.83,27.48,18.6
15-07-2021,PINHEL,2,0,24,"[0,120]",Baixo a Moderado,,,,2,Centro,GUARDA,0910,48452.12,8511,577,566,551,538,689,1227,1778,2344,2921,17.57,6.03,4.84,3.67
15-07-2021,POMBAL,40,3,77,"[0,120]",Baixo a Moderado,,,,40,Centro,LEIRIA,1015,62600.28,51461,3187,2791,2494,2328,2027,4355,6849,9640,12827,82.21,20.49,15.4,10.94
15-07-2021,PONTA DELGADA,172,12,253,"[240,480]",Elevado,,,,172,Açores,AÇORES,4203,23298.65,67935,3108,2435,1726,1133,902,2035,3761,6196,9304,291.58,39.93,26.59,16.14
15-07-2021,PONTA DO SOL,4,0,47,"[0,120]",Baixo a Moderado,,,,4,Madeira,MADEIRA,3105,4622.03,8593,319,283,347,208,221,429,776,1059,1378,185.92,29.81,22.91,16.79
15-07-2021,PONTE DA BARCA,4,0,36,"[0,120]",Baixo a Moderado,,,,4,Norte,VIANA DO CASTELO,1606,18211.37,11180,635,576,517,554,490,1044,1561,2137,2772,61.39,15.22,11.73,8.57
15-07-2021,PONTE DE LIMA,36,3,88,"[0,120]",Baixo a Moderado,,,,36,Norte,VIANA DO CASTELO,1607,32025.46,41315,2321,2022,1720,1596,1462,3058,4778,6800,9121,129.01,28.48,21.23,14.92
15-07-2021,PONTE DE SOR,16,1,108,"[0,120]",Baixo a Moderado,,,,16,Alentejo,PORTALEGRE,1213,83971.16,14994,939,800,716,739,831,1570,2286,3086,4025,17.86,4.79,3.68,2.72
15-07-2021,PORTALEGRE,26,2,119,"[0,120]",Baixo a Moderado,,,,26,Alentejo,PORTALEGRE,1214,44713.64,22172,1577,1351,1137,993,984,1977,3114,4465,6042,49.59,13.51,9.99,6.96
15-07-2021,PORTEL,10,1,173,"[120,240]",Moderado,,,,10,Alentejo,ÉVORA,0709,60100.57,5828,336,358,283,331,305,636,919,1277,1613,9.7,2.68,2.12,1.53
15-07-2021,PORTIMÃO,522,37,941,"[480,960]",Muito Elevado,,,,522,Algarve,FARO,0811,18206.29,55483,3182,2927,2116,1582,1400,2982,5098,8025,11207,304.75,61.56,44.08,28.0
15-07-2021,PORTO,1642,117,758,"[480,960]",Muito Elevado,,,,1642,Norte,PORTO,1312,4142.02,216606,15790,15193,11280,9409,10044,19453,30733,45926,61716,5229.5,1490.0,1108.79,741.98
15-07-2021,PORTO DE MÓS,41,3,176,"[120,240]",Moderado,,,,41,Centro,LEIRIA,1016,26183.41,23275,1355,1210,1034,888,872,1760,2794,4004,5359,88.89,20.47,15.29,10.67
15-07-2021,PORTO MONIZ,3,0,130,"[120,240]",Moderado,,,,3,Madeira,MADEIRA,3106,8293.38,2342,143,130,95,98,120,218,313,443,586,28.24,7.07,5.34,3.77
15-07-2021,PORTO SANTO,6,0,115,"[0,120]",Baixo a Moderado,,,,6,Madeira,MADEIRA,3201,4300.7,5202,240,157,134,110,68,178,312,469,709,120.95,16.48,10.9,7.25
15-07-2021,PÓVOA DE LANHOSO,25,2,116,"[0,120]",Baixo a Moderado,,,,25,Norte,BRAGA,0309,13465.29,21499,1175,909,732,673,624,1297,2029,2938,4113,159.67,30.55,21.82,15.07
15-07-2021,PÓVOA DE VARZIM,181,13,288,"[240,480]",Elevado,,,,181,Norte,PORTO,1313,8220.59,62784,3712,3120,2134,1594,1305,2899,5033,8153,11865,763.7,144.33,99.17,61.22
15-07-2021,POVOAÇÃO,0,0,0,"[0,120]",Baixo a Moderado,,,,0,Açores,AÇORES,4204,10640.77,5927,293,212,191,144,134,278,469,681,974,55.7,9.15,6.4,4.41
15-07-2021,VILA DA PRAIA DA VITÓRIA,9,1,42,"[0,120]",Baixo a Moderado,,,,9,Açores,AÇORES,4302,16127.06,21317,1133,789,619,436,336,772,1391,2180,3313,132.18,20.54,13.52,8.63
15-07-2021,PROENÇA-A-NOVA,7,1,97,"[0,120]",Baixo a Moderado,,,,7,Centro,CASTELO BRANCO,0508,39539.96,7298,508,465,389,400,560,960,1349,1814,2322,18.46,5.87,4.59,3.41
15-07-2021,REDONDO,4,0,64,"[0,120]",Baixo a Moderado,,,,4,Alentejo,ÉVORA,0710,36950.87,6353,349,325,288,288,354,642,930,1255,1604,17.19,4.34,3.4,2.52
15-07-2021,REGUENGOS DE MONSARAZ,19,1,191,"[120,240]",Moderado,,,,19,Alentejo,ÉVORA,0711,46399.72,10015,602,511,455,462,473,935,1390,1901,2503,21.58,5.39,4.1,3.0
15-07-2021,RESENDE,14,1,140,"[120,240]",Moderado,,,,14,Norte,VISEU,1813,12334.93,10137,560,493,448,433,422,855,1303,1796,2356,82.18,19.1,14.56,10.56
15-07-2021,RIBEIRA BRAVA,20,1,162,"[120,240]",Moderado,,,,20,Madeira,MADEIRA,3107,6544.88,12435,648,500,411,311,287,598,1009,1509,2157,189.99,32.96,23.06,15.42
15-07-2021,RIBEIRA DE PENA,7,1,117,"[0,120]",Baixo a Moderado,,,,7,Norte,VILA REAL,1709,21745.98,6016,371,301,290,310,368,678,968,1269,1640,27.66,7.54,5.84,4.45
15-07-2021,RIBEIRA GRANDE,91,6,277,"[240,480]",Elevado,,,,91,Açores,AÇORES,4205,18015.13,32811,1163,689,512,345,253,598,1110,1799,2962,182.13,16.44,9.99,6.16
15-07-2021,RIO MAIOR,45,3,222,"[120,240]",Moderado,,,,45,Lisboa e Vale do Tejo,SANTARÉM,1414,27276.45,20379,1251,1144,941,795,648,1443,2384,3528,4779,74.71,17.52,12.93,8.74
15-07-2021,SABROSA,4,0,68,"[0,120]",Baixo a Moderado,,,,4,Norte,VILA REAL,1710,15692.45,5918,393,314,304,302,350,652,956,1270,1663,37.71,10.6,8.09,6.09
15-07-2021,SABUGAL,4,0,38,"[0,120]",Baixo a Moderado,,,,4,Centro,GUARDA,0911,82269.82,10585,724,707,694,796,1009,1805,2499,3206,3930,12.87,4.78,3.9,3.04
15-07-2021,SALVATERRA DE MAGOS,45,3,212,"[120,240]",Moderado,,,,45,Lisboa e Vale do Tejo,SANTARÉM,1415,24393.2,21295,1275,1181,1060,799,772,1571,2631,3812,5087,87.3,20.85,15.63,10.79
15-07-2021,SANTA COMBA DÃO,6,0,57,"[0,120]",Baixo a Moderado,,,,6,Centro,VISEU,1814,11194.77,10452,732,684,569,538,464,1002,1571,2255,2987,93.36,26.68,20.14,14.03
15-07-2021,SANTA CRUZ,35,2,77,"[0,120]",Baixo a Moderado,,,,35,Madeira,MADEIRA,3108,8150.28,45281,1817,1301,974,716,523,1239,2213,3514,5331,555.6,65.41,43.12,27.15
15-07-2021,SANTA CRUZ DA GRACIOSA,5,0,120,"[120,240]",Moderado,,,,5,Açores,AÇORES,4401,6065.78,4208,228,180,163,124,145,269,432,612,840,69.37,13.85,10.09,7.12
15-07-2021,SANTA CRUZ DAS FLORES,0,0,0,"[0,120]",Baixo a Moderado,,,,0,Açores,AÇORES,4802,7091.44,2165,125,98,74,56,51,107,181,279,404,30.53,5.7,3.93,2.55
15-07-2021,SANTA MARIA DA FEIRA,190,14,137,"[120,240]",Moderado,,,,190,Norte,AVEIRO,0109,21587.65,138636,8182,6743,4771,3856,3079,6935,11706,18449,26631,642.19,123.36,85.46,54.22
15-07-2021,SANTA MARTA DE PENAGUIÃO,11,1,168,"[120,240]",Moderado,,,,11,Norte,VILA REAL,1711,6928.13,6599,483,373,337,316,317,633,970,1343,1826,95.25,26.36,19.39,14.0
15-07-2021,SANTANA,6,0,90,"[0,120]",Baixo a Moderado,,,,6,Madeira,MADEIRA,3109,9547.3,6711,418,353,343,282,277,559,902,1255,1673,70.29,17.52,13.15,9.45
15-07-2021,SANTARÉM,87,6,152,"[120,240]",Moderado,,,,87,Lisboa e Vale do Tejo,SANTARÉM,1416,55253.58,57421,3654,3441,2760,2466,2206,4672,7432,10873,14527,103.92,26.29,19.68,13.45
15-07-2021,SANTIAGO DO CACÉM,92,7,318,"[240,480]",Elevado,,,,92,Alentejo,SETÚBAL,1509,105969.29,28791,2144,1689,1472,1295,1215,2510,3982,5671,7815,27.17,7.37,5.35,3.76
15-07-2021,SANTO TIRSO,295,21,433,"[240,480]",Elevado,,,,295,Norte,PORTO,1314,13655.52,68055,4911,3935,2761,2257,1810,4067,6828,10763,15674,498.35,114.78,78.82,50.0
15-07-2021,SÃO BRÁS DE ALPORTEL,49,4,472,"[240,480]",Elevado,,,,49,Algarve,FARO,0812,15336.92,10416,596,468,467,404,401,805,1272,1740,2336,67.91,15.23,11.35,8.29
15-07-2021,SÃO JOÃO DA MADEIRA,31,2,141,"[120,240]",Moderado,,,,31,Norte,AVEIRO,0116,794.3,21958,1347,1069,796,601,593,1194,1990,3059,4406,2765.49,554.91,385.26,250.63
15-07-2021,SÃO JOÃO DA PESQUEIRA,15,1,212,"[120,240]",Moderado,,,,15,Norte,VISEU,1815,26610.85,7125,417,330,294,328,328,656,950,1280,1697,26.77,6.38,4.81,3.57
15-07-2021,SÃO PEDRO DO SUL,6,0,39,"[0,120]",Baixo a Moderado,,,,6,Centro,VISEU,1816,34895.09,15403,990,962,861,759,909,1668,2529,3491,4481,44.14,12.84,10.0,7.25
15-07-2021,SÃO ROQUE DO PICO,0,0,0,"[0,120]",Baixo a Moderado,,,,0,Açores,AÇORES,4603,14236.1,3266,199,141,93,96,113,209,302,443,642,22.94,4.51,3.11,2.12
15-07-2021,SÃO VICENTE,4,0,78,"[0,120]",Baixo a Moderado,,,,4,Madeira,MADEIRA,3110,7883.71,5143,272,264,266,225,280,505,771,1035,1307,65.23,16.58,13.13,9.78
15-07-2021,SARDOAL,1,0,27,"[0,120]",Baixo a Moderado,,,,1,Lisboa e Vale do Tejo,SANTARÉM,1417,9214.72,3741,227,178,148,165,248,413,561,739,966,40.6,10.48,8.02,6.09
15-07-2021,SÁTÃO,7,0,60,"[0,120]",Baixo a Moderado,,,,7,Centro,VISEU,1817,20194.11,11580,765,671,515,465,476,941,1456,2127,2892,57.34,14.32,10.53,7.21
15-07-2021,SEIA,14,1,63,"[0,120]",Baixo a Moderado,,,,14,Centro,GUARDA,0912,43568.83,22234,1807,1589,1238,1122,721,1843,3081,4670,6477,51.03,14.87,10.72,7.07
15-07-2021,SEIXAL,745,53,444,"[240,480]",Elevado,,,,745,Lisboa e Vale do Tejo,SETÚBAL,1510,9545.17,167752,10586,9270,6661,4391,2930,7321,13982,23252,33838,1757.49,354.51,243.6,146.49
15-07-2021,SERNANCELHE,3,0,56,"[0,120]",Baixo a Moderado,,,,3,Norte,VISEU,1818,22861.22,5396,305,293,286,273,260,533,819,1112,1417,23.6,6.2,4.86,3.58
15-07-2021,SERPA,36,3,254,"[240,480]",Elevado,,,,36,Alentejo,BEJA,0213,110563.34,14304,903,761,719,697,626,1323,2042,2803,3706,12.94,3.35,2.54,1.85
15-07-2021,SERTÃ,19,1,130,"[120,240]",Moderado,,,,19,Centro,CASTELO BRANCO,0509,44673.17,14577,870,779,790,767,1020,1787,2577,3356,4226,32.63,9.46,7.51,5.77
15-07-2021,SESIMBRA,259,19,500,"[480,960]",Muito Elevado,,,,259,Lisboa e Vale do Tejo,SETÚBAL,1511,19571.75,51858,2400,2321,1853,1257,1083,2340,4193,6514,8914,264.96,45.54,33.28,21.42
15-07-2021,SETÚBAL,335,24,291,"[240,480]",Elevado,,,,335,Lisboa e Vale do Tejo,SETÚBAL,1512,23032.5,115126,7425,6929,5075,3775,2655,6430,11505,18434,25859,499.83,112.27,80.03,49.95
15-07-2021,SEVER DO VOUGA,10,1,89,"[0,120]",Baixo a Moderado,,,,10,Centro,AVEIRO,0117,12987.56,11331,766,637,568,540,567,1107,1675,2312,3078,87.24,23.7,17.8,12.9
15-07-2021,SILVES,206,15,569,"[480,960]",Muito Elevado,,,,206,Algarve,FARO,0813,68006.23,36226,2137,1869,1610,1423,1600,3023,4633,6502,8639,53.27,12.7,9.56,6.81
15-07-2021,SINES,123,9,897,"[480,960]",Muito Elevado,,,,123,Alentejo,SETÚBAL,1513,20330.17,13715,888,791,551,416,268,684,1235,2026,2914,67.46,14.33,9.97,6.07
15-07-2021,SINTRA,1918,137,490,"[480,960]",Muito Elevado,,,,1918,Lisboa e Vale do Tejo,LISBOA,1111,31922.73,391402,20490,18316,13545,9137,7284,16421,29966,48282,68772,1226.08,215.43,151.25,93.87
15-07-2021,SOBRAL DE MONTE AGRAÇO,84,6,785,"[480,960]",Muito Elevado,,,,84,Lisboa e Vale do Tejo,LISBOA,1112,5210.32,10651,564,507,352,272,212,484,836,1343,1907,204.43,36.6,25.78,16.05
15-07-2021,SOURE,20,1,117,"[0,120]",Baixo a Moderado,,,,20,Centro,COIMBRA,0615,26506.07,17120,1173,1142,1004,883,987,1870,2874,4016,5189,64.59,19.58,15.15,10.84
15-07-2021,SOUSEL,2,0,46,"[0,120]",Baixo a Moderado,,,,2,Alentejo,PORTALEGRE,1215,27932.18,4412,261,274,208,302,292,594,802,1076,1337,15.8,4.79,3.85,2.87
15-07-2021,TÁBUA,8,1,70,"[0,120]",Baixo a Moderado,,,,8,Centro,COIMBRA,0616,19978.58,11368,729,584,524,430,464,894,1418,2002,2731,56.9,13.67,10.02,7.1
15-07-2021,TABUAÇO,0,0,0,"[0,120]",Baixo a Moderado,,,,0,Norte,VISEU,1819,13385.67,6033,372,314,217,282,363,645,862,1176,1548,45.07,11.56,8.79,6.44
15-07-2021,TAROUCA,9,1,115,"[0,120]",Baixo a Moderado,,,,9,Norte,VISEU,1820,10008.49,7804,405,335,313,277,324,601,914,1249,1654,77.98,16.53,12.48,9.13
15-07-2021,TAVIRA,67,5,272,"[240,480]",Elevado,,,,67,Algarve,FARO,0814,60696.7,24530,1493,1415,1252,1066,1277,2343,3595,5010,6503,40.41,10.71,8.25,5.92
15-07-2021,TERRAS DE BOURO,4,0,63,"[0,120]",Baixo a Moderado,,,,4,Norte,BRAGA,0310,27746.07,6361,391,372,296,319,340,659,955,1327,1718,22.93,6.19,4.78,3.44
15-07-2021,TOMAR,34,2,92,"[0,120]",Baixo a Moderado,,,,34,Lisboa e Vale do Tejo,SANTARÉM,1418,35120.44,36748,2403,2189,1868,1853,1822,3675,5543,7732,10135,104.64,28.86,22.02,15.78
15-07-2021,TONDELA,45,3,171,"[120,240]",Moderado,,,,45,Centro,VISEU,1821,37121.73,26357,1768,1722,1518,1475,1417,2892,4410,6132,7900,71.0,21.28,16.52,11.88
15-07-2021,TORRE DE MONCORVO,0,0,0,"[0,120]",Baixo a Moderado,,,,0,Norte,BRAGANÇA,0409,53155.67,7695,556,478,488,551,719,1270,1758,2236,2792,14.48,5.25,4.21,3.31
15-07-2021,TORRES NOVAS,36,3,103,"[0,120]",Baixo a Moderado,,,,36,Lisboa e Vale do Tejo,SANTARÉM,1419,26999.68,34933,2324,1979,1738,1406,1475,2881,4619,6598,8922,129.38,33.04,24.44,17.11
15-07-2021,TORRES VEDRAS,159,11,203,"[120,240]",Moderado,,,,159,Lisboa e Vale do Tejo,LISBOA,1113,40714.89,78530,4513,3945,3447,2628,2104,4732,8179,12124,16637,192.88,40.86,29.78,20.09
15-07-2021,TRANCOSO,22,2,247,"[240,480]",Elevado,,,,22,Centro,GUARDA,0913,36152.47,8875,581,557,542,586,496,1082,1624,2181,2762,24.55,7.64,6.03,4.49
15-07-2021,TROFA,78,6,203,"[120,240]",Moderado,,,,78,Norte,PORTO,1318,7201.76,38418,2336,1894,1231,939,684,1623,2854,4748,7084,533.44,98.36,65.93,39.63
15-07-2021,VAGOS,94,7,413,"[240,480]",Elevado,,,,94,Centro,AVEIRO,0118,16491.5,22740,1320,1205,922,784,724,1508,2430,3635,4955,137.89,30.04,22.04,14.73
15-07-2021,VALE DE CAMBRA,17,1,80,"[0,120]",Baixo a Moderado,,,,17,Norte,AVEIRO,0119,14733.47,21327,1491,1363,1005,831,798,1629,2634,3997,5488,144.76,37.25,27.13,17.88
15-07-2021,VALENÇA,7,1,53,"[0,120]",Baixo a Moderado,,,,7,Norte,VIANA DO CASTELO,1608,11712.86,13290,867,791,582,582,503,1085,1667,2458,3325,113.46,28.39,20.99,14.23
15-07-2021,VALONGO,385,27,395,"[240,480]",Elevado,,,,385,Norte,PORTO,1315,7512.45,97444,5629,4696,3207,2462,1829,4291,7498,12194,17823,1297.18,237.26,162.33,99.81
15-07-2021,VALPAÇOS,38,3,259,"[240,480]",Elevado,,,,38,Norte,VILA REAL,1712,54873.93,14818,1217,1118,999,928,997,1925,2924,4042,5259,27.0,9.58,7.37,5.33
15-07-2021,VELAS,2,0,39,"[0,120]",Baixo a Moderado,,,,2,Açores,AÇORES,4502,11738.38,5093,278,208,166,153,113,266,432,640,918,43.39,7.82,5.45,3.68
15-07-2021,VENDAS NOVAS,20,1,179,"[120,240]",Moderado,,,,20,Alentejo,ÉVORA,0712,22238.88,11255,677,768,655,501,532,1033,1688,2456,3133,50.61,14.09,11.04,7.59
15-07-2021,VIANA DO ALENTEJO,24,2,470,"[240,480]",Elevado,,,,24,Alentejo,ÉVORA,0713,39367.29,5145,245,208,235,210,214,424,659,867,1112,13.07,2.82,2.2,1.67
15-07-2021,VIANA DO CASTELO,127,9,151,"[120,240]",Moderado,,,,127,Norte,VIANA DO CASTELO,1609,31902.01,84417,5470,4433,3591,3061,2982,6043,9634,14067,19537,264.61,61.24,44.09,30.2
15-07-2021,VIDIGUEIRA,6,0,110,"[0,120]",Baixo a Moderado,,,,6,Alentejo,BEJA,0214,31661.09,5510,300,248,215,233,275,508,723,971,1271,17.4,4.01,3.07,2.28
15-07-2021,VIEIRA DO MINHO,18,1,153,"[120,240]",Moderado,,,,18,Norte,BRAGA,0311,21644.35,11842,703,594,525,548,482,1030,1555,2149,2852,54.71,13.18,9.93,7.18
15-07-2021,VILA DE REI,3,0,90,"[0,120]",Baixo a Moderado,,,,3,Centro,CASTELO BRANCO,0510,19154.6,3323,169,128,172,247,302,549,721,849,1018,17.35,5.31,4.43,3.76
15-07-2021,VILA DO BISPO,29,2,563,"[480,960]",Muito Elevado,,,,29,Algarve,FARO,0815,17906.06,5154,302,302,314,232,233,465,779,1081,1383,28.78,7.72,6.04,4.35
15-07-2021,VILA DO CONDE,184,13,230,"[120,240]",Moderado,,,,184,Norte,PORTO,1316,14902.77,79899,4726,3875,2819,2070,1743,3813,6632,10507,15233,536.13,102.21,70.5,44.5
15-07-2021,VILA DO PORTO,2,0,36,"[0,120]",Baixo a Moderado,,,,2,Açores,AÇORES,4101,9688.74,5616,274,212,135,96,123,219,354,566,840,57.96,8.67,5.84,3.65
15-07-2021,VILA FLOR,5,0,83,"[0,120]",Baixo a Moderado,,,,5,Norte,BRAGANÇA,0410,26581.14,6044,429,362,422,294,331,625,1047,1409,1838,22.74,6.91,5.3,3.94
15-07-2021,VILA FRANCA DE XIRA,788,56,555,"[480,960]",Muito Elevado,,,,788,Lisboa e Vale do Tejo,LISBOA,1114,31819.39,141957,8501,6852,4869,3425,2472,5897,10766,17618,26119,446.14,82.09,55.37,33.84
15-07-2021,VILA FRANCA DO CAMPO,16,1,146,"[120,240]",Moderado,,,,16,Açores,AÇORES,4206,7796.82,11051,450,344,248,217,154,371,619,963,1413,141.73,18.12,12.35,7.94
15-07-2021,VILA NOVA DA BARQUINHA,6,0,79,"[0,120]",Baixo a Moderado,,,,6,Lisboa e Vale do Tejo,SANTARÉM,1420,4952.97,7461,415,406,392,364,338,702,1094,1500,1915,150.64,38.66,30.28,22.09
15-07-2021,VILA NOVA DE CERVEIRA,11,1,124,"[120,240]",Moderado,,,,11,Norte,VIANA DO CASTELO,1610,10846.66,8910,531,444,410,384,334,718,1128,1572,2103,82.14,19.39,14.49,10.4
15-07-2021,VILA NOVA DE FAMALICÃO,342,24,260,"[240,480]",Elevado,,,,342,Norte,BRAGA,0312,20159.26,131676,7817,6164,4202,3282,2749,6031,10233,16397,24214,653.19,120.12,81.34,50.76
15-07-2021,VILA NOVA DE FOZ CÔA,6,0,93,"[0,120]",Baixo a Moderado,,,,6,Centro,GUARDA,0914,39815.18,6503,442,385,390,398,429,827,1217,1602,2044,16.33,5.13,4.02,3.06
15-07-2021,VILA NOVA DE GAIA,1508,108,502,"[480,960]",Muito Elevado,,,,1508,Norte,PORTO,1317,16846.43,300472,18349,15568,10972,8224,6281,14505,25477,41045,59394,1783.64,352.57,243.65,151.23
15-07-2021,VILA NOVA DE PAIVA,5,0,107,"[0,120]",Baixo a Moderado,,,,5,Centro,VISEU,1822,17553.28,4687,289,272,233,217,241,458,691,963,1252,26.7,7.13,5.49,3.94
15-07-2021,VILA NOVA DE POIARES,0,0,0,"[0,120]",Baixo a Moderado,,,,0,Centro,COIMBRA,0617,8445.3,6939,380,284,262,235,182,417,679,963,1343,82.17,15.9,11.4,8.04
15-07-2021,VILA POUCA DE AGUIAR,19,1,160,"[120,240]",Moderado,,,,19,Norte,VILA REAL,1713,43706.62,11961,860,817,733,601,627,1228,1961,2778,3638,27.37,8.32,6.36,4.49
15-07-2021,VILA REAL,150,11,301,"[240,480]",Elevado,,,,150,Norte,VILA REAL,1714,37880.28,49962,3025,2498,2065,1579,1466,3045,5110,7608,10633,131.9,28.07,20.08,13.49
15-07-2021,VILA REAL DE SANTO ANTÓNIO,65,5,349,"[240,480]",Elevado,,,,65,Algarve,FARO,0816,6125.0,18749,1172,1069,811,569,586,1155,1966,3035,4207,306.11,68.69,49.55,32.1
15-07-2021,VILA VELHA DE RÓDÃO,0,0,0,"[0,120]",Baixo a Moderado,,,,0,Centro,CASTELO BRANCO,0511,32991.16,3144,209,229,180,283,306,589,769,998,1207,9.53,3.66,3.03,2.33
15-07-2021,VILA VERDE,56,4,120,"[120,240]",Moderado,,,,56,Norte,BRAGA,0313,22866.52,46911,2365,2063,1667,1494,1437,2931,4598,6661,9026,205.15,39.47,29.13,20.11
15-07-2021,VILA VIÇOSA,24,2,317,"[240,480]",Elevado,,,,24,Alentejo,ÉVORA,0714,19485.89,7656,487,379,342,345,324,669,1011,1390,1877,39.29,9.63,7.13,5.19
15-07-2021,VIMIOSO,1,0,25,"[0,120]",Baixo a Moderado,,,,1,Norte,BRAGANÇA,0411,48158.51,4023,274,230,261,293,335,628,889,1119,1393,8.35,2.89,2.32,1.85
15-07-2021,VINHAIS,14,1,184,"[120,240]",Moderado,,,,14,Norte,BRAGANÇA,0412,69475.09,7746,599,577,636,641,815,1456,2092,2669,3268,11.15,4.7,3.84,3.01
15-07-2021,VISEU,529,38,544,"[480,960]",Muito Elevado,,,,529,Centro,VISEU,1823,50710.14,97249,5769,5038,4140,3158,2710,5868,10008,15046,20815,191.77,41.05,29.67,19.74
15-07-2021,VIZELA,36,3,151,"[120,240]",Moderado,,,,36,Norte,BRAGA,0314,2469.83,23897,1258,928,655,509,371,880,1535,2463,3721,967.49,150.65,99.72,62.15
15-07-2021,VOUZELA,6,0,62,"[0,120]",Baixo a Moderado,,,,6,Centro,VISEU,1824,19369.46,9619,626,605,554,532,507,1039,1593,2198,2824,49.66,14.58,11.35,8.22
22-07-2021,ABRANTES,30,2,86,"[0,120]",Baixo a Moderado,,,,30,Lisboa e Vale do Tejo,SANTARÉM,1401,71469.08,35130,2473,2213,1730,1748,2021,3769,5499,7712,10185,49.15,14.25,10.79,7.69
22-07-2021,ÁGUEDA,163,12,354,"[240,480]",Elevado,,,,163,Centro,AVEIRO,0101,33527.44,46075,3237,2713,2090,1635,1496,3131,5221,7934,11171,137.43,33.32,23.66,15.57
22-07-2021,AGUIAR DA BEIRA,2,0,43,"[0,120]",Baixo a Moderado,,,,2,Centro,GUARDA,0901,20676.57,4652,304,281,235,239,148,387,622,903,1207,22.5,5.84,4.37,3.01
22-07-2021,ALANDROAL,5,0,102,"[0,120]",Baixo a Moderado,,,,5,Alentejo,ÉVORA,0701,54267.81,4992,307,256,296,299,377,676,972,1228,1535,9.2,2.83,2.26,1.79
22-07-2021,ALBERGARIA-A-VELHA,129,9,535,"[480,960]",Muito Elevado,,,,129,Centro,AVEIRO,0102,15882.5,24144,1550,1298,996,687,680,1367,2363,3661,5211,152.02,32.81,23.05,14.88
22-07-2021,ALBUFEIRA,645,46,1553,"[960,Max]",Extremamente Elevado,,,,645,Algarve,FARO,0801,14066.42,41528,2067,1717,1425,985,858,1843,3268,4985,7052,295.24,50.14,35.44,23.23
22-07-2021,ALCÁCER DO SAL,3,0,26,"[0,120]",Baixo a Moderado,,,,3,Alentejo,SETÚBAL,1501,149987.3,11659,884,814,623,623,602,1225,1848,2662,3546,7.77,2.36,1.77,1.23
22-07-2021,ALCANENA,15,1,117,"[0,120]",Baixo a Moderado,,,,15,Lisboa e Vale do Tejo,SANTARÉM,1402,12732.86,12809,891,744,628,536,588,1124,1752,2496,3387,100.6,26.6,19.6,13.76
22-07-2021,ALCOBAÇA,119,9,223,"[120,240]",Moderado,,,,119,Lisboa e Vale do Tejo,LEIRIA,1001,40814.09,53555,3420,2927,2466,2059,1676,3735,6201,9128,12548,131.22,30.74,22.36,15.19
22-07-2021,ALCOCHETE,53,4,266,"[240,480]",Elevado,,,,53,Lisboa e Vale do Tejo,SETÚBAL,1502,12836.48,19787,857,834,691,476,447,923,1614,2448,3305,154.15,25.75,19.07,12.57
22-07-2021,ALCOUTIM,6,0,289,"[240,480]",Elevado,,,,6,Algarve,FARO,0802,57536.33,2159,191,188,163,190,267,457,620,808,999,3.75,1.74,1.4,1.08
22-07-2021,ALENQUER,171,12,389,"[240,480]",Elevado,,,,171,Lisboa e Vale do Tejo,LISBOA,1101,30421.92,44052,2298,2062,1629,1330,1155,2485,4114,6176,8474,144.8,27.85,20.3,13.52
22-07-2021,ALFÂNDEGA DA FÉ,2,0,45,"[0,120]",Baixo a Moderado,,,,2,Norte,BRAGANÇA,0401,32194.64,4550,325,277,301,274,325,599,900,1177,1502,14.13,4.67,3.66,2.8
22-07-2021,ALIJÓ,17,1,161,"[120,240]",Moderado,,,,17,Norte,VILA REAL,1701,29759.89,10625,766,687,635,542,666,1208,1843,2530,3296,35.7,11.08,8.5,6.19
22-07-2021,ALJEZUR,23,2,411,"[240,480]",Elevado,,,,23,Algarve,FARO,0803,32349.95,5594,316,336,335,320,410,730,1065,1401,1717,17.29,5.31,4.33,3.29
22-07-2021,ALJUSTREL,49,3,590,"[480,960]",Muito Elevado,,,,49,Alentejo,BEJA,0201,45847.41,8247,635,521,443,347,358,705,1148,1669,2304,17.99,5.03,3.64,2.5
22-07-2021,ALMADA,904,65,535,"[480,960]",Muito Elevado,,,,904,Lisboa e Vale do Tejo,SETÚBAL,1503,7000.89,169039,10469,9777,7876,6144,5111,11255,19131,28908,39377,2414.5,562.45,412.91,273.26
22-07-2021,ALMEIDA,10,1,173,"[120,240]",Moderado,,,,10,Centro,GUARDA,0902,51798.46,5830,441,419,396,458,393,851,1247,1666,2107,11.26,4.07,3.22,2.41
22-07-2021,ALMEIRIM,32,2,143,"[120,240]",Moderado,,,,32,Lisboa e Vale do Tejo,SANTARÉM,1403,22212.05,22546,1342,1353,1106,866,843,1709,2815,4168,5510,101.5,24.81,18.76,12.67
22-07-2021,ALMODÔVAR,22,2,330,"[240,480]",Elevado,,,,22,Alentejo,BEJA,0202,77788.03,6725,414,443,396,373,328,701,1097,1540,1954,8.65,2.51,1.98,1.41
22-07-2021,ALPIARÇA,14,1,200,"[120,240]",Moderado,,,,14,Lisboa e Vale do Tejo,SANTARÉM,1404,9536.33,7059,515,486,363,333,274,607,970,1456,1971,74.02,20.67,15.27,10.17
22-07-2021,ALTER DO CHÃO,7,1,223,"[120,240]",Moderado,,,,7,Alentejo,PORTALEGRE,1201,36206.62,3165,201,163,136,208,187,395,531,694,895,8.74,2.47,1.92,1.47
22-07-2021,ALVAIÁZERE,9,1,137,"[120,240]",Moderado,,,,9,Centro,LEIRIA,1002,16047.76,6597,419,389,346,406,539,945,1291,1680,2099,41.11,13.08,10.47,8.04
22-07-2021,ALVITO,3,0,122,"[120,240]",Moderado,,,,3,Alentejo,BEJA,0203,26485.32,2477,145,110,105,111,89,200,305,415,560,9.35,2.11,1.57,1.15
22-07-2021,AMADORA,921,66,500,"[480,960]",Muito Elevado,,,,921,Lisboa e Vale do Tejo,LISBOA,1115,2378.47,184106,11186,10936,8780,6460,5890,12350,21130,32066,43252,7742.05,1818.84,1348.44,888.56
22-07-2021,AMARANTE,189,14,356,"[240,480]",Elevado,,,,189,Norte,PORTO,1301,30133.15,53193,3086,2413,1812,1643,1311,2954,4766,7179,10265,176.53,34.07,23.82,15.82
22-07-2021,AMARES,29,2,160,"[120,240]",Moderado,,,,29,Norte,BRAGA,0301,8195.41,18129,1001,829,622,489,524,1013,1635,2464,3465,221.22,42.28,30.07,19.95
22-07-2021,ANADIA,61,4,223,"[120,240]",Moderado,,,,61,Centro,AVEIRO,0103,21663.48,27258,1931,1698,1376,1208,1262,2470,3846,5544,7475,125.83,34.51,25.59,17.75
22-07-2021,ANGRA DO HEROÍSMO,38,3,113,"[0,120]",Baixo a Moderado,,,,38,Açores,AÇORES,4301,23899.66,33807,2006,1473,1122,768,635,1403,2525,3998,6004,141.45,25.12,16.73,10.56
22-07-2021,ANSIÃO,6,0,50,"[0,120]",Baixo a Moderado,,,,6,Centro,LEIRIA,1003,17609.42,12039,727,709,646,694,530,1224,1870,2579,3306,68.37,18.77,14.65,10.62
22-07-2021,ARCOS DE VALDEVEZ,17,1,82,"[0,120]",Baixo a Moderado,,,,17,Norte,VIANA DO CASTELO,1601,44759.64,20926,1329,1338,1282,1343,1515,2858,4140,5478,6807,46.75,15.21,12.24,9.25
22-07-2021,ARGANIL,5,0,45,"[0,120]",Baixo a Moderado,,,,5,Centro,COIMBRA,0601,33283.93,11014,672,648,612,559,596,1155,1767,2415,3087,33.09,9.27,7.26,5.31
22-07-2021,ARMAMAR,4,0,70,"[0,120]",Baixo a Moderado,,,,4,Norte,VISEU,1801,11723.73,5769,357,305,309,285,310,595,904,1209,1566,49.21,13.36,10.31,7.71
22-07-2021,AROUCA,45,3,218,"[120,240]",Moderado,,,,45,Norte,AVEIRO,0104,32910.52,20720,1306,1047,753,683,683,1366,2119,3166,4472,62.96,13.59,9.62,6.44
22-07-2021,ARRAIOLOS,34,2,495,"[480,960]",Muito Elevado,,,,34,Alentejo,ÉVORA,0702,68374.55,6928,435,384,283,367,480,847,1130,1514,1949,10.13,2.85,2.21,1.65
22-07-2021,ARRONCHES,3,0,109,"[0,120]",Baixo a Moderado,,,,3,Alentejo,PORTALEGRE,1202,31464.72,2820,155,142,162,187,179,366,528,670,825,8.96,2.62,2.13,1.68
22-07-2021,ARRUDA DOS VINHOS,27,2,178,"[120,240]",Moderado,,,,27,Lisboa e Vale do Tejo,LISBOA,1102,7795.93,15412,738,738,562,509,438,947,1509,2247,2985,197.69,38.29,28.82,19.36
22-07-2021,AVEIRO,320,23,407,"[240,480]",Elevado,,,,320,Centro,AVEIRO,0105,19757.57,78734,4520,4004,3050,2250,2103,4353,7403,11407,15927,398.49,80.61,57.73,37.47
22-07-2021,AVIS,15,1,358,"[240,480]",Elevado,,,,15,Alentejo,PORTALEGRE,1203,60596.51,4247,315,225,206,251,273,524,730,955,1270,7.01,2.1,1.58,1.2
22-07-2021,AZAMBUJA,87,6,385,"[240,480]",Elevado,,,,87,Lisboa e Vale do Tejo,LISBOA,1103,26265.65,22716,1322,1171,1070,798,618,1416,2486,3657,4979,86.48,18.96,13.92,9.46
22-07-2021,BAIÃO,31,2,167,"[120,240]",Moderado,,,,31,Norte,PORTO,1302,17452.83,18748,1070,862,714,686,725,1411,2125,2987,4057,107.42,23.25,17.11,12.18
22-07-2021,BARCELOS,281,20,242,"[240,480]",Elevado,,,,281,Norte,BRAGA,0302,37890.14,116187,6721,5325,3619,2991,2562,5553,9172,14497,21218,306.64,56.0,38.26,24.21
22-07-2021,BARRANCOS,0,0,0,"[0,120]",Baixo a Moderado,,,,0,Alentejo,BEJA,0204,16841.73,1634,90,65,65,94,61,155,220,285,375,9.7,2.23,1.69,1.31
22-07-2021,BARREIRO,536,38,713,"[480,960]",Muito Elevado,,,,536,Lisboa e Vale do Tejo,SETÚBAL,1504,3639.07,75147,5194,5565,4459,3105,1767,4872,9331,14896,20090,2065.05,552.07,409.34,256.42
22-07-2021,BATALHA,43,3,272,"[240,480]",Elevado,,,,43,Centro,LEIRIA,1004,10341.6,15963,873,762,649,529,549,1078,1727,2489,3362,154.35,32.51,24.07,16.7
22-07-2021,BEJA,101,7,300,"[240,480]",Elevado,,,,101,Alentejo,BEJA,0205,114647.55,33579,2005,1840,1386,1272,1039,2311,3697,5537,7542,29.29,6.58,4.83,3.22
22-07-2021,BELMONTE,2,0,31,"[0,120]",Baixo a Moderado,,,,2,Centro,CASTELO BRANCO,0501,11875.91,6398,444,321,325,310,355,665,990,1311,1755,53.87,14.78,11.04,8.34
22-07-2021,BENAVENTE,126,9,413,"[240,480]",Elevado,,,,126,Lisboa e Vale do Tejo,SANTARÉM,1405,52138.39,30602,1468,1376,1141,876,643,1519,2660,4036,5504,58.69,10.56,7.74,5.1
22-07-2021,BOMBARRAL,17,1,134,"[120,240]",Moderado,,,,17,Lisboa e Vale do Tejo,LEIRIA,1005,9128.55,12558,875,714,561,491,429,920,1481,2195,3070,137.56,33.63,24.04,16.22
22-07-2021,BORBA,5,0,75,"[0,120]",Baixo a Moderado,,,,5,Alentejo,ÉVORA,0703,14518.65,6736,430,375,279,436,392,828,1107,1482,1912,46.39,13.17,10.21,7.62
22-07-2021,BOTICAS,7,1,142,"[120,240]",Moderado,,,,7,Norte,VILA REAL,1702,32195.66,4998,347,306,311,305,380,685,996,1302,1649,15.52,5.12,4.04,3.09
22-07-2021,BRAGA,466,33,255,"[240,480]",Elevado,,,,466,Norte,BRAGA,0303,18339.95,182679,10029,7963,5241,4320,3671,7991,13232,21195,31224,996.07,170.25,115.57,72.15
22-07-2021,BRAGANÇA,95,7,284,"[240,480]",Elevado,,,,95,Norte,BRAGANÇA,0402,117357.27,33607,2402,1855,1652,1393,1163,2556,4208,6063,8465,28.64,7.21,5.17,3.59
22-07-2021,CABECEIRAS DE BASTO,24,2,155,"[120,240]",Moderado,,,,24,Norte,BRAGA,0304,24182.16,15628,774,594,544,575,574,1149,1693,2287,3061,64.63,12.66,9.46,7.0
22-07-2021,CADAVAL,48,3,349,"[240,480]",Elevado,,,,48,Lisboa e Vale do Tejo,LISBOA,1104,17489.3,13673,813,796,756,621,625,1246,2002,2798,3611,78.18,20.65,16.0,11.45
22-07-2021,CALDAS DA RAINHA,128,9,246,"[240,480]",Elevado,,,,128,Lisboa e Vale do Tejo,LEIRIA,1006,25569.47,51912,3035,2684,2186,1899,1705,3604,5790,8474,11509,203.03,45.01,33.14,22.64
22-07-2021,CALHETA,17,1,157,"[120,240]",Moderado,,,,17,Madeira,MADEIRA,3101,11150.43,10867,576,497,507,399,415,814,1321,1818,2394,97.46,21.47,16.3,11.85
22-07-2021,CALHETA (AÇORES),1,0,32,"[0,120]",Baixo a Moderado,,,,1,Açores,AÇORES,4501,12626.4,3184,215,159,141,139,122,261,402,561,776,25.22,6.15,4.44,3.18
22-07-2021,CÂMARA DE LOBOS,22,2,65,"[0,120]",Baixo a Moderado,,,,22,Madeira,MADEIRA,3102,5216.67,33675,1396,1059,834,545,381,926,1760,2819,4215,645.49,80.79,54.03,33.74
22-07-2021,CAMINHA,8,1,51,"[0,120]",Baixo a Moderado,,,,8,Norte,VIANA DO CASTELO,1602,13652.14,15877,1046,944,818,646,656,1302,2120,3064,4110,116.3,30.11,22.44,15.53
22-07-2021,CAMPO MAIOR,9,1,116,"[0,120]",Baixo a Moderado,,,,9,Alentejo,PORTALEGRE,1204,24720.16,7874,471,364,351,279,327,606,957,1321,1792,31.85,7.25,5.34,3.87
22-07-2021,CANTANHEDE,77,5,219,"[120,240]",Moderado,,,,77,Centro,COIMBRA,0602,39088.02,35011,2346,2096,1880,1709,1451,3160,5040,7136,9482,89.57,24.26,18.26,12.89
22-07-2021,CARRAZEDA DE ANSIÃES,2,0,36,"[0,120]",Baixo a Moderado,,,,2,Norte,BRAGANÇA,0403,27924.09,5666,424,389,391,312,465,777,1168,1557,1981,20.29,7.09,5.58,4.18
22-07-2021,CARREGAL DO SAL,15,1,161,"[120,240]",Moderado,,,,15,Centro,VISEU,1802,11689.21,9271,587,562,486,462,376,838,1324,1886,2473,79.31,21.16,16.13,11.33
22-07-2021,CARTAXO,52,4,219,"[120,240]",Moderado,,,,52,Lisboa e Vale do Tejo,SANTARÉM,1406,15817.28,23843,1415,1376,1142,861,632,1493,2635,4011,5426,150.74,34.3,25.36,16.66
22-07-2021,CASCAIS,1177,84,551,"[480,960]",Muito Elevado,,,,1177,Lisboa e Vale do Tejo,LISBOA,1105,9740.17,213608,12151,11444,8680,6469,5248,11717,20397,31841,43992,2193.1,451.66,326.91,209.41
22-07-2021,CASTANHEIRA DE PÊRA,1,0,39,"[0,120]",Baixo a Moderado,,,,1,Centro,LEIRIA,1007,6677.45,2614,233,195,157,190,187,377,534,729,962,39.15,14.41,10.92,8.0
22-07-2021,CASTELO BRANCO,48,3,92,"[0,120]",Baixo a Moderado,,,,48,Centro,CASTELO BRANCO,0502,143819.15,51987,3528,3042,2499,2229,2225,4454,6953,9995,13523,36.15,9.4,6.95,4.83
22-07-2021,CASTELO DE PAIVA,40,3,261,"[240,480]",Elevado,,,,40,Norte,AVEIRO,0106,11500.53,15454,881,697,545,420,431,851,1396,2093,2974,134.37,25.86,18.2,12.14
22-07-2021,CASTELO DE VIDE,1,0,35,"[0,120]",Baixo a Moderado,,,,1,Alentejo,PORTALEGRE,1205,26491.24,2919,204,173,179,147,170,317,496,669,873,11.02,3.3,2.53,1.87
22-07-2021,CASTRO DAIRE,21,2,152,"[120,240]",Moderado,,,,21,Centro,VISEU,1803,37904.13,13823,942,857,765,732,773,1505,2270,3127,4069,36.47,10.74,8.25,5.99
22-07-2021,CASTRO MARIM,21,2,339,"[240,480]",Elevado,,,,21,Algarve,FARO,0804,30084.37,6237,370,345,334,322,344,666,1000,1345,1715,20.73,5.7,4.47,3.32
22-07-2021,CASTRO VERDE,11,1,160,"[120,240]",Moderado,,,,11,Alentejo,BEJA,0206,56944.23,6949,437,347,303,275,227,502,805,1152,1589,12.2,2.79,2.02,1.41
22-07-2021,CELORICO DA BEIRA,10,1,144,"[120,240]",Moderado,,,,10,Centro,GUARDA,0903,24721.63,6928,430,416,363,369,535,904,1267,1683,2113,28.02,8.55,6.81,5.12
22-07-2021,CELORICO DE BASTO,52,4,275,"[240,480]",Elevado,,,,52,Norte,BRAGA,0305,18107.02,19040,1001,802,668,728,729,1457,2125,2927,3928,105.15,21.69,16.17,11.74
22-07-2021,CHAMUSCA,17,1,187,"[120,240]",Moderado,,,,17,Lisboa e Vale do Tejo,SANTARÉM,1407,74600.54,9197,629,583,553,465,579,1044,1597,2180,2809,12.33,3.77,2.92,2.14
22-07-2021,CHAVES,151,11,383,"[240,480]",Elevado,,,,151,Norte,VILA REAL,1703,59122.95,39343,2676,2429,1991,1886,1918,3804,5795,8224,10900,66.54,18.44,13.91,9.8
22-07-2021,CINFÃES,45,3,244,"[240,480]",Elevado,,,,45,Norte,VISEU,1804,23928.76,18244,1067,902,779,734,758,1492,2271,3173,4240,76.24,17.72,13.26,9.49
22-07-2021,COIMBRA,258,18,192,"[120,240]",Moderado,,,,258,Centro,COIMBRA,0603,31939.94,134166,9489,8734,6353,5139,5074,10213,16566,25300,34789,420.06,108.92,79.21,51.87
22-07-2021,CONDEIXA-A-NOVA,20,1,112,"[0,120]",Baixo a Moderado,,,,20,Centro,COIMBRA,0604,13867.47,17733,871,809,717,583,490,1073,1790,2599,3470,127.88,25.02,18.74,12.91
22-07-2021,CONSTÂNCIA,32,2,790,"[480,960]",Muito Elevado,,,,32,Lisboa e Vale do Tejo,SANTARÉM,1408,8036.58,4030,211,183,187,148,155,303,490,673,884,50.14,11.0,8.37,6.1
22-07-2021,CORUCHE,27,2,157,"[120,240]",Moderado,,,,27,Lisboa e Vale do Tejo,SANTARÉM,1409,111572.03,17471,1294,1090,1095,1096,1019,2115,3210,4300,5594,15.66,5.01,3.85,2.88
22-07-2021,CORVO,0,0,0,"[0,120]",Baixo a Moderado,,,,0,Açores,AÇORES,4901,1711.45,464,22,21,11,13,19,32,43,64,86,27.12,5.03,3.74,2.51
22-07-2021,COVILHÃ,22,2,47,"[0,120]",Baixo a Moderado,,,,22,Centro,CASTELO BRANCO,0503,55560.06,46787,3533,2998,2365,2111,2193,4304,6669,9667,13200,84.21,23.76,17.4,12.0
22-07-2021,CRATO,2,0,65,"[0,120]",Baixo a Moderado,,,,2,Alentejo,PORTALEGRE,1206,39806.88,3129,229,258,163,182,228,410,573,831,1060,7.86,2.66,2.09,1.44
22-07-2021,CUBA,30,2,660,"[480,960]",Muito Elevado,,,,30,Alentejo,BEJA,0207,17208.72,4595,255,233,206,190,143,333,539,772,1027,26.7,5.97,4.49,3.13
22-07-2021,ELVAS,66,5,320,"[240,480]",Elevado,,,,66,Alentejo,PORTALEGRE,1207,63128.86,20528,1057,1145,902,852,810,1662,2564,3709,4766,32.52,7.55,5.88,4.06
22-07-2021,ENTRONCAMENTO,28,2,132,"[120,240]",Moderado,,,,28,Lisboa e Vale do Tejo,SANTARÉM,1410,1372.81,21558,1066,930,868,695,592,1287,2155,3085,4151,1570.14,302.33,224.69,156.96
22-07-2021,ESPINHO,121,9,411,"[240,480]",Elevado,,,,121,Norte,AVEIRO,0107,2105.68,29516,2205,1993,1430,1177,960,2137,3567,5560,7765,1401.52,368.71,264.01,169.37
22-07-2021,ESPOSENDE,78,6,228,"[120,240]",Moderado,,,,78,Norte,BRAGA,0306,9540.98,34177,1831,1522,1095,894,723,1617,2712,4234,6065,358.21,63.57,44.38,28.42
22-07-2021,ESTARREJA,62,4,237,"[120,240]",Moderado,,,,62,Centro,AVEIRO,0108,10817.33,26006,1503,1399,1106,953,728,1681,2787,4186,5689,240.42,52.59,38.7,25.76
22-07-2021,ESTREMOZ,28,2,222,"[120,240]",Moderado,,,,28,Alentejo,ÉVORA,0704,51379.95,12728,789,613,697,786,877,1663,2360,2973,3762,24.77,7.32,5.79,4.59
22-07-2021,ÉVORA,165,12,314,"[240,480]",Elevado,,,,165,Alentejo,ÉVORA,0705,130707.58,52428,3569,2852,2176,1966,1803,3769,5945,8797,12366,40.11,9.46,6.73,4.55
22-07-2021,FAFE,204,15,425,"[240,480]",Elevado,,,,204,Norte,BRAGA,0307,21908.11,48060,3044,2455,1679,1403,1208,2611,4290,6745,9789,219.37,44.68,30.79,19.58
22-07-2021,FARO,542,39,888,"[480,960]",Muito Elevado,,,,542,Algarve,FARO,0805,20256.79,61015,3847,3364,2604,2055,1601,3656,6260,9624,13471,301.2,66.5,47.51,30.9
22-07-2021,FELGUEIRAS,323,23,572,"[480,960]",Muito Elevado,,,,323,Norte,PORTO,1303,11573.75,56422,2951,2302,1601,1316,973,2289,3890,6192,9143,487.49,79.0,53.5,33.61
22-07-2021,FERREIRA DO ALENTEJO,7,1,90,"[0,120]",Baixo a Moderado,,,,7,Alentejo,BEJA,0208,64820.68,7845,515,414,372,343,345,688,1060,1474,1989,12.1,3.07,2.27,1.64
22-07-2021,FERREIRA DO ZÊZERE,4,0,50,"[0,120]",Baixo a Moderado,,,,4,Lisboa e Vale do Tejo,SANTARÉM,1411,19038.03,7959,470,370,416,465,456,921,1337,1707,2177,41.81,11.44,8.97,7.02
22-07-2021,FIGUEIRA DA FOZ,85,6,144,"[120,240]",Moderado,,,,85,Centro,COIMBRA,0605,37905.26,58747,4032,3597,2887,2495,2043,4538,7425,11022,15054,154.98,39.72,29.08,19.59
22-07-2021,FIGUEIRA DE CASTELO RODRIGO,10,1,179,"[120,240]",Moderado,,,,10,Centro,GUARDA,0904,50857.46,5584,347,352,290,352,391,743,1033,1385,1732,10.98,3.41,2.72,2.03
22-07-2021,FIGUEIRÓ DOS VINHOS,0,0,0,"[0,120]",Baixo a Moderado,,,,0,Centro,LEIRIA,1008,17344.0,5568,402,386,322,309,351,660,982,1368,1770,32.1,10.21,7.89,5.66
22-07-2021,FORNOS DE ALGODRES,2,0,44,"[0,120]",Baixo a Moderado,,,,2,Centro,GUARDA,0905,13145.05,4528,261,218,247,256,232,488,735,953,1214,34.45,9.24,7.25,5.59
22-07-2021,FREIXO DE ESPADA À CINTA,9,1,278,"[240,480]",Elevado,,,,9,Norte,BRAGANÇA,0404,24414.29,3298,211,177,231,196,189,385,616,793,1004,13.51,4.11,3.25,2.52
22-07-2021,FRONTEIRA,3,0,102,"[0,120]",Baixo a Moderado,,,,3,Alentejo,PORTALEGRE,1208,24859.58,2974,213,182,149,156,168,324,473,655,868,11.96,3.49,2.63,1.9
22-07-2021,FUNCHAL,161,12,155,"[120,240]",Moderado,,,,161,Madeira,MADEIRA,3103,7616.2,104024,6382,5086,3643,2821,1990,4811,8454,13540,19922,1365.86,261.58,177.78,111.0
22-07-2021,FUNDÃO,17,1,64,"[0,120]",Baixo a Moderado,,,,17,Centro,CASTELO BRANCO,0504,70019.79,26495,1781,1464,1432,1357,1643,3000,4432,5896,7677,37.84,10.96,8.42,6.33
22-07-2021,GAVIÃO,1,0,31,"[0,120]",Baixo a Moderado,,,,1,Alentejo,PORTALEGRE,1209,29459.45,3263,189,186,222,263,293,556,778,964,1153,11.08,3.91,3.27,2.64
22-07-2021,GÓIS,2,0,53,"[0,120]",Baixo a Moderado,,,,2,Centro,COIMBRA,0606,26330.19,3805,235,199,240,233,244,477,717,916,1151,14.45,4.37,3.48,2.72
22-07-2021,GOLEGÃ,7,1,132,"[120,240]",Moderado,,,,7,Lisboa e Vale do Tejo,SANTARÉM,1412,8431.67,5339,356,299,281,243,255,498,779,1078,1434,63.32,17.01,12.78,9.24
22-07-2021,GONDOMAR,999,71,602,"[480,960]",Muito Elevado,,,,999,Norte,PORTO,1304,13191.76,165985,10555,8755,6222,4450,3364,7814,14036,22791,33346,1258.22,252.77,172.76,106.4
22-07-2021,GOUVEIA,21,2,170,"[120,240]",Moderado,,,,21,Centro,GUARDA,0906,30061.17,12387,871,931,780,783,810,1593,2373,3304,4175,41.21,13.89,10.99,7.89
22-07-2021,GRÂNDOLA,29,2,199,"[120,240]",Moderado,,,,29,Alentejo,SETÚBAL,1505,82593.66,14639,834,834,708,688,672,1360,2068,2902,3736,17.72,4.52,3.51,2.5
22-07-2021,GUARDA,125,9,321,"[240,480]",Elevado,,,,125,Centro,GUARDA,0907,71209.58,38969,2477,2041,1686,1415,1474,2889,4575,6616,9093,54.72,12.77,9.29,6.42
22-07-2021,GUIMARÃES,480,34,315,"[240,480]",Elevado,,,,480,Norte,BRAGA,0308,24099.96,152309,9394,7074,4809,3877,2948,6825,11634,18708,28102,631.99,116.61,77.63,48.27
22-07-2021,HORTA,10,1,69,"[0,120]",Baixo a Moderado,,,,10,Açores,AÇORES,4701,17305.53,14521,818,658,468,352,302,654,1122,1780,2598,83.91,15.01,10.29,6.48
22-07-2021,IDANHA-A-NOVA,2,0,25,"[0,120]",Baixo a Moderado,,,,2,Centro,CASTELO BRANCO,0505,141633.51,8043,518,490,519,672,974,1646,2165,2655,3173,5.68,2.24,1.87,1.53
22-07-2021,ÍLHAVO,112,8,289,"[240,480]",Elevado,,,,112,Centro,AVEIRO,0110,7347.55,38699,2227,1943,1444,1193,850,2043,3487,5430,7657,526.66,104.21,73.9,47.46
22-07-2021,LAGOA (FARO),175,13,769,"[480,960]",Muito Elevado,,,,175,Algarve,FARO,0806,8825.45,22762,1314,1168,919,749,670,1419,2338,3506,4820,257.93,54.62,39.73,26.49
22-07-2021,LAGOA,133,9,902,"[480,960]",Muito Elevado,,,,133,Açores,AÇORES,4201,4559.32,14721,536,458,349,238,235,473,822,1280,1816,322.9,39.83,28.08,18.03
22-07-2021,LAGOS,314,22,1034,"[960,Max]",Extremamente Elevado,,,,314,Algarve,FARO,0807,21299.27,30374,1744,1434,1247,1053,1029,2082,3329,4763,6507,142.61,30.55,22.36,15.63
22-07-2021,LAJES DAS FLORES,4,0,274,"[240,480]",Elevado,,,,4,Açores,AÇORES,4801,7004.79,1463,88,53,62,46,54,100,162,215,303,20.89,4.33,3.07,2.31
22-07-2021,LAJES DO PICO,0,0,0,"[0,120]",Baixo a Moderado,,,,0,Açores,AÇORES,4601,15531.09,4490,304,231,223,159,162,321,544,775,1079,28.91,6.95,4.99,3.5
22-07-2021,LAMEGO,17,1,69,"[0,120]",Baixo a Moderado,,,,17,Norte,VISEU,1805,16542.11,24895,1639,1284,1124,898,783,1681,2805,4089,5728,150.5,34.63,24.72,16.96
22-07-2021,LEIRIA,314,22,251,"[240,480]",Elevado,,,,314,Centro,LEIRIA,1009,56508.83,125267,7389,6366,5090,3902,3159,7061,12151,18517,25906,221.68,45.84,32.77,21.5
22-07-2021,LISBOA,4280,306,840,"[480,960]",Muito Elevado,,,,4280,Lisboa e Vale do Tejo,LISBOA,1106,10005.43,509515,33197,33340,27706,23037,26770,49807,77513,110853,144050,5092.6,1439.78,1107.98,774.74
22-07-2021,LOULÉ,769,55,1120,"[960,Max]",Extremamente Elevado,,,,769,Algarve,FARO,0808,76366.91,68697,3890,3350,2780,2358,2251,4609,7389,10739,14629,89.96,19.16,14.06,9.68
22-07-2021,LOURES,1195,85,559,"[480,960]",Muito Elevado,,,,1195,Lisboa e Vale do Tejo,LISBOA,1107,16723.99,213687,12746,12794,9644,6669,5033,11702,21346,34140,46886,1277.73,280.35,204.14,127.64
22-07-2021,LOURINHÃ,106,8,409,"[240,480]",Elevado,,,,106,Lisboa e Vale do Tejo,LISBOA,1108,14717.2,25855,1584,1243,992,842,645,1487,2479,3722,5306,175.68,36.05,25.29,16.84
22-07-2021,LOUSÃ,9,1,52,"[0,120]",Baixo a Moderado,,,,9,Centro,COIMBRA,0607,13840.01,17158,946,866,658,528,450,978,1636,2502,3448,123.97,24.91,18.08,11.82
22-07-2021,LOUSADA,330,24,706,"[480,960]",Muito Elevado,,,,330,Norte,PORTO,1305,9608.01,46755,2289,1698,1176,853,621,1474,2650,4348,6637,486.63,69.08,45.25,27.58
22-07-2021,MAÇÃO,7,1,113,"[0,120]",Baixo a Moderado,,,,7,Lisboa e Vale do Tejo,SANTARÉM,1413,39997.98,6267,386,362,390,440,657,1097,1487,1849,2235,15.67,5.59,4.62,3.72
22-07-2021,MACEDO DE CAVALEIROS,7,1,49,"[0,120]",Baixo a Moderado,,,,7,Norte,BRAGANÇA,0405,69914.08,14516,1082,889,878,823,938,1761,2639,3528,4610,20.76,6.59,5.05,3.77
22-07-2021,MACHICO,14,1,70,"[0,120]",Baixo a Moderado,,,,14,Madeira,MADEIRA,3104,6825.1,19981,1197,860,662,455,331,786,1448,2308,3505,292.76,51.36,33.82,21.22
22-07-2021,MADALENA,6,0,102,"[0,120]",Baixo a Moderado,,,,6,Açores,AÇORES,4602,14712.33,5895,334,256,173,190,179,369,542,798,1132,40.07,7.69,5.42,3.68
22-07-2021,MAFRA,370,26,436,"[240,480]",Elevado,,,,370,Lisboa e Vale do Tejo,LISBOA,1109,29165.5,84816,3613,3334,2839,2089,1899,3988,6827,10161,13774,290.81,47.23,34.84,23.41
22-07-2021,MAIA,749,54,539,"[480,960]",Muito Elevado,,,,749,Norte,PORTO,1306,8293.94,138971,7801,6617,4512,3339,2631,5970,10482,17099,24900,1675.56,300.22,206.16,126.38
22-07-2021,MANGUALDE,31,2,167,"[120,240]",Moderado,,,,31,Centro,VISEU,1806,21925.56,18510,1198,1128,885,852,743,1595,2480,3608,4806,84.42,21.92,16.46,11.31
22-07-2021,MANTEIGAS,6,0,201,"[120,240]",Moderado,,,,6,Centro,GUARDA,0908,12197.55,3007,258,197,159,167,146,313,472,669,927,24.65,7.6,5.48,3.87
22-07-2021,MARCO DE CANAVESES,154,11,300,"[240,480]",Elevado,,,,154,Norte,PORTO,1307,20188.98,51496,2678,2060,1488,1265,1023,2288,3776,5836,8514,255.07,42.17,28.91,18.7
22-07-2021,MARINHA GRANDE,83,6,216,"[120,240]",Moderado,,,,83,Centro,LEIRIA,1010,18725.19,38508,2365,2302,1638,1359,1058,2417,4055,6357,8722,205.65,46.58,33.95,21.66
22-07-2021,MARVÃO,3,0,102,"[0,120]",Baixo a Moderado,,,,3,Alentejo,PORTALEGRE,1210,15489.9,3005,198,185,142,197,237,434,576,761,959,19.4,6.19,4.91,3.72
22-07-2021,MATOSINHOS,1252,89,714,"[480,960]",Muito Elevado,,,,1252,Norte,PORTO,1308,6241.97,175357,11850,9977,7023,5024,3884,8908,15931,25908,37758,2809.31,604.9,415.06,255.22
22-07-2021,MEALHADA,38,3,190,"[120,240]",Moderado,,,,38,Centro,AVEIRO,0111,11065.66,19914,1163,1039,810,828,831,1659,2469,3508,4671,179.96,42.21,31.7,22.31
22-07-2021,MÊDA,9,1,197,"[120,240]",Moderado,,,,9,Centro,GUARDA,0909,28604.92,4587,343,306,290,288,443,731,1021,1327,1670,16.04,5.84,4.64,3.57
22-07-2021,MELGAÇO,0,0,0,"[0,120]",Baixo a Moderado,,,,0,Norte,VIANA DO CASTELO,1603,23824.58,8093,507,567,578,614,675,1289,1867,2434,2941,33.97,12.34,10.22,7.84
22-07-2021,MÉRTOLA,5,0,83,"[0,120]",Baixo a Moderado,,,,5,Alentejo,BEJA,0209,129287.34,6142,400,390,378,423,600,1023,1401,1791,2191,4.75,1.69,1.39,1.08
22-07-2021,MESÃO FRIO,7,1,178,"[120,240]",Moderado,,,,7,Norte,VILA REAL,1704,2664.87,3964,265,205,168,157,120,277,445,650,915,148.74,34.33,24.39,16.7
22-07-2021,MIRA,29,2,244,"[240,480]",Elevado,,,,29,Centro,COIMBRA,0608,12403.38,11832,727,729,659,550,466,1016,1675,2404,3131,95.4,25.24,19.38,13.5
22-07-2021,MIRANDA DO CORVO,5,0,39,"[0,120]",Baixo a Moderado,,,,5,Centro,COIMBRA,0609,12637.79,12708,706,659,568,498,404,902,1470,2129,2835,100.55,22.43,16.85,11.63
22-07-2021,MIRANDA DO DOURO,23,2,340,"[240,480]",Elevado,,,,23,Norte,BRAGANÇA,0406,48718.31,6830,482,429,442,463,470,933,1375,1804,2286,14.02,4.69,3.7,2.82
22-07-2021,MIRANDELA,91,6,417,"[240,480]",Elevado,,,,91,Norte,BRAGANÇA,0407,65895.67,21754,1640,1315,1204,1078,947,2025,3229,4544,6184,33.01,9.38,6.9,4.9
22-07-2021,MOGADOURO,67,5,797,"[480,960]",Muito Elevado,,,,67,Norte,BRAGANÇA,0408,76064.93,8392,589,529,576,630,655,1285,1861,2390,2979,11.03,3.92,3.14,2.45
22-07-2021,MOIMENTA DA BEIRA,15,1,154,"[120,240]",Moderado,,,,15,Norte,VISEU,1807,21996.9,9736,576,514,471,416,461,877,1348,1862,2438,44.26,11.08,8.46,6.13
22-07-2021,MOITA,464,33,720,"[480,960]",Muito Elevado,,,,464,Lisboa e Vale do Tejo,SETÚBAL,1506,5525.98,64407,4226,3646,2623,1801,1425,3226,5849,9495,13721,1165.53,248.3,171.82,105.85
22-07-2021,MONÇÃO,16,1,90,"[0,120]",Baixo a Moderado,,,,16,Norte,VIANA DO CASTELO,1604,21130.85,17869,1161,1105,1031,1006,972,1978,3009,4114,5275,84.56,24.96,19.47,14.24
22-07-2021,MONCHIQUE,10,1,201,"[120,240]",Moderado,,,,10,Algarve,FARO,0809,39530.43,5077,353,384,321,355,392,747,1068,1452,1805,12.84,4.57,3.67,2.7
22-07-2021,MONDIM DE BASTO,9,1,131,"[120,240]",Moderado,,,,9,Norte,VILA REAL,1705,17207.52,6946,395,300,314,284,283,567,881,1181,1576,40.36,9.16,6.86,5.12
22-07-2021,MONFORTE,2,0,68,"[0,120]",Baixo a Moderado,,,,2,Alentejo,PORTALEGRE,1211,42024.82,2975,139,115,117,192,168,360,477,592,731,7.08,1.74,1.41,1.14
22-07-2021,MONTALEGRE,38,3,417,"[240,480]",Elevado,,,,38,Norte,VILA REAL,1706,80545.71,8997,699,628,595,603,730,1333,1928,2556,3255,11.17,4.04,3.17,2.39
22-07-2021,MONTEMOR-O-NOVO,43,3,272,"[240,480]",Elevado,,,,43,Alentejo,ÉVORA,0706,123296.65,15647,991,953,868,878,971,1849,2717,3670,4661,12.69,3.78,2.98,2.2
22-07-2021,MONTEMOR-O-VELHO,33,2,130,"[120,240]",Moderado,,,,33,Centro,COIMBRA,0610,22896.23,25224,1496,1397,1217,1057,988,2045,3262,4659,6155,110.17,26.88,20.35,14.25
22-07-2021,MONTIJO,260,19,451,"[240,480]",Elevado,,,,260,Lisboa e Vale do Tejo,SETÚBAL,1507,34861.64,57614,2771,2441,1990,1554,1109,2663,4653,7094,9865,165.26,28.3,20.35,13.35
22-07-2021,MORA,5,0,124,"[120,240]",Moderado,,,,5,Alentejo,ÉVORA,0707,44395.02,4138,336,275,252,238,257,495,747,1022,1358,9.32,3.06,2.3,1.68
22-07-2021,MORTÁGUA,7,0,79,"[0,120]",Baixo a Moderado,,,,7,Centro,VISEU,1808,25117.82,8803,638,584,535,499,460,959,1494,2078,2716,35.05,10.81,8.27,5.95
22-07-2021,MOURA,41,3,301,"[240,480]",Elevado,,,,41,Alentejo,BEJA,0210,95845.55,13718,817,656,665,542,461,1003,1668,2324,3141,14.31,3.28,2.42,1.74
22-07-2021,MOURÃO,4,0,164,"[120,240]",Moderado,,,,4,Alentejo,ÉVORA,0708,27862.98,2450,139,108,80,104,109,213,293,401,540,8.79,1.94,1.44,1.05
22-07-2021,MURÇA,4,0,74,"[0,120]",Baixo a Moderado,,,,4,Norte,VILA REAL,1707,18937.11,5463,384,341,307,306,319,625,932,1273,1657,28.85,8.75,6.72,4.92
22-07-2021,MURTOSA,28,2,269,"[240,480]",Elevado,,,,28,Centro,AVEIRO,0112,7308.78,10279,509,473,403,353,409,762,1165,1638,2147,140.63,29.37,22.41,15.94
22-07-2021,NAZARÉ,64,5,449,"[240,480]",Elevado,,,,64,Lisboa e Vale do Tejo,LEIRIA,1011,8243.43,14165,967,903,670,420,396,816,1486,2389,3356,171.84,40.71,28.98,18.03
22-07-2021,NELAS,16,1,123,"[120,240]",Moderado,,,,16,Centro,VISEU,1809,12571.48,12974,924,787,668,604,583,1187,1855,2642,3566,103.21,28.37,21.02,14.76
22-07-2021,NISA,1,0,17,"[0,120]",Baixo a Moderado,,,,1,Alentejo,PORTALEGRE,1212,57567.84,6061,405,389,355,483,478,961,1316,1705,2110,10.53,3.67,2.96,2.29
22-07-2021,NORDESTE,0,0,0,"[0,120]",Baixo a Moderado,,,,0,Açores,AÇORES,4202,10146.8,4862,246,180,124,161,162,323,447,627,873,47.92,8.6,6.18,4.41
22-07-2021,ÓBIDOS,15,1,125,"[120,240]",Moderado,,,,15,Lisboa e Vale do Tejo,LEIRIA,1012,14155.44,11850,743,650,574,452,436,888,1462,2112,2855,83.72,20.17,14.92,10.33
22-07-2021,ODEMIRA,66,5,268,"[240,480]",Elevado,,,,66,Alentejo,BEJA,0211,172060.15,24717,1475,1317,1225,1397,1349,2746,3971,5288,6763,14.37,3.93,3.07,2.31
22-07-2021,ODIVELAS,908,65,561,"[480,960]",Muito Elevado,,,,908,Lisboa e Vale do Tejo,LISBOA,1116,2654.36,161774,9562,9038,6952,4641,3812,8453,15405,24443,34005,6095.48,1281.27,920.99,580.44
22-07-2021,OEIRAS,807,58,455,"[240,480]",Elevado,,,,807,Lisboa e Vale do Tejo,LISBOA,1110,4588.31,177408,11580,11575,8566,6211,5855,12066,20632,32207,43787,3866.78,954.38,701.98,449.69
22-07-2021,OLEIROS,3,0,60,"[0,120]",Baixo a Moderado,,,,3,Centro,CASTELO BRANCO,0506,47109.31,5003,384,341,366,397,487,884,1250,1591,1975,10.62,4.19,3.38,2.65
22-07-2021,OLHÃO,363,26,817,"[480,960]",Muito Elevado,,,,363,Algarve,FARO,0810,13086.38,44405,2455,2309,1689,1342,1268,2610,4299,6608,9063,339.33,69.26,50.5,32.85
22-07-2021,OLIVEIRA DE AZEMÉIS,96,7,146,"[120,240]",Moderado,,,,96,Norte,AVEIRO,0113,16110.41,66011,4155,3614,2794,2183,1738,3921,6715,10329,14484,409.75,89.91,64.12,41.68
22-07-2021,OLIVEIRA DE FRADES,9,1,90,"[0,120]",Baixo a Moderado,,,,9,Centro,VISEU,1810,14534.62,9936,553,475,438,359,415,774,1212,1687,2240,68.36,15.41,11.61,8.34
22-07-2021,OLIVEIRA DO BAIRRO,107,8,441,"[240,480]",Elevado,,,,107,Centro,AVEIRO,0114,8731.99,24277,1327,1182,999,786,810,1596,2595,3777,5104,278.02,58.45,43.25,29.72
22-07-2021,OLIVEIRA DO HOSPITAL,41,3,213,"[120,240]",Moderado,,,,41,Centro,COIMBRA,0611,23451.66,19253,1161,1097,962,924,960,1884,2846,3943,5104,82.1,21.76,16.81,12.14
22-07-2021,OURÉM,83,6,189,"[120,240]",Moderado,,,,83,Lisboa e Vale do Tejo,SANTARÉM,1421,41668.03,44044,2463,2069,1899,1817,1603,3420,5319,7388,9851,105.7,23.64,17.73,12.77
22-07-2021,OURIQUE,5,0,110,"[0,120]",Baixo a Moderado,,,,5,Alentejo,BEJA,0212,66331.36,4607,313,287,284,268,227,495,779,1066,1379,6.95,2.08,1.61,1.17
22-07-2021,OVAR,135,10,248,"[240,480]",Elevado,,,,135,Centro,AVEIRO,0115,14770.25,54260,3294,2709,1994,1636,1234,2870,4864,7573,10867,367.37,73.57,51.27,32.93
22-07-2021,PAÇOS DE FERREIRA,271,19,477,"[240,480]",Elevado,,,,271,Norte,PORTO,1309,7099.29,56728,2903,2193,1518,1135,664,1799,3317,5510,8413,799.1,118.51,77.62,46.72
22-07-2021,PALMELA,204,15,318,"[240,480]",Elevado,,,,204,Lisboa e Vale do Tejo,SETÚBAL,1508,46512.01,64269,3402,3244,2635,1846,1391,3237,5872,9116,12518,138.18,26.91,19.6,12.62
22-07-2021,PAMPILHOSA DA SERRA,7,1,174,"[120,240]",Moderado,,,,7,Centro,COIMBRA,0612,39646.24,4037,238,254,295,339,423,762,1057,1311,1549,10.18,3.91,3.31,2.67
22-07-2021,PAREDES,458,33,532,"[480,960]",Muito Elevado,,,,458,Norte,PORTO,1310,15675.69,86067,4272,3532,2412,1717,1258,2975,5387,8919,13191,549.04,84.15,56.9,34.36
22-07-2021,PAREDES DE COURA,21,2,248,"[240,480]",Elevado,,,,21,Norte,VIANA DO CASTELO,1605,13818.59,8535,466,528,407,465,515,980,1387,1915,2381,61.76,17.23,13.86,10.04
22-07-2021,PEDRÓGÃO GRANDE,33,2,966,"[960,Max]",Extremamente Elevado,,,,33,Centro,LEIRIA,1013,12874.75,3410,175,173,196,221,252,473,669,842,1017,26.49,7.9,6.54,5.2
22-07-2021,PENACOVA,16,1,117,"[0,120]",Baixo a Moderado,,,,16,Centro,COIMBRA,0613,21673.23,13694,968,923,745,621,703,1324,2069,2992,3960,63.18,18.27,13.81,9.55
22-07-2021,PENAFIEL,232,17,333,"[240,480]",Elevado,,,,232,Norte,PORTO,1311,21224.27,69772,3648,2823,2032,1663,1230,2893,4925,7748,11396,328.74,53.69,36.51,23.2
22-07-2021,PENALVA DO CASTELO,5,0,70,"[0,120]",Baixo a Moderado,,,,5,Centro,VISEU,1811,13433.92,7115,449,457,413,391,426,817,1230,1687,2136,52.96,15.9,12.56,9.16
22-07-2021,PENAMACOR,4,0,85,"[0,120]",Baixo a Moderado,,,,4,Centro,CASTELO BRANCO,0507,56370.69,4755,262,248,273,451,633,1084,1357,1605,1867,8.44,3.31,2.85,2.41
22-07-2021,PENEDONO,5,0,194,"[120,240]",Moderado,,,,5,Norte,VISEU,1812,13370.75,2591,172,113,129,156,138,294,423,536,708,19.38,5.3,4.01,3.16
22-07-2021,PENELA,5,0,93,"[0,120]",Baixo a Moderado,,,,5,Centro,COIMBRA,0614,13480.0,5397,314,324,274,359,344,703,977,1301,1615,40.04,11.98,9.65,7.25
22-07-2021,PENICHE,96,7,363,"[240,480]",Elevado,,,,96,Lisboa e Vale do Tejo,LEIRIA,1014,7754.98,26501,1746,1504,1203,926,707,1633,2836,4340,6086,341.73,78.48,55.96,36.57
22-07-2021,PESO DA RÉGUA,35,3,223,"[120,240]",Moderado,,,,35,Norte,VILA REAL,1708,9486.01,15773,1076,843,650,659,455,1114,1764,2607,3683,166.28,38.83,27.48,18.6
22-07-2021,PINHEL,3,0,36,"[0,120]",Baixo a Moderado,,,,3,Centro,GUARDA,0910,48452.12,8511,577,566,551,538,689,1227,1778,2344,2921,17.57,6.03,4.84,3.67
22-07-2021,POMBAL,62,4,120,"[120,240]",Moderado,,,,62,Centro,LEIRIA,1015,62600.28,51461,3187,2791,2494,2328,2027,4355,6849,9640,12827,82.21,20.49,15.4,10.94
22-07-2021,PONTA DELGADA,195,14,287,"[240,480]",Elevado,,,,195,Açores,AÇORES,4203,23298.65,67935,3108,2435,1726,1133,902,2035,3761,6196,9304,291.58,39.93,26.59,16.14
22-07-2021,PONTA DO SOL,4,0,47,"[0,120]",Baixo a Moderado,,,,4,Madeira,MADEIRA,3105,4622.03,8593,319,283,347,208,221,429,776,1059,1378,185.92,29.81,22.91,16.79
22-07-2021,PONTE DA BARCA,8,1,72,"[0,120]",Baixo a Moderado,,,,8,Norte,VIANA DO CASTELO,1606,18211.37,11180,635,576,517,554,490,1044,1561,2137,2772,61.39,15.22,11.73,8.57
22-07-2021,PONTE DE LIMA,74,5,178,"[120,240]",Moderado,,,,74,Norte,VIANA DO CASTELO,1607,32025.46,41315,2321,2022,1720,1596,1462,3058,4778,6800,9121,129.01,28.48,21.23,14.92
22-07-2021,PONTE DE SOR,28,2,189,"[120,240]",Moderado,,,,28,Alentejo,PORTALEGRE,1213,83971.16,14994,939,800,716,739,831,1570,2286,3086,4025,17.86,4.79,3.68,2.72
22-07-2021,PORTALEGRE,27,2,123,"[120,240]",Moderado,,,,27,Alentejo,PORTALEGRE,1214,44713.64,22172,1577,1351,1137,993,984,1977,3114,4465,6042,49.59,13.51,9.99,6.96
22-07-2021,PORTEL,3,0,52,"[0,120]",Baixo a Moderado,,,,3,Alentejo,ÉVORA,0709,60100.57,5828,336,358,283,331,305,636,919,1277,1613,9.7,2.68,2.12,1.53
22-07-2021,PORTIMÃO,631,45,1137,"[960,Max]",Extremamente Elevado,,,,631,Algarve,FARO,0811,18206.29,55483,3182,2927,2116,1582,1400,2982,5098,8025,11207,304.75,61.56,44.08,28.0
22-07-2021,PORTO,1887,135,871,"[480,960]",Muito Elevado,,,,1887,Norte,PORTO,1312,4142.02,216606,15790,15193,11280,9409,10044,19453,30733,45926,61716,5229.5,1490.0,1108.79,741.98
22-07-2021,PORTO DE MÓS,43,3,184,"[120,240]",Moderado,,,,43,Centro,LEIRIA,1016,26183.41,23275,1355,1210,1034,888,872,1760,2794,4004,5359,88.89,20.47,15.29,10.67
22-07-2021,PORTO MONIZ,7,1,303,"[240,480]",Elevado,,,,7,Madeira,MADEIRA,3106,8293.38,2342,143,130,95,98,120,218,313,443,586,28.24,7.07,5.34,3.77
22-07-2021,PORTO SANTO,5,0,96,"[0,120]",Baixo a Moderado,,,,5,Madeira,MADEIRA,3201,4300.7,5202,240,157,134,110,68,178,312,469,709,120.95,16.48,10.9,7.25
22-07-2021,PÓVOA DE LANHOSO,60,4,279,"[240,480]",Elevado,,,,60,Norte,BRAGA,0309,13465.29,21499,1175,909,732,673,624,1297,2029,2938,4113,159.67,30.55,21.82,15.07
22-07-2021,PÓVOA DE VARZIM,259,19,413,"[240,480]",Elevado,,,,259,Norte,PORTO,1313,8220.59,62784,3712,3120,2134,1594,1305,2899,5033,8153,11865,763.7,144.33,99.17,61.22
22-07-2021,POVOAÇÃO,3,0,51,"[0,120]",Baixo a Moderado,,,,3,Açores,AÇORES,4204,10640.77,5927,293,212,191,144,134,278,469,681,974,55.7,9.15,6.4,4.41
22-07-2021,VILA DA PRAIA DA VITÓRIA,66,5,311,"[240,480]",Elevado,,,,66,Açores,AÇORES,4302,16127.06,21317,1133,789,619,436,336,772,1391,2180,3313,132.18,20.54,13.52,8.63
22-07-2021,PROENÇA-A-NOVA,16,1,221,"[120,240]",Moderado,,,,16,Centro,CASTELO BRANCO,0508,39539.96,7298,508,465,389,400,560,960,1349,1814,2322,18.46,5.87,4.59,3.41
22-07-2021,REDONDO,5,0,80,"[0,120]",Baixo a Moderado,,,,5,Alentejo,ÉVORA,0710,36950.87,6353,349,325,288,288,354,642,930,1255,1604,17.19,4.34,3.4,2.52
22-07-2021,REGUENGOS DE MONSARAZ,12,1,121,"[120,240]",Moderado,,,,12,Alentejo,ÉVORA,0711,46399.72,10015,602,511,455,462,473,935,1390,1901,2503,21.58,5.39,4.1,3.0
22-07-2021,RESENDE,27,2,269,"[240,480]",Elevado,,,,27,Norte,VISEU,1813,12334.93,10137,560,493,448,433,422,855,1303,1796,2356,82.18,19.1,14.56,10.56
22-07-2021,RIBEIRA BRAVA,28,2,227,"[120,240]",Moderado,,,,28,Madeira,MADEIRA,3107,6544.88,12435,648,500,411,311,287,598,1009,1509,2157,189.99,32.96,23.06,15.42
22-07-2021,RIBEIRA DE PENA,7,1,117,"[0,120]",Baixo a Moderado,,,,7,Norte,VILA REAL,1709,21745.98,6016,371,301,290,310,368,678,968,1269,1640,27.66,7.54,5.84,4.45
22-07-2021,RIBEIRA GRANDE,64,5,195,"[120,240]",Moderado,,,,64,Açores,AÇORES,4205,18015.13,32811,1163,689,512,345,253,598,1110,1799,2962,182.13,16.44,9.99,6.16
22-07-2021,RIO MAIOR,67,5,330,"[240,480]",Elevado,,,,67,Lisboa e Vale do Tejo,SANTARÉM,1414,27276.45,20379,1251,1144,941,795,648,1443,2384,3528,4779,74.71,17.52,12.93,8.74
22-07-2021,SABROSA,7,1,119,"[0,120]",Baixo a Moderado,,,,7,Norte,VILA REAL,1710,15692.45,5918,393,314,304,302,350,652,956,1270,1663,37.71,10.6,8.09,6.09
22-07-2021,SABUGAL,4,0,38,"[0,120]",Baixo a Moderado,,,,4,Centro,GUARDA,0911,82269.82,10585,724,707,694,796,1009,1805,2499,3206,3930,12.87,4.78,3.9,3.04
22-07-2021,SALVATERRA DE MAGOS,57,4,269,"[240,480]",Elevado,,,,57,Lisboa e Vale do Tejo,SANTARÉM,1415,24393.2,21295,1275,1181,1060,799,772,1571,2631,3812,5087,87.3,20.85,15.63,10.79
22-07-2021,SANTA COMBA DÃO,18,1,172,"[120,240]",Moderado,,,,18,Centro,VISEU,1814,11194.77,10452,732,684,569,538,464,1002,1571,2255,2987,93.36,26.68,20.14,14.03
22-07-2021,SANTA CRUZ,59,4,131,"[120,240]",Moderado,,,,59,Madeira,MADEIRA,3108,8150.28,45281,1817,1301,974,716,523,1239,2213,3514,5331,555.6,65.41,43.12,27.15
22-07-2021,SANTA CRUZ DA GRACIOSA,5,0,120,"[120,240]",Moderado,,,,5,Açores,AÇORES,4401,6065.78,4208,228,180,163,124,145,269,432,612,840,69.37,13.85,10.09,7.12
22-07-2021,SANTA CRUZ DAS FLORES,0,0,0,"[0,120]",Baixo a Moderado,,,,0,Açores,AÇORES,4802,7091.44,2165,125,98,74,56,51,107,181,279,404,30.53,5.7,3.93,2.55
22-07-2021,SANTA MARIA DA FEIRA,299,21,216,"[120,240]",Moderado,,,,299,Norte,AVEIRO,0109,21587.65,138636,8182,6743,4771,3856,3079,6935,11706,18449,26631,642.19,123.36,85.46,54.22
22-07-2021,SANTA MARTA DE PENAGUIÃO,15,1,229,"[120,240]",Moderado,,,,15,Norte,VILA REAL,1711,6928.13,6599,483,373,337,316,317,633,970,1343,1826,95.25,26.36,19.39,14.0
22-07-2021,SANTANA,7,1,105,"[0,120]",Baixo a Moderado,,,,7,Madeira,MADEIRA,3109,9547.3,6711,418,353,343,282,277,559,902,1255,1673,70.29,17.52,13.15,9.45
22-07-2021,SANTARÉM,111,8,193,"[120,240]",Moderado,,,,111,Lisboa e Vale do Tejo,SANTARÉM,1416,55253.58,57421,3654,3441,2760,2466,2206,4672,7432,10873,14527,103.92,26.29,19.68,13.45
22-07-2021,SANTIAGO DO CACÉM,92,7,321,"[240,480]",Elevado,,,,92,Alentejo,SETÚBAL,1509,105969.29,28791,2144,1689,1472,1295,1215,2510,3982,5671,7815,27.17,7.37,5.35,3.76
22-07-2021,SANTO TIRSO,374,27,549,"[480,960]",Muito Elevado,,,,374,Norte,PORTO,1314,13655.52,68055,4911,3935,2761,2257,1810,4067,6828,10763,15674,498.35,114.78,78.82,50.0
22-07-2021,SÃO BRÁS DE ALPORTEL,102,7,983,"[960,Max]",Extremamente Elevado,,,,102,Algarve,FARO,0812,15336.92,10416,596,468,467,404,401,805,1272,1740,2336,67.91,15.23,11.35,8.29
22-07-2021,SÃO JOÃO DA MADEIRA,43,3,195,"[120,240]",Moderado,,,,43,Norte,AVEIRO,0116,794.3,21958,1347,1069,796,601,593,1194,1990,3059,4406,2765.49,554.91,385.26,250.63
22-07-2021,SÃO JOÃO DA PESQUEIRA,24,2,340,"[240,480]",Elevado,,,,24,Norte,VISEU,1815,26610.85,7125,417,330,294,328,328,656,950,1280,1697,26.77,6.38,4.81,3.57
22-07-2021,SÃO PEDRO DO SUL,8,1,52,"[0,120]",Baixo a Moderado,,,,8,Centro,VISEU,1816,34895.09,15403,990,962,861,759,909,1668,2529,3491,4481,44.14,12.84,10.0,7.25
22-07-2021,SÃO ROQUE DO PICO,1,0,31,"[0,120]",Baixo a Moderado,,,,1,Açores,AÇORES,4603,14236.1,3266,199,141,93,96,113,209,302,443,642,22.94,4.51,3.11,2.12
22-07-2021,SÃO VICENTE,2,0,39,"[0,120]",Baixo a Moderado,,,,2,Madeira,MADEIRA,3110,7883.71,5143,272,264,266,225,280,505,771,1035,1307,65.23,16.58,13.13,9.78
22-07-2021,SARDOAL,0,0,0,"[0,120]",Baixo a Moderado,,,,0,Lisboa e Vale do Tejo,SANTARÉM,1417,9214.72,3741,227,178,148,165,248,413,561,739,966,40.6,10.48,8.02,6.09
22-07-2021,SÁTÃO,12,1,103,"[0,120]",Baixo a Moderado,,,,12,Centro,VISEU,1817,20194.11,11580,765,671,515,465,476,941,1456,2127,2892,57.34,14.32,10.53,7.21
22-07-2021,SEIA,16,1,72,"[0,120]",Baixo a Moderado,,,,16,Centro,GUARDA,0912,43568.83,22234,1807,1589,1238,1122,721,1843,3081,4670,6477,51.03,14.87,10.72,7.07
22-07-2021,SEIXAL,693,49,413,"[240,480]",Elevado,,,,693,Lisboa e Vale do Tejo,SETÚBAL,1510,9545.17,167752,10586,9270,6661,4391,2930,7321,13982,23252,33838,1757.49,354.51,243.6,146.49
22-07-2021,SERNANCELHE,3,0,56,"[0,120]",Baixo a Moderado,,,,3,Norte,VISEU,1818,22861.22,5396,305,293,286,273,260,533,819,1112,1417,23.6,6.2,4.86,3.58
22-07-2021,SERPA,55,4,388,"[240,480]",Elevado,,,,55,Alentejo,BEJA,0213,110563.34,14304,903,761,719,697,626,1323,2042,2803,3706,12.94,3.35,2.54,1.85
22-07-2021,SERTÃ,34,2,233,"[120,240]",Moderado,,,,34,Centro,CASTELO BRANCO,0509,44673.17,14577,870,779,790,767,1020,1787,2577,3356,4226,32.63,9.46,7.51,5.77
22-07-2021,SESIMBRA,256,18,493,"[480,960]",Muito Elevado,,,,256,Lisboa e Vale do Tejo,SETÚBAL,1511,19571.75,51858,2400,2321,1853,1257,1083,2340,4193,6514,8914,264.96,45.54,33.28,21.42
22-07-2021,SETÚBAL,412,29,358,"[240,480]",Elevado,,,,412,Lisboa e Vale do Tejo,SETÚBAL,1512,23032.5,115126,7425,6929,5075,3775,2655,6430,11505,18434,25859,499.83,112.27,80.03,49.95
22-07-2021,SEVER DO VOUGA,14,1,124,"[120,240]",Moderado,,,,14,Centro,AVEIRO,0117,12987.56,11331,766,637,568,540,567,1107,1675,2312,3078,87.24,23.7,17.8,12.9
22-07-2021,SILVES,195,14,538,"[480,960]",Muito Elevado,,,,195,Algarve,FARO,0813,68006.23,36226,2137,1869,1610,1423,1600,3023,4633,6502,8639,53.27,12.7,9.56,6.81
22-07-2021,SINES,183,13,1335,"[960,Max]",Extremamente Elevado,,,,183,Alentejo,SETÚBAL,1513,20330.17,13715,888,791,551,416,268,684,1235,2026,2914,67.46,14.33,9.97,6.07
22-07-2021,SINTRA,1930,138,493,"[480,960]",Muito Elevado,,,,1930,Lisboa e Vale do Tejo,LISBOA,1111,31922.73,391402,20490,18316,13545,9137,7284,16421,29966,48282,68772,1226.08,215.43,151.25,93.87
22-07-2021,SOBRAL DE MONTE AGRAÇO,67,5,628,"[480,960]",Muito Elevado,,,,67,Lisboa e Vale do Tejo,LISBOA,1112,5210.32,10651,564,507,352,272,212,484,836,1343,1907,204.43,36.6,25.78,16.05
22-07-2021,SOURE,18,1,106,"[0,120]",Baixo a Moderado,,,,18,Centro,COIMBRA,0615,26506.07,17120,1173,1142,1004,883,987,1870,2874,4016,5189,64.59,19.58,15.15,10.84
22-07-2021,SOUSEL,2,0,46,"[0,120]",Baixo a Moderado,,,,2,Alentejo,PORTALEGRE,1215,27932.18,4412,261,274,208,302,292,594,802,1076,1337,15.8,4.79,3.85,2.87
22-07-2021,TÁBUA,9,1,79,"[0,120]",Baixo a Moderado,,,,9,Centro,COIMBRA,0616,19978.58,11368,729,584,524,430,464,894,1418,2002,2731,56.9,13.67,10.02,7.1
22-07-2021,TABUAÇO,3,0,50,"[0,120]",Baixo a Moderado,,,,3,Norte,VISEU,1819,13385.67,6033,372,314,217,282,363,645,862,1176,1548,45.07,11.56,8.79,6.44
22-07-2021,TAROUCA,14,1,179,"[120,240]",Moderado,,,,14,Norte,VISEU,1820,10008.49,7804,405,335,313,277,324,601,914,1249,1654,77.98,16.53,12.48,9.13
22-07-2021,TAVIRA,81,6,329,"[240,480]",Elevado,,,,81,Algarve,FARO,0814,60696.7,24530,1493,1415,1252,1066,1277,2343,3595,5010,6503,40.41,10.71,8.25,5.92
22-07-2021,TERRAS DE BOURO,12,1,190,"[120,240]",Moderado,,,,12,Norte,BRAGA,0310,27746.07,6361,391,372,296,319,340,659,955,1327,1718,22.93,6.19,4.78,3.44
22-07-2021,TOMAR,47,3,128,"[120,240]",Moderado,,,,47,Lisboa e Vale do Tejo,SANTARÉM,1418,35120.44,36748,2403,2189,1868,1853,1822,3675,5543,7732,10135,104.64,28.86,22.02,15.78
22-07-2021,TONDELA,61,4,231,"[120,240]",Moderado,,,,61,Centro,VISEU,1821,37121.73,26357,1768,1722,1518,1475,1417,2892,4410,6132,7900,71.0,21.28,16.52,11.88
22-07-2021,TORRE DE MONCORVO,1,0,13,"[0,120]",Baixo a Moderado,,,,1,Norte,BRAGANÇA,0409,53155.67,7695,556,478,488,551,719,1270,1758,2236,2792,14.48,5.25,4.21,3.31
22-07-2021,TORRES NOVAS,51,4,145,"[120,240]",Moderado,,,,51,Lisboa e Vale do Tejo,SANTARÉM,1419,26999.68,34933,2324,1979,1738,1406,1475,2881,4619,6598,8922,129.38,33.04,24.44,17.11
22-07-2021,TORRES VEDRAS,163,12,208,"[120,240]",Moderado,,,,163,Lisboa e Vale do Tejo,LISBOA,1113,40714.89,78530,4513,3945,3447,2628,2104,4732,8179,12124,16637,192.88,40.86,29.78,20.09
22-07-2021,TRANCOSO,14,1,157,"[120,240]",Moderado,,,,14,Centro,GUARDA,0913,36152.47,8875,581,557,542,586,496,1082,1624,2181,2762,24.55,7.64,6.03,4.49
22-07-2021,TROFA,134,10,348,"[240,480]",Elevado,,,,134,Norte,PORTO,1318,7201.76,38418,2336,1894,1231,939,684,1623,2854,4748,7084,533.44,98.36,65.93,39.63
22-07-2021,VAGOS,66,5,292,"[240,480]",Elevado,,,,66,Centro,AVEIRO,0118,16491.5,22740,1320,1205,922,784,724,1508,2430,3635,4955,137.89,30.04,22.04,14.73
22-07-2021,VALE DE CAMBRA,29,2,137,"[120,240]",Moderado,,,,29,Norte,AVEIRO,0119,14733.47,21327,1491,1363,1005,831,798,1629,2634,3997,5488,144.76,37.25,27.13,17.88
22-07-2021,VALENÇA,12,1,91,"[0,120]",Baixo a Moderado,,,,12,Norte,VIANA DO CASTELO,1608,11712.86,13290,867,791,582,582,503,1085,1667,2458,3325,113.46,28.39,20.99,14.23
22-07-2021,VALONGO,514,37,527,"[480,960]",Muito Elevado,,,,514,Norte,PORTO,1315,7512.45,97444,5629,4696,3207,2462,1829,4291,7498,12194,17823,1297.18,237.26,162.33,99.81
22-07-2021,VALPAÇOS,36,3,246,"[240,480]",Elevado,,,,36,Norte,VILA REAL,1712,54873.93,14818,1217,1118,999,928,997,1925,2924,4042,5259,27.0,9.58,7.37,5.33
22-07-2021,VELAS,3,0,59,"[0,120]",Baixo a Moderado,,,,3,Açores,AÇORES,4502,11738.38,5093,278,208,166,153,113,266,432,640,918,43.39,7.82,5.45,3.68
22-07-2021,VENDAS NOVAS,25,2,223,"[120,240]",Moderado,,,,25,Alentejo,ÉVORA,0712,22238.88,11255,677,768,655,501,532,1033,1688,2456,3133,50.61,14.09,11.04,7.59
22-07-2021,VIANA DO ALENTEJO,7,1,137,"[120,240]",Moderado,,,,7,Alentejo,ÉVORA,0713,39367.29,5145,245,208,235,210,214,424,659,867,1112,13.07,2.82,2.2,1.67
22-07-2021,VIANA DO CASTELO,162,12,192,"[120,240]",Moderado,,,,162,Norte,VIANA DO CASTELO,1609,31902.01,84417,5470,4433,3591,3061,2982,6043,9634,14067,19537,264.61,61.24,44.09,30.2
22-07-2021,VIDIGUEIRA,6,0,110,"[0,120]",Baixo a Moderado,,,,6,Alentejo,BEJA,0214,31661.09,5510,300,248,215,233,275,508,723,971,1271,17.4,4.01,3.07,2.28
22-07-2021,VIEIRA DO MINHO,22,2,187,"[120,240]",Moderado,,,,22,Norte,BRAGA,0311,21644.35,11842,703,594,525,548,482,1030,1555,2149,2852,54.71,13.18,9.93,7.18
22-07-2021,VILA DE REI,5,0,150,"[120,240]",Moderado,,,,5,Centro,CASTELO BRANCO,0510,19154.6,3323,169,128,172,247,302,549,721,849,1018,17.35,5.31,4.43,3.76
22-07-2021,VILA DO BISPO,31,2,602,"[480,960]",Muito Elevado,,,,31,Algarve,FARO,0815,17906.06,5154,302,302,314,232,233,465,779,1081,1383,28.78,7.72,6.04,4.35
22-07-2021,VILA DO CONDE,332,24,416,"[240,480]",Elevado,,,,332,Norte,PORTO,1316,14902.77,79899,4726,3875,2819,2070,1743,3813,6632,10507,15233,536.13,102.21,70.5,44.5
22-07-2021,VILA DO PORTO,1,0,18,"[0,120]",Baixo a Moderado,,,,1,Açores,AÇORES,4101,9688.74,5616,274,212,135,96,123,219,354,566,840,57.96,8.67,5.84,3.65
22-07-2021,VILA FLOR,14,1,233,"[120,240]",Moderado,,,,14,Norte,BRAGANÇA,0410,26581.14,6044,429,362,422,294,331,625,1047,1409,1838,22.74,6.91,5.3,3.94
22-07-2021,VILA FRANCA DE XIRA,865,62,609,"[480,960]",Muito Elevado,,,,865,Lisboa e Vale do Tejo,LISBOA,1114,31819.39,141957,8501,6852,4869,3425,2472,5897,10766,17618,26119,446.14,82.09,55.37,33.84
22-07-2021,VILA FRANCA DO CAMPO,18,1,164,"[120,240]",Moderado,,,,18,Açores,AÇORES,4206,7796.82,11051,450,344,248,217,154,371,619,963,1413,141.73,18.12,12.35,7.94
22-07-2021,VILA NOVA DA BARQUINHA,7,0,93,"[0,120]",Baixo a Moderado,,,,7,Lisboa e Vale do Tejo,SANTARÉM,1420,4952.97,7461,415,406,392,364,338,702,1094,1500,1915,150.64,38.66,30.28,22.09
22-07-2021,VILA NOVA DE CERVEIRA,14,1,157,"[120,240]",Moderado,,,,14,Norte,VIANA DO CASTELO,1610,10846.66,8910,531,444,410,384,334,718,1128,1572,2103,82.14,19.39,14.49,10.4
22-07-2021,VILA NOVA DE FAMALICÃO,504,36,383,"[240,480]",Elevado,,,,504,Norte,BRAGA,0312,20159.26,131676,7817,6164,4202,3282,2749,6031,10233,16397,24214,653.19,120.12,81.34,50.76
22-07-2021,VILA NOVA DE FOZ CÔA,4,0,62,"[0,120]",Baixo a Moderado,,,,4,Centro,GUARDA,0914,39815.18,6503,442,385,390,398,429,827,1217,1602,2044,16.33,5.13,4.02,3.06
22-07-2021,VILA NOVA DE GAIA,1794,128,597,"[480,960]",Muito Elevado,,,,1794,Norte,PORTO,1317,16846.43,300472,18349,15568,10972,8224,6281,14505,25477,41045,59394,1783.64,352.57,243.65,151.23
22-07-2021,VILA NOVA DE PAIVA,10,1,213,"[120,240]",Moderado,,,,10,Centro,VISEU,1822,17553.28,4687,289,272,233,217,241,458,691,963,1252,26.7,7.13,5.49,3.94
22-07-2021,VILA NOVA DE POIARES,3,0,43,"[0,120]",Baixo a Moderado,,,,3,Centro,COIMBRA,0617,8445.3,6939,380,284,262,235,182,417,679,963,1343,82.17,15.9,11.4,8.04
22-07-2021,VILA POUCA DE AGUIAR,29,2,245,"[240,480]",Elevado,,,,29,Norte,VILA REAL,1713,43706.62,11961,860,817,733,601,627,1228,1961,2778,3638,27.37,8.32,6.36,4.49
22-07-2021,VILA REAL,248,18,497,"[480,960]",Muito Elevado,,,,248,Norte,VILA REAL,1714,37880.28,49962,3025,2498,2065,1579,1466,3045,5110,7608,10633,131.9,28.07,20.08,13.49
22-07-2021,VILA REAL DE SANTO ANTÓNIO,88,6,472,"[240,480]",Elevado,,,,88,Algarve,FARO,0816,6125.0,18749,1172,1069,811,569,586,1155,1966,3035,4207,306.11,68.69,49.55,32.1
22-07-2021,VILA VELHA DE RÓDÃO,0,0,0,"[0,120]",Baixo a Moderado,,,,0,Centro,CASTELO BRANCO,0511,32991.16,3144,209,229,180,283,306,589,769,998,1207,9.53,3.66,3.03,2.33
22-07-2021,VILA VERDE,81,6,173,"[120,240]",Moderado,,,,81,Norte,BRAGA,0313,22866.52,46911,2365,2063,1667,1494,1437,2931,4598,6661,9026,205.15,39.47,29.13,20.11
22-07-2021,VILA VIÇOSA,26,2,344,"[240,480]",Elevado,,,,26,Alentejo,ÉVORA,0714,19485.89,7656,487,379,342,345,324,669,1011,1390,1877,39.29,9.63,7.13,5.19
22-07-2021,VIMIOSO,3,0,76,"[0,120]",Baixo a Moderado,,,,3,Norte,BRAGANÇA,0411,48158.51,4023,274,230,261,293,335,628,889,1119,1393,8.35,2.89,2.32,1.85
22-07-2021,VINHAIS,14,1,184,"[120,240]",Moderado,,,,14,Norte,BRAGANÇA,0412,69475.09,7746,599,577,636,641,815,1456,2092,2669,3268,11.15,4.7,3.84,3.01
22-07-2021,VISEU,492,35,506,"[480,960]",Muito Elevado,,,,492,Centro,VISEU,1823,50710.14,97249,5769,5038,4140,3158,2710,5868,10008,15046,20815,191.77,41.05,29.67,19.74
22-07-2021,VIZELA,52,4,218,"[120,240]",Moderado,,,,52,Norte,BRAGA,0314,2469.83,23897,1258,928,655,509,371,880,1535,2463,3721,967.49,150.65,99.72,62.15
22-07-2021,VOUZELA,11,1,114,"[0,120]",Baixo a Moderado,,,,11,Centro,VISEU,1824,19369.46,9619,626,605,554,532,507,1039,1593,2198,2824,49.66,14.58,11.35,8.22
29-07-2021,ABRANTES,43,3,123,"[120,240]",Moderado,,,,43,Lisboa e Vale do Tejo,SANTARÉM,1401,71469.08,35130,2473,2213,1730,1748,2021,3769,5499,7712,10185,49.15,14.25,10.79,7.69
29-07-2021,ÁGUEDA,193,14,419,"[240,480]",Elevado,,,,193,Centro,AVEIRO,0101,33527.44,46075,3237,2713,2090,1635,1496,3131,5221,7934,11171,137.43,33.32,23.66,15.57
29-07-2021,AGUIAR DA BEIRA,3,0,65,"[0,120]",Baixo a Moderado,,,,3,Centro,GUARDA,0901,20676.57,4652,304,281,235,239,148,387,622,903,1207,22.5,5.84,4.37,3.01
29-07-2021,ALANDROAL,9,1,184,"[120,240]",Moderado,,,,9,Alentejo,ÉVORA,0701,54267.81,4992,307,256,296,299,377,676,972,1228,1535,9.2,2.83,2.26,1.79
29-07-2021,ALBERGARIA-A-VELHA,79,6,329,"[240,480]",Elevado,,,,79,Centro,AVEIRO,0102,15882.5,24144,1550,1298,996,687,680,1367,2363,3661,5211,152.02,32.81,23.05,14.88
29-07-2021,ALBUFEIRA,457,33,1100,"[960,Max]",Extremamente Elevado,,,,457,Algarve,FARO,0801,14066.42,41528,2067,1717,1425,985,858,1843,3268,4985,7052,295.24,50.14,35.44,23.23
29-07-2021,ALCÁCER DO SAL,7,1,61,"[0,120]",Baixo a Moderado,,,,7,Alentejo,SETÚBAL,1501,149987.3,11659,884,814,623,623,602,1225,1848,2662,3546,7.77,2.36,1.77,1.23
29-07-2021,ALCANENA,28,2,218,"[120,240]",Moderado,,,,28,Lisboa e Vale do Tejo,SANTARÉM,1402,12732.86,12809,891,744,628,536,588,1124,1752,2496,3387,100.6,26.6,19.6,13.76
29-07-2021,ALCOBAÇA,117,8,218,"[120,240]",Moderado,,,,117,Lisboa e Vale do Tejo,LEIRIA,1001,40814.09,53555,3420,2927,2466,2059,1676,3735,6201,9128,12548,131.22,30.74,22.36,15.19
29-07-2021,ALCOCHETE,42,3,211,"[120,240]",Moderado,,,,42,Lisboa e Vale do Tejo,SETÚBAL,1502,12836.48,19787,857,834,691,476,447,923,1614,2448,3305,154.15,25.75,19.07,12.57
29-07-2021,ALCOUTIM,8,1,385,"[240,480]",Elevado,,,,8,Algarve,FARO,0802,57536.33,2159,191,188,163,190,267,457,620,808,999,3.75,1.74,1.4,1.08
29-07-2021,ALENQUER,159,11,362,"[240,480]",Elevado,,,,159,Lisboa e Vale do Tejo,LISBOA,1101,30421.92,44052,2298,2062,1629,1330,1155,2485,4114,6176,8474,144.8,27.85,20.3,13.52
29-07-2021,ALFÂNDEGA DA FÉ,4,0,89,"[0,120]",Baixo a Moderado,,,,4,Norte,BRAGANÇA,0401,32194.64,4550,325,277,301,274,325,599,900,1177,1502,14.13,4.67,3.66,2.8
29-07-2021,ALIJÓ,12,1,114,"[0,120]",Baixo a Moderado,,,,12,Norte,VILA REAL,1701,29759.89,10625,766,687,635,542,666,1208,1843,2530,3296,35.7,11.08,8.5,6.19
29-07-2021,ALJEZUR,26,2,464,"[240,480]",Elevado,,,,26,Algarve,FARO,0803,32349.95,5594,316,336,335,320,410,730,1065,1401,1717,17.29,5.31,4.33,3.29
29-07-2021,ALJUSTREL,27,2,332,"[240,480]",Elevado,,,,27,Alentejo,BEJA,0201,45847.41,8247,635,521,443,347,358,705,1148,1669,2304,17.99,5.03,3.64,2.5
29-07-2021,ALMADA,832,59,492,"[480,960]",Muito Elevado,,,,832,Lisboa e Vale do Tejo,SETÚBAL,1503,7000.89,169039,10469,9777,7876,6144,5111,11255,19131,28908,39377,2414.5,562.45,412.91,273.26
29-07-2021,ALMEIDA,4,0,69,"[0,120]",Baixo a Moderado,,,,4,Centro,GUARDA,0902,51798.46,5830,441,419,396,458,393,851,1247,1666,2107,11.26,4.07,3.22,2.41
29-07-2021,ALMEIRIM,43,3,192,"[120,240]",Moderado,,,,43,Lisboa e Vale do Tejo,SANTARÉM,1403,22212.05,22546,1342,1353,1106,866,843,1709,2815,4168,5510,101.5,24.81,18.76,12.67
29-07-2021,ALMODÔVAR,24,2,360,"[240,480]",Elevado,,,,24,Alentejo,BEJA,0202,77788.03,6725,414,443,396,373,328,701,1097,1540,1954,8.65,2.51,1.98,1.41
29-07-2021,ALPIARÇA,13,1,186,"[120,240]",Moderado,,,,13,Lisboa e Vale do Tejo,SANTARÉM,1404,9536.33,7059,515,486,363,333,274,607,970,1456,1971,74.02,20.67,15.27,10.17
29-07-2021,ALTER DO CHÃO,11,1,351,"[240,480]",Elevado,,,,11,Alentejo,PORTALEGRE,1201,36206.62,3165,201,163,136,208,187,395,531,694,895,8.74,2.47,1.92,1.47
29-07-2021,ALVAIÁZERE,2,0,30,"[0,120]",Baixo a Moderado,,,,2,Centro,LEIRIA,1002,16047.76,6597,419,389,346,406,539,945,1291,1680,2099,41.11,13.08,10.47,8.04
29-07-2021,ALVITO,3,0,122,"[120,240]",Moderado,,,,3,Alentejo,BEJA,0203,26485.32,2477,145,110,105,111,89,200,305,415,560,9.35,2.11,1.57,1.15
29-07-2021,AMADORA,847,60,460,"[240,480]",Elevado,,,,847,Lisboa e Vale do Tejo,LISBOA,1115,2378.47,184106,11186,10936,8780,6460,5890,12350,21130,32066,43252,7742.05,1818.84,1348.44,888.56
29-07-2021,AMARANTE,234,17,439,"[240,480]",Elevado,,,,234,Norte,PORTO,1301,30133.15,53193,3086,2413,1812,1643,1311,2954,4766,7179,10265,176.53,34.07,23.82,15.82
29-07-2021,AMARES,42,3,232,"[120,240]",Moderado,,,,42,Norte,BRAGA,0301,8195.41,18129,1001,829,622,489,524,1013,1635,2464,3465,221.22,42.28,30.07,19.95
29-07-2021,ANADIA,75,5,274,"[240,480]",Elevado,,,,75,Centro,AVEIRO,0103,21663.48,27258,1931,1698,1376,1208,1262,2470,3846,5544,7475,125.83,34.51,25.59,17.75
29-07-2021,ANGRA DO HEROÍSMO,104,7,309,"[240,480]",Elevado,,,,104,Açores,AÇORES,4301,23899.66,33807,2006,1473,1122,768,635,1403,2525,3998,6004,141.45,25.12,16.73,10.56
29-07-2021,ANSIÃO,5,0,41,"[0,120]",Baixo a Moderado,,,,5,Centro,LEIRIA,1003,17609.42,12039,727,709,646,694,530,1224,1870,2579,3306,68.37,18.77,14.65,10.62
29-07-2021,ARCOS DE VALDEVEZ,22,2,106,"[0,120]",Baixo a Moderado,,,,22,Norte,VIANA DO CASTELO,1601,44759.64,20926,1329,1338,1282,1343,1515,2858,4140,5478,6807,46.75,15.21,12.24,9.25
29-07-2021,ARGANIL,13,1,118,"[0,120]",Baixo a Moderado,,,,13,Centro,COIMBRA,0601,33283.93,11014,672,648,612,559,596,1155,1767,2415,3087,33.09,9.27,7.26,5.31
29-07-2021,ARMAMAR,3,0,52,"[0,120]",Baixo a Moderado,,,,3,Norte,VISEU,1801,11723.73,5769,357,305,309,285,310,595,904,1209,1566,49.21,13.36,10.31,7.71
29-07-2021,AROUCA,58,4,281,"[240,480]",Elevado,,,,58,Norte,AVEIRO,0104,32910.52,20720,1306,1047,753,683,683,1366,2119,3166,4472,62.96,13.59,9.62,6.44
29-07-2021,ARRAIOLOS,23,2,335,"[240,480]",Elevado,,,,23,Alentejo,ÉVORA,0702,68374.55,6928,435,384,283,367,480,847,1130,1514,1949,10.13,2.85,2.21,1.65
29-07-2021,ARRONCHES,2,0,72,"[0,120]",Baixo a Moderado,,,,2,Alentejo,PORTALEGRE,1202,31464.72,2820,155,142,162,187,179,366,528,670,825,8.96,2.62,2.13,1.68
29-07-2021,ARRUDA DOS VINHOS,21,2,139,"[120,240]",Moderado,,,,21,Lisboa e Vale do Tejo,LISBOA,1102,7795.93,15412,738,738,562,509,438,947,1509,2247,2985,197.69,38.29,28.82,19.36
29-07-2021,AVEIRO,247,18,314,"[240,480]",Elevado,,,,247,Centro,AVEIRO,0105,19757.57,78734,4520,4004,3050,2250,2103,4353,7403,11407,15927,398.49,80.61,57.73,37.47
29-07-2021,AVIS,8,1,191,"[120,240]",Moderado,,,,8,Alentejo,PORTALEGRE,1203,60596.51,4247,315,225,206,251,273,524,730,955,1270,7.01,2.1,1.58,1.2
29-07-2021,AZAMBUJA,92,7,403,"[240,480]",Elevado,,,,92,Lisboa e Vale do Tejo,LISBOA,1103,26265.65,22716,1322,1171,1070,798,618,1416,2486,3657,4979,86.48,18.96,13.92,9.46
29-07-2021,BAIÃO,48,3,258,"[240,480]",Elevado,,,,48,Norte,PORTO,1302,17452.83,18748,1070,862,714,686,725,1411,2125,2987,4057,107.42,23.25,17.11,12.18
29-07-2021,BARCELOS,328,23,282,"[240,480]",Elevado,,,,328,Norte,BRAGA,0302,37890.14,116187,6721,5325,3619,2991,2562,5553,9172,14497,21218,306.64,56.0,38.26,24.21
29-07-2021,BARRANCOS,0,0,0,"[0,120]",Baixo a Moderado,,,,0,Alentejo,BEJA,0204,16841.73,1634,90,65,65,94,61,155,220,285,375,9.7,2.23,1.69,1.31
29-07-2021,BARREIRO,470,34,626,"[480,960]",Muito Elevado,,,,470,Lisboa e Vale do Tejo,SETÚBAL,1504,3639.07,75147,5194,5565,4459,3105,1767,4872,9331,14896,20090,2065.05,552.07,409.34,256.42
29-07-2021,BATALHA,49,4,309,"[240,480]",Elevado,,,,49,Centro,LEIRIA,1004,10341.6,15963,873,762,649,529,549,1078,1727,2489,3362,154.35,32.51,24.07,16.7
29-07-2021,BEJA,156,11,465,"[240,480]",Elevado,,,,156,Alentejo,BEJA,0205,114647.55,33579,2005,1840,1386,1272,1039,2311,3697,5537,7542,29.29,6.58,4.83,3.22
29-07-2021,BELMONTE,6,0,94,"[0,120]",Baixo a Moderado,,,,6,Centro,CASTELO BRANCO,0501,11875.91,6398,444,321,325,310,355,665,990,1311,1755,53.87,14.78,11.04,8.34
29-07-2021,BENAVENTE,91,6,296,"[240,480]",Elevado,,,,91,Lisboa e Vale do Tejo,SANTARÉM,1405,52138.39,30602,1468,1376,1141,876,643,1519,2660,4036,5504,58.69,10.56,7.74,5.1
29-07-2021,BOMBARRAL,14,1,110,"[0,120]",Baixo a Moderado,,,,14,Lisboa e Vale do Tejo,LEIRIA,1005,9128.55,12558,875,714,561,491,429,920,1481,2195,3070,137.56,33.63,24.04,16.22
29-07-2021,BORBA,5,0,75,"[0,120]",Baixo a Moderado,,,,5,Alentejo,ÉVORA,0703,14518.65,6736,430,375,279,436,392,828,1107,1482,1912,46.39,13.17,10.21,7.62
29-07-2021,BOTICAS,12,1,244,"[240,480]",Elevado,,,,12,Norte,VILA REAL,1702,32195.66,4998,347,306,311,305,380,685,996,1302,1649,15.52,5.12,4.04,3.09
29-07-2021,BRAGA,572,41,313,"[240,480]",Elevado,,,,572,Norte,BRAGA,0303,18339.95,182679,10029,7963,5241,4320,3671,7991,13232,21195,31224,996.07,170.25,115.57,72.15
29-07-2021,BRAGANÇA,92,7,275,"[240,480]",Elevado,,,,92,Norte,BRAGANÇA,0402,117357.27,33607,2402,1855,1652,1393,1163,2556,4208,6063,8465,28.64,7.21,5.17,3.59
29-07-2021,CABECEIRAS DE BASTO,40,3,258,"[240,480]",Elevado,,,,40,Norte,BRAGA,0304,24182.16,15628,774,594,544,575,574,1149,1693,2287,3061,64.63,12.66,9.46,7.0
29-07-2021,CADAVAL,45,3,328,"[240,480]",Elevado,,,,45,Lisboa e Vale do Tejo,LISBOA,1104,17489.3,13673,813,796,756,621,625,1246,2002,2798,3611,78.18,20.65,16.0,11.45
29-07-2021,CALDAS DA RAINHA,150,11,288,"[240,480]",Elevado,,,,150,Lisboa e Vale do Tejo,LEIRIA,1006,25569.47,51912,3035,2684,2186,1899,1705,3604,5790,8474,11509,203.03,45.01,33.14,22.64
29-07-2021,CALHETA,16,1,148,"[120,240]",Moderado,,,,16,Madeira,MADEIRA,3101,11150.43,10867,576,497,507,399,415,814,1321,1818,2394,97.46,21.47,16.3,11.85
29-07-2021,CALHETA (AÇORES),1,0,32,"[0,120]",Baixo a Moderado,,,,1,Açores,AÇORES,4501,12626.4,3184,215,159,141,139,122,261,402,561,776,25.22,6.15,4.44,3.18
29-07-2021,CÂMARA DE LOBOS,29,2,86,"[0,120]",Baixo a Moderado,,,,29,Madeira,MADEIRA,3102,5216.67,33675,1396,1059,834,545,381,926,1760,2819,4215,645.49,80.79,54.03,33.74
29-07-2021,CAMINHA,14,1,89,"[0,120]",Baixo a Moderado,,,,14,Norte,VIANA DO CASTELO,1602,13652.14,15877,1046,944,818,646,656,1302,2120,3064,4110,116.3,30.11,22.44,15.53
29-07-2021,CAMPO MAIOR,16,1,205,"[120,240]",Moderado,,,,16,Alentejo,PORTALEGRE,1204,24720.16,7874,471,364,351,279,327,606,957,1321,1792,31.85,7.25,5.34,3.87
29-07-2021,CANTANHEDE,69,5,196,"[120,240]",Moderado,,,,69,Centro,COIMBRA,0602,39088.02,35011,2346,2096,1880,1709,1451,3160,5040,7136,9482,89.57,24.26,18.26,12.89
29-07-2021,CARRAZEDA DE ANSIÃES,4,0,71,"[0,120]",Baixo a Moderado,,,,4,Norte,BRAGANÇA,0403,27924.09,5666,424,389,391,312,465,777,1168,1557,1981,20.29,7.09,5.58,4.18
29-07-2021,CARREGAL DO SAL,13,1,140,"[120,240]",Moderado,,,,13,Centro,VISEU,1802,11689.21,9271,587,562,486,462,376,838,1324,1886,2473,79.31,21.16,16.13,11.33
29-07-2021,CARTAXO,63,5,265,"[240,480]",Elevado,,,,63,Lisboa e Vale do Tejo,SANTARÉM,1406,15817.28,23843,1415,1376,1142,861,632,1493,2635,4011,5426,150.74,34.3,25.36,16.66
29-07-2021,CASCAIS,955,68,447,"[240,480]",Elevado,,,,955,Lisboa e Vale do Tejo,LISBOA,1105,9740.17,213608,12151,11444,8680,6469,5248,11717,20397,31841,43992,2193.1,451.66,326.91,209.41
29-07-2021,CASTANHEIRA DE PÊRA,1,0,39,"[0,120]",Baixo a Moderado,,,,1,Centro,LEIRIA,1007,6677.45,2614,233,195,157,190,187,377,534,729,962,39.15,14.41,10.92,8.0
29-07-2021,CASTELO BRANCO,63,4,121,"[120,240]",Moderado,,,,63,Centro,CASTELO BRANCO,0502,143819.15,51987,3528,3042,2499,2229,2225,4454,6953,9995,13523,36.15,9.4,6.95,4.83
29-07-2021,CASTELO DE PAIVA,40,3,261,"[240,480]",Elevado,,,,40,Norte,AVEIRO,0106,11500.53,15454,881,697,545,420,431,851,1396,2093,2974,134.37,25.86,18.2,12.14
29-07-2021,CASTELO DE VIDE,2,0,69,"[0,120]",Baixo a Moderado,,,,2,Alentejo,PORTALEGRE,1205,26491.24,2919,204,173,179,147,170,317,496,669,873,11.02,3.3,2.53,1.87
29-07-2021,CASTRO DAIRE,19,1,138,"[120,240]",Moderado,,,,19,Centro,VISEU,1803,37904.13,13823,942,857,765,732,773,1505,2270,3127,4069,36.47,10.74,8.25,5.99
29-07-2021,CASTRO MARIM,28,2,452,"[240,480]",Elevado,,,,28,Algarve,FARO,0804,30084.37,6237,370,345,334,322,344,666,1000,1345,1715,20.73,5.7,4.47,3.32
29-07-2021,CASTRO VERDE,25,2,363,"[240,480]",Elevado,,,,25,Alentejo,BEJA,0206,56944.23,6949,437,347,303,275,227,502,805,1152,1589,12.2,2.79,2.02,1.41
29-07-2021,CELORICO DA BEIRA,5,0,72,"[0,120]",Baixo a Moderado,,,,5,Centro,GUARDA,0903,24721.63,6928,430,416,363,369,535,904,1267,1683,2113,28.02,8.55,6.81,5.12
29-07-2021,CELORICO DE BASTO,54,4,286,"[240,480]",Elevado,,,,54,Norte,BRAGA,0305,18107.02,19040,1001,802,668,728,729,1457,2125,2927,3928,105.15,21.69,16.17,11.74
29-07-2021,CHAMUSCA,26,2,287,"[240,480]",Elevado,,,,26,Lisboa e Vale do Tejo,SANTARÉM,1407,74600.54,9197,629,583,553,465,579,1044,1597,2180,2809,12.33,3.77,2.92,2.14
29-07-2021,CHAVES,115,8,293,"[240,480]",Elevado,,,,115,Norte,VILA REAL,1703,59122.95,39343,2676,2429,1991,1886,1918,3804,5795,8224,10900,66.54,18.44,13.91,9.8
29-07-2021,CINFÃES,51,4,278,"[240,480]",Elevado,,,,51,Norte,VISEU,1804,23928.76,18244,1067,902,779,734,758,1492,2271,3173,4240,76.24,17.72,13.26,9.49
29-07-2021,COIMBRA,266,19,198,"[120,240]",Moderado,,,,266,Centro,COIMBRA,0603,31939.94,134166,9489,8734,6353,5139,5074,10213,16566,25300,34789,420.06,108.92,79.21,51.87
29-07-2021,CONDEIXA-A-NOVA,22,2,123,"[120,240]",Moderado,,,,22,Centro,COIMBRA,0604,13867.47,17733,871,809,717,583,490,1073,1790,2599,3470,127.88,25.02,18.74,12.91
29-07-2021,CONSTÂNCIA,31,2,765,"[480,960]",Muito Elevado,,,,31,Lisboa e Vale do Tejo,SANTARÉM,1408,8036.58,4030,211,183,187,148,155,303,490,673,884,50.14,11.0,8.37,6.1
29-07-2021,CORUCHE,31,2,175,"[120,240]",Moderado,,,,31,Lisboa e Vale do Tejo,SANTARÉM,1409,111572.03,17471,1294,1090,1095,1096,1019,2115,3210,4300,5594,15.66,5.01,3.85,2.88
29-07-2021,CORVO,0,0,0,"[0,120]",Baixo a Moderado,,,,0,Açores,AÇORES,4901,1711.45,464,22,21,11,13,19,32,43,64,86,27.12,5.03,3.74,2.51
29-07-2021,COVILHÃ,25,2,53,"[0,120]",Baixo a Moderado,,,,25,Centro,CASTELO BRANCO,0503,55560.06,46787,3533,2998,2365,2111,2193,4304,6669,9667,13200,84.21,23.76,17.4,12.0
29-07-2021,CRATO,2,0,65,"[0,120]",Baixo a Moderado,,,,2,Alentejo,PORTALEGRE,1206,39806.88,3129,229,258,163,182,228,410,573,831,1060,7.86,2.66,2.09,1.44
29-07-2021,CUBA,41,3,902,"[480,960]",Muito Elevado,,,,41,Alentejo,BEJA,0207,17208.72,4595,255,233,206,190,143,333,539,772,1027,26.7,5.97,4.49,3.13
29-07-2021,ELVAS,59,4,286,"[240,480]",Elevado,,,,59,Alentejo,PORTALEGRE,1207,63128.86,20528,1057,1145,902,852,810,1662,2564,3709,4766,32.52,7.55,5.88,4.06
29-07-2021,ENTRONCAMENTO,58,4,269,"[240,480]",Elevado,,,,58,Lisboa e Vale do Tejo,SANTARÉM,1410,1372.81,21558,1066,930,868,695,592,1287,2155,3085,4151,1570.14,302.33,224.69,156.96
29-07-2021,ESPINHO,153,11,517,"[480,960]",Muito Elevado,,,,153,Norte,AVEIRO,0107,2105.68,29516,2205,1993,1430,1177,960,2137,3567,5560,7765,1401.52,368.71,264.01,169.37
29-07-2021,ESPOSENDE,140,10,410,"[240,480]",Elevado,,,,140,Norte,BRAGA,0306,9540.98,34177,1831,1522,1095,894,723,1617,2712,4234,6065,358.21,63.57,44.38,28.42
29-07-2021,ESTARREJA,34,2,130,"[120,240]",Moderado,,,,34,Centro,AVEIRO,0108,10817.33,26006,1503,1399,1106,953,728,1681,2787,4186,5689,240.42,52.59,38.7,25.76
29-07-2021,ESTREMOZ,31,2,246,"[240,480]",Elevado,,,,31,Alentejo,ÉVORA,0704,51379.95,12728,789,613,697,786,877,1663,2360,2973,3762,24.77,7.32,5.79,4.59
29-07-2021,ÉVORA,206,15,393,"[240,480]",Elevado,,,,206,Alentejo,ÉVORA,0705,130707.58,52428,3569,2852,2176,1966,1803,3769,5945,8797,12366,40.11,9.46,6.73,4.55
29-07-2021,FAFE,205,15,427,"[240,480]",Elevado,,,,205,Norte,BRAGA,0307,21908.11,48060,3044,2455,1679,1403,1208,2611,4290,6745,9789,219.37,44.68,30.79,19.58
29-07-2021,FARO,511,36,837,"[480,960]",Muito Elevado,,,,511,Algarve,FARO,0805,20256.79,61015,3847,3364,2604,2055,1601,3656,6260,9624,13471,301.2,66.5,47.51,30.9
29-07-2021,FELGUEIRAS,385,27,682,"[480,960]",Muito Elevado,,,,385,Norte,PORTO,1303,11573.75,56422,2951,2302,1601,1316,973,2289,3890,6192,9143,487.49,79.0,53.5,33.61
29-07-2021,FERREIRA DO ALENTEJO,12,1,154,"[120,240]",Moderado,,,,12,Alentejo,BEJA,0208,64820.68,7845,515,414,372,343,345,688,1060,1474,1989,12.1,3.07,2.27,1.64
29-07-2021,FERREIRA DO ZÊZERE,7,1,88,"[0,120]",Baixo a Moderado,,,,7,Lisboa e Vale do Tejo,SANTARÉM,1411,19038.03,7959,470,370,416,465,456,921,1337,1707,2177,41.81,11.44,8.97,7.02
29-07-2021,FIGUEIRA DA FOZ,113,8,192,"[120,240]",Moderado,,,,113,Centro,COIMBRA,0605,37905.26,58747,4032,3597,2887,2495,2043,4538,7425,11022,15054,154.98,39.72,29.08,19.59
29-07-2021,FIGUEIRA DE CASTELO RODRIGO,11,1,197,"[120,240]",Moderado,,,,11,Centro,GUARDA,0904,50857.46,5584,347,352,290,352,391,743,1033,1385,1732,10.98,3.41,2.72,2.03
29-07-2021,FIGUEIRÓ DOS VINHOS,1,0,18,"[0,120]",Baixo a Moderado,,,,1,Centro,LEIRIA,1008,17344.0,5568,402,386,322,309,351,660,982,1368,1770,32.1,10.21,7.89,5.66
29-07-2021,FORNOS DE ALGODRES,1,0,22,"[0,120]",Baixo a Moderado,,,,1,Centro,GUARDA,0905,13145.05,4528,261,218,247,256,232,488,735,953,1214,34.45,9.24,7.25,5.59
29-07-2021,FREIXO DE ESPADA À CINTA,5,0,154,"[120,240]",Moderado,,,,5,Norte,BRAGANÇA,0404,24414.29,3298,211,177,231,196,189,385,616,793,1004,13.51,4.11,3.25,2.52
29-07-2021,FRONTEIRA,2,0,68,"[0,120]",Baixo a Moderado,,,,2,Alentejo,PORTALEGRE,1208,24859.58,2974,213,182,149,156,168,324,473,655,868,11.96,3.49,2.63,1.9
29-07-2021,FUNCHAL,212,15,204,"[120,240]",Moderado,,,,212,Madeira,MADEIRA,3103,7616.2,104024,6382,5086,3643,2821,1990,4811,8454,13540,19922,1365.86,261.58,177.78,111.0
29-07-2021,FUNDÃO,29,2,110,"[0,120]",Baixo a Moderado,,,,29,Centro,CASTELO BRANCO,0504,70019.79,26495,1781,1464,1432,1357,1643,3000,4432,5896,7677,37.84,10.96,8.42,6.33
29-07-2021,GAVIÃO,1,0,31,"[0,120]",Baixo a Moderado,,,,1,Alentejo,PORTALEGRE,1209,29459.45,3263,189,186,222,263,293,556,778,964,1153,11.08,3.91,3.27,2.64
29-07-2021,GÓIS,5,0,133,"[120,240]",Moderado,,,,5,Centro,COIMBRA,0606,26330.19,3805,235,199,240,233,244,477,717,916,1151,14.45,4.37,3.48,2.72
29-07-2021,GOLEGÃ,2,0,38,"[0,120]",Baixo a Moderado,,,,2,Lisboa e Vale do Tejo,SANTARÉM,1412,8431.67,5339,356,299,281,243,255,498,779,1078,1434,63.32,17.01,12.78,9.24
29-07-2021,GONDOMAR,885,63,533,"[480,960]",Muito Elevado,,,,885,Norte,PORTO,1304,13191.76,165985,10555,8755,6222,4450,3364,7814,14036,22791,33346,1258.22,252.77,172.76,106.4
29-07-2021,GOUVEIA,16,1,129,"[120,240]",Moderado,,,,16,Centro,GUARDA,0906,30061.17,12387,871,931,780,783,810,1593,2373,3304,4175,41.21,13.89,10.99,7.89
29-07-2021,GRÂNDOLA,43,3,294,"[240,480]",Elevado,,,,43,Alentejo,SETÚBAL,1505,82593.66,14639,834,834,708,688,672,1360,2068,2902,3736,17.72,4.52,3.51,2.5
29-07-2021,GUARDA,86,6,221,"[120,240]",Moderado,,,,86,Centro,GUARDA,0907,71209.58,38969,2477,2041,1686,1415,1474,2889,4575,6616,9093,54.72,12.77,9.29,6.42
29-07-2021,GUIMARÃES,573,41,376,"[240,480]",Elevado,,,,573,Norte,BRAGA,0308,24099.96,152309,9394,7074,4809,3877,2948,6825,11634,18708,28102,631.99,116.61,77.63,48.27
29-07-2021,HORTA,7,0,48,"[0,120]",Baixo a Moderado,,,,7,Açores,AÇORES,4701,17305.53,14521,818,658,468,352,302,654,1122,1780,2598,83.91,15.01,10.29,6.48
29-07-2021,IDANHA-A-NOVA,2,0,25,"[0,120]",Baixo a Moderado,,,,2,Centro,CASTELO BRANCO,0505,141633.51,8043,518,490,519,672,974,1646,2165,2655,3173,5.68,2.24,1.87,1.53
29-07-2021,ÍLHAVO,98,7,253,"[240,480]",Elevado,,,,98,Centro,AVEIRO,0110,7347.55,38699,2227,1943,1444,1193,850,2043,3487,5430,7657,526.66,104.21,73.9,47.46
29-07-2021,LAGOA (FARO),193,14,849,"[480,960]",Muito Elevado,,,,193,Algarve,FARO,0806,8825.45,22762,1314,1168,919,749,670,1419,2338,3506,4820,257.93,54.62,39.73,26.49
29-07-2021,LAGOA,99,7,671,"[480,960]",Muito Elevado,,,,99,Açores,AÇORES,4201,4559.32,14721,536,458,349,238,235,473,822,1280,1816,322.9,39.83,28.08,18.03
29-07-2021,LAGOS,283,20,932,"[480,960]",Muito Elevado,,,,283,Algarve,FARO,0807,21299.27,30374,1744,1434,1247,1053,1029,2082,3329,4763,6507,142.61,30.55,22.36,15.63
29-07-2021,LAJES DAS FLORES,5,0,342,"[240,480]",Elevado,,,,5,Açores,AÇORES,4801,7004.79,1463,88,53,62,46,54,100,162,215,303,20.89,4.33,3.07,2.31
29-07-2021,LAJES DO PICO,6,0,134,"[120,240]",Moderado,,,,6,Açores,AÇORES,4601,15531.09,4490,304,231,223,159,162,321,544,775,1079,28.91,6.95,4.99,3.5
29-07-2021,LAMEGO,36,3,145,"[120,240]",Moderado,,,,36,Norte,VISEU,1805,16542.11,24895,1639,1284,1124,898,783,1681,2805,4089,5728,150.5,34.63,24.72,16.96
29-07-2021,LEIRIA,447,32,357,"[240,480]",Elevado,,,,447,Centro,LEIRIA,1009,56508.83,125267,7389,6366,5090,3902,3159,7061,12151,18517,25906,221.68,45.84,32.77,21.5
29-07-2021,LISBOA,3821,273,750,"[480,960]",Muito Elevado,,,,3821,Lisboa e Vale do Tejo,LISBOA,1106,10005.43,509515,33197,33340,27706,23037,26770,49807,77513,110853,144050,5092.6,1439.78,1107.98,774.74
29-07-2021,LOULÉ,682,49,993,"[960,Max]",Extremamente Elevado,,,,682,Algarve,FARO,0808,76366.91,68697,3890,3350,2780,2358,2251,4609,7389,10739,14629,89.96,19.16,14.06,9.68
29-07-2021,LOURES,1056,75,494,"[480,960]",Muito Elevado,,,,1056,Lisboa e Vale do Tejo,LISBOA,1107,16723.99,213687,12746,12794,9644,6669,5033,11702,21346,34140,46886,1277.73,280.35,204.14,127.64
29-07-2021,LOURINHÃ,58,4,225,"[120,240]",Moderado,,,,58,Lisboa e Vale do Tejo,LISBOA,1108,14717.2,25855,1584,1243,992,842,645,1487,2479,3722,5306,175.68,36.05,25.29,16.84
29-07-2021,LOUSÃ,10,1,58,"[0,120]",Baixo a Moderado,,,,10,Centro,COIMBRA,0607,13840.01,17158,946,866,658,528,450,978,1636,2502,3448,123.97,24.91,18.08,11.82
29-07-2021,LOUSADA,387,28,827,"[480,960]",Muito Elevado,,,,387,Norte,PORTO,1305,9608.01,46755,2289,1698,1176,853,621,1474,2650,4348,6637,486.63,69.08,45.25,27.58
29-07-2021,MAÇÃO,8,1,129,"[120,240]",Moderado,,,,8,Lisboa e Vale do Tejo,SANTARÉM,1413,39997.98,6267,386,362,390,440,657,1097,1487,1849,2235,15.67,5.59,4.62,3.72
29-07-2021,MACEDO DE CAVALEIROS,11,1,76,"[0,120]",Baixo a Moderado,,,,11,Norte,BRAGANÇA,0405,69914.08,14516,1082,889,878,823,938,1761,2639,3528,4610,20.76,6.59,5.05,3.77
29-07-2021,MACHICO,29,2,146,"[120,240]",Moderado,,,,29,Madeira,MADEIRA,3104,6825.1,19981,1197,860,662,455,331,786,1448,2308,3505,292.76,51.36,33.82,21.22
29-07-2021,MADALENA,5,0,85,"[0,120]",Baixo a Moderado,,,,5,Açores,AÇORES,4602,14712.33,5895,334,256,173,190,179,369,542,798,1132,40.07,7.69,5.42,3.68
29-07-2021,MAFRA,344,25,406,"[240,480]",Elevado,,,,344,Lisboa e Vale do Tejo,LISBOA,1109,29165.5,84816,3613,3334,2839,2089,1899,3988,6827,10161,13774,290.81,47.23,34.84,23.41
29-07-2021,MAIA,724,52,521,"[480,960]",Muito Elevado,,,,724,Norte,PORTO,1306,8293.94,138971,7801,6617,4512,3339,2631,5970,10482,17099,24900,1675.56,300.22,206.16,126.38
29-07-2021,MANGUALDE,27,2,146,"[120,240]",Moderado,,,,27,Centro,VISEU,1806,21925.56,18510,1198,1128,885,852,743,1595,2480,3608,4806,84.42,21.92,16.46,11.31
29-07-2021,MANTEIGAS,7,1,234,"[120,240]",Moderado,,,,7,Centro,GUARDA,0908,12197.55,3007,258,197,159,167,146,313,472,669,927,24.65,7.6,5.48,3.87
29-07-2021,MARCO DE CANAVESES,156,11,302,"[240,480]",Elevado,,,,156,Norte,PORTO,1307,20188.98,51496,2678,2060,1488,1265,1023,2288,3776,5836,8514,255.07,42.17,28.91,18.7
29-07-2021,MARINHA GRANDE,107,8,278,"[240,480]",Elevado,,,,107,Centro,LEIRIA,1010,18725.19,38508,2365,2302,1638,1359,1058,2417,4055,6357,8722,205.65,46.58,33.95,21.66
29-07-2021,MARVÃO,2,0,68,"[0,120]",Baixo a Moderado,,,,2,Alentejo,PORTALEGRE,1210,15489.9,3005,198,185,142,197,237,434,576,761,959,19.4,6.19,4.91,3.72
29-07-2021,MATOSINHOS,1291,92,736,"[480,960]",Muito Elevado,,,,1291,Norte,PORTO,1308,6241.97,175357,11850,9977,7023,5024,3884,8908,15931,25908,37758,2809.31,604.9,415.06,255.22
29-07-2021,MEALHADA,51,4,255,"[240,480]",Elevado,,,,51,Centro,AVEIRO,0111,11065.66,19914,1163,1039,810,828,831,1659,2469,3508,4671,179.96,42.21,31.7,22.31
29-07-2021,MÊDA,5,0,109,"[0,120]",Baixo a Moderado,,,,5,Centro,GUARDA,0909,28604.92,4587,343,306,290,288,443,731,1021,1327,1670,16.04,5.84,4.64,3.57
29-07-2021,MELGAÇO,1,0,13,"[0,120]",Baixo a Moderado,,,,1,Norte,VIANA DO CASTELO,1603,23824.58,8093,507,567,578,614,675,1289,1867,2434,2941,33.97,12.34,10.22,7.84
29-07-2021,MÉRTOLA,17,1,281,"[240,480]",Elevado,,,,17,Alentejo,BEJA,0209,129287.34,6142,400,390,378,423,600,1023,1401,1791,2191,4.75,1.69,1.39,1.08
29-07-2021,MESÃO FRIO,4,0,102,"[0,120]",Baixo a Moderado,,,,4,Norte,VILA REAL,1704,2664.87,3964,265,205,168,157,120,277,445,650,915,148.74,34.33,24.39,16.7
29-07-2021,MIRA,23,2,194,"[120,240]",Moderado,,,,23,Centro,COIMBRA,0608,12403.38,11832,727,729,659,550,466,1016,1675,2404,3131,95.4,25.24,19.38,13.5
29-07-2021,MIRANDA DO CORVO,13,1,102,"[0,120]",Baixo a Moderado,,,,13,Centro,COIMBRA,0609,12637.79,12708,706,659,568,498,404,902,1470,2129,2835,100.55,22.43,16.85,11.63
29-07-2021,MIRANDA DO DOURO,16,1,237,"[120,240]",Moderado,,,,16,Norte,BRAGANÇA,0406,48718.31,6830,482,429,442,463,470,933,1375,1804,2286,14.02,4.69,3.7,2.82
29-07-2021,MIRANDELA,167,12,769,"[480,960]",Muito Elevado,,,,167,Norte,BRAGANÇA,0407,65895.67,21754,1640,1315,1204,1078,947,2025,3229,4544,6184,33.01,9.38,6.9,4.9
29-07-2021,MOGADOURO,57,4,676,"[480,960]",Muito Elevado,,,,57,Norte,BRAGANÇA,0408,76064.93,8392,589,529,576,630,655,1285,1861,2390,2979,11.03,3.92,3.14,2.45
29-07-2021,MOIMENTA DA BEIRA,18,1,185,"[120,240]",Moderado,,,,18,Norte,VISEU,1807,21996.9,9736,576,514,471,416,461,877,1348,1862,2438,44.26,11.08,8.46,6.13
29-07-2021,MOITA,381,27,592,"[480,960]",Muito Elevado,,,,381,Lisboa e Vale do Tejo,SETÚBAL,1506,5525.98,64407,4226,3646,2623,1801,1425,3226,5849,9495,13721,1165.53,248.3,171.82,105.85
29-07-2021,MONÇÃO,20,1,113,"[0,120]",Baixo a Moderado,,,,20,Norte,VIANA DO CASTELO,1604,21130.85,17869,1161,1105,1031,1006,972,1978,3009,4114,5275,84.56,24.96,19.47,14.24
29-07-2021,MONCHIQUE,15,1,301,"[240,480]",Elevado,,,,15,Algarve,FARO,0809,39530.43,5077,353,384,321,355,392,747,1068,1452,1805,12.84,4.57,3.67,2.7
29-07-2021,MONDIM DE BASTO,9,1,131,"[120,240]",Moderado,,,,9,Norte,VILA REAL,1705,17207.52,6946,395,300,314,284,283,567,881,1181,1576,40.36,9.16,6.86,5.12
29-07-2021,MONFORTE,2,0,68,"[0,120]",Baixo a Moderado,,,,2,Alentejo,PORTALEGRE,1211,42024.82,2975,139,115,117,192,168,360,477,592,731,7.08,1.74,1.41,1.14
29-07-2021,MONTALEGRE,51,4,563,"[480,960]",Muito Elevado,,,,51,Norte,VILA REAL,1706,80545.71,8997,699,628,595,603,730,1333,1928,2556,3255,11.17,4.04,3.17,2.39
29-07-2021,MONTEMOR-O-NOVO,46,3,291,"[240,480]",Elevado,,,,46,Alentejo,ÉVORA,0706,123296.65,15647,991,953,868,878,971,1849,2717,3670,4661,12.69,3.78,2.98,2.2
29-07-2021,MONTEMOR-O-VELHO,42,3,166,"[120,240]",Moderado,,,,42,Centro,COIMBRA,0610,22896.23,25224,1496,1397,1217,1057,988,2045,3262,4659,6155,110.17,26.88,20.35,14.25
29-07-2021,MONTIJO,223,16,387,"[240,480]",Elevado,,,,223,Lisboa e Vale do Tejo,SETÚBAL,1507,34861.64,57614,2771,2441,1990,1554,1109,2663,4653,7094,9865,165.26,28.3,20.35,13.35
29-07-2021,MORA,5,0,124,"[120,240]",Moderado,,,,5,Alentejo,ÉVORA,0707,44395.02,4138,336,275,252,238,257,495,747,1022,1358,9.32,3.06,2.3,1.68
29-07-2021,MORTÁGUA,10,1,113,"[0,120]",Baixo a Moderado,,,,10,Centro,VISEU,1808,25117.82,8803,638,584,535,499,460,959,1494,2078,2716,35.05,10.81,8.27,5.95
29-07-2021,MOURA,61,4,448,"[240,480]",Elevado,,,,61,Alentejo,BEJA,0210,95845.55,13718,817,656,665,542,461,1003,1668,2324,3141,14.31,3.28,2.42,1.74
29-07-2021,MOURÃO,4,0,164,"[120,240]",Moderado,,,,4,Alentejo,ÉVORA,0708,27862.98,2450,139,108,80,104,109,213,293,401,540,8.79,1.94,1.44,1.05
29-07-2021,MURÇA,8,1,148,"[120,240]",Moderado,,,,8,Norte,VILA REAL,1707,18937.11,5463,384,341,307,306,319,625,932,1273,1657,28.85,8.75,6.72,4.92
29-07-2021,MURTOSA,10,1,96,"[0,120]",Baixo a Moderado,,,,10,Centro,AVEIRO,0112,7308.78,10279,509,473,403,353,409,762,1165,1638,2147,140.63,29.37,22.41,15.94
29-07-2021,NAZARÉ,64,5,449,"[240,480]",Elevado,,,,64,Lisboa e Vale do Tejo,LEIRIA,1011,8243.43,14165,967,903,670,420,396,816,1486,2389,3356,171.84,40.71,28.98,18.03
29-07-2021,NELAS,25,2,193,"[120,240]",Moderado,,,,25,Centro,VISEU,1809,12571.48,12974,924,787,668,604,583,1187,1855,2642,3566,103.21,28.37,21.02,14.76
29-07-2021,NISA,0,0,0,"[0,120]",Baixo a Moderado,,,,0,Alentejo,PORTALEGRE,1212,57567.84,6061,405,389,355,483,478,961,1316,1705,2110,10.53,3.67,2.96,2.29
29-07-2021,NORDESTE,1,0,21,"[0,120]",Baixo a Moderado,,,,1,Açores,AÇORES,4202,10146.8,4862,246,180,124,161,162,323,447,627,873,47.92,8.6,6.18,4.41
29-07-2021,ÓBIDOS,21,1,175,"[120,240]",Moderado,,,,21,Lisboa e Vale do Tejo,LEIRIA,1012,14155.44,11850,743,650,574,452,436,888,1462,2112,2855,83.72,20.17,14.92,10.33
29-07-2021,ODEMIRA,90,6,365,"[240,480]",Elevado,,,,90,Alentejo,BEJA,0211,172060.15,24717,1475,1317,1225,1397,1349,2746,3971,5288,6763,14.37,3.93,3.07,2.31
29-07-2021,ODIVELAS,778,56,481,"[480,960]",Muito Elevado,,,,778,Lisboa e Vale do Tejo,LISBOA,1116,2654.36,161774,9562,9038,6952,4641,3812,8453,15405,24443,34005,6095.48,1281.27,920.99,580.44
29-07-2021,OEIRAS,697,50,393,"[240,480]",Elevado,,,,697,Lisboa e Vale do Tejo,LISBOA,1110,4588.31,177408,11580,11575,8566,6211,5855,12066,20632,32207,43787,3866.78,954.38,701.98,449.69
29-07-2021,OLEIROS,2,0,40,"[0,120]",Baixo a Moderado,,,,2,Centro,CASTELO BRANCO,0506,47109.31,5003,384,341,366,397,487,884,1250,1591,1975,10.62,4.19,3.38,2.65
29-07-2021,OLHÃO,298,21,670,"[480,960]",Muito Elevado,,,,298,Algarve,FARO,0810,13086.38,44405,2455,2309,1689,1342,1268,2610,4299,6608,9063,339.33,69.26,50.5,32.85
29-07-2021,OLIVEIRA DE AZEMÉIS,137,10,208,"[120,240]",Moderado,,,,137,Norte,AVEIRO,0113,16110.41,66011,4155,3614,2794,2183,1738,3921,6715,10329,14484,409.75,89.91,64.12,41.68
29-07-2021,OLIVEIRA DE FRADES,12,1,120,"[120,240]",Moderado,,,,12,Centro,VISEU,1810,14534.62,9936,553,475,438,359,415,774,1212,1687,2240,68.36,15.41,11.61,8.34
29-07-2021,OLIVEIRA DO BAIRRO,90,6,372,"[240,480]",Elevado,,,,90,Centro,AVEIRO,0114,8731.99,24277,1327,1182,999,786,810,1596,2595,3777,5104,278.02,58.45,43.25,29.72
29-07-2021,OLIVEIRA DO HOSPITAL,70,5,364,"[240,480]",Elevado,,,,70,Centro,COIMBRA,0611,23451.66,19253,1161,1097,962,924,960,1884,2846,3943,5104,82.1,21.76,16.81,12.14
29-07-2021,OURÉM,75,5,171,"[120,240]",Moderado,,,,75,Lisboa e Vale do Tejo,SANTARÉM,1421,41668.03,44044,2463,2069,1899,1817,1603,3420,5319,7388,9851,105.7,23.64,17.73,12.77
29-07-2021,OURIQUE,3,0,66,"[0,120]",Baixo a Moderado,,,,3,Alentejo,BEJA,0212,66331.36,4607,313,287,284,268,227,495,779,1066,1379,6.95,2.08,1.61,1.17
29-07-2021,OVAR,154,11,284,"[240,480]",Elevado,,,,154,Centro,AVEIRO,0115,14770.25,54260,3294,2709,1994,1636,1234,2870,4864,7573,10867,367.37,73.57,51.27,32.93
29-07-2021,PAÇOS DE FERREIRA,304,22,536,"[480,960]",Muito Elevado,,,,304,Norte,PORTO,1309,7099.29,56728,2903,2193,1518,1135,664,1799,3317,5510,8413,799.1,118.51,77.62,46.72
29-07-2021,PALMELA,202,14,314,"[240,480]",Elevado,,,,202,Lisboa e Vale do Tejo,SETÚBAL,1508,46512.01,64269,3402,3244,2635,1846,1391,3237,5872,9116,12518,138.18,26.91,19.6,12.62
29-07-2021,PAMPILHOSA DA SERRA,4,0,99,"[0,120]",Baixo a Moderado,,,,4,Centro,COIMBRA,0612,39646.24,4037,238,254,295,339,423,762,1057,1311,1549,10.18,3.91,3.31,2.67
29-07-2021,PAREDES,473,34,550,"[480,960]",Muito Elevado,,,,473,Norte,PORTO,1310,15675.69,86067,4272,3532,2412,1717,1258,2975,5387,8919,13191,549.04,84.15,56.9,34.36
29-07-2021,PAREDES DE COURA,21,2,248,"[240,480]",Elevado,,,,21,Norte,VIANA DO CASTELO,1605,13818.59,8535,466,528,407,465,515,980,1387,1915,2381,61.76,17.23,13.86,10.04
29-07-2021,PEDRÓGÃO GRANDE,23,2,673,"[480,960]",Muito Elevado,,,,23,Centro,LEIRIA,1013,12874.75,3410,175,173,196,221,252,473,669,842,1017,26.49,7.9,6.54,5.2
29-07-2021,PENACOVA,32,2,235,"[120,240]",Moderado,,,,32,Centro,COIMBRA,0613,21673.23,13694,968,923,745,621,703,1324,2069,2992,3960,63.18,18.27,13.81,9.55
29-07-2021,PENAFIEL,313,22,448,"[240,480]",Elevado,,,,313,Norte,PORTO,1311,21224.27,69772,3648,2823,2032,1663,1230,2893,4925,7748,11396,328.74,53.69,36.51,23.2
29-07-2021,PENALVA DO CASTELO,11,1,154,"[120,240]",Moderado,,,,11,Centro,VISEU,1811,13433.92,7115,449,457,413,391,426,817,1230,1687,2136,52.96,15.9,12.56,9.16
29-07-2021,PENAMACOR,3,0,64,"[0,120]",Baixo a Moderado,,,,3,Centro,CASTELO BRANCO,0507,56370.69,4755,262,248,273,451,633,1084,1357,1605,1867,8.44,3.31,2.85,2.41
29-07-2021,PENEDONO,9,1,350,"[240,480]",Elevado,,,,9,Norte,VISEU,1812,13370.75,2591,172,113,129,156,138,294,423,536,708,19.38,5.3,4.01,3.16
29-07-2021,PENELA,4,0,74,"[0,120]",Baixo a Moderado,,,,4,Centro,COIMBRA,0614,13480.0,5397,314,324,274,359,344,703,977,1301,1615,40.04,11.98,9.65,7.25
29-07-2021,PENICHE,116,8,438,"[240,480]",Elevado,,,,116,Lisboa e Vale do Tejo,LEIRIA,1014,7754.98,26501,1746,1504,1203,926,707,1633,2836,4340,6086,341.73,78.48,55.96,36.57
29-07-2021,PESO DA RÉGUA,38,3,242,"[240,480]",Elevado,,,,38,Norte,VILA REAL,1708,9486.01,15773,1076,843,650,659,455,1114,1764,2607,3683,166.28,38.83,27.48,18.6
29-07-2021,PINHEL,5,0,59,"[0,120]",Baixo a Moderado,,,,5,Centro,GUARDA,0910,48452.12,8511,577,566,551,538,689,1227,1778,2344,2921,17.57,6.03,4.84,3.67
29-07-2021,POMBAL,84,6,163,"[120,240]",Moderado,,,,84,Centro,LEIRIA,1015,62600.28,51461,3187,2791,2494,2328,2027,4355,6849,9640,12827,82.21,20.49,15.4,10.94
29-07-2021,PONTA DELGADA,194,14,286,"[240,480]",Elevado,,,,194,Açores,AÇORES,4203,23298.65,67935,3108,2435,1726,1133,902,2035,3761,6196,9304,291.58,39.93,26.59,16.14
29-07-2021,PONTA DO SOL,3,0,35,"[0,120]",Baixo a Moderado,,,,3,Madeira,MADEIRA,3105,4622.03,8593,319,283,347,208,221,429,776,1059,1378,185.92,29.81,22.91,16.79
29-07-2021,PONTE DA BARCA,7,1,63,"[0,120]",Baixo a Moderado,,,,7,Norte,VIANA DO CASTELO,1606,18211.37,11180,635,576,517,554,490,1044,1561,2137,2772,61.39,15.22,11.73,8.57
29-07-2021,PONTE DE LIMA,98,7,236,"[120,240]",Moderado,,,,98,Norte,VIANA DO CASTELO,1607,32025.46,41315,2321,2022,1720,1596,1462,3058,4778,6800,9121,129.01,28.48,21.23,14.92
29-07-2021,PONTE DE SOR,32,2,216,"[120,240]",Moderado,,,,32,Alentejo,PORTALEGRE,1213,83971.16,14994,939,800,716,739,831,1570,2286,3086,4025,17.86,4.79,3.68,2.72
29-07-2021,PORTALEGRE,43,3,196,"[120,240]",Moderado,,,,43,Alentejo,PORTALEGRE,1214,44713.64,22172,1577,1351,1137,993,984,1977,3114,4465,6042,49.59,13.51,9.99,6.96
29-07-2021,PORTEL,2,0,35,"[0,120]",Baixo a Moderado,,,,2,Alentejo,ÉVORA,0709,60100.57,5828,336,358,283,331,305,636,919,1277,1613,9.7,2.68,2.12,1.53
29-07-2021,PORTIMÃO,656,47,1183,"[960,Max]",Extremamente Elevado,,,,656,Algarve,FARO,0811,18206.29,55483,3182,2927,2116,1582,1400,2982,5098,8025,11207,304.75,61.56,44.08,28.0
29-07-2021,PORTO,1783,127,823,"[480,960]",Muito Elevado,,,,1783,Norte,PORTO,1312,4142.02,216606,15790,15193,11280,9409,10044,19453,30733,45926,61716,5229.5,1490.0,1108.79,741.98
29-07-2021,PORTO DE MÓS,83,6,356,"[240,480]",Elevado,,,,83,Centro,LEIRIA,1016,26183.41,23275,1355,1210,1034,888,872,1760,2794,4004,5359,88.89,20.47,15.29,10.67
29-07-2021,PORTO MONIZ,5,0,216,"[120,240]",Moderado,,,,5,Madeira,MADEIRA,3106,8293.38,2342,143,130,95,98,120,218,313,443,586,28.24,7.07,5.34,3.77
29-07-2021,PORTO SANTO,11,1,212,"[120,240]",Moderado,,,,11,Madeira,MADEIRA,3201,4300.7,5202,240,157,134,110,68,178,312,469,709,120.95,16.48,10.9,7.25
29-07-2021,PÓVOA DE LANHOSO,75,5,349,"[240,480]",Elevado,,,,75,Norte,BRAGA,0309,13465.29,21499,1175,909,732,673,624,1297,2029,2938,4113,159.67,30.55,21.82,15.07
29-07-2021,PÓVOA DE VARZIM,305,22,486,"[480,960]",Muito Elevado,,,,305,Norte,PORTO,1313,8220.59,62784,3712,3120,2134,1594,1305,2899,5033,8153,11865,763.7,144.33,99.17,61.22
29-07-2021,POVOAÇÃO,6,0,102,"[0,120]",Baixo a Moderado,,,,6,Açores,AÇORES,4204,10640.77,5927,293,212,191,144,134,278,469,681,974,55.7,9.15,6.4,4.41
29-07-2021,VILA DA PRAIA DA VITÓRIA,106,8,495,"[480,960]",Muito Elevado,,,,106,Açores,AÇORES,4302,16127.06,21317,1133,789,619,436,336,772,1391,2180,3313,132.18,20.54,13.52,8.63
29-07-2021,PROENÇA-A-NOVA,13,1,179,"[120,240]",Moderado,,,,13,Centro,CASTELO BRANCO,0508,39539.96,7298,508,465,389,400,560,960,1349,1814,2322,18.46,5.87,4.59,3.41
29-07-2021,REDONDO,3,0,48,"[0,120]",Baixo a Moderado,,,,3,Alentejo,ÉVORA,0710,36950.87,6353,349,325,288,288,354,642,930,1255,1604,17.19,4.34,3.4,2.52
29-07-2021,REGUENGOS DE MONSARAZ,17,1,171,"[120,240]",Moderado,,,,17,Alentejo,ÉVORA,0711,46399.72,10015,602,511,455,462,473,935,1390,1901,2503,21.58,5.39,4.1,3.0
29-07-2021,RESENDE,25,2,249,"[240,480]",Elevado,,,,25,Norte,VISEU,1813,12334.93,10137,560,493,448,433,422,855,1303,1796,2356,82.18,19.1,14.56,10.56
29-07-2021,RIBEIRA BRAVA,25,2,202,"[120,240]",Moderado,,,,25,Madeira,MADEIRA,3107,6544.88,12435,648,500,411,311,287,598,1009,1509,2157,189.99,32.96,23.06,15.42
29-07-2021,RIBEIRA DE PENA,8,1,134,"[120,240]",Moderado,,,,8,Norte,VILA REAL,1709,21745.98,6016,371,301,290,310,368,678,968,1269,1640,27.66,7.54,5.84,4.45
29-07-2021,RIBEIRA GRANDE,98,7,299,"[240,480]",Elevado,,,,98,Açores,AÇORES,4205,18015.13,32811,1163,689,512,345,253,598,1110,1799,2962,182.13,16.44,9.99,6.16
29-07-2021,RIO MAIOR,75,5,370,"[240,480]",Elevado,,,,75,Lisboa e Vale do Tejo,SANTARÉM,1414,27276.45,20379,1251,1144,941,795,648,1443,2384,3528,4779,74.71,17.52,12.93,8.74
29-07-2021,SABROSA,13,1,221,"[120,240]",Moderado,,,,13,Norte,VILA REAL,1710,15692.45,5918,393,314,304,302,350,652,956,1270,1663,37.71,10.6,8.09,6.09
29-07-2021,SABUGAL,4,0,38,"[0,120]",Baixo a Moderado,,,,4,Centro,GUARDA,0911,82269.82,10585,724,707,694,796,1009,1805,2499,3206,3930,12.87,4.78,3.9,3.04
29-07-2021,SALVATERRA DE MAGOS,50,4,236,"[120,240]",Moderado,,,,50,Lisboa e Vale do Tejo,SANTARÉM,1415,24393.2,21295,1275,1181,1060,799,772,1571,2631,3812,5087,87.3,20.85,15.63,10.79
29-07-2021,SANTA COMBA DÃO,23,2,220,"[120,240]",Moderado,,,,23,Centro,VISEU,1814,11194.77,10452,732,684,569,538,464,1002,1571,2255,2987,93.36,26.68,20.14,14.03
29-07-2021,SANTA CRUZ,54,4,120,"[120,240]",Moderado,,,,54,Madeira,MADEIRA,3108,8150.28,45281,1817,1301,974,716,523,1239,2213,3514,5331,555.6,65.41,43.12,27.15
29-07-2021,SANTA CRUZ DA GRACIOSA,1,0,24,"[0,120]",Baixo a Moderado,,,,1,Açores,AÇORES,4401,6065.78,4208,228,180,163,124,145,269,432,612,840,69.37,13.85,10.09,7.12
29-07-2021,SANTA CRUZ DAS FLORES,0,0,0,"[0,120]",Baixo a Moderado,,,,0,Açores,AÇORES,4802,7091.44,2165,125,98,74,56,51,107,181,279,404,30.53,5.7,3.93,2.55
29-07-2021,SANTA MARIA DA FEIRA,329,23,237,"[120,240]",Moderado,,,,329,Norte,AVEIRO,0109,21587.65,138636,8182,6743,4771,3856,3079,6935,11706,18449,26631,642.19,123.36,85.46,54.22
29-07-2021,SANTA MARTA DE PENAGUIÃO,18,1,275,"[240,480]",Elevado,,,,18,Norte,VILA REAL,1711,6928.13,6599,483,373,337,316,317,633,970,1343,1826,95.25,26.36,19.39,14.0
29-07-2021,SANTANA,6,0,90,"[0,120]",Baixo a Moderado,,,,6,Madeira,MADEIRA,3109,9547.3,6711,418,353,343,282,277,559,902,1255,1673,70.29,17.52,13.15,9.45
29-07-2021,SANTARÉM,136,10,236,"[120,240]",Moderado,,,,136,Lisboa e Vale do Tejo,SANTARÉM,1416,55253.58,57421,3654,3441,2760,2466,2206,4672,7432,10873,14527,103.92,26.29,19.68,13.45
29-07-2021,SANTIAGO DO CACÉM,77,6,269,"[240,480]",Elevado,,,,77,Alentejo,SETÚBAL,1509,105969.29,28791,2144,1689,1472,1295,1215,2510,3982,5671,7815,27.17,7.37,5.35,3.76
29-07-2021,SANTO TIRSO,328,23,482,"[480,960]",Muito Elevado,,,,328,Norte,PORTO,1314,13655.52,68055,4911,3935,2761,2257,1810,4067,6828,10763,15674,498.35,114.78,78.82,50.0
29-07-2021,SÃO BRÁS DE ALPORTEL,99,7,954,"[480,960]",Muito Elevado,,,,99,Algarve,FARO,0812,15336.92,10416,596,468,467,404,401,805,1272,1740,2336,67.91,15.23,11.35,8.29
29-07-2021,SÃO JOÃO DA MADEIRA,53,4,240,"[240,480]",Elevado,,,,53,Norte,AVEIRO,0116,794.3,21958,1347,1069,796,601,593,1194,1990,3059,4406,2765.49,554.91,385.26,250.63
29-07-2021,SÃO JOÃO DA PESQUEIRA,23,2,326,"[240,480]",Elevado,,,,23,Norte,VISEU,1815,26610.85,7125,417,330,294,328,328,656,950,1280,1697,26.77,6.38,4.81,3.57
29-07-2021,SÃO PEDRO DO SUL,13,1,84,"[0,120]",Baixo a Moderado,,,,13,Centro,VISEU,1816,34895.09,15403,990,962,861,759,909,1668,2529,3491,4481,44.14,12.84,10.0,7.25
29-07-2021,SÃO ROQUE DO PICO,1,0,31,"[0,120]",Baixo a Moderado,,,,1,Açores,AÇORES,4603,14236.1,3266,199,141,93,96,113,209,302,443,642,22.94,4.51,3.11,2.12
29-07-2021,SÃO VICENTE,0,0,0,"[0,120]",Baixo a Moderado,,,,0,Madeira,MADEIRA,3110,7883.71,5143,272,264,266,225,280,505,771,1035,1307,65.23,16.58,13.13,9.78
29-07-2021,SARDOAL,5,0,135,"[120,240]",Moderado,,,,5,Lisboa e Vale do Tejo,SANTARÉM,1417,9214.72,3741,227,178,148,165,248,413,561,739,966,40.6,10.48,8.02,6.09
29-07-2021,SÁTÃO,16,1,138,"[120,240]",Moderado,,,,16,Centro,VISEU,1817,20194.11,11580,765,671,515,465,476,941,1456,2127,2892,57.34,14.32,10.53,7.21
29-07-2021,SEIA,24,2,108,"[0,120]",Baixo a Moderado,,,,24,Centro,GUARDA,0912,43568.83,22234,1807,1589,1238,1122,721,1843,3081,4670,6477,51.03,14.87,10.72,7.07
29-07-2021,SEIXAL,683,49,407,"[240,480]",Elevado,,,,683,Lisboa e Vale do Tejo,SETÚBAL,1510,9545.17,167752,10586,9270,6661,4391,2930,7321,13982,23252,33838,1757.49,354.51,243.6,146.49
29-07-2021,SERNANCELHE,4,0,74,"[0,120]",Baixo a Moderado,,,,4,Norte,VISEU,1818,22861.22,5396,305,293,286,273,260,533,819,1112,1417,23.6,6.2,4.86,3.58
29-07-2021,SERPA,63,4,437,"[240,480]",Elevado,,,,63,Alentejo,BEJA,0213,110563.34,14304,903,761,719,697,626,1323,2042,2803,3706,12.94,3.35,2.54,1.85
29-07-2021,SERTÃ,33,2,227,"[120,240]",Moderado,,,,33,Centro,CASTELO BRANCO,0509,44673.17,14577,870,779,790,767,1020,1787,2577,3356,4226,32.63,9.46,7.51,5.77
29-07-2021,SESIMBRA,228,16,439,"[240,480]",Elevado,,,,228,Lisboa e Vale do Tejo,SETÚBAL,1511,19571.75,51858,2400,2321,1853,1257,1083,2340,4193,6514,8914,264.96,45.54,33.28,21.42
29-07-2021,SETÚBAL,406,29,353,"[240,480]",Elevado,,,,406,Lisboa e Vale do Tejo,SETÚBAL,1512,23032.5,115126,7425,6929,5075,3775,2655,6430,11505,18434,25859,499.83,112.27,80.03,49.95
29-07-2021,SEVER DO VOUGA,20,1,177,"[120,240]",Moderado,,,,20,Centro,AVEIRO,0117,12987.56,11331,766,637,568,540,567,1107,1675,2312,3078,87.24,23.7,17.8,12.9
29-07-2021,SILVES,200,14,552,"[480,960]",Muito Elevado,,,,200,Algarve,FARO,0813,68006.23,36226,2137,1869,1610,1423,1600,3023,4633,6502,8639,53.27,12.7,9.56,6.81
29-07-2021,SINES,187,13,1364,"[960,Max]",Extremamente Elevado,,,,187,Alentejo,SETÚBAL,1513,20330.17,13715,888,791,551,416,268,684,1235,2026,2914,67.46,14.33,9.97,6.07
29-07-2021,SINTRA,1761,126,450,"[240,480]",Elevado,,,,1761,Lisboa e Vale do Tejo,LISBOA,1111,31922.73,391402,20490,18316,13545,9137,7284,16421,29966,48282,68772,1226.08,215.43,151.25,93.87
29-07-2021,SOBRAL DE MONTE AGRAÇO,45,3,425,"[240,480]",Elevado,,,,45,Lisboa e Vale do Tejo,LISBOA,1112,5210.32,10651,564,507,352,272,212,484,836,1343,1907,204.43,36.6,25.78,16.05
29-07-2021,SOURE,29,2,170,"[120,240]",Moderado,,,,29,Centro,COIMBRA,0615,26506.07,17120,1173,1142,1004,883,987,1870,2874,4016,5189,64.59,19.58,15.15,10.84
29-07-2021,SOUSEL,13,1,300,"[240,480]",Elevado,,,,13,Alentejo,PORTALEGRE,1215,27932.18,4412,261,274,208,302,292,594,802,1076,1337,15.8,4.79,3.85,2.87
29-07-2021,TÁBUA,4,0,35,"[0,120]",Baixo a Moderado,,,,4,Centro,COIMBRA,0616,19978.58,11368,729,584,524,430,464,894,1418,2002,2731,56.9,13.67,10.02,7.1
29-07-2021,TABUAÇO,6,0,100,"[0,120]",Baixo a Moderado,,,,6,Norte,VISEU,1819,13385.67,6033,372,314,217,282,363,645,862,1176,1548,45.07,11.56,8.79,6.44
29-07-2021,TAROUCA,17,1,217,"[120,240]",Moderado,,,,17,Norte,VISEU,1820,10008.49,7804,405,335,313,277,324,601,914,1249,1654,77.98,16.53,12.48,9.13
29-07-2021,TAVIRA,81,6,329,"[240,480]",Elevado,,,,81,Algarve,FARO,0814,60696.7,24530,1493,1415,1252,1066,1277,2343,3595,5010,6503,40.41,10.71,8.25,5.92
29-07-2021,TERRAS DE BOURO,20,1,317,"[240,480]",Elevado,,,,20,Norte,BRAGA,0310,27746.07,6361,391,372,296,319,340,659,955,1327,1718,22.93,6.19,4.78,3.44
29-07-2021,TOMAR,73,5,199,"[120,240]",Moderado,,,,73,Lisboa e Vale do Tejo,SANTARÉM,1418,35120.44,36748,2403,2189,1868,1853,1822,3675,5543,7732,10135,104.64,28.86,22.02,15.78
29-07-2021,TONDELA,58,4,220,"[120,240]",Moderado,,,,58,Centro,VISEU,1821,37121.73,26357,1768,1722,1518,1475,1417,2892,4410,6132,7900,71.0,21.28,16.52,11.88
29-07-2021,TORRE DE MONCORVO,2,0,26,"[0,120]",Baixo a Moderado,,,,2,Norte,BRAGANÇA,0409,53155.67,7695,556,478,488,551,719,1270,1758,2236,2792,14.48,5.25,4.21,3.31
29-07-2021,TORRES NOVAS,82,6,234,"[120,240]",Moderado,,,,82,Lisboa e Vale do Tejo,SANTARÉM,1419,26999.68,34933,2324,1979,1738,1406,1475,2881,4619,6598,8922,129.38,33.04,24.44,17.11
29-07-2021,TORRES VEDRAS,159,11,203,"[120,240]",Moderado,,,,159,Lisboa e Vale do Tejo,LISBOA,1113,40714.89,78530,4513,3945,3447,2628,2104,4732,8179,12124,16637,192.88,40.86,29.78,20.09
29-07-2021,TRANCOSO,14,1,157,"[120,240]",Moderado,,,,14,Centro,GUARDA,0913,36152.47,8875,581,557,542,586,496,1082,1624,2181,2762,24.55,7.64,6.03,4.49
29-07-2021,TROFA,169,12,439,"[240,480]",Elevado,,,,169,Norte,PORTO,1318,7201.76,38418,2336,1894,1231,939,684,1623,2854,4748,7084,533.44,98.36,65.93,39.63
29-07-2021,VAGOS,43,3,187,"[120,240]",Moderado,,,,43,Centro,AVEIRO,0118,16491.5,22740,1320,1205,922,784,724,1508,2430,3635,4955,137.89,30.04,22.04,14.73
29-07-2021,VALE DE CAMBRA,46,3,217,"[120,240]",Moderado,,,,46,Norte,AVEIRO,0119,14733.47,21327,1491,1363,1005,831,798,1629,2634,3997,5488,144.76,37.25,27.13,17.88
29-07-2021,VALENÇA,25,2,189,"[120,240]",Moderado,,,,25,Norte,VIANA DO CASTELO,1608,11712.86,13290,867,791,582,582,503,1085,1667,2458,3325,113.46,28.39,20.99,14.23
29-07-2021,VALONGO,500,36,513,"[480,960]",Muito Elevado,,,,500,Norte,PORTO,1315,7512.45,97444,5629,4696,3207,2462,1829,4291,7498,12194,17823,1297.18,237.26,162.33,99.81
29-07-2021,VALPAÇOS,40,3,273,"[240,480]",Elevado,,,,40,Norte,VILA REAL,1712,54873.93,14818,1217,1118,999,928,997,1925,2924,4042,5259,27.0,9.58,7.37,5.33
29-07-2021,VELAS,3,0,59,"[0,120]",Baixo a Moderado,,,,3,Açores,AÇORES,4502,11738.38,5093,278,208,166,153,113,266,432,640,918,43.39,7.82,5.45,3.68
29-07-2021,VENDAS NOVAS,34,2,304,"[240,480]",Elevado,,,,34,Alentejo,ÉVORA,0712,22238.88,11255,677,768,655,501,532,1033,1688,2456,3133,50.61,14.09,11.04,7.59
29-07-2021,VIANA DO ALENTEJO,16,1,313,"[240,480]",Elevado,,,,16,Alentejo,ÉVORA,0713,39367.29,5145,245,208,235,210,214,424,659,867,1112,13.07,2.82,2.2,1.67
29-07-2021,VIANA DO CASTELO,152,11,180,"[120,240]",Moderado,,,,152,Norte,VIANA DO CASTELO,1609,31902.01,84417,5470,4433,3591,3061,2982,6043,9634,14067,19537,264.61,61.24,44.09,30.2
29-07-2021,VIDIGUEIRA,20,1,365,"[240,480]",Elevado,,,,20,Alentejo,BEJA,0214,31661.09,5510,300,248,215,233,275,508,723,971,1271,17.4,4.01,3.07,2.28
29-07-2021,VIEIRA DO MINHO,26,2,221,"[120,240]",Moderado,,,,26,Norte,BRAGA,0311,21644.35,11842,703,594,525,548,482,1030,1555,2149,2852,54.71,13.18,9.93,7.18
29-07-2021,VILA DE REI,4,0,120,"[120,240]",Moderado,,,,4,Centro,CASTELO BRANCO,0510,19154.6,3323,169,128,172,247,302,549,721,849,1018,17.35,5.31,4.43,3.76
29-07-2021,VILA DO BISPO,33,2,641,"[480,960]",Muito Elevado,,,,33,Algarve,FARO,0815,17906.06,5154,302,302,314,232,233,465,779,1081,1383,28.78,7.72,6.04,4.35
29-07-2021,VILA DO CONDE,382,27,478,"[240,480]",Elevado,,,,382,Norte,PORTO,1316,14902.77,79899,4726,3875,2819,2070,1743,3813,6632,10507,15233,536.13,102.21,70.5,44.5
29-07-2021,VILA DO PORTO,8,1,143,"[120,240]",Moderado,,,,8,Açores,AÇORES,4101,9688.74,5616,274,212,135,96,123,219,354,566,840,57.96,8.67,5.84,3.65
29-07-2021,VILA FLOR,23,2,383,"[240,480]",Elevado,,,,23,Norte,BRAGANÇA,0410,26581.14,6044,429,362,422,294,331,625,1047,1409,1838,22.74,6.91,5.3,3.94
29-07-2021,VILA FRANCA DE XIRA,730,52,514,"[480,960]",Muito Elevado,,,,730,Lisboa e Vale do Tejo,LISBOA,1114,31819.39,141957,8501,6852,4869,3425,2472,5897,10766,17618,26119,446.14,82.09,55.37,33.84
29-07-2021,VILA FRANCA DO CAMPO,20,1,182,"[120,240]",Moderado,,,,20,Açores,AÇORES,4206,7796.82,11051,450,344,248,217,154,371,619,963,1413,141.73,18.12,12.35,7.94
29-07-2021,VILA NOVA DA BARQUINHA,5,0,66,"[0,120]",Baixo a Moderado,,,,5,Lisboa e Vale do Tejo,SANTARÉM,1420,4952.97,7461,415,406,392,364,338,702,1094,1500,1915,150.64,38.66,30.28,22.09
29-07-2021,VILA NOVA DE CERVEIRA,18,1,202,"[120,240]",Moderado,,,,18,Norte,VIANA DO CASTELO,1610,10846.66,8910,531,444,410,384,334,718,1128,1572,2103,82.14,19.39,14.49,10.4
29-07-2021,VILA NOVA DE FAMALICÃO,524,37,398,"[240,480]",Elevado,,,,524,Norte,BRAGA,0312,20159.26,131676,7817,6164,4202,3282,2749,6031,10233,16397,24214,653.19,120.12,81.34,50.76
29-07-2021,VILA NOVA DE FOZ CÔA,27,2,420,"[240,480]",Elevado,,,,27,Centro,GUARDA,0914,39815.18,6503,442,385,390,398,429,827,1217,1602,2044,16.33,5.13,4.02,3.06
29-07-2021,VILA NOVA DE GAIA,1689,121,562,"[480,960]",Muito Elevado,,,,1689,Norte,PORTO,1317,16846.43,300472,18349,15568,10972,8224,6281,14505,25477,41045,59394,1783.64,352.57,243.65,151.23
29-07-2021,VILA NOVA DE PAIVA,10,1,213,"[120,240]",Moderado,,,,10,Centro,VISEU,1822,17553.28,4687,289,272,233,217,241,458,691,963,1252,26.7,7.13,5.49,3.94
29-07-2021,VILA NOVA DE POIARES,8,1,115,"[0,120]",Baixo a Moderado,,,,8,Centro,COIMBRA,0617,8445.3,6939,380,284,262,235,182,417,679,963,1343,82.17,15.9,11.4,8.04
29-07-2021,VILA POUCA DE AGUIAR,33,2,278,"[240,480]",Elevado,,,,33,Norte,VILA REAL,1713,43706.62,11961,860,817,733,601,627,1228,1961,2778,3638,27.37,8.32,6.36,4.49
29-07-2021,VILA REAL,314,22,628,"[480,960]",Muito Elevado,,,,314,Norte,VILA REAL,1714,37880.28,49962,3025,2498,2065,1579,1466,3045,5110,7608,10633,131.9,28.07,20.08,13.49
29-07-2021,VILA REAL DE SANTO ANTÓNIO,83,6,445,"[240,480]",Elevado,,,,83,Algarve,FARO,0816,6125.0,18749,1172,1069,811,569,586,1155,1966,3035,4207,306.11,68.69,49.55,32.1
29-07-2021,VILA VELHA DE RÓDÃO,0,0,0,"[0,120]",Baixo a Moderado,,,,0,Centro,CASTELO BRANCO,0511,32991.16,3144,209,229,180,283,306,589,769,998,1207,9.53,3.66,3.03,2.33
29-07-2021,VILA VERDE,121,9,259,"[240,480]",Elevado,,,,121,Norte,BRAGA,0313,22866.52,46911,2365,2063,1667,1494,1437,2931,4598,6661,9026,205.15,39.47,29.13,20.11
29-07-2021,VILA VIÇOSA,28,2,370,"[240,480]",Elevado,,,,28,Alentejo,ÉVORA,0714,19485.89,7656,487,379,342,345,324,669,1011,1390,1877,39.29,9.63,7.13,5.19
29-07-2021,VIMIOSO,3,0,76,"[0,120]",Baixo a Moderado,,,,3,Norte,BRAGANÇA,0411,48158.51,4023,274,230,261,293,335,628,889,1119,1393,8.35,2.89,2.32,1.85
29-07-2021,VINHAIS,12,1,158,"[120,240]",Moderado,,,,12,Norte,BRAGANÇA,0412,69475.09,7746,599,577,636,641,815,1456,2092,2669,3268,11.15,4.7,3.84,3.01
29-07-2021,VISEU,358,26,368,"[240,480]",Elevado,,,,358,Centro,VISEU,1823,50710.14,97249,5769,5038,4140,3158,2710,5868,10008,15046,20815,191.77,41.05,29.67,19.74
29-07-2021,VIZELA,77,5,322,"[240,480]",Elevado,,,,77,Norte,BRAGA,0314,2469.83,23897,1258,928,655,509,371,880,1535,2463,3721,967.49,150.65,99.72,62.15
29-07-2021,VOUZELA,14,1,145,"[120,240]",Moderado,,,,14,Centro,VISEU,1824,19369.46,9619,626,605,554,532,507,1039,1593,2198,2824,49.66,14.58,11.35,8.22
05-08-2021,ABRANTES,55,4,157,"[120,240]",Moderado,,,,55,Lisboa e Vale do Tejo,SANTARÉM,1401,71469.08,35130,2473,2213,1730,1748,2021,3769,5499,7712,10185,49.15,14.25,10.79,7.69
05-08-2021,ÁGUEDA,216,15,468,"[240,480]",Elevado,,,,216,Centro,AVEIRO,0101,33527.44,46075,3237,2713,2090,1635,1496,3131,5221,7934,11171,137.43,33.32,23.66,15.57
05-08-2021,AGUIAR DA BEIRA,2,0,43,"[0,120]",Baixo a Moderado,,,,2,Centro,GUARDA,0901,20676.57,4652,304,281,235,239,148,387,622,903,1207,22.5,5.84,4.37,3.01
05-08-2021,ALANDROAL,10,1,204,"[120,240]",Moderado,,,,10,Alentejo,ÉVORA,0701,54267.81,4992,307,256,296,299,377,676,972,1228,1535,9.2,2.83,2.26,1.79
05-08-2021,ALBERGARIA-A-VELHA,19,1,78,"[0,120]",Baixo a Moderado,,,,19,Centro,AVEIRO,0102,15882.5,24144,1550,1298,996,687,680,1367,2363,3661,5211,152.02,32.81,23.05,14.88
05-08-2021,ALBUFEIRA,286,20,689,"[480,960]",Muito Elevado,,,,286,Algarve,FARO,0801,14066.42,41528,2067,1717,1425,985,858,1843,3268,4985,7052,295.24,50.14,35.44,23.23
05-08-2021,ALCÁCER DO SAL,10,1,87,"[0,120]",Baixo a Moderado,,,,10,Alentejo,SETÚBAL,1501,149987.3,11659,884,814,623,623,602,1225,1848,2662,3546,7.77,2.36,1.77,1.23
05-08-2021,ALCANENA,49,3,381,"[240,480]",Elevado,,,,49,Lisboa e Vale do Tejo,SANTARÉM,1402,12732.86,12809,891,744,628,536,588,1124,1752,2496,3387,100.6,26.6,19.6,13.76
05-08-2021,ALCOBAÇA,87,6,162,"[120,240]",Moderado,,,,87,Lisboa e Vale do Tejo,LEIRIA,1001,40814.09,53555,3420,2927,2466,2059,1676,3735,6201,9128,12548,131.22,30.74,22.36,15.19
05-08-2021,ALCOCHETE,29,2,145,"[120,240]",Moderado,,,,29,Lisboa e Vale do Tejo,SETÚBAL,1502,12836.48,19787,857,834,691,476,447,923,1614,2448,3305,154.15,25.75,19.07,12.57
05-08-2021,ALCOUTIM,14,1,626,"[480,960]",Muito Elevado,,,,14,Algarve,FARO,0802,57536.33,2159,191,188,163,190,267,457,620,808,999,3.75,1.74,1.4,1.08
05-08-2021,ALENQUER,118,8,268,"[240,480]",Elevado,,,,118,Lisboa e Vale do Tejo,LISBOA,1101,30421.92,44052,2298,2062,1629,1330,1155,2485,4114,6176,8474,144.8,27.85,20.3,13.52
05-08-2021,ALFÂNDEGA DA FÉ,3,0,67,"[0,120]",Baixo a Moderado,,,,3,Norte,BRAGANÇA,0401,32194.64,4550,325,277,301,274,325,599,900,1177,1502,14.13,4.67,3.66,2.8
05-08-2021,ALIJÓ,23,2,218,"[120,240]",Moderado,,,,23,Norte,VILA REAL,1701,29759.89,10625,766,687,635,542,666,1208,1843,2530,3296,35.7,11.08,8.5,6.19
05-08-2021,ALJEZUR,14,1,250,"[240,480]",Elevado,,,,14,Algarve,FARO,0803,32349.95,5594,316,336,335,320,410,730,1065,1401,1717,17.29,5.31,4.33,3.29
05-08-2021,ALJUSTREL,22,2,270,"[240,480]",Elevado,,,,22,Alentejo,BEJA,0201,45847.41,8247,635,521,443,347,358,705,1148,1669,2304,17.99,5.03,3.64,2.5
05-08-2021,ALMADA,632,45,374,"[240,480]",Elevado,,,,632,Lisboa e Vale do Tejo,SETÚBAL,1503,7000.89,169039,10469,9777,7876,6144,5111,11255,19131,28908,39377,2414.5,562.45,412.91,273.26
05-08-2021,ALMEIDA,2,0,35,"[0,120]",Baixo a Moderado,,,,2,Centro,GUARDA,0902,51798.46,5830,441,419,396,458,393,851,1247,1666,2107,11.26,4.07,3.22,2.41
05-08-2021,ALMEIRIM,42,3,187,"[120,240]",Moderado,,,,42,Lisboa e Vale do Tejo,SANTARÉM,1403,22212.05,22546,1342,1353,1106,866,843,1709,2815,4168,5510,101.5,24.81,18.76,12.67
05-08-2021,ALMODÔVAR,29,2,435,"[240,480]",Elevado,,,,29,Alentejo,BEJA,0202,77788.03,6725,414,443,396,373,328,701,1097,1540,1954,8.65,2.51,1.98,1.41
05-08-2021,ALPIARÇA,14,1,200,"[120,240]",Moderado,,,,14,Lisboa e Vale do Tejo,SANTARÉM,1404,9536.33,7059,515,486,363,333,274,607,970,1456,1971,74.02,20.67,15.27,10.17
05-08-2021,ALTER DO CHÃO,8,1,255,"[240,480]",Elevado,,,,8,Alentejo,PORTALEGRE,1201,36206.62,3165,201,163,136,208,187,395,531,694,895,8.74,2.47,1.92,1.47
05-08-2021,ALVAIÁZERE,1,0,15,"[0,120]",Baixo a Moderado,,,,1,Centro,LEIRIA,1002,16047.76,6597,419,389,346,406,539,945,1291,1680,2099,41.11,13.08,10.47,8.04
05-08-2021,ALVITO,4,0,162,"[120,240]",Moderado,,,,4,Alentejo,BEJA,0203,26485.32,2477,145,110,105,111,89,200,305,415,560,9.35,2.11,1.57,1.15
05-08-2021,AMADORA,714,51,388,"[240,480]",Elevado,,,,714,Lisboa e Vale do Tejo,LISBOA,1115,2378.47,184106,11186,10936,8780,6460,5890,12350,21130,32066,43252,7742.05,1818.84,1348.44,888.56
05-08-2021,AMARANTE,251,18,471,"[240,480]",Elevado,,,,251,Norte,PORTO,1301,30133.15,53193,3086,2413,1812,1643,1311,2954,4766,7179,10265,176.53,34.07,23.82,15.82
05-08-2021,AMARES,52,4,287,"[240,480]",Elevado,,,,52,Norte,BRAGA,0301,8195.41,18129,1001,829,622,489,524,1013,1635,2464,3465,221.22,42.28,30.07,19.95
05-08-2021,ANADIA,63,4,230,"[120,240]",Moderado,,,,63,Centro,AVEIRO,0103,21663.48,27258,1931,1698,1376,1208,1262,2470,3846,5544,7475,125.83,34.51,25.59,17.75
05-08-2021,ANGRA DO HEROÍSMO,95,7,282,"[240,480]",Elevado,,,,95,Açores,AÇORES,4301,23899.66,33807,2006,1473,1122,768,635,1403,2525,3998,6004,141.45,25.12,16.73,10.56
05-08-2021,ANSIÃO,4,0,33,"[0,120]",Baixo a Moderado,,,,4,Centro,LEIRIA,1003,17609.42,12039,727,709,646,694,530,1224,1870,2579,3306,68.37,18.77,14.65,10.62
05-08-2021,ARCOS DE VALDEVEZ,22,2,106,"[0,120]",Baixo a Moderado,,,,22,Norte,VIANA DO CASTELO,1601,44759.64,20926,1329,1338,1282,1343,1515,2858,4140,5478,6807,46.75,15.21,12.24,9.25
05-08-2021,ARGANIL,20,1,182,"[120,240]",Moderado,,,,20,Centro,COIMBRA,0601,33283.93,11014,672,648,612,559,596,1155,1767,2415,3087,33.09,9.27,7.26,5.31
05-08-2021,ARMAMAR,5,0,87,"[0,120]",Baixo a Moderado,,,,5,Norte,VISEU,1801,11723.73,5769,357,305,309,285,310,595,904,1209,1566,49.21,13.36,10.31,7.71
05-08-2021,AROUCA,73,5,354,"[240,480]",Elevado,,,,73,Norte,AVEIRO,0104,32910.52,20720,1306,1047,753,683,683,1366,2119,3166,4472,62.96,13.59,9.62,6.44
05-08-2021,ARRAIOLOS,18,1,262,"[240,480]",Elevado,,,,18,Alentejo,ÉVORA,0702,68374.55,6928,435,384,283,367,480,847,1130,1514,1949,10.13,2.85,2.21,1.65
05-08-2021,ARRONCHES,1,0,36,"[0,120]",Baixo a Moderado,,,,1,Alentejo,PORTALEGRE,1202,31464.72,2820,155,142,162,187,179,366,528,670,825,8.96,2.62,2.13,1.68
05-08-2021,ARRUDA DOS VINHOS,17,1,108,"[0,120]",Baixo a Moderado,,,,17,Lisboa e Vale do Tejo,LISBOA,1102,7795.93,15412,738,738,562,509,438,947,1509,2247,2985,197.69,38.29,28.82,19.36
05-08-2021,AVEIRO,181,13,230,"[120,240]",Moderado,,,,181,Centro,AVEIRO,0105,19757.57,78734,4520,4004,3050,2250,2103,4353,7403,11407,15927,398.49,80.61,57.73,37.47
05-08-2021,AVIS,7,1,167,"[120,240]",Moderado,,,,7,Alentejo,PORTALEGRE,1203,60596.51,4247,315,225,206,251,273,524,730,955,1270,7.01,2.1,1.58,1.2
05-08-2021,AZAMBUJA,66,5,289,"[240,480]",Elevado,,,,66,Lisboa e Vale do Tejo,LISBOA,1103,26265.65,22716,1322,1171,1070,798,618,1416,2486,3657,4979,86.48,18.96,13.92,9.46
05-08-2021,BAIÃO,53,4,285,"[240,480]",Elevado,,,,53,Norte,PORTO,1302,17452.83,18748,1070,862,714,686,725,1411,2125,2987,4057,107.42,23.25,17.11,12.18
05-08-2021,BARCELOS,277,20,238,"[120,240]",Moderado,,,,277,Norte,BRAGA,0302,37890.14,116187,6721,5325,3619,2991,2562,5553,9172,14497,21218,306.64,56.0,38.26,24.21
05-08-2021,BARRANCOS,1,0,62,"[0,120]",Baixo a Moderado,,,,1,Alentejo,BEJA,0204,16841.73,1634,90,65,65,94,61,155,220,285,375,9.7,2.23,1.69,1.31
05-08-2021,BARREIRO,334,24,444,"[240,480]",Elevado,,,,334,Lisboa e Vale do Tejo,SETÚBAL,1504,3639.07,75147,5194,5565,4459,3105,1767,4872,9331,14896,20090,2065.05,552.07,409.34,256.42
05-08-2021,BATALHA,63,5,396,"[240,480]",Elevado,,,,63,Centro,LEIRIA,1004,10341.6,15963,873,762,649,529,549,1078,1727,2489,3362,154.35,32.51,24.07,16.7
05-08-2021,BEJA,182,13,543,"[480,960]",Muito Elevado,,,,182,Alentejo,BEJA,0205,114647.55,33579,2005,1840,1386,1272,1039,2311,3697,5537,7542,29.29,6.58,4.83,3.22
05-08-2021,BELMONTE,7,1,110,"[0,120]",Baixo a Moderado,,,,7,Centro,CASTELO BRANCO,0501,11875.91,6398,444,321,325,310,355,665,990,1311,1755,53.87,14.78,11.04,8.34
05-08-2021,BENAVENTE,72,5,234,"[120,240]",Moderado,,,,72,Lisboa e Vale do Tejo,SANTARÉM,1405,52138.39,30602,1468,1376,1141,876,643,1519,2660,4036,5504,58.69,10.56,7.74,5.1
05-08-2021,BOMBARRAL,10,1,79,"[0,120]",Baixo a Moderado,,,,10,Lisboa e Vale do Tejo,LEIRIA,1005,9128.55,12558,875,714,561,491,429,920,1481,2195,3070,137.56,33.63,24.04,16.22
05-08-2021,BORBA,7,1,105,"[0,120]",Baixo a Moderado,,,,7,Alentejo,ÉVORA,0703,14518.65,6736,430,375,279,436,392,828,1107,1482,1912,46.39,13.17,10.21,7.62
05-08-2021,BOTICAS,15,1,305,"[240,480]",Elevado,,,,15,Norte,VILA REAL,1702,32195.66,4998,347,306,311,305,380,685,996,1302,1649,15.52,5.12,4.04,3.09
05-08-2021,BRAGA,647,46,354,"[240,480]",Elevado,,,,647,Norte,BRAGA,0303,18339.95,182679,10029,7963,5241,4320,3671,7991,13232,21195,31224,996.07,170.25,115.57,72.15
05-08-2021,BRAGANÇA,81,6,242,"[240,480]",Elevado,,,,81,Norte,BRAGANÇA,0402,117357.27,33607,2402,1855,1652,1393,1163,2556,4208,6063,8465,28.64,7.21,5.17,3.59
05-08-2021,CABECEIRAS DE BASTO,36,3,232,"[120,240]",Moderado,,,,36,Norte,BRAGA,0304,24182.16,15628,774,594,544,575,574,1149,1693,2287,3061,64.63,12.66,9.46,7.0
05-08-2021,CADAVAL,28,2,204,"[120,240]",Moderado,,,,28,Lisboa e Vale do Tejo,LISBOA,1104,17489.3,13673,813,796,756,621,625,1246,2002,2798,3611,78.18,20.65,16.0,11.45
05-08-2021,CALDAS DA RAINHA,121,9,234,"[120,240]",Moderado,,,,121,Lisboa e Vale do Tejo,LEIRIA,1006,25569.47,51912,3035,2684,2186,1899,1705,3604,5790,8474,11509,203.03,45.01,33.14,22.64
05-08-2021,CALHETA,8,1,74,"[0,120]",Baixo a Moderado,,,,8,Madeira,MADEIRA,3101,11150.43,10867,576,497,507,399,415,814,1321,1818,2394,97.46,21.47,16.3,11.85
05-08-2021,CALHETA (AÇORES),0,0,0,"[0,120]",Baixo a Moderado,,,,0,Açores,AÇORES,4501,12626.4,3184,215,159,141,139,122,261,402,561,776,25.22,6.15,4.44,3.18
05-08-2021,CÂMARA DE LOBOS,25,2,74,"[0,120]",Baixo a Moderado,,,,25,Madeira,MADEIRA,3102,5216.67,33675,1396,1059,834,545,381,926,1760,2819,4215,645.49,80.79,54.03,33.74
05-08-2021,CAMINHA,22,2,139,"[120,240]",Moderado,,,,22,Norte,VIANA DO CASTELO,1602,13652.14,15877,1046,944,818,646,656,1302,2120,3064,4110,116.3,30.11,22.44,15.53
05-08-2021,CAMPO MAIOR,13,1,167,"[120,240]",Moderado,,,,13,Alentejo,PORTALEGRE,1204,24720.16,7874,471,364,351,279,327,606,957,1321,1792,31.85,7.25,5.34,3.87
05-08-2021,CANTANHEDE,39,3,111,"[0,120]",Baixo a Moderado,,,,39,Centro,COIMBRA,0602,39088.02,35011,2346,2096,1880,1709,1451,3160,5040,7136,9482,89.57,24.26,18.26,12.89
05-08-2021,CARRAZEDA DE ANSIÃES,8,1,143,"[120,240]",Moderado,,,,8,Norte,BRAGANÇA,0403,27924.09,5666,424,389,391,312,465,777,1168,1557,1981,20.29,7.09,5.58,4.18
05-08-2021,CARREGAL DO SAL,12,1,129,"[120,240]",Moderado,,,,12,Centro,VISEU,1802,11689.21,9271,587,562,486,462,376,838,1324,1886,2473,79.31,21.16,16.13,11.33
05-08-2021,CARTAXO,47,3,198,"[120,240]",Moderado,,,,47,Lisboa e Vale do Tejo,SANTARÉM,1406,15817.28,23843,1415,1376,1142,861,632,1493,2635,4011,5426,150.74,34.3,25.36,16.66
05-08-2021,CASCAIS,874,62,409,"[240,480]",Elevado,,,,874,Lisboa e Vale do Tejo,LISBOA,1105,9740.17,213608,12151,11444,8680,6469,5248,11717,20397,31841,43992,2193.1,451.66,326.91,209.41
05-08-2021,CASTANHEIRA DE PÊRA,0,0,0,"[0,120]",Baixo a Moderado,,,,0,Centro,LEIRIA,1007,6677.45,2614,233,195,157,190,187,377,534,729,962,39.15,14.41,10.92,8.0
05-08-2021,CASTELO BRANCO,111,8,213,"[120,240]",Moderado,,,,111,Centro,CASTELO BRANCO,0502,143819.15,51987,3528,3042,2499,2229,2225,4454,6953,9995,13523,36.15,9.4,6.95,4.83
05-08-2021,CASTELO DE PAIVA,32,2,209,"[120,240]",Moderado,,,,32,Norte,AVEIRO,0106,11500.53,15454,881,697,545,420,431,851,1396,2093,2974,134.37,25.86,18.2,12.14
05-08-2021,CASTELO DE VIDE,3,0,104,"[0,120]",Baixo a Moderado,,,,3,Alentejo,PORTALEGRE,1205,26491.24,2919,204,173,179,147,170,317,496,669,873,11.02,3.3,2.53,1.87
05-08-2021,CASTRO DAIRE,22,2,159,"[120,240]",Moderado,,,,22,Centro,VISEU,1803,37904.13,13823,942,857,765,732,773,1505,2270,3127,4069,36.47,10.74,8.25,5.99
05-08-2021,CASTRO MARIM,33,2,532,"[480,960]",Muito Elevado,,,,33,Algarve,FARO,0804,30084.37,6237,370,345,334,322,344,666,1000,1345,1715,20.73,5.7,4.47,3.32
05-08-2021,CASTRO VERDE,26,2,377,"[240,480]",Elevado,,,,26,Alentejo,BEJA,0206,56944.23,6949,437,347,303,275,227,502,805,1152,1589,12.2,2.79,2.02,1.41
05-08-2021,CELORICO DA BEIRA,5,0,72,"[0,120]",Baixo a Moderado,,,,5,Centro,GUARDA,0903,24721.63,6928,430,416,363,369,535,904,1267,1683,2113,28.02,8.55,6.81,5.12
05-08-2021,CELORICO DE BASTO,53,4,280,"[240,480]",Elevado,,,,53,Norte,BRAGA,0305,18107.02,19040,1001,802,668,728,729,1457,2125,2927,3928,105.15,21.69,16.17,11.74
05-08-2021,CHAMUSCA,19,1,210,"[120,240]",Moderado,,,,19,Lisboa e Vale do Tejo,SANTARÉM,1407,74600.54,9197,629,583,553,465,579,1044,1597,2180,2809,12.33,3.77,2.92,2.14
05-08-2021,CHAVES,82,6,209,"[120,240]",Moderado,,,,82,Norte,VILA REAL,1703,59122.95,39343,2676,2429,1991,1886,1918,3804,5795,8224,10900,66.54,18.44,13.91,9.8
05-08-2021,CINFÃES,60,4,328,"[240,480]",Elevado,,,,60,Norte,VISEU,1804,23928.76,18244,1067,902,779,734,758,1492,2271,3173,4240,76.24,17.72,13.26,9.49
05-08-2021,COIMBRA,254,18,189,"[120,240]",Moderado,,,,254,Centro,COIMBRA,0603,31939.94,134166,9489,8734,6353,5139,5074,10213,16566,25300,34789,420.06,108.92,79.21,51.87
05-08-2021,CONDEIXA-A-NOVA,16,1,89,"[0,120]",Baixo a Moderado,,,,16,Centro,COIMBRA,0604,13867.47,17733,871,809,717,583,490,1073,1790,2599,3470,127.88,25.02,18.74,12.91
05-08-2021,CONSTÂNCIA,11,1,272,"[240,480]",Elevado,,,,11,Lisboa e Vale do Tejo,SANTARÉM,1408,8036.58,4030,211,183,187,148,155,303,490,673,884,50.14,11.0,8.37,6.1
05-08-2021,CORUCHE,25,2,145,"[120,240]",Moderado,,,,25,Lisboa e Vale do Tejo,SANTARÉM,1409,111572.03,17471,1294,1090,1095,1096,1019,2115,3210,4300,5594,15.66,5.01,3.85,2.88
05-08-2021,CORVO,0,0,0,"[0,120]",Baixo a Moderado,,,,0,Açores,AÇORES,4901,1711.45,464,22,21,11,13,19,32,43,64,86,27.12,5.03,3.74,2.51
05-08-2021,COVILHÃ,28,2,60,"[0,120]",Baixo a Moderado,,,,28,Centro,CASTELO BRANCO,0503,55560.06,46787,3533,2998,2365,2111,2193,4304,6669,9667,13200,84.21,23.76,17.4,12.0
05-08-2021,CRATO,2,0,65,"[0,120]",Baixo a Moderado,,,,2,Alentejo,PORTALEGRE,1206,39806.88,3129,229,258,163,182,228,410,573,831,1060,7.86,2.66,2.09,1.44
05-08-2021,CUBA,23,2,506,"[480,960]",Muito Elevado,,,,23,Alentejo,BEJA,0207,17208.72,4595,255,233,206,190,143,333,539,772,1027,26.7,5.97,4.49,3.13
05-08-2021,ELVAS,45,3,217,"[120,240]",Moderado,,,,45,Alentejo,PORTALEGRE,1207,63128.86,20528,1057,1145,902,852,810,1662,2564,3709,4766,32.52,7.55,5.88,4.06
05-08-2021,ENTRONCAMENTO,83,6,383,"[240,480]",Elevado,,,,83,Lisboa e Vale do Tejo,SANTARÉM,1410,1372.81,21558,1066,930,868,695,592,1287,2155,3085,4151,1570.14,302.33,224.69,156.96
05-08-2021,ESPINHO,129,9,438,"[240,480]",Elevado,,,,129,Norte,AVEIRO,0107,2105.68,29516,2205,1993,1430,1177,960,2137,3567,5560,7765,1401.52,368.71,264.01,169.37
05-08-2021,ESPOSENDE,178,13,521,"[480,960]",Muito Elevado,,,,178,Norte,BRAGA,0306,9540.98,34177,1831,1522,1095,894,723,1617,2712,4234,6065,358.21,63.57,44.38,28.42
05-08-2021,ESTARREJA,31,2,119,"[0,120]",Baixo a Moderado,,,,31,Centro,AVEIRO,0108,10817.33,26006,1503,1399,1106,953,728,1681,2787,4186,5689,240.42,52.59,38.7,25.76
05-08-2021,ESTREMOZ,33,2,262,"[240,480]",Elevado,,,,33,Alentejo,ÉVORA,0704,51379.95,12728,789,613,697,786,877,1663,2360,2973,3762,24.77,7.32,5.79,4.59
05-08-2021,ÉVORA,221,16,422,"[240,480]",Elevado,,,,221,Alentejo,ÉVORA,0705,130707.58,52428,3569,2852,2176,1966,1803,3769,5945,8797,12366,40.11,9.46,6.73,4.55
05-08-2021,FAFE,151,11,314,"[240,480]",Elevado,,,,151,Norte,BRAGA,0307,21908.11,48060,3044,2455,1679,1403,1208,2611,4290,6745,9789,219.37,44.68,30.79,19.58
05-08-2021,FARO,514,37,842,"[480,960]",Muito Elevado,,,,514,Algarve,FARO,0805,20256.79,61015,3847,3364,2604,2055,1601,3656,6260,9624,13471,301.2,66.5,47.51,30.9
05-08-2021,FELGUEIRAS,261,19,463,"[240,480]",Elevado,,,,261,Norte,PORTO,1303,11573.75,56422,2951,2302,1601,1316,973,2289,3890,6192,9143,487.49,79.0,53.5,33.61
05-08-2021,FERREIRA DO ALENTEJO,15,1,192,"[120,240]",Moderado,,,,15,Alentejo,BEJA,0208,64820.68,7845,515,414,372,343,345,688,1060,1474,1989,12.1,3.07,2.27,1.64
05-08-2021,FERREIRA DO ZÊZERE,10,1,126,"[120,240]",Moderado,,,,10,Lisboa e Vale do Tejo,SANTARÉM,1411,19038.03,7959,470,370,416,465,456,921,1337,1707,2177,41.81,11.44,8.97,7.02
05-08-2021,FIGUEIRA DA FOZ,105,7,178,"[120,240]",Moderado,,,,105,Centro,COIMBRA,0605,37905.26,58747,4032,3597,2887,2495,2043,4538,7425,11022,15054,154.98,39.72,29.08,19.59
05-08-2021,FIGUEIRA DE CASTELO RODRIGO,5,0,89,"[0,120]",Baixo a Moderado,,,,5,Centro,GUARDA,0904,50857.46,5584,347,352,290,352,391,743,1033,1385,1732,10.98,3.41,2.72,2.03
05-08-2021,FIGUEIRÓ DOS VINHOS,7,1,126,"[120,240]",Moderado,,,,7,Centro,LEIRIA,1008,17344.0,5568,402,386,322,309,351,660,982,1368,1770,32.1,10.21,7.89,5.66
05-08-2021,FORNOS DE ALGODRES,2,0,44,"[0,120]",Baixo a Moderado,,,,2,Centro,GUARDA,0905,13145.05,4528,261,218,247,256,232,488,735,953,1214,34.45,9.24,7.25,5.59
05-08-2021,FREIXO DE ESPADA À CINTA,1,0,31,"[0,120]",Baixo a Moderado,,,,1,Norte,BRAGANÇA,0404,24414.29,3298,211,177,231,196,189,385,616,793,1004,13.51,4.11,3.25,2.52
05-08-2021,FRONTEIRA,2,0,68,"[0,120]",Baixo a Moderado,,,,2,Alentejo,PORTALEGRE,1208,24859.58,2974,213,182,149,156,168,324,473,655,868,11.96,3.49,2.63,1.9
05-08-2021,FUNCHAL,237,17,228,"[120,240]",Moderado,,,,237,Madeira,MADEIRA,3103,7616.2,104024,6382,5086,3643,2821,1990,4811,8454,13540,19922,1365.86,261.58,177.78,111.0
05-08-2021,FUNDÃO,28,2,106,"[0,120]",Baixo a Moderado,,,,28,Centro,CASTELO BRANCO,0504,70019.79,26495,1781,1464,1432,1357,1643,3000,4432,5896,7677,37.84,10.96,8.42,6.33
05-08-2021,GAVIÃO,4,0,126,"[120,240]",Moderado,,,,4,Alentejo,PORTALEGRE,1209,29459.45,3263,189,186,222,263,293,556,778,964,1153,11.08,3.91,3.27,2.64
05-08-2021,GÓIS,3,0,80,"[0,120]",Baixo a Moderado,,,,3,Centro,COIMBRA,0606,26330.19,3805,235,199,240,233,244,477,717,916,1151,14.45,4.37,3.48,2.72
05-08-2021,GOLEGÃ,4,0,76,"[0,120]",Baixo a Moderado,,,,4,Lisboa e Vale do Tejo,SANTARÉM,1412,8431.67,5339,356,299,281,243,255,498,779,1078,1434,63.32,17.01,12.78,9.24
05-08-2021,GONDOMAR,729,52,439,"[240,480]",Elevado,,,,729,Norte,PORTO,1304,13191.76,165985,10555,8755,6222,4450,3364,7814,14036,22791,33346,1258.22,252.77,172.76,106.4
05-08-2021,GOUVEIA,13,1,105,"[0,120]",Baixo a Moderado,,,,13,Centro,GUARDA,0906,30061.17,12387,871,931,780,783,810,1593,2373,3304,4175,41.21,13.89,10.99,7.89
05-08-2021,GRÂNDOLA,35,3,240,"[240,480]",Elevado,,,,35,Alentejo,SETÚBAL,1505,82593.66,14639,834,834,708,688,672,1360,2068,2902,3736,17.72,4.52,3.51,2.5
05-08-2021,GUARDA,58,4,149,"[120,240]",Moderado,,,,58,Centro,GUARDA,0907,71209.58,38969,2477,2041,1686,1415,1474,2889,4575,6616,9093,54.72,12.77,9.29,6.42
05-08-2021,GUIMARÃES,489,35,321,"[240,480]",Elevado,,,,489,Norte,BRAGA,0308,24099.96,152309,9394,7074,4809,3877,2948,6825,11634,18708,28102,631.99,116.61,77.63,48.27
05-08-2021,HORTA,5,0,35,"[0,120]",Baixo a Moderado,,,,5,Açores,AÇORES,4701,17305.53,14521,818,658,468,352,302,654,1122,1780,2598,83.91,15.01,10.29,6.48
05-08-2021,IDANHA-A-NOVA,3,0,38,"[0,120]",Baixo a Moderado,,,,3,Centro,CASTELO BRANCO,0505,141633.51,8043,518,490,519,672,974,1646,2165,2655,3173,5.68,2.24,1.87,1.53
05-08-2021,ÍLHAVO,106,8,273,"[240,480]",Elevado,,,,106,Centro,AVEIRO,0110,7347.55,38699,2227,1943,1444,1193,850,2043,3487,5430,7657,526.66,104.21,73.9,47.46
05-08-2021,LAGOA (FARO),170,12,747,"[480,960]",Muito Elevado,,,,170,Algarve,FARO,0806,8825.45,22762,1314,1168,919,749,670,1419,2338,3506,4820,257.93,54.62,39.73,26.49
05-08-2021,LAGOA,81,6,549,"[480,960]",Muito Elevado,,,,81,Açores,AÇORES,4201,4559.32,14721,536,458,349,238,235,473,822,1280,1816,322.9,39.83,28.08,18.03
05-08-2021,LAGOS,246,18,809,"[480,960]",Muito Elevado,,,,246,Algarve,FARO,0807,21299.27,30374,1744,1434,1247,1053,1029,2082,3329,4763,6507,142.61,30.55,22.36,15.63
05-08-2021,LAJES DAS FLORES,2,0,137,"[120,240]",Moderado,,,,2,Açores,AÇORES,4801,7004.79,1463,88,53,62,46,54,100,162,215,303,20.89,4.33,3.07,2.31
05-08-2021,LAJES DO PICO,6,0,134,"[120,240]",Moderado,,,,6,Açores,AÇORES,4601,15531.09,4490,304,231,223,159,162,321,544,775,1079,28.91,6.95,4.99,3.5
05-08-2021,LAMEGO,39,3,158,"[120,240]",Moderado,,,,39,Norte,VISEU,1805,16542.11,24895,1639,1284,1124,898,783,1681,2805,4089,5728,150.5,34.63,24.72,16.96
05-08-2021,LEIRIA,467,33,373,"[240,480]",Elevado,,,,467,Centro,LEIRIA,1009,56508.83,125267,7389,6366,5090,3902,3159,7061,12151,18517,25906,221.68,45.84,32.77,21.5
05-08-2021,LISBOA,3032,217,595,"[480,960]",Muito Elevado,,,,3032,Lisboa e Vale do Tejo,LISBOA,1106,10005.43,509515,33197,33340,27706,23037,26770,49807,77513,110853,144050,5092.6,1439.78,1107.98,774.74
05-08-2021,LOULÉ,570,41,830,"[480,960]",Muito Elevado,,,,570,Algarve,FARO,0808,76366.91,68697,3890,3350,2780,2358,2251,4609,7389,10739,14629,89.96,19.16,14.06,9.68
05-08-2021,LOURES,791,56,370,"[240,480]",Elevado,,,,791,Lisboa e Vale do Tejo,LISBOA,1107,16723.99,213687,12746,12794,9644,6669,5033,11702,21346,34140,46886,1277.73,280.35,204.14,127.64
05-08-2021,LOURINHÃ,44,3,172,"[120,240]",Moderado,,,,44,Lisboa e Vale do Tejo,LISBOA,1108,14717.2,25855,1584,1243,992,842,645,1487,2479,3722,5306,175.68,36.05,25.29,16.84
05-08-2021,LOUSÃ,13,1,75,"[0,120]",Baixo a Moderado,,,,13,Centro,COIMBRA,0607,13840.01,17158,946,866,658,528,450,978,1636,2502,3448,123.97,24.91,18.08,11.82
05-08-2021,LOUSADA,277,20,593,"[480,960]",Muito Elevado,,,,277,Norte,PORTO,1305,9608.01,46755,2289,1698,1176,853,621,1474,2650,4348,6637,486.63,69.08,45.25,27.58
05-08-2021,MAÇÃO,17,1,275,"[240,480]",Elevado,,,,17,Lisboa e Vale do Tejo,SANTARÉM,1413,39997.98,6267,386,362,390,440,657,1097,1487,1849,2235,15.67,5.59,4.62,3.72
05-08-2021,MACEDO DE CAVALEIROS,13,1,90,"[0,120]",Baixo a Moderado,,,,13,Norte,BRAGANÇA,0405,69914.08,14516,1082,889,878,823,938,1761,2639,3528,4610,20.76,6.59,5.05,3.77
05-08-2021,MACHICO,40,3,201,"[120,240]",Moderado,,,,40,Madeira,MADEIRA,3104,6825.1,19981,1197,860,662,455,331,786,1448,2308,3505,292.76,51.36,33.82,21.22
05-08-2021,MADALENA,4,0,68,"[0,120]",Baixo a Moderado,,,,4,Açores,AÇORES,4602,14712.33,5895,334,256,173,190,179,369,542,798,1132,40.07,7.69,5.42,3.68
05-08-2021,MAFRA,276,20,325,"[240,480]",Elevado,,,,276,Lisboa e Vale do Tejo,LISBOA,1109,29165.5,84816,3613,3334,2839,2089,1899,3988,6827,10161,13774,290.81,47.23,34.84,23.41
05-08-2021,MAIA,574,41,413,"[240,480]",Elevado,,,,574,Norte,PORTO,1306,8293.94,138971,7801,6617,4512,3339,2631,5970,10482,17099,24900,1675.56,300.22,206.16,126.38
05-08-2021,MANGUALDE,15,1,81,"[0,120]",Baixo a Moderado,,,,15,Centro,VISEU,1806,21925.56,18510,1198,1128,885,852,743,1595,2480,3608,4806,84.42,21.92,16.46,11.31
05-08-2021,MANTEIGAS,3,0,100,"[0,120]",Baixo a Moderado,,,,3,Centro,GUARDA,0908,12197.55,3007,258,197,159,167,146,313,472,669,927,24.65,7.6,5.48,3.87
05-08-2021,MARCO DE CANAVESES,115,8,224,"[120,240]",Moderado,,,,115,Norte,PORTO,1307,20188.98,51496,2678,2060,1488,1265,1023,2288,3776,5836,8514,255.07,42.17,28.91,18.7
05-08-2021,MARINHA GRANDE,115,8,298,"[240,480]",Elevado,,,,115,Centro,LEIRIA,1010,18725.19,38508,2365,2302,1638,1359,1058,2417,4055,6357,8722,205.65,46.58,33.95,21.66
05-08-2021,MARVÃO,0,0,0,"[0,120]",Baixo a Moderado,,,,0,Alentejo,PORTALEGRE,1210,15489.9,3005,198,185,142,197,237,434,576,761,959,19.4,6.19,4.91,3.72
05-08-2021,MATOSINHOS,975,70,556,"[480,960]",Muito Elevado,,,,975,Norte,PORTO,1308,6241.97,175357,11850,9977,7023,5024,3884,8908,15931,25908,37758,2809.31,604.9,415.06,255.22
05-08-2021,MEALHADA,40,3,200,"[120,240]",Moderado,,,,40,Centro,AVEIRO,0111,11065.66,19914,1163,1039,810,828,831,1659,2469,3508,4671,179.96,42.21,31.7,22.31
05-08-2021,MÊDA,4,0,87,"[0,120]",Baixo a Moderado,,,,4,Centro,GUARDA,0909,28604.92,4587,343,306,290,288,443,731,1021,1327,1670,16.04,5.84,4.64,3.57
05-08-2021,MELGAÇO,4,0,50,"[0,120]",Baixo a Moderado,,,,4,Norte,VIANA DO CASTELO,1603,23824.58,8093,507,567,578,614,675,1289,1867,2434,2941,33.97,12.34,10.22,7.84
05-08-2021,MÉRTOLA,28,2,463,"[240,480]",Elevado,,,,28,Alentejo,BEJA,0209,129287.34,6142,400,390,378,423,600,1023,1401,1791,2191,4.75,1.69,1.39,1.08
05-08-2021,MESÃO FRIO,1,0,25,"[0,120]",Baixo a Moderado,,,,1,Norte,VILA REAL,1704,2664.87,3964,265,205,168,157,120,277,445,650,915,148.74,34.33,24.39,16.7
05-08-2021,MIRA,20,1,168,"[120,240]",Moderado,,,,20,Centro,COIMBRA,0608,12403.38,11832,727,729,659,550,466,1016,1675,2404,3131,95.4,25.24,19.38,13.5
05-08-2021,MIRANDA DO CORVO,12,1,94,"[0,120]",Baixo a Moderado,,,,12,Centro,COIMBRA,0609,12637.79,12708,706,659,568,498,404,902,1470,2129,2835,100.55,22.43,16.85,11.63
05-08-2021,MIRANDA DO DOURO,2,0,30,"[0,120]",Baixo a Moderado,,,,2,Norte,BRAGANÇA,0406,48718.31,6830,482,429,442,463,470,933,1375,1804,2286,14.02,4.69,3.7,2.82
05-08-2021,MIRANDELA,126,9,579,"[480,960]",Muito Elevado,,,,126,Norte,BRAGANÇA,0407,65895.67,21754,1640,1315,1204,1078,947,2025,3229,4544,6184,33.01,9.38,6.9,4.9
05-08-2021,MOGADOURO,15,1,181,"[120,240]",Moderado,,,,15,Norte,BRAGANÇA,0408,76064.93,8392,589,529,576,630,655,1285,1861,2390,2979,11.03,3.92,3.14,2.45
05-08-2021,MOIMENTA DA BEIRA,8,1,82,"[0,120]",Baixo a Moderado,,,,8,Norte,VISEU,1807,21996.9,9736,576,514,471,416,461,877,1348,1862,2438,44.26,11.08,8.46,6.13
05-08-2021,MOITA,265,19,411,"[240,480]",Elevado,,,,265,Lisboa e Vale do Tejo,SETÚBAL,1506,5525.98,64407,4226,3646,2623,1801,1425,3226,5849,9495,13721,1165.53,248.3,171.82,105.85
05-08-2021,MONÇÃO,19,1,107,"[0,120]",Baixo a Moderado,,,,19,Norte,VIANA DO CASTELO,1604,21130.85,17869,1161,1105,1031,1006,972,1978,3009,4114,5275,84.56,24.96,19.47,14.24
05-08-2021,MONCHIQUE,25,2,502,"[480,960]",Muito Elevado,,,,25,Algarve,FARO,0809,39530.43,5077,353,384,321,355,392,747,1068,1452,1805,12.84,4.57,3.67,2.7
05-08-2021,MONDIM DE BASTO,9,1,131,"[120,240]",Moderado,,,,9,Norte,VILA REAL,1705,17207.52,6946,395,300,314,284,283,567,881,1181,1576,40.36,9.16,6.86,5.12
05-08-2021,MONFORTE,1,0,34,"[0,120]",Baixo a Moderado,,,,1,Alentejo,PORTALEGRE,1211,42024.82,2975,139,115,117,192,168,360,477,592,731,7.08,1.74,1.41,1.14
05-08-2021,MONTALEGRE,57,4,630,"[480,960]",Muito Elevado,,,,57,Norte,VILA REAL,1706,80545.71,8997,699,628,595,603,730,1333,1928,2556,3255,11.17,4.04,3.17,2.39
05-08-2021,MONTEMOR-O-NOVO,83,6,531,"[480,960]",Muito Elevado,,,,83,Alentejo,ÉVORA,0706,123296.65,15647,991,953,868,878,971,1849,2717,3670,4661,12.69,3.78,2.98,2.2
05-08-2021,MONTEMOR-O-VELHO,43,3,170,"[120,240]",Moderado,,,,43,Centro,COIMBRA,0610,22896.23,25224,1496,1397,1217,1057,988,2045,3262,4659,6155,110.17,26.88,20.35,14.25
05-08-2021,MONTIJO,131,9,227,"[120,240]",Moderado,,,,131,Lisboa e Vale do Tejo,SETÚBAL,1507,34861.64,57614,2771,2441,1990,1554,1109,2663,4653,7094,9865,165.26,28.3,20.35,13.35
05-08-2021,MORA,2,0,50,"[0,120]",Baixo a Moderado,,,,2,Alentejo,ÉVORA,0707,44395.02,4138,336,275,252,238,257,495,747,1022,1358,9.32,3.06,2.3,1.68
05-08-2021,MORTÁGUA,23,2,261,"[240,480]",Elevado,,,,23,Centro,VISEU,1808,25117.82,8803,638,584,535,499,460,959,1494,2078,2716,35.05,10.81,8.27,5.95
05-08-2021,MOURA,51,4,375,"[240,480]",Elevado,,,,51,Alentejo,BEJA,0210,95845.55,13718,817,656,665,542,461,1003,1668,2324,3141,14.31,3.28,2.42,1.74
05-08-2021,MOURÃO,4,0,164,"[120,240]",Moderado,,,,4,Alentejo,ÉVORA,0708,27862.98,2450,139,108,80,104,109,213,293,401,540,8.79,1.94,1.44,1.05
05-08-2021,MURÇA,8,1,148,"[120,240]",Moderado,,,,8,Norte,VILA REAL,1707,18937.11,5463,384,341,307,306,319,625,932,1273,1657,28.85,8.75,6.72,4.92
05-08-2021,MURTOSA,11,1,106,"[0,120]",Baixo a Moderado,,,,11,Centro,AVEIRO,0112,7308.78,10279,509,473,403,353,409,762,1165,1638,2147,140.63,29.37,22.41,15.94
05-08-2021,NAZARÉ,66,5,463,"[240,480]",Elevado,,,,66,Lisboa e Vale do Tejo,LEIRIA,1011,8243.43,14165,967,903,670,420,396,816,1486,2389,3356,171.84,40.71,28.98,18.03
05-08-2021,NELAS,22,2,169,"[120,240]",Moderado,,,,22,Centro,VISEU,1809,12571.48,12974,924,787,668,604,583,1187,1855,2642,3566,103.21,28.37,21.02,14.76
05-08-2021,NISA,3,0,50,"[0,120]",Baixo a Moderado,,,,3,Alentejo,PORTALEGRE,1212,57567.84,6061,405,389,355,483,478,961,1316,1705,2110,10.53,3.67,2.96,2.29
05-08-2021,NORDESTE,2,0,42,"[0,120]",Baixo a Moderado,,,,2,Açores,AÇORES,4202,10146.8,4862,246,180,124,161,162,323,447,627,873,47.92,8.6,6.18,4.41
05-08-2021,ÓBIDOS,23,2,191,"[120,240]",Moderado,,,,23,Lisboa e Vale do Tejo,LEIRIA,1012,14155.44,11850,743,650,574,452,436,888,1462,2112,2855,83.72,20.17,14.92,10.33
05-08-2021,ODEMIRA,118,8,479,"[240,480]",Elevado,,,,118,Alentejo,BEJA,0211,172060.15,24717,1475,1317,1225,1397,1349,2746,3971,5288,6763,14.37,3.93,3.07,2.31
05-08-2021,ODIVELAS,581,41,359,"[240,480]",Elevado,,,,581,Lisboa e Vale do Tejo,LISBOA,1116,2654.36,161774,9562,9038,6952,4641,3812,8453,15405,24443,34005,6095.48,1281.27,920.99,580.44
05-08-2021,OEIRAS,637,45,359,"[240,480]",Elevado,,,,637,Lisboa e Vale do Tejo,LISBOA,1110,4588.31,177408,11580,11575,8566,6211,5855,12066,20632,32207,43787,3866.78,954.38,701.98,449.69
05-08-2021,OLEIROS,2,0,40,"[0,120]",Baixo a Moderado,,,,2,Centro,CASTELO BRANCO,0506,47109.31,5003,384,341,366,397,487,884,1250,1591,1975,10.62,4.19,3.38,2.65
05-08-2021,OLHÃO,235,17,530,"[480,960]",Muito Elevado,,,,235,Algarve,FARO,0810,13086.38,44405,2455,2309,1689,1342,1268,2610,4299,6608,9063,339.33,69.26,50.5,32.85
05-08-2021,OLIVEIRA DE AZEMÉIS,102,7,154,"[120,240]",Moderado,,,,102,Norte,AVEIRO,0113,16110.41,66011,4155,3614,2794,2183,1738,3921,6715,10329,14484,409.75,89.91,64.12,41.68
05-08-2021,OLIVEIRA DE FRADES,18,1,180,"[120,240]",Moderado,,,,18,Centro,VISEU,1810,14534.62,9936,553,475,438,359,415,774,1212,1687,2240,68.36,15.41,11.61,8.34
05-08-2021,OLIVEIRA DO BAIRRO,71,5,291,"[240,480]",Elevado,,,,71,Centro,AVEIRO,0114,8731.99,24277,1327,1182,999,786,810,1596,2595,3777,5104,278.02,58.45,43.25,29.72
05-08-2021,OLIVEIRA DO HOSPITAL,120,9,623,"[480,960]",Muito Elevado,,,,120,Centro,COIMBRA,0611,23451.66,19253,1161,1097,962,924,960,1884,2846,3943,5104,82.1,21.76,16.81,12.14
05-08-2021,OURÉM,85,6,194,"[120,240]",Moderado,,,,85,Lisboa e Vale do Tejo,SANTARÉM,1421,41668.03,44044,2463,2069,1899,1817,1603,3420,5319,7388,9851,105.7,23.64,17.73,12.77
05-08-2021,OURIQUE,14,1,308,"[240,480]",Elevado,,,,14,Alentejo,BEJA,0212,66331.36,4607,313,287,284,268,227,495,779,1066,1379,6.95,2.08,1.61,1.17
05-08-2021,OVAR,132,9,244,"[240,480]",Elevado,,,,132,Centro,AVEIRO,0115,14770.25,54260,3294,2709,1994,1636,1234,2870,4864,7573,10867,367.37,73.57,51.27,32.93
05-08-2021,PAÇOS DE FERREIRA,180,13,318,"[240,480]",Elevado,,,,180,Norte,PORTO,1309,7099.29,56728,2903,2193,1518,1135,664,1799,3317,5510,8413,799.1,118.51,77.62,46.72
05-08-2021,PALMELA,156,11,242,"[240,480]",Elevado,,,,156,Lisboa e Vale do Tejo,SETÚBAL,1508,46512.01,64269,3402,3244,2635,1846,1391,3237,5872,9116,12518,138.18,26.91,19.6,12.62
05-08-2021,PAMPILHOSA DA SERRA,1,0,25,"[0,120]",Baixo a Moderado,,,,1,Centro,COIMBRA,0612,39646.24,4037,238,254,295,339,423,762,1057,1311,1549,10.18,3.91,3.31,2.67
05-08-2021,PAREDES,374,27,435,"[240,480]",Elevado,,,,374,Norte,PORTO,1310,15675.69,86067,4272,3532,2412,1717,1258,2975,5387,8919,13191,549.04,84.15,56.9,34.36
05-08-2021,PAREDES DE COURA,29,2,342,"[240,480]",Elevado,,,,29,Norte,VIANA DO CASTELO,1605,13818.59,8535,466,528,407,465,515,980,1387,1915,2381,61.76,17.23,13.86,10.04
05-08-2021,PEDRÓGÃO GRANDE,7,0,205,"[120,240]",Moderado,,,,7,Centro,LEIRIA,1013,12874.75,3410,175,173,196,221,252,473,669,842,1017,26.49,7.9,6.54,5.2
05-08-2021,PENACOVA,36,3,264,"[240,480]",Elevado,,,,36,Centro,COIMBRA,0613,21673.23,13694,968,923,745,621,703,1324,2069,2992,3960,63.18,18.27,13.81,9.55
05-08-2021,PENAFIEL,299,21,428,"[240,480]",Elevado,,,,299,Norte,PORTO,1311,21224.27,69772,3648,2823,2032,1663,1230,2893,4925,7748,11396,328.74,53.69,36.51,23.2
05-08-2021,PENALVA DO CASTELO,8,1,112,"[0,120]",Baixo a Moderado,,,,8,Centro,VISEU,1811,13433.92,7115,449,457,413,391,426,817,1230,1687,2136,52.96,15.9,12.56,9.16
05-08-2021,PENAMACOR,3,0,64,"[0,120]",Baixo a Moderado,,,,3,Centro,CASTELO BRANCO,0507,56370.69,4755,262,248,273,451,633,1084,1357,1605,1867,8.44,3.31,2.85,2.41
05-08-2021,PENEDONO,3,0,117,"[0,120]",Baixo a Moderado,,,,3,Norte,VISEU,1812,13370.75,2591,172,113,129,156,138,294,423,536,708,19.38,5.3,4.01,3.16
05-08-2021,PENELA,2,0,37,"[0,120]",Baixo a Moderado,,,,2,Centro,COIMBRA,0614,13480.0,5397,314,324,274,359,344,703,977,1301,1615,40.04,11.98,9.65,7.25
05-08-2021,PENICHE,112,8,423,"[240,480]",Elevado,,,,112,Lisboa e Vale do Tejo,LEIRIA,1014,7754.98,26501,1746,1504,1203,926,707,1633,2836,4340,6086,341.73,78.48,55.96,36.57
05-08-2021,PESO DA RÉGUA,29,2,185,"[120,240]",Moderado,,,,29,Norte,VILA REAL,1708,9486.01,15773,1076,843,650,659,455,1114,1764,2607,3683,166.28,38.83,27.48,18.6
05-08-2021,PINHEL,3,0,36,"[0,120]",Baixo a Moderado,,,,3,Centro,GUARDA,0910,48452.12,8511,577,566,551,538,689,1227,1778,2344,2921,17.57,6.03,4.84,3.67
05-08-2021,POMBAL,82,6,159,"[120,240]",Moderado,,,,82,Centro,LEIRIA,1015,62600.28,51461,3187,2791,2494,2328,2027,4355,6849,9640,12827,82.21,20.49,15.4,10.94
05-08-2021,PONTA DELGADA,201,14,296,"[240,480]",Elevado,,,,201,Açores,AÇORES,4203,23298.65,67935,3108,2435,1726,1133,902,2035,3761,6196,9304,291.58,39.93,26.59,16.14
05-08-2021,PONTA DO SOL,1,0,12,"[0,120]",Baixo a Moderado,,,,1,Madeira,MADEIRA,3105,4622.03,8593,319,283,347,208,221,429,776,1059,1378,185.92,29.81,22.91,16.79
05-08-2021,PONTE DA BARCA,8,1,72,"[0,120]",Baixo a Moderado,,,,8,Norte,VIANA DO CASTELO,1606,18211.37,11180,635,576,517,554,490,1044,1561,2137,2772,61.39,15.22,11.73,8.57
05-08-2021,PONTE DE LIMA,74,5,180,"[120,240]",Moderado,,,,74,Norte,VIANA DO CASTELO,1607,32025.46,41315,2321,2022,1720,1596,1462,3058,4778,6800,9121,129.01,28.48,21.23,14.92
05-08-2021,PONTE DE SOR,49,4,330,"[240,480]",Elevado,,,,49,Alentejo,PORTALEGRE,1213,83971.16,14994,939,800,716,739,831,1570,2286,3086,4025,17.86,4.79,3.68,2.72
05-08-2021,PORTALEGRE,51,4,228,"[120,240]",Moderado,,,,51,Alentejo,PORTALEGRE,1214,44713.64,22172,1577,1351,1137,993,984,1977,3114,4465,6042,49.59,13.51,9.99,6.96
05-08-2021,PORTEL,6,0,104,"[0,120]",Baixo a Moderado,,,,6,Alentejo,ÉVORA,0709,60100.57,5828,336,358,283,331,305,636,919,1277,1613,9.7,2.68,2.12,1.53
05-08-2021,PORTIMÃO,583,42,1050,"[960,Max]",Extremamente Elevado,,,,583,Algarve,FARO,0811,18206.29,55483,3182,2927,2116,1582,1400,2982,5098,8025,11207,304.75,61.56,44.08,28.0
05-08-2021,PORTO,1484,106,685,"[480,960]",Muito Elevado,,,,1484,Norte,PORTO,1312,4142.02,216606,15790,15193,11280,9409,10044,19453,30733,45926,61716,5229.5,1490.0,1108.79,741.98
05-08-2021,PORTO DE MÓS,110,8,472,"[240,480]",Elevado,,,,110,Centro,LEIRIA,1016,26183.41,23275,1355,1210,1034,888,872,1760,2794,4004,5359,88.89,20.47,15.29,10.67
05-08-2021,PORTO MONIZ,0,0,0,"[0,120]",Baixo a Moderado,,,,0,Madeira,MADEIRA,3106,8293.38,2342,143,130,95,98,120,218,313,443,586,28.24,7.07,5.34,3.77
05-08-2021,PORTO SANTO,11,1,212,"[120,240]",Moderado,,,,11,Madeira,MADEIRA,3201,4300.7,5202,240,157,134,110,68,178,312,469,709,120.95,16.48,10.9,7.25
05-08-2021,PÓVOA DE LANHOSO,64,5,298,"[240,480]",Elevado,,,,64,Norte,BRAGA,0309,13465.29,21499,1175,909,732,673,624,1297,2029,2938,4113,159.67,30.55,21.82,15.07
05-08-2021,PÓVOA DE VARZIM,249,18,397,"[240,480]",Elevado,,,,249,Norte,PORTO,1313,8220.59,62784,3712,3120,2134,1594,1305,2899,5033,8153,11865,763.7,144.33,99.17,61.22
05-08-2021,POVOAÇÃO,4,0,68,"[0,120]",Baixo a Moderado,,,,4,Açores,AÇORES,4204,10640.77,5927,293,212,191,144,134,278,469,681,974,55.7,9.15,6.4,4.41
05-08-2021,VILA DA PRAIA DA VITÓRIA,68,5,320,"[240,480]",Elevado,,,,68,Açores,AÇORES,4302,16127.06,21317,1133,789,619,436,336,772,1391,2180,3313,132.18,20.54,13.52,8.63
05-08-2021,PROENÇA-A-NOVA,115,8,1574,"[960,Max]",Extremamente Elevado,,,,115,Centro,CASTELO BRANCO,0508,39539.96,7298,508,465,389,400,560,960,1349,1814,2322,18.46,5.87,4.59,3.41
05-08-2021,REDONDO,7,1,111,"[0,120]",Baixo a Moderado,,,,7,Alentejo,ÉVORA,0710,36950.87,6353,349,325,288,288,354,642,930,1255,1604,17.19,4.34,3.4,2.52
05-08-2021,REGUENGOS DE MONSARAZ,20,1,201,"[120,240]",Moderado,,,,20,Alentejo,ÉVORA,0711,46399.72,10015,602,511,455,462,473,935,1390,1901,2503,21.58,5.39,4.1,3.0
05-08-2021,RESENDE,16,1,160,"[120,240]",Moderado,,,,16,Norte,VISEU,1813,12334.93,10137,560,493,448,433,422,855,1303,1796,2356,82.18,19.1,14.56,10.56
05-08-2021,RIBEIRA BRAVA,20,1,162,"[120,240]",Moderado,,,,20,Madeira,MADEIRA,3107,6544.88,12435,648,500,411,311,287,598,1009,1509,2157,189.99,32.96,23.06,15.42
05-08-2021,RIBEIRA DE PENA,7,1,117,"[0,120]",Baixo a Moderado,,,,7,Norte,VILA REAL,1709,21745.98,6016,371,301,290,310,368,678,968,1269,1640,27.66,7.54,5.84,4.45
05-08-2021,RIBEIRA GRANDE,163,12,497,"[480,960]",Muito Elevado,,,,163,Açores,AÇORES,4205,18015.13,32811,1163,689,512,345,253,598,1110,1799,2962,182.13,16.44,9.99,6.16
05-08-2021,RIO MAIOR,64,5,315,"[240,480]",Elevado,,,,64,Lisboa e Vale do Tejo,SANTARÉM,1414,27276.45,20379,1251,1144,941,795,648,1443,2384,3528,4779,74.71,17.52,12.93,8.74
05-08-2021,SABROSA,11,1,187,"[120,240]",Moderado,,,,11,Norte,VILA REAL,1710,15692.45,5918,393,314,304,302,350,652,956,1270,1663,37.71,10.6,8.09,6.09
05-08-2021,SABUGAL,4,0,38,"[0,120]",Baixo a Moderado,,,,4,Centro,GUARDA,0911,82269.82,10585,724,707,694,796,1009,1805,2499,3206,3930,12.87,4.78,3.9,3.04
05-08-2021,SALVATERRA DE MAGOS,33,2,156,"[120,240]",Moderado,,,,33,Lisboa e Vale do Tejo,SANTARÉM,1415,24393.2,21295,1275,1181,1060,799,772,1571,2631,3812,5087,87.3,20.85,15.63,10.79
05-08-2021,SANTA COMBA DÃO,12,1,115,"[0,120]",Baixo a Moderado,,,,12,Centro,VISEU,1814,11194.77,10452,732,684,569,538,464,1002,1571,2255,2987,93.36,26.68,20.14,14.03
05-08-2021,SANTA CRUZ,46,3,101,"[0,120]",Baixo a Moderado,,,,46,Madeira,MADEIRA,3108,8150.28,45281,1817,1301,974,716,523,1239,2213,3514,5331,555.6,65.41,43.12,27.15
05-08-2021,SANTA CRUZ DA GRACIOSA,3,0,72,"[0,120]",Baixo a Moderado,,,,3,Açores,AÇORES,4401,6065.78,4208,228,180,163,124,145,269,432,612,840,69.37,13.85,10.09,7.12
05-08-2021,SANTA CRUZ DAS FLORES,0,0,0,"[0,120]",Baixo a Moderado,,,,0,Açores,AÇORES,4802,7091.44,2165,125,98,74,56,51,107,181,279,404,30.53,5.7,3.93,2.55
05-08-2021,SANTA MARIA DA FEIRA,297,21,214,"[120,240]",Moderado,,,,297,Norte,AVEIRO,0109,21587.65,138636,8182,6743,4771,3856,3079,6935,11706,18449,26631,642.19,123.36,85.46,54.22
05-08-2021,SANTA MARTA DE PENAGUIÃO,16,1,244,"[240,480]",Elevado,,,,16,Norte,VILA REAL,1711,6928.13,6599,483,373,337,316,317,633,970,1343,1826,95.25,26.36,19.39,14.0
05-08-2021,SANTANA,6,0,90,"[0,120]",Baixo a Moderado,,,,6,Madeira,MADEIRA,3109,9547.3,6711,418,353,343,282,277,559,902,1255,1673,70.29,17.52,13.15,9.45
05-08-2021,SANTARÉM,144,10,250,"[240,480]",Elevado,,,,144,Lisboa e Vale do Tejo,SANTARÉM,1416,55253.58,57421,3654,3441,2760,2466,2206,4672,7432,10873,14527,103.92,26.29,19.68,13.45
05-08-2021,SANTIAGO DO CACÉM,52,4,182,"[120,240]",Moderado,,,,52,Alentejo,SETÚBAL,1509,105969.29,28791,2144,1689,1472,1295,1215,2510,3982,5671,7815,27.17,7.37,5.35,3.76
05-08-2021,SANTO TIRSO,212,15,311,"[240,480]",Elevado,,,,212,Norte,PORTO,1314,13655.52,68055,4911,3935,2761,2257,1810,4067,6828,10763,15674,498.35,114.78,78.82,50.0
05-08-2021,SÃO BRÁS DE ALPORTEL,54,4,521,"[480,960]",Muito Elevado,,,,54,Algarve,FARO,0812,15336.92,10416,596,468,467,404,401,805,1272,1740,2336,67.91,15.23,11.35,8.29
05-08-2021,SÃO JOÃO DA MADEIRA,52,4,236,"[120,240]",Moderado,,,,52,Norte,AVEIRO,0116,794.3,21958,1347,1069,796,601,593,1194,1990,3059,4406,2765.49,554.91,385.26,250.63
05-08-2021,SÃO JOÃO DA PESQUEIRA,11,1,156,"[120,240]",Moderado,,,,11,Norte,VISEU,1815,26610.85,7125,417,330,294,328,328,656,950,1280,1697,26.77,6.38,4.81,3.57
05-08-2021,SÃO PEDRO DO SUL,15,1,97,"[0,120]",Baixo a Moderado,,,,15,Centro,VISEU,1816,34895.09,15403,990,962,861,759,909,1668,2529,3491,4481,44.14,12.84,10.0,7.25
05-08-2021,SÃO ROQUE DO PICO,2,0,61,"[0,120]",Baixo a Moderado,,,,2,Açores,AÇORES,4603,14236.1,3266,199,141,93,96,113,209,302,443,642,22.94,4.51,3.11,2.12
05-08-2021,SÃO VICENTE,5,0,98,"[0,120]",Baixo a Moderado,,,,5,Madeira,MADEIRA,3110,7883.71,5143,272,264,266,225,280,505,771,1035,1307,65.23,16.58,13.13,9.78
05-08-2021,SARDOAL,6,0,161,"[120,240]",Moderado,,,,6,Lisboa e Vale do Tejo,SANTARÉM,1417,9214.72,3741,227,178,148,165,248,413,561,739,966,40.6,10.48,8.02,6.09
05-08-2021,SÁTÃO,17,1,146,"[120,240]",Moderado,,,,17,Centro,VISEU,1817,20194.11,11580,765,671,515,465,476,941,1456,2127,2892,57.34,14.32,10.53,7.21
05-08-2021,SEIA,25,2,113,"[0,120]",Baixo a Moderado,,,,25,Centro,GUARDA,0912,43568.83,22234,1807,1589,1238,1122,721,1843,3081,4670,6477,51.03,14.87,10.72,7.07
05-08-2021,SEIXAL,569,41,339,"[240,480]",Elevado,,,,569,Lisboa e Vale do Tejo,SETÚBAL,1510,9545.17,167752,10586,9270,6661,4391,2930,7321,13982,23252,33838,1757.49,354.51,243.6,146.49
05-08-2021,SERNANCELHE,4,0,74,"[0,120]",Baixo a Moderado,,,,4,Norte,VISEU,1818,22861.22,5396,305,293,286,273,260,533,819,1112,1417,23.6,6.2,4.86,3.58
05-08-2021,SERPA,81,6,564,"[480,960]",Muito Elevado,,,,81,Alentejo,BEJA,0213,110563.34,14304,903,761,719,697,626,1323,2042,2803,3706,12.94,3.35,2.54,1.85
05-08-2021,SERTÃ,22,2,151,"[120,240]",Moderado,,,,22,Centro,CASTELO BRANCO,0509,44673.17,14577,870,779,790,767,1020,1787,2577,3356,4226,32.63,9.46,7.51,5.77
05-08-2021,SESIMBRA,177,13,341,"[240,480]",Elevado,,,,177,Lisboa e Vale do Tejo,SETÚBAL,1511,19571.75,51858,2400,2321,1853,1257,1083,2340,4193,6514,8914,264.96,45.54,33.28,21.42
05-08-2021,SETÚBAL,326,23,283,"[240,480]",Elevado,,,,326,Lisboa e Vale do Tejo,SETÚBAL,1512,23032.5,115126,7425,6929,5075,3775,2655,6430,11505,18434,25859,499.83,112.27,80.03,49.95
05-08-2021,SEVER DO VOUGA,19,1,168,"[120,240]",Moderado,,,,19,Centro,AVEIRO,0117,12987.56,11331,766,637,568,540,567,1107,1675,2312,3078,87.24,23.7,17.8,12.9
05-08-2021,SILVES,163,12,450,"[240,480]",Elevado,,,,163,Algarve,FARO,0813,68006.23,36226,2137,1869,1610,1423,1600,3023,4633,6502,8639,53.27,12.7,9.56,6.81
05-08-2021,SINES,139,10,1014,"[960,Max]",Extremamente Elevado,,,,139,Alentejo,SETÚBAL,1513,20330.17,13715,888,791,551,416,268,684,1235,2026,2914,67.46,14.33,9.97,6.07
05-08-2021,SINTRA,1460,104,373,"[240,480]",Elevado,,,,1460,Lisboa e Vale do Tejo,LISBOA,1111,31922.73,391402,20490,18316,13545,9137,7284,16421,29966,48282,68772,1226.08,215.43,151.25,93.87
05-08-2021,SOBRAL DE MONTE AGRAÇO,32,2,305,"[240,480]",Elevado,,,,32,Lisboa e Vale do Tejo,LISBOA,1112,5210.32,10651,564,507,352,272,212,484,836,1343,1907,204.43,36.6,25.78,16.05
05-08-2021,SOURE,37,3,217,"[120,240]",Moderado,,,,37,Centro,COIMBRA,0615,26506.07,17120,1173,1142,1004,883,987,1870,2874,4016,5189,64.59,19.58,15.15,10.84
05-08-2021,SOUSEL,27,2,601,"[480,960]",Muito Elevado,,,,27,Alentejo,PORTALEGRE,1215,27932.18,4412,261,274,208,302,292,594,802,1076,1337,15.8,4.79,3.85,2.87
05-08-2021,TÁBUA,9,1,79,"[0,120]",Baixo a Moderado,,,,9,Centro,COIMBRA,0616,19978.58,11368,729,584,524,430,464,894,1418,2002,2731,56.9,13.67,10.02,7.1
05-08-2021,TABUAÇO,10,1,166,"[120,240]",Moderado,,,,10,Norte,VISEU,1819,13385.67,6033,372,314,217,282,363,645,862,1176,1548,45.07,11.56,8.79,6.44
05-08-2021,TAROUCA,5,0,64,"[0,120]",Baixo a Moderado,,,,5,Norte,VISEU,1820,10008.49,7804,405,335,313,277,324,601,914,1249,1654,77.98,16.53,12.48,9.13
05-08-2021,TAVIRA,73,5,296,"[240,480]",Elevado,,,,73,Algarve,FARO,0814,60696.7,24530,1493,1415,1252,1066,1277,2343,3595,5010,6503,40.41,10.71,8.25,5.92
05-08-2021,TERRAS DE BOURO,11,1,174,"[120,240]",Moderado,,,,11,Norte,BRAGA,0310,27746.07,6361,391,372,296,319,340,659,955,1327,1718,22.93,6.19,4.78,3.44
05-08-2021,TOMAR,72,5,196,"[120,240]",Moderado,,,,72,Lisboa e Vale do Tejo,SANTARÉM,1418,35120.44,36748,2403,2189,1868,1853,1822,3675,5543,7732,10135,104.64,28.86,22.02,15.78
05-08-2021,TONDELA,42,3,159,"[120,240]",Moderado,,,,42,Centro,VISEU,1821,37121.73,26357,1768,1722,1518,1475,1417,2892,4410,6132,7900,71.0,21.28,16.52,11.88
05-08-2021,TORRE DE MONCORVO,4,0,53,"[0,120]",Baixo a Moderado,,,,4,Norte,BRAGANÇA,0409,53155.67,7695,556,478,488,551,719,1270,1758,2236,2792,14.48,5.25,4.21,3.31
05-08-2021,TORRES NOVAS,107,8,305,"[240,480]",Elevado,,,,107,Lisboa e Vale do Tejo,SANTARÉM,1419,26999.68,34933,2324,1979,1738,1406,1475,2881,4619,6598,8922,129.38,33.04,24.44,17.11
05-08-2021,TORRES VEDRAS,130,9,165,"[120,240]",Moderado,,,,130,Lisboa e Vale do Tejo,LISBOA,1113,40714.89,78530,4513,3945,3447,2628,2104,4732,8179,12124,16637,192.88,40.86,29.78,20.09
05-08-2021,TRANCOSO,7,1,79,"[0,120]",Baixo a Moderado,,,,7,Centro,GUARDA,0913,36152.47,8875,581,557,542,586,496,1082,1624,2181,2762,24.55,7.64,6.03,4.49
05-08-2021,TROFA,155,11,403,"[240,480]",Elevado,,,,155,Norte,PORTO,1318,7201.76,38418,2336,1894,1231,939,684,1623,2854,4748,7084,533.44,98.36,65.93,39.63
05-08-2021,VAGOS,47,3,205,"[120,240]",Moderado,,,,47,Centro,AVEIRO,0118,16491.5,22740,1320,1205,922,784,724,1508,2430,3635,4955,137.89,30.04,22.04,14.73
05-08-2021,VALE DE CAMBRA,45,3,212,"[120,240]",Moderado,,,,45,Norte,AVEIRO,0119,14733.47,21327,1491,1363,1005,831,798,1629,2634,3997,5488,144.76,37.25,27.13,17.88
05-08-2021,VALENÇA,43,3,326,"[240,480]",Elevado,,,,43,Norte,VIANA DO CASTELO,1608,11712.86,13290,867,791,582,582,503,1085,1667,2458,3325,113.46,28.39,20.99,14.23
05-08-2021,VALONGO,392,28,402,"[240,480]",Elevado,,,,392,Norte,PORTO,1315,7512.45,97444,5629,4696,3207,2462,1829,4291,7498,12194,17823,1297.18,237.26,162.33,99.81
05-08-2021,VALPAÇOS,32,2,218,"[120,240]",Moderado,,,,32,Norte,VILA REAL,1712,54873.93,14818,1217,1118,999,928,997,1925,2924,4042,5259,27.0,9.58,7.37,5.33
05-08-2021,VELAS,4,0,79,"[0,120]",Baixo a Moderado,,,,4,Açores,AÇORES,4502,11738.38,5093,278,208,166,153,113,266,432,640,918,43.39,7.82,5.45,3.68
05-08-2021,VENDAS NOVAS,29,2,259,"[240,480]",Elevado,,,,29,Alentejo,ÉVORA,0712,22238.88,11255,677,768,655,501,532,1033,1688,2456,3133,50.61,14.09,11.04,7.59
05-08-2021,VIANA DO ALENTEJO,14,1,274,"[240,480]",Elevado,,,,14,Alentejo,ÉVORA,0713,39367.29,5145,245,208,235,210,214,424,659,867,1112,13.07,2.82,2.2,1.67
05-08-2021,VIANA DO CASTELO,144,10,170,"[120,240]",Moderado,,,,144,Norte,VIANA DO CASTELO,1609,31902.01,84417,5470,4433,3591,3061,2982,6043,9634,14067,19537,264.61,61.24,44.09,30.2
05-08-2021,VIDIGUEIRA,26,2,475,"[240,480]",Elevado,,,,26,Alentejo,BEJA,0214,31661.09,5510,300,248,215,233,275,508,723,971,1271,17.4,4.01,3.07,2.28
05-08-2021,VIEIRA DO MINHO,32,2,272,"[240,480]",Elevado,,,,32,Norte,BRAGA,0311,21644.35,11842,703,594,525,548,482,1030,1555,2149,2852,54.71,13.18,9.93,7.18
05-08-2021,VILA DE REI,0,0,0,"[0,120]",Baixo a Moderado,,,,0,Centro,CASTELO BRANCO,0510,19154.6,3323,169,128,172,247,302,549,721,849,1018,17.35,5.31,4.43,3.76
05-08-2021,VILA DO BISPO,38,3,738,"[480,960]",Muito Elevado,,,,38,Algarve,FARO,0815,17906.06,5154,302,302,314,232,233,465,779,1081,1383,28.78,7.72,6.04,4.35
05-08-2021,VILA DO CONDE,356,25,445,"[240,480]",Elevado,,,,356,Norte,PORTO,1316,14902.77,79899,4726,3875,2819,2070,1743,3813,6632,10507,15233,536.13,102.21,70.5,44.5
05-08-2021,VILA DO PORTO,14,1,249,"[240,480]",Elevado,,,,14,Açores,AÇORES,4101,9688.74,5616,274,212,135,96,123,219,354,566,840,57.96,8.67,5.84,3.65
05-08-2021,VILA FLOR,18,1,299,"[240,480]",Elevado,,,,18,Norte,BRAGANÇA,0410,26581.14,6044,429,362,422,294,331,625,1047,1409,1838,22.74,6.91,5.3,3.94
05-08-2021,VILA FRANCA DE XIRA,446,32,314,"[240,480]",Elevado,,,,446,Lisboa e Vale do Tejo,LISBOA,1114,31819.39,141957,8501,6852,4869,3425,2472,5897,10766,17618,26119,446.14,82.09,55.37,33.84
05-08-2021,VILA FRANCA DO CAMPO,40,3,364,"[240,480]",Elevado,,,,40,Açores,AÇORES,4206,7796.82,11051,450,344,248,217,154,371,619,963,1413,141.73,18.12,12.35,7.94
05-08-2021,VILA NOVA DA BARQUINHA,12,1,159,"[120,240]",Moderado,,,,12,Lisboa e Vale do Tejo,SANTARÉM,1420,4952.97,7461,415,406,392,364,338,702,1094,1500,1915,150.64,38.66,30.28,22.09
05-08-2021,VILA NOVA DE CERVEIRA,19,1,213,"[120,240]",Moderado,,,,19,Norte,VIANA DO CASTELO,1610,10846.66,8910,531,444,410,384,334,718,1128,1572,2103,82.14,19.39,14.49,10.4
05-08-2021,VILA NOVA DE FAMALICÃO,381,27,289,"[240,480]",Elevado,,,,381,Norte,BRAGA,0312,20159.26,131676,7817,6164,4202,3282,2749,6031,10233,16397,24214,653.19,120.12,81.34,50.76
05-08-2021,VILA NOVA DE FOZ CÔA,54,4,825,"[480,960]",Muito Elevado,,,,54,Centro,GUARDA,0914,39815.18,6503,442,385,390,398,429,827,1217,1602,2044,16.33,5.13,4.02,3.06
05-08-2021,VILA NOVA DE GAIA,1379,99,459,"[240,480]",Elevado,,,,1379,Norte,PORTO,1317,16846.43,300472,18349,15568,10972,8224,6281,14505,25477,41045,59394,1783.64,352.57,243.65,151.23
05-08-2021,VILA NOVA DE PAIVA,6,0,128,"[120,240]",Moderado,,,,6,Centro,VISEU,1822,17553.28,4687,289,272,233,217,241,458,691,963,1252,26.7,7.13,5.49,3.94
05-08-2021,VILA NOVA DE POIARES,14,1,201,"[120,240]",Moderado,,,,14,Centro,COIMBRA,0617,8445.3,6939,380,284,262,235,182,417,679,963,1343,82.17,15.9,11.4,8.04
05-08-2021,VILA POUCA DE AGUIAR,23,2,194,"[120,240]",Moderado,,,,23,Norte,VILA REAL,1713,43706.62,11961,860,817,733,601,627,1228,1961,2778,3638,27.37,8.32,6.36,4.49
05-08-2021,VILA REAL,252,18,505,"[480,960]",Muito Elevado,,,,252,Norte,VILA REAL,1714,37880.28,49962,3025,2498,2065,1579,1466,3045,5110,7608,10633,131.9,28.07,20.08,13.49
05-08-2021,VILA REAL DE SANTO ANTÓNIO,108,8,574,"[480,960]",Muito Elevado,,,,108,Algarve,FARO,0816,6125.0,18749,1172,1069,811,569,586,1155,1966,3035,4207,306.11,68.69,49.55,32.1
05-08-2021,VILA VELHA DE RÓDÃO,1,0,32,"[0,120]",Baixo a Moderado,,,,1,Centro,CASTELO BRANCO,0511,32991.16,3144,209,229,180,283,306,589,769,998,1207,9.53,3.66,3.03,2.33
05-08-2021,VILA VERDE,128,9,272,"[240,480]",Elevado,,,,128,Norte,BRAGA,0313,22866.52,46911,2365,2063,1667,1494,1437,2931,4598,6661,9026,205.15,39.47,29.13,20.11
05-08-2021,VILA VIÇOSA,32,2,423,"[240,480]",Elevado,,,,32,Alentejo,ÉVORA,0714,19485.89,7656,487,379,342,345,324,669,1011,1390,1877,39.29,9.63,7.13,5.19
05-08-2021,VIMIOSO,1,0,25,"[0,120]",Baixo a Moderado,,,,1,Norte,BRAGANÇA,0411,48158.51,4023,274,230,261,293,335,628,889,1119,1393,8.35,2.89,2.32,1.85
05-08-2021,VINHAIS,4,0,53,"[0,120]",Baixo a Moderado,,,,4,Norte,BRAGANÇA,0412,69475.09,7746,599,577,636,641,815,1456,2092,2669,3268,11.15,4.7,3.84,3.01
05-08-2021,VISEU,228,16,234,"[120,240]",Moderado,,,,228,Centro,VISEU,1823,50710.14,97249,5769,5038,4140,3158,2710,5868,10008,15046,20815,191.77,41.05,29.67,19.74
05-08-2021,VIZELA,75,5,314,"[240,480]",Elevado,,,,75,Norte,BRAGA,0314,2469.83,23897,1258,928,655,509,371,880,1535,2463,3721,967.49,150.65,99.72,62.15
05-08-2021,VOUZELA,8,1,83,"[0,120]",Baixo a Moderado,,,,8,Centro,VISEU,1824,19369.46,9619,626,605,554,532,507,1039,1593,2198,2824,49.66,14.58,11.35,8.22
12-08-2021,ABRANTES,44,3,126,"[120,240]",Moderado,,,,44,Lisboa e Vale do Tejo,SANTARÉM,1401,71469.08,35130,2473,2213,1730,1748,2021,3769,5499,7712,10185,49.15,14.25,10.79,7.69
12-08-2021,ÁGUEDA,182,13,395,"[240,480]",Elevado,,,,182,Centro,AVEIRO,0101,33527.44,46075,3237,2713,2090,1635,1496,3131,5221,7934,11171,137.43,33.32,23.66,15.57
12-08-2021,AGUIAR DA BEIRA,5,0,108,"[0,120]",Baixo a Moderado,,,,5,Centro,GUARDA,0901,20676.57,4652,304,281,235,239,148,387,622,903,1207,22.5,5.84,4.37,3.01
12-08-2021,ALANDROAL,11,1,225,"[120,240]",Moderado,,,,11,Alentejo,ÉVORA,0701,54267.81,4992,307,256,296,299,377,676,972,1228,1535,9.2,2.83,2.26,1.79
12-08-2021,ALBERGARIA-A-VELHA,30,2,123,"[120,240]",Moderado,,,,30,Centro,AVEIRO,0102,15882.5,24144,1550,1298,996,687,680,1367,2363,3661,5211,152.02,32.81,23.05,14.88
12-08-2021,ALBUFEIRA,323,23,778,"[480,960]",Muito Elevado,,,,323,Algarve,FARO,0801,14066.42,41528,2067,1717,1425,985,858,1843,3268,4985,7052,295.24,50.14,35.44,23.23
12-08-2021,ALCÁCER DO SAL,28,2,243,"[240,480]",Elevado,,,,28,Alentejo,SETÚBAL,1501,149987.3,11659,884,814,623,623,602,1225,1848,2662,3546,7.77,2.36,1.77,1.23
12-08-2021,ALCANENA,50,4,389,"[240,480]",Elevado,,,,50,Lisboa e Vale do Tejo,SANTARÉM,1402,12732.86,12809,891,744,628,536,588,1124,1752,2496,3387,100.6,26.6,19.6,13.76
12-08-2021,ALCOBAÇA,108,8,201,"[120,240]",Moderado,,,,108,Lisboa e Vale do Tejo,LEIRIA,1001,40814.09,53555,3420,2927,2466,2059,1676,3735,6201,9128,12548,131.22,30.74,22.36,15.19
12-08-2021,ALCOCHETE,40,3,201,"[120,240]",Moderado,,,,40,Lisboa e Vale do Tejo,SETÚBAL,1502,12836.48,19787,857,834,691,476,447,923,1614,2448,3305,154.15,25.75,19.07,12.57
12-08-2021,ALCOUTIM,12,1,578,"[480,960]",Muito Elevado,,,,12,Algarve,FARO,0802,57536.33,2159,191,188,163,190,267,457,620,808,999,3.75,1.74,1.4,1.08
12-08-2021,ALENQUER,111,8,253,"[240,480]",Elevado,,,,111,Lisboa e Vale do Tejo,LISBOA,1101,30421.92,44052,2298,2062,1629,1330,1155,2485,4114,6176,8474,144.8,27.85,20.3,13.52
12-08-2021,ALFÂNDEGA DA FÉ,1,0,22,"[0,120]",Baixo a Moderado,,,,1,Norte,BRAGANÇA,0401,32194.64,4550,325,277,301,274,325,599,900,1177,1502,14.13,4.67,3.66,2.8
12-08-2021,ALIJÓ,27,2,256,"[240,480]",Elevado,,,,27,Norte,VILA REAL,1701,29759.89,10625,766,687,635,542,666,1208,1843,2530,3296,35.7,11.08,8.5,6.19
12-08-2021,ALJEZUR,20,1,357,"[240,480]",Elevado,,,,20,Algarve,FARO,0803,32349.95,5594,316,336,335,320,410,730,1065,1401,1717,17.29,5.31,4.33,3.29
12-08-2021,ALJUSTREL,22,2,270,"[240,480]",Elevado,,,,22,Alentejo,BEJA,0201,45847.41,8247,635,521,443,347,358,705,1148,1669,2304,17.99,5.03,3.64,2.5
12-08-2021,ALMADA,483,35,286,"[240,480]",Elevado,,,,483,Lisboa e Vale do Tejo,SETÚBAL,1503,7000.89,169039,10469,9777,7876,6144,5111,11255,19131,28908,39377,2414.5,562.45,412.91,273.26
12-08-2021,ALMEIDA,4,0,69,"[0,120]",Baixo a Moderado,,,,4,Centro,GUARDA,0902,51798.46,5830,441,419,396,458,393,851,1247,1666,2107,11.26,4.07,3.22,2.41
12-08-2021,ALMEIRIM,43,3,192,"[120,240]",Moderado,,,,43,Lisboa e Vale do Tejo,SANTARÉM,1403,22212.05,22546,1342,1353,1106,866,843,1709,2815,4168,5510,101.5,24.81,18.76,12.67
12-08-2021,ALMODÔVAR,63,4,931,"[480,960]",Muito Elevado,,,,63,Alentejo,BEJA,0202,77788.03,6725,414,443,396,373,328,701,1097,1540,1954,8.65,2.51,1.98,1.41
12-08-2021,ALPIARÇA,26,2,372,"[240,480]",Elevado,,,,26,Lisboa e Vale do Tejo,SANTARÉM,1404,9536.33,7059,515,486,363,333,274,607,970,1456,1971,74.02,20.67,15.27,10.17
12-08-2021,ALTER DO CHÃO,5,0,159,"[120,240]",Moderado,,,,5,Alentejo,PORTALEGRE,1201,36206.62,3165,201,163,136,208,187,395,531,694,895,8.74,2.47,1.92,1.47
12-08-2021,ALVAIÁZERE,4,0,61,"[0,120]",Baixo a Moderado,,,,4,Centro,LEIRIA,1002,16047.76,6597,419,389,346,406,539,945,1291,1680,2099,41.11,13.08,10.47,8.04
12-08-2021,ALVITO,5,0,203,"[120,240]",Moderado,,,,5,Alentejo,BEJA,0203,26485.32,2477,145,110,105,111,89,200,305,415,560,9.35,2.11,1.57,1.15
12-08-2021,AMADORA,676,48,367,"[240,480]",Elevado,,,,676,Lisboa e Vale do Tejo,LISBOA,1115,2378.47,184106,11186,10936,8780,6460,5890,12350,21130,32066,43252,7742.05,1818.84,1348.44,888.56
12-08-2021,AMARANTE,229,16,431,"[240,480]",Elevado,,,,229,Norte,PORTO,1301,30133.15,53193,3086,2413,1812,1643,1311,2954,4766,7179,10265,176.53,34.07,23.82,15.82
12-08-2021,AMARES,52,4,287,"[240,480]",Elevado,,,,52,Norte,BRAGA,0301,8195.41,18129,1001,829,622,489,524,1013,1635,2464,3465,221.22,42.28,30.07,19.95
12-08-2021,ANADIA,65,5,238,"[120,240]",Moderado,,,,65,Centro,AVEIRO,0103,21663.48,27258,1931,1698,1376,1208,1262,2470,3846,5544,7475,125.83,34.51,25.59,17.75
12-08-2021,ANGRA DO HEROÍSMO,54,4,160,"[120,240]",Moderado,,,,54,Açores,AÇORES,4301,23899.66,33807,2006,1473,1122,768,635,1403,2525,3998,6004,141.45,25.12,16.73,10.56
12-08-2021,ANSIÃO,16,1,133,"[120,240]",Moderado,,,,16,Centro,LEIRIA,1003,17609.42,12039,727,709,646,694,530,1224,1870,2579,3306,68.37,18.77,14.65,10.62
12-08-2021,ARCOS DE VALDEVEZ,13,1,63,"[0,120]",Baixo a Moderado,,,,13,Norte,VIANA DO CASTELO,1601,44759.64,20926,1329,1338,1282,1343,1515,2858,4140,5478,6807,46.75,15.21,12.24,9.25
12-08-2021,ARGANIL,13,1,118,"[0,120]",Baixo a Moderado,,,,13,Centro,COIMBRA,0601,33283.93,11014,672,648,612,559,596,1155,1767,2415,3087,33.09,9.27,7.26,5.31
12-08-2021,ARMAMAR,5,0,87,"[0,120]",Baixo a Moderado,,,,5,Norte,VISEU,1801,11723.73,5769,357,305,309,285,310,595,904,1209,1566,49.21,13.36,10.31,7.71
12-08-2021,AROUCA,55,4,267,"[240,480]",Elevado,,,,55,Norte,AVEIRO,0104,32910.52,20720,1306,1047,753,683,683,1366,2119,3166,4472,62.96,13.59,9.62,6.44
12-08-2021,ARRAIOLOS,12,1,175,"[120,240]",Moderado,,,,12,Alentejo,ÉVORA,0702,68374.55,6928,435,384,283,367,480,847,1130,1514,1949,10.13,2.85,2.21,1.65
12-08-2021,ARRONCHES,3,0,109,"[0,120]",Baixo a Moderado,,,,3,Alentejo,PORTALEGRE,1202,31464.72,2820,155,142,162,187,179,366,528,670,825,8.96,2.62,2.13,1.68
12-08-2021,ARRUDA DOS VINHOS,12,1,76,"[0,120]",Baixo a Moderado,,,,12,Lisboa e Vale do Tejo,LISBOA,1102,7795.93,15412,738,738,562,509,438,947,1509,2247,2985,197.69,38.29,28.82,19.36
12-08-2021,AVEIRO,176,13,224,"[120,240]",Moderado,,,,176,Centro,AVEIRO,0105,19757.57,78734,4520,4004,3050,2250,2103,4353,7403,11407,15927,398.49,80.61,57.73,37.47
12-08-2021,AVIS,3,0,72,"[0,120]",Baixo a Moderado,,,,3,Alentejo,PORTALEGRE,1203,60596.51,4247,315,225,206,251,273,524,730,955,1270,7.01,2.1,1.58,1.2
12-08-2021,AZAMBUJA,41,3,180,"[120,240]",Moderado,,,,41,Lisboa e Vale do Tejo,LISBOA,1103,26265.65,22716,1322,1171,1070,798,618,1416,2486,3657,4979,86.48,18.96,13.92,9.46
12-08-2021,BAIÃO,49,4,264,"[240,480]",Elevado,,,,49,Norte,PORTO,1302,17452.83,18748,1070,862,714,686,725,1411,2125,2987,4057,107.42,23.25,17.11,12.18
12-08-2021,BARCELOS,329,23,283,"[240,480]",Elevado,,,,329,Norte,BRAGA,0302,37890.14,116187,6721,5325,3619,2991,2562,5553,9172,14497,21218,306.64,56.0,38.26,24.21
12-08-2021,BARRANCOS,2,0,123,"[120,240]",Moderado,,,,2,Alentejo,BEJA,0204,16841.73,1634,90,65,65,94,61,155,220,285,375,9.7,2.23,1.69,1.31
12-08-2021,BARREIRO,298,21,396,"[240,480]",Elevado,,,,298,Lisboa e Vale do Tejo,SETÚBAL,1504,3639.07,75147,5194,5565,4459,3105,1767,4872,9331,14896,20090,2065.05,552.07,409.34,256.42
12-08-2021,BATALHA,49,4,309,"[240,480]",Elevado,,,,49,Centro,LEIRIA,1004,10341.6,15963,873,762,649,529,549,1078,1727,2489,3362,154.35,32.51,24.07,16.7
12-08-2021,BEJA,194,14,579,"[480,960]",Muito Elevado,,,,194,Alentejo,BEJA,0205,114647.55,33579,2005,1840,1386,1272,1039,2311,3697,5537,7542,29.29,6.58,4.83,3.22
12-08-2021,BELMONTE,5,0,78,"[0,120]",Baixo a Moderado,,,,5,Centro,CASTELO BRANCO,0501,11875.91,6398,444,321,325,310,355,665,990,1311,1755,53.87,14.78,11.04,8.34
12-08-2021,BENAVENTE,70,5,228,"[120,240]",Moderado,,,,70,Lisboa e Vale do Tejo,SANTARÉM,1405,52138.39,30602,1468,1376,1141,876,643,1519,2660,4036,5504,58.69,10.56,7.74,5.1
12-08-2021,BOMBARRAL,10,1,79,"[0,120]",Baixo a Moderado,,,,10,Lisboa e Vale do Tejo,LEIRIA,1005,9128.55,12558,875,714,561,491,429,920,1481,2195,3070,137.56,33.63,24.04,16.22
12-08-2021,BORBA,9,1,135,"[120,240]",Moderado,,,,9,Alentejo,ÉVORA,0703,14518.65,6736,430,375,279,436,392,828,1107,1482,1912,46.39,13.17,10.21,7.62
12-08-2021,BOTICAS,28,2,568,"[480,960]",Muito Elevado,,,,28,Norte,VILA REAL,1702,32195.66,4998,347,306,311,305,380,685,996,1302,1649,15.52,5.12,4.04,3.09
12-08-2021,BRAGA,554,40,303,"[240,480]",Elevado,,,,554,Norte,BRAGA,0303,18339.95,182679,10029,7963,5241,4320,3671,7991,13232,21195,31224,996.07,170.25,115.57,72.15
12-08-2021,BRAGANÇA,84,6,251,"[240,480]",Elevado,,,,84,Norte,BRAGANÇA,0402,117357.27,33607,2402,1855,1652,1393,1163,2556,4208,6063,8465,28.64,7.21,5.17,3.59
12-08-2021,CABECEIRAS DE BASTO,17,1,109,"[0,120]",Baixo a Moderado,,,,17,Norte,BRAGA,0304,24182.16,15628,774,594,544,575,574,1149,1693,2287,3061,64.63,12.66,9.46,7.0
12-08-2021,CADAVAL,14,1,102,"[0,120]",Baixo a Moderado,,,,14,Lisboa e Vale do Tejo,LISBOA,1104,17489.3,13673,813,796,756,621,625,1246,2002,2798,3611,78.18,20.65,16.0,11.45
12-08-2021,CALDAS DA RAINHA,108,8,208,"[120,240]",Moderado,,,,108,Lisboa e Vale do Tejo,LEIRIA,1006,25569.47,51912,3035,2684,2186,1899,1705,3604,5790,8474,11509,203.03,45.01,33.14,22.64
12-08-2021,CALHETA,4,0,37,"[0,120]",Baixo a Moderado,,,,4,Madeira,MADEIRA,3101,11150.43,10867,576,497,507,399,415,814,1321,1818,2394,97.46,21.47,16.3,11.85
12-08-2021,CALHETA (AÇORES),0,0,0,"[0,120]",Baixo a Moderado,,,,0,Açores,AÇORES,4501,12626.4,3184,215,159,141,139,122,261,402,561,776,25.22,6.15,4.44,3.18
12-08-2021,CÂMARA DE LOBOS,28,2,83,"[0,120]",Baixo a Moderado,,,,28,Madeira,MADEIRA,3102,5216.67,33675,1396,1059,834,545,381,926,1760,2819,4215,645.49,80.79,54.03,33.74
12-08-2021,CAMINHA,26,2,165,"[120,240]",Moderado,,,,26,Norte,VIANA DO CASTELO,1602,13652.14,15877,1046,944,818,646,656,1302,2120,3064,4110,116.3,30.11,22.44,15.53
12-08-2021,CAMPO MAIOR,11,1,141,"[120,240]",Moderado,,,,11,Alentejo,PORTALEGRE,1204,24720.16,7874,471,364,351,279,327,606,957,1321,1792,31.85,7.25,5.34,3.87
12-08-2021,CANTANHEDE,35,3,100,"[0,120]",Baixo a Moderado,,,,35,Centro,COIMBRA,0602,39088.02,35011,2346,2096,1880,1709,1451,3160,5040,7136,9482,89.57,24.26,18.26,12.89
12-08-2021,CARRAZEDA DE ANSIÃES,6,0,107,"[0,120]",Baixo a Moderado,,,,6,Norte,BRAGANÇA,0403,27924.09,5666,424,389,391,312,465,777,1168,1557,1981,20.29,7.09,5.58,4.18
12-08-2021,CARREGAL DO SAL,9,1,97,"[0,120]",Baixo a Moderado,,,,9,Centro,VISEU,1802,11689.21,9271,587,562,486,462,376,838,1324,1886,2473,79.31,21.16,16.13,11.33
12-08-2021,CARTAXO,29,2,122,"[120,240]",Moderado,,,,29,Lisboa e Vale do Tejo,SANTARÉM,1406,15817.28,23843,1415,1376,1142,861,632,1493,2635,4011,5426,150.74,34.3,25.36,16.66
12-08-2021,CASCAIS,850,61,398,"[240,480]",Elevado,,,,850,Lisboa e Vale do Tejo,LISBOA,1105,9740.17,213608,12151,11444,8680,6469,5248,11717,20397,31841,43992,2193.1,451.66,326.91,209.41
12-08-2021,CASTANHEIRA DE PÊRA,0,0,0,"[0,120]",Baixo a Moderado,,,,0,Centro,LEIRIA,1007,6677.45,2614,233,195,157,190,187,377,534,729,962,39.15,14.41,10.92,8.0
12-08-2021,CASTELO BRANCO,98,7,188,"[120,240]",Moderado,,,,98,Centro,CASTELO BRANCO,0502,143819.15,51987,3528,3042,2499,2229,2225,4454,6953,9995,13523,36.15,9.4,6.95,4.83
12-08-2021,CASTELO DE PAIVA,27,2,176,"[120,240]",Moderado,,,,27,Norte,AVEIRO,0106,11500.53,15454,881,697,545,420,431,851,1396,2093,2974,134.37,25.86,18.2,12.14
12-08-2021,CASTELO DE VIDE,5,0,173,"[120,240]",Moderado,,,,5,Alentejo,PORTALEGRE,1205,26491.24,2919,204,173,179,147,170,317,496,669,873,11.02,3.3,2.53,1.87
12-08-2021,CASTRO DAIRE,38,3,275,"[240,480]",Elevado,,,,38,Centro,VISEU,1803,37904.13,13823,942,857,765,732,773,1505,2270,3127,4069,36.47,10.74,8.25,5.99
12-08-2021,CASTRO MARIM,30,2,484,"[480,960]",Muito Elevado,,,,30,Algarve,FARO,0804,30084.37,6237,370,345,334,322,344,666,1000,1345,1715,20.73,5.7,4.47,3.32
12-08-2021,CASTRO VERDE,20,1,290,"[240,480]",Elevado,,,,20,Alentejo,BEJA,0206,56944.23,6949,437,347,303,275,227,502,805,1152,1589,12.2,2.79,2.02,1.41
12-08-2021,CELORICO DA BEIRA,5,0,72,"[0,120]",Baixo a Moderado,,,,5,Centro,GUARDA,0903,24721.63,6928,430,416,363,369,535,904,1267,1683,2113,28.02,8.55,6.81,5.12
12-08-2021,CELORICO DE BASTO,48,3,254,"[240,480]",Elevado,,,,48,Norte,BRAGA,0305,18107.02,19040,1001,802,668,728,729,1457,2125,2927,3928,105.15,21.69,16.17,11.74
12-08-2021,CHAMUSCA,14,1,154,"[120,240]",Moderado,,,,14,Lisboa e Vale do Tejo,SANTARÉM,1407,74600.54,9197,629,583,553,465,579,1044,1597,2180,2809,12.33,3.77,2.92,2.14
12-08-2021,CHAVES,68,5,173,"[120,240]",Moderado,,,,68,Norte,VILA REAL,1703,59122.95,39343,2676,2429,1991,1886,1918,3804,5795,8224,10900,66.54,18.44,13.91,9.8
12-08-2021,CINFÃES,58,4,317,"[240,480]",Elevado,,,,58,Norte,VISEU,1804,23928.76,18244,1067,902,779,734,758,1492,2271,3173,4240,76.24,17.72,13.26,9.49
12-08-2021,COIMBRA,256,18,191,"[120,240]",Moderado,,,,256,Centro,COIMBRA,0603,31939.94,134166,9489,8734,6353,5139,5074,10213,16566,25300,34789,420.06,108.92,79.21,51.87
12-08-2021,CONDEIXA-A-NOVA,9,1,50,"[0,120]",Baixo a Moderado,,,,9,Centro,COIMBRA,0604,13867.47,17733,871,809,717,583,490,1073,1790,2599,3470,127.88,25.02,18.74,12.91
12-08-2021,CONSTÂNCIA,0,0,0,"[0,120]",Baixo a Moderado,,,,0,Lisboa e Vale do Tejo,SANTARÉM,1408,8036.58,4030,211,183,187,148,155,303,490,673,884,50.14,11.0,8.37,6.1
12-08-2021,CORUCHE,39,3,221,"[120,240]",Moderado,,,,39,Lisboa e Vale do Tejo,SANTARÉM,1409,111572.03,17471,1294,1090,1095,1096,1019,2115,3210,4300,5594,15.66,5.01,3.85,2.88
12-08-2021,CORVO,0,0,0,"[0,120]",Baixo a Moderado,,,,0,Açores,AÇORES,4901,1711.45,464,22,21,11,13,19,32,43,64,86,27.12,5.03,3.74,2.51
12-08-2021,COVILHÃ,57,4,122,"[120,240]",Moderado,,,,57,Centro,CASTELO BRANCO,0503,55560.06,46787,3533,2998,2365,2111,2193,4304,6669,9667,13200,84.21,23.76,17.4,12.0
12-08-2021,CRATO,1,0,33,"[0,120]",Baixo a Moderado,,,,1,Alentejo,PORTALEGRE,1206,39806.88,3129,229,258,163,182,228,410,573,831,1060,7.86,2.66,2.09,1.44
12-08-2021,CUBA,20,1,440,"[240,480]",Elevado,,,,20,Alentejo,BEJA,0207,17208.72,4595,255,233,206,190,143,333,539,772,1027,26.7,5.97,4.49,3.13
12-08-2021,ELVAS,52,4,251,"[240,480]",Elevado,,,,52,Alentejo,PORTALEGRE,1207,63128.86,20528,1057,1145,902,852,810,1662,2564,3709,4766,32.52,7.55,5.88,4.06
12-08-2021,ENTRONCAMENTO,79,6,365,"[240,480]",Elevado,,,,79,Lisboa e Vale do Tejo,SANTARÉM,1410,1372.81,21558,1066,930,868,695,592,1287,2155,3085,4151,1570.14,302.33,224.69,156.96
12-08-2021,ESPINHO,82,6,279,"[240,480]",Elevado,,,,82,Norte,AVEIRO,0107,2105.68,29516,2205,1993,1430,1177,960,2137,3567,5560,7765,1401.52,368.71,264.01,169.37
12-08-2021,ESPOSENDE,241,17,705,"[480,960]",Muito Elevado,,,,241,Norte,BRAGA,0306,9540.98,34177,1831,1522,1095,894,723,1617,2712,4234,6065,358.21,63.57,44.38,28.42
12-08-2021,ESTARREJA,27,2,103,"[0,120]",Baixo a Moderado,,,,27,Centro,AVEIRO,0108,10817.33,26006,1503,1399,1106,953,728,1681,2787,4186,5689,240.42,52.59,38.7,25.76
12-08-2021,ESTREMOZ,36,3,286,"[240,480]",Elevado,,,,36,Alentejo,ÉVORA,0704,51379.95,12728,789,613,697,786,877,1663,2360,2973,3762,24.77,7.32,5.79,4.59
12-08-2021,ÉVORA,177,13,337,"[240,480]",Elevado,,,,177,Alentejo,ÉVORA,0705,130707.58,52428,3569,2852,2176,1966,1803,3769,5945,8797,12366,40.11,9.46,6.73,4.55
12-08-2021,FAFE,139,10,289,"[240,480]",Elevado,,,,139,Norte,BRAGA,0307,21908.11,48060,3044,2455,1679,1403,1208,2611,4290,6745,9789,219.37,44.68,30.79,19.58
12-08-2021,FARO,441,31,722,"[480,960]",Muito Elevado,,,,441,Algarve,FARO,0805,20256.79,61015,3847,3364,2604,2055,1601,3656,6260,9624,13471,301.2,66.5,47.51,30.9
12-08-2021,FELGUEIRAS,192,14,340,"[240,480]",Elevado,,,,192,Norte,PORTO,1303,11573.75,56422,2951,2302,1601,1316,973,2289,3890,6192,9143,487.49,79.0,53.5,33.61
12-08-2021,FERREIRA DO ALENTEJO,13,1,167,"[120,240]",Moderado,,,,13,Alentejo,BEJA,0208,64820.68,7845,515,414,372,343,345,688,1060,1474,1989,12.1,3.07,2.27,1.64
12-08-2021,FERREIRA DO ZÊZERE,7,1,88,"[0,120]",Baixo a Moderado,,,,7,Lisboa e Vale do Tejo,SANTARÉM,1411,19038.03,7959,470,370,416,465,456,921,1337,1707,2177,41.81,11.44,8.97,7.02
12-08-2021,FIGUEIRA DA FOZ,116,8,197,"[120,240]",Moderado,,,,116,Centro,COIMBRA,0605,37905.26,58747,4032,3597,2887,2495,2043,4538,7425,11022,15054,154.98,39.72,29.08,19.59
12-08-2021,FIGUEIRA DE CASTELO RODRIGO,2,0,36,"[0,120]",Baixo a Moderado,,,,2,Centro,GUARDA,0904,50857.46,5584,347,352,290,352,391,743,1033,1385,1732,10.98,3.41,2.72,2.03
12-08-2021,FIGUEIRÓ DOS VINHOS,7,1,126,"[120,240]",Moderado,,,,7,Centro,LEIRIA,1008,17344.0,5568,402,386,322,309,351,660,982,1368,1770,32.1,10.21,7.89,5.66
12-08-2021,FORNOS DE ALGODRES,3,0,66,"[0,120]",Baixo a Moderado,,,,3,Centro,GUARDA,0905,13145.05,4528,261,218,247,256,232,488,735,953,1214,34.45,9.24,7.25,5.59
12-08-2021,FREIXO DE ESPADA À CINTA,0,0,0,"[0,120]",Baixo a Moderado,,,,0,Norte,BRAGANÇA,0404,24414.29,3298,211,177,231,196,189,385,616,793,1004,13.51,4.11,3.25,2.52
12-08-2021,FRONTEIRA,1,0,34,"[0,120]",Baixo a Moderado,,,,1,Alentejo,PORTALEGRE,1208,24859.58,2974,213,182,149,156,168,324,473,655,868,11.96,3.49,2.63,1.9
12-08-2021,FUNCHAL,207,15,199,"[120,240]",Moderado,,,,207,Madeira,MADEIRA,3103,7616.2,104024,6382,5086,3643,2821,1990,4811,8454,13540,19922,1365.86,261.58,177.78,111.0
12-08-2021,FUNDÃO,16,1,60,"[0,120]",Baixo a Moderado,,,,16,Centro,CASTELO BRANCO,0504,70019.79,26495,1781,1464,1432,1357,1643,3000,4432,5896,7677,37.84,10.96,8.42,6.33
12-08-2021,GAVIÃO,7,1,220,"[120,240]",Moderado,,,,7,Alentejo,PORTALEGRE,1209,29459.45,3263,189,186,222,263,293,556,778,964,1153,11.08,3.91,3.27,2.64
12-08-2021,GÓIS,3,0,80,"[0,120]",Baixo a Moderado,,,,3,Centro,COIMBRA,0606,26330.19,3805,235,199,240,233,244,477,717,916,1151,14.45,4.37,3.48,2.72
12-08-2021,GOLEGÃ,5,0,95,"[0,120]",Baixo a Moderado,,,,5,Lisboa e Vale do Tejo,SANTARÉM,1412,8431.67,5339,356,299,281,243,255,498,779,1078,1434,63.32,17.01,12.78,9.24
12-08-2021,GONDOMAR,569,41,343,"[240,480]",Elevado,,,,569,Norte,PORTO,1304,13191.76,165985,10555,8755,6222,4450,3364,7814,14036,22791,33346,1258.22,252.77,172.76,106.4
12-08-2021,GOUVEIA,17,1,138,"[120,240]",Moderado,,,,17,Centro,GUARDA,0906,30061.17,12387,871,931,780,783,810,1593,2373,3304,4175,41.21,13.89,10.99,7.89
12-08-2021,GRÂNDOLA,23,2,157,"[120,240]",Moderado,,,,23,Alentejo,SETÚBAL,1505,82593.66,14639,834,834,708,688,672,1360,2068,2902,3736,17.72,4.52,3.51,2.5
12-08-2021,GUARDA,52,4,133,"[120,240]",Moderado,,,,52,Centro,GUARDA,0907,71209.58,38969,2477,2041,1686,1415,1474,2889,4575,6616,9093,54.72,12.77,9.29,6.42
12-08-2021,GUIMARÃES,394,28,259,"[240,480]",Elevado,,,,394,Norte,BRAGA,0308,24099.96,152309,9394,7074,4809,3877,2948,6825,11634,18708,28102,631.99,116.61,77.63,48.27
12-08-2021,HORTA,21,2,145,"[120,240]",Moderado,,,,21,Açores,AÇORES,4701,17305.53,14521,818,658,468,352,302,654,1122,1780,2598,83.91,15.01,10.29,6.48
12-08-2021,IDANHA-A-NOVA,7,1,88,"[0,120]",Baixo a Moderado,,,,7,Centro,CASTELO BRANCO,0505,141633.51,8043,518,490,519,672,974,1646,2165,2655,3173,5.68,2.24,1.87,1.53
12-08-2021,ÍLHAVO,123,9,319,"[240,480]",Elevado,,,,123,Centro,AVEIRO,0110,7347.55,38699,2227,1943,1444,1193,850,2043,3487,5430,7657,526.66,104.21,73.9,47.46
12-08-2021,LAGOA (FARO),171,12,752,"[480,960]",Muito Elevado,,,,171,Algarve,FARO,0806,8825.45,22762,1314,1168,919,749,670,1419,2338,3506,4820,257.93,54.62,39.73,26.49
12-08-2021,LAGOA,71,5,481,"[480,960]",Muito Elevado,,,,71,Açores,AÇORES,4201,4559.32,14721,536,458,349,238,235,473,822,1280,1816,322.9,39.83,28.08,18.03
12-08-2021,LAGOS,263,19,866,"[480,960]",Muito Elevado,,,,263,Algarve,FARO,0807,21299.27,30374,1744,1434,1247,1053,1029,2082,3329,4763,6507,142.61,30.55,22.36,15.63
12-08-2021,LAJES DAS FLORES,1,0,68,"[0,120]",Baixo a Moderado,,,,1,Açores,AÇORES,4801,7004.79,1463,88,53,62,46,54,100,162,215,303,20.89,4.33,3.07,2.31
12-08-2021,LAJES DO PICO,4,0,89,"[0,120]",Baixo a Moderado,,,,4,Açores,AÇORES,4601,15531.09,4490,304,231,223,159,162,321,544,775,1079,28.91,6.95,4.99,3.5
12-08-2021,LAMEGO,22,2,89,"[0,120]",Baixo a Moderado,,,,22,Norte,VISEU,1805,16542.11,24895,1639,1284,1124,898,783,1681,2805,4089,5728,150.5,34.63,24.72,16.96
12-08-2021,LEIRIA,415,30,331,"[240,480]",Elevado,,,,415,Centro,LEIRIA,1009,56508.83,125267,7389,6366,5090,3902,3159,7061,12151,18517,25906,221.68,45.84,32.77,21.5
12-08-2021,LISBOA,2823,202,554,"[480,960]",Muito Elevado,,,,2823,Lisboa e Vale do Tejo,LISBOA,1106,10005.43,509515,33197,33340,27706,23037,26770,49807,77513,110853,144050,5092.6,1439.78,1107.98,774.74
12-08-2021,LOULÉ,507,36,738,"[480,960]",Muito Elevado,,,,507,Algarve,FARO,0808,76366.91,68697,3890,3350,2780,2358,2251,4609,7389,10739,14629,89.96,19.16,14.06,9.68
12-08-2021,LOURES,694,50,325,"[240,480]",Elevado,,,,694,Lisboa e Vale do Tejo,LISBOA,1107,16723.99,213687,12746,12794,9644,6669,5033,11702,21346,34140,46886,1277.73,280.35,204.14,127.64
12-08-2021,LOURINHÃ,52,4,202,"[120,240]",Moderado,,,,52,Lisboa e Vale do Tejo,LISBOA,1108,14717.2,25855,1584,1243,992,842,645,1487,2479,3722,5306,175.68,36.05,25.29,16.84
12-08-2021,LOUSÃ,19,1,110,"[0,120]",Baixo a Moderado,,,,19,Centro,COIMBRA,0607,13840.01,17158,946,866,658,528,450,978,1636,2502,3448,123.97,24.91,18.08,11.82
12-08-2021,LOUSADA,179,13,382,"[240,480]",Elevado,,,,179,Norte,PORTO,1305,9608.01,46755,2289,1698,1176,853,621,1474,2650,4348,6637,486.63,69.08,45.25,27.58
12-08-2021,MAÇÃO,26,2,420,"[240,480]",Elevado,,,,26,Lisboa e Vale do Tejo,SANTARÉM,1413,39997.98,6267,386,362,390,440,657,1097,1487,1849,2235,15.67,5.59,4.62,3.72
12-08-2021,MACEDO DE CAVALEIROS,13,1,90,"[0,120]",Baixo a Moderado,,,,13,Norte,BRAGANÇA,0405,69914.08,14516,1082,889,878,823,938,1761,2639,3528,4610,20.76,6.59,5.05,3.77
12-08-2021,MACHICO,39,3,196,"[120,240]",Moderado,,,,39,Madeira,MADEIRA,3104,6825.1,19981,1197,860,662,455,331,786,1448,2308,3505,292.76,51.36,33.82,21.22
12-08-2021,MADALENA,3,0,51,"[0,120]",Baixo a Moderado,,,,3,Açores,AÇORES,4602,14712.33,5895,334,256,173,190,179,369,542,798,1132,40.07,7.69,5.42,3.68
12-08-2021,MAFRA,214,15,252,"[240,480]",Elevado,,,,214,Lisboa e Vale do Tejo,LISBOA,1109,29165.5,84816,3613,3334,2839,2089,1899,3988,6827,10161,13774,290.81,47.23,34.84,23.41
12-08-2021,MAIA,504,36,363,"[240,480]",Elevado,,,,504,Norte,PORTO,1306,8293.94,138971,7801,6617,4512,3339,2631,5970,10482,17099,24900,1675.56,300.22,206.16,126.38
12-08-2021,MANGUALDE,7,1,38,"[0,120]",Baixo a Moderado,,,,7,Centro,VISEU,1806,21925.56,18510,1198,1128,885,852,743,1595,2480,3608,4806,84.42,21.92,16.46,11.31
12-08-2021,MANTEIGAS,0,0,0,"[0,120]",Baixo a Moderado,,,,0,Centro,GUARDA,0908,12197.55,3007,258,197,159,167,146,313,472,669,927,24.65,7.6,5.48,3.87
12-08-2021,MARCO DE CANAVESES,126,9,244,"[240,480]",Elevado,,,,126,Norte,PORTO,1307,20188.98,51496,2678,2060,1488,1265,1023,2288,3776,5836,8514,255.07,42.17,28.91,18.7
12-08-2021,MARINHA GRANDE,132,9,342,"[240,480]",Elevado,,,,132,Centro,LEIRIA,1010,18725.19,38508,2365,2302,1638,1359,1058,2417,4055,6357,8722,205.65,46.58,33.95,21.66
12-08-2021,MARVÃO,0,0,0,"[0,120]",Baixo a Moderado,,,,0,Alentejo,PORTALEGRE,1210,15489.9,3005,198,185,142,197,237,434,576,761,959,19.4,6.19,4.91,3.72
12-08-2021,MATOSINHOS,736,53,420,"[240,480]",Elevado,,,,736,Norte,PORTO,1308,6241.97,175357,11850,9977,7023,5024,3884,8908,15931,25908,37758,2809.31,604.9,415.06,255.22
12-08-2021,MEALHADA,31,2,155,"[120,240]",Moderado,,,,31,Centro,AVEIRO,0111,11065.66,19914,1163,1039,810,828,831,1659,2469,3508,4671,179.96,42.21,31.7,22.31
12-08-2021,MÊDA,2,0,44,"[0,120]",Baixo a Moderado,,,,2,Centro,GUARDA,0909,28604.92,4587,343,306,290,288,443,731,1021,1327,1670,16.04,5.84,4.64,3.57
12-08-2021,MELGAÇO,7,1,88,"[0,120]",Baixo a Moderado,,,,7,Norte,VIANA DO CASTELO,1603,23824.58,8093,507,567,578,614,675,1289,1867,2434,2941,33.97,12.34,10.22,7.84
12-08-2021,MÉRTOLA,32,2,529,"[480,960]",Muito Elevado,,,,32,Alentejo,BEJA,0209,129287.34,6142,400,390,378,423,600,1023,1401,1791,2191,4.75,1.69,1.39,1.08
12-08-2021,MESÃO FRIO,0,0,0,"[0,120]",Baixo a Moderado,,,,0,Norte,VILA REAL,1704,2664.87,3964,265,205,168,157,120,277,445,650,915,148.74,34.33,24.39,16.7
12-08-2021,MIRA,12,1,101,"[0,120]",Baixo a Moderado,,,,12,Centro,COIMBRA,0608,12403.38,11832,727,729,659,550,466,1016,1675,2404,3131,95.4,25.24,19.38,13.5
12-08-2021,MIRANDA DO CORVO,8,1,63,"[0,120]",Baixo a Moderado,,,,8,Centro,COIMBRA,0609,12637.79,12708,706,659,568,498,404,902,1470,2129,2835,100.55,22.43,16.85,11.63
12-08-2021,MIRANDA DO DOURO,1,0,15,"[0,120]",Baixo a Moderado,,,,1,Norte,BRAGANÇA,0406,48718.31,6830,482,429,442,463,470,933,1375,1804,2286,14.02,4.69,3.7,2.82
12-08-2021,MIRANDELA,47,3,218,"[120,240]",Moderado,,,,47,Norte,BRAGANÇA,0407,65895.67,21754,1640,1315,1204,1078,947,2025,3229,4544,6184,33.01,9.38,6.9,4.9
12-08-2021,MOGADOURO,7,1,84,"[0,120]",Baixo a Moderado,,,,7,Norte,BRAGANÇA,0408,76064.93,8392,589,529,576,630,655,1285,1861,2390,2979,11.03,3.92,3.14,2.45
12-08-2021,MOIMENTA DA BEIRA,4,0,41,"[0,120]",Baixo a Moderado,,,,4,Norte,VISEU,1807,21996.9,9736,576,514,471,416,461,877,1348,1862,2438,44.26,11.08,8.46,6.13
12-08-2021,MOITA,205,15,318,"[240,480]",Elevado,,,,205,Lisboa e Vale do Tejo,SETÚBAL,1506,5525.98,64407,4226,3646,2623,1801,1425,3226,5849,9495,13721,1165.53,248.3,171.82,105.85
12-08-2021,MONÇÃO,21,2,118,"[0,120]",Baixo a Moderado,,,,21,Norte,VIANA DO CASTELO,1604,21130.85,17869,1161,1105,1031,1006,972,1978,3009,4114,5275,84.56,24.96,19.47,14.24
12-08-2021,MONCHIQUE,21,2,422,"[240,480]",Elevado,,,,21,Algarve,FARO,0809,39530.43,5077,353,384,321,355,392,747,1068,1452,1805,12.84,4.57,3.67,2.7
12-08-2021,MONDIM DE BASTO,8,1,116,"[0,120]",Baixo a Moderado,,,,8,Norte,VILA REAL,1705,17207.52,6946,395,300,314,284,283,567,881,1181,1576,40.36,9.16,6.86,5.12
12-08-2021,MONFORTE,1,0,34,"[0,120]",Baixo a Moderado,,,,1,Alentejo,PORTALEGRE,1211,42024.82,2975,139,115,117,192,168,360,477,592,731,7.08,1.74,1.41,1.14
12-08-2021,MONTALEGRE,54,4,597,"[480,960]",Muito Elevado,,,,54,Norte,VILA REAL,1706,80545.71,8997,699,628,595,603,730,1333,1928,2556,3255,11.17,4.04,3.17,2.39
12-08-2021,MONTEMOR-O-NOVO,79,6,505,"[480,960]",Muito Elevado,,,,79,Alentejo,ÉVORA,0706,123296.65,15647,991,953,868,878,971,1849,2717,3670,4661,12.69,3.78,2.98,2.2
12-08-2021,MONTEMOR-O-VELHO,40,3,158,"[120,240]",Moderado,,,,40,Centro,COIMBRA,0610,22896.23,25224,1496,1397,1217,1057,988,2045,3262,4659,6155,110.17,26.88,20.35,14.25
12-08-2021,MONTIJO,93,7,162,"[120,240]",Moderado,,,,93,Lisboa e Vale do Tejo,SETÚBAL,1507,34861.64,57614,2771,2441,1990,1554,1109,2663,4653,7094,9865,165.26,28.3,20.35,13.35
12-08-2021,MORA,1,0,25,"[0,120]",Baixo a Moderado,,,,1,Alentejo,ÉVORA,0707,44395.02,4138,336,275,252,238,257,495,747,1022,1358,9.32,3.06,2.3,1.68
12-08-2021,MORTÁGUA,23,2,261,"[240,480]",Elevado,,,,23,Centro,VISEU,1808,25117.82,8803,638,584,535,499,460,959,1494,2078,2716,35.05,10.81,8.27,5.95
12-08-2021,MOURA,47,3,345,"[240,480]",Elevado,,,,47,Alentejo,BEJA,0210,95845.55,13718,817,656,665,542,461,1003,1668,2324,3141,14.31,3.28,2.42,1.74
12-08-2021,MOURÃO,3,0,123,"[120,240]",Moderado,,,,3,Alentejo,ÉVORA,0708,27862.98,2450,139,108,80,104,109,213,293,401,540,8.79,1.94,1.44,1.05
12-08-2021,MURÇA,6,0,111,"[0,120]",Baixo a Moderado,,,,6,Norte,VILA REAL,1707,18937.11,5463,384,341,307,306,319,625,932,1273,1657,28.85,8.75,6.72,4.92
12-08-2021,MURTOSA,15,1,144,"[120,240]",Moderado,,,,15,Centro,AVEIRO,0112,7308.78,10279,509,473,403,353,409,762,1165,1638,2147,140.63,29.37,22.41,15.94
12-08-2021,NAZARÉ,59,4,414,"[240,480]",Elevado,,,,59,Lisboa e Vale do Tejo,LEIRIA,1011,8243.43,14165,967,903,670,420,396,816,1486,2389,3356,171.84,40.71,28.98,18.03
12-08-2021,NELAS,19,1,146,"[120,240]",Moderado,,,,19,Centro,VISEU,1809,12571.48,12974,924,787,668,604,583,1187,1855,2642,3566,103.21,28.37,21.02,14.76
12-08-2021,NISA,5,0,84,"[0,120]",Baixo a Moderado,,,,5,Alentejo,PORTALEGRE,1212,57567.84,6061,405,389,355,483,478,961,1316,1705,2110,10.53,3.67,2.96,2.29
12-08-2021,NORDESTE,6,0,125,"[120,240]",Moderado,,,,6,Açores,AÇORES,4202,10146.8,4862,246,180,124,161,162,323,447,627,873,47.92,8.6,6.18,4.41
12-08-2021,ÓBIDOS,27,2,225,"[120,240]",Moderado,,,,27,Lisboa e Vale do Tejo,LEIRIA,1012,14155.44,11850,743,650,574,452,436,888,1462,2112,2855,83.72,20.17,14.92,10.33
12-08-2021,ODEMIRA,133,10,540,"[480,960]",Muito Elevado,,,,133,Alentejo,BEJA,0211,172060.15,24717,1475,1317,1225,1397,1349,2746,3971,5288,6763,14.37,3.93,3.07,2.31
12-08-2021,ODIVELAS,479,34,296,"[240,480]",Elevado,,,,479,Lisboa e Vale do Tejo,LISBOA,1116,2654.36,161774,9562,9038,6952,4641,3812,8453,15405,24443,34005,6095.48,1281.27,920.99,580.44
12-08-2021,OEIRAS,651,47,367,"[240,480]",Elevado,,,,651,Lisboa e Vale do Tejo,LISBOA,1110,4588.31,177408,11580,11575,8566,6211,5855,12066,20632,32207,43787,3866.78,954.38,701.98,449.69
12-08-2021,OLEIROS,3,0,60,"[0,120]",Baixo a Moderado,,,,3,Centro,CASTELO BRANCO,0506,47109.31,5003,384,341,366,397,487,884,1250,1591,1975,10.62,4.19,3.38,2.65
12-08-2021,OLHÃO,188,13,423,"[240,480]",Elevado,,,,188,Algarve,FARO,0810,13086.38,44405,2455,2309,1689,1342,1268,2610,4299,6608,9063,339.33,69.26,50.5,32.85
12-08-2021,OLIVEIRA DE AZEMÉIS,75,5,113,"[0,120]",Baixo a Moderado,,,,75,Norte,AVEIRO,0113,16110.41,66011,4155,3614,2794,2183,1738,3921,6715,10329,14484,409.75,89.91,64.12,41.68
12-08-2021,OLIVEIRA DE FRADES,12,1,120,"[120,240]",Moderado,,,,12,Centro,VISEU,1810,14534.62,9936,553,475,438,359,415,774,1212,1687,2240,68.36,15.41,11.61,8.34
12-08-2021,OLIVEIRA DO BAIRRO,53,4,218,"[120,240]",Moderado,,,,53,Centro,AVEIRO,0114,8731.99,24277,1327,1182,999,786,810,1596,2595,3777,5104,278.02,58.45,43.25,29.72
12-08-2021,OLIVEIRA DO HOSPITAL,93,7,483,"[480,960]",Muito Elevado,,,,93,Centro,COIMBRA,0611,23451.66,19253,1161,1097,962,924,960,1884,2846,3943,5104,82.1,21.76,16.81,12.14
12-08-2021,OURÉM,70,5,160,"[120,240]",Moderado,,,,70,Lisboa e Vale do Tejo,SANTARÉM,1421,41668.03,44044,2463,2069,1899,1817,1603,3420,5319,7388,9851,105.7,23.64,17.73,12.77
12-08-2021,OURIQUE,17,1,374,"[240,480]",Elevado,,,,17,Alentejo,BEJA,0212,66331.36,4607,313,287,284,268,227,495,779,1066,1379,6.95,2.08,1.61,1.17
12-08-2021,OVAR,118,8,218,"[120,240]",Moderado,,,,118,Centro,AVEIRO,0115,14770.25,54260,3294,2709,1994,1636,1234,2870,4864,7573,10867,367.37,73.57,51.27,32.93
12-08-2021,PAÇOS DE FERREIRA,104,7,184,"[120,240]",Moderado,,,,104,Norte,PORTO,1309,7099.29,56728,2903,2193,1518,1135,664,1799,3317,5510,8413,799.1,118.51,77.62,46.72
12-08-2021,PALMELA,148,11,231,"[120,240]",Moderado,,,,148,Lisboa e Vale do Tejo,SETÚBAL,1508,46512.01,64269,3402,3244,2635,1846,1391,3237,5872,9116,12518,138.18,26.91,19.6,12.62
12-08-2021,PAMPILHOSA DA SERRA,2,0,50,"[0,120]",Baixo a Moderado,,,,2,Centro,COIMBRA,0612,39646.24,4037,238,254,295,339,423,762,1057,1311,1549,10.18,3.91,3.31,2.67
12-08-2021,PAREDES,269,19,313,"[240,480]",Elevado,,,,269,Norte,PORTO,1310,15675.69,86067,4272,3532,2412,1717,1258,2975,5387,8919,13191,549.04,84.15,56.9,34.36
12-08-2021,PAREDES DE COURA,27,2,319,"[240,480]",Elevado,,,,27,Norte,VIANA DO CASTELO,1605,13818.59,8535,466,528,407,465,515,980,1387,1915,2381,61.76,17.23,13.86,10.04
12-08-2021,PEDRÓGÃO GRANDE,1,0,29,"[0,120]",Baixo a Moderado,,,,1,Centro,LEIRIA,1013,12874.75,3410,175,173,196,221,252,473,669,842,1017,26.49,7.9,6.54,5.2
12-08-2021,PENACOVA,33,2,242,"[240,480]",Elevado,,,,33,Centro,COIMBRA,0613,21673.23,13694,968,923,745,621,703,1324,2069,2992,3960,63.18,18.27,13.81,9.55
12-08-2021,PENAFIEL,253,18,363,"[240,480]",Elevado,,,,253,Norte,PORTO,1311,21224.27,69772,3648,2823,2032,1663,1230,2893,4925,7748,11396,328.74,53.69,36.51,23.2
12-08-2021,PENALVA DO CASTELO,3,0,42,"[0,120]",Baixo a Moderado,,,,3,Centro,VISEU,1811,13433.92,7115,449,457,413,391,426,817,1230,1687,2136,52.96,15.9,12.56,9.16
12-08-2021,PENAMACOR,5,0,106,"[0,120]",Baixo a Moderado,,,,5,Centro,CASTELO BRANCO,0507,56370.69,4755,262,248,273,451,633,1084,1357,1605,1867,8.44,3.31,2.85,2.41
12-08-2021,PENEDONO,0,0,0,"[0,120]",Baixo a Moderado,,,,0,Norte,VISEU,1812,13370.75,2591,172,113,129,156,138,294,423,536,708,19.38,5.3,4.01,3.16
12-08-2021,PENELA,7,1,130,"[120,240]",Moderado,,,,7,Centro,COIMBRA,0614,13480.0,5397,314,324,274,359,344,703,977,1301,1615,40.04,11.98,9.65,7.25
12-08-2021,PENICHE,106,8,401,"[240,480]",Elevado,,,,106,Lisboa e Vale do Tejo,LEIRIA,1014,7754.98,26501,1746,1504,1203,926,707,1633,2836,4340,6086,341.73,78.48,55.96,36.57
12-08-2021,PESO DA RÉGUA,22,2,140,"[120,240]",Moderado,,,,22,Norte,VILA REAL,1708,9486.01,15773,1076,843,650,659,455,1114,1764,2607,3683,166.28,38.83,27.48,18.6
12-08-2021,PINHEL,3,0,36,"[0,120]",Baixo a Moderado,,,,3,Centro,GUARDA,0910,48452.12,8511,577,566,551,538,689,1227,1778,2344,2921,17.57,6.03,4.84,3.67
12-08-2021,POMBAL,84,6,163,"[120,240]",Moderado,,,,84,Centro,LEIRIA,1015,62600.28,51461,3187,2791,2494,2328,2027,4355,6849,9640,12827,82.21,20.49,15.4,10.94
12-08-2021,PONTA DELGADA,217,16,320,"[240,480]",Elevado,,,,217,Açores,AÇORES,4203,23298.65,67935,3108,2435,1726,1133,902,2035,3761,6196,9304,291.58,39.93,26.59,16.14
12-08-2021,PONTA DO SOL,1,0,12,"[0,120]",Baixo a Moderado,,,,1,Madeira,MADEIRA,3105,4622.03,8593,319,283,347,208,221,429,776,1059,1378,185.92,29.81,22.91,16.79
12-08-2021,PONTE DA BARCA,8,1,72,"[0,120]",Baixo a Moderado,,,,8,Norte,VIANA DO CASTELO,1606,18211.37,11180,635,576,517,554,490,1044,1561,2137,2772,61.39,15.22,11.73,8.57
12-08-2021,PONTE DE LIMA,79,6,192,"[120,240]",Moderado,,,,79,Norte,VIANA DO CASTELO,1607,32025.46,41315,2321,2022,1720,1596,1462,3058,4778,6800,9121,129.01,28.48,21.23,14.92
12-08-2021,PONTE DE SOR,67,5,445,"[240,480]",Elevado,,,,67,Alentejo,PORTALEGRE,1213,83971.16,14994,939,800,716,739,831,1570,2286,3086,4025,17.86,4.79,3.68,2.72
12-08-2021,PORTALEGRE,35,3,160,"[120,240]",Moderado,,,,35,Alentejo,PORTALEGRE,1214,44713.64,22172,1577,1351,1137,993,984,1977,3114,4465,6042,49.59,13.51,9.99,6.96
12-08-2021,PORTEL,10,1,173,"[120,240]",Moderado,,,,10,Alentejo,ÉVORA,0709,60100.57,5828,336,358,283,331,305,636,919,1277,1613,9.7,2.68,2.12,1.53
12-08-2021,PORTIMÃO,547,39,986,"[960,Max]",Extremamente Elevado,,,,547,Algarve,FARO,0811,18206.29,55483,3182,2927,2116,1582,1400,2982,5098,8025,11207,304.75,61.56,44.08,28.0
12-08-2021,PORTO,1209,86,558,"[480,960]",Muito Elevado,,,,1209,Norte,PORTO,1312,4142.02,216606,15790,15193,11280,9409,10044,19453,30733,45926,61716,5229.5,1490.0,1108.79,741.98
12-08-2021,PORTO DE MÓS,97,7,416,"[240,480]",Elevado,,,,97,Centro,LEIRIA,1016,26183.41,23275,1355,1210,1034,888,872,1760,2794,4004,5359,88.89,20.47,15.29,10.67
12-08-2021,PORTO MONIZ,2,0,87,"[0,120]",Baixo a Moderado,,,,2,Madeira,MADEIRA,3106,8293.38,2342,143,130,95,98,120,218,313,443,586,28.24,7.07,5.34,3.77
12-08-2021,PORTO SANTO,8,1,154,"[120,240]",Moderado,,,,8,Madeira,MADEIRA,3201,4300.7,5202,240,157,134,110,68,178,312,469,709,120.95,16.48,10.9,7.25
12-08-2021,PÓVOA DE LANHOSO,69,5,321,"[240,480]",Elevado,,,,69,Norte,BRAGA,0309,13465.29,21499,1175,909,732,673,624,1297,2029,2938,4113,159.67,30.55,21.82,15.07
12-08-2021,PÓVOA DE VARZIM,222,16,354,"[240,480]",Elevado,,,,222,Norte,PORTO,1313,8220.59,62784,3712,3120,2134,1594,1305,2899,5033,8153,11865,763.7,144.33,99.17,61.22
12-08-2021,POVOAÇÃO,6,0,102,"[0,120]",Baixo a Moderado,,,,6,Açores,AÇORES,4204,10640.77,5927,293,212,191,144,134,278,469,681,974,55.7,9.15,6.4,4.41
12-08-2021,VILA DA PRAIA DA VITÓRIA,32,2,151,"[120,240]",Moderado,,,,32,Açores,AÇORES,4302,16127.06,21317,1133,789,619,436,336,772,1391,2180,3313,132.18,20.54,13.52,8.63
12-08-2021,PROENÇA-A-NOVA,142,10,1947,"[960,Max]",Extremamente Elevado,,,,142,Centro,CASTELO BRANCO,0508,39539.96,7298,508,465,389,400,560,960,1349,1814,2322,18.46,5.87,4.59,3.41
12-08-2021,REDONDO,6,0,95,"[0,120]",Baixo a Moderado,,,,6,Alentejo,ÉVORA,0710,36950.87,6353,349,325,288,288,354,642,930,1255,1604,17.19,4.34,3.4,2.52
12-08-2021,REGUENGOS DE MONSARAZ,21,2,212,"[120,240]",Moderado,,,,21,Alentejo,ÉVORA,0711,46399.72,10015,602,511,455,462,473,935,1390,1901,2503,21.58,5.39,4.1,3.0
12-08-2021,RESENDE,32,2,319,"[240,480]",Elevado,,,,32,Norte,VISEU,1813,12334.93,10137,560,493,448,433,422,855,1303,1796,2356,82.18,19.1,14.56,10.56
12-08-2021,RIBEIRA BRAVA,14,1,113,"[0,120]",Baixo a Moderado,,,,14,Madeira,MADEIRA,3107,6544.88,12435,648,500,411,311,287,598,1009,1509,2157,189.99,32.96,23.06,15.42
12-08-2021,RIBEIRA DE PENA,7,1,117,"[0,120]",Baixo a Moderado,,,,7,Norte,VILA REAL,1709,21745.98,6016,371,301,290,310,368,678,968,1269,1640,27.66,7.54,5.84,4.45
12-08-2021,RIBEIRA GRANDE,176,13,536,"[480,960]",Muito Elevado,,,,176,Açores,AÇORES,4205,18015.13,32811,1163,689,512,345,253,598,1110,1799,2962,182.13,16.44,9.99,6.16
12-08-2021,RIO MAIOR,56,4,276,"[240,480]",Elevado,,,,56,Lisboa e Vale do Tejo,SANTARÉM,1414,27276.45,20379,1251,1144,941,795,648,1443,2384,3528,4779,74.71,17.52,12.93,8.74
12-08-2021,SABROSA,6,0,102,"[0,120]",Baixo a Moderado,,,,6,Norte,VILA REAL,1710,15692.45,5918,393,314,304,302,350,652,956,1270,1663,37.71,10.6,8.09,6.09
12-08-2021,SABUGAL,6,0,57,"[0,120]",Baixo a Moderado,,,,6,Centro,GUARDA,0911,82269.82,10585,724,707,694,796,1009,1805,2499,3206,3930,12.87,4.78,3.9,3.04
12-08-2021,SALVATERRA DE MAGOS,27,2,127,"[120,240]",Moderado,,,,27,Lisboa e Vale do Tejo,SANTARÉM,1415,24393.2,21295,1275,1181,1060,799,772,1571,2631,3812,5087,87.3,20.85,15.63,10.79
12-08-2021,SANTA COMBA DÃO,7,1,67,"[0,120]",Baixo a Moderado,,,,7,Centro,VISEU,1814,11194.77,10452,732,684,569,538,464,1002,1571,2255,2987,93.36,26.68,20.14,14.03
12-08-2021,SANTA CRUZ,63,5,140,"[120,240]",Moderado,,,,63,Madeira,MADEIRA,3108,8150.28,45281,1817,1301,974,716,523,1239,2213,3514,5331,555.6,65.41,43.12,27.15
12-08-2021,SANTA CRUZ DA GRACIOSA,2,0,48,"[0,120]",Baixo a Moderado,,,,2,Açores,AÇORES,4401,6065.78,4208,228,180,163,124,145,269,432,612,840,69.37,13.85,10.09,7.12
12-08-2021,SANTA CRUZ DAS FLORES,0,0,0,"[0,120]",Baixo a Moderado,,,,0,Açores,AÇORES,4802,7091.44,2165,125,98,74,56,51,107,181,279,404,30.53,5.7,3.93,2.55
12-08-2021,SANTA MARIA DA FEIRA,344,25,248,"[240,480]",Elevado,,,,344,Norte,AVEIRO,0109,21587.65,138636,8182,6743,4771,3856,3079,6935,11706,18449,26631,642.19,123.36,85.46,54.22
12-08-2021,SANTA MARTA DE PENAGUIÃO,18,1,275,"[240,480]",Elevado,,,,18,Norte,VILA REAL,1711,6928.13,6599,483,373,337,316,317,633,970,1343,1826,95.25,26.36,19.39,14.0
12-08-2021,SANTANA,2,0,30,"[0,120]",Baixo a Moderado,,,,2,Madeira,MADEIRA,3109,9547.3,6711,418,353,343,282,277,559,902,1255,1673,70.29,17.52,13.15,9.45
12-08-2021,SANTARÉM,142,10,247,"[240,480]",Elevado,,,,142,Lisboa e Vale do Tejo,SANTARÉM,1416,55253.58,57421,3654,3441,2760,2466,2206,4672,7432,10873,14527,103.92,26.29,19.68,13.45
12-08-2021,SANTIAGO DO CACÉM,40,3,140,"[120,240]",Moderado,,,,40,Alentejo,SETÚBAL,1509,105969.29,28791,2144,1689,1472,1295,1215,2510,3982,5671,7815,27.17,7.37,5.35,3.76
12-08-2021,SANTO TIRSO,174,12,256,"[240,480]",Elevado,,,,174,Norte,PORTO,1314,13655.52,68055,4911,3935,2761,2257,1810,4067,6828,10763,15674,498.35,114.78,78.82,50.0
12-08-2021,SÃO BRÁS DE ALPORTEL,33,2,318,"[240,480]",Elevado,,,,33,Algarve,FARO,0812,15336.92,10416,596,468,467,404,401,805,1272,1740,2336,67.91,15.23,11.35,8.29
12-08-2021,SÃO JOÃO DA MADEIRA,62,4,281,"[240,480]",Elevado,,,,62,Norte,AVEIRO,0116,794.3,21958,1347,1069,796,601,593,1194,1990,3059,4406,2765.49,554.91,385.26,250.63
12-08-2021,SÃO JOÃO DA PESQUEIRA,4,0,57,"[0,120]",Baixo a Moderado,,,,4,Norte,VISEU,1815,26610.85,7125,417,330,294,328,328,656,950,1280,1697,26.77,6.38,4.81,3.57
12-08-2021,SÃO PEDRO DO SUL,15,1,97,"[0,120]",Baixo a Moderado,,,,15,Centro,VISEU,1816,34895.09,15403,990,962,861,759,909,1668,2529,3491,4481,44.14,12.84,10.0,7.25
12-08-2021,SÃO ROQUE DO PICO,2,0,61,"[0,120]",Baixo a Moderado,,,,2,Açores,AÇORES,4603,14236.1,3266,199,141,93,96,113,209,302,443,642,22.94,4.51,3.11,2.12
12-08-2021,SÃO VICENTE,21,2,411,"[240,480]",Elevado,,,,21,Madeira,MADEIRA,3110,7883.71,5143,272,264,266,225,280,505,771,1035,1307,65.23,16.58,13.13,9.78
12-08-2021,SARDOAL,6,0,161,"[120,240]",Moderado,,,,6,Lisboa e Vale do Tejo,SANTARÉM,1417,9214.72,3741,227,178,148,165,248,413,561,739,966,40.6,10.48,8.02,6.09
12-08-2021,SÁTÃO,16,1,138,"[120,240]",Moderado,,,,16,Centro,VISEU,1817,20194.11,11580,765,671,515,465,476,941,1456,2127,2892,57.34,14.32,10.53,7.21
12-08-2021,SEIA,26,2,117,"[0,120]",Baixo a Moderado,,,,26,Centro,GUARDA,0912,43568.83,22234,1807,1589,1238,1122,721,1843,3081,4670,6477,51.03,14.87,10.72,7.07
12-08-2021,SEIXAL,450,32,268,"[240,480]",Elevado,,,,450,Lisboa e Vale do Tejo,SETÚBAL,1510,9545.17,167752,10586,9270,6661,4391,2930,7321,13982,23252,33838,1757.49,354.51,243.6,146.49
12-08-2021,SERNANCELHE,3,0,56,"[0,120]",Baixo a Moderado,,,,3,Norte,VISEU,1818,22861.22,5396,305,293,286,273,260,533,819,1112,1417,23.6,6.2,4.86,3.58
12-08-2021,SERPA,75,5,522,"[480,960]",Muito Elevado,,,,75,Alentejo,BEJA,0213,110563.34,14304,903,761,719,697,626,1323,2042,2803,3706,12.94,3.35,2.54,1.85
12-08-2021,SERTÃ,10,1,69,"[0,120]",Baixo a Moderado,,,,10,Centro,CASTELO BRANCO,0509,44673.17,14577,870,779,790,767,1020,1787,2577,3356,4226,32.63,9.46,7.51,5.77
12-08-2021,SESIMBRA,125,9,241,"[240,480]",Elevado,,,,125,Lisboa e Vale do Tejo,SETÚBAL,1511,19571.75,51858,2400,2321,1853,1257,1083,2340,4193,6514,8914,264.96,45.54,33.28,21.42
12-08-2021,SETÚBAL,322,23,280,"[240,480]",Elevado,,,,322,Lisboa e Vale do Tejo,SETÚBAL,1512,23032.5,115126,7425,6929,5075,3775,2655,6430,11505,18434,25859,499.83,112.27,80.03,49.95
12-08-2021,SEVER DO VOUGA,13,1,115,"[0,120]",Baixo a Moderado,,,,13,Centro,AVEIRO,0117,12987.56,11331,766,637,568,540,567,1107,1675,2312,3078,87.24,23.7,17.8,12.9
12-08-2021,SILVES,152,11,420,"[240,480]",Elevado,,,,152,Algarve,FARO,0813,68006.23,36226,2137,1869,1610,1423,1600,3023,4633,6502,8639,53.27,12.7,9.56,6.81
12-08-2021,SINES,108,8,788,"[480,960]",Muito Elevado,,,,108,Alentejo,SETÚBAL,1513,20330.17,13715,888,791,551,416,268,684,1235,2026,2914,67.46,14.33,9.97,6.07
12-08-2021,SINTRA,1225,88,313,"[240,480]",Elevado,,,,1225,Lisboa e Vale do Tejo,LISBOA,1111,31922.73,391402,20490,18316,13545,9137,7284,16421,29966,48282,68772,1226.08,215.43,151.25,93.87
12-08-2021,SOBRAL DE MONTE AGRAÇO,27,2,249,"[240,480]",Elevado,,,,27,Lisboa e Vale do Tejo,LISBOA,1112,5210.32,10651,564,507,352,272,212,484,836,1343,1907,204.43,36.6,25.78,16.05
12-08-2021,SOURE,37,3,217,"[120,240]",Moderado,,,,37,Centro,COIMBRA,0615,26506.07,17120,1173,1142,1004,883,987,1870,2874,4016,5189,64.59,19.58,15.15,10.84
12-08-2021,SOUSEL,43,3,970,"[960,Max]",Extremamente Elevado,,,,43,Alentejo,PORTALEGRE,1215,27932.18,4412,261,274,208,302,292,594,802,1076,1337,15.8,4.79,3.85,2.87
12-08-2021,TÁBUA,11,1,96,"[0,120]",Baixo a Moderado,,,,11,Centro,COIMBRA,0616,19978.58,11368,729,584,524,430,464,894,1418,2002,2731,56.9,13.67,10.02,7.1
12-08-2021,TABUAÇO,7,0,116,"[0,120]",Baixo a Moderado,,,,7,Norte,VISEU,1819,13385.67,6033,372,314,217,282,363,645,862,1176,1548,45.07,11.56,8.79,6.44
12-08-2021,TAROUCA,4,0,51,"[0,120]",Baixo a Moderado,,,,4,Norte,VISEU,1820,10008.49,7804,405,335,313,277,324,601,914,1249,1654,77.98,16.53,12.48,9.13
12-08-2021,TAVIRA,62,4,251,"[240,480]",Elevado,,,,62,Algarve,FARO,0814,60696.7,24530,1493,1415,1252,1066,1277,2343,3595,5010,6503,40.41,10.71,8.25,5.92
12-08-2021,TERRAS DE BOURO,10,1,158,"[120,240]",Moderado,,,,10,Norte,BRAGA,0310,27746.07,6361,391,372,296,319,340,659,955,1327,1718,22.93,6.19,4.78,3.44
12-08-2021,TOMAR,45,3,122,"[120,240]",Moderado,,,,45,Lisboa e Vale do Tejo,SANTARÉM,1418,35120.44,36748,2403,2189,1868,1853,1822,3675,5543,7732,10135,104.64,28.86,22.02,15.78
12-08-2021,TONDELA,39,3,148,"[120,240]",Moderado,,,,39,Centro,VISEU,1821,37121.73,26357,1768,1722,1518,1475,1417,2892,4410,6132,7900,71.0,21.28,16.52,11.88
12-08-2021,TORRE DE MONCORVO,6,0,79,"[0,120]",Baixo a Moderado,,,,6,Norte,BRAGANÇA,0409,53155.67,7695,556,478,488,551,719,1270,1758,2236,2792,14.48,5.25,4.21,3.31
12-08-2021,TORRES NOVAS,89,6,256,"[240,480]",Elevado,,,,89,Lisboa e Vale do Tejo,SANTARÉM,1419,26999.68,34933,2324,1979,1738,1406,1475,2881,4619,6598,8922,129.38,33.04,24.44,17.11
12-08-2021,TORRES VEDRAS,143,10,182,"[120,240]",Moderado,,,,143,Lisboa e Vale do Tejo,LISBOA,1113,40714.89,78530,4513,3945,3447,2628,2104,4732,8179,12124,16637,192.88,40.86,29.78,20.09
12-08-2021,TRANCOSO,4,0,45,"[0,120]",Baixo a Moderado,,,,4,Centro,GUARDA,0913,36152.47,8875,581,557,542,586,496,1082,1624,2181,2762,24.55,7.64,6.03,4.49
12-08-2021,TROFA,136,10,354,"[240,480]",Elevado,,,,136,Norte,PORTO,1318,7201.76,38418,2336,1894,1231,939,684,1623,2854,4748,7084,533.44,98.36,65.93,39.63
12-08-2021,VAGOS,53,4,235,"[120,240]",Moderado,,,,53,Centro,AVEIRO,0118,16491.5,22740,1320,1205,922,784,724,1508,2430,3635,4955,137.89,30.04,22.04,14.73
12-08-2021,VALE DE CAMBRA,40,3,189,"[120,240]",Moderado,,,,40,Norte,AVEIRO,0119,14733.47,21327,1491,1363,1005,831,798,1629,2634,3997,5488,144.76,37.25,27.13,17.88
12-08-2021,VALENÇA,64,5,478,"[240,480]",Elevado,,,,64,Norte,VIANA DO CASTELO,1608,11712.86,13290,867,791,582,582,503,1085,1667,2458,3325,113.46,28.39,20.99,14.23
12-08-2021,VALONGO,280,20,287,"[240,480]",Elevado,,,,280,Norte,PORTO,1315,7512.45,97444,5629,4696,3207,2462,1829,4291,7498,12194,17823,1297.18,237.26,162.33,99.81
12-08-2021,VALPAÇOS,19,1,130,"[120,240]",Moderado,,,,19,Norte,VILA REAL,1712,54873.93,14818,1217,1118,999,928,997,1925,2924,4042,5259,27.0,9.58,7.37,5.33
12-08-2021,VELAS,7,1,138,"[120,240]",Moderado,,,,7,Açores,AÇORES,4502,11738.38,5093,278,208,166,153,113,266,432,640,918,43.39,7.82,5.45,3.68
12-08-2021,VENDAS NOVAS,20,1,179,"[120,240]",Moderado,,,,20,Alentejo,ÉVORA,0712,22238.88,11255,677,768,655,501,532,1033,1688,2456,3133,50.61,14.09,11.04,7.59
12-08-2021,VIANA DO ALENTEJO,5,0,98,"[0,120]",Baixo a Moderado,,,,5,Alentejo,ÉVORA,0713,39367.29,5145,245,208,235,210,214,424,659,867,1112,13.07,2.82,2.2,1.67
12-08-2021,VIANA DO CASTELO,168,12,199,"[120,240]",Moderado,,,,168,Norte,VIANA DO CASTELO,1609,31902.01,84417,5470,4433,3591,3061,2982,6043,9634,14067,19537,264.61,61.24,44.09,30.2
12-08-2021,VIDIGUEIRA,20,1,365,"[240,480]",Elevado,,,,20,Alentejo,BEJA,0214,31661.09,5510,300,248,215,233,275,508,723,971,1271,17.4,4.01,3.07,2.28
12-08-2021,VIEIRA DO MINHO,54,4,458,"[240,480]",Elevado,,,,54,Norte,BRAGA,0311,21644.35,11842,703,594,525,548,482,1030,1555,2149,2852,54.71,13.18,9.93,7.18
12-08-2021,VILA DE REI,1,0,30,"[0,120]",Baixo a Moderado,,,,1,Centro,CASTELO BRANCO,0510,19154.6,3323,169,128,172,247,302,549,721,849,1018,17.35,5.31,4.43,3.76
12-08-2021,VILA DO BISPO,68,5,1321,"[960,Max]",Extremamente Elevado,,,,68,Algarve,FARO,0815,17906.06,5154,302,302,314,232,233,465,779,1081,1383,28.78,7.72,6.04,4.35
12-08-2021,VILA DO CONDE,276,20,345,"[240,480]",Elevado,,,,276,Norte,PORTO,1316,14902.77,79899,4726,3875,2819,2070,1743,3813,6632,10507,15233,536.13,102.21,70.5,44.5
12-08-2021,VILA DO PORTO,8,1,143,"[120,240]",Moderado,,,,8,Açores,AÇORES,4101,9688.74,5616,274,212,135,96,123,219,354,566,840,57.96,8.67,5.84,3.65
12-08-2021,VILA FLOR,15,1,250,"[240,480]",Elevado,,,,15,Norte,BRAGANÇA,0410,26581.14,6044,429,362,422,294,331,625,1047,1409,1838,22.74,6.91,5.3,3.94
12-08-2021,VILA FRANCA DE XIRA,358,26,252,"[240,480]",Elevado,,,,358,Lisboa e Vale do Tejo,LISBOA,1114,31819.39,141957,8501,6852,4869,3425,2472,5897,10766,17618,26119,446.14,82.09,55.37,33.84
12-08-2021,VILA FRANCA DO CAMPO,53,4,483,"[480,960]",Muito Elevado,,,,53,Açores,AÇORES,4206,7796.82,11051,450,344,248,217,154,371,619,963,1413,141.73,18.12,12.35,7.94
12-08-2021,VILA NOVA DA BARQUINHA,18,1,238,"[120,240]",Moderado,,,,18,Lisboa e Vale do Tejo,SANTARÉM,1420,4952.97,7461,415,406,392,364,338,702,1094,1500,1915,150.64,38.66,30.28,22.09
12-08-2021,VILA NOVA DE CERVEIRA,10,1,112,"[0,120]",Baixo a Moderado,,,,10,Norte,VIANA DO CASTELO,1610,10846.66,8910,531,444,410,384,334,718,1128,1572,2103,82.14,19.39,14.49,10.4
12-08-2021,VILA NOVA DE FAMALICÃO,348,25,264,"[240,480]",Elevado,,,,348,Norte,BRAGA,0312,20159.26,131676,7817,6164,4202,3282,2749,6031,10233,16397,24214,653.19,120.12,81.34,50.76
12-08-2021,VILA NOVA DE FOZ CÔA,41,3,638,"[480,960]",Muito Elevado,,,,41,Centro,GUARDA,0914,39815.18,6503,442,385,390,398,429,827,1217,1602,2044,16.33,5.13,4.02,3.06
12-08-2021,VILA NOVA DE GAIA,1127,80,375,"[240,480]",Elevado,,,,1127,Norte,PORTO,1317,16846.43,300472,18349,15568,10972,8224,6281,14505,25477,41045,59394,1783.64,352.57,243.65,151.23
12-08-2021,VILA NOVA DE PAIVA,7,0,149,"[120,240]",Moderado,,,,7,Centro,VISEU,1822,17553.28,4687,289,272,233,217,241,458,691,963,1252,26.7,7.13,5.49,3.94
12-08-2021,VILA NOVA DE POIARES,9,1,129,"[120,240]",Moderado,,,,9,Centro,COIMBRA,0617,8445.3,6939,380,284,262,235,182,417,679,963,1343,82.17,15.9,11.4,8.04
12-08-2021,VILA POUCA DE AGUIAR,13,1,110,"[0,120]",Baixo a Moderado,,,,13,Norte,VILA REAL,1713,43706.62,11961,860,817,733,601,627,1228,1961,2778,3638,27.37,8.32,6.36,4.49
12-08-2021,VILA REAL,160,11,321,"[240,480]",Elevado,,,,160,Norte,VILA REAL,1714,37880.28,49962,3025,2498,2065,1579,1466,3045,5110,7608,10633,131.9,28.07,20.08,13.49
12-08-2021,VILA REAL DE SANTO ANTÓNIO,123,9,655,"[480,960]",Muito Elevado,,,,123,Algarve,FARO,0816,6125.0,18749,1172,1069,811,569,586,1155,1966,3035,4207,306.11,68.69,49.55,32.1
12-08-2021,VILA VELHA DE RÓDÃO,2,0,64,"[0,120]",Baixo a Moderado,,,,2,Centro,CASTELO BRANCO,0511,32991.16,3144,209,229,180,283,306,589,769,998,1207,9.53,3.66,3.03,2.33
12-08-2021,VILA VERDE,121,9,257,"[240,480]",Elevado,,,,121,Norte,BRAGA,0313,22866.52,46911,2365,2063,1667,1494,1437,2931,4598,6661,9026,205.15,39.47,29.13,20.11
12-08-2021,VILA VIÇOSA,30,2,397,"[240,480]",Elevado,,,,30,Alentejo,ÉVORA,0714,19485.89,7656,487,379,342,345,324,669,1011,1390,1877,39.29,9.63,7.13,5.19
12-08-2021,VIMIOSO,1,0,25,"[0,120]",Baixo a Moderado,,,,1,Norte,BRAGANÇA,0411,48158.51,4023,274,230,261,293,335,628,889,1119,1393,8.35,2.89,2.32,1.85
12-08-2021,VINHAIS,2,0,26,"[0,120]",Baixo a Moderado,,,,2,Norte,BRAGANÇA,0412,69475.09,7746,599,577,636,641,815,1456,2092,2669,3268,11.15,4.7,3.84,3.01
12-08-2021,VISEU,224,16,230,"[120,240]",Moderado,,,,224,Centro,VISEU,1823,50710.14,97249,5769,5038,4140,3158,2710,5868,10008,15046,20815,191.77,41.05,29.67,19.74
12-08-2021,VIZELA,76,5,318,"[240,480]",Elevado,,,,76,Norte,BRAGA,0314,2469.83,23897,1258,928,655,509,371,880,1535,2463,3721,967.49,150.65,99.72,62.15
12-08-2021,VOUZELA,12,1,125,"[120,240]",Moderado,,,,12,Centro,VISEU,1824,19369.46,9619,626,605,554,532,507,1039,1593,2198,2824,49.66,14.58,11.35,8.22
19-08-2021,ABRANTES,36,3,103,"[0,120]",Baixo a Moderado,,,,36,Lisboa e Vale do Tejo,SANTARÉM,1401,71469.08,35130,2473,2213,1730,1748,2021,3769,5499,7712,10185,49.15,14.25,10.79,7.69
19-08-2021,ÁGUEDA,110,8,239,"[120,240]",Moderado,,,,110,Centro,AVEIRO,0101,33527.44,46075,3237,2713,2090,1635,1496,3131,5221,7934,11171,137.43,33.32,23.66,15.57
19-08-2021,AGUIAR DA BEIRA,13,1,281,"[240,480]",Elevado,,,,13,Centro,GUARDA,0901,20676.57,4652,304,281,235,239,148,387,622,903,1207,22.5,5.84,4.37,3.01
19-08-2021,ALANDROAL,10,1,204,"[120,240]",Moderado,,,,10,Alentejo,ÉVORA,0701,54267.81,4992,307,256,296,299,377,676,972,1228,1535,9.2,2.83,2.26,1.79
19-08-2021,ALBERGARIA-A-VELHA,50,4,206,"[120,240]",Moderado,,,,50,Centro,AVEIRO,0102,15882.5,24144,1550,1298,996,687,680,1367,2363,3661,5211,152.02,32.81,23.05,14.88
19-08-2021,ALBUFEIRA,411,29,990,"[960,Max]",Extremamente Elevado,,,,411,Algarve,FARO,0801,14066.42,41528,2067,1717,1425,985,858,1843,3268,4985,7052,295.24,50.14,35.44,23.23
19-08-2021,ALCÁCER DO SAL,34,2,294,"[240,480]",Elevado,,,,34,Alentejo,SETÚBAL,1501,149987.3,11659,884,814,623,623,602,1225,1848,2662,3546,7.77,2.36,1.77,1.23
19-08-2021,ALCANENA,49,3,381,"[240,480]",Elevado,,,,49,Lisboa e Vale do Tejo,SANTARÉM,1402,12732.86,12809,891,744,628,536,588,1124,1752,2496,3387,100.6,26.6,19.6,13.76
19-08-2021,ALCOBAÇA,168,12,313,"[240,480]",Elevado,,,,168,Lisboa e Vale do Tejo,LEIRIA,1001,40814.09,53555,3420,2927,2466,2059,1676,3735,6201,9128,12548,131.22,30.74,22.36,15.19
19-08-2021,ALCOCHETE,40,3,201,"[120,240]",Moderado,,,,40,Lisboa e Vale do Tejo,SETÚBAL,1502,12836.48,19787,857,834,691,476,447,923,1614,2448,3305,154.15,25.75,19.07,12.57
19-08-2021,ALCOUTIM,4,0,193,"[120,240]",Moderado,,,,4,Algarve,FARO,0802,57536.33,2159,191,188,163,190,267,457,620,808,999,3.75,1.74,1.4,1.08
19-08-2021,ALENQUER,85,6,192,"[120,240]",Moderado,,,,85,Lisboa e Vale do Tejo,LISBOA,1101,30421.92,44052,2298,2062,1629,1330,1155,2485,4114,6176,8474,144.8,27.85,20.3,13.52
19-08-2021,ALFÂNDEGA DA FÉ,1,0,22,"[0,120]",Baixo a Moderado,,,,1,Norte,BRAGANÇA,0401,32194.64,4550,325,277,301,274,325,599,900,1177,1502,14.13,4.67,3.66,2.8
19-08-2021,ALIJÓ,15,1,142,"[120,240]",Moderado,,,,15,Norte,VILA REAL,1701,29759.89,10625,766,687,635,542,666,1208,1843,2530,3296,35.7,11.08,8.5,6.19
19-08-2021,ALJEZUR,29,2,518,"[480,960]",Muito Elevado,,,,29,Algarve,FARO,0803,32349.95,5594,316,336,335,320,410,730,1065,1401,1717,17.29,5.31,4.33,3.29
19-08-2021,ALJUSTREL,11,1,135,"[120,240]",Moderado,,,,11,Alentejo,BEJA,0201,45847.41,8247,635,521,443,347,358,705,1148,1669,2304,17.99,5.03,3.64,2.5
19-08-2021,ALMADA,536,38,317,"[240,480]",Elevado,,,,536,Lisboa e Vale do Tejo,SETÚBAL,1503,7000.89,169039,10469,9777,7876,6144,5111,11255,19131,28908,39377,2414.5,562.45,412.91,273.26
19-08-2021,ALMEIDA,16,1,277,"[240,480]",Elevado,,,,16,Centro,GUARDA,0902,51798.46,5830,441,419,396,458,393,851,1247,1666,2107,11.26,4.07,3.22,2.41
19-08-2021,ALMEIRIM,47,3,210,"[120,240]",Moderado,,,,47,Lisboa e Vale do Tejo,SANTARÉM,1403,22212.05,22546,1342,1353,1106,866,843,1709,2815,4168,5510,101.5,24.81,18.76,12.67
19-08-2021,ALMODÔVAR,63,4,931,"[480,960]",Muito Elevado,,,,63,Alentejo,BEJA,0202,77788.03,6725,414,443,396,373,328,701,1097,1540,1954,8.65,2.51,1.98,1.41
19-08-2021,ALPIARÇA,42,3,601,"[480,960]",Muito Elevado,,,,42,Lisboa e Vale do Tejo,SANTARÉM,1404,9536.33,7059,515,486,363,333,274,607,970,1456,1971,74.02,20.67,15.27,10.17
19-08-2021,ALTER DO CHÃO,10,1,319,"[240,480]",Elevado,,,,10,Alentejo,PORTALEGRE,1201,36206.62,3165,201,163,136,208,187,395,531,694,895,8.74,2.47,1.92,1.47
19-08-2021,ALVAIÁZERE,1,0,15,"[0,120]",Baixo a Moderado,,,,1,Centro,LEIRIA,1002,16047.76,6597,419,389,346,406,539,945,1291,1680,2099,41.11,13.08,10.47,8.04
19-08-2021,ALVITO,2,0,81,"[0,120]",Baixo a Moderado,,,,2,Alentejo,BEJA,0203,26485.32,2477,145,110,105,111,89,200,305,415,560,9.35,2.11,1.57,1.15
19-08-2021,AMADORA,650,46,353,"[240,480]",Elevado,,,,650,Lisboa e Vale do Tejo,LISBOA,1115,2378.47,184106,11186,10936,8780,6460,5890,12350,21130,32066,43252,7742.05,1818.84,1348.44,888.56
19-08-2021,AMARANTE,139,10,261,"[240,480]",Elevado,,,,139,Norte,PORTO,1301,30133.15,53193,3086,2413,1812,1643,1311,2954,4766,7179,10265,176.53,34.07,23.82,15.82
19-08-2021,AMARES,85,6,470,"[240,480]",Elevado,,,,85,Norte,BRAGA,0301,8195.41,18129,1001,829,622,489,524,1013,1635,2464,3465,221.22,42.28,30.07,19.95
19-08-2021,ANADIA,64,5,234,"[120,240]",Moderado,,,,64,Centro,AVEIRO,0103,21663.48,27258,1931,1698,1376,1208,1262,2470,3846,5544,7475,125.83,34.51,25.59,17.75
19-08-2021,ANGRA DO HEROÍSMO,28,2,83,"[0,120]",Baixo a Moderado,,,,28,Açores,AÇORES,4301,23899.66,33807,2006,1473,1122,768,635,1403,2525,3998,6004,141.45,25.12,16.73,10.56
19-08-2021,ANSIÃO,22,2,182,"[120,240]",Moderado,,,,22,Centro,LEIRIA,1003,17609.42,12039,727,709,646,694,530,1224,1870,2579,3306,68.37,18.77,14.65,10.62
19-08-2021,ARCOS DE VALDEVEZ,13,1,63,"[0,120]",Baixo a Moderado,,,,13,Norte,VIANA DO CASTELO,1601,44759.64,20926,1329,1338,1282,1343,1515,2858,4140,5478,6807,46.75,15.21,12.24,9.25
19-08-2021,ARGANIL,6,0,55,"[0,120]",Baixo a Moderado,,,,6,Centro,COIMBRA,0601,33283.93,11014,672,648,612,559,596,1155,1767,2415,3087,33.09,9.27,7.26,5.31
19-08-2021,ARMAMAR,2,0,35,"[0,120]",Baixo a Moderado,,,,2,Norte,VISEU,1801,11723.73,5769,357,305,309,285,310,595,904,1209,1566,49.21,13.36,10.31,7.71
19-08-2021,AROUCA,131,9,631,"[480,960]",Muito Elevado,,,,131,Norte,AVEIRO,0104,32910.52,20720,1306,1047,753,683,683,1366,2119,3166,4472,62.96,13.59,9.62,6.44
19-08-2021,ARRAIOLOS,6,0,87,"[0,120]",Baixo a Moderado,,,,6,Alentejo,ÉVORA,0702,68374.55,6928,435,384,283,367,480,847,1130,1514,1949,10.13,2.85,2.21,1.65
19-08-2021,ARRONCHES,2,0,72,"[0,120]",Baixo a Moderado,,,,2,Alentejo,PORTALEGRE,1202,31464.72,2820,155,142,162,187,179,366,528,670,825,8.96,2.62,2.13,1.68
19-08-2021,ARRUDA DOS VINHOS,20,1,127,"[120,240]",Moderado,,,,20,Lisboa e Vale do Tejo,LISBOA,1102,7795.93,15412,738,738,562,509,438,947,1509,2247,2985,197.69,38.29,28.82,19.36
19-08-2021,AVEIRO,162,12,206,"[120,240]",Moderado,,,,162,Centro,AVEIRO,0105,19757.57,78734,4520,4004,3050,2250,2103,4353,7403,11407,15927,398.49,80.61,57.73,37.47
19-08-2021,AVIS,1,0,24,"[0,120]",Baixo a Moderado,,,,1,Alentejo,PORTALEGRE,1203,60596.51,4247,315,225,206,251,273,524,730,955,1270,7.01,2.1,1.58,1.2
19-08-2021,AZAMBUJA,16,1,70,"[0,120]",Baixo a Moderado,,,,16,Lisboa e Vale do Tejo,LISBOA,1103,26265.65,22716,1322,1171,1070,798,618,1416,2486,3657,4979,86.48,18.96,13.92,9.46
19-08-2021,BAIÃO,38,3,205,"[120,240]",Moderado,,,,38,Norte,PORTO,1302,17452.83,18748,1070,862,714,686,725,1411,2125,2987,4057,107.42,23.25,17.11,12.18
19-08-2021,BARCELOS,395,28,340,"[240,480]",Elevado,,,,395,Norte,BRAGA,0302,37890.14,116187,6721,5325,3619,2991,2562,5553,9172,14497,21218,306.64,56.0,38.26,24.21
19-08-2021,BARRANCOS,3,0,185,"[120,240]",Moderado,,,,3,Alentejo,BEJA,0204,16841.73,1634,90,65,65,94,61,155,220,285,375,9.7,2.23,1.69,1.31
19-08-2021,BARREIRO,252,18,336,"[240,480]",Elevado,,,,252,Lisboa e Vale do Tejo,SETÚBAL,1504,3639.07,75147,5194,5565,4459,3105,1767,4872,9331,14896,20090,2065.05,552.07,409.34,256.42
19-08-2021,BATALHA,27,2,167,"[120,240]",Moderado,,,,27,Centro,LEIRIA,1004,10341.6,15963,873,762,649,529,549,1078,1727,2489,3362,154.35,32.51,24.07,16.7
19-08-2021,BEJA,311,22,927,"[480,960]",Muito Elevado,,,,311,Alentejo,BEJA,0205,114647.55,33579,2005,1840,1386,1272,1039,2311,3697,5537,7542,29.29,6.58,4.83,3.22
19-08-2021,BELMONTE,2,0,31,"[0,120]",Baixo a Moderado,,,,2,Centro,CASTELO BRANCO,0501,11875.91,6398,444,321,325,310,355,665,990,1311,1755,53.87,14.78,11.04,8.34
19-08-2021,BENAVENTE,95,7,312,"[240,480]",Elevado,,,,95,Lisboa e Vale do Tejo,SANTARÉM,1405,52138.39,30602,1468,1376,1141,876,643,1519,2660,4036,5504,58.69,10.56,7.74,5.1
19-08-2021,BOMBARRAL,16,1,126,"[120,240]",Moderado,,,,16,Lisboa e Vale do Tejo,LEIRIA,1005,9128.55,12558,875,714,561,491,429,920,1481,2195,3070,137.56,33.63,24.04,16.22
19-08-2021,BORBA,13,1,195,"[120,240]",Moderado,,,,13,Alentejo,ÉVORA,0703,14518.65,6736,430,375,279,436,392,828,1107,1482,1912,46.39,13.17,10.21,7.62
19-08-2021,BOTICAS,75,5,1502,"[960,Max]",Extremamente Elevado,,,,75,Norte,VILA REAL,1702,32195.66,4998,347,306,311,305,380,685,996,1302,1649,15.52,5.12,4.04,3.09
19-08-2021,BRAGA,533,38,292,"[240,480]",Elevado,,,,533,Norte,BRAGA,0303,18339.95,182679,10029,7963,5241,4320,3671,7991,13232,21195,31224,996.07,170.25,115.57,72.15
19-08-2021,BRAGANÇA,75,5,224,"[120,240]",Moderado,,,,75,Norte,BRAGANÇA,0402,117357.27,33607,2402,1855,1652,1393,1163,2556,4208,6063,8465,28.64,7.21,5.17,3.59
19-08-2021,CABECEIRAS DE BASTO,22,2,142,"[120,240]",Moderado,,,,22,Norte,BRAGA,0304,24182.16,15628,774,594,544,575,574,1149,1693,2287,3061,64.63,12.66,9.46,7.0
19-08-2021,CADAVAL,12,1,87,"[0,120]",Baixo a Moderado,,,,12,Lisboa e Vale do Tejo,LISBOA,1104,17489.3,13673,813,796,756,621,625,1246,2002,2798,3611,78.18,20.65,16.0,11.45
19-08-2021,CALDAS DA RAINHA,106,8,204,"[120,240]",Moderado,,,,106,Lisboa e Vale do Tejo,LEIRIA,1006,25569.47,51912,3035,2684,2186,1899,1705,3604,5790,8474,11509,203.03,45.01,33.14,22.64
19-08-2021,CALHETA,5,0,46,"[0,120]",Baixo a Moderado,,,,5,Madeira,MADEIRA,3101,11150.43,10867,576,497,507,399,415,814,1321,1818,2394,97.46,21.47,16.3,11.85
19-08-2021,CALHETA (AÇORES),3,0,95,"[0,120]",Baixo a Moderado,,,,3,Açores,AÇORES,4501,12626.4,3184,215,159,141,139,122,261,402,561,776,25.22,6.15,4.44,3.18
19-08-2021,CÂMARA DE LOBOS,55,4,164,"[120,240]",Moderado,,,,55,Madeira,MADEIRA,3102,5216.67,33675,1396,1059,834,545,381,926,1760,2819,4215,645.49,80.79,54.03,33.74
19-08-2021,CAMINHA,30,2,190,"[120,240]",Moderado,,,,30,Norte,VIANA DO CASTELO,1602,13652.14,15877,1046,944,818,646,656,1302,2120,3064,4110,116.3,30.11,22.44,15.53
19-08-2021,CAMPO MAIOR,17,1,218,"[120,240]",Moderado,,,,17,Alentejo,PORTALEGRE,1204,24720.16,7874,471,364,351,279,327,606,957,1321,1792,31.85,7.25,5.34,3.87
19-08-2021,CANTANHEDE,45,3,128,"[120,240]",Moderado,,,,45,Centro,COIMBRA,0602,39088.02,35011,2346,2096,1880,1709,1451,3160,5040,7136,9482,89.57,24.26,18.26,12.89
19-08-2021,CARRAZEDA DE ANSIÃES,5,0,89,"[0,120]",Baixo a Moderado,,,,5,Norte,BRAGANÇA,0403,27924.09,5666,424,389,391,312,465,777,1168,1557,1981,20.29,7.09,5.58,4.18
19-08-2021,CARREGAL DO SAL,11,1,118,"[0,120]",Baixo a Moderado,,,,11,Centro,VISEU,1802,11689.21,9271,587,562,486,462,376,838,1324,1886,2473,79.31,21.16,16.13,11.33
19-08-2021,CARTAXO,23,2,97,"[0,120]",Baixo a Moderado,,,,23,Lisboa e Vale do Tejo,SANTARÉM,1406,15817.28,23843,1415,1376,1142,861,632,1493,2635,4011,5426,150.74,34.3,25.36,16.66
19-08-2021,CASCAIS,857,61,401,"[240,480]",Elevado,,,,857,Lisboa e Vale do Tejo,LISBOA,1105,9740.17,213608,12151,11444,8680,6469,5248,11717,20397,31841,43992,2193.1,451.66,326.91,209.41
19-08-2021,CASTANHEIRA DE PÊRA,1,0,39,"[0,120]",Baixo a Moderado,,,,1,Centro,LEIRIA,1007,6677.45,2614,233,195,157,190,187,377,534,729,962,39.15,14.41,10.92,8.0
19-08-2021,CASTELO BRANCO,67,5,129,"[120,240]",Moderado,,,,67,Centro,CASTELO BRANCO,0502,143819.15,51987,3528,3042,2499,2229,2225,4454,6953,9995,13523,36.15,9.4,6.95,4.83
19-08-2021,CASTELO DE PAIVA,28,2,183,"[120,240]",Moderado,,,,28,Norte,AVEIRO,0106,11500.53,15454,881,697,545,420,431,851,1396,2093,2974,134.37,25.86,18.2,12.14
19-08-2021,CASTELO DE VIDE,3,0,104,"[0,120]",Baixo a Moderado,,,,3,Alentejo,PORTALEGRE,1205,26491.24,2919,204,173,179,147,170,317,496,669,873,11.02,3.3,2.53,1.87
19-08-2021,CASTRO DAIRE,29,2,210,"[120,240]",Moderado,,,,29,Centro,VISEU,1803,37904.13,13823,942,857,765,732,773,1505,2270,3127,4069,36.47,10.74,8.25,5.99
19-08-2021,CASTRO MARIM,18,1,290,"[240,480]",Elevado,,,,18,Algarve,FARO,0804,30084.37,6237,370,345,334,322,344,666,1000,1345,1715,20.73,5.7,4.47,3.32
19-08-2021,CASTRO VERDE,9,1,131,"[120,240]",Moderado,,,,9,Alentejo,BEJA,0206,56944.23,6949,437,347,303,275,227,502,805,1152,1589,12.2,2.79,2.02,1.41
19-08-2021,CELORICO DA BEIRA,10,1,144,"[120,240]",Moderado,,,,10,Centro,GUARDA,0903,24721.63,6928,430,416,363,369,535,904,1267,1683,2113,28.02,8.55,6.81,5.12
19-08-2021,CELORICO DE BASTO,40,3,212,"[120,240]",Moderado,,,,40,Norte,BRAGA,0305,18107.02,19040,1001,802,668,728,729,1457,2125,2927,3928,105.15,21.69,16.17,11.74
19-08-2021,CHAMUSCA,8,1,88,"[0,120]",Baixo a Moderado,,,,8,Lisboa e Vale do Tejo,SANTARÉM,1407,74600.54,9197,629,583,553,465,579,1044,1597,2180,2809,12.33,3.77,2.92,2.14
19-08-2021,CHAVES,104,7,265,"[240,480]",Elevado,,,,104,Norte,VILA REAL,1703,59122.95,39343,2676,2429,1991,1886,1918,3804,5795,8224,10900,66.54,18.44,13.91,9.8
19-08-2021,CINFÃES,45,3,244,"[240,480]",Elevado,,,,45,Norte,VISEU,1804,23928.76,18244,1067,902,779,734,758,1492,2271,3173,4240,76.24,17.72,13.26,9.49
19-08-2021,COIMBRA,280,20,209,"[120,240]",Moderado,,,,280,Centro,COIMBRA,0603,31939.94,134166,9489,8734,6353,5139,5074,10213,16566,25300,34789,420.06,108.92,79.21,51.87
19-08-2021,CONDEIXA-A-NOVA,15,1,84,"[0,120]",Baixo a Moderado,,,,15,Centro,COIMBRA,0604,13867.47,17733,871,809,717,583,490,1073,1790,2599,3470,127.88,25.02,18.74,12.91
19-08-2021,CONSTÂNCIA,1,0,25,"[0,120]",Baixo a Moderado,,,,1,Lisboa e Vale do Tejo,SANTARÉM,1408,8036.58,4030,211,183,187,148,155,303,490,673,884,50.14,11.0,8.37,6.1
19-08-2021,CORUCHE,36,3,204,"[120,240]",Moderado,,,,36,Lisboa e Vale do Tejo,SANTARÉM,1409,111572.03,17471,1294,1090,1095,1096,1019,2115,3210,4300,5594,15.66,5.01,3.85,2.88
19-08-2021,CORVO,0,0,0,"[0,120]",Baixo a Moderado,,,,0,Açores,AÇORES,4901,1711.45,464,22,21,11,13,19,32,43,64,86,27.12,5.03,3.74,2.51
19-08-2021,COVILHÃ,133,9,284,"[240,480]",Elevado,,,,133,Centro,CASTELO BRANCO,0503,55560.06,46787,3533,2998,2365,2111,2193,4304,6669,9667,13200,84.21,23.76,17.4,12.0
19-08-2021,CRATO,1,0,33,"[0,120]",Baixo a Moderado,,,,1,Alentejo,PORTALEGRE,1206,39806.88,3129,229,258,163,182,228,410,573,831,1060,7.86,2.66,2.09,1.44
19-08-2021,CUBA,31,2,682,"[480,960]",Muito Elevado,,,,31,Alentejo,BEJA,0207,17208.72,4595,255,233,206,190,143,333,539,772,1027,26.7,5.97,4.49,3.13
19-08-2021,ELVAS,54,4,261,"[240,480]",Elevado,,,,54,Alentejo,PORTALEGRE,1207,63128.86,20528,1057,1145,902,852,810,1662,2564,3709,4766,32.52,7.55,5.88,4.06
19-08-2021,ENTRONCAMENTO,65,5,301,"[240,480]",Elevado,,,,65,Lisboa e Vale do Tejo,SANTARÉM,1410,1372.81,21558,1066,930,868,695,592,1287,2155,3085,4151,1570.14,302.33,224.69,156.96
19-08-2021,ESPINHO,63,5,214,"[120,240]",Moderado,,,,63,Norte,AVEIRO,0107,2105.68,29516,2205,1993,1430,1177,960,2137,3567,5560,7765,1401.52,368.71,264.01,169.37
19-08-2021,ESPOSENDE,263,19,770,"[480,960]",Muito Elevado,,,,263,Norte,BRAGA,0306,9540.98,34177,1831,1522,1095,894,723,1617,2712,4234,6065,358.21,63.57,44.38,28.42
19-08-2021,ESTARREJA,19,1,73,"[0,120]",Baixo a Moderado,,,,19,Centro,AVEIRO,0108,10817.33,26006,1503,1399,1106,953,728,1681,2787,4186,5689,240.42,52.59,38.7,25.76
19-08-2021,ESTREMOZ,36,3,286,"[240,480]",Elevado,,,,36,Alentejo,ÉVORA,0704,51379.95,12728,789,613,697,786,877,1663,2360,2973,3762,24.77,7.32,5.79,4.59
19-08-2021,ÉVORA,180,13,343,"[240,480]",Elevado,,,,180,Alentejo,ÉVORA,0705,130707.58,52428,3569,2852,2176,1966,1803,3769,5945,8797,12366,40.11,9.46,6.73,4.55
19-08-2021,FAFE,184,13,383,"[240,480]",Elevado,,,,184,Norte,BRAGA,0307,21908.11,48060,3044,2455,1679,1403,1208,2611,4290,6745,9789,219.37,44.68,30.79,19.58
19-08-2021,FARO,387,28,634,"[480,960]",Muito Elevado,,,,387,Algarve,FARO,0805,20256.79,61015,3847,3364,2604,2055,1601,3656,6260,9624,13471,301.2,66.5,47.51,30.9
19-08-2021,FELGUEIRAS,166,12,294,"[240,480]",Elevado,,,,166,Norte,PORTO,1303,11573.75,56422,2951,2302,1601,1316,973,2289,3890,6192,9143,487.49,79.0,53.5,33.61
19-08-2021,FERREIRA DO ALENTEJO,17,1,218,"[120,240]",Moderado,,,,17,Alentejo,BEJA,0208,64820.68,7845,515,414,372,343,345,688,1060,1474,1989,12.1,3.07,2.27,1.64
19-08-2021,FERREIRA DO ZÊZERE,5,0,63,"[0,120]",Baixo a Moderado,,,,5,Lisboa e Vale do Tejo,SANTARÉM,1411,19038.03,7959,470,370,416,465,456,921,1337,1707,2177,41.81,11.44,8.97,7.02
19-08-2021,FIGUEIRA DA FOZ,152,11,258,"[240,480]",Elevado,,,,152,Centro,COIMBRA,0605,37905.26,58747,4032,3597,2887,2495,2043,4538,7425,11022,15054,154.98,39.72,29.08,19.59
19-08-2021,FIGUEIRA DE CASTELO RODRIGO,1,0,18,"[0,120]",Baixo a Moderado,,,,1,Centro,GUARDA,0904,50857.46,5584,347,352,290,352,391,743,1033,1385,1732,10.98,3.41,2.72,2.03
19-08-2021,FIGUEIRÓ DOS VINHOS,2,0,36,"[0,120]",Baixo a Moderado,,,,2,Centro,LEIRIA,1008,17344.0,5568,402,386,322,309,351,660,982,1368,1770,32.1,10.21,7.89,5.66
19-08-2021,FORNOS DE ALGODRES,4,0,88,"[0,120]",Baixo a Moderado,,,,4,Centro,GUARDA,0905,13145.05,4528,261,218,247,256,232,488,735,953,1214,34.45,9.24,7.25,5.59
19-08-2021,FREIXO DE ESPADA À CINTA,2,0,62,"[0,120]",Baixo a Moderado,,,,2,Norte,BRAGANÇA,0404,24414.29,3298,211,177,231,196,189,385,616,793,1004,13.51,4.11,3.25,2.52
19-08-2021,FRONTEIRA,3,0,102,"[0,120]",Baixo a Moderado,,,,3,Alentejo,PORTALEGRE,1208,24859.58,2974,213,182,149,156,168,324,473,655,868,11.96,3.49,2.63,1.9
19-08-2021,FUNCHAL,279,20,268,"[240,480]",Elevado,,,,279,Madeira,MADEIRA,3103,7616.2,104024,6382,5086,3643,2821,1990,4811,8454,13540,19922,1365.86,261.58,177.78,111.0
19-08-2021,FUNDÃO,24,2,91,"[0,120]",Baixo a Moderado,,,,24,Centro,CASTELO BRANCO,0504,70019.79,26495,1781,1464,1432,1357,1643,3000,4432,5896,7677,37.84,10.96,8.42,6.33
19-08-2021,GAVIÃO,6,0,189,"[120,240]",Moderado,,,,6,Alentejo,PORTALEGRE,1209,29459.45,3263,189,186,222,263,293,556,778,964,1153,11.08,3.91,3.27,2.64
19-08-2021,GÓIS,1,0,27,"[0,120]",Baixo a Moderado,,,,1,Centro,COIMBRA,0606,26330.19,3805,235,199,240,233,244,477,717,916,1151,14.45,4.37,3.48,2.72
19-08-2021,GOLEGÃ,2,0,38,"[0,120]",Baixo a Moderado,,,,2,Lisboa e Vale do Tejo,SANTARÉM,1412,8431.67,5339,356,299,281,243,255,498,779,1078,1434,63.32,17.01,12.78,9.24
19-08-2021,GONDOMAR,405,29,244,"[240,480]",Elevado,,,,405,Norte,PORTO,1304,13191.76,165985,10555,8755,6222,4450,3364,7814,14036,22791,33346,1258.22,252.77,172.76,106.4
19-08-2021,GOUVEIA,19,1,154,"[120,240]",Moderado,,,,19,Centro,GUARDA,0906,30061.17,12387,871,931,780,783,810,1593,2373,3304,4175,41.21,13.89,10.99,7.89
19-08-2021,GRÂNDOLA,26,2,178,"[120,240]",Moderado,,,,26,Alentejo,SETÚBAL,1505,82593.66,14639,834,834,708,688,672,1360,2068,2902,3736,17.72,4.52,3.51,2.5
19-08-2021,GUARDA,69,5,177,"[120,240]",Moderado,,,,69,Centro,GUARDA,0907,71209.58,38969,2477,2041,1686,1415,1474,2889,4575,6616,9093,54.72,12.77,9.29,6.42
19-08-2021,GUIMARÃES,431,31,283,"[240,480]",Elevado,,,,431,Norte,BRAGA,0308,24099.96,152309,9394,7074,4809,3877,2948,6825,11634,18708,28102,631.99,116.61,77.63,48.27
19-08-2021,HORTA,23,2,159,"[120,240]",Moderado,,,,23,Açores,AÇORES,4701,17305.53,14521,818,658,468,352,302,654,1122,1780,2598,83.91,15.01,10.29,6.48
19-08-2021,IDANHA-A-NOVA,8,1,101,"[0,120]",Baixo a Moderado,,,,8,Centro,CASTELO BRANCO,0505,141633.51,8043,518,490,519,672,974,1646,2165,2655,3173,5.68,2.24,1.87,1.53
19-08-2021,ÍLHAVO,112,8,289,"[240,480]",Elevado,,,,112,Centro,AVEIRO,0110,7347.55,38699,2227,1943,1444,1193,850,2043,3487,5430,7657,526.66,104.21,73.9,47.46
19-08-2021,LAGOA (FARO),156,11,686,"[480,960]",Muito Elevado,,,,156,Algarve,FARO,0806,8825.45,22762,1314,1168,919,749,670,1419,2338,3506,4820,257.93,54.62,39.73,26.49
19-08-2021,LAGOA,57,4,386,"[240,480]",Elevado,,,,57,Açores,AÇORES,4201,4559.32,14721,536,458,349,238,235,473,822,1280,1816,322.9,39.83,28.08,18.03
19-08-2021,LAGOS,387,28,1275,"[960,Max]",Extremamente Elevado,,,,387,Algarve,FARO,0807,21299.27,30374,1744,1434,1247,1053,1029,2082,3329,4763,6507,142.61,30.55,22.36,15.63
19-08-2021,LAJES DAS FLORES,0,0,0,"[0,120]",Baixo a Moderado,,,,0,Açores,AÇORES,4801,7004.79,1463,88,53,62,46,54,100,162,215,303,20.89,4.33,3.07,2.31
19-08-2021,LAJES DO PICO,2,0,45,"[0,120]",Baixo a Moderado,,,,2,Açores,AÇORES,4601,15531.09,4490,304,231,223,159,162,321,544,775,1079,28.91,6.95,4.99,3.5
19-08-2021,LAMEGO,17,1,69,"[0,120]",Baixo a Moderado,,,,17,Norte,VISEU,1805,16542.11,24895,1639,1284,1124,898,783,1681,2805,4089,5728,150.5,34.63,24.72,16.96
19-08-2021,LEIRIA,446,32,356,"[240,480]",Elevado,,,,446,Centro,LEIRIA,1009,56508.83,125267,7389,6366,5090,3902,3159,7061,12151,18517,25906,221.68,45.84,32.77,21.5
19-08-2021,LISBOA,2751,197,540,"[480,960]",Muito Elevado,,,,2751,Lisboa e Vale do Tejo,LISBOA,1106,10005.43,509515,33197,33340,27706,23037,26770,49807,77513,110853,144050,5092.6,1439.78,1107.98,774.74
19-08-2021,LOULÉ,569,41,828,"[480,960]",Muito Elevado,,,,569,Algarve,FARO,0808,76366.91,68697,3890,3350,2780,2358,2251,4609,7389,10739,14629,89.96,19.16,14.06,9.68
19-08-2021,LOURES,611,44,286,"[240,480]",Elevado,,,,611,Lisboa e Vale do Tejo,LISBOA,1107,16723.99,213687,12746,12794,9644,6669,5033,11702,21346,34140,46886,1277.73,280.35,204.14,127.64
19-08-2021,LOURINHÃ,39,3,149,"[120,240]",Moderado,,,,39,Lisboa e Vale do Tejo,LISBOA,1108,14717.2,25855,1584,1243,992,842,645,1487,2479,3722,5306,175.68,36.05,25.29,16.84
19-08-2021,LOUSÃ,21,1,122,"[120,240]",Moderado,,,,21,Centro,COIMBRA,0607,13840.01,17158,946,866,658,528,450,978,1636,2502,3448,123.97,24.91,18.08,11.82
19-08-2021,LOUSADA,142,10,303,"[240,480]",Elevado,,,,142,Norte,PORTO,1305,9608.01,46755,2289,1698,1176,853,621,1474,2650,4348,6637,486.63,69.08,45.25,27.58
19-08-2021,MAÇÃO,14,1,226,"[120,240]",Moderado,,,,14,Lisboa e Vale do Tejo,SANTARÉM,1413,39997.98,6267,386,362,390,440,657,1097,1487,1849,2235,15.67,5.59,4.62,3.72
19-08-2021,MACEDO DE CAVALEIROS,10,1,69,"[0,120]",Baixo a Moderado,,,,10,Norte,BRAGANÇA,0405,69914.08,14516,1082,889,878,823,938,1761,2639,3528,4610,20.76,6.59,5.05,3.77
19-08-2021,MACHICO,34,2,171,"[120,240]",Moderado,,,,34,Madeira,MADEIRA,3104,6825.1,19981,1197,860,662,455,331,786,1448,2308,3505,292.76,51.36,33.82,21.22
19-08-2021,MADALENA,1,0,17,"[0,120]",Baixo a Moderado,,,,1,Açores,AÇORES,4602,14712.33,5895,334,256,173,190,179,369,542,798,1132,40.07,7.69,5.42,3.68
19-08-2021,MAFRA,202,14,238,"[120,240]",Moderado,,,,202,Lisboa e Vale do Tejo,LISBOA,1109,29165.5,84816,3613,3334,2839,2089,1899,3988,6827,10161,13774,290.81,47.23,34.84,23.41
19-08-2021,MAIA,429,31,309,"[240,480]",Elevado,,,,429,Norte,PORTO,1306,8293.94,138971,7801,6617,4512,3339,2631,5970,10482,17099,24900,1675.56,300.22,206.16,126.38
19-08-2021,MANGUALDE,28,2,151,"[120,240]",Moderado,,,,28,Centro,VISEU,1806,21925.56,18510,1198,1128,885,852,743,1595,2480,3608,4806,84.42,21.92,16.46,11.31
19-08-2021,MANTEIGAS,2,0,67,"[0,120]",Baixo a Moderado,,,,2,Centro,GUARDA,0908,12197.55,3007,258,197,159,167,146,313,472,669,927,24.65,7.6,5.48,3.87
19-08-2021,MARCO DE CANAVESES,100,7,195,"[120,240]",Moderado,,,,100,Norte,PORTO,1307,20188.98,51496,2678,2060,1488,1265,1023,2288,3776,5836,8514,255.07,42.17,28.91,18.7
19-08-2021,MARINHA GRANDE,175,13,455,"[240,480]",Elevado,,,,175,Centro,LEIRIA,1010,18725.19,38508,2365,2302,1638,1359,1058,2417,4055,6357,8722,205.65,46.58,33.95,21.66
19-08-2021,MARVÃO,0,0,0,"[0,120]",Baixo a Moderado,,,,0,Alentejo,PORTALEGRE,1210,15489.9,3005,198,185,142,197,237,434,576,761,959,19.4,6.19,4.91,3.72
19-08-2021,MATOSINHOS,535,38,305,"[240,480]",Elevado,,,,535,Norte,PORTO,1308,6241.97,175357,11850,9977,7023,5024,3884,8908,15931,25908,37758,2809.31,604.9,415.06,255.22
19-08-2021,MEALHADA,26,2,130,"[120,240]",Moderado,,,,26,Centro,AVEIRO,0111,11065.66,19914,1163,1039,810,828,831,1659,2469,3508,4671,179.96,42.21,31.7,22.31
19-08-2021,MÊDA,0,0,0,"[0,120]",Baixo a Moderado,,,,0,Centro,GUARDA,0909,28604.92,4587,343,306,290,288,443,731,1021,1327,1670,16.04,5.84,4.64,3.57
19-08-2021,MELGAÇO,7,1,88,"[0,120]",Baixo a Moderado,,,,7,Norte,VIANA DO CASTELO,1603,23824.58,8093,507,567,578,614,675,1289,1867,2434,2941,33.97,12.34,10.22,7.84
19-08-2021,MÉRTOLA,18,1,298,"[240,480]",Elevado,,,,18,Alentejo,BEJA,0209,129287.34,6142,400,390,378,423,600,1023,1401,1791,2191,4.75,1.69,1.39,1.08
19-08-2021,MESÃO FRIO,2,0,51,"[0,120]",Baixo a Moderado,,,,2,Norte,VILA REAL,1704,2664.87,3964,265,205,168,157,120,277,445,650,915,148.74,34.33,24.39,16.7
19-08-2021,MIRA,15,1,126,"[120,240]",Moderado,,,,15,Centro,COIMBRA,0608,12403.38,11832,727,729,659,550,466,1016,1675,2404,3131,95.4,25.24,19.38,13.5
19-08-2021,MIRANDA DO CORVO,13,1,102,"[0,120]",Baixo a Moderado,,,,13,Centro,COIMBRA,0609,12637.79,12708,706,659,568,498,404,902,1470,2129,2835,100.55,22.43,16.85,11.63
19-08-2021,MIRANDA DO DOURO,5,0,74,"[0,120]",Baixo a Moderado,,,,5,Norte,BRAGANÇA,0406,48718.31,6830,482,429,442,463,470,933,1375,1804,2286,14.02,4.69,3.7,2.82
19-08-2021,MIRANDELA,32,2,148,"[120,240]",Moderado,,,,32,Norte,BRAGANÇA,0407,65895.67,21754,1640,1315,1204,1078,947,2025,3229,4544,6184,33.01,9.38,6.9,4.9
19-08-2021,MOGADOURO,8,1,97,"[0,120]",Baixo a Moderado,,,,8,Norte,BRAGANÇA,0408,76064.93,8392,589,529,576,630,655,1285,1861,2390,2979,11.03,3.92,3.14,2.45
19-08-2021,MOIMENTA DA BEIRA,3,0,31,"[0,120]",Baixo a Moderado,,,,3,Norte,VISEU,1807,21996.9,9736,576,514,471,416,461,877,1348,1862,2438,44.26,11.08,8.46,6.13
19-08-2021,MOITA,175,12,271,"[240,480]",Elevado,,,,175,Lisboa e Vale do Tejo,SETÚBAL,1506,5525.98,64407,4226,3646,2623,1801,1425,3226,5849,9495,13721,1165.53,248.3,171.82,105.85
19-08-2021,MONÇÃO,28,2,158,"[120,240]",Moderado,,,,28,Norte,VIANA DO CASTELO,1604,21130.85,17869,1161,1105,1031,1006,972,1978,3009,4114,5275,84.56,24.96,19.47,14.24
19-08-2021,MONCHIQUE,12,1,241,"[240,480]",Elevado,,,,12,Algarve,FARO,0809,39530.43,5077,353,384,321,355,392,747,1068,1452,1805,12.84,4.57,3.67,2.7
19-08-2021,MONDIM DE BASTO,18,1,262,"[240,480]",Elevado,,,,18,Norte,VILA REAL,1705,17207.52,6946,395,300,314,284,283,567,881,1181,1576,40.36,9.16,6.86,5.12
19-08-2021,MONFORTE,4,0,136,"[120,240]",Moderado,,,,4,Alentejo,PORTALEGRE,1211,42024.82,2975,139,115,117,192,168,360,477,592,731,7.08,1.74,1.41,1.14
19-08-2021,MONTALEGRE,29,2,327,"[240,480]",Elevado,,,,29,Norte,VILA REAL,1706,80545.71,8997,699,628,595,603,730,1333,1928,2556,3255,11.17,4.04,3.17,2.39
19-08-2021,MONTEMOR-O-NOVO,38,3,246,"[240,480]",Elevado,,,,38,Alentejo,ÉVORA,0706,123296.65,15647,991,953,868,878,971,1849,2717,3670,4661,12.69,3.78,2.98,2.2
19-08-2021,MONTEMOR-O-VELHO,22,2,87,"[0,120]",Baixo a Moderado,,,,22,Centro,COIMBRA,0610,22896.23,25224,1496,1397,1217,1057,988,2045,3262,4659,6155,110.17,26.88,20.35,14.25
19-08-2021,MONTIJO,84,6,145,"[120,240]",Moderado,,,,84,Lisboa e Vale do Tejo,SETÚBAL,1507,34861.64,57614,2771,2441,1990,1554,1109,2663,4653,7094,9865,165.26,28.3,20.35,13.35
19-08-2021,MORA,2,0,50,"[0,120]",Baixo a Moderado,,,,2,Alentejo,ÉVORA,0707,44395.02,4138,336,275,252,238,257,495,747,1022,1358,9.32,3.06,2.3,1.68
19-08-2021,MORTÁGUA,15,1,170,"[120,240]",Moderado,,,,15,Centro,VISEU,1808,25117.82,8803,638,584,535,499,460,959,1494,2078,2716,35.05,10.81,8.27,5.95
19-08-2021,MOURA,99,7,720,"[480,960]",Muito Elevado,,,,99,Alentejo,BEJA,0210,95845.55,13718,817,656,665,542,461,1003,1668,2324,3141,14.31,3.28,2.42,1.74
19-08-2021,MOURÃO,26,2,1069,"[960,Max]",Extremamente Elevado,,,,26,Alentejo,ÉVORA,0708,27862.98,2450,139,108,80,104,109,213,293,401,540,8.79,1.94,1.44,1.05
19-08-2021,MURÇA,5,0,93,"[0,120]",Baixo a Moderado,,,,5,Norte,VILA REAL,1707,18937.11,5463,384,341,307,306,319,625,932,1273,1657,28.85,8.75,6.72,4.92
19-08-2021,MURTOSA,12,1,115,"[0,120]",Baixo a Moderado,,,,12,Centro,AVEIRO,0112,7308.78,10279,509,473,403,353,409,762,1165,1638,2147,140.63,29.37,22.41,15.94
19-08-2021,NAZARÉ,51,4,358,"[240,480]",Elevado,,,,51,Lisboa e Vale do Tejo,LEIRIA,1011,8243.43,14165,967,903,670,420,396,816,1486,2389,3356,171.84,40.71,28.98,18.03
19-08-2021,NELAS,10,1,77,"[0,120]",Baixo a Moderado,,,,10,Centro,VISEU,1809,12571.48,12974,924,787,668,604,583,1187,1855,2642,3566,103.21,28.37,21.02,14.76
19-08-2021,NISA,3,0,50,"[0,120]",Baixo a Moderado,,,,3,Alentejo,PORTALEGRE,1212,57567.84,6061,405,389,355,483,478,961,1316,1705,2110,10.53,3.67,2.96,2.29
19-08-2021,NORDESTE,6,0,125,"[120,240]",Moderado,,,,6,Açores,AÇORES,4202,10146.8,4862,246,180,124,161,162,323,447,627,873,47.92,8.6,6.18,4.41
19-08-2021,ÓBIDOS,31,2,258,"[240,480]",Elevado,,,,31,Lisboa e Vale do Tejo,LEIRIA,1012,14155.44,11850,743,650,574,452,436,888,1462,2112,2855,83.72,20.17,14.92,10.33
19-08-2021,ODEMIRA,114,8,463,"[240,480]",Elevado,,,,114,Alentejo,BEJA,0211,172060.15,24717,1475,1317,1225,1397,1349,2746,3971,5288,6763,14.37,3.93,3.07,2.31
19-08-2021,ODIVELAS,396,28,245,"[240,480]",Elevado,,,,396,Lisboa e Vale do Tejo,LISBOA,1116,2654.36,161774,9562,9038,6952,4641,3812,8453,15405,24443,34005,6095.48,1281.27,920.99,580.44
19-08-2021,OEIRAS,701,50,395,"[240,480]",Elevado,,,,701,Lisboa e Vale do Tejo,LISBOA,1110,4588.31,177408,11580,11575,8566,6211,5855,12066,20632,32207,43787,3866.78,954.38,701.98,449.69
19-08-2021,OLEIROS,1,0,20,"[0,120]",Baixo a Moderado,,,,1,Centro,CASTELO BRANCO,0506,47109.31,5003,384,341,366,397,487,884,1250,1591,1975,10.62,4.19,3.38,2.65
19-08-2021,OLHÃO,146,10,328,"[240,480]",Elevado,,,,146,Algarve,FARO,0810,13086.38,44405,2455,2309,1689,1342,1268,2610,4299,6608,9063,339.33,69.26,50.5,32.85
19-08-2021,OLIVEIRA DE AZEMÉIS,139,10,210,"[120,240]",Moderado,,,,139,Norte,AVEIRO,0113,16110.41,66011,4155,3614,2794,2183,1738,3921,6715,10329,14484,409.75,89.91,64.12,41.68
19-08-2021,OLIVEIRA DE FRADES,14,1,140,"[120,240]",Moderado,,,,14,Centro,VISEU,1810,14534.62,9936,553,475,438,359,415,774,1212,1687,2240,68.36,15.41,11.61,8.34
19-08-2021,OLIVEIRA DO BAIRRO,26,2,109,"[0,120]",Baixo a Moderado,,,,26,Centro,AVEIRO,0114,8731.99,24277,1327,1182,999,786,810,1596,2595,3777,5104,278.02,58.45,43.25,29.72
19-08-2021,OLIVEIRA DO HOSPITAL,48,3,249,"[240,480]",Elevado,,,,48,Centro,COIMBRA,0611,23451.66,19253,1161,1097,962,924,960,1884,2846,3943,5104,82.1,21.76,16.81,12.14
19-08-2021,OURÉM,86,6,196,"[120,240]",Moderado,,,,86,Lisboa e Vale do Tejo,SANTARÉM,1421,41668.03,44044,2463,2069,1899,1817,1603,3420,5319,7388,9851,105.7,23.64,17.73,12.77
19-08-2021,OURIQUE,12,1,264,"[240,480]",Elevado,,,,12,Alentejo,BEJA,0212,66331.36,4607,313,287,284,268,227,495,779,1066,1379,6.95,2.08,1.61,1.17
19-08-2021,OVAR,106,8,196,"[120,240]",Moderado,,,,106,Centro,AVEIRO,0115,14770.25,54260,3294,2709,1994,1636,1234,2870,4864,7573,10867,367.37,73.57,51.27,32.93
19-08-2021,PAÇOS DE FERREIRA,91,7,161,"[120,240]",Moderado,,,,91,Norte,PORTO,1309,7099.29,56728,2903,2193,1518,1135,664,1799,3317,5510,8413,799.1,118.51,77.62,46.72
19-08-2021,PALMELA,129,9,200,"[120,240]",Moderado,,,,129,Lisboa e Vale do Tejo,SETÚBAL,1508,46512.01,64269,3402,3244,2635,1846,1391,3237,5872,9116,12518,138.18,26.91,19.6,12.62
19-08-2021,PAMPILHOSA DA SERRA,9,1,223,"[120,240]",Moderado,,,,9,Centro,COIMBRA,0612,39646.24,4037,238,254,295,339,423,762,1057,1311,1549,10.18,3.91,3.31,2.67
19-08-2021,PAREDES,248,18,288,"[240,480]",Elevado,,,,248,Norte,PORTO,1310,15675.69,86067,4272,3532,2412,1717,1258,2975,5387,8919,13191,549.04,84.15,56.9,34.36
19-08-2021,PAREDES DE COURA,15,1,177,"[120,240]",Moderado,,,,15,Norte,VIANA DO CASTELO,1605,13818.59,8535,466,528,407,465,515,980,1387,1915,2381,61.76,17.23,13.86,10.04
19-08-2021,PEDRÓGÃO GRANDE,2,0,59,"[0,120]",Baixo a Moderado,,,,2,Centro,LEIRIA,1013,12874.75,3410,175,173,196,221,252,473,669,842,1017,26.49,7.9,6.54,5.2
19-08-2021,PENACOVA,19,1,139,"[120,240]",Moderado,,,,19,Centro,COIMBRA,0613,21673.23,13694,968,923,745,621,703,1324,2069,2992,3960,63.18,18.27,13.81,9.55
19-08-2021,PENAFIEL,245,17,351,"[240,480]",Elevado,,,,245,Norte,PORTO,1311,21224.27,69772,3648,2823,2032,1663,1230,2893,4925,7748,11396,328.74,53.69,36.51,23.2
19-08-2021,PENALVA DO CASTELO,12,1,168,"[120,240]",Moderado,,,,12,Centro,VISEU,1811,13433.92,7115,449,457,413,391,426,817,1230,1687,2136,52.96,15.9,12.56,9.16
19-08-2021,PENAMACOR,3,0,64,"[0,120]",Baixo a Moderado,,,,3,Centro,CASTELO BRANCO,0507,56370.69,4755,262,248,273,451,633,1084,1357,1605,1867,8.44,3.31,2.85,2.41
19-08-2021,PENEDONO,0,0,0,"[0,120]",Baixo a Moderado,,,,0,Norte,VISEU,1812,13370.75,2591,172,113,129,156,138,294,423,536,708,19.38,5.3,4.01,3.16
19-08-2021,PENELA,16,1,297,"[240,480]",Elevado,,,,16,Centro,COIMBRA,0614,13480.0,5397,314,324,274,359,344,703,977,1301,1615,40.04,11.98,9.65,7.25
19-08-2021,PENICHE,102,7,386,"[240,480]",Elevado,,,,102,Lisboa e Vale do Tejo,LEIRIA,1014,7754.98,26501,1746,1504,1203,926,707,1633,2836,4340,6086,341.73,78.48,55.96,36.57
19-08-2021,PESO DA RÉGUA,19,1,121,"[120,240]",Moderado,,,,19,Norte,VILA REAL,1708,9486.01,15773,1076,843,650,659,455,1114,1764,2607,3683,166.28,38.83,27.48,18.6
19-08-2021,PINHEL,4,0,47,"[0,120]",Baixo a Moderado,,,,4,Centro,GUARDA,0910,48452.12,8511,577,566,551,538,689,1227,1778,2344,2921,17.57,6.03,4.84,3.67
19-08-2021,POMBAL,116,8,225,"[120,240]",Moderado,,,,116,Centro,LEIRIA,1015,62600.28,51461,3187,2791,2494,2328,2027,4355,6849,9640,12827,82.21,20.49,15.4,10.94
19-08-2021,PONTA DELGADA,228,16,336,"[240,480]",Elevado,,,,228,Açores,AÇORES,4203,23298.65,67935,3108,2435,1726,1133,902,2035,3761,6196,9304,291.58,39.93,26.59,16.14
19-08-2021,PONTA DO SOL,7,1,82,"[0,120]",Baixo a Moderado,,,,7,Madeira,MADEIRA,3105,4622.03,8593,319,283,347,208,221,429,776,1059,1378,185.92,29.81,22.91,16.79
19-08-2021,PONTE DA BARCA,14,1,126,"[120,240]",Moderado,,,,14,Norte,VIANA DO CASTELO,1606,18211.37,11180,635,576,517,554,490,1044,1561,2137,2772,61.39,15.22,11.73,8.57
19-08-2021,PONTE DE LIMA,86,6,209,"[120,240]",Moderado,,,,86,Norte,VIANA DO CASTELO,1607,32025.46,41315,2321,2022,1720,1596,1462,3058,4778,6800,9121,129.01,28.48,21.23,14.92
19-08-2021,PONTE DE SOR,87,6,579,"[480,960]",Muito Elevado,,,,87,Alentejo,PORTALEGRE,1213,83971.16,14994,939,800,716,739,831,1570,2286,3086,4025,17.86,4.79,3.68,2.72
19-08-2021,PORTALEGRE,30,2,137,"[120,240]",Moderado,,,,30,Alentejo,PORTALEGRE,1214,44713.64,22172,1577,1351,1137,993,984,1977,3114,4465,6042,49.59,13.51,9.99,6.96
19-08-2021,PORTEL,20,1,346,"[240,480]",Elevado,,,,20,Alentejo,ÉVORA,0709,60100.57,5828,336,358,283,331,305,636,919,1277,1613,9.7,2.68,2.12,1.53
19-08-2021,PORTIMÃO,495,35,892,"[480,960]",Muito Elevado,,,,495,Algarve,FARO,0811,18206.29,55483,3182,2927,2116,1582,1400,2982,5098,8025,11207,304.75,61.56,44.08,28.0
19-08-2021,PORTO,1025,73,473,"[240,480]",Elevado,,,,1025,Norte,PORTO,1312,4142.02,216606,15790,15193,11280,9409,10044,19453,30733,45926,61716,5229.5,1490.0,1108.79,741.98
19-08-2021,PORTO DE MÓS,67,5,287,"[240,480]",Elevado,,,,67,Centro,LEIRIA,1016,26183.41,23275,1355,1210,1034,888,872,1760,2794,4004,5359,88.89,20.47,15.29,10.67
19-08-2021,PORTO MONIZ,2,0,87,"[0,120]",Baixo a Moderado,,,,2,Madeira,MADEIRA,3106,8293.38,2342,143,130,95,98,120,218,313,443,586,28.24,7.07,5.34,3.77
19-08-2021,PORTO SANTO,10,1,192,"[120,240]",Moderado,,,,10,Madeira,MADEIRA,3201,4300.7,5202,240,157,134,110,68,178,312,469,709,120.95,16.48,10.9,7.25
19-08-2021,PÓVOA DE LANHOSO,81,6,377,"[240,480]",Elevado,,,,81,Norte,BRAGA,0309,13465.29,21499,1175,909,732,673,624,1297,2029,2938,4113,159.67,30.55,21.82,15.07
19-08-2021,PÓVOA DE VARZIM,262,19,417,"[240,480]",Elevado,,,,262,Norte,PORTO,1313,8220.59,62784,3712,3120,2134,1594,1305,2899,5033,8153,11865,763.7,144.33,99.17,61.22
19-08-2021,POVOAÇÃO,16,1,271,"[240,480]",Elevado,,,,16,Açores,AÇORES,4204,10640.77,5927,293,212,191,144,134,278,469,681,974,55.7,9.15,6.4,4.41
19-08-2021,VILA DA PRAIA DA VITÓRIA,12,1,57,"[0,120]",Baixo a Moderado,,,,12,Açores,AÇORES,4302,16127.06,21317,1133,789,619,436,336,772,1391,2180,3313,132.18,20.54,13.52,8.63
19-08-2021,PROENÇA-A-NOVA,37,3,511,"[480,960]",Muito Elevado,,,,37,Centro,CASTELO BRANCO,0508,39539.96,7298,508,465,389,400,560,960,1349,1814,2322,18.46,5.87,4.59,3.41
19-08-2021,REDONDO,6,0,95,"[0,120]",Baixo a Moderado,,,,6,Alentejo,ÉVORA,0710,36950.87,6353,349,325,288,288,354,642,930,1255,1604,17.19,4.34,3.4,2.52
19-08-2021,REGUENGOS DE MONSARAZ,25,2,252,"[240,480]",Elevado,,,,25,Alentejo,ÉVORA,0711,46399.72,10015,602,511,455,462,473,935,1390,1901,2503,21.58,5.39,4.1,3.0
19-08-2021,RESENDE,62,4,609,"[480,960]",Muito Elevado,,,,62,Norte,VISEU,1813,12334.93,10137,560,493,448,433,422,855,1303,1796,2356,82.18,19.1,14.56,10.56
19-08-2021,RIBEIRA BRAVA,8,1,65,"[0,120]",Baixo a Moderado,,,,8,Madeira,MADEIRA,3107,6544.88,12435,648,500,411,311,287,598,1009,1509,2157,189.99,32.96,23.06,15.42
19-08-2021,RIBEIRA DE PENA,16,1,267,"[240,480]",Elevado,,,,16,Norte,VILA REAL,1709,21745.98,6016,371,301,290,310,368,678,968,1269,1640,27.66,7.54,5.84,4.45
19-08-2021,RIBEIRA GRANDE,140,10,427,"[240,480]",Elevado,,,,140,Açores,AÇORES,4205,18015.13,32811,1163,689,512,345,253,598,1110,1799,2962,182.13,16.44,9.99,6.16
19-08-2021,RIO MAIOR,45,3,222,"[120,240]",Moderado,,,,45,Lisboa e Vale do Tejo,SANTARÉM,1414,27276.45,20379,1251,1144,941,795,648,1443,2384,3528,4779,74.71,17.52,12.93,8.74
19-08-2021,SABROSA,14,1,238,"[120,240]",Moderado,,,,14,Norte,VILA REAL,1710,15692.45,5918,393,314,304,302,350,652,956,1270,1663,37.71,10.6,8.09,6.09
19-08-2021,SABUGAL,14,1,133,"[120,240]",Moderado,,,,14,Centro,GUARDA,0911,82269.82,10585,724,707,694,796,1009,1805,2499,3206,3930,12.87,4.78,3.9,3.04
19-08-2021,SALVATERRA DE MAGOS,34,2,161,"[120,240]",Moderado,,,,34,Lisboa e Vale do Tejo,SANTARÉM,1415,24393.2,21295,1275,1181,1060,799,772,1571,2631,3812,5087,87.3,20.85,15.63,10.79
19-08-2021,SANTA COMBA DÃO,8,1,77,"[0,120]",Baixo a Moderado,,,,8,Centro,VISEU,1814,11194.77,10452,732,684,569,538,464,1002,1571,2255,2987,93.36,26.68,20.14,14.03
19-08-2021,SANTA CRUZ,77,5,169,"[120,240]",Moderado,,,,77,Madeira,MADEIRA,3108,8150.28,45281,1817,1301,974,716,523,1239,2213,3514,5331,555.6,65.41,43.12,27.15
19-08-2021,SANTA CRUZ DA GRACIOSA,7,1,168,"[120,240]",Moderado,,,,7,Açores,AÇORES,4401,6065.78,4208,228,180,163,124,145,269,432,612,840,69.37,13.85,10.09,7.12
19-08-2021,SANTA CRUZ DAS FLORES,0,0,0,"[0,120]",Baixo a Moderado,,,,0,Açores,AÇORES,4802,7091.44,2165,125,98,74,56,51,107,181,279,404,30.53,5.7,3.93,2.55
19-08-2021,SANTA MARIA DA FEIRA,341,24,246,"[240,480]",Elevado,,,,341,Norte,AVEIRO,0109,21587.65,138636,8182,6743,4771,3856,3079,6935,11706,18449,26631,642.19,123.36,85.46,54.22
19-08-2021,SANTA MARTA DE PENAGUIÃO,32,2,488,"[480,960]",Muito Elevado,,,,32,Norte,VILA REAL,1711,6928.13,6599,483,373,337,316,317,633,970,1343,1826,95.25,26.36,19.39,14.0
19-08-2021,SANTANA,12,1,181,"[120,240]",Moderado,,,,12,Madeira,MADEIRA,3109,9547.3,6711,418,353,343,282,277,559,902,1255,1673,70.29,17.52,13.15,9.45
19-08-2021,SANTARÉM,126,9,219,"[120,240]",Moderado,,,,126,Lisboa e Vale do Tejo,SANTARÉM,1416,55253.58,57421,3654,3441,2760,2466,2206,4672,7432,10873,14527,103.92,26.29,19.68,13.45
19-08-2021,SANTIAGO DO CACÉM,47,3,164,"[120,240]",Moderado,,,,47,Alentejo,SETÚBAL,1509,105969.29,28791,2144,1689,1472,1295,1215,2510,3982,5671,7815,27.17,7.37,5.35,3.76
19-08-2021,SANTO TIRSO,148,11,217,"[120,240]",Moderado,,,,148,Norte,PORTO,1314,13655.52,68055,4911,3935,2761,2257,1810,4067,6828,10763,15674,498.35,114.78,78.82,50.0
19-08-2021,SÃO BRÁS DE ALPORTEL,47,3,453,"[240,480]",Elevado,,,,47,Algarve,FARO,0812,15336.92,10416,596,468,467,404,401,805,1272,1740,2336,67.91,15.23,11.35,8.29
19-08-2021,SÃO JOÃO DA MADEIRA,86,6,390,"[240,480]",Elevado,,,,86,Norte,AVEIRO,0116,794.3,21958,1347,1069,796,601,593,1194,1990,3059,4406,2765.49,554.91,385.26,250.63
19-08-2021,SÃO JOÃO DA PESQUEIRA,3,0,42,"[0,120]",Baixo a Moderado,,,,3,Norte,VISEU,1815,26610.85,7125,417,330,294,328,328,656,950,1280,1697,26.77,6.38,4.81,3.57
19-08-2021,SÃO PEDRO DO SUL,22,2,143,"[120,240]",Moderado,,,,22,Centro,VISEU,1816,34895.09,15403,990,962,861,759,909,1668,2529,3491,4481,44.14,12.84,10.0,7.25
19-08-2021,SÃO ROQUE DO PICO,0,0,0,"[0,120]",Baixo a Moderado,,,,0,Açores,AÇORES,4603,14236.1,3266,199,141,93,96,113,209,302,443,642,22.94,4.51,3.11,2.12
19-08-2021,SÃO VICENTE,18,1,352,"[240,480]",Elevado,,,,18,Madeira,MADEIRA,3110,7883.71,5143,272,264,266,225,280,505,771,1035,1307,65.23,16.58,13.13,9.78
19-08-2021,SARDOAL,5,0,135,"[120,240]",Moderado,,,,5,Lisboa e Vale do Tejo,SANTARÉM,1417,9214.72,3741,227,178,148,165,248,413,561,739,966,40.6,10.48,8.02,6.09
19-08-2021,SÁTÃO,18,1,155,"[120,240]",Moderado,,,,18,Centro,VISEU,1817,20194.11,11580,765,671,515,465,476,941,1456,2127,2892,57.34,14.32,10.53,7.21
19-08-2021,SEIA,22,2,99,"[0,120]",Baixo a Moderado,,,,22,Centro,GUARDA,0912,43568.83,22234,1807,1589,1238,1122,721,1843,3081,4670,6477,51.03,14.87,10.72,7.07
19-08-2021,SEIXAL,428,31,255,"[240,480]",Elevado,,,,428,Lisboa e Vale do Tejo,SETÚBAL,1510,9545.17,167752,10586,9270,6661,4391,2930,7321,13982,23252,33838,1757.49,354.51,243.6,146.49
19-08-2021,SERNANCELHE,3,0,56,"[0,120]",Baixo a Moderado,,,,3,Norte,VISEU,1818,22861.22,5396,305,293,286,273,260,533,819,1112,1417,23.6,6.2,4.86,3.58
19-08-2021,SERPA,38,3,268,"[240,480]",Elevado,,,,38,Alentejo,BEJA,0213,110563.34,14304,903,761,719,697,626,1323,2042,2803,3706,12.94,3.35,2.54,1.85
19-08-2021,SERTÃ,1,0,7,"[0,120]",Baixo a Moderado,,,,1,Centro,CASTELO BRANCO,0509,44673.17,14577,870,779,790,767,1020,1787,2577,3356,4226,32.63,9.46,7.51,5.77
19-08-2021,SESIMBRA,113,8,217,"[120,240]",Moderado,,,,113,Lisboa e Vale do Tejo,SETÚBAL,1511,19571.75,51858,2400,2321,1853,1257,1083,2340,4193,6514,8914,264.96,45.54,33.28,21.42
19-08-2021,SETÚBAL,292,21,254,"[240,480]",Elevado,,,,292,Lisboa e Vale do Tejo,SETÚBAL,1512,23032.5,115126,7425,6929,5075,3775,2655,6430,11505,18434,25859,499.83,112.27,80.03,49.95
19-08-2021,SEVER DO VOUGA,10,1,89,"[0,120]",Baixo a Moderado,,,,10,Centro,AVEIRO,0117,12987.56,11331,766,637,568,540,567,1107,1675,2312,3078,87.24,23.7,17.8,12.9
19-08-2021,SILVES,172,12,475,"[240,480]",Elevado,,,,172,Algarve,FARO,0813,68006.23,36226,2137,1869,1610,1423,1600,3023,4633,6502,8639,53.27,12.7,9.56,6.81
19-08-2021,SINES,86,6,627,"[480,960]",Muito Elevado,,,,86,Alentejo,SETÚBAL,1513,20330.17,13715,888,791,551,416,268,684,1235,2026,2914,67.46,14.33,9.97,6.07
19-08-2021,SINTRA,1053,75,269,"[240,480]",Elevado,,,,1053,Lisboa e Vale do Tejo,LISBOA,1111,31922.73,391402,20490,18316,13545,9137,7284,16421,29966,48282,68772,1226.08,215.43,151.25,93.87
19-08-2021,SOBRAL DE MONTE AGRAÇO,19,1,175,"[120,240]",Moderado,,,,19,Lisboa e Vale do Tejo,LISBOA,1112,5210.32,10651,564,507,352,272,212,484,836,1343,1907,204.43,36.6,25.78,16.05
19-08-2021,SOURE,15,1,88,"[0,120]",Baixo a Moderado,,,,15,Centro,COIMBRA,0615,26506.07,17120,1173,1142,1004,883,987,1870,2874,4016,5189,64.59,19.58,15.15,10.84
19-08-2021,SOUSEL,22,2,508,"[480,960]",Muito Elevado,,,,22,Alentejo,PORTALEGRE,1215,27932.18,4412,261,274,208,302,292,594,802,1076,1337,15.8,4.79,3.85,2.87
19-08-2021,TÁBUA,26,2,228,"[120,240]",Moderado,,,,26,Centro,COIMBRA,0616,19978.58,11368,729,584,524,430,464,894,1418,2002,2731,56.9,13.67,10.02,7.1
19-08-2021,TABUAÇO,4,0,66,"[0,120]",Baixo a Moderado,,,,4,Norte,VISEU,1819,13385.67,6033,372,314,217,282,363,645,862,1176,1548,45.07,11.56,8.79,6.44
19-08-2021,TAROUCA,4,0,51,"[0,120]",Baixo a Moderado,,,,4,Norte,VISEU,1820,10008.49,7804,405,335,313,277,324,601,914,1249,1654,77.98,16.53,12.48,9.13
19-08-2021,TAVIRA,79,6,321,"[240,480]",Elevado,,,,79,Algarve,FARO,0814,60696.7,24530,1493,1415,1252,1066,1277,2343,3595,5010,6503,40.41,10.71,8.25,5.92
19-08-2021,TERRAS DE BOURO,15,1,238,"[120,240]",Moderado,,,,15,Norte,BRAGA,0310,27746.07,6361,391,372,296,319,340,659,955,1327,1718,22.93,6.19,4.78,3.44
19-08-2021,TOMAR,54,4,147,"[120,240]",Moderado,,,,54,Lisboa e Vale do Tejo,SANTARÉM,1418,35120.44,36748,2403,2189,1868,1853,1822,3675,5543,7732,10135,104.64,28.86,22.02,15.78
19-08-2021,TONDELA,53,4,201,"[120,240]",Moderado,,,,53,Centro,VISEU,1821,37121.73,26357,1768,1722,1518,1475,1417,2892,4410,6132,7900,71.0,21.28,16.52,11.88
19-08-2021,TORRE DE MONCORVO,7,1,92,"[0,120]",Baixo a Moderado,,,,7,Norte,BRAGANÇA,0409,53155.67,7695,556,478,488,551,719,1270,1758,2236,2792,14.48,5.25,4.21,3.31
19-08-2021,TORRES NOVAS,79,6,225,"[120,240]",Moderado,,,,79,Lisboa e Vale do Tejo,SANTARÉM,1419,26999.68,34933,2324,1979,1738,1406,1475,2881,4619,6598,8922,129.38,33.04,24.44,17.11
19-08-2021,TORRES VEDRAS,145,10,185,"[120,240]",Moderado,,,,145,Lisboa e Vale do Tejo,LISBOA,1113,40714.89,78530,4513,3945,3447,2628,2104,4732,8179,12124,16637,192.88,40.86,29.78,20.09
19-08-2021,TRANCOSO,5,0,56,"[0,120]",Baixo a Moderado,,,,5,Centro,GUARDA,0913,36152.47,8875,581,557,542,586,496,1082,1624,2181,2762,24.55,7.64,6.03,4.49
19-08-2021,TROFA,118,8,307,"[240,480]",Elevado,,,,118,Norte,PORTO,1318,7201.76,38418,2336,1894,1231,939,684,1623,2854,4748,7084,533.44,98.36,65.93,39.63
19-08-2021,VAGOS,43,3,187,"[120,240]",Moderado,,,,43,Centro,AVEIRO,0118,16491.5,22740,1320,1205,922,784,724,1508,2430,3635,4955,137.89,30.04,22.04,14.73
19-08-2021,VALE DE CAMBRA,74,5,349,"[240,480]",Elevado,,,,74,Norte,AVEIRO,0119,14733.47,21327,1491,1363,1005,831,798,1629,2634,3997,5488,144.76,37.25,27.13,17.88
19-08-2021,VALENÇA,62,4,470,"[240,480]",Elevado,,,,62,Norte,VIANA DO CASTELO,1608,11712.86,13290,867,791,582,582,503,1085,1667,2458,3325,113.46,28.39,20.99,14.23
19-08-2021,VALONGO,196,14,201,"[120,240]",Moderado,,,,196,Norte,PORTO,1315,7512.45,97444,5629,4696,3207,2462,1829,4291,7498,12194,17823,1297.18,237.26,162.33,99.81
19-08-2021,VALPAÇOS,19,1,130,"[120,240]",Moderado,,,,19,Norte,VILA REAL,1712,54873.93,14818,1217,1118,999,928,997,1925,2924,4042,5259,27.0,9.58,7.37,5.33
19-08-2021,VELAS,17,1,335,"[240,480]",Elevado,,,,17,Açores,AÇORES,4502,11738.38,5093,278,208,166,153,113,266,432,640,918,43.39,7.82,5.45,3.68
19-08-2021,VENDAS NOVAS,10,1,89,"[0,120]",Baixo a Moderado,,,,10,Alentejo,ÉVORA,0712,22238.88,11255,677,768,655,501,532,1033,1688,2456,3133,50.61,14.09,11.04,7.59
19-08-2021,VIANA DO ALENTEJO,8,1,157,"[120,240]",Moderado,,,,8,Alentejo,ÉVORA,0713,39367.29,5145,245,208,235,210,214,424,659,867,1112,13.07,2.82,2.2,1.67
19-08-2021,VIANA DO CASTELO,202,14,239,"[120,240]",Moderado,,,,202,Norte,VIANA DO CASTELO,1609,31902.01,84417,5470,4433,3591,3061,2982,6043,9634,14067,19537,264.61,61.24,44.09,30.2
19-08-2021,VIDIGUEIRA,23,2,420,"[240,480]",Elevado,,,,23,Alentejo,BEJA,0214,31661.09,5510,300,248,215,233,275,508,723,971,1271,17.4,4.01,3.07,2.28
19-08-2021,VIEIRA DO MINHO,48,3,407,"[240,480]",Elevado,,,,48,Norte,BRAGA,0311,21644.35,11842,703,594,525,548,482,1030,1555,2149,2852,54.71,13.18,9.93,7.18
19-08-2021,VILA DE REI,5,0,150,"[120,240]",Moderado,,,,5,Centro,CASTELO BRANCO,0510,19154.6,3323,169,128,172,247,302,549,721,849,1018,17.35,5.31,4.43,3.76
19-08-2021,VILA DO BISPO,70,5,1360,"[960,Max]",Extremamente Elevado,,,,70,Algarve,FARO,0815,17906.06,5154,302,302,314,232,233,465,779,1081,1383,28.78,7.72,6.04,4.35
19-08-2021,VILA DO CONDE,193,14,241,"[240,480]",Elevado,,,,193,Norte,PORTO,1316,14902.77,79899,4726,3875,2819,2070,1743,3813,6632,10507,15233,536.13,102.21,70.5,44.5
19-08-2021,VILA DO PORTO,6,0,107,"[0,120]",Baixo a Moderado,,,,6,Açores,AÇORES,4101,9688.74,5616,274,212,135,96,123,219,354,566,840,57.96,8.67,5.84,3.65
19-08-2021,VILA FLOR,8,1,133,"[120,240]",Moderado,,,,8,Norte,BRAGANÇA,0410,26581.14,6044,429,362,422,294,331,625,1047,1409,1838,22.74,6.91,5.3,3.94
19-08-2021,VILA FRANCA DE XIRA,359,26,253,"[240,480]",Elevado,,,,359,Lisboa e Vale do Tejo,LISBOA,1114,31819.39,141957,8501,6852,4869,3425,2472,5897,10766,17618,26119,446.14,82.09,55.37,33.84
19-08-2021,VILA FRANCA DO CAMPO,38,3,346,"[240,480]",Elevado,,,,38,Açores,AÇORES,4206,7796.82,11051,450,344,248,217,154,371,619,963,1413,141.73,18.12,12.35,7.94
19-08-2021,VILA NOVA DA BARQUINHA,14,1,185,"[120,240]",Moderado,,,,14,Lisboa e Vale do Tejo,SANTARÉM,1420,4952.97,7461,415,406,392,364,338,702,1094,1500,1915,150.64,38.66,30.28,22.09
19-08-2021,VILA NOVA DE CERVEIRA,28,2,315,"[240,480]",Elevado,,,,28,Norte,VIANA DO CASTELO,1610,10846.66,8910,531,444,410,384,334,718,1128,1572,2103,82.14,19.39,14.49,10.4
19-08-2021,VILA NOVA DE FAMALICÃO,453,32,344,"[240,480]",Elevado,,,,453,Norte,BRAGA,0312,20159.26,131676,7817,6164,4202,3282,2749,6031,10233,16397,24214,653.19,120.12,81.34,50.76
19-08-2021,VILA NOVA DE FOZ CÔA,15,1,234,"[120,240]",Moderado,,,,15,Centro,GUARDA,0914,39815.18,6503,442,385,390,398,429,827,1217,1602,2044,16.33,5.13,4.02,3.06
19-08-2021,VILA NOVA DE GAIA,787,56,262,"[240,480]",Elevado,,,,787,Norte,PORTO,1317,16846.43,300472,18349,15568,10972,8224,6281,14505,25477,41045,59394,1783.64,352.57,243.65,151.23
19-08-2021,VILA NOVA DE PAIVA,8,1,171,"[120,240]",Moderado,,,,8,Centro,VISEU,1822,17553.28,4687,289,272,233,217,241,458,691,963,1252,26.7,7.13,5.49,3.94
19-08-2021,VILA NOVA DE POIARES,19,1,273,"[240,480]",Elevado,,,,19,Centro,COIMBRA,0617,8445.3,6939,380,284,262,235,182,417,679,963,1343,82.17,15.9,11.4,8.04
19-08-2021,VILA POUCA DE AGUIAR,60,4,498,"[480,960]",Muito Elevado,,,,60,Norte,VILA REAL,1713,43706.62,11961,860,817,733,601,627,1228,1961,2778,3638,27.37,8.32,6.36,4.49
19-08-2021,VILA REAL,137,10,275,"[240,480]",Elevado,,,,137,Norte,VILA REAL,1714,37880.28,49962,3025,2498,2065,1579,1466,3045,5110,7608,10633,131.9,28.07,20.08,13.49
19-08-2021,VILA REAL DE SANTO ANTÓNIO,74,5,397,"[240,480]",Elevado,,,,74,Algarve,FARO,0816,6125.0,18749,1172,1069,811,569,586,1155,1966,3035,4207,306.11,68.69,49.55,32.1
19-08-2021,VILA VELHA DE RÓDÃO,3,0,95,"[0,120]",Baixo a Moderado,,,,3,Centro,CASTELO BRANCO,0511,32991.16,3144,209,229,180,283,306,589,769,998,1207,9.53,3.66,3.03,2.33
19-08-2021,VILA VERDE,175,13,374,"[240,480]",Elevado,,,,175,Norte,BRAGA,0313,22866.52,46911,2365,2063,1667,1494,1437,2931,4598,6661,9026,205.15,39.47,29.13,20.11
19-08-2021,VILA VIÇOSA,24,2,317,"[240,480]",Elevado,,,,24,Alentejo,ÉVORA,0714,19485.89,7656,487,379,342,345,324,669,1011,1390,1877,39.29,9.63,7.13,5.19
19-08-2021,VIMIOSO,2,0,51,"[0,120]",Baixo a Moderado,,,,2,Norte,BRAGANÇA,0411,48158.51,4023,274,230,261,293,335,628,889,1119,1393,8.35,2.89,2.32,1.85
19-08-2021,VINHAIS,2,0,26,"[0,120]",Baixo a Moderado,,,,2,Norte,BRAGANÇA,0412,69475.09,7746,599,577,636,641,815,1456,2092,2669,3268,11.15,4.7,3.84,3.01
19-08-2021,VISEU,336,24,346,"[240,480]",Elevado,,,,336,Centro,VISEU,1823,50710.14,97249,5769,5038,4140,3158,2710,5868,10008,15046,20815,191.77,41.05,29.67,19.74
19-08-2021,VIZELA,98,7,410,"[240,480]",Elevado,,,,98,Norte,BRAGA,0314,2469.83,23897,1258,928,655,509,371,880,1535,2463,3721,967.49,150.65,99.72,62.15
19-08-2021,VOUZELA,10,1,104,"[0,120]",Baixo a Moderado,,,,10,Centro,VISEU,1824,19369.46,9619,626,605,554,532,507,1039,1593,2198,2824,49.66,14.58,11.35,8.22
26-08-2021,ABRANTES,48,3,137,"[120,240]",Moderado,,,,48,Lisboa e Vale do Tejo,SANTARÉM,1401,71469.08,35130,2473,2213,1730,1748,2021,3769,5499,7712,10185,49.15,14.25,10.79,7.69
26-08-2021,ÁGUEDA,90,6,196,"[120,240]",Moderado,,,,90,Centro,AVEIRO,0101,33527.44,46075,3237,2713,2090,1635,1496,3131,5221,7934,11171,137.43,33.32,23.66,15.57
26-08-2021,AGUIAR DA BEIRA,12,1,259,"[240,480]",Elevado,,,,12,Centro,GUARDA,0901,20676.57,4652,304,281,235,239,148,387,622,903,1207,22.5,5.84,4.37,3.01
26-08-2021,ALANDROAL,7,1,143,"[120,240]",Moderado,,,,7,Alentejo,ÉVORA,0701,54267.81,4992,307,256,296,299,377,676,972,1228,1535,9.2,2.83,2.26,1.79
26-08-2021,ALBERGARIA-A-VELHA,51,4,210,"[120,240]",Moderado,,,,51,Centro,AVEIRO,0102,15882.5,24144,1550,1298,996,687,680,1367,2363,3661,5211,152.02,32.81,23.05,14.88
26-08-2021,ALBUFEIRA,435,31,1047,"[960,Max]",Extremamente Elevado,,,,435,Algarve,FARO,0801,14066.42,41528,2067,1717,1425,985,858,1843,3268,4985,7052,295.24,50.14,35.44,23.23
26-08-2021,ALCÁCER DO SAL,20,1,173,"[120,240]",Moderado,,,,20,Alentejo,SETÚBAL,1501,149987.3,11659,884,814,623,623,602,1225,1848,2662,3546,7.77,2.36,1.77,1.23
26-08-2021,ALCANENA,69,5,536,"[480,960]",Muito Elevado,,,,69,Lisboa e Vale do Tejo,SANTARÉM,1402,12732.86,12809,891,744,628,536,588,1124,1752,2496,3387,100.6,26.6,19.6,13.76
26-08-2021,ALCOBAÇA,167,12,311,"[240,480]",Elevado,,,,167,Lisboa e Vale do Tejo,LEIRIA,1001,40814.09,53555,3420,2927,2466,2059,1676,3735,6201,9128,12548,131.22,30.74,22.36,15.19
26-08-2021,ALCOCHETE,36,3,181,"[120,240]",Moderado,,,,36,Lisboa e Vale do Tejo,SETÚBAL,1502,12836.48,19787,857,834,691,476,447,923,1614,2448,3305,154.15,25.75,19.07,12.57
26-08-2021,ALCOUTIM,2,0,96,"[0,120]",Baixo a Moderado,,,,2,Algarve,FARO,0802,57536.33,2159,191,188,163,190,267,457,620,808,999,3.75,1.74,1.4,1.08
26-08-2021,ALENQUER,59,4,134,"[120,240]",Moderado,,,,59,Lisboa e Vale do Tejo,LISBOA,1101,30421.92,44052,2298,2062,1629,1330,1155,2485,4114,6176,8474,144.8,27.85,20.3,13.52
26-08-2021,ALFÂNDEGA DA FÉ,1,0,22,"[0,120]",Baixo a Moderado,,,,1,Norte,BRAGANÇA,0401,32194.64,4550,325,277,301,274,325,599,900,1177,1502,14.13,4.67,3.66,2.8
26-08-2021,ALIJÓ,13,1,123,"[120,240]",Moderado,,,,13,Norte,VILA REAL,1701,29759.89,10625,766,687,635,542,666,1208,1843,2530,3296,35.7,11.08,8.5,6.19
26-08-2021,ALJEZUR,20,1,357,"[240,480]",Elevado,,,,20,Algarve,FARO,0803,32349.95,5594,316,336,335,320,410,730,1065,1401,1717,17.29,5.31,4.33,3.29
26-08-2021,ALJUSTREL,11,1,135,"[120,240]",Moderado,,,,11,Alentejo,BEJA,0201,45847.41,8247,635,521,443,347,358,705,1148,1669,2304,17.99,5.03,3.64,2.5
26-08-2021,ALMADA,598,43,354,"[240,480]",Elevado,,,,598,Lisboa e Vale do Tejo,SETÚBAL,1503,7000.89,169039,10469,9777,7876,6144,5111,11255,19131,28908,39377,2414.5,562.45,412.91,273.26
26-08-2021,ALMEIDA,24,2,415,"[240,480]",Elevado,,,,24,Centro,GUARDA,0902,51798.46,5830,441,419,396,458,393,851,1247,1666,2107,11.26,4.07,3.22,2.41
26-08-2021,ALMEIRIM,30,2,134,"[120,240]",Moderado,,,,30,Lisboa e Vale do Tejo,SANTARÉM,1403,22212.05,22546,1342,1353,1106,866,843,1709,2815,4168,5510,101.5,24.81,18.76,12.67
26-08-2021,ALMODÔVAR,25,2,375,"[240,480]",Elevado,,,,25,Alentejo,BEJA,0202,77788.03,6725,414,443,396,373,328,701,1097,1540,1954,8.65,2.51,1.98,1.41
26-08-2021,ALPIARÇA,21,2,301,"[240,480]",Elevado,,,,21,Lisboa e Vale do Tejo,SANTARÉM,1404,9536.33,7059,515,486,363,333,274,607,970,1456,1971,74.02,20.67,15.27,10.17
26-08-2021,ALTER DO CHÃO,10,1,319,"[240,480]",Elevado,,,,10,Alentejo,PORTALEGRE,1201,36206.62,3165,201,163,136,208,187,395,531,694,895,8.74,2.47,1.92,1.47
26-08-2021,ALVAIÁZERE,0,0,0,"[0,120]",Baixo a Moderado,,,,0,Centro,LEIRIA,1002,16047.76,6597,419,389,346,406,539,945,1291,1680,2099,41.11,13.08,10.47,8.04
26-08-2021,ALVITO,0,0,0,"[0,120]",Baixo a Moderado,,,,0,Alentejo,BEJA,0203,26485.32,2477,145,110,105,111,89,200,305,415,560,9.35,2.11,1.57,1.15
26-08-2021,AMADORA,602,43,327,"[240,480]",Elevado,,,,602,Lisboa e Vale do Tejo,LISBOA,1115,2378.47,184106,11186,10936,8780,6460,5890,12350,21130,32066,43252,7742.05,1818.84,1348.44,888.56
26-08-2021,AMARANTE,87,6,163,"[120,240]",Moderado,,,,87,Norte,PORTO,1301,30133.15,53193,3086,2413,1812,1643,1311,2954,4766,7179,10265,176.53,34.07,23.82,15.82
26-08-2021,AMARES,112,8,619,"[480,960]",Muito Elevado,,,,112,Norte,BRAGA,0301,8195.41,18129,1001,829,622,489,524,1013,1635,2464,3465,221.22,42.28,30.07,19.95
26-08-2021,ANADIA,74,5,270,"[240,480]",Elevado,,,,74,Centro,AVEIRO,0103,21663.48,27258,1931,1698,1376,1208,1262,2470,3846,5544,7475,125.83,34.51,25.59,17.75
26-08-2021,ANGRA DO HEROÍSMO,16,1,48,"[0,120]",Baixo a Moderado,,,,16,Açores,AÇORES,4301,23899.66,33807,2006,1473,1122,768,635,1403,2525,3998,6004,141.45,25.12,16.73,10.56
26-08-2021,ANSIÃO,23,2,191,"[120,240]",Moderado,,,,23,Centro,LEIRIA,1003,17609.42,12039,727,709,646,694,530,1224,1870,2579,3306,68.37,18.77,14.65,10.62
26-08-2021,ARCOS DE VALDEVEZ,28,2,135,"[120,240]",Moderado,,,,28,Norte,VIANA DO CASTELO,1601,44759.64,20926,1329,1338,1282,1343,1515,2858,4140,5478,6807,46.75,15.21,12.24,9.25
26-08-2021,ARGANIL,30,2,273,"[240,480]",Elevado,,,,30,Centro,COIMBRA,0601,33283.93,11014,672,648,612,559,596,1155,1767,2415,3087,33.09,9.27,7.26,5.31
26-08-2021,ARMAMAR,2,0,35,"[0,120]",Baixo a Moderado,,,,2,Norte,VISEU,1801,11723.73,5769,357,305,309,285,310,595,904,1209,1566,49.21,13.36,10.31,7.71
26-08-2021,AROUCA,155,11,747,"[480,960]",Muito Elevado,,,,155,Norte,AVEIRO,0104,32910.52,20720,1306,1047,753,683,683,1366,2119,3166,4472,62.96,13.59,9.62,6.44
26-08-2021,ARRAIOLOS,20,1,291,"[240,480]",Elevado,,,,20,Alentejo,ÉVORA,0702,68374.55,6928,435,384,283,367,480,847,1130,1514,1949,10.13,2.85,2.21,1.65
26-08-2021,ARRONCHES,1,0,36,"[0,120]",Baixo a Moderado,,,,1,Alentejo,PORTALEGRE,1202,31464.72,2820,155,142,162,187,179,366,528,670,825,8.96,2.62,2.13,1.68
26-08-2021,ARRUDA DOS VINHOS,18,1,120,"[120,240]",Moderado,,,,18,Lisboa e Vale do Tejo,LISBOA,1102,7795.93,15412,738,738,562,509,438,947,1509,2247,2985,197.69,38.29,28.82,19.36
26-08-2021,AVEIRO,128,9,163,"[120,240]",Moderado,,,,128,Centro,AVEIRO,0105,19757.57,78734,4520,4004,3050,2250,2103,4353,7403,11407,15927,398.49,80.61,57.73,37.47
26-08-2021,AVIS,1,0,24,"[0,120]",Baixo a Moderado,,,,1,Alentejo,PORTALEGRE,1203,60596.51,4247,315,225,206,251,273,524,730,955,1270,7.01,2.1,1.58,1.2
26-08-2021,AZAMBUJA,35,2,153,"[120,240]",Moderado,,,,35,Lisboa e Vale do Tejo,LISBOA,1103,26265.65,22716,1322,1171,1070,798,618,1416,2486,3657,4979,86.48,18.96,13.92,9.46
26-08-2021,BAIÃO,24,2,129,"[120,240]",Moderado,,,,24,Norte,PORTO,1302,17452.83,18748,1070,862,714,686,725,1411,2125,2987,4057,107.42,23.25,17.11,12.18
26-08-2021,BARCELOS,516,37,444,"[240,480]",Elevado,,,,516,Norte,BRAGA,0302,37890.14,116187,6721,5325,3619,2991,2562,5553,9172,14497,21218,306.64,56.0,38.26,24.21
26-08-2021,BARRANCOS,0,0,0,"[0,120]",Baixo a Moderado,,,,0,Alentejo,BEJA,0204,16841.73,1634,90,65,65,94,61,155,220,285,375,9.7,2.23,1.69,1.31
26-08-2021,BARREIRO,211,15,281,"[240,480]",Elevado,,,,211,Lisboa e Vale do Tejo,SETÚBAL,1504,3639.07,75147,5194,5565,4459,3105,1767,4872,9331,14896,20090,2065.05,552.07,409.34,256.42
26-08-2021,BATALHA,50,4,315,"[240,480]",Elevado,,,,50,Centro,LEIRIA,1004,10341.6,15963,873,762,649,529,549,1078,1727,2489,3362,154.35,32.51,24.07,16.7
26-08-2021,BEJA,336,24,1002,"[960,Max]",Extremamente Elevado,,,,336,Alentejo,BEJA,0205,114647.55,33579,2005,1840,1386,1272,1039,2311,3697,5537,7542,29.29,6.58,4.83,3.22
26-08-2021,BELMONTE,12,1,188,"[120,240]",Moderado,,,,12,Centro,CASTELO BRANCO,0501,11875.91,6398,444,321,325,310,355,665,990,1311,1755,53.87,14.78,11.04,8.34
26-08-2021,BENAVENTE,95,7,309,"[240,480]",Elevado,,,,95,Lisboa e Vale do Tejo,SANTARÉM,1405,52138.39,30602,1468,1376,1141,876,643,1519,2660,4036,5504,58.69,10.56,7.74,5.1
26-08-2021,BOMBARRAL,20,1,158,"[120,240]",Moderado,,,,20,Lisboa e Vale do Tejo,LEIRIA,1005,9128.55,12558,875,714,561,491,429,920,1481,2195,3070,137.56,33.63,24.04,16.22
26-08-2021,BORBA,19,1,285,"[240,480]",Elevado,,,,19,Alentejo,ÉVORA,0703,14518.65,6736,430,375,279,436,392,828,1107,1482,1912,46.39,13.17,10.21,7.62
26-08-2021,BOTICAS,72,5,1441,"[960,Max]",Extremamente Elevado,,,,72,Norte,VILA REAL,1702,32195.66,4998,347,306,311,305,380,685,996,1302,1649,15.52,5.12,4.04,3.09
26-08-2021,BRAGA,826,59,452,"[240,480]",Elevado,,,,826,Norte,BRAGA,0303,18339.95,182679,10029,7963,5241,4320,3671,7991,13232,21195,31224,996.07,170.25,115.57,72.15
26-08-2021,BRAGANÇA,99,7,296,"[240,480]",Elevado,,,,99,Norte,BRAGANÇA,0402,117357.27,33607,2402,1855,1652,1393,1163,2556,4208,6063,8465,28.64,7.21,5.17,3.59
26-08-2021,CABECEIRAS DE BASTO,45,3,290,"[240,480]",Elevado,,,,45,Norte,BRAGA,0304,24182.16,15628,774,594,544,575,574,1149,1693,2287,3061,64.63,12.66,9.46,7.0
26-08-2021,CADAVAL,25,2,182,"[120,240]",Moderado,,,,25,Lisboa e Vale do Tejo,LISBOA,1104,17489.3,13673,813,796,756,621,625,1246,2002,2798,3611,78.18,20.65,16.0,11.45
26-08-2021,CALDAS DA RAINHA,96,7,185,"[120,240]",Moderado,,,,96,Lisboa e Vale do Tejo,LEIRIA,1006,25569.47,51912,3035,2684,2186,1899,1705,3604,5790,8474,11509,203.03,45.01,33.14,22.64
26-08-2021,CALHETA,10,1,92,"[0,120]",Baixo a Moderado,,,,10,Madeira,MADEIRA,3101,11150.43,10867,576,497,507,399,415,814,1321,1818,2394,97.46,21.47,16.3,11.85
26-08-2021,CALHETA (AÇORES),3,0,95,"[0,120]",Baixo a Moderado,,,,3,Açores,AÇORES,4501,12626.4,3184,215,159,141,139,122,261,402,561,776,25.22,6.15,4.44,3.18
26-08-2021,CÂMARA DE LOBOS,66,5,196,"[120,240]",Moderado,,,,66,Madeira,MADEIRA,3102,5216.67,33675,1396,1059,834,545,381,926,1760,2819,4215,645.49,80.79,54.03,33.74
26-08-2021,CAMINHA,33,2,209,"[120,240]",Moderado,,,,33,Norte,VIANA DO CASTELO,1602,13652.14,15877,1046,944,818,646,656,1302,2120,3064,4110,116.3,30.11,22.44,15.53
26-08-2021,CAMPO MAIOR,39,3,501,"[480,960]",Muito Elevado,,,,39,Alentejo,PORTALEGRE,1204,24720.16,7874,471,364,351,279,327,606,957,1321,1792,31.85,7.25,5.34,3.87
26-08-2021,CANTANHEDE,62,4,177,"[120,240]",Moderado,,,,62,Centro,COIMBRA,0602,39088.02,35011,2346,2096,1880,1709,1451,3160,5040,7136,9482,89.57,24.26,18.26,12.89
26-08-2021,CARRAZEDA DE ANSIÃES,5,0,89,"[0,120]",Baixo a Moderado,,,,5,Norte,BRAGANÇA,0403,27924.09,5666,424,389,391,312,465,777,1168,1557,1981,20.29,7.09,5.58,4.18
26-08-2021,CARREGAL DO SAL,43,3,462,"[240,480]",Elevado,,,,43,Centro,VISEU,1802,11689.21,9271,587,562,486,462,376,838,1324,1886,2473,79.31,21.16,16.13,11.33
26-08-2021,CARTAXO,22,2,93,"[0,120]",Baixo a Moderado,,,,22,Lisboa e Vale do Tejo,SANTARÉM,1406,15817.28,23843,1415,1376,1142,861,632,1493,2635,4011,5426,150.74,34.3,25.36,16.66
26-08-2021,CASCAIS,799,57,374,"[240,480]",Elevado,,,,799,Lisboa e Vale do Tejo,LISBOA,1105,9740.17,213608,12151,11444,8680,6469,5248,11717,20397,31841,43992,2193.1,451.66,326.91,209.41
26-08-2021,CASTANHEIRA DE PÊRA,2,0,78,"[0,120]",Baixo a Moderado,,,,2,Centro,LEIRIA,1007,6677.45,2614,233,195,157,190,187,377,534,729,962,39.15,14.41,10.92,8.0
26-08-2021,CASTELO BRANCO,125,9,240,"[240,480]",Elevado,,,,125,Centro,CASTELO BRANCO,0502,143819.15,51987,3528,3042,2499,2229,2225,4454,6953,9995,13523,36.15,9.4,6.95,4.83
26-08-2021,CASTELO DE PAIVA,30,2,196,"[120,240]",Moderado,,,,30,Norte,AVEIRO,0106,11500.53,15454,881,697,545,420,431,851,1396,2093,2974,134.37,25.86,18.2,12.14
26-08-2021,CASTELO DE VIDE,2,0,69,"[0,120]",Baixo a Moderado,,,,2,Alentejo,PORTALEGRE,1205,26491.24,2919,204,173,179,147,170,317,496,669,873,11.02,3.3,2.53,1.87
26-08-2021,CASTRO DAIRE,9,1,65,"[0,120]",Baixo a Moderado,,,,9,Centro,VISEU,1803,37904.13,13823,942,857,765,732,773,1505,2270,3127,4069,36.47,10.74,8.25,5.99
26-08-2021,CASTRO MARIM,16,1,258,"[240,480]",Elevado,,,,16,Algarve,FARO,0804,30084.37,6237,370,345,334,322,344,666,1000,1345,1715,20.73,5.7,4.47,3.32
26-08-2021,CASTRO VERDE,21,2,305,"[240,480]",Elevado,,,,21,Alentejo,BEJA,0206,56944.23,6949,437,347,303,275,227,502,805,1152,1589,12.2,2.79,2.02,1.41
26-08-2021,CELORICO DA BEIRA,22,2,317,"[240,480]",Elevado,,,,22,Centro,GUARDA,0903,24721.63,6928,430,416,363,369,535,904,1267,1683,2113,28.02,8.55,6.81,5.12
26-08-2021,CELORICO DE BASTO,53,4,280,"[240,480]",Elevado,,,,53,Norte,BRAGA,0305,18107.02,19040,1001,802,668,728,729,1457,2125,2927,3928,105.15,21.69,16.17,11.74
26-08-2021,CHAMUSCA,5,0,55,"[0,120]",Baixo a Moderado,,,,5,Lisboa e Vale do Tejo,SANTARÉM,1407,74600.54,9197,629,583,553,465,579,1044,1597,2180,2809,12.33,3.77,2.92,2.14
26-08-2021,CHAVES,207,15,526,"[480,960]",Muito Elevado,,,,207,Norte,VILA REAL,1703,59122.95,39343,2676,2429,1991,1886,1918,3804,5795,8224,10900,66.54,18.44,13.91,9.8
26-08-2021,CINFÃES,41,3,222,"[120,240]",Moderado,,,,41,Norte,VISEU,1804,23928.76,18244,1067,902,779,734,758,1492,2271,3173,4240,76.24,17.72,13.26,9.49
26-08-2021,COIMBRA,311,22,232,"[120,240]",Moderado,,,,311,Centro,COIMBRA,0603,31939.94,134166,9489,8734,6353,5139,5074,10213,16566,25300,34789,420.06,108.92,79.21,51.87
26-08-2021,CONDEIXA-A-NOVA,15,1,84,"[0,120]",Baixo a Moderado,,,,15,Centro,COIMBRA,0604,13867.47,17733,871,809,717,583,490,1073,1790,2599,3470,127.88,25.02,18.74,12.91
26-08-2021,CONSTÂNCIA,1,0,25,"[0,120]",Baixo a Moderado,,,,1,Lisboa e Vale do Tejo,SANTARÉM,1408,8036.58,4030,211,183,187,148,155,303,490,673,884,50.14,11.0,8.37,6.1
26-08-2021,CORUCHE,14,1,81,"[0,120]",Baixo a Moderado,,,,14,Lisboa e Vale do Tejo,SANTARÉM,1409,111572.03,17471,1294,1090,1095,1096,1019,2115,3210,4300,5594,15.66,5.01,3.85,2.88
26-08-2021,CORVO,0,0,0,"[0,120]",Baixo a Moderado,,,,0,Açores,AÇORES,4901,1711.45,464,22,21,11,13,19,32,43,64,86,27.12,5.03,3.74,2.51
26-08-2021,COVILHÃ,249,18,532,"[480,960]",Muito Elevado,,,,249,Centro,CASTELO BRANCO,0503,55560.06,46787,3533,2998,2365,2111,2193,4304,6669,9667,13200,84.21,23.76,17.4,12.0
26-08-2021,CRATO,2,0,65,"[0,120]",Baixo a Moderado,,,,2,Alentejo,PORTALEGRE,1206,39806.88,3129,229,258,163,182,228,410,573,831,1060,7.86,2.66,2.09,1.44
26-08-2021,CUBA,27,2,594,"[480,960]",Muito Elevado,,,,27,Alentejo,BEJA,0207,17208.72,4595,255,233,206,190,143,333,539,772,1027,26.7,5.97,4.49,3.13
26-08-2021,ELVAS,48,3,232,"[120,240]",Moderado,,,,48,Alentejo,PORTALEGRE,1207,63128.86,20528,1057,1145,902,852,810,1662,2564,3709,4766,32.52,7.55,5.88,4.06
26-08-2021,ENTRONCAMENTO,53,4,246,"[240,480]",Elevado,,,,53,Lisboa e Vale do Tejo,SANTARÉM,1410,1372.81,21558,1066,930,868,695,592,1287,2155,3085,4151,1570.14,302.33,224.69,156.96
26-08-2021,ESPINHO,55,4,187,"[120,240]",Moderado,,,,55,Norte,AVEIRO,0107,2105.68,29516,2205,1993,1430,1177,960,2137,3567,5560,7765,1401.52,368.71,264.01,169.37
26-08-2021,ESPOSENDE,211,15,618,"[480,960]",Muito Elevado,,,,211,Norte,BRAGA,0306,9540.98,34177,1831,1522,1095,894,723,1617,2712,4234,6065,358.21,63.57,44.38,28.42
26-08-2021,ESTARREJA,30,2,115,"[0,120]",Baixo a Moderado,,,,30,Centro,AVEIRO,0108,10817.33,26006,1503,1399,1106,953,728,1681,2787,4186,5689,240.42,52.59,38.7,25.76
26-08-2021,ESTREMOZ,35,3,278,"[240,480]",Elevado,,,,35,Alentejo,ÉVORA,0704,51379.95,12728,789,613,697,786,877,1663,2360,2973,3762,24.77,7.32,5.79,4.59
26-08-2021,ÉVORA,226,16,431,"[240,480]",Elevado,,,,226,Alentejo,ÉVORA,0705,130707.58,52428,3569,2852,2176,1966,1803,3769,5945,8797,12366,40.11,9.46,6.73,4.55
26-08-2021,FAFE,223,16,463,"[240,480]",Elevado,,,,223,Norte,BRAGA,0307,21908.11,48060,3044,2455,1679,1403,1208,2611,4290,6745,9789,219.37,44.68,30.79,19.58
26-08-2021,FARO,405,29,664,"[480,960]",Muito Elevado,,,,405,Algarve,FARO,0805,20256.79,61015,3847,3364,2604,2055,1601,3656,6260,9624,13471,301.2,66.5,47.51,30.9
26-08-2021,FELGUEIRAS,167,12,296,"[240,480]",Elevado,,,,167,Norte,PORTO,1303,11573.75,56422,2951,2302,1601,1316,973,2289,3890,6192,9143,487.49,79.0,53.5,33.61
26-08-2021,FERREIRA DO ALENTEJO,17,1,218,"[120,240]",Moderado,,,,17,Alentejo,BEJA,0208,64820.68,7845,515,414,372,343,345,688,1060,1474,1989,12.1,3.07,2.27,1.64
26-08-2021,FERREIRA DO ZÊZERE,21,2,264,"[240,480]",Elevado,,,,21,Lisboa e Vale do Tejo,SANTARÉM,1411,19038.03,7959,470,370,416,465,456,921,1337,1707,2177,41.81,11.44,8.97,7.02
26-08-2021,FIGUEIRA DA FOZ,146,10,249,"[240,480]",Elevado,,,,146,Centro,COIMBRA,0605,37905.26,58747,4032,3597,2887,2495,2043,4538,7425,11022,15054,154.98,39.72,29.08,19.59
26-08-2021,FIGUEIRA DE CASTELO RODRIGO,4,0,72,"[0,120]",Baixo a Moderado,,,,4,Centro,GUARDA,0904,50857.46,5584,347,352,290,352,391,743,1033,1385,1732,10.98,3.41,2.72,2.03
26-08-2021,FIGUEIRÓ DOS VINHOS,5,0,90,"[0,120]",Baixo a Moderado,,,,5,Centro,LEIRIA,1008,17344.0,5568,402,386,322,309,351,660,982,1368,1770,32.1,10.21,7.89,5.66
26-08-2021,FORNOS DE ALGODRES,5,0,110,"[0,120]",Baixo a Moderado,,,,5,Centro,GUARDA,0905,13145.05,4528,261,218,247,256,232,488,735,953,1214,34.45,9.24,7.25,5.59
26-08-2021,FREIXO DE ESPADA À CINTA,2,0,62,"[0,120]",Baixo a Moderado,,,,2,Norte,BRAGANÇA,0404,24414.29,3298,211,177,231,196,189,385,616,793,1004,13.51,4.11,3.25,2.52
26-08-2021,FRONTEIRA,24,2,818,"[480,960]",Muito Elevado,,,,24,Alentejo,PORTALEGRE,1208,24859.58,2974,213,182,149,156,168,324,473,655,868,11.96,3.49,2.63,1.9
26-08-2021,FUNCHAL,316,23,304,"[240,480]",Elevado,,,,316,Madeira,MADEIRA,3103,7616.2,104024,6382,5086,3643,2821,1990,4811,8454,13540,19922,1365.86,261.58,177.78,111.0
26-08-2021,FUNDÃO,36,3,136,"[120,240]",Moderado,,,,36,Centro,CASTELO BRANCO,0504,70019.79,26495,1781,1464,1432,1357,1643,3000,4432,5896,7677,37.84,10.96,8.42,6.33
26-08-2021,GAVIÃO,1,0,31,"[0,120]",Baixo a Moderado,,,,1,Alentejo,PORTALEGRE,1209,29459.45,3263,189,186,222,263,293,556,778,964,1153,11.08,3.91,3.27,2.64
26-08-2021,GÓIS,3,0,80,"[0,120]",Baixo a Moderado,,,,3,Centro,COIMBRA,0606,26330.19,3805,235,199,240,233,244,477,717,916,1151,14.45,4.37,3.48,2.72
26-08-2021,GOLEGÃ,5,0,95,"[0,120]",Baixo a Moderado,,,,5,Lisboa e Vale do Tejo,SANTARÉM,1412,8431.67,5339,356,299,281,243,255,498,779,1078,1434,63.32,17.01,12.78,9.24
26-08-2021,GONDOMAR,320,23,193,"[120,240]",Moderado,,,,320,Norte,PORTO,1304,13191.76,165985,10555,8755,6222,4450,3364,7814,14036,22791,33346,1258.22,252.77,172.76,106.4
26-08-2021,GOUVEIA,10,1,81,"[0,120]",Baixo a Moderado,,,,10,Centro,GUARDA,0906,30061.17,12387,871,931,780,783,810,1593,2373,3304,4175,41.21,13.89,10.99,7.89
26-08-2021,GRÂNDOLA,29,2,199,"[120,240]",Moderado,,,,29,Alentejo,SETÚBAL,1505,82593.66,14639,834,834,708,688,672,1360,2068,2902,3736,17.72,4.52,3.51,2.5
26-08-2021,GUARDA,76,5,195,"[120,240]",Moderado,,,,76,Centro,GUARDA,0907,71209.58,38969,2477,2041,1686,1415,1474,2889,4575,6616,9093,54.72,12.77,9.29,6.42
26-08-2021,GUIMARÃES,564,40,370,"[240,480]",Elevado,,,,564,Norte,BRAGA,0308,24099.96,152309,9394,7074,4809,3877,2948,6825,11634,18708,28102,631.99,116.61,77.63,48.27
26-08-2021,HORTA,8,1,55,"[0,120]",Baixo a Moderado,,,,8,Açores,AÇORES,4701,17305.53,14521,818,658,468,352,302,654,1122,1780,2598,83.91,15.01,10.29,6.48
26-08-2021,IDANHA-A-NOVA,17,1,214,"[120,240]",Moderado,,,,17,Centro,CASTELO BRANCO,0505,141633.51,8043,518,490,519,672,974,1646,2165,2655,3173,5.68,2.24,1.87,1.53
26-08-2021,ÍLHAVO,81,6,209,"[120,240]",Moderado,,,,81,Centro,AVEIRO,0110,7347.55,38699,2227,1943,1444,1193,850,2043,3487,5430,7657,526.66,104.21,73.9,47.46
26-08-2021,LAGOA (FARO),133,10,585,"[480,960]",Muito Elevado,,,,133,Algarve,FARO,0806,8825.45,22762,1314,1168,919,749,670,1419,2338,3506,4820,257.93,54.62,39.73,26.49
26-08-2021,LAGOA,51,4,346,"[240,480]",Elevado,,,,51,Açores,AÇORES,4201,4559.32,14721,536,458,349,238,235,473,822,1280,1816,322.9,39.83,28.08,18.03
26-08-2021,LAGOS,414,30,1364,"[960,Max]",Extremamente Elevado,,,,414,Algarve,FARO,0807,21299.27,30374,1744,1434,1247,1053,1029,2082,3329,4763,6507,142.61,30.55,22.36,15.63
26-08-2021,LAJES DAS FLORES,0,0,0,"[0,120]",Baixo a Moderado,,,,0,Açores,AÇORES,4801,7004.79,1463,88,53,62,46,54,100,162,215,303,20.89,4.33,3.07,2.31
26-08-2021,LAJES DO PICO,3,0,67,"[0,120]",Baixo a Moderado,,,,3,Açores,AÇORES,4601,15531.09,4490,304,231,223,159,162,321,544,775,1079,28.91,6.95,4.99,3.5
26-08-2021,LAMEGO,14,1,57,"[0,120]",Baixo a Moderado,,,,14,Norte,VISEU,1805,16542.11,24895,1639,1284,1124,898,783,1681,2805,4089,5728,150.5,34.63,24.72,16.96
26-08-2021,LEIRIA,599,43,478,"[240,480]",Elevado,,,,599,Centro,LEIRIA,1009,56508.83,125267,7389,6366,5090,3902,3159,7061,12151,18517,25906,221.68,45.84,32.77,21.5
26-08-2021,LISBOA,2344,167,460,"[240,480]",Elevado,,,,2344,Lisboa e Vale do Tejo,LISBOA,1106,10005.43,509515,33197,33340,27706,23037,26770,49807,77513,110853,144050,5092.6,1439.78,1107.98,774.74
26-08-2021,LOULÉ,545,39,793,"[480,960]",Muito Elevado,,,,545,Algarve,FARO,0808,76366.91,68697,3890,3350,2780,2358,2251,4609,7389,10739,14629,89.96,19.16,14.06,9.68
26-08-2021,LOURES,528,38,247,"[240,480]",Elevado,,,,528,Lisboa e Vale do Tejo,LISBOA,1107,16723.99,213687,12746,12794,9644,6669,5033,11702,21346,34140,46886,1277.73,280.35,204.14,127.64
26-08-2021,LOURINHÃ,35,3,137,"[120,240]",Moderado,,,,35,Lisboa e Vale do Tejo,LISBOA,1108,14717.2,25855,1584,1243,992,842,645,1487,2479,3722,5306,175.68,36.05,25.29,16.84
26-08-2021,LOUSÃ,23,2,133,"[120,240]",Moderado,,,,23,Centro,COIMBRA,0607,13840.01,17158,946,866,658,528,450,978,1636,2502,3448,123.97,24.91,18.08,11.82
26-08-2021,LOUSADA,144,10,307,"[240,480]",Elevado,,,,144,Norte,PORTO,1305,9608.01,46755,2289,1698,1176,853,621,1474,2650,4348,6637,486.63,69.08,45.25,27.58
26-08-2021,MAÇÃO,14,1,226,"[120,240]",Moderado,,,,14,Lisboa e Vale do Tejo,SANTARÉM,1413,39997.98,6267,386,362,390,440,657,1097,1487,1849,2235,15.67,5.59,4.62,3.72
26-08-2021,MACEDO DE CAVALEIROS,18,1,125,"[120,240]",Moderado,,,,18,Norte,BRAGANÇA,0405,69914.08,14516,1082,889,878,823,938,1761,2639,3528,4610,20.76,6.59,5.05,3.77
26-08-2021,MACHICO,17,1,86,"[0,120]",Baixo a Moderado,,,,17,Madeira,MADEIRA,3104,6825.1,19981,1197,860,662,455,331,786,1448,2308,3505,292.76,51.36,33.82,21.22
26-08-2021,MADALENA,0,0,0,"[0,120]",Baixo a Moderado,,,,0,Açores,AÇORES,4602,14712.33,5895,334,256,173,190,179,369,542,798,1132,40.07,7.69,5.42,3.68
26-08-2021,MAFRA,209,15,247,"[240,480]",Elevado,,,,209,Lisboa e Vale do Tejo,LISBOA,1109,29165.5,84816,3613,3334,2839,2089,1899,3988,6827,10161,13774,290.81,47.23,34.84,23.41
26-08-2021,MAIA,334,24,240,"[240,480]",Elevado,,,,334,Norte,PORTO,1306,8293.94,138971,7801,6617,4512,3339,2631,5970,10482,17099,24900,1675.56,300.22,206.16,126.38
26-08-2021,MANGUALDE,53,4,286,"[240,480]",Elevado,,,,53,Centro,VISEU,1806,21925.56,18510,1198,1128,885,852,743,1595,2480,3608,4806,84.42,21.92,16.46,11.31
26-08-2021,MANTEIGAS,3,0,100,"[0,120]",Baixo a Moderado,,,,3,Centro,GUARDA,0908,12197.55,3007,258,197,159,167,146,313,472,669,927,24.65,7.6,5.48,3.87
26-08-2021,MARCO DE CANAVESES,81,6,158,"[120,240]",Moderado,,,,81,Norte,PORTO,1307,20188.98,51496,2678,2060,1488,1265,1023,2288,3776,5836,8514,255.07,42.17,28.91,18.7
26-08-2021,MARINHA GRANDE,171,12,443,"[240,480]",Elevado,,,,171,Centro,LEIRIA,1010,18725.19,38508,2365,2302,1638,1359,1058,2417,4055,6357,8722,205.65,46.58,33.95,21.66
26-08-2021,MARVÃO,55,4,1838,"[960,Max]",Extremamente Elevado,,,,55,Alentejo,PORTALEGRE,1210,15489.9,3005,198,185,142,197,237,434,576,761,959,19.4,6.19,4.91,3.72
26-08-2021,MATOSINHOS,463,33,264,"[240,480]",Elevado,,,,463,Norte,PORTO,1308,6241.97,175357,11850,9977,7023,5024,3884,8908,15931,25908,37758,2809.31,604.9,415.06,255.22
26-08-2021,MEALHADA,18,1,90,"[0,120]",Baixo a Moderado,,,,18,Centro,AVEIRO,0111,11065.66,19914,1163,1039,810,828,831,1659,2469,3508,4671,179.96,42.21,31.7,22.31
26-08-2021,MÊDA,9,1,197,"[120,240]",Moderado,,,,9,Centro,GUARDA,0909,28604.92,4587,343,306,290,288,443,731,1021,1327,1670,16.04,5.84,4.64,3.57
26-08-2021,MELGAÇO,15,1,188,"[120,240]",Moderado,,,,15,Norte,VIANA DO CASTELO,1603,23824.58,8093,507,567,578,614,675,1289,1867,2434,2941,33.97,12.34,10.22,7.84
26-08-2021,MÉRTOLA,12,1,198,"[120,240]",Moderado,,,,12,Alentejo,BEJA,0209,129287.34,6142,400,390,378,423,600,1023,1401,1791,2191,4.75,1.69,1.39,1.08
26-08-2021,MESÃO FRIO,5,0,127,"[120,240]",Moderado,,,,5,Norte,VILA REAL,1704,2664.87,3964,265,205,168,157,120,277,445,650,915,148.74,34.33,24.39,16.7
26-08-2021,MIRA,12,1,101,"[0,120]",Baixo a Moderado,,,,12,Centro,COIMBRA,0608,12403.38,11832,727,729,659,550,466,1016,1675,2404,3131,95.4,25.24,19.38,13.5
26-08-2021,MIRANDA DO CORVO,22,2,173,"[120,240]",Moderado,,,,22,Centro,COIMBRA,0609,12637.79,12708,706,659,568,498,404,902,1470,2129,2835,100.55,22.43,16.85,11.63
26-08-2021,MIRANDA DO DOURO,8,1,118,"[0,120]",Baixo a Moderado,,,,8,Norte,BRAGANÇA,0406,48718.31,6830,482,429,442,463,470,933,1375,1804,2286,14.02,4.69,3.7,2.82
26-08-2021,MIRANDELA,59,4,269,"[240,480]",Elevado,,,,59,Norte,BRAGANÇA,0407,65895.67,21754,1640,1315,1204,1078,947,2025,3229,4544,6184,33.01,9.38,6.9,4.9
26-08-2021,MOGADOURO,18,1,217,"[120,240]",Moderado,,,,18,Norte,BRAGANÇA,0408,76064.93,8392,589,529,576,630,655,1285,1861,2390,2979,11.03,3.92,3.14,2.45
26-08-2021,MOIMENTA DA BEIRA,8,1,82,"[0,120]",Baixo a Moderado,,,,8,Norte,VISEU,1807,21996.9,9736,576,514,471,416,461,877,1348,1862,2438,44.26,11.08,8.46,6.13
26-08-2021,MOITA,153,11,237,"[120,240]",Moderado,,,,153,Lisboa e Vale do Tejo,SETÚBAL,1506,5525.98,64407,4226,3646,2623,1801,1425,3226,5849,9495,13721,1165.53,248.3,171.82,105.85
26-08-2021,MONÇÃO,65,5,361,"[240,480]",Elevado,,,,65,Norte,VIANA DO CASTELO,1604,21130.85,17869,1161,1105,1031,1006,972,1978,3009,4114,5275,84.56,24.96,19.47,14.24
26-08-2021,MONCHIQUE,6,0,121,"[120,240]",Moderado,,,,6,Algarve,FARO,0809,39530.43,5077,353,384,321,355,392,747,1068,1452,1805,12.84,4.57,3.67,2.7
26-08-2021,MONDIM DE BASTO,31,2,451,"[240,480]",Elevado,,,,31,Norte,VILA REAL,1705,17207.52,6946,395,300,314,284,283,567,881,1181,1576,40.36,9.16,6.86,5.12
26-08-2021,MONFORTE,5,0,170,"[120,240]",Moderado,,,,5,Alentejo,PORTALEGRE,1211,42024.82,2975,139,115,117,192,168,360,477,592,731,7.08,1.74,1.41,1.14
26-08-2021,MONTALEGRE,58,4,642,"[480,960]",Muito Elevado,,,,58,Norte,VILA REAL,1706,80545.71,8997,699,628,595,603,730,1333,1928,2556,3255,11.17,4.04,3.17,2.39
26-08-2021,MONTEMOR-O-NOVO,31,2,201,"[120,240]",Moderado,,,,31,Alentejo,ÉVORA,0706,123296.65,15647,991,953,868,878,971,1849,2717,3670,4661,12.69,3.78,2.98,2.2
26-08-2021,MONTEMOR-O-VELHO,21,1,83,"[0,120]",Baixo a Moderado,,,,21,Centro,COIMBRA,0610,22896.23,25224,1496,1397,1217,1057,988,2045,3262,4659,6155,110.17,26.88,20.35,14.25
26-08-2021,MONTIJO,96,7,167,"[120,240]",Moderado,,,,96,Lisboa e Vale do Tejo,SETÚBAL,1507,34861.64,57614,2771,2441,1990,1554,1109,2663,4653,7094,9865,165.26,28.3,20.35,13.35
26-08-2021,MORA,2,0,50,"[0,120]",Baixo a Moderado,,,,2,Alentejo,ÉVORA,0707,44395.02,4138,336,275,252,238,257,495,747,1022,1358,9.32,3.06,2.3,1.68
26-08-2021,MORTÁGUA,18,1,204,"[120,240]",Moderado,,,,18,Centro,VISEU,1808,25117.82,8803,638,584,535,499,460,959,1494,2078,2716,35.05,10.81,8.27,5.95
26-08-2021,MOURA,102,7,742,"[480,960]",Muito Elevado,,,,102,Alentejo,BEJA,0210,95845.55,13718,817,656,665,542,461,1003,1668,2324,3141,14.31,3.28,2.42,1.74
26-08-2021,MOURÃO,34,2,1397,"[960,Max]",Extremamente Elevado,,,,34,Alentejo,ÉVORA,0708,27862.98,2450,139,108,80,104,109,213,293,401,540,8.79,1.94,1.44,1.05
26-08-2021,MURÇA,7,1,130,"[120,240]",Moderado,,,,7,Norte,VILA REAL,1707,18937.11,5463,384,341,307,306,319,625,932,1273,1657,28.85,8.75,6.72,4.92
26-08-2021,MURTOSA,10,1,96,"[0,120]",Baixo a Moderado,,,,10,Centro,AVEIRO,0112,7308.78,10279,509,473,403,353,409,762,1165,1638,2147,140.63,29.37,22.41,15.94
26-08-2021,NAZARÉ,51,4,358,"[240,480]",Elevado,,,,51,Lisboa e Vale do Tejo,LEIRIA,1011,8243.43,14165,967,903,670,420,396,816,1486,2389,3356,171.84,40.71,28.98,18.03
26-08-2021,NELAS,10,1,77,"[0,120]",Baixo a Moderado,,,,10,Centro,VISEU,1809,12571.48,12974,924,787,668,604,583,1187,1855,2642,3566,103.21,28.37,21.02,14.76
26-08-2021,NISA,5,0,84,"[0,120]",Baixo a Moderado,,,,5,Alentejo,PORTALEGRE,1212,57567.84,6061,405,389,355,483,478,961,1316,1705,2110,10.53,3.67,2.96,2.29
26-08-2021,NORDESTE,1,0,21,"[0,120]",Baixo a Moderado,,,,1,Açores,AÇORES,4202,10146.8,4862,246,180,124,161,162,323,447,627,873,47.92,8.6,6.18,4.41
26-08-2021,ÓBIDOS,24,2,200,"[120,240]",Moderado,,,,24,Lisboa e Vale do Tejo,LEIRIA,1012,14155.44,11850,743,650,574,452,436,888,1462,2112,2855,83.72,20.17,14.92,10.33
26-08-2021,ODEMIRA,67,5,272,"[240,480]",Elevado,,,,67,Alentejo,BEJA,0211,172060.15,24717,1475,1317,1225,1397,1349,2746,3971,5288,6763,14.37,3.93,3.07,2.31
26-08-2021,ODIVELAS,374,27,231,"[120,240]",Moderado,,,,374,Lisboa e Vale do Tejo,LISBOA,1116,2654.36,161774,9562,9038,6952,4641,3812,8453,15405,24443,34005,6095.48,1281.27,920.99,580.44
26-08-2021,OEIRAS,585,42,330,"[240,480]",Elevado,,,,585,Lisboa e Vale do Tejo,LISBOA,1110,4588.31,177408,11580,11575,8566,6211,5855,12066,20632,32207,43787,3866.78,954.38,701.98,449.69
26-08-2021,OLEIROS,1,0,20,"[0,120]",Baixo a Moderado,,,,1,Centro,CASTELO BRANCO,0506,47109.31,5003,384,341,366,397,487,884,1250,1591,1975,10.62,4.19,3.38,2.65
26-08-2021,OLHÃO,165,12,371,"[240,480]",Elevado,,,,165,Algarve,FARO,0810,13086.38,44405,2455,2309,1689,1342,1268,2610,4299,6608,9063,339.33,69.26,50.5,32.85
26-08-2021,OLIVEIRA DE AZEMÉIS,178,13,269,"[240,480]",Elevado,,,,178,Norte,AVEIRO,0113,16110.41,66011,4155,3614,2794,2183,1738,3921,6715,10329,14484,409.75,89.91,64.12,41.68
26-08-2021,OLIVEIRA DE FRADES,18,1,180,"[120,240]",Moderado,,,,18,Centro,VISEU,1810,14534.62,9936,553,475,438,359,415,774,1212,1687,2240,68.36,15.41,11.61,8.34
26-08-2021,OLIVEIRA DO BAIRRO,18,1,73,"[0,120]",Baixo a Moderado,,,,18,Centro,AVEIRO,0114,8731.99,24277,1327,1182,999,786,810,1596,2595,3777,5104,278.02,58.45,43.25,29.72
26-08-2021,OLIVEIRA DO HOSPITAL,48,3,249,"[240,480]",Elevado,,,,48,Centro,COIMBRA,0611,23451.66,19253,1161,1097,962,924,960,1884,2846,3943,5104,82.1,21.76,16.81,12.14
26-08-2021,OURÉM,133,10,302,"[240,480]",Elevado,,,,133,Lisboa e Vale do Tejo,SANTARÉM,1421,41668.03,44044,2463,2069,1899,1817,1603,3420,5319,7388,9851,105.7,23.64,17.73,12.77
26-08-2021,OURIQUE,9,1,198,"[120,240]",Moderado,,,,9,Alentejo,BEJA,0212,66331.36,4607,313,287,284,268,227,495,779,1066,1379,6.95,2.08,1.61,1.17
26-08-2021,OVAR,97,7,178,"[120,240]",Moderado,,,,97,Centro,AVEIRO,0115,14770.25,54260,3294,2709,1994,1636,1234,2870,4864,7573,10867,367.37,73.57,51.27,32.93
26-08-2021,PAÇOS DE FERREIRA,98,7,173,"[120,240]",Moderado,,,,98,Norte,PORTO,1309,7099.29,56728,2903,2193,1518,1135,664,1799,3317,5510,8413,799.1,118.51,77.62,46.72
26-08-2021,PALMELA,107,8,167,"[120,240]",Moderado,,,,107,Lisboa e Vale do Tejo,SETÚBAL,1508,46512.01,64269,3402,3244,2635,1846,1391,3237,5872,9116,12518,138.18,26.91,19.6,12.62
26-08-2021,PAMPILHOSA DA SERRA,9,1,223,"[120,240]",Moderado,,,,9,Centro,COIMBRA,0612,39646.24,4037,238,254,295,339,423,762,1057,1311,1549,10.18,3.91,3.31,2.67
26-08-2021,PAREDES,251,18,292,"[240,480]",Elevado,,,,251,Norte,PORTO,1310,15675.69,86067,4272,3532,2412,1717,1258,2975,5387,8919,13191,549.04,84.15,56.9,34.36
26-08-2021,PAREDES DE COURA,12,1,142,"[120,240]",Moderado,,,,12,Norte,VIANA DO CASTELO,1605,13818.59,8535,466,528,407,465,515,980,1387,1915,2381,61.76,17.23,13.86,10.04
26-08-2021,PEDRÓGÃO GRANDE,1,0,29,"[0,120]",Baixo a Moderado,,,,1,Centro,LEIRIA,1013,12874.75,3410,175,173,196,221,252,473,669,842,1017,26.49,7.9,6.54,5.2
26-08-2021,PENACOVA,26,2,191,"[120,240]",Moderado,,,,26,Centro,COIMBRA,0613,21673.23,13694,968,923,745,621,703,1324,2069,2992,3960,63.18,18.27,13.81,9.55
26-08-2021,PENAFIEL,240,17,344,"[240,480]",Elevado,,,,240,Norte,PORTO,1311,21224.27,69772,3648,2823,2032,1663,1230,2893,4925,7748,11396,328.74,53.69,36.51,23.2
26-08-2021,PENALVA DO CASTELO,20,1,280,"[240,480]",Elevado,,,,20,Centro,VISEU,1811,13433.92,7115,449,457,413,391,426,817,1230,1687,2136,52.96,15.9,12.56,9.16
26-08-2021,PENAMACOR,5,0,106,"[0,120]",Baixo a Moderado,,,,5,Centro,CASTELO BRANCO,0507,56370.69,4755,262,248,273,451,633,1084,1357,1605,1867,8.44,3.31,2.85,2.41
26-08-2021,PENEDONO,0,0,0,"[0,120]",Baixo a Moderado,,,,0,Norte,VISEU,1812,13370.75,2591,172,113,129,156,138,294,423,536,708,19.38,5.3,4.01,3.16
26-08-2021,PENELA,18,1,334,"[240,480]",Elevado,,,,18,Centro,COIMBRA,0614,13480.0,5397,314,324,274,359,344,703,977,1301,1615,40.04,11.98,9.65,7.25
26-08-2021,PENICHE,90,6,341,"[240,480]",Elevado,,,,90,Lisboa e Vale do Tejo,LEIRIA,1014,7754.98,26501,1746,1504,1203,926,707,1633,2836,4340,6086,341.73,78.48,55.96,36.57
26-08-2021,PESO DA RÉGUA,25,2,159,"[120,240]",Moderado,,,,25,Norte,VILA REAL,1708,9486.01,15773,1076,843,650,659,455,1114,1764,2607,3683,166.28,38.83,27.48,18.6
26-08-2021,PINHEL,8,1,95,"[0,120]",Baixo a Moderado,,,,8,Centro,GUARDA,0910,48452.12,8511,577,566,551,538,689,1227,1778,2344,2921,17.57,6.03,4.84,3.67
26-08-2021,POMBAL,220,16,428,"[240,480]",Elevado,,,,220,Centro,LEIRIA,1015,62600.28,51461,3187,2791,2494,2328,2027,4355,6849,9640,12827,82.21,20.49,15.4,10.94
26-08-2021,PONTA DELGADA,173,12,255,"[240,480]",Elevado,,,,173,Açores,AÇORES,4203,23298.65,67935,3108,2435,1726,1133,902,2035,3761,6196,9304,291.58,39.93,26.59,16.14
26-08-2021,PONTA DO SOL,18,1,210,"[120,240]",Moderado,,,,18,Madeira,MADEIRA,3105,4622.03,8593,319,283,347,208,221,429,776,1059,1378,185.92,29.81,22.91,16.79
26-08-2021,PONTE DA BARCA,26,2,234,"[120,240]",Moderado,,,,26,Norte,VIANA DO CASTELO,1606,18211.37,11180,635,576,517,554,490,1044,1561,2137,2772,61.39,15.22,11.73,8.57
26-08-2021,PONTE DE LIMA,70,5,170,"[120,240]",Moderado,,,,70,Norte,VIANA DO CASTELO,1607,32025.46,41315,2321,2022,1720,1596,1462,3058,4778,6800,9121,129.01,28.48,21.23,14.92
26-08-2021,PONTE DE SOR,59,4,391,"[240,480]",Elevado,,,,59,Alentejo,PORTALEGRE,1213,83971.16,14994,939,800,716,739,831,1570,2286,3086,4025,17.86,4.79,3.68,2.72
26-08-2021,PORTALEGRE,41,3,183,"[120,240]",Moderado,,,,41,Alentejo,PORTALEGRE,1214,44713.64,22172,1577,1351,1137,993,984,1977,3114,4465,6042,49.59,13.51,9.99,6.96
26-08-2021,PORTEL,35,3,606,"[480,960]",Muito Elevado,,,,35,Alentejo,ÉVORA,0709,60100.57,5828,336,358,283,331,305,636,919,1277,1613,9.7,2.68,2.12,1.53
26-08-2021,PORTIMÃO,494,35,890,"[480,960]",Muito Elevado,,,,494,Algarve,FARO,0811,18206.29,55483,3182,2927,2116,1582,1400,2982,5098,8025,11207,304.75,61.56,44.08,28.0
26-08-2021,PORTO,843,60,389,"[240,480]",Elevado,,,,843,Norte,PORTO,1312,4142.02,216606,15790,15193,11280,9409,10044,19453,30733,45926,61716,5229.5,1490.0,1108.79,741.98
26-08-2021,PORTO DE MÓS,65,5,279,"[240,480]",Elevado,,,,65,Centro,LEIRIA,1016,26183.41,23275,1355,1210,1034,888,872,1760,2794,4004,5359,88.89,20.47,15.29,10.67
26-08-2021,PORTO MONIZ,0,0,0,"[0,120]",Baixo a Moderado,,,,0,Madeira,MADEIRA,3106,8293.38,2342,143,130,95,98,120,218,313,443,586,28.24,7.07,5.34,3.77
26-08-2021,PORTO SANTO,21,2,404,"[240,480]",Elevado,,,,21,Madeira,MADEIRA,3201,4300.7,5202,240,157,134,110,68,178,312,469,709,120.95,16.48,10.9,7.25
26-08-2021,PÓVOA DE LANHOSO,99,7,461,"[240,480]",Elevado,,,,99,Norte,BRAGA,0309,13465.29,21499,1175,909,732,673,624,1297,2029,2938,4113,159.67,30.55,21.82,15.07
26-08-2021,PÓVOA DE VARZIM,263,19,419,"[240,480]",Elevado,,,,263,Norte,PORTO,1313,8220.59,62784,3712,3120,2134,1594,1305,2899,5033,8153,11865,763.7,144.33,99.17,61.22
26-08-2021,POVOAÇÃO,10,1,170,"[120,240]",Moderado,,,,10,Açores,AÇORES,4204,10640.77,5927,293,212,191,144,134,278,469,681,974,55.7,9.15,6.4,4.41
26-08-2021,VILA DA PRAIA DA VITÓRIA,7,1,33,"[0,120]",Baixo a Moderado,,,,7,Açores,AÇORES,4302,16127.06,21317,1133,789,619,436,336,772,1391,2180,3313,132.18,20.54,13.52,8.63
26-08-2021,PROENÇA-A-NOVA,15,1,207,"[120,240]",Moderado,,,,15,Centro,CASTELO BRANCO,0508,39539.96,7298,508,465,389,400,560,960,1349,1814,2322,18.46,5.87,4.59,3.41
26-08-2021,REDONDO,16,1,255,"[240,480]",Elevado,,,,16,Alentejo,ÉVORA,0710,36950.87,6353,349,325,288,288,354,642,930,1255,1604,17.19,4.34,3.4,2.52
26-08-2021,REGUENGOS DE MONSARAZ,36,3,363,"[240,480]",Elevado,,,,36,Alentejo,ÉVORA,0711,46399.72,10015,602,511,455,462,473,935,1390,1901,2503,21.58,5.39,4.1,3.0
26-08-2021,RESENDE,45,3,439,"[240,480]",Elevado,,,,45,Norte,VISEU,1813,12334.93,10137,560,493,448,433,422,855,1303,1796,2356,82.18,19.1,14.56,10.56
26-08-2021,RIBEIRA BRAVA,10,1,81,"[0,120]",Baixo a Moderado,,,,10,Madeira,MADEIRA,3107,6544.88,12435,648,500,411,311,287,598,1009,1509,2157,189.99,32.96,23.06,15.42
26-08-2021,RIBEIRA DE PENA,73,5,1219,"[960,Max]",Extremamente Elevado,,,,73,Norte,VILA REAL,1709,21745.98,6016,371,301,290,310,368,678,968,1269,1640,27.66,7.54,5.84,4.45
26-08-2021,RIBEIRA GRANDE,99,7,302,"[240,480]",Elevado,,,,99,Açores,AÇORES,4205,18015.13,32811,1163,689,512,345,253,598,1110,1799,2962,182.13,16.44,9.99,6.16
26-08-2021,RIO MAIOR,35,3,173,"[120,240]",Moderado,,,,35,Lisboa e Vale do Tejo,SANTARÉM,1414,27276.45,20379,1251,1144,941,795,648,1443,2384,3528,4779,74.71,17.52,12.93,8.74
26-08-2021,SABROSA,32,2,544,"[480,960]",Muito Elevado,,,,32,Norte,VILA REAL,1710,15692.45,5918,393,314,304,302,350,652,956,1270,1663,37.71,10.6,8.09,6.09
26-08-2021,SABUGAL,19,1,181,"[120,240]",Moderado,,,,19,Centro,GUARDA,0911,82269.82,10585,724,707,694,796,1009,1805,2499,3206,3930,12.87,4.78,3.9,3.04
26-08-2021,SALVATERRA DE MAGOS,45,3,212,"[120,240]",Moderado,,,,45,Lisboa e Vale do Tejo,SANTARÉM,1415,24393.2,21295,1275,1181,1060,799,772,1571,2631,3812,5087,87.3,20.85,15.63,10.79
26-08-2021,SANTA COMBA DÃO,15,1,144,"[120,240]",Moderado,,,,15,Centro,VISEU,1814,11194.77,10452,732,684,569,538,464,1002,1571,2255,2987,93.36,26.68,20.14,14.03
26-08-2021,SANTA CRUZ,69,5,153,"[120,240]",Moderado,,,,69,Madeira,MADEIRA,3108,8150.28,45281,1817,1301,974,716,523,1239,2213,3514,5331,555.6,65.41,43.12,27.15
26-08-2021,SANTA CRUZ DA GRACIOSA,14,1,335,"[240,480]",Elevado,,,,14,Açores,AÇORES,4401,6065.78,4208,228,180,163,124,145,269,432,612,840,69.37,13.85,10.09,7.12
26-08-2021,SANTA CRUZ DAS FLORES,0,0,0,"[0,120]",Baixo a Moderado,,,,0,Açores,AÇORES,4802,7091.44,2165,125,98,74,56,51,107,181,279,404,30.53,5.7,3.93,2.55
26-08-2021,SANTA MARIA DA FEIRA,265,19,191,"[120,240]",Moderado,,,,265,Norte,AVEIRO,0109,21587.65,138636,8182,6743,4771,3856,3079,6935,11706,18449,26631,642.19,123.36,85.46,54.22
26-08-2021,SANTA MARTA DE PENAGUIÃO,29,2,442,"[240,480]",Elevado,,,,29,Norte,VILA REAL,1711,6928.13,6599,483,373,337,316,317,633,970,1343,1826,95.25,26.36,19.39,14.0
26-08-2021,SANTANA,27,2,406,"[240,480]",Elevado,,,,27,Madeira,MADEIRA,3109,9547.3,6711,418,353,343,282,277,559,902,1255,1673,70.29,17.52,13.15,9.45
26-08-2021,SANTARÉM,107,8,187,"[120,240]",Moderado,,,,107,Lisboa e Vale do Tejo,SANTARÉM,1416,55253.58,57421,3654,3441,2760,2466,2206,4672,7432,10873,14527,103.92,26.29,19.68,13.45
26-08-2021,SANTIAGO DO CACÉM,68,5,237,"[120,240]",Moderado,,,,68,Alentejo,SETÚBAL,1509,105969.29,28791,2144,1689,1472,1295,1215,2510,3982,5671,7815,27.17,7.37,5.35,3.76
26-08-2021,SANTO TIRSO,138,10,203,"[120,240]",Moderado,,,,138,Norte,PORTO,1314,13655.52,68055,4911,3935,2761,2257,1810,4067,6828,10763,15674,498.35,114.78,78.82,50.0
26-08-2021,SÃO BRÁS DE ALPORTEL,59,4,569,"[480,960]",Muito Elevado,,,,59,Algarve,FARO,0812,15336.92,10416,596,468,467,404,401,805,1272,1740,2336,67.91,15.23,11.35,8.29
26-08-2021,SÃO JOÃO DA MADEIRA,90,6,412,"[240,480]",Elevado,,,,90,Norte,AVEIRO,0116,794.3,21958,1347,1069,796,601,593,1194,1990,3059,4406,2765.49,554.91,385.26,250.63
26-08-2021,SÃO JOÃO DA PESQUEIRA,4,0,57,"[0,120]",Baixo a Moderado,,,,4,Norte,VISEU,1815,26610.85,7125,417,330,294,328,328,656,950,1280,1697,26.77,6.38,4.81,3.57
26-08-2021,SÃO PEDRO DO SUL,45,3,292,"[240,480]",Elevado,,,,45,Centro,VISEU,1816,34895.09,15403,990,962,861,759,909,1668,2529,3491,4481,44.14,12.84,10.0,7.25
26-08-2021,SÃO ROQUE DO PICO,1,0,31,"[0,120]",Baixo a Moderado,,,,1,Açores,AÇORES,4603,14236.1,3266,199,141,93,96,113,209,302,443,642,22.94,4.51,3.11,2.12
26-08-2021,SÃO VICENTE,5,0,98,"[0,120]",Baixo a Moderado,,,,5,Madeira,MADEIRA,3110,7883.71,5143,272,264,266,225,280,505,771,1035,1307,65.23,16.58,13.13,9.78
26-08-2021,SARDOAL,6,0,161,"[120,240]",Moderado,,,,6,Lisboa e Vale do Tejo,SANTARÉM,1417,9214.72,3741,227,178,148,165,248,413,561,739,966,40.6,10.48,8.02,6.09
26-08-2021,SÁTÃO,15,1,129,"[120,240]",Moderado,,,,15,Centro,VISEU,1817,20194.11,11580,765,671,515,465,476,941,1456,2127,2892,57.34,14.32,10.53,7.21
26-08-2021,SEIA,26,2,117,"[0,120]",Baixo a Moderado,,,,26,Centro,GUARDA,0912,43568.83,22234,1807,1589,1238,1122,721,1843,3081,4670,6477,51.03,14.87,10.72,7.07
26-08-2021,SEIXAL,367,26,219,"[120,240]",Moderado,,,,367,Lisboa e Vale do Tejo,SETÚBAL,1510,9545.17,167752,10586,9270,6661,4391,2930,7321,13982,23252,33838,1757.49,354.51,243.6,146.49
26-08-2021,SERNANCELHE,6,0,112,"[0,120]",Baixo a Moderado,,,,6,Norte,VISEU,1818,22861.22,5396,305,293,286,273,260,533,819,1112,1417,23.6,6.2,4.86,3.58
26-08-2021,SERPA,37,3,261,"[240,480]",Elevado,,,,37,Alentejo,BEJA,0213,110563.34,14304,903,761,719,697,626,1323,2042,2803,3706,12.94,3.35,2.54,1.85
26-08-2021,SERTÃ,3,0,21,"[0,120]",Baixo a Moderado,,,,3,Centro,CASTELO BRANCO,0509,44673.17,14577,870,779,790,767,1020,1787,2577,3356,4226,32.63,9.46,7.51,5.77
26-08-2021,SESIMBRA,141,10,271,"[240,480]",Elevado,,,,141,Lisboa e Vale do Tejo,SETÚBAL,1511,19571.75,51858,2400,2321,1853,1257,1083,2340,4193,6514,8914,264.96,45.54,33.28,21.42
26-08-2021,SETÚBAL,258,18,224,"[120,240]",Moderado,,,,258,Lisboa e Vale do Tejo,SETÚBAL,1512,23032.5,115126,7425,6929,5075,3775,2655,6430,11505,18434,25859,499.83,112.27,80.03,49.95
26-08-2021,SEVER DO VOUGA,12,1,106,"[0,120]",Baixo a Moderado,,,,12,Centro,AVEIRO,0117,12987.56,11331,766,637,568,540,567,1107,1675,2312,3078,87.24,23.7,17.8,12.9
26-08-2021,SILVES,140,10,386,"[240,480]",Elevado,,,,140,Algarve,FARO,0813,68006.23,36226,2137,1869,1610,1423,1600,3023,4633,6502,8639,53.27,12.7,9.56,6.81
26-08-2021,SINES,73,5,533,"[480,960]",Muito Elevado,,,,73,Alentejo,SETÚBAL,1513,20330.17,13715,888,791,551,416,268,684,1235,2026,2914,67.46,14.33,9.97,6.07
26-08-2021,SINTRA,982,70,251,"[240,480]",Elevado,,,,982,Lisboa e Vale do Tejo,LISBOA,1111,31922.73,391402,20490,18316,13545,9137,7284,16421,29966,48282,68772,1226.08,215.43,151.25,93.87
26-08-2021,SOBRAL DE MONTE AGRAÇO,27,2,249,"[240,480]",Elevado,,,,27,Lisboa e Vale do Tejo,LISBOA,1112,5210.32,10651,564,507,352,272,212,484,836,1343,1907,204.43,36.6,25.78,16.05
26-08-2021,SOURE,32,2,188,"[120,240]",Moderado,,,,32,Centro,COIMBRA,0615,26506.07,17120,1173,1142,1004,883,987,1870,2874,4016,5189,64.59,19.58,15.15,10.84
26-08-2021,SOUSEL,26,2,578,"[480,960]",Muito Elevado,,,,26,Alentejo,PORTALEGRE,1215,27932.18,4412,261,274,208,302,292,594,802,1076,1337,15.8,4.79,3.85,2.87
26-08-2021,TÁBUA,53,4,464,"[240,480]",Elevado,,,,53,Centro,COIMBRA,0616,19978.58,11368,729,584,524,430,464,894,1418,2002,2731,56.9,13.67,10.02,7.1
26-08-2021,TABUAÇO,3,0,50,"[0,120]",Baixo a Moderado,,,,3,Norte,VISEU,1819,13385.67,6033,372,314,217,282,363,645,862,1176,1548,45.07,11.56,8.79,6.44
26-08-2021,TAROUCA,12,1,153,"[120,240]",Moderado,,,,12,Norte,VISEU,1820,10008.49,7804,405,335,313,277,324,601,914,1249,1654,77.98,16.53,12.48,9.13
26-08-2021,TAVIRA,89,6,362,"[240,480]",Elevado,,,,89,Algarve,FARO,0814,60696.7,24530,1493,1415,1252,1066,1277,2343,3595,5010,6503,40.41,10.71,8.25,5.92
26-08-2021,TERRAS DE BOURO,18,1,285,"[240,480]",Elevado,,,,18,Norte,BRAGA,0310,27746.07,6361,391,372,296,319,340,659,955,1327,1718,22.93,6.19,4.78,3.44
26-08-2021,TOMAR,55,4,150,"[120,240]",Moderado,,,,55,Lisboa e Vale do Tejo,SANTARÉM,1418,35120.44,36748,2403,2189,1868,1853,1822,3675,5543,7732,10135,104.64,28.86,22.02,15.78
26-08-2021,TONDELA,49,4,186,"[120,240]",Moderado,,,,49,Centro,VISEU,1821,37121.73,26357,1768,1722,1518,1475,1417,2892,4410,6132,7900,71.0,21.28,16.52,11.88
26-08-2021,TORRE DE MONCORVO,10,1,131,"[120,240]",Moderado,,,,10,Norte,BRAGANÇA,0409,53155.67,7695,556,478,488,551,719,1270,1758,2236,2792,14.48,5.25,4.21,3.31
26-08-2021,TORRES NOVAS,82,6,236,"[120,240]",Moderado,,,,82,Lisboa e Vale do Tejo,SANTARÉM,1419,26999.68,34933,2324,1979,1738,1406,1475,2881,4619,6598,8922,129.38,33.04,24.44,17.11
26-08-2021,TORRES VEDRAS,148,11,189,"[120,240]",Moderado,,,,148,Lisboa e Vale do Tejo,LISBOA,1113,40714.89,78530,4513,3945,3447,2628,2104,4732,8179,12124,16637,192.88,40.86,29.78,20.09
26-08-2021,TRANCOSO,8,1,90,"[0,120]",Baixo a Moderado,,,,8,Centro,GUARDA,0913,36152.47,8875,581,557,542,586,496,1082,1624,2181,2762,24.55,7.64,6.03,4.49
26-08-2021,TROFA,93,7,242,"[240,480]",Elevado,,,,93,Norte,PORTO,1318,7201.76,38418,2336,1894,1231,939,684,1623,2854,4748,7084,533.44,98.36,65.93,39.63
26-08-2021,VAGOS,33,2,144,"[120,240]",Moderado,,,,33,Centro,AVEIRO,0118,16491.5,22740,1320,1205,922,784,724,1508,2430,3635,4955,137.89,30.04,22.04,14.73
26-08-2021,VALE DE CAMBRA,103,7,481,"[480,960]",Muito Elevado,,,,103,Norte,AVEIRO,0119,14733.47,21327,1491,1363,1005,831,798,1629,2634,3997,5488,144.76,37.25,27.13,17.88
26-08-2021,VALENÇA,44,3,334,"[240,480]",Elevado,,,,44,Norte,VIANA DO CASTELO,1608,11712.86,13290,867,791,582,582,503,1085,1667,2458,3325,113.46,28.39,20.99,14.23
26-08-2021,VALONGO,198,14,203,"[120,240]",Moderado,,,,198,Norte,PORTO,1315,7512.45,97444,5629,4696,3207,2462,1829,4291,7498,12194,17823,1297.18,237.26,162.33,99.81
26-08-2021,VALPAÇOS,38,3,259,"[240,480]",Elevado,,,,38,Norte,VILA REAL,1712,54873.93,14818,1217,1118,999,928,997,1925,2924,4042,5259,27.0,9.58,7.37,5.33
26-08-2021,VELAS,12,1,237,"[120,240]",Moderado,,,,12,Açores,AÇORES,4502,11738.38,5093,278,208,166,153,113,266,432,640,918,43.39,7.82,5.45,3.68
26-08-2021,VENDAS NOVAS,14,1,125,"[120,240]",Moderado,,,,14,Alentejo,ÉVORA,0712,22238.88,11255,677,768,655,501,532,1033,1688,2456,3133,50.61,14.09,11.04,7.59
26-08-2021,VIANA DO ALENTEJO,12,1,235,"[120,240]",Moderado,,,,12,Alentejo,ÉVORA,0713,39367.29,5145,245,208,235,210,214,424,659,867,1112,13.07,2.82,2.2,1.67
26-08-2021,VIANA DO CASTELO,189,14,224,"[120,240]",Moderado,,,,189,Norte,VIANA DO CASTELO,1609,31902.01,84417,5470,4433,3591,3061,2982,6043,9634,14067,19537,264.61,61.24,44.09,30.2
26-08-2021,VIDIGUEIRA,13,1,237,"[120,240]",Moderado,,,,13,Alentejo,BEJA,0214,31661.09,5510,300,248,215,233,275,508,723,971,1271,17.4,4.01,3.07,2.28
26-08-2021,VIEIRA DO MINHO,37,3,314,"[240,480]",Elevado,,,,37,Norte,BRAGA,0311,21644.35,11842,703,594,525,548,482,1030,1555,2149,2852,54.71,13.18,9.93,7.18
26-08-2021,VILA DE REI,4,0,120,"[120,240]",Moderado,,,,4,Centro,CASTELO BRANCO,0510,19154.6,3323,169,128,172,247,302,549,721,849,1018,17.35,5.31,4.43,3.76
26-08-2021,VILA DO BISPO,47,3,913,"[480,960]",Muito Elevado,,,,47,Algarve,FARO,0815,17906.06,5154,302,302,314,232,233,465,779,1081,1383,28.78,7.72,6.04,4.35
26-08-2021,VILA DO CONDE,226,16,283,"[240,480]",Elevado,,,,226,Norte,PORTO,1316,14902.77,79899,4726,3875,2819,2070,1743,3813,6632,10507,15233,536.13,102.21,70.5,44.5
26-08-2021,VILA DO PORTO,4,0,71,"[0,120]",Baixo a Moderado,,,,4,Açores,AÇORES,4101,9688.74,5616,274,212,135,96,123,219,354,566,840,57.96,8.67,5.84,3.65
26-08-2021,VILA FLOR,11,1,183,"[120,240]",Moderado,,,,11,Norte,BRAGANÇA,0410,26581.14,6044,429,362,422,294,331,625,1047,1409,1838,22.74,6.91,5.3,3.94
26-08-2021,VILA FRANCA DE XIRA,336,24,237,"[120,240]",Moderado,,,,336,Lisboa e Vale do Tejo,LISBOA,1114,31819.39,141957,8501,6852,4869,3425,2472,5897,10766,17618,26119,446.14,82.09,55.37,33.84
26-08-2021,VILA FRANCA DO CAMPO,17,1,155,"[120,240]",Moderado,,,,17,Açores,AÇORES,4206,7796.82,11051,450,344,248,217,154,371,619,963,1413,141.73,18.12,12.35,7.94
26-08-2021,VILA NOVA DA BARQUINHA,7,0,93,"[0,120]",Baixo a Moderado,,,,7,Lisboa e Vale do Tejo,SANTARÉM,1420,4952.97,7461,415,406,392,364,338,702,1094,1500,1915,150.64,38.66,30.28,22.09
26-08-2021,VILA NOVA DE CERVEIRA,39,3,438,"[240,480]",Elevado,,,,39,Norte,VIANA DO CASTELO,1610,10846.66,8910,531,444,410,384,334,718,1128,1572,2103,82.14,19.39,14.49,10.4
26-08-2021,VILA NOVA DE FAMALICÃO,517,37,393,"[240,480]",Elevado,,,,517,Norte,BRAGA,0312,20159.26,131676,7817,6164,4202,3282,2749,6031,10233,16397,24214,653.19,120.12,81.34,50.76
26-08-2021,VILA NOVA DE FOZ CÔA,5,0,78,"[0,120]",Baixo a Moderado,,,,5,Centro,GUARDA,0914,39815.18,6503,442,385,390,398,429,827,1217,1602,2044,16.33,5.13,4.02,3.06
26-08-2021,VILA NOVA DE GAIA,655,47,218,"[120,240]",Moderado,,,,655,Norte,PORTO,1317,16846.43,300472,18349,15568,10972,8224,6281,14505,25477,41045,59394,1783.64,352.57,243.65,151.23
26-08-2021,VILA NOVA DE PAIVA,8,1,171,"[120,240]",Moderado,,,,8,Centro,VISEU,1822,17553.28,4687,289,272,233,217,241,458,691,963,1252,26.7,7.13,5.49,3.94
26-08-2021,VILA NOVA DE POIARES,29,2,417,"[240,480]",Elevado,,,,29,Centro,COIMBRA,0617,8445.3,6939,380,284,262,235,182,417,679,963,1343,82.17,15.9,11.4,8.04
26-08-2021,VILA POUCA DE AGUIAR,101,7,843,"[480,960]",Muito Elevado,,,,101,Norte,VILA REAL,1713,43706.62,11961,860,817,733,601,627,1228,1961,2778,3638,27.37,8.32,6.36,4.49
26-08-2021,VILA REAL,160,11,321,"[240,480]",Elevado,,,,160,Norte,VILA REAL,1714,37880.28,49962,3025,2498,2065,1579,1466,3045,5110,7608,10633,131.9,28.07,20.08,13.49
26-08-2021,VILA REAL DE SANTO ANTÓNIO,46,3,247,"[240,480]",Elevado,,,,46,Algarve,FARO,0816,6125.0,18749,1172,1069,811,569,586,1155,1966,3035,4207,306.11,68.69,49.55,32.1
26-08-2021,VILA VELHA DE RÓDÃO,7,1,223,"[120,240]",Moderado,,,,7,Centro,CASTELO BRANCO,0511,32991.16,3144,209,229,180,283,306,589,769,998,1207,9.53,3.66,3.03,2.33
26-08-2021,VILA VERDE,294,21,626,"[480,960]",Muito Elevado,,,,294,Norte,BRAGA,0313,22866.52,46911,2365,2063,1667,1494,1437,2931,4598,6661,9026,205.15,39.47,29.13,20.11
26-08-2021,VILA VIÇOSA,27,2,357,"[240,480]",Elevado,,,,27,Alentejo,ÉVORA,0714,19485.89,7656,487,379,342,345,324,669,1011,1390,1877,39.29,9.63,7.13,5.19
26-08-2021,VIMIOSO,8,1,202,"[120,240]",Moderado,,,,8,Norte,BRAGANÇA,0411,48158.51,4023,274,230,261,293,335,628,889,1119,1393,8.35,2.89,2.32,1.85
26-08-2021,VINHAIS,3,0,39,"[0,120]",Baixo a Moderado,,,,3,Norte,BRAGANÇA,0412,69475.09,7746,599,577,636,641,815,1456,2092,2669,3268,11.15,4.7,3.84,3.01
26-08-2021,VISEU,424,30,436,"[240,480]",Elevado,,,,424,Centro,VISEU,1823,50710.14,97249,5769,5038,4140,3158,2710,5868,10008,15046,20815,191.77,41.05,29.67,19.74
26-08-2021,VIZELA,86,6,360,"[240,480]",Elevado,,,,86,Norte,BRAGA,0314,2469.83,23897,1258,928,655,509,371,880,1535,2463,3721,967.49,150.65,99.72,62.15
26-08-2021,VOUZELA,6,0,62,"[0,120]",Baixo a Moderado,,,,6,Centro,VISEU,1824,19369.46,9619,626,605,554,532,507,1039,1593,2198,2824,49.66,14.58,11.35,8.22
02-09-2021,ABRANTES,43,3,123,"[120,240]",Moderado,,,,43,Lisboa e Vale do Tejo,SANTARÉM,1401,71469.08,35130,2473,2213,1730,1748,2021,3769,5499,7712,10185,49.15,14.25,10.79,7.69
02-09-2021,ÁGUEDA,91,7,198,"[120,240]",Moderado,,,,91,Centro,AVEIRO,0101,33527.44,46075,3237,2713,2090,1635,1496,3131,5221,7934,11171,137.43,33.32,23.66,15.57
02-09-2021,AGUIAR DA BEIRA,6,0,129,"[120,240]",Moderado,,,,6,Centro,GUARDA,0901,20676.57,4652,304,281,235,239,148,387,622,903,1207,22.5,5.84,4.37,3.01
02-09-2021,ALANDROAL,2,0,41,"[0,120]",Baixo a Moderado,,,,2,Alentejo,ÉVORA,0701,54267.81,4992,307,256,296,299,377,676,972,1228,1535,9.2,2.83,2.26,1.79
02-09-2021,ALBERGARIA-A-VELHA,40,3,165,"[120,240]",Moderado,,,,40,Centro,AVEIRO,0102,15882.5,24144,1550,1298,996,687,680,1367,2363,3661,5211,152.02,32.81,23.05,14.88
02-09-2021,ALBUFEIRA,468,33,1128,"[960,Max]",Extremamente Elevado,,,,468,Algarve,FARO,0801,14066.42,41528,2067,1717,1425,985,858,1843,3268,4985,7052,295.24,50.14,35.44,23.23
02-09-2021,ALCÁCER DO SAL,15,1,130,"[120,240]",Moderado,,,,15,Alentejo,SETÚBAL,1501,149987.3,11659,884,814,623,623,602,1225,1848,2662,3546,7.77,2.36,1.77,1.23
02-09-2021,ALCANENA,58,4,451,"[240,480]",Elevado,,,,58,Lisboa e Vale do Tejo,SANTARÉM,1402,12732.86,12809,891,744,628,536,588,1124,1752,2496,3387,100.6,26.6,19.6,13.76
02-09-2021,ALCOBAÇA,127,9,238,"[120,240]",Moderado,,,,127,Lisboa e Vale do Tejo,LEIRIA,1001,40814.09,53555,3420,2927,2466,2059,1676,3735,6201,9128,12548,131.22,30.74,22.36,15.19
02-09-2021,ALCOCHETE,45,3,226,"[120,240]",Moderado,,,,45,Lisboa e Vale do Tejo,SETÚBAL,1502,12836.48,19787,857,834,691,476,447,923,1614,2448,3305,154.15,25.75,19.07,12.57
02-09-2021,ALCOUTIM,3,0,144,"[120,240]",Moderado,,,,3,Algarve,FARO,0802,57536.33,2159,191,188,163,190,267,457,620,808,999,3.75,1.74,1.4,1.08
02-09-2021,ALENQUER,69,5,157,"[120,240]",Moderado,,,,69,Lisboa e Vale do Tejo,LISBOA,1101,30421.92,44052,2298,2062,1629,1330,1155,2485,4114,6176,8474,144.8,27.85,20.3,13.52
02-09-2021,ALFÂNDEGA DA FÉ,2,0,45,"[0,120]",Baixo a Moderado,,,,2,Norte,BRAGANÇA,0401,32194.64,4550,325,277,301,274,325,599,900,1177,1502,14.13,4.67,3.66,2.8
02-09-2021,ALIJÓ,20,1,190,"[120,240]",Moderado,,,,20,Norte,VILA REAL,1701,29759.89,10625,766,687,635,542,666,1208,1843,2530,3296,35.7,11.08,8.5,6.19
02-09-2021,ALJEZUR,8,1,143,"[120,240]",Moderado,,,,8,Algarve,FARO,0803,32349.95,5594,316,336,335,320,410,730,1065,1401,1717,17.29,5.31,4.33,3.29
02-09-2021,ALJUSTREL,24,2,295,"[240,480]",Elevado,,,,24,Alentejo,BEJA,0201,45847.41,8247,635,521,443,347,358,705,1148,1669,2304,17.99,5.03,3.64,2.5
02-09-2021,ALMADA,509,36,301,"[240,480]",Elevado,,,,509,Lisboa e Vale do Tejo,SETÚBAL,1503,7000.89,169039,10469,9777,7876,6144,5111,11255,19131,28908,39377,2414.5,562.45,412.91,273.26
02-09-2021,ALMEIDA,16,1,277,"[240,480]",Elevado,,,,16,Centro,GUARDA,0902,51798.46,5830,441,419,396,458,393,851,1247,1666,2107,11.26,4.07,3.22,2.41
02-09-2021,ALMEIRIM,23,2,103,"[0,120]",Baixo a Moderado,,,,23,Lisboa e Vale do Tejo,SANTARÉM,1403,22212.05,22546,1342,1353,1106,866,843,1709,2815,4168,5510,101.5,24.81,18.76,12.67
02-09-2021,ALMODÔVAR,13,1,195,"[120,240]",Moderado,,,,13,Alentejo,BEJA,0202,77788.03,6725,414,443,396,373,328,701,1097,1540,1954,8.65,2.51,1.98,1.41
02-09-2021,ALPIARÇA,4,0,57,"[0,120]",Baixo a Moderado,,,,4,Lisboa e Vale do Tejo,SANTARÉM,1404,9536.33,7059,515,486,363,333,274,607,970,1456,1971,74.02,20.67,15.27,10.17
02-09-2021,ALTER DO CHÃO,12,1,383,"[240,480]",Elevado,,,,12,Alentejo,PORTALEGRE,1201,36206.62,3165,201,163,136,208,187,395,531,694,895,8.74,2.47,1.92,1.47
02-09-2021,ALVAIÁZERE,0,0,0,"[0,120]",Baixo a Moderado,,,,0,Centro,LEIRIA,1002,16047.76,6597,419,389,346,406,539,945,1291,1680,2099,41.11,13.08,10.47,8.04
02-09-2021,ALVITO,4,0,162,"[120,240]",Moderado,,,,4,Alentejo,BEJA,0203,26485.32,2477,145,110,105,111,89,200,305,415,560,9.35,2.11,1.57,1.15
02-09-2021,AMADORA,490,35,266,"[240,480]",Elevado,,,,490,Lisboa e Vale do Tejo,LISBOA,1115,2378.47,184106,11186,10936,8780,6460,5890,12350,21130,32066,43252,7742.05,1818.84,1348.44,888.56
02-09-2021,AMARANTE,82,6,155,"[120,240]",Moderado,,,,82,Norte,PORTO,1301,30133.15,53193,3086,2413,1812,1643,1311,2954,4766,7179,10265,176.53,34.07,23.82,15.82
02-09-2021,AMARES,137,10,757,"[480,960]",Muito Elevado,,,,137,Norte,BRAGA,0301,8195.41,18129,1001,829,622,489,524,1013,1635,2464,3465,221.22,42.28,30.07,19.95
02-09-2021,ANADIA,72,5,263,"[240,480]",Elevado,,,,72,Centro,AVEIRO,0103,21663.48,27258,1931,1698,1376,1208,1262,2470,3846,5544,7475,125.83,34.51,25.59,17.75
02-09-2021,ANGRA DO HEROÍSMO,21,1,62,"[0,120]",Baixo a Moderado,,,,21,Açores,AÇORES,4301,23899.66,33807,2006,1473,1122,768,635,1403,2525,3998,6004,141.45,25.12,16.73,10.56
02-09-2021,ANSIÃO,16,1,133,"[120,240]",Moderado,,,,16,Centro,LEIRIA,1003,17609.42,12039,727,709,646,694,530,1224,1870,2579,3306,68.37,18.77,14.65,10.62
02-09-2021,ARCOS DE VALDEVEZ,41,3,197,"[120,240]",Moderado,,,,41,Norte,VIANA DO CASTELO,1601,44759.64,20926,1329,1338,1282,1343,1515,2858,4140,5478,6807,46.75,15.21,12.24,9.25
02-09-2021,ARGANIL,41,3,373,"[240,480]",Elevado,,,,41,Centro,COIMBRA,0601,33283.93,11014,672,648,612,559,596,1155,1767,2415,3087,33.09,9.27,7.26,5.31
02-09-2021,ARMAMAR,2,0,35,"[0,120]",Baixo a Moderado,,,,2,Norte,VISEU,1801,11723.73,5769,357,305,309,285,310,595,904,1209,1566,49.21,13.36,10.31,7.71
02-09-2021,AROUCA,127,9,611,"[480,960]",Muito Elevado,,,,127,Norte,AVEIRO,0104,32910.52,20720,1306,1047,753,683,683,1366,2119,3166,4472,62.96,13.59,9.62,6.44
02-09-2021,ARRAIOLOS,27,2,393,"[240,480]",Elevado,,,,27,Alentejo,ÉVORA,0702,68374.55,6928,435,384,283,367,480,847,1130,1514,1949,10.13,2.85,2.21,1.65
02-09-2021,ARRONCHES,5,0,181,"[120,240]",Moderado,,,,5,Alentejo,PORTALEGRE,1202,31464.72,2820,155,142,162,187,179,366,528,670,825,8.96,2.62,2.13,1.68
02-09-2021,ARRUDA DOS VINHOS,23,2,152,"[120,240]",Moderado,,,,23,Lisboa e Vale do Tejo,LISBOA,1102,7795.93,15412,738,738,562,509,438,947,1509,2247,2985,197.69,38.29,28.82,19.36
02-09-2021,AVEIRO,114,8,145,"[120,240]",Moderado,,,,114,Centro,AVEIRO,0105,19757.57,78734,4520,4004,3050,2250,2103,4353,7403,11407,15927,398.49,80.61,57.73,37.47
02-09-2021,AVIS,0,0,0,"[0,120]",Baixo a Moderado,,,,0,Alentejo,PORTALEGRE,1203,60596.51,4247,315,225,206,251,273,524,730,955,1270,7.01,2.1,1.58,1.2
02-09-2021,AZAMBUJA,44,3,193,"[120,240]",Moderado,,,,44,Lisboa e Vale do Tejo,LISBOA,1103,26265.65,22716,1322,1171,1070,798,618,1416,2486,3657,4979,86.48,18.96,13.92,9.46
02-09-2021,BAIÃO,24,2,129,"[120,240]",Moderado,,,,24,Norte,PORTO,1302,17452.83,18748,1070,862,714,686,725,1411,2125,2987,4057,107.42,23.25,17.11,12.18
02-09-2021,BARCELOS,596,43,513,"[480,960]",Muito Elevado,,,,596,Norte,BRAGA,0302,37890.14,116187,6721,5325,3619,2991,2562,5553,9172,14497,21218,306.64,56.0,38.26,24.21
02-09-2021,BARRANCOS,1,0,62,"[0,120]",Baixo a Moderado,,,,1,Alentejo,BEJA,0204,16841.73,1634,90,65,65,94,61,155,220,285,375,9.7,2.23,1.69,1.31
02-09-2021,BARREIRO,162,12,215,"[120,240]",Moderado,,,,162,Lisboa e Vale do Tejo,SETÚBAL,1504,3639.07,75147,5194,5565,4459,3105,1767,4872,9331,14896,20090,2065.05,552.07,409.34,256.42
02-09-2021,BATALHA,59,4,371,"[240,480]",Elevado,,,,59,Centro,LEIRIA,1004,10341.6,15963,873,762,649,529,549,1078,1727,2489,3362,154.35,32.51,24.07,16.7
02-09-2021,BEJA,251,18,747,"[480,960]",Muito Elevado,,,,251,Alentejo,BEJA,0205,114647.55,33579,2005,1840,1386,1272,1039,2311,3697,5537,7542,29.29,6.58,4.83,3.22
02-09-2021,BELMONTE,31,2,486,"[480,960]",Muito Elevado,,,,31,Centro,CASTELO BRANCO,0501,11875.91,6398,444,321,325,310,355,665,990,1311,1755,53.87,14.78,11.04,8.34
02-09-2021,BENAVENTE,101,7,329,"[240,480]",Elevado,,,,101,Lisboa e Vale do Tejo,SANTARÉM,1405,52138.39,30602,1468,1376,1141,876,643,1519,2660,4036,5504,58.69,10.56,7.74,5.1
02-09-2021,BOMBARRAL,18,1,142,"[120,240]",Moderado,,,,18,Lisboa e Vale do Tejo,LEIRIA,1005,9128.55,12558,875,714,561,491,429,920,1481,2195,3070,137.56,33.63,24.04,16.22
02-09-2021,BORBA,22,2,330,"[240,480]",Elevado,,,,22,Alentejo,ÉVORA,0703,14518.65,6736,430,375,279,436,392,828,1107,1482,1912,46.39,13.17,10.21,7.62
02-09-2021,BOTICAS,41,3,812,"[480,960]",Muito Elevado,,,,41,Norte,VILA REAL,1702,32195.66,4998,347,306,311,305,380,685,996,1302,1649,15.52,5.12,4.04,3.09
02-09-2021,BRAGA,965,69,528,"[480,960]",Muito Elevado,,,,965,Norte,BRAGA,0303,18339.95,182679,10029,7963,5241,4320,3671,7991,13232,21195,31224,996.07,170.25,115.57,72.15
02-09-2021,BRAGANÇA,119,8,353,"[240,480]",Elevado,,,,119,Norte,BRAGANÇA,0402,117357.27,33607,2402,1855,1652,1393,1163,2556,4208,6063,8465,28.64,7.21,5.17,3.59
02-09-2021,CABECEIRAS DE BASTO,69,5,444,"[240,480]",Elevado,,,,69,Norte,BRAGA,0304,24182.16,15628,774,594,544,575,574,1149,1693,2287,3061,64.63,12.66,9.46,7.0
02-09-2021,CADAVAL,26,2,189,"[120,240]",Moderado,,,,26,Lisboa e Vale do Tejo,LISBOA,1104,17489.3,13673,813,796,756,621,625,1246,2002,2798,3611,78.18,20.65,16.0,11.45
02-09-2021,CALDAS DA RAINHA,88,6,170,"[120,240]",Moderado,,,,88,Lisboa e Vale do Tejo,LEIRIA,1006,25569.47,51912,3035,2684,2186,1899,1705,3604,5790,8474,11509,203.03,45.01,33.14,22.64
02-09-2021,CALHETA,10,1,92,"[0,120]",Baixo a Moderado,,,,10,Madeira,MADEIRA,3101,11150.43,10867,576,497,507,399,415,814,1321,1818,2394,97.46,21.47,16.3,11.85
02-09-2021,CALHETA (AÇORES),0,0,0,"[0,120]",Baixo a Moderado,,,,0,Açores,AÇORES,4501,12626.4,3184,215,159,141,139,122,261,402,561,776,25.22,6.15,4.44,3.18
02-09-2021,CÂMARA DE LOBOS,52,4,155,"[120,240]",Moderado,,,,52,Madeira,MADEIRA,3102,5216.67,33675,1396,1059,834,545,381,926,1760,2819,4215,645.49,80.79,54.03,33.74
02-09-2021,CAMINHA,25,2,158,"[120,240]",Moderado,,,,25,Norte,VIANA DO CASTELO,1602,13652.14,15877,1046,944,818,646,656,1302,2120,3064,4110,116.3,30.11,22.44,15.53
02-09-2021,CAMPO MAIOR,46,3,590,"[480,960]",Muito Elevado,,,,46,Alentejo,PORTALEGRE,1204,24720.16,7874,471,364,351,279,327,606,957,1321,1792,31.85,7.25,5.34,3.87
02-09-2021,CANTANHEDE,95,7,270,"[240,480]",Elevado,,,,95,Centro,COIMBRA,0602,39088.02,35011,2346,2096,1880,1709,1451,3160,5040,7136,9482,89.57,24.26,18.26,12.89
02-09-2021,CARRAZEDA DE ANSIÃES,1,0,18,"[0,120]",Baixo a Moderado,,,,1,Norte,BRAGANÇA,0403,27924.09,5666,424,389,391,312,465,777,1168,1557,1981,20.29,7.09,5.58,4.18
02-09-2021,CARREGAL DO SAL,45,3,483,"[480,960]",Muito Elevado,,,,45,Centro,VISEU,1802,11689.21,9271,587,562,486,462,376,838,1324,1886,2473,79.31,21.16,16.13,11.33
02-09-2021,CARTAXO,25,2,105,"[0,120]",Baixo a Moderado,,,,25,Lisboa e Vale do Tejo,SANTARÉM,1406,15817.28,23843,1415,1376,1142,861,632,1493,2635,4011,5426,150.74,34.3,25.36,16.66
02-09-2021,CASCAIS,628,45,294,"[240,480]",Elevado,,,,628,Lisboa e Vale do Tejo,LISBOA,1105,9740.17,213608,12151,11444,8680,6469,5248,11717,20397,31841,43992,2193.1,451.66,326.91,209.41
02-09-2021,CASTANHEIRA DE PÊRA,2,0,78,"[0,120]",Baixo a Moderado,,,,2,Centro,LEIRIA,1007,6677.45,2614,233,195,157,190,187,377,534,729,962,39.15,14.41,10.92,8.0
02-09-2021,CASTELO BRANCO,167,12,321,"[240,480]",Elevado,,,,167,Centro,CASTELO BRANCO,0502,143819.15,51987,3528,3042,2499,2229,2225,4454,6953,9995,13523,36.15,9.4,6.95,4.83
02-09-2021,CASTELO DE PAIVA,18,1,118,"[0,120]",Baixo a Moderado,,,,18,Norte,AVEIRO,0106,11500.53,15454,881,697,545,420,431,851,1396,2093,2974,134.37,25.86,18.2,12.14
02-09-2021,CASTELO DE VIDE,7,1,242,"[240,480]",Elevado,,,,7,Alentejo,PORTALEGRE,1205,26491.24,2919,204,173,179,147,170,317,496,669,873,11.02,3.3,2.53,1.87
02-09-2021,CASTRO DAIRE,9,1,65,"[0,120]",Baixo a Moderado,,,,9,Centro,VISEU,1803,37904.13,13823,942,857,765,732,773,1505,2270,3127,4069,36.47,10.74,8.25,5.99
02-09-2021,CASTRO MARIM,9,1,145,"[120,240]",Moderado,,,,9,Algarve,FARO,0804,30084.37,6237,370,345,334,322,344,666,1000,1345,1715,20.73,5.7,4.47,3.32
02-09-2021,CASTRO VERDE,39,3,566,"[480,960]",Muito Elevado,,,,39,Alentejo,BEJA,0206,56944.23,6949,437,347,303,275,227,502,805,1152,1589,12.2,2.79,2.02,1.41
02-09-2021,CELORICO DA BEIRA,22,2,317,"[240,480]",Elevado,,,,22,Centro,GUARDA,0903,24721.63,6928,430,416,363,369,535,904,1267,1683,2113,28.02,8.55,6.81,5.12
02-09-2021,CELORICO DE BASTO,58,4,302,"[240,480]",Elevado,,,,58,Norte,BRAGA,0305,18107.02,19040,1001,802,668,728,729,1457,2125,2927,3928,105.15,21.69,16.17,11.74
02-09-2021,CHAMUSCA,5,0,55,"[0,120]",Baixo a Moderado,,,,5,Lisboa e Vale do Tejo,SANTARÉM,1407,74600.54,9197,629,583,553,465,579,1044,1597,2180,2809,12.33,3.77,2.92,2.14
02-09-2021,CHAVES,186,13,472,"[240,480]",Elevado,,,,186,Norte,VILA REAL,1703,59122.95,39343,2676,2429,1991,1886,1918,3804,5795,8224,10900,66.54,18.44,13.91,9.8
02-09-2021,CINFÃES,38,3,206,"[120,240]",Moderado,,,,38,Norte,VISEU,1804,23928.76,18244,1067,902,779,734,758,1492,2271,3173,4240,76.24,17.72,13.26,9.49
02-09-2021,COIMBRA,258,18,192,"[120,240]",Moderado,,,,258,Centro,COIMBRA,0603,31939.94,134166,9489,8734,6353,5139,5074,10213,16566,25300,34789,420.06,108.92,79.21,51.87
02-09-2021,CONDEIXA-A-NOVA,21,1,117,"[0,120]",Baixo a Moderado,,,,21,Centro,COIMBRA,0604,13867.47,17733,871,809,717,583,490,1073,1790,2599,3470,127.88,25.02,18.74,12.91
02-09-2021,CONSTÂNCIA,4,0,99,"[0,120]",Baixo a Moderado,,,,4,Lisboa e Vale do Tejo,SANTARÉM,1408,8036.58,4030,211,183,187,148,155,303,490,673,884,50.14,11.0,8.37,6.1
02-09-2021,CORUCHE,10,1,58,"[0,120]",Baixo a Moderado,,,,10,Lisboa e Vale do Tejo,SANTARÉM,1409,111572.03,17471,1294,1090,1095,1096,1019,2115,3210,4300,5594,15.66,5.01,3.85,2.88
02-09-2021,CORVO,1,0,213,"[120,240]",Moderado,,,,1,Açores,AÇORES,4901,1711.45,464,22,21,11,13,19,32,43,64,86,27.12,5.03,3.74,2.51
02-09-2021,COVILHÃ,267,19,571,"[480,960]",Muito Elevado,,,,267,Centro,CASTELO BRANCO,0503,55560.06,46787,3533,2998,2365,2111,2193,4304,6669,9667,13200,84.21,23.76,17.4,12.0
02-09-2021,CRATO,3,0,98,"[0,120]",Baixo a Moderado,,,,3,Alentejo,PORTALEGRE,1206,39806.88,3129,229,258,163,182,228,410,573,831,1060,7.86,2.66,2.09,1.44
02-09-2021,CUBA,14,1,308,"[240,480]",Elevado,,,,14,Alentejo,BEJA,0207,17208.72,4595,255,233,206,190,143,333,539,772,1027,26.7,5.97,4.49,3.13
02-09-2021,ELVAS,36,3,173,"[120,240]",Moderado,,,,36,Alentejo,PORTALEGRE,1207,63128.86,20528,1057,1145,902,852,810,1662,2564,3709,4766,32.52,7.55,5.88,4.06
02-09-2021,ENTRONCAMENTO,57,4,265,"[240,480]",Elevado,,,,57,Lisboa e Vale do Tejo,SANTARÉM,1410,1372.81,21558,1066,930,868,695,592,1287,2155,3085,4151,1570.14,302.33,224.69,156.96
02-09-2021,ESPINHO,73,5,248,"[240,480]",Elevado,,,,73,Norte,AVEIRO,0107,2105.68,29516,2205,1993,1430,1177,960,2137,3567,5560,7765,1401.52,368.71,264.01,169.37
02-09-2021,ESPOSENDE,173,12,506,"[480,960]",Muito Elevado,,,,173,Norte,BRAGA,0306,9540.98,34177,1831,1522,1095,894,723,1617,2712,4234,6065,358.21,63.57,44.38,28.42
02-09-2021,ESTARREJA,28,2,107,"[0,120]",Baixo a Moderado,,,,28,Centro,AVEIRO,0108,10817.33,26006,1503,1399,1106,953,728,1681,2787,4186,5689,240.42,52.59,38.7,25.76
02-09-2021,ESTREMOZ,29,2,230,"[120,240]",Moderado,,,,29,Alentejo,ÉVORA,0704,51379.95,12728,789,613,697,786,877,1663,2360,2973,3762,24.77,7.32,5.79,4.59
02-09-2021,ÉVORA,225,16,429,"[240,480]",Elevado,,,,225,Alentejo,ÉVORA,0705,130707.58,52428,3569,2852,2176,1966,1803,3769,5945,8797,12366,40.11,9.46,6.73,4.55
02-09-2021,FAFE,272,19,566,"[480,960]",Muito Elevado,,,,272,Norte,BRAGA,0307,21908.11,48060,3044,2455,1679,1403,1208,2611,4290,6745,9789,219.37,44.68,30.79,19.58
02-09-2021,FARO,341,24,559,"[480,960]",Muito Elevado,,,,341,Algarve,FARO,0805,20256.79,61015,3847,3364,2604,2055,1601,3656,6260,9624,13471,301.2,66.5,47.51,30.9
02-09-2021,FELGUEIRAS,151,11,267,"[240,480]",Elevado,,,,151,Norte,PORTO,1303,11573.75,56422,2951,2302,1601,1316,973,2289,3890,6192,9143,487.49,79.0,53.5,33.61
02-09-2021,FERREIRA DO ALENTEJO,9,1,115,"[0,120]",Baixo a Moderado,,,,9,Alentejo,BEJA,0208,64820.68,7845,515,414,372,343,345,688,1060,1474,1989,12.1,3.07,2.27,1.64
02-09-2021,FERREIRA DO ZÊZERE,24,2,302,"[240,480]",Elevado,,,,24,Lisboa e Vale do Tejo,SANTARÉM,1411,19038.03,7959,470,370,416,465,456,921,1337,1707,2177,41.81,11.44,8.97,7.02
02-09-2021,FIGUEIRA DA FOZ,156,11,266,"[240,480]",Elevado,,,,156,Centro,COIMBRA,0605,37905.26,58747,4032,3597,2887,2495,2043,4538,7425,11022,15054,154.98,39.72,29.08,19.59
02-09-2021,FIGUEIRA DE CASTELO RODRIGO,12,1,215,"[120,240]",Moderado,,,,12,Centro,GUARDA,0904,50857.46,5584,347,352,290,352,391,743,1033,1385,1732,10.98,3.41,2.72,2.03
02-09-2021,FIGUEIRÓ DOS VINHOS,10,1,180,"[120,240]",Moderado,,,,10,Centro,LEIRIA,1008,17344.0,5568,402,386,322,309,351,660,982,1368,1770,32.1,10.21,7.89,5.66
02-09-2021,FORNOS DE ALGODRES,8,1,176,"[120,240]",Moderado,,,,8,Centro,GUARDA,0905,13145.05,4528,261,218,247,256,232,488,735,953,1214,34.45,9.24,7.25,5.59
02-09-2021,FREIXO DE ESPADA À CINTA,1,0,31,"[0,120]",Baixo a Moderado,,,,1,Norte,BRAGANÇA,0404,24414.29,3298,211,177,231,196,189,385,616,793,1004,13.51,4.11,3.25,2.52
02-09-2021,FRONTEIRA,43,3,1432,"[960,Max]",Extremamente Elevado,,,,43,Alentejo,PORTALEGRE,1208,24859.58,2974,213,182,149,156,168,324,473,655,868,11.96,3.49,2.63,1.9
02-09-2021,FUNCHAL,224,16,215,"[120,240]",Moderado,,,,224,Madeira,MADEIRA,3103,7616.2,104024,6382,5086,3643,2821,1990,4811,8454,13540,19922,1365.86,261.58,177.78,111.0
02-09-2021,FUNDÃO,41,3,155,"[120,240]",Moderado,,,,41,Centro,CASTELO BRANCO,0504,70019.79,26495,1781,1464,1432,1357,1643,3000,4432,5896,7677,37.84,10.96,8.42,6.33
02-09-2021,GAVIÃO,2,0,63,"[0,120]",Baixo a Moderado,,,,2,Alentejo,PORTALEGRE,1209,29459.45,3263,189,186,222,263,293,556,778,964,1153,11.08,3.91,3.27,2.64
02-09-2021,GÓIS,3,0,80,"[0,120]",Baixo a Moderado,,,,3,Centro,COIMBRA,0606,26330.19,3805,235,199,240,233,244,477,717,916,1151,14.45,4.37,3.48,2.72
02-09-2021,GOLEGÃ,5,0,95,"[0,120]",Baixo a Moderado,,,,5,Lisboa e Vale do Tejo,SANTARÉM,1412,8431.67,5339,356,299,281,243,255,498,779,1078,1434,63.32,17.01,12.78,9.24
02-09-2021,GONDOMAR,284,20,171,"[120,240]",Moderado,,,,284,Norte,PORTO,1304,13191.76,165985,10555,8755,6222,4450,3364,7814,14036,22791,33346,1258.22,252.77,172.76,106.4
02-09-2021,GOUVEIA,7,1,57,"[0,120]",Baixo a Moderado,,,,7,Centro,GUARDA,0906,30061.17,12387,871,931,780,783,810,1593,2373,3304,4175,41.21,13.89,10.99,7.89
02-09-2021,GRÂNDOLA,23,2,157,"[120,240]",Moderado,,,,23,Alentejo,SETÚBAL,1505,82593.66,14639,834,834,708,688,672,1360,2068,2902,3736,17.72,4.52,3.51,2.5
02-09-2021,GUARDA,68,5,174,"[120,240]",Moderado,,,,68,Centro,GUARDA,0907,71209.58,38969,2477,2041,1686,1415,1474,2889,4575,6616,9093,54.72,12.77,9.29,6.42
02-09-2021,GUIMARÃES,621,44,408,"[240,480]",Elevado,,,,621,Norte,BRAGA,0308,24099.96,152309,9394,7074,4809,3877,2948,6825,11634,18708,28102,631.99,116.61,77.63,48.27
02-09-2021,HORTA,6,0,42,"[0,120]",Baixo a Moderado,,,,6,Açores,AÇORES,4701,17305.53,14521,818,658,468,352,302,654,1122,1780,2598,83.91,15.01,10.29,6.48
02-09-2021,IDANHA-A-NOVA,19,1,240,"[240,480]",Elevado,,,,19,Centro,CASTELO BRANCO,0505,141633.51,8043,518,490,519,672,974,1646,2165,2655,3173,5.68,2.24,1.87,1.53
02-09-2021,ÍLHAVO,41,3,107,"[0,120]",Baixo a Moderado,,,,41,Centro,AVEIRO,0110,7347.55,38699,2227,1943,1444,1193,850,2043,3487,5430,7657,526.66,104.21,73.9,47.46
02-09-2021,LAGOA (FARO),122,9,536,"[480,960]",Muito Elevado,,,,122,Algarve,FARO,0806,8825.45,22762,1314,1168,919,749,670,1419,2338,3506,4820,257.93,54.62,39.73,26.49
02-09-2021,LAGOA,22,2,149,"[120,240]",Moderado,,,,22,Açores,AÇORES,4201,4559.32,14721,536,458,349,238,235,473,822,1280,1816,322.9,39.83,28.08,18.03
02-09-2021,LAGOS,353,25,1163,"[960,Max]",Extremamente Elevado,,,,353,Algarve,FARO,0807,21299.27,30374,1744,1434,1247,1053,1029,2082,3329,4763,6507,142.61,30.55,22.36,15.63
02-09-2021,LAJES DAS FLORES,0,0,0,"[0,120]",Baixo a Moderado,,,,0,Açores,AÇORES,4801,7004.79,1463,88,53,62,46,54,100,162,215,303,20.89,4.33,3.07,2.31
02-09-2021,LAJES DO PICO,4,0,89,"[0,120]",Baixo a Moderado,,,,4,Açores,AÇORES,4601,15531.09,4490,304,231,223,159,162,321,544,775,1079,28.91,6.95,4.99,3.5
02-09-2021,LAMEGO,16,1,65,"[0,120]",Baixo a Moderado,,,,16,Norte,VISEU,1805,16542.11,24895,1639,1284,1124,898,783,1681,2805,4089,5728,150.5,34.63,24.72,16.96
02-09-2021,LEIRIA,619,44,494,"[480,960]",Muito Elevado,,,,619,Centro,LEIRIA,1009,56508.83,125267,7389,6366,5090,3902,3159,7061,12151,18517,25906,221.68,45.84,32.77,21.5
02-09-2021,LISBOA,1921,137,377,"[240,480]",Elevado,,,,1921,Lisboa e Vale do Tejo,LISBOA,1106,10005.43,509515,33197,33340,27706,23037,26770,49807,77513,110853,144050,5092.6,1439.78,1107.98,774.74
02-09-2021,LOULÉ,431,31,627,"[480,960]",Muito Elevado,,,,431,Algarve,FARO,0808,76366.91,68697,3890,3350,2780,2358,2251,4609,7389,10739,14629,89.96,19.16,14.06,9.68
02-09-2021,LOURES,451,32,211,"[120,240]",Moderado,,,,451,Lisboa e Vale do Tejo,LISBOA,1107,16723.99,213687,12746,12794,9644,6669,5033,11702,21346,34140,46886,1277.73,280.35,204.14,127.64
02-09-2021,LOURINHÃ,41,3,160,"[120,240]",Moderado,,,,41,Lisboa e Vale do Tejo,LISBOA,1108,14717.2,25855,1584,1243,992,842,645,1487,2479,3722,5306,175.68,36.05,25.29,16.84
02-09-2021,LOUSÃ,29,2,168,"[120,240]",Moderado,,,,29,Centro,COIMBRA,0607,13840.01,17158,946,866,658,528,450,978,1636,2502,3448,123.97,24.91,18.08,11.82
02-09-2021,LOUSADA,105,8,225,"[120,240]",Moderado,,,,105,Norte,PORTO,1305,9608.01,46755,2289,1698,1176,853,621,1474,2650,4348,6637,486.63,69.08,45.25,27.58
02-09-2021,MAÇÃO,11,1,178,"[120,240]",Moderado,,,,11,Lisboa e Vale do Tejo,SANTARÉM,1413,39997.98,6267,386,362,390,440,657,1097,1487,1849,2235,15.67,5.59,4.62,3.72
02-09-2021,MACEDO DE CAVALEIROS,31,2,215,"[120,240]",Moderado,,,,31,Norte,BRAGANÇA,0405,69914.08,14516,1082,889,878,823,938,1761,2639,3528,4610,20.76,6.59,5.05,3.77
02-09-2021,MACHICO,21,2,106,"[0,120]",Baixo a Moderado,,,,21,Madeira,MADEIRA,3104,6825.1,19981,1197,860,662,455,331,786,1448,2308,3505,292.76,51.36,33.82,21.22
02-09-2021,MADALENA,0,0,0,"[0,120]",Baixo a Moderado,,,,0,Açores,AÇORES,4602,14712.33,5895,334,256,173,190,179,369,542,798,1132,40.07,7.69,5.42,3.68
02-09-2021,MAFRA,250,18,295,"[240,480]",Elevado,,,,250,Lisboa e Vale do Tejo,LISBOA,1109,29165.5,84816,3613,3334,2839,2089,1899,3988,6827,10161,13774,290.81,47.23,34.84,23.41
02-09-2021,MAIA,311,22,224,"[120,240]",Moderado,,,,311,Norte,PORTO,1306,8293.94,138971,7801,6617,4512,3339,2631,5970,10482,17099,24900,1675.56,300.22,206.16,126.38
02-09-2021,MANGUALDE,49,3,264,"[240,480]",Elevado,,,,49,Centro,VISEU,1806,21925.56,18510,1198,1128,885,852,743,1595,2480,3608,4806,84.42,21.92,16.46,11.31
02-09-2021,MANTEIGAS,3,0,100,"[0,120]",Baixo a Moderado,,,,3,Centro,GUARDA,0908,12197.55,3007,258,197,159,167,146,313,472,669,927,24.65,7.6,5.48,3.87
02-09-2021,MARCO DE CANAVESES,92,7,178,"[120,240]",Moderado,,,,92,Norte,PORTO,1307,20188.98,51496,2678,2060,1488,1265,1023,2288,3776,5836,8514,255.07,42.17,28.91,18.7
02-09-2021,MARINHA GRANDE,161,11,417,"[240,480]",Elevado,,,,161,Centro,LEIRIA,1010,18725.19,38508,2365,2302,1638,1359,1058,2417,4055,6357,8722,205.65,46.58,33.95,21.66
02-09-2021,MARVÃO,67,5,2246,"[960,Max]",Extremamente Elevado,,,,67,Alentejo,PORTALEGRE,1210,15489.9,3005,198,185,142,197,237,434,576,761,959,19.4,6.19,4.91,3.72
02-09-2021,MATOSINHOS,389,28,222,"[120,240]",Moderado,,,,389,Norte,PORTO,1308,6241.97,175357,11850,9977,7023,5024,3884,8908,15931,25908,37758,2809.31,604.9,415.06,255.22
02-09-2021,MEALHADA,20,1,100,"[0,120]",Baixo a Moderado,,,,20,Centro,AVEIRO,0111,11065.66,19914,1163,1039,810,828,831,1659,2469,3508,4671,179.96,42.21,31.7,22.31
02-09-2021,MÊDA,18,1,393,"[240,480]",Elevado,,,,18,Centro,GUARDA,0909,28604.92,4587,343,306,290,288,443,731,1021,1327,1670,16.04,5.84,4.64,3.57
02-09-2021,MELGAÇO,20,1,250,"[240,480]",Elevado,,,,20,Norte,VIANA DO CASTELO,1603,23824.58,8093,507,567,578,614,675,1289,1867,2434,2941,33.97,12.34,10.22,7.84
02-09-2021,MÉRTOLA,10,1,165,"[120,240]",Moderado,,,,10,Alentejo,BEJA,0209,129287.34,6142,400,390,378,423,600,1023,1401,1791,2191,4.75,1.69,1.39,1.08
02-09-2021,MESÃO FRIO,5,0,127,"[120,240]",Moderado,,,,5,Norte,VILA REAL,1704,2664.87,3964,265,205,168,157,120,277,445,650,915,148.74,34.33,24.39,16.7
02-09-2021,MIRA,5,0,42,"[0,120]",Baixo a Moderado,,,,5,Centro,COIMBRA,0608,12403.38,11832,727,729,659,550,466,1016,1675,2404,3131,95.4,25.24,19.38,13.5
02-09-2021,MIRANDA DO CORVO,14,1,110,"[0,120]",Baixo a Moderado,,,,14,Centro,COIMBRA,0609,12637.79,12708,706,659,568,498,404,902,1470,2129,2835,100.55,22.43,16.85,11.63
02-09-2021,MIRANDA DO DOURO,9,1,133,"[120,240]",Moderado,,,,9,Norte,BRAGANÇA,0406,48718.31,6830,482,429,442,463,470,933,1375,1804,2286,14.02,4.69,3.7,2.82
02-09-2021,MIRANDELA,75,5,343,"[240,480]",Elevado,,,,75,Norte,BRAGANÇA,0407,65895.67,21754,1640,1315,1204,1078,947,2025,3229,4544,6184,33.01,9.38,6.9,4.9
02-09-2021,MOGADOURO,20,1,241,"[240,480]",Elevado,,,,20,Norte,BRAGANÇA,0408,76064.93,8392,589,529,576,630,655,1285,1861,2390,2979,11.03,3.92,3.14,2.45
02-09-2021,MOIMENTA DA BEIRA,9,1,93,"[0,120]",Baixo a Moderado,,,,9,Norte,VISEU,1807,21996.9,9736,576,514,471,416,461,877,1348,1862,2438,44.26,11.08,8.46,6.13
02-09-2021,MOITA,142,10,220,"[120,240]",Moderado,,,,142,Lisboa e Vale do Tejo,SETÚBAL,1506,5525.98,64407,4226,3646,2623,1801,1425,3226,5849,9495,13721,1165.53,248.3,171.82,105.85
02-09-2021,MONÇÃO,66,5,367,"[240,480]",Elevado,,,,66,Norte,VIANA DO CASTELO,1604,21130.85,17869,1161,1105,1031,1006,972,1978,3009,4114,5275,84.56,24.96,19.47,14.24
02-09-2021,MONCHIQUE,5,0,100,"[0,120]",Baixo a Moderado,,,,5,Algarve,FARO,0809,39530.43,5077,353,384,321,355,392,747,1068,1452,1805,12.84,4.57,3.67,2.7
02-09-2021,MONDIM DE BASTO,28,2,407,"[240,480]",Elevado,,,,28,Norte,VILA REAL,1705,17207.52,6946,395,300,314,284,283,567,881,1181,1576,40.36,9.16,6.86,5.12
02-09-2021,MONFORTE,2,0,68,"[0,120]",Baixo a Moderado,,,,2,Alentejo,PORTALEGRE,1211,42024.82,2975,139,115,117,192,168,360,477,592,731,7.08,1.74,1.41,1.14
02-09-2021,MONTALEGRE,90,6,1002,"[960,Max]",Extremamente Elevado,,,,90,Norte,VILA REAL,1706,80545.71,8997,699,628,595,603,730,1333,1928,2556,3255,11.17,4.04,3.17,2.39
02-09-2021,MONTEMOR-O-NOVO,21,2,136,"[120,240]",Moderado,,,,21,Alentejo,ÉVORA,0706,123296.65,15647,991,953,868,878,971,1849,2717,3670,4661,12.69,3.78,2.98,2.2
02-09-2021,MONTEMOR-O-VELHO,32,2,127,"[120,240]",Moderado,,,,32,Centro,COIMBRA,0610,22896.23,25224,1496,1397,1217,1057,988,2045,3262,4659,6155,110.17,26.88,20.35,14.25
02-09-2021,MONTIJO,108,8,188,"[120,240]",Moderado,,,,108,Lisboa e Vale do Tejo,SETÚBAL,1507,34861.64,57614,2771,2441,1990,1554,1109,2663,4653,7094,9865,165.26,28.3,20.35,13.35
02-09-2021,MORA,0,0,0,"[0,120]",Baixo a Moderado,,,,0,Alentejo,ÉVORA,0707,44395.02,4138,336,275,252,238,257,495,747,1022,1358,9.32,3.06,2.3,1.68
02-09-2021,MORTÁGUA,18,1,204,"[120,240]",Moderado,,,,18,Centro,VISEU,1808,25117.82,8803,638,584,535,499,460,959,1494,2078,2716,35.05,10.81,8.27,5.95
02-09-2021,MOURA,100,7,728,"[480,960]",Muito Elevado,,,,100,Alentejo,BEJA,0210,95845.55,13718,817,656,665,542,461,1003,1668,2324,3141,14.31,3.28,2.42,1.74
02-09-2021,MOURÃO,17,1,699,"[480,960]",Muito Elevado,,,,17,Alentejo,ÉVORA,0708,27862.98,2450,139,108,80,104,109,213,293,401,540,8.79,1.94,1.44,1.05
02-09-2021,MURÇA,8,1,148,"[120,240]",Moderado,,,,8,Norte,VILA REAL,1707,18937.11,5463,384,341,307,306,319,625,932,1273,1657,28.85,8.75,6.72,4.92
02-09-2021,MURTOSA,6,0,58,"[0,120]",Baixo a Moderado,,,,6,Centro,AVEIRO,0112,7308.78,10279,509,473,403,353,409,762,1165,1638,2147,140.63,29.37,22.41,15.94
02-09-2021,NAZARÉ,48,3,337,"[240,480]",Elevado,,,,48,Lisboa e Vale do Tejo,LEIRIA,1011,8243.43,14165,967,903,670,420,396,816,1486,2389,3356,171.84,40.71,28.98,18.03
02-09-2021,NELAS,16,1,123,"[120,240]",Moderado,,,,16,Centro,VISEU,1809,12571.48,12974,924,787,668,604,583,1187,1855,2642,3566,103.21,28.37,21.02,14.76
02-09-2021,NISA,5,0,84,"[0,120]",Baixo a Moderado,,,,5,Alentejo,PORTALEGRE,1212,57567.84,6061,405,389,355,483,478,961,1316,1705,2110,10.53,3.67,2.96,2.29
02-09-2021,NORDESTE,2,0,42,"[0,120]",Baixo a Moderado,,,,2,Açores,AÇORES,4202,10146.8,4862,246,180,124,161,162,323,447,627,873,47.92,8.6,6.18,4.41
02-09-2021,ÓBIDOS,22,2,183,"[120,240]",Moderado,,,,22,Lisboa e Vale do Tejo,LEIRIA,1012,14155.44,11850,743,650,574,452,436,888,1462,2112,2855,83.72,20.17,14.92,10.33
02-09-2021,ODEMIRA,48,3,195,"[120,240]",Moderado,,,,48,Alentejo,BEJA,0211,172060.15,24717,1475,1317,1225,1397,1349,2746,3971,5288,6763,14.37,3.93,3.07,2.31
02-09-2021,ODIVELAS,366,26,226,"[120,240]",Moderado,,,,366,Lisboa e Vale do Tejo,LISBOA,1116,2654.36,161774,9562,9038,6952,4641,3812,8453,15405,24443,34005,6095.48,1281.27,920.99,580.44
02-09-2021,OEIRAS,435,31,245,"[240,480]",Elevado,,,,435,Lisboa e Vale do Tejo,LISBOA,1110,4588.31,177408,11580,11575,8566,6211,5855,12066,20632,32207,43787,3866.78,954.38,701.98,449.69
02-09-2021,OLEIROS,2,0,40,"[0,120]",Baixo a Moderado,,,,2,Centro,CASTELO BRANCO,0506,47109.31,5003,384,341,366,397,487,884,1250,1591,1975,10.62,4.19,3.38,2.65
02-09-2021,OLHÃO,153,11,344,"[240,480]",Elevado,,,,153,Algarve,FARO,0810,13086.38,44405,2455,2309,1689,1342,1268,2610,4299,6608,9063,339.33,69.26,50.5,32.85
02-09-2021,OLIVEIRA DE AZEMÉIS,177,13,268,"[240,480]",Elevado,,,,177,Norte,AVEIRO,0113,16110.41,66011,4155,3614,2794,2183,1738,3921,6715,10329,14484,409.75,89.91,64.12,41.68
02-09-2021,OLIVEIRA DE FRADES,32,2,320,"[240,480]",Elevado,,,,32,Centro,VISEU,1810,14534.62,9936,553,475,438,359,415,774,1212,1687,2240,68.36,15.41,11.61,8.34
02-09-2021,OLIVEIRA DO BAIRRO,28,2,117,"[0,120]",Baixo a Moderado,,,,28,Centro,AVEIRO,0114,8731.99,24277,1327,1182,999,786,810,1596,2595,3777,5104,278.02,58.45,43.25,29.72
02-09-2021,OLIVEIRA DO HOSPITAL,39,3,203,"[120,240]",Moderado,,,,39,Centro,COIMBRA,0611,23451.66,19253,1161,1097,962,924,960,1884,2846,3943,5104,82.1,21.76,16.81,12.14
02-09-2021,OURÉM,143,10,325,"[240,480]",Elevado,,,,143,Lisboa e Vale do Tejo,SANTARÉM,1421,41668.03,44044,2463,2069,1899,1817,1603,3420,5319,7388,9851,105.7,23.64,17.73,12.77
02-09-2021,OURIQUE,4,0,88,"[0,120]",Baixo a Moderado,,,,4,Alentejo,BEJA,0212,66331.36,4607,313,287,284,268,227,495,779,1066,1379,6.95,2.08,1.61,1.17
02-09-2021,OVAR,99,7,182,"[120,240]",Moderado,,,,99,Centro,AVEIRO,0115,14770.25,54260,3294,2709,1994,1636,1234,2870,4864,7573,10867,367.37,73.57,51.27,32.93
02-09-2021,PAÇOS DE FERREIRA,138,10,244,"[240,480]",Elevado,,,,138,Norte,PORTO,1309,7099.29,56728,2903,2193,1518,1135,664,1799,3317,5510,8413,799.1,118.51,77.62,46.72
02-09-2021,PALMELA,130,9,203,"[120,240]",Moderado,,,,130,Lisboa e Vale do Tejo,SETÚBAL,1508,46512.01,64269,3402,3244,2635,1846,1391,3237,5872,9116,12518,138.18,26.91,19.6,12.62
02-09-2021,PAMPILHOSA DA SERRA,6,0,149,"[120,240]",Moderado,,,,6,Centro,COIMBRA,0612,39646.24,4037,238,254,295,339,423,762,1057,1311,1549,10.18,3.91,3.31,2.67
02-09-2021,PAREDES,251,18,292,"[240,480]",Elevado,,,,251,Norte,PORTO,1310,15675.69,86067,4272,3532,2412,1717,1258,2975,5387,8919,13191,549.04,84.15,56.9,34.36
02-09-2021,PAREDES DE COURA,8,1,94,"[0,120]",Baixo a Moderado,,,,8,Norte,VIANA DO CASTELO,1605,13818.59,8535,466,528,407,465,515,980,1387,1915,2381,61.76,17.23,13.86,10.04
02-09-2021,PEDRÓGÃO GRANDE,2,0,59,"[0,120]",Baixo a Moderado,,,,2,Centro,LEIRIA,1013,12874.75,3410,175,173,196,221,252,473,669,842,1017,26.49,7.9,6.54,5.2
02-09-2021,PENACOVA,26,2,191,"[120,240]",Moderado,,,,26,Centro,COIMBRA,0613,21673.23,13694,968,923,745,621,703,1324,2069,2992,3960,63.18,18.27,13.81,9.55
02-09-2021,PENAFIEL,194,14,278,"[240,480]",Elevado,,,,194,Norte,PORTO,1311,21224.27,69772,3648,2823,2032,1663,1230,2893,4925,7748,11396,328.74,53.69,36.51,23.2
02-09-2021,PENALVA DO CASTELO,19,1,266,"[240,480]",Elevado,,,,19,Centro,VISEU,1811,13433.92,7115,449,457,413,391,426,817,1230,1687,2136,52.96,15.9,12.56,9.16
02-09-2021,PENAMACOR,5,0,106,"[0,120]",Baixo a Moderado,,,,5,Centro,CASTELO BRANCO,0507,56370.69,4755,262,248,273,451,633,1084,1357,1605,1867,8.44,3.31,2.85,2.41
02-09-2021,PENEDONO,10,1,389,"[240,480]",Elevado,,,,10,Norte,VISEU,1812,13370.75,2591,172,113,129,156,138,294,423,536,708,19.38,5.3,4.01,3.16
02-09-2021,PENELA,22,2,408,"[240,480]",Elevado,,,,22,Centro,COIMBRA,0614,13480.0,5397,314,324,274,359,344,703,977,1301,1615,40.04,11.98,9.65,7.25
02-09-2021,PENICHE,88,6,333,"[240,480]",Elevado,,,,88,Lisboa e Vale do Tejo,LEIRIA,1014,7754.98,26501,1746,1504,1203,926,707,1633,2836,4340,6086,341.73,78.48,55.96,36.57
02-09-2021,PESO DA RÉGUA,37,3,236,"[120,240]",Moderado,,,,37,Norte,VILA REAL,1708,9486.01,15773,1076,843,650,659,455,1114,1764,2607,3683,166.28,38.83,27.48,18.6
02-09-2021,PINHEL,5,0,59,"[0,120]",Baixo a Moderado,,,,5,Centro,GUARDA,0910,48452.12,8511,577,566,551,538,689,1227,1778,2344,2921,17.57,6.03,4.84,3.67
02-09-2021,POMBAL,270,19,525,"[480,960]",Muito Elevado,,,,270,Centro,LEIRIA,1015,62600.28,51461,3187,2791,2494,2328,2027,4355,6849,9640,12827,82.21,20.49,15.4,10.94
02-09-2021,PONTA DELGADA,123,9,181,"[120,240]",Moderado,,,,123,Açores,AÇORES,4203,23298.65,67935,3108,2435,1726,1133,902,2035,3761,6196,9304,291.58,39.93,26.59,16.14
02-09-2021,PONTA DO SOL,15,1,175,"[120,240]",Moderado,,,,15,Madeira,MADEIRA,3105,4622.03,8593,319,283,347,208,221,429,776,1059,1378,185.92,29.81,22.91,16.79
02-09-2021,PONTE DA BARCA,35,3,315,"[240,480]",Elevado,,,,35,Norte,VIANA DO CASTELO,1606,18211.37,11180,635,576,517,554,490,1044,1561,2137,2772,61.39,15.22,11.73,8.57
02-09-2021,PONTE DE LIMA,95,7,231,"[120,240]",Moderado,,,,95,Norte,VIANA DO CASTELO,1607,32025.46,41315,2321,2022,1720,1596,1462,3058,4778,6800,9121,129.01,28.48,21.23,14.92
02-09-2021,PONTE DE SOR,34,2,229,"[120,240]",Moderado,,,,34,Alentejo,PORTALEGRE,1213,83971.16,14994,939,800,716,739,831,1570,2286,3086,4025,17.86,4.79,3.68,2.72
02-09-2021,PORTALEGRE,38,3,173,"[120,240]",Moderado,,,,38,Alentejo,PORTALEGRE,1214,44713.64,22172,1577,1351,1137,993,984,1977,3114,4465,6042,49.59,13.51,9.99,6.96
02-09-2021,PORTEL,22,2,381,"[240,480]",Elevado,,,,22,Alentejo,ÉVORA,0709,60100.57,5828,336,358,283,331,305,636,919,1277,1613,9.7,2.68,2.12,1.53
02-09-2021,PORTIMÃO,478,34,862,"[480,960]",Muito Elevado,,,,478,Algarve,FARO,0811,18206.29,55483,3182,2927,2116,1582,1400,2982,5098,8025,11207,304.75,61.56,44.08,28.0
02-09-2021,PORTO,700,50,323,"[240,480]",Elevado,,,,700,Norte,PORTO,1312,4142.02,216606,15790,15193,11280,9409,10044,19453,30733,45926,61716,5229.5,1490.0,1108.79,741.98
02-09-2021,PORTO DE MÓS,82,6,352,"[240,480]",Elevado,,,,82,Centro,LEIRIA,1016,26183.41,23275,1355,1210,1034,888,872,1760,2794,4004,5359,88.89,20.47,15.29,10.67
02-09-2021,PORTO MONIZ,2,0,87,"[0,120]",Baixo a Moderado,,,,2,Madeira,MADEIRA,3106,8293.38,2342,143,130,95,98,120,218,313,443,586,28.24,7.07,5.34,3.77
02-09-2021,PORTO SANTO,21,2,404,"[240,480]",Elevado,,,,21,Madeira,MADEIRA,3201,4300.7,5202,240,157,134,110,68,178,312,469,709,120.95,16.48,10.9,7.25
02-09-2021,PÓVOA DE LANHOSO,111,8,517,"[480,960]",Muito Elevado,,,,111,Norte,BRAGA,0309,13465.29,21499,1175,909,732,673,624,1297,2029,2938,4113,159.67,30.55,21.82,15.07
02-09-2021,PÓVOA DE VARZIM,228,16,363,"[240,480]",Elevado,,,,228,Norte,PORTO,1313,8220.59,62784,3712,3120,2134,1594,1305,2899,5033,8153,11865,763.7,144.33,99.17,61.22
02-09-2021,POVOAÇÃO,1,0,17,"[0,120]",Baixo a Moderado,,,,1,Açores,AÇORES,4204,10640.77,5927,293,212,191,144,134,278,469,681,974,55.7,9.15,6.4,4.41
02-09-2021,VILA DA PRAIA DA VITÓRIA,10,1,47,"[0,120]",Baixo a Moderado,,,,10,Açores,AÇORES,4302,16127.06,21317,1133,789,619,436,336,772,1391,2180,3313,132.18,20.54,13.52,8.63
02-09-2021,PROENÇA-A-NOVA,8,1,110,"[0,120]",Baixo a Moderado,,,,8,Centro,CASTELO BRANCO,0508,39539.96,7298,508,465,389,400,560,960,1349,1814,2322,18.46,5.87,4.59,3.41
02-09-2021,REDONDO,17,1,271,"[240,480]",Elevado,,,,17,Alentejo,ÉVORA,0710,36950.87,6353,349,325,288,288,354,642,930,1255,1604,17.19,4.34,3.4,2.52
02-09-2021,REGUENGOS DE MONSARAZ,36,3,363,"[240,480]",Elevado,,,,36,Alentejo,ÉVORA,0711,46399.72,10015,602,511,455,462,473,935,1390,1901,2503,21.58,5.39,4.1,3.0
02-09-2021,RESENDE,34,2,339,"[240,480]",Elevado,,,,34,Norte,VISEU,1813,12334.93,10137,560,493,448,433,422,855,1303,1796,2356,82.18,19.1,14.56,10.56
02-09-2021,RIBEIRA BRAVA,4,0,32,"[0,120]",Baixo a Moderado,,,,4,Madeira,MADEIRA,3107,6544.88,12435,648,500,411,311,287,598,1009,1509,2157,189.99,32.96,23.06,15.42
02-09-2021,RIBEIRA DE PENA,86,6,1436,"[960,Max]",Extremamente Elevado,,,,86,Norte,VILA REAL,1709,21745.98,6016,371,301,290,310,368,678,968,1269,1640,27.66,7.54,5.84,4.45
02-09-2021,RIBEIRA GRANDE,44,3,134,"[120,240]",Moderado,,,,44,Açores,AÇORES,4205,18015.13,32811,1163,689,512,345,253,598,1110,1799,2962,182.13,16.44,9.99,6.16
02-09-2021,RIO MAIOR,28,2,138,"[120,240]",Moderado,,,,28,Lisboa e Vale do Tejo,SANTARÉM,1414,27276.45,20379,1251,1144,941,795,648,1443,2384,3528,4779,74.71,17.52,12.93,8.74
02-09-2021,SABROSA,42,3,714,"[480,960]",Muito Elevado,,,,42,Norte,VILA REAL,1710,15692.45,5918,393,314,304,302,350,652,956,1270,1663,37.71,10.6,8.09,6.09
02-09-2021,SABUGAL,23,2,219,"[120,240]",Moderado,,,,23,Centro,GUARDA,0911,82269.82,10585,724,707,694,796,1009,1805,2499,3206,3930,12.87,4.78,3.9,3.04
02-09-2021,SALVATERRA DE MAGOS,39,3,184,"[120,240]",Moderado,,,,39,Lisboa e Vale do Tejo,SANTARÉM,1415,24393.2,21295,1275,1181,1060,799,772,1571,2631,3812,5087,87.3,20.85,15.63,10.79
02-09-2021,SANTA COMBA DÃO,15,1,144,"[120,240]",Moderado,,,,15,Centro,VISEU,1814,11194.77,10452,732,684,569,538,464,1002,1571,2255,2987,93.36,26.68,20.14,14.03
02-09-2021,SANTA CRUZ,58,4,127,"[120,240]",Moderado,,,,58,Madeira,MADEIRA,3108,8150.28,45281,1817,1301,974,716,523,1239,2213,3514,5331,555.6,65.41,43.12,27.15
02-09-2021,SANTA CRUZ DA GRACIOSA,7,1,168,"[120,240]",Moderado,,,,7,Açores,AÇORES,4401,6065.78,4208,228,180,163,124,145,269,432,612,840,69.37,13.85,10.09,7.12
02-09-2021,SANTA CRUZ DAS FLORES,0,0,0,"[0,120]",Baixo a Moderado,,,,0,Açores,AÇORES,4802,7091.44,2165,125,98,74,56,51,107,181,279,404,30.53,5.7,3.93,2.55
02-09-2021,SANTA MARIA DA FEIRA,254,18,183,"[120,240]",Moderado,,,,254,Norte,AVEIRO,0109,21587.65,138636,8182,6743,4771,3856,3079,6935,11706,18449,26631,642.19,123.36,85.46,54.22
02-09-2021,SANTA MARTA DE PENAGUIÃO,9,1,137,"[120,240]",Moderado,,,,9,Norte,VILA REAL,1711,6928.13,6599,483,373,337,316,317,633,970,1343,1826,95.25,26.36,19.39,14.0
02-09-2021,SANTANA,27,2,406,"[240,480]",Elevado,,,,27,Madeira,MADEIRA,3109,9547.3,6711,418,353,343,282,277,559,902,1255,1673,70.29,17.52,13.15,9.45
02-09-2021,SANTARÉM,76,5,133,"[120,240]",Moderado,,,,76,Lisboa e Vale do Tejo,SANTARÉM,1416,55253.58,57421,3654,3441,2760,2466,2206,4672,7432,10873,14527,103.92,26.29,19.68,13.45
02-09-2021,SANTIAGO DO CACÉM,67,5,234,"[120,240]",Moderado,,,,67,Alentejo,SETÚBAL,1509,105969.29,28791,2144,1689,1472,1295,1215,2510,3982,5671,7815,27.17,7.37,5.35,3.76
02-09-2021,SANTO TIRSO,147,10,216,"[120,240]",Moderado,,,,147,Norte,PORTO,1314,13655.52,68055,4911,3935,2761,2257,1810,4067,6828,10763,15674,498.35,114.78,78.82,50.0
02-09-2021,SÃO BRÁS DE ALPORTEL,38,3,366,"[240,480]",Elevado,,,,38,Algarve,FARO,0812,15336.92,10416,596,468,467,404,401,805,1272,1740,2336,67.91,15.23,11.35,8.29
02-09-2021,SÃO JOÃO DA MADEIRA,101,7,458,"[240,480]",Elevado,,,,101,Norte,AVEIRO,0116,794.3,21958,1347,1069,796,601,593,1194,1990,3059,4406,2765.49,554.91,385.26,250.63
02-09-2021,SÃO JOÃO DA PESQUEIRA,3,0,42,"[0,120]",Baixo a Moderado,,,,3,Norte,VISEU,1815,26610.85,7125,417,330,294,328,328,656,950,1280,1697,26.77,6.38,4.81,3.57
02-09-2021,SÃO PEDRO DO SUL,73,5,473,"[240,480]",Elevado,,,,73,Centro,VISEU,1816,34895.09,15403,990,962,861,759,909,1668,2529,3491,4481,44.14,12.84,10.0,7.25
02-09-2021,SÃO ROQUE DO PICO,2,0,61,"[0,120]",Baixo a Moderado,,,,2,Açores,AÇORES,4603,14236.1,3266,199,141,93,96,113,209,302,443,642,22.94,4.51,3.11,2.12
02-09-2021,SÃO VICENTE,11,1,215,"[120,240]",Moderado,,,,11,Madeira,MADEIRA,3110,7883.71,5143,272,264,266,225,280,505,771,1035,1307,65.23,16.58,13.13,9.78
02-09-2021,SARDOAL,3,0,81,"[0,120]",Baixo a Moderado,,,,3,Lisboa e Vale do Tejo,SANTARÉM,1417,9214.72,3741,227,178,148,165,248,413,561,739,966,40.6,10.48,8.02,6.09
02-09-2021,SÁTÃO,20,1,172,"[120,240]",Moderado,,,,20,Centro,VISEU,1817,20194.11,11580,765,671,515,465,476,941,1456,2127,2892,57.34,14.32,10.53,7.21
02-09-2021,SEIA,25,2,113,"[0,120]",Baixo a Moderado,,,,25,Centro,GUARDA,0912,43568.83,22234,1807,1589,1238,1122,721,1843,3081,4670,6477,51.03,14.87,10.72,7.07
02-09-2021,SEIXAL,346,25,206,"[120,240]",Moderado,,,,346,Lisboa e Vale do Tejo,SETÚBAL,1510,9545.17,167752,10586,9270,6661,4391,2930,7321,13982,23252,33838,1757.49,354.51,243.6,146.49
02-09-2021,SERNANCELHE,8,1,149,"[120,240]",Moderado,,,,8,Norte,VISEU,1818,22861.22,5396,305,293,286,273,260,533,819,1112,1417,23.6,6.2,4.86,3.58
02-09-2021,SERPA,47,3,332,"[240,480]",Elevado,,,,47,Alentejo,BEJA,0213,110563.34,14304,903,761,719,697,626,1323,2042,2803,3706,12.94,3.35,2.54,1.85
02-09-2021,SERTÃ,4,0,27,"[0,120]",Baixo a Moderado,,,,4,Centro,CASTELO BRANCO,0509,44673.17,14577,870,779,790,767,1020,1787,2577,3356,4226,32.63,9.46,7.51,5.77
02-09-2021,SESIMBRA,151,11,291,"[240,480]",Elevado,,,,151,Lisboa e Vale do Tejo,SETÚBAL,1511,19571.75,51858,2400,2321,1853,1257,1083,2340,4193,6514,8914,264.96,45.54,33.28,21.42
02-09-2021,SETÚBAL,236,17,205,"[120,240]",Moderado,,,,236,Lisboa e Vale do Tejo,SETÚBAL,1512,23032.5,115126,7425,6929,5075,3775,2655,6430,11505,18434,25859,499.83,112.27,80.03,49.95
02-09-2021,SEVER DO VOUGA,13,1,115,"[0,120]",Baixo a Moderado,,,,13,Centro,AVEIRO,0117,12987.56,11331,766,637,568,540,567,1107,1675,2312,3078,87.24,23.7,17.8,12.9
02-09-2021,SILVES,134,10,370,"[240,480]",Elevado,,,,134,Algarve,FARO,0813,68006.23,36226,2137,1869,1610,1423,1600,3023,4633,6502,8639,53.27,12.7,9.56,6.81
02-09-2021,SINES,50,4,365,"[240,480]",Elevado,,,,50,Alentejo,SETÚBAL,1513,20330.17,13715,888,791,551,416,268,684,1235,2026,2914,67.46,14.33,9.97,6.07
02-09-2021,SINTRA,873,62,223,"[120,240]",Moderado,,,,873,Lisboa e Vale do Tejo,LISBOA,1111,31922.73,391402,20490,18316,13545,9137,7284,16421,29966,48282,68772,1226.08,215.43,151.25,93.87
02-09-2021,SOBRAL DE MONTE AGRAÇO,22,2,203,"[120,240]",Moderado,,,,22,Lisboa e Vale do Tejo,LISBOA,1112,5210.32,10651,564,507,352,272,212,484,836,1343,1907,204.43,36.6,25.78,16.05
02-09-2021,SOURE,46,3,270,"[240,480]",Elevado,,,,46,Centro,COIMBRA,0615,26506.07,17120,1173,1142,1004,883,987,1870,2874,4016,5189,64.59,19.58,15.15,10.84
02-09-2021,SOUSEL,28,2,624,"[480,960]",Muito Elevado,,,,28,Alentejo,PORTALEGRE,1215,27932.18,4412,261,274,208,302,292,594,802,1076,1337,15.8,4.79,3.85,2.87
02-09-2021,TÁBUA,52,4,455,"[240,480]",Elevado,,,,52,Centro,COIMBRA,0616,19978.58,11368,729,584,524,430,464,894,1418,2002,2731,56.9,13.67,10.02,7.1
02-09-2021,TABUAÇO,0,0,0,"[0,120]",Baixo a Moderado,,,,0,Norte,VISEU,1819,13385.67,6033,372,314,217,282,363,645,862,1176,1548,45.07,11.56,8.79,6.44
02-09-2021,TAROUCA,13,1,166,"[120,240]",Moderado,,,,13,Norte,VISEU,1820,10008.49,7804,405,335,313,277,324,601,914,1249,1654,77.98,16.53,12.48,9.13
02-09-2021,TAVIRA,87,6,354,"[240,480]",Elevado,,,,87,Algarve,FARO,0814,60696.7,24530,1493,1415,1252,1066,1277,2343,3595,5010,6503,40.41,10.71,8.25,5.92
02-09-2021,TERRAS DE BOURO,24,2,380,"[240,480]",Elevado,,,,24,Norte,BRAGA,0310,27746.07,6361,391,372,296,319,340,659,955,1327,1718,22.93,6.19,4.78,3.44
02-09-2021,TOMAR,40,3,109,"[0,120]",Baixo a Moderado,,,,40,Lisboa e Vale do Tejo,SANTARÉM,1418,35120.44,36748,2403,2189,1868,1853,1822,3675,5543,7732,10135,104.64,28.86,22.02,15.78
02-09-2021,TONDELA,41,3,156,"[120,240]",Moderado,,,,41,Centro,VISEU,1821,37121.73,26357,1768,1722,1518,1475,1417,2892,4410,6132,7900,71.0,21.28,16.52,11.88
02-09-2021,TORRE DE MONCORVO,5,0,66,"[0,120]",Baixo a Moderado,,,,5,Norte,BRAGANÇA,0409,53155.67,7695,556,478,488,551,719,1270,1758,2236,2792,14.48,5.25,4.21,3.31
02-09-2021,TORRES NOVAS,68,5,194,"[120,240]",Moderado,,,,68,Lisboa e Vale do Tejo,SANTARÉM,1419,26999.68,34933,2324,1979,1738,1406,1475,2881,4619,6598,8922,129.38,33.04,24.44,17.11
02-09-2021,TORRES VEDRAS,137,10,174,"[120,240]",Moderado,,,,137,Lisboa e Vale do Tejo,LISBOA,1113,40714.89,78530,4513,3945,3447,2628,2104,4732,8179,12124,16637,192.88,40.86,29.78,20.09
02-09-2021,TRANCOSO,9,1,101,"[0,120]",Baixo a Moderado,,,,9,Centro,GUARDA,0913,36152.47,8875,581,557,542,586,496,1082,1624,2181,2762,24.55,7.64,6.03,4.49
02-09-2021,TROFA,74,5,192,"[120,240]",Moderado,,,,74,Norte,PORTO,1318,7201.76,38418,2336,1894,1231,939,684,1623,2854,4748,7084,533.44,98.36,65.93,39.63
02-09-2021,VAGOS,29,2,126,"[120,240]",Moderado,,,,29,Centro,AVEIRO,0118,16491.5,22740,1320,1205,922,784,724,1508,2430,3635,4955,137.89,30.04,22.04,14.73
02-09-2021,VALE DE CAMBRA,80,6,373,"[240,480]",Elevado,,,,80,Norte,AVEIRO,0119,14733.47,21327,1491,1363,1005,831,798,1629,2634,3997,5488,144.76,37.25,27.13,17.88
02-09-2021,VALENÇA,28,2,212,"[120,240]",Moderado,,,,28,Norte,VIANA DO CASTELO,1608,11712.86,13290,867,791,582,582,503,1085,1667,2458,3325,113.46,28.39,20.99,14.23
02-09-2021,VALONGO,160,11,164,"[120,240]",Moderado,,,,160,Norte,PORTO,1315,7512.45,97444,5629,4696,3207,2462,1829,4291,7498,12194,17823,1297.18,237.26,162.33,99.81
02-09-2021,VALPAÇOS,70,5,471,"[240,480]",Elevado,,,,70,Norte,VILA REAL,1712,54873.93,14818,1217,1118,999,928,997,1925,2924,4042,5259,27.0,9.58,7.37,5.33
02-09-2021,VELAS,1,0,20,"[0,120]",Baixo a Moderado,,,,1,Açores,AÇORES,4502,11738.38,5093,278,208,166,153,113,266,432,640,918,43.39,7.82,5.45,3.68
02-09-2021,VENDAS NOVAS,39,3,349,"[240,480]",Elevado,,,,39,Alentejo,ÉVORA,0712,22238.88,11255,677,768,655,501,532,1033,1688,2456,3133,50.61,14.09,11.04,7.59
02-09-2021,VIANA DO ALENTEJO,15,1,294,"[240,480]",Elevado,,,,15,Alentejo,ÉVORA,0713,39367.29,5145,245,208,235,210,214,424,659,867,1112,13.07,2.82,2.2,1.67
02-09-2021,VIANA DO CASTELO,205,15,243,"[240,480]",Elevado,,,,205,Norte,VIANA DO CASTELO,1609,31902.01,84417,5470,4433,3591,3061,2982,6043,9634,14067,19537,264.61,61.24,44.09,30.2
02-09-2021,VIDIGUEIRA,4,0,73,"[0,120]",Baixo a Moderado,,,,4,Alentejo,BEJA,0214,31661.09,5510,300,248,215,233,275,508,723,971,1271,17.4,4.01,3.07,2.28
02-09-2021,VIEIRA DO MINHO,43,3,365,"[240,480]",Elevado,,,,43,Norte,BRAGA,0311,21644.35,11842,703,594,525,548,482,1030,1555,2149,2852,54.71,13.18,9.93,7.18
02-09-2021,VILA DE REI,0,0,0,"[0,120]",Baixo a Moderado,,,,0,Centro,CASTELO BRANCO,0510,19154.6,3323,169,128,172,247,302,549,721,849,1018,17.35,5.31,4.43,3.76
02-09-2021,VILA DO BISPO,37,3,719,"[480,960]",Muito Elevado,,,,37,Algarve,FARO,0815,17906.06,5154,302,302,314,232,233,465,779,1081,1383,28.78,7.72,6.04,4.35
02-09-2021,VILA DO CONDE,246,18,308,"[240,480]",Elevado,,,,246,Norte,PORTO,1316,14902.77,79899,4726,3875,2819,2070,1743,3813,6632,10507,15233,536.13,102.21,70.5,44.5
02-09-2021,VILA DO PORTO,0,0,0,"[0,120]",Baixo a Moderado,,,,0,Açores,AÇORES,4101,9688.74,5616,274,212,135,96,123,219,354,566,840,57.96,8.67,5.84,3.65
02-09-2021,VILA FLOR,10,1,166,"[120,240]",Moderado,,,,10,Norte,BRAGANÇA,0410,26581.14,6044,429,362,422,294,331,625,1047,1409,1838,22.74,6.91,5.3,3.94
02-09-2021,VILA FRANCA DE XIRA,300,21,211,"[120,240]",Moderado,,,,300,Lisboa e Vale do Tejo,LISBOA,1114,31819.39,141957,8501,6852,4869,3425,2472,5897,10766,17618,26119,446.14,82.09,55.37,33.84
02-09-2021,VILA FRANCA DO CAMPO,8,1,73,"[0,120]",Baixo a Moderado,,,,8,Açores,AÇORES,4206,7796.82,11051,450,344,248,217,154,371,619,963,1413,141.73,18.12,12.35,7.94
02-09-2021,VILA NOVA DA BARQUINHA,10,1,132,"[120,240]",Moderado,,,,10,Lisboa e Vale do Tejo,SANTARÉM,1420,4952.97,7461,415,406,392,364,338,702,1094,1500,1915,150.64,38.66,30.28,22.09
02-09-2021,VILA NOVA DE CERVEIRA,25,2,281,"[240,480]",Elevado,,,,25,Norte,VIANA DO CASTELO,1610,10846.66,8910,531,444,410,384,334,718,1128,1572,2103,82.14,19.39,14.49,10.4
02-09-2021,VILA NOVA DE FAMALICÃO,502,36,381,"[240,480]",Elevado,,,,502,Norte,BRAGA,0312,20159.26,131676,7817,6164,4202,3282,2749,6031,10233,16397,24214,653.19,120.12,81.34,50.76
02-09-2021,VILA NOVA DE FOZ CÔA,8,1,125,"[120,240]",Moderado,,,,8,Centro,GUARDA,0914,39815.18,6503,442,385,390,398,429,827,1217,1602,2044,16.33,5.13,4.02,3.06
02-09-2021,VILA NOVA DE GAIA,568,41,189,"[120,240]",Moderado,,,,568,Norte,PORTO,1317,16846.43,300472,18349,15568,10972,8224,6281,14505,25477,41045,59394,1783.64,352.57,243.65,151.23
02-09-2021,VILA NOVA DE PAIVA,13,1,277,"[240,480]",Elevado,,,,13,Centro,VISEU,1822,17553.28,4687,289,272,233,217,241,458,691,963,1252,26.7,7.13,5.49,3.94
02-09-2021,VILA NOVA DE POIARES,18,1,259,"[240,480]",Elevado,,,,18,Centro,COIMBRA,0617,8445.3,6939,380,284,262,235,182,417,679,963,1343,82.17,15.9,11.4,8.04
02-09-2021,VILA POUCA DE AGUIAR,89,6,742,"[480,960]",Muito Elevado,,,,89,Norte,VILA REAL,1713,43706.62,11961,860,817,733,601,627,1228,1961,2778,3638,27.37,8.32,6.36,4.49
02-09-2021,VILA REAL,130,9,261,"[240,480]",Elevado,,,,130,Norte,VILA REAL,1714,37880.28,49962,3025,2498,2065,1579,1466,3045,5110,7608,10633,131.9,28.07,20.08,13.49
02-09-2021,VILA REAL DE SANTO ANTÓNIO,49,4,263,"[240,480]",Elevado,,,,49,Algarve,FARO,0816,6125.0,18749,1172,1069,811,569,586,1155,1966,3035,4207,306.11,68.69,49.55,32.1
02-09-2021,VILA VELHA DE RÓDÃO,9,1,286,"[240,480]",Elevado,,,,9,Centro,CASTELO BRANCO,0511,32991.16,3144,209,229,180,283,306,589,769,998,1207,9.53,3.66,3.03,2.33
02-09-2021,VILA VERDE,359,26,765,"[480,960]",Muito Elevado,,,,359,Norte,BRAGA,0313,22866.52,46911,2365,2063,1667,1494,1437,2931,4598,6661,9026,205.15,39.47,29.13,20.11
02-09-2021,VILA VIÇOSA,32,2,423,"[240,480]",Elevado,,,,32,Alentejo,ÉVORA,0714,19485.89,7656,487,379,342,345,324,669,1011,1390,1877,39.29,9.63,7.13,5.19
02-09-2021,VIMIOSO,11,1,278,"[240,480]",Elevado,,,,11,Norte,BRAGANÇA,0411,48158.51,4023,274,230,261,293,335,628,889,1119,1393,8.35,2.89,2.32,1.85
02-09-2021,VINHAIS,8,1,105,"[0,120]",Baixo a Moderado,,,,8,Norte,BRAGANÇA,0412,69475.09,7746,599,577,636,641,815,1456,2092,2669,3268,11.15,4.7,3.84,3.01
02-09-2021,VISEU,385,28,396,"[240,480]",Elevado,,,,385,Centro,VISEU,1823,50710.14,97249,5769,5038,4140,3158,2710,5868,10008,15046,20815,191.77,41.05,29.67,19.74
02-09-2021,VIZELA,78,6,326,"[240,480]",Elevado,,,,78,Norte,BRAGA,0314,2469.83,23897,1258,928,655,509,371,880,1535,2463,3721,967.49,150.65,99.72,62.15
02-09-2021,VOUZELA,11,1,114,"[0,120]",Baixo a Moderado,,,,11,Centro,VISEU,1824,19369.46,9619,626,605,554,532,507,1039,1593,2198,2824,49.66,14.58,11.35,8.22
09-09-2021,ABRANTES,45,3,129,"[120,240]",Moderado,,,,45,Lisboa e Vale do Tejo,SANTARÉM,1401,71469.08,35130,2473,2213,1730,1748,2021,3769,5499,7712,10185,49.15,14.25,10.79,7.69
09-09-2021,ÁGUEDA,49,3,106,"[0,120]",Baixo a Moderado,,,,49,Centro,AVEIRO,0101,33527.44,46075,3237,2713,2090,1635,1496,3131,5221,7934,11171,137.43,33.32,23.66,15.57
09-09-2021,AGUIAR DA BEIRA,3,0,65,"[0,120]",Baixo a Moderado,,,,3,Centro,GUARDA,0901,20676.57,4652,304,281,235,239,148,387,622,903,1207,22.5,5.84,4.37,3.01
09-09-2021,ALANDROAL,1,0,20,"[0,120]",Baixo a Moderado,,,,1,Alentejo,ÉVORA,0701,54267.81,4992,307,256,296,299,377,676,972,1228,1535,9.2,2.83,2.26,1.79
09-09-2021,ALBERGARIA-A-VELHA,23,2,95,"[0,120]",Baixo a Moderado,,,,23,Centro,AVEIRO,0102,15882.5,24144,1550,1298,996,687,680,1367,2363,3661,5211,152.02,32.81,23.05,14.88
09-09-2021,ALBUFEIRA,414,30,997,"[960,Max]",Extremamente Elevado,,,,414,Algarve,FARO,0801,14066.42,41528,2067,1717,1425,985,858,1843,3268,4985,7052,295.24,50.14,35.44,23.23
09-09-2021,ALCÁCER DO SAL,8,1,69,"[0,120]",Baixo a Moderado,,,,8,Alentejo,SETÚBAL,1501,149987.3,11659,884,814,623,623,602,1225,1848,2662,3546,7.77,2.36,1.77,1.23
09-09-2021,ALCANENA,28,2,218,"[120,240]",Moderado,,,,28,Lisboa e Vale do Tejo,SANTARÉM,1402,12732.86,12809,891,744,628,536,588,1124,1752,2496,3387,100.6,26.6,19.6,13.76
09-09-2021,ALCOBAÇA,89,6,167,"[120,240]",Moderado,,,,89,Lisboa e Vale do Tejo,LEIRIA,1001,40814.09,53555,3420,2927,2466,2059,1676,3735,6201,9128,12548,131.22,30.74,22.36,15.19
09-09-2021,ALCOCHETE,34,2,171,"[120,240]",Moderado,,,,34,Lisboa e Vale do Tejo,SETÚBAL,1502,12836.48,19787,857,834,691,476,447,923,1614,2448,3305,154.15,25.75,19.07,12.57
09-09-2021,ALCOUTIM,2,0,96,"[0,120]",Baixo a Moderado,,,,2,Algarve,FARO,0802,57536.33,2159,191,188,163,190,267,457,620,808,999,3.75,1.74,1.4,1.08
09-09-2021,ALENQUER,63,4,143,"[120,240]",Moderado,,,,63,Lisboa e Vale do Tejo,LISBOA,1101,30421.92,44052,2298,2062,1629,1330,1155,2485,4114,6176,8474,144.8,27.85,20.3,13.52
09-09-2021,ALFÂNDEGA DA FÉ,3,0,67,"[0,120]",Baixo a Moderado,,,,3,Norte,BRAGANÇA,0401,32194.64,4550,325,277,301,274,325,599,900,1177,1502,14.13,4.67,3.66,2.8
09-09-2021,ALIJÓ,21,2,199,"[120,240]",Moderado,,,,21,Norte,VILA REAL,1701,29759.89,10625,766,687,635,542,666,1208,1843,2530,3296,35.7,11.08,8.5,6.19
09-09-2021,ALJEZUR,7,0,125,"[120,240]",Moderado,,,,7,Algarve,FARO,0803,32349.95,5594,316,336,335,320,410,730,1065,1401,1717,17.29,5.31,4.33,3.29
09-09-2021,ALJUSTREL,26,2,319,"[240,480]",Elevado,,,,26,Alentejo,BEJA,0201,45847.41,8247,635,521,443,347,358,705,1148,1669,2304,17.99,5.03,3.64,2.5
09-09-2021,ALMADA,363,26,215,"[120,240]",Moderado,,,,363,Lisboa e Vale do Tejo,SETÚBAL,1503,7000.89,169039,10469,9777,7876,6144,5111,11255,19131,28908,39377,2414.5,562.45,412.91,273.26
09-09-2021,ALMEIDA,11,1,190,"[120,240]",Moderado,,,,11,Centro,GUARDA,0902,51798.46,5830,441,419,396,458,393,851,1247,1666,2107,11.26,4.07,3.22,2.41
09-09-2021,ALMEIRIM,30,2,134,"[120,240]",Moderado,,,,30,Lisboa e Vale do Tejo,SANTARÉM,1403,22212.05,22546,1342,1353,1106,866,843,1709,2815,4168,5510,101.5,24.81,18.76,12.67
09-09-2021,ALMODÔVAR,12,1,180,"[120,240]",Moderado,,,,12,Alentejo,BEJA,0202,77788.03,6725,414,443,396,373,328,701,1097,1540,1954,8.65,2.51,1.98,1.41
09-09-2021,ALPIARÇA,8,1,115,"[0,120]",Baixo a Moderado,,,,8,Lisboa e Vale do Tejo,SANTARÉM,1404,9536.33,7059,515,486,363,333,274,607,970,1456,1971,74.02,20.67,15.27,10.17
09-09-2021,ALTER DO CHÃO,11,1,351,"[240,480]",Elevado,,,,11,Alentejo,PORTALEGRE,1201,36206.62,3165,201,163,136,208,187,395,531,694,895,8.74,2.47,1.92,1.47
09-09-2021,ALVAIÁZERE,1,0,15,"[0,120]",Baixo a Moderado,,,,1,Centro,LEIRIA,1002,16047.76,6597,419,389,346,406,539,945,1291,1680,2099,41.11,13.08,10.47,8.04
09-09-2021,ALVITO,7,1,284,"[240,480]",Elevado,,,,7,Alentejo,BEJA,0203,26485.32,2477,145,110,105,111,89,200,305,415,560,9.35,2.11,1.57,1.15
09-09-2021,AMADORA,425,30,231,"[120,240]",Moderado,,,,425,Lisboa e Vale do Tejo,LISBOA,1115,2378.47,184106,11186,10936,8780,6460,5890,12350,21130,32066,43252,7742.05,1818.84,1348.44,888.56
09-09-2021,AMARANTE,72,5,136,"[120,240]",Moderado,,,,72,Norte,PORTO,1301,30133.15,53193,3086,2413,1812,1643,1311,2954,4766,7179,10265,176.53,34.07,23.82,15.82
09-09-2021,AMARES,112,8,619,"[480,960]",Muito Elevado,,,,112,Norte,BRAGA,0301,8195.41,18129,1001,829,622,489,524,1013,1635,2464,3465,221.22,42.28,30.07,19.95
09-09-2021,ANADIA,42,3,153,"[120,240]",Moderado,,,,42,Centro,AVEIRO,0103,21663.48,27258,1931,1698,1376,1208,1262,2470,3846,5544,7475,125.83,34.51,25.59,17.75
09-09-2021,ANGRA DO HEROÍSMO,14,1,42,"[0,120]",Baixo a Moderado,,,,14,Açores,AÇORES,4301,23899.66,33807,2006,1473,1122,768,635,1403,2525,3998,6004,141.45,25.12,16.73,10.56
09-09-2021,ANSIÃO,8,1,66,"[0,120]",Baixo a Moderado,,,,8,Centro,LEIRIA,1003,17609.42,12039,727,709,646,694,530,1224,1870,2579,3306,68.37,18.77,14.65,10.62
09-09-2021,ARCOS DE VALDEVEZ,46,3,221,"[120,240]",Moderado,,,,46,Norte,VIANA DO CASTELO,1601,44759.64,20926,1329,1338,1282,1343,1515,2858,4140,5478,6807,46.75,15.21,12.24,9.25
09-09-2021,ARGANIL,23,2,209,"[120,240]",Moderado,,,,23,Centro,COIMBRA,0601,33283.93,11014,672,648,612,559,596,1155,1767,2415,3087,33.09,9.27,7.26,5.31
09-09-2021,ARMAMAR,1,0,17,"[0,120]",Baixo a Moderado,,,,1,Norte,VISEU,1801,11723.73,5769,357,305,309,285,310,595,904,1209,1566,49.21,13.36,10.31,7.71
09-09-2021,AROUCA,93,7,451,"[240,480]",Elevado,,,,93,Norte,AVEIRO,0104,32910.52,20720,1306,1047,753,683,683,1366,2119,3166,4472,62.96,13.59,9.62,6.44
09-09-2021,ARRAIOLOS,12,1,175,"[120,240]",Moderado,,,,12,Alentejo,ÉVORA,0702,68374.55,6928,435,384,283,367,480,847,1130,1514,1949,10.13,2.85,2.21,1.65
09-09-2021,ARRONCHES,4,0,145,"[120,240]",Moderado,,,,4,Alentejo,PORTALEGRE,1202,31464.72,2820,155,142,162,187,179,366,528,670,825,8.96,2.62,2.13,1.68
09-09-2021,ARRUDA DOS VINHOS,26,2,171,"[120,240]",Moderado,,,,26,Lisboa e Vale do Tejo,LISBOA,1102,7795.93,15412,738,738,562,509,438,947,1509,2247,2985,197.69,38.29,28.82,19.36
09-09-2021,AVEIRO,90,6,114,"[0,120]",Baixo a Moderado,,,,90,Centro,AVEIRO,0105,19757.57,78734,4520,4004,3050,2250,2103,4353,7403,11407,15927,398.49,80.61,57.73,37.47
09-09-2021,AVIS,0,0,0,"[0,120]",Baixo a Moderado,,,,0,Alentejo,PORTALEGRE,1203,60596.51,4247,315,225,206,251,273,524,730,955,1270,7.01,2.1,1.58,1.2
09-09-2021,AZAMBUJA,23,2,101,"[0,120]",Baixo a Moderado,,,,23,Lisboa e Vale do Tejo,LISBOA,1103,26265.65,22716,1322,1171,1070,798,618,1416,2486,3657,4979,86.48,18.96,13.92,9.46
09-09-2021,BAIÃO,18,1,97,"[0,120]",Baixo a Moderado,,,,18,Norte,PORTO,1302,17452.83,18748,1070,862,714,686,725,1411,2125,2987,4057,107.42,23.25,17.11,12.18
09-09-2021,BARCELOS,432,31,372,"[240,480]",Elevado,,,,432,Norte,BRAGA,0302,37890.14,116187,6721,5325,3619,2991,2562,5553,9172,14497,21218,306.64,56.0,38.26,24.21
09-09-2021,BARRANCOS,4,0,246,"[240,480]",Elevado,,,,4,Alentejo,BEJA,0204,16841.73,1634,90,65,65,94,61,155,220,285,375,9.7,2.23,1.69,1.31
09-09-2021,BARREIRO,128,9,170,"[120,240]",Moderado,,,,128,Lisboa e Vale do Tejo,SETÚBAL,1504,3639.07,75147,5194,5565,4459,3105,1767,4872,9331,14896,20090,2065.05,552.07,409.34,256.42
09-09-2021,BATALHA,43,3,272,"[240,480]",Elevado,,,,43,Centro,LEIRIA,1004,10341.6,15963,873,762,649,529,549,1078,1727,2489,3362,154.35,32.51,24.07,16.7
09-09-2021,BEJA,198,14,591,"[480,960]",Muito Elevado,,,,198,Alentejo,BEJA,0205,114647.55,33579,2005,1840,1386,1272,1039,2311,3697,5537,7542,29.29,6.58,4.83,3.22
09-09-2021,BELMONTE,27,2,423,"[240,480]",Elevado,,,,27,Centro,CASTELO BRANCO,0501,11875.91,6398,444,321,325,310,355,665,990,1311,1755,53.87,14.78,11.04,8.34
09-09-2021,BENAVENTE,103,7,335,"[240,480]",Elevado,,,,103,Lisboa e Vale do Tejo,SANTARÉM,1405,52138.39,30602,1468,1376,1141,876,643,1519,2660,4036,5504,58.69,10.56,7.74,5.1
09-09-2021,BOMBARRAL,15,1,118,"[0,120]",Baixo a Moderado,,,,15,Lisboa e Vale do Tejo,LEIRIA,1005,9128.55,12558,875,714,561,491,429,920,1481,2195,3070,137.56,33.63,24.04,16.22
09-09-2021,BORBA,16,1,240,"[240,480]",Elevado,,,,16,Alentejo,ÉVORA,0703,14518.65,6736,430,375,279,436,392,828,1107,1482,1912,46.39,13.17,10.21,7.62
09-09-2021,BOTICAS,28,2,568,"[480,960]",Muito Elevado,,,,28,Norte,VILA REAL,1702,32195.66,4998,347,306,311,305,380,685,996,1302,1649,15.52,5.12,4.04,3.09
09-09-2021,BRAGA,659,47,361,"[240,480]",Elevado,,,,659,Norte,BRAGA,0303,18339.95,182679,10029,7963,5241,4320,3671,7991,13232,21195,31224,996.07,170.25,115.57,72.15
09-09-2021,BRAGANÇA,69,5,206,"[120,240]",Moderado,,,,69,Norte,BRAGANÇA,0402,117357.27,33607,2402,1855,1652,1393,1163,2556,4208,6063,8465,28.64,7.21,5.17,3.59
09-09-2021,CABECEIRAS DE BASTO,71,5,457,"[240,480]",Elevado,,,,71,Norte,BRAGA,0304,24182.16,15628,774,594,544,575,574,1149,1693,2287,3061,64.63,12.66,9.46,7.0
09-09-2021,CADAVAL,18,1,131,"[120,240]",Moderado,,,,18,Lisboa e Vale do Tejo,LISBOA,1104,17489.3,13673,813,796,756,621,625,1246,2002,2798,3611,78.18,20.65,16.0,11.45
09-09-2021,CALDAS DA RAINHA,72,5,139,"[120,240]",Moderado,,,,72,Lisboa e Vale do Tejo,LEIRIA,1006,25569.47,51912,3035,2684,2186,1899,1705,3604,5790,8474,11509,203.03,45.01,33.14,22.64
09-09-2021,CALHETA,7,1,65,"[0,120]",Baixo a Moderado,,,,7,Madeira,MADEIRA,3101,11150.43,10867,576,497,507,399,415,814,1321,1818,2394,97.46,21.47,16.3,11.85
09-09-2021,CALHETA (AÇORES),0,0,0,"[0,120]",Baixo a Moderado,,,,0,Açores,AÇORES,4501,12626.4,3184,215,159,141,139,122,261,402,561,776,25.22,6.15,4.44,3.18
09-09-2021,CÂMARA DE LOBOS,25,2,74,"[0,120]",Baixo a Moderado,,,,25,Madeira,MADEIRA,3102,5216.67,33675,1396,1059,834,545,381,926,1760,2819,4215,645.49,80.79,54.03,33.74
09-09-2021,CAMINHA,26,2,165,"[120,240]",Moderado,,,,26,Norte,VIANA DO CASTELO,1602,13652.14,15877,1046,944,818,646,656,1302,2120,3064,4110,116.3,30.11,22.44,15.53
09-09-2021,CAMPO MAIOR,36,3,462,"[240,480]",Elevado,,,,36,Alentejo,PORTALEGRE,1204,24720.16,7874,471,364,351,279,327,606,957,1321,1792,31.85,7.25,5.34,3.87
09-09-2021,CANTANHEDE,101,7,288,"[240,480]",Elevado,,,,101,Centro,COIMBRA,0602,39088.02,35011,2346,2096,1880,1709,1451,3160,5040,7136,9482,89.57,24.26,18.26,12.89
09-09-2021,CARRAZEDA DE ANSIÃES,1,0,18,"[0,120]",Baixo a Moderado,,,,1,Norte,BRAGANÇA,0403,27924.09,5666,424,389,391,312,465,777,1168,1557,1981,20.29,7.09,5.58,4.18
09-09-2021,CARREGAL DO SAL,12,1,129,"[120,240]",Moderado,,,,12,Centro,VISEU,1802,11689.21,9271,587,562,486,462,376,838,1324,1886,2473,79.31,21.16,16.13,11.33
09-09-2021,CARTAXO,33,2,139,"[120,240]",Moderado,,,,33,Lisboa e Vale do Tejo,SANTARÉM,1406,15817.28,23843,1415,1376,1142,861,632,1493,2635,4011,5426,150.74,34.3,25.36,16.66
09-09-2021,CASCAIS,478,34,224,"[120,240]",Moderado,,,,478,Lisboa e Vale do Tejo,LISBOA,1105,9740.17,213608,12151,11444,8680,6469,5248,11717,20397,31841,43992,2193.1,451.66,326.91,209.41
09-09-2021,CASTANHEIRA DE PÊRA,4,0,155,"[120,240]",Moderado,,,,4,Centro,LEIRIA,1007,6677.45,2614,233,195,157,190,187,377,534,729,962,39.15,14.41,10.92,8.0
09-09-2021,CASTELO BRANCO,188,13,362,"[240,480]",Elevado,,,,188,Centro,CASTELO BRANCO,0502,143819.15,51987,3528,3042,2499,2229,2225,4454,6953,9995,13523,36.15,9.4,6.95,4.83
09-09-2021,CASTELO DE PAIVA,20,1,131,"[120,240]",Moderado,,,,20,Norte,AVEIRO,0106,11500.53,15454,881,697,545,420,431,851,1396,2093,2974,134.37,25.86,18.2,12.14
09-09-2021,CASTELO DE VIDE,5,0,173,"[120,240]",Moderado,,,,5,Alentejo,PORTALEGRE,1205,26491.24,2919,204,173,179,147,170,317,496,669,873,11.02,3.3,2.53,1.87
09-09-2021,CASTRO DAIRE,19,1,138,"[120,240]",Moderado,,,,19,Centro,VISEU,1803,37904.13,13823,942,857,765,732,773,1505,2270,3127,4069,36.47,10.74,8.25,5.99
09-09-2021,CASTRO MARIM,6,0,97,"[0,120]",Baixo a Moderado,,,,6,Algarve,FARO,0804,30084.37,6237,370,345,334,322,344,666,1000,1345,1715,20.73,5.7,4.47,3.32
09-09-2021,CASTRO VERDE,25,2,363,"[240,480]",Elevado,,,,25,Alentejo,BEJA,0206,56944.23,6949,437,347,303,275,227,502,805,1152,1589,12.2,2.79,2.02,1.41
09-09-2021,CELORICO DA BEIRA,32,2,461,"[240,480]",Elevado,,,,32,Centro,GUARDA,0903,24721.63,6928,430,416,363,369,535,904,1267,1683,2113,28.02,8.55,6.81,5.12
09-09-2021,CELORICO DE BASTO,37,3,196,"[120,240]",Moderado,,,,37,Norte,BRAGA,0305,18107.02,19040,1001,802,668,728,729,1457,2125,2927,3928,105.15,21.69,16.17,11.74
09-09-2021,CHAMUSCA,3,0,33,"[0,120]",Baixo a Moderado,,,,3,Lisboa e Vale do Tejo,SANTARÉM,1407,74600.54,9197,629,583,553,465,579,1044,1597,2180,2809,12.33,3.77,2.92,2.14
09-09-2021,CHAVES,103,7,263,"[240,480]",Elevado,,,,103,Norte,VILA REAL,1703,59122.95,39343,2676,2429,1991,1886,1918,3804,5795,8224,10900,66.54,18.44,13.91,9.8
09-09-2021,CINFÃES,43,3,233,"[120,240]",Moderado,,,,43,Norte,VISEU,1804,23928.76,18244,1067,902,779,734,758,1492,2271,3173,4240,76.24,17.72,13.26,9.49
09-09-2021,COIMBRA,220,16,164,"[120,240]",Moderado,,,,220,Centro,COIMBRA,0603,31939.94,134166,9489,8734,6353,5139,5074,10213,16566,25300,34789,420.06,108.92,79.21,51.87
09-09-2021,CONDEIXA-A-NOVA,64,5,363,"[240,480]",Elevado,,,,64,Centro,COIMBRA,0604,13867.47,17733,871,809,717,583,490,1073,1790,2599,3470,127.88,25.02,18.74,12.91
09-09-2021,CONSTÂNCIA,5,0,123,"[120,240]",Moderado,,,,5,Lisboa e Vale do Tejo,SANTARÉM,1408,8036.58,4030,211,183,187,148,155,303,490,673,884,50.14,11.0,8.37,6.1
09-09-2021,CORUCHE,8,1,47,"[0,120]",Baixo a Moderado,,,,8,Lisboa e Vale do Tejo,SANTARÉM,1409,111572.03,17471,1294,1090,1095,1096,1019,2115,3210,4300,5594,15.66,5.01,3.85,2.88
09-09-2021,CORVO,1,0,213,"[120,240]",Moderado,,,,1,Açores,AÇORES,4901,1711.45,464,22,21,11,13,19,32,43,64,86,27.12,5.03,3.74,2.51
09-09-2021,COVILHÃ,182,13,389,"[240,480]",Elevado,,,,182,Centro,CASTELO BRANCO,0503,55560.06,46787,3533,2998,2365,2111,2193,4304,6669,9667,13200,84.21,23.76,17.4,12.0
09-09-2021,CRATO,3,0,98,"[0,120]",Baixo a Moderado,,,,3,Alentejo,PORTALEGRE,1206,39806.88,3129,229,258,163,182,228,410,573,831,1060,7.86,2.66,2.09,1.44
09-09-2021,CUBA,7,1,154,"[120,240]",Moderado,,,,7,Alentejo,BEJA,0207,17208.72,4595,255,233,206,190,143,333,539,772,1027,26.7,5.97,4.49,3.13
09-09-2021,ELVAS,31,2,153,"[120,240]",Moderado,,,,31,Alentejo,PORTALEGRE,1207,63128.86,20528,1057,1145,902,852,810,1662,2564,3709,4766,32.52,7.55,5.88,4.06
09-09-2021,ENTRONCAMENTO,51,4,237,"[120,240]",Moderado,,,,51,Lisboa e Vale do Tejo,SANTARÉM,1410,1372.81,21558,1066,930,868,695,592,1287,2155,3085,4151,1570.14,302.33,224.69,156.96
09-09-2021,ESPINHO,66,5,224,"[120,240]",Moderado,,,,66,Norte,AVEIRO,0107,2105.68,29516,2205,1993,1430,1177,960,2137,3567,5560,7765,1401.52,368.71,264.01,169.37
09-09-2021,ESPOSENDE,125,9,366,"[240,480]",Elevado,,,,125,Norte,BRAGA,0306,9540.98,34177,1831,1522,1095,894,723,1617,2712,4234,6065,358.21,63.57,44.38,28.42
09-09-2021,ESTARREJA,21,1,80,"[0,120]",Baixo a Moderado,,,,21,Centro,AVEIRO,0108,10817.33,26006,1503,1399,1106,953,728,1681,2787,4186,5689,240.42,52.59,38.7,25.76
09-09-2021,ESTREMOZ,14,1,111,"[0,120]",Baixo a Moderado,,,,14,Alentejo,ÉVORA,0704,51379.95,12728,789,613,697,786,877,1663,2360,2973,3762,24.77,7.32,5.79,4.59
09-09-2021,ÉVORA,155,11,295,"[240,480]",Elevado,,,,155,Alentejo,ÉVORA,0705,130707.58,52428,3569,2852,2176,1966,1803,3769,5945,8797,12366,40.11,9.46,6.73,4.55
09-09-2021,FAFE,292,21,607,"[480,960]",Muito Elevado,,,,292,Norte,BRAGA,0307,21908.11,48060,3044,2455,1679,1403,1208,2611,4290,6745,9789,219.37,44.68,30.79,19.58
09-09-2021,FARO,252,18,413,"[240,480]",Elevado,,,,252,Algarve,FARO,0805,20256.79,61015,3847,3364,2604,2055,1601,3656,6260,9624,13471,301.2,66.5,47.51,30.9
09-09-2021,FELGUEIRAS,126,9,224,"[120,240]",Moderado,,,,126,Norte,PORTO,1303,11573.75,56422,2951,2302,1601,1316,973,2289,3890,6192,9143,487.49,79.0,53.5,33.61
09-09-2021,FERREIRA DO ALENTEJO,10,1,128,"[120,240]",Moderado,,,,10,Alentejo,BEJA,0208,64820.68,7845,515,414,372,343,345,688,1060,1474,1989,12.1,3.07,2.27,1.64
09-09-2021,FERREIRA DO ZÊZERE,18,1,226,"[120,240]",Moderado,,,,18,Lisboa e Vale do Tejo,SANTARÉM,1411,19038.03,7959,470,370,416,465,456,921,1337,1707,2177,41.81,11.44,8.97,7.02
09-09-2021,FIGUEIRA DA FOZ,156,11,265,"[240,480]",Elevado,,,,156,Centro,COIMBRA,0605,37905.26,58747,4032,3597,2887,2495,2043,4538,7425,11022,15054,154.98,39.72,29.08,19.59
09-09-2021,FIGUEIRA DE CASTELO RODRIGO,23,2,412,"[240,480]",Elevado,,,,23,Centro,GUARDA,0904,50857.46,5584,347,352,290,352,391,743,1033,1385,1732,10.98,3.41,2.72,2.03
09-09-2021,FIGUEIRÓ DOS VINHOS,7,1,126,"[120,240]",Moderado,,,,7,Centro,LEIRIA,1008,17344.0,5568,402,386,322,309,351,660,982,1368,1770,32.1,10.21,7.89,5.66
09-09-2021,FORNOS DE ALGODRES,9,1,198,"[120,240]",Moderado,,,,9,Centro,GUARDA,0905,13145.05,4528,261,218,247,256,232,488,735,953,1214,34.45,9.24,7.25,5.59
09-09-2021,FREIXO DE ESPADA À CINTA,0,0,0,"[0,120]",Baixo a Moderado,,,,0,Norte,BRAGANÇA,0404,24414.29,3298,211,177,231,196,189,385,616,793,1004,13.51,4.11,3.25,2.52
09-09-2021,FRONTEIRA,23,2,784,"[480,960]",Muito Elevado,,,,23,Alentejo,PORTALEGRE,1208,24859.58,2974,213,182,149,156,168,324,473,655,868,11.96,3.49,2.63,1.9
09-09-2021,FUNCHAL,157,11,151,"[120,240]",Moderado,,,,157,Madeira,MADEIRA,3103,7616.2,104024,6382,5086,3643,2821,1990,4811,8454,13540,19922,1365.86,261.58,177.78,111.0
09-09-2021,FUNDÃO,34,2,128,"[120,240]",Moderado,,,,34,Centro,CASTELO BRANCO,0504,70019.79,26495,1781,1464,1432,1357,1643,3000,4432,5896,7677,37.84,10.96,8.42,6.33
09-09-2021,GAVIÃO,1,0,31,"[0,120]",Baixo a Moderado,,,,1,Alentejo,PORTALEGRE,1209,29459.45,3263,189,186,222,263,293,556,778,964,1153,11.08,3.91,3.27,2.64
09-09-2021,GÓIS,1,0,27,"[0,120]",Baixo a Moderado,,,,1,Centro,COIMBRA,0606,26330.19,3805,235,199,240,233,244,477,717,916,1151,14.45,4.37,3.48,2.72
09-09-2021,GOLEGÃ,3,0,57,"[0,120]",Baixo a Moderado,,,,3,Lisboa e Vale do Tejo,SANTARÉM,1412,8431.67,5339,356,299,281,243,255,498,779,1078,1434,63.32,17.01,12.78,9.24
09-09-2021,GONDOMAR,229,16,138,"[120,240]",Moderado,,,,229,Norte,PORTO,1304,13191.76,165985,10555,8755,6222,4450,3364,7814,14036,22791,33346,1258.22,252.77,172.76,106.4
09-09-2021,GOUVEIA,8,1,65,"[0,120]",Baixo a Moderado,,,,8,Centro,GUARDA,0906,30061.17,12387,871,931,780,783,810,1593,2373,3304,4175,41.21,13.89,10.99,7.89
09-09-2021,GRÂNDOLA,29,2,199,"[120,240]",Moderado,,,,29,Alentejo,SETÚBAL,1505,82593.66,14639,834,834,708,688,672,1360,2068,2902,3736,17.72,4.52,3.51,2.5
09-09-2021,GUARDA,78,6,200,"[120,240]",Moderado,,,,78,Centro,GUARDA,0907,71209.58,38969,2477,2041,1686,1415,1474,2889,4575,6616,9093,54.72,12.77,9.29,6.42
09-09-2021,GUIMARÃES,553,39,363,"[240,480]",Elevado,,,,553,Norte,BRAGA,0308,24099.96,152309,9394,7074,4809,3877,2948,6825,11634,18708,28102,631.99,116.61,77.63,48.27
09-09-2021,HORTA,2,0,14,"[0,120]",Baixo a Moderado,,,,2,Açores,AÇORES,4701,17305.53,14521,818,658,468,352,302,654,1122,1780,2598,83.91,15.01,10.29,6.48
09-09-2021,IDANHA-A-NOVA,10,1,126,"[120,240]",Moderado,,,,10,Centro,CASTELO BRANCO,0505,141633.51,8043,518,490,519,672,974,1646,2165,2655,3173,5.68,2.24,1.87,1.53
09-09-2021,ÍLHAVO,36,3,92,"[0,120]",Baixo a Moderado,,,,36,Centro,AVEIRO,0110,7347.55,38699,2227,1943,1444,1193,850,2043,3487,5430,7657,526.66,104.21,73.9,47.46
09-09-2021,LAGOA (FARO),92,7,405,"[240,480]",Elevado,,,,92,Algarve,FARO,0806,8825.45,22762,1314,1168,919,749,670,1419,2338,3506,4820,257.93,54.62,39.73,26.49
09-09-2021,LAGOA,7,0,47,"[0,120]",Baixo a Moderado,,,,7,Açores,AÇORES,4201,4559.32,14721,536,458,349,238,235,473,822,1280,1816,322.9,39.83,28.08,18.03
09-09-2021,LAGOS,250,18,823,"[480,960]",Muito Elevado,,,,250,Algarve,FARO,0807,21299.27,30374,1744,1434,1247,1053,1029,2082,3329,4763,6507,142.61,30.55,22.36,15.63
09-09-2021,LAJES DAS FLORES,0,0,0,"[0,120]",Baixo a Moderado,,,,0,Açores,AÇORES,4801,7004.79,1463,88,53,62,46,54,100,162,215,303,20.89,4.33,3.07,2.31
09-09-2021,LAJES DO PICO,2,0,45,"[0,120]",Baixo a Moderado,,,,2,Açores,AÇORES,4601,15531.09,4490,304,231,223,159,162,321,544,775,1079,28.91,6.95,4.99,3.5
09-09-2021,LAMEGO,31,2,125,"[120,240]",Moderado,,,,31,Norte,VISEU,1805,16542.11,24895,1639,1284,1124,898,783,1681,2805,4089,5728,150.5,34.63,24.72,16.96
09-09-2021,LEIRIA,461,33,368,"[240,480]",Elevado,,,,461,Centro,LEIRIA,1009,56508.83,125267,7389,6366,5090,3902,3159,7061,12151,18517,25906,221.68,45.84,32.77,21.5
09-09-2021,LISBOA,1437,103,282,"[240,480]",Elevado,,,,1437,Lisboa e Vale do Tejo,LISBOA,1106,10005.43,509515,33197,33340,27706,23037,26770,49807,77513,110853,144050,5092.6,1439.78,1107.98,774.74
09-09-2021,LOULÉ,376,27,547,"[480,960]",Muito Elevado,,,,376,Algarve,FARO,0808,76366.91,68697,3890,3350,2780,2358,2251,4609,7389,10739,14629,89.96,19.16,14.06,9.68
09-09-2021,LOURES,387,28,181,"[120,240]",Moderado,,,,387,Lisboa e Vale do Tejo,LISBOA,1107,16723.99,213687,12746,12794,9644,6669,5033,11702,21346,34140,46886,1277.73,280.35,204.14,127.64
09-09-2021,LOURINHÃ,43,3,168,"[120,240]",Moderado,,,,43,Lisboa e Vale do Tejo,LISBOA,1108,14717.2,25855,1584,1243,992,842,645,1487,2479,3722,5306,175.68,36.05,25.29,16.84
09-09-2021,LOUSÃ,21,1,122,"[120,240]",Moderado,,,,21,Centro,COIMBRA,0607,13840.01,17158,946,866,658,528,450,978,1636,2502,3448,123.97,24.91,18.08,11.82
09-09-2021,LOUSADA,94,7,200,"[120,240]",Moderado,,,,94,Norte,PORTO,1305,9608.01,46755,2289,1698,1176,853,621,1474,2650,4348,6637,486.63,69.08,45.25,27.58
09-09-2021,MAÇÃO,4,0,65,"[0,120]",Baixo a Moderado,,,,4,Lisboa e Vale do Tejo,SANTARÉM,1413,39997.98,6267,386,362,390,440,657,1097,1487,1849,2235,15.67,5.59,4.62,3.72
09-09-2021,MACEDO DE CAVALEIROS,23,2,160,"[120,240]",Moderado,,,,23,Norte,BRAGANÇA,0405,69914.08,14516,1082,889,878,823,938,1761,2639,3528,4610,20.76,6.59,5.05,3.77
09-09-2021,MACHICO,21,2,106,"[0,120]",Baixo a Moderado,,,,21,Madeira,MADEIRA,3104,6825.1,19981,1197,860,662,455,331,786,1448,2308,3505,292.76,51.36,33.82,21.22
09-09-2021,MADALENA,15,1,255,"[240,480]",Elevado,,,,15,Açores,AÇORES,4602,14712.33,5895,334,256,173,190,179,369,542,798,1132,40.07,7.69,5.42,3.68
09-09-2021,MAFRA,201,14,237,"[120,240]",Moderado,,,,201,Lisboa e Vale do Tejo,LISBOA,1109,29165.5,84816,3613,3334,2839,2089,1899,3988,6827,10161,13774,290.81,47.23,34.84,23.41
09-09-2021,MAIA,214,15,154,"[120,240]",Moderado,,,,214,Norte,PORTO,1306,8293.94,138971,7801,6617,4512,3339,2631,5970,10482,17099,24900,1675.56,300.22,206.16,126.38
09-09-2021,MANGUALDE,33,2,178,"[120,240]",Moderado,,,,33,Centro,VISEU,1806,21925.56,18510,1198,1128,885,852,743,1595,2480,3608,4806,84.42,21.92,16.46,11.31
09-09-2021,MANTEIGAS,8,1,268,"[240,480]",Elevado,,,,8,Centro,GUARDA,0908,12197.55,3007,258,197,159,167,146,313,472,669,927,24.65,7.6,5.48,3.87
09-09-2021,MARCO DE CANAVESES,57,4,111,"[0,120]",Baixo a Moderado,,,,57,Norte,PORTO,1307,20188.98,51496,2678,2060,1488,1265,1023,2288,3776,5836,8514,255.07,42.17,28.91,18.7
09-09-2021,MARINHA GRANDE,126,9,327,"[240,480]",Elevado,,,,126,Centro,LEIRIA,1010,18725.19,38508,2365,2302,1638,1359,1058,2417,4055,6357,8722,205.65,46.58,33.95,21.66
09-09-2021,MARVÃO,13,1,442,"[240,480]",Elevado,,,,13,Alentejo,PORTALEGRE,1210,15489.9,3005,198,185,142,197,237,434,576,761,959,19.4,6.19,4.91,3.72
09-09-2021,MATOSINHOS,279,20,159,"[120,240]",Moderado,,,,279,Norte,PORTO,1308,6241.97,175357,11850,9977,7023,5024,3884,8908,15931,25908,37758,2809.31,604.9,415.06,255.22
09-09-2021,MEALHADA,16,1,80,"[0,120]",Baixo a Moderado,,,,16,Centro,AVEIRO,0111,11065.66,19914,1163,1039,810,828,831,1659,2469,3508,4671,179.96,42.21,31.7,22.31
09-09-2021,MÊDA,11,1,240,"[240,480]",Elevado,,,,11,Centro,GUARDA,0909,28604.92,4587,343,306,290,288,443,731,1021,1327,1670,16.04,5.84,4.64,3.57
09-09-2021,MELGAÇO,17,1,213,"[120,240]",Moderado,,,,17,Norte,VIANA DO CASTELO,1603,23824.58,8093,507,567,578,614,675,1289,1867,2434,2941,33.97,12.34,10.22,7.84
09-09-2021,MÉRTOLA,15,1,248,"[240,480]",Elevado,,,,15,Alentejo,BEJA,0209,129287.34,6142,400,390,378,423,600,1023,1401,1791,2191,4.75,1.69,1.39,1.08
09-09-2021,MESÃO FRIO,6,0,152,"[120,240]",Moderado,,,,6,Norte,VILA REAL,1704,2664.87,3964,265,205,168,157,120,277,445,650,915,148.74,34.33,24.39,16.7
09-09-2021,MIRA,3,0,25,"[0,120]",Baixo a Moderado,,,,3,Centro,COIMBRA,0608,12403.38,11832,727,729,659,550,466,1016,1675,2404,3131,95.4,25.24,19.38,13.5
09-09-2021,MIRANDA DO CORVO,7,0,55,"[0,120]",Baixo a Moderado,,,,7,Centro,COIMBRA,0609,12637.79,12708,706,659,568,498,404,902,1470,2129,2835,100.55,22.43,16.85,11.63
09-09-2021,MIRANDA DO DOURO,4,0,59,"[0,120]",Baixo a Moderado,,,,4,Norte,BRAGANÇA,0406,48718.31,6830,482,429,442,463,470,933,1375,1804,2286,14.02,4.69,3.7,2.82
09-09-2021,MIRANDELA,54,4,250,"[240,480]",Elevado,,,,54,Norte,BRAGANÇA,0407,65895.67,21754,1640,1315,1204,1078,947,2025,3229,4544,6184,33.01,9.38,6.9,4.9
09-09-2021,MOGADOURO,6,0,72,"[0,120]",Baixo a Moderado,,,,6,Norte,BRAGANÇA,0408,76064.93,8392,589,529,576,630,655,1285,1861,2390,2979,11.03,3.92,3.14,2.45
09-09-2021,MOIMENTA DA BEIRA,10,1,103,"[0,120]",Baixo a Moderado,,,,10,Norte,VISEU,1807,21996.9,9736,576,514,471,416,461,877,1348,1862,2438,44.26,11.08,8.46,6.13
09-09-2021,MOITA,131,9,203,"[120,240]",Moderado,,,,131,Lisboa e Vale do Tejo,SETÚBAL,1506,5525.98,64407,4226,3646,2623,1801,1425,3226,5849,9495,13721,1165.53,248.3,171.82,105.85
09-09-2021,MONÇÃO,27,2,152,"[120,240]",Moderado,,,,27,Norte,VIANA DO CASTELO,1604,21130.85,17869,1161,1105,1031,1006,972,1978,3009,4114,5275,84.56,24.96,19.47,14.24
09-09-2021,MONCHIQUE,8,1,161,"[120,240]",Moderado,,,,8,Algarve,FARO,0809,39530.43,5077,353,384,321,355,392,747,1068,1452,1805,12.84,4.57,3.67,2.7
09-09-2021,MONDIM DE BASTO,19,1,276,"[240,480]",Elevado,,,,19,Norte,VILA REAL,1705,17207.52,6946,395,300,314,284,283,567,881,1181,1576,40.36,9.16,6.86,5.12
09-09-2021,MONFORTE,3,0,102,"[0,120]",Baixo a Moderado,,,,3,Alentejo,PORTALEGRE,1211,42024.82,2975,139,115,117,192,168,360,477,592,731,7.08,1.74,1.41,1.14
09-09-2021,MONTALEGRE,93,7,1036,"[960,Max]",Extremamente Elevado,,,,93,Norte,VILA REAL,1706,80545.71,8997,699,628,595,603,730,1333,1928,2556,3255,11.17,4.04,3.17,2.39
09-09-2021,MONTEMOR-O-NOVO,14,1,91,"[0,120]",Baixo a Moderado,,,,14,Alentejo,ÉVORA,0706,123296.65,15647,991,953,868,878,971,1849,2717,3670,4661,12.69,3.78,2.98,2.2
09-09-2021,MONTEMOR-O-VELHO,38,3,150,"[120,240]",Moderado,,,,38,Centro,COIMBRA,0610,22896.23,25224,1496,1397,1217,1057,988,2045,3262,4659,6155,110.17,26.88,20.35,14.25
09-09-2021,MONTIJO,96,7,167,"[120,240]",Moderado,,,,96,Lisboa e Vale do Tejo,SETÚBAL,1507,34861.64,57614,2771,2441,1990,1554,1109,2663,4653,7094,9865,165.26,28.3,20.35,13.35
09-09-2021,MORA,0,0,0,"[0,120]",Baixo a Moderado,,,,0,Alentejo,ÉVORA,0707,44395.02,4138,336,275,252,238,257,495,747,1022,1358,9.32,3.06,2.3,1.68
09-09-2021,MORTÁGUA,12,1,136,"[120,240]",Moderado,,,,12,Centro,VISEU,1808,25117.82,8803,638,584,535,499,460,959,1494,2078,2716,35.05,10.81,8.27,5.95
09-09-2021,MOURA,84,6,610,"[480,960]",Muito Elevado,,,,84,Alentejo,BEJA,0210,95845.55,13718,817,656,665,542,461,1003,1668,2324,3141,14.31,3.28,2.42,1.74
09-09-2021,MOURÃO,14,1,575,"[480,960]",Muito Elevado,,,,14,Alentejo,ÉVORA,0708,27862.98,2450,139,108,80,104,109,213,293,401,540,8.79,1.94,1.44,1.05
09-09-2021,MURÇA,5,0,93,"[0,120]",Baixo a Moderado,,,,5,Norte,VILA REAL,1707,18937.11,5463,384,341,307,306,319,625,932,1273,1657,28.85,8.75,6.72,4.92
09-09-2021,MURTOSA,4,0,38,"[0,120]",Baixo a Moderado,,,,4,Centro,AVEIRO,0112,7308.78,10279,509,473,403,353,409,762,1165,1638,2147,140.63,29.37,22.41,15.94
09-09-2021,NAZARÉ,32,2,224,"[120,240]",Moderado,,,,32,Lisboa e Vale do Tejo,LEIRIA,1011,8243.43,14165,967,903,670,420,396,816,1486,2389,3356,171.84,40.71,28.98,18.03
09-09-2021,NELAS,12,1,92,"[0,120]",Baixo a Moderado,,,,12,Centro,VISEU,1809,12571.48,12974,924,787,668,604,583,1187,1855,2642,3566,103.21,28.37,21.02,14.76
09-09-2021,NISA,7,1,117,"[0,120]",Baixo a Moderado,,,,7,Alentejo,PORTALEGRE,1212,57567.84,6061,405,389,355,483,478,961,1316,1705,2110,10.53,3.67,2.96,2.29
09-09-2021,NORDESTE,2,0,42,"[0,120]",Baixo a Moderado,,,,2,Açores,AÇORES,4202,10146.8,4862,246,180,124,161,162,323,447,627,873,47.92,8.6,6.18,4.41
09-09-2021,ÓBIDOS,20,1,166,"[120,240]",Moderado,,,,20,Lisboa e Vale do Tejo,LEIRIA,1012,14155.44,11850,743,650,574,452,436,888,1462,2112,2855,83.72,20.17,14.92,10.33
09-09-2021,ODEMIRA,69,5,280,"[240,480]",Elevado,,,,69,Alentejo,BEJA,0211,172060.15,24717,1475,1317,1225,1397,1349,2746,3971,5288,6763,14.37,3.93,3.07,2.31
09-09-2021,ODIVELAS,291,21,180,"[120,240]",Moderado,,,,291,Lisboa e Vale do Tejo,LISBOA,1116,2654.36,161774,9562,9038,6952,4641,3812,8453,15405,24443,34005,6095.48,1281.27,920.99,580.44
09-09-2021,OEIRAS,314,22,177,"[120,240]",Moderado,,,,314,Lisboa e Vale do Tejo,LISBOA,1110,4588.31,177408,11580,11575,8566,6211,5855,12066,20632,32207,43787,3866.78,954.38,701.98,449.69
09-09-2021,OLEIROS,2,0,40,"[0,120]",Baixo a Moderado,,,,2,Centro,CASTELO BRANCO,0506,47109.31,5003,384,341,366,397,487,884,1250,1591,1975,10.62,4.19,3.38,2.65
09-09-2021,OLHÃO,135,10,303,"[240,480]",Elevado,,,,135,Algarve,FARO,0810,13086.38,44405,2455,2309,1689,1342,1268,2610,4299,6608,9063,339.33,69.26,50.5,32.85
09-09-2021,OLIVEIRA DE AZEMÉIS,164,12,248,"[240,480]",Elevado,,,,164,Norte,AVEIRO,0113,16110.41,66011,4155,3614,2794,2183,1738,3921,6715,10329,14484,409.75,89.91,64.12,41.68
09-09-2021,OLIVEIRA DE FRADES,31,2,310,"[240,480]",Elevado,,,,31,Centro,VISEU,1810,14534.62,9936,553,475,438,359,415,774,1212,1687,2240,68.36,15.41,11.61,8.34
09-09-2021,OLIVEIRA DO BAIRRO,18,1,73,"[0,120]",Baixo a Moderado,,,,18,Centro,AVEIRO,0114,8731.99,24277,1327,1182,999,786,810,1596,2595,3777,5104,278.02,58.45,43.25,29.72
09-09-2021,OLIVEIRA DO HOSPITAL,25,2,130,"[120,240]",Moderado,,,,25,Centro,COIMBRA,0611,23451.66,19253,1161,1097,962,924,960,1884,2846,3943,5104,82.1,21.76,16.81,12.14
09-09-2021,OURÉM,119,8,270,"[240,480]",Elevado,,,,119,Lisboa e Vale do Tejo,SANTARÉM,1421,41668.03,44044,2463,2069,1899,1817,1603,3420,5319,7388,9851,105.7,23.64,17.73,12.77
09-09-2021,OURIQUE,5,0,110,"[0,120]",Baixo a Moderado,,,,5,Alentejo,BEJA,0212,66331.36,4607,313,287,284,268,227,495,779,1066,1379,6.95,2.08,1.61,1.17
09-09-2021,OVAR,69,5,127,"[120,240]",Moderado,,,,69,Centro,AVEIRO,0115,14770.25,54260,3294,2709,1994,1636,1234,2870,4864,7573,10867,367.37,73.57,51.27,32.93
09-09-2021,PAÇOS DE FERREIRA,153,11,269,"[240,480]",Elevado,,,,153,Norte,PORTO,1309,7099.29,56728,2903,2193,1518,1135,664,1799,3317,5510,8413,799.1,118.51,77.62,46.72
09-09-2021,PALMELA,130,9,203,"[120,240]",Moderado,,,,130,Lisboa e Vale do Tejo,SETÚBAL,1508,46512.01,64269,3402,3244,2635,1846,1391,3237,5872,9116,12518,138.18,26.91,19.6,12.62
09-09-2021,PAMPILHOSA DA SERRA,6,0,149,"[120,240]",Moderado,,,,6,Centro,COIMBRA,0612,39646.24,4037,238,254,295,339,423,762,1057,1311,1549,10.18,3.91,3.31,2.67
09-09-2021,PAREDES,199,14,231,"[120,240]",Moderado,,,,199,Norte,PORTO,1310,15675.69,86067,4272,3532,2412,1717,1258,2975,5387,8919,13191,549.04,84.15,56.9,34.36
09-09-2021,PAREDES DE COURA,6,0,71,"[0,120]",Baixo a Moderado,,,,6,Norte,VIANA DO CASTELO,1605,13818.59,8535,466,528,407,465,515,980,1387,1915,2381,61.76,17.23,13.86,10.04
09-09-2021,PEDRÓGÃO GRANDE,1,0,29,"[0,120]",Baixo a Moderado,,,,1,Centro,LEIRIA,1013,12874.75,3410,175,173,196,221,252,473,669,842,1017,26.49,7.9,6.54,5.2
09-09-2021,PENACOVA,21,2,154,"[120,240]",Moderado,,,,21,Centro,COIMBRA,0613,21673.23,13694,968,923,745,621,703,1324,2069,2992,3960,63.18,18.27,13.81,9.55
09-09-2021,PENAFIEL,175,13,251,"[240,480]",Elevado,,,,175,Norte,PORTO,1311,21224.27,69772,3648,2823,2032,1663,1230,2893,4925,7748,11396,328.74,53.69,36.51,23.2
09-09-2021,PENALVA DO CASTELO,11,1,154,"[120,240]",Moderado,,,,11,Centro,VISEU,1811,13433.92,7115,449,457,413,391,426,817,1230,1687,2136,52.96,15.9,12.56,9.16
09-09-2021,PENAMACOR,7,1,148,"[120,240]",Moderado,,,,7,Centro,CASTELO BRANCO,0507,56370.69,4755,262,248,273,451,633,1084,1357,1605,1867,8.44,3.31,2.85,2.41
09-09-2021,PENEDONO,19,1,739,"[480,960]",Muito Elevado,,,,19,Norte,VISEU,1812,13370.75,2591,172,113,129,156,138,294,423,536,708,19.38,5.3,4.01,3.16
09-09-2021,PENELA,9,1,167,"[120,240]",Moderado,,,,9,Centro,COIMBRA,0614,13480.0,5397,314,324,274,359,344,703,977,1301,1615,40.04,11.98,9.65,7.25
09-09-2021,PENICHE,58,4,217,"[120,240]",Moderado,,,,58,Lisboa e Vale do Tejo,LEIRIA,1014,7754.98,26501,1746,1504,1203,926,707,1633,2836,4340,6086,341.73,78.48,55.96,36.57
09-09-2021,PESO DA RÉGUA,39,3,249,"[240,480]",Elevado,,,,39,Norte,VILA REAL,1708,9486.01,15773,1076,843,650,659,455,1114,1764,2607,3683,166.28,38.83,27.48,18.6
09-09-2021,PINHEL,5,0,59,"[0,120]",Baixo a Moderado,,,,5,Centro,GUARDA,0910,48452.12,8511,577,566,551,538,689,1227,1778,2344,2921,17.57,6.03,4.84,3.67
09-09-2021,POMBAL,197,14,383,"[240,480]",Elevado,,,,197,Centro,LEIRIA,1015,62600.28,51461,3187,2791,2494,2328,2027,4355,6849,9640,12827,82.21,20.49,15.4,10.94
09-09-2021,PONTA DELGADA,74,5,109,"[0,120]",Baixo a Moderado,,,,74,Açores,AÇORES,4203,23298.65,67935,3108,2435,1726,1133,902,2035,3761,6196,9304,291.58,39.93,26.59,16.14
09-09-2021,PONTA DO SOL,2,0,23,"[0,120]",Baixo a Moderado,,,,2,Madeira,MADEIRA,3105,4622.03,8593,319,283,347,208,221,429,776,1059,1378,185.92,29.81,22.91,16.79
09-09-2021,PONTE DA BARCA,36,3,324,"[240,480]",Elevado,,,,36,Norte,VIANA DO CASTELO,1606,18211.37,11180,635,576,517,554,490,1044,1561,2137,2772,61.39,15.22,11.73,8.57
09-09-2021,PONTE DE LIMA,79,6,192,"[120,240]",Moderado,,,,79,Norte,VIANA DO CASTELO,1607,32025.46,41315,2321,2022,1720,1596,1462,3058,4778,6800,9121,129.01,28.48,21.23,14.92
09-09-2021,PONTE DE SOR,33,2,222,"[120,240]",Moderado,,,,33,Alentejo,PORTALEGRE,1213,83971.16,14994,939,800,716,739,831,1570,2286,3086,4025,17.86,4.79,3.68,2.72
09-09-2021,PORTALEGRE,14,1,64,"[0,120]",Baixo a Moderado,,,,14,Alentejo,PORTALEGRE,1214,44713.64,22172,1577,1351,1137,993,984,1977,3114,4465,6042,49.59,13.51,9.99,6.96
09-09-2021,PORTEL,8,1,139,"[120,240]",Moderado,,,,8,Alentejo,ÉVORA,0709,60100.57,5828,336,358,283,331,305,636,919,1277,1613,9.7,2.68,2.12,1.53
09-09-2021,PORTIMÃO,389,28,701,"[480,960]",Muito Elevado,,,,389,Algarve,FARO,0811,18206.29,55483,3182,2927,2116,1582,1400,2982,5098,8025,11207,304.75,61.56,44.08,28.0
09-09-2021,PORTO,542,39,250,"[240,480]",Elevado,,,,542,Norte,PORTO,1312,4142.02,216606,15790,15193,11280,9409,10044,19453,30733,45926,61716,5229.5,1490.0,1108.79,741.98
09-09-2021,PORTO DE MÓS,80,6,343,"[240,480]",Elevado,,,,80,Centro,LEIRIA,1016,26183.41,23275,1355,1210,1034,888,872,1760,2794,4004,5359,88.89,20.47,15.29,10.67
09-09-2021,PORTO MONIZ,3,0,130,"[120,240]",Moderado,,,,3,Madeira,MADEIRA,3106,8293.38,2342,143,130,95,98,120,218,313,443,586,28.24,7.07,5.34,3.77
09-09-2021,PORTO SANTO,7,1,135,"[120,240]",Moderado,,,,7,Madeira,MADEIRA,3201,4300.7,5202,240,157,134,110,68,178,312,469,709,120.95,16.48,10.9,7.25
09-09-2021,PÓVOA DE LANHOSO,91,7,424,"[240,480]",Elevado,,,,91,Norte,BRAGA,0309,13465.29,21499,1175,909,732,673,624,1297,2029,2938,4113,159.67,30.55,21.82,15.07
09-09-2021,PÓVOA DE VARZIM,184,13,293,"[240,480]",Elevado,,,,184,Norte,PORTO,1313,8220.59,62784,3712,3120,2134,1594,1305,2899,5033,8153,11865,763.7,144.33,99.17,61.22
09-09-2021,POVOAÇÃO,1,0,17,"[0,120]",Baixo a Moderado,,,,1,Açores,AÇORES,4204,10640.77,5927,293,212,191,144,134,278,469,681,974,55.7,9.15,6.4,4.41
09-09-2021,VILA DA PRAIA DA VITÓRIA,9,1,42,"[0,120]",Baixo a Moderado,,,,9,Açores,AÇORES,4302,16127.06,21317,1133,789,619,436,336,772,1391,2180,3313,132.18,20.54,13.52,8.63
09-09-2021,PROENÇA-A-NOVA,2,0,28,"[0,120]",Baixo a Moderado,,,,2,Centro,CASTELO BRANCO,0508,39539.96,7298,508,465,389,400,560,960,1349,1814,2322,18.46,5.87,4.59,3.41
09-09-2021,REDONDO,9,1,143,"[120,240]",Moderado,,,,9,Alentejo,ÉVORA,0710,36950.87,6353,349,325,288,288,354,642,930,1255,1604,17.19,4.34,3.4,2.52
09-09-2021,REGUENGOS DE MONSARAZ,11,1,111,"[0,120]",Baixo a Moderado,,,,11,Alentejo,ÉVORA,0711,46399.72,10015,602,511,455,462,473,935,1390,1901,2503,21.58,5.39,4.1,3.0
09-09-2021,RESENDE,19,1,190,"[120,240]",Moderado,,,,19,Norte,VISEU,1813,12334.93,10137,560,493,448,433,422,855,1303,1796,2356,82.18,19.1,14.56,10.56
09-09-2021,RIBEIRA BRAVA,2,0,16,"[0,120]",Baixo a Moderado,,,,2,Madeira,MADEIRA,3107,6544.88,12435,648,500,411,311,287,598,1009,1509,2157,189.99,32.96,23.06,15.42
09-09-2021,RIBEIRA DE PENA,40,3,668,"[480,960]",Muito Elevado,,,,40,Norte,VILA REAL,1709,21745.98,6016,371,301,290,310,368,678,968,1269,1640,27.66,7.54,5.84,4.45
09-09-2021,RIBEIRA GRANDE,14,1,43,"[0,120]",Baixo a Moderado,,,,14,Açores,AÇORES,4205,18015.13,32811,1163,689,512,345,253,598,1110,1799,2962,182.13,16.44,9.99,6.16
09-09-2021,RIO MAIOR,20,1,99,"[0,120]",Baixo a Moderado,,,,20,Lisboa e Vale do Tejo,SANTARÉM,1414,27276.45,20379,1251,1144,941,795,648,1443,2384,3528,4779,74.71,17.52,12.93,8.74
09-09-2021,SABROSA,24,2,408,"[240,480]",Elevado,,,,24,Norte,VILA REAL,1710,15692.45,5918,393,314,304,302,350,652,956,1270,1663,37.71,10.6,8.09,6.09
09-09-2021,SABUGAL,22,2,209,"[120,240]",Moderado,,,,22,Centro,GUARDA,0911,82269.82,10585,724,707,694,796,1009,1805,2499,3206,3930,12.87,4.78,3.9,3.04
09-09-2021,SALVATERRA DE MAGOS,29,2,137,"[120,240]",Moderado,,,,29,Lisboa e Vale do Tejo,SANTARÉM,1415,24393.2,21295,1275,1181,1060,799,772,1571,2631,3812,5087,87.3,20.85,15.63,10.79
09-09-2021,SANTA COMBA DÃO,15,1,144,"[120,240]",Moderado,,,,15,Centro,VISEU,1814,11194.77,10452,732,684,569,538,464,1002,1571,2255,2987,93.36,26.68,20.14,14.03
09-09-2021,SANTA CRUZ,62,4,136,"[120,240]",Moderado,,,,62,Madeira,MADEIRA,3108,8150.28,45281,1817,1301,974,716,523,1239,2213,3514,5331,555.6,65.41,43.12,27.15
09-09-2021,SANTA CRUZ DA GRACIOSA,0,0,0,"[0,120]",Baixo a Moderado,,,,0,Açores,AÇORES,4401,6065.78,4208,228,180,163,124,145,269,432,612,840,69.37,13.85,10.09,7.12
09-09-2021,SANTA CRUZ DAS FLORES,0,0,0,"[0,120]",Baixo a Moderado,,,,0,Açores,AÇORES,4802,7091.44,2165,125,98,74,56,51,107,181,279,404,30.53,5.7,3.93,2.55
09-09-2021,SANTA MARIA DA FEIRA,234,17,169,"[120,240]",Moderado,,,,234,Norte,AVEIRO,0109,21587.65,138636,8182,6743,4771,3856,3079,6935,11706,18449,26631,642.19,123.36,85.46,54.22
09-09-2021,SANTA MARTA DE PENAGUIÃO,9,1,137,"[120,240]",Moderado,,,,9,Norte,VILA REAL,1711,6928.13,6599,483,373,337,316,317,633,970,1343,1826,95.25,26.36,19.39,14.0
09-09-2021,SANTANA,13,1,196,"[120,240]",Moderado,,,,13,Madeira,MADEIRA,3109,9547.3,6711,418,353,343,282,277,559,902,1255,1673,70.29,17.52,13.15,9.45
09-09-2021,SANTARÉM,69,5,121,"[120,240]",Moderado,,,,69,Lisboa e Vale do Tejo,SANTARÉM,1416,55253.58,57421,3654,3441,2760,2466,2206,4672,7432,10873,14527,103.92,26.29,19.68,13.45
09-09-2021,SANTIAGO DO CACÉM,52,4,182,"[120,240]",Moderado,,,,52,Alentejo,SETÚBAL,1509,105969.29,28791,2144,1689,1472,1295,1215,2510,3982,5671,7815,27.17,7.37,5.35,3.76
09-09-2021,SANTO TIRSO,125,9,183,"[120,240]",Moderado,,,,125,Norte,PORTO,1314,13655.52,68055,4911,3935,2761,2257,1810,4067,6828,10763,15674,498.35,114.78,78.82,50.0
09-09-2021,SÃO BRÁS DE ALPORTEL,32,2,309,"[240,480]",Elevado,,,,32,Algarve,FARO,0812,15336.92,10416,596,468,467,404,401,805,1272,1740,2336,67.91,15.23,11.35,8.29
09-09-2021,SÃO JOÃO DA MADEIRA,79,6,358,"[240,480]",Elevado,,,,79,Norte,AVEIRO,0116,794.3,21958,1347,1069,796,601,593,1194,1990,3059,4406,2765.49,554.91,385.26,250.63
09-09-2021,SÃO JOÃO DA PESQUEIRA,2,0,28,"[0,120]",Baixo a Moderado,,,,2,Norte,VISEU,1815,26610.85,7125,417,330,294,328,328,656,950,1280,1697,26.77,6.38,4.81,3.57
09-09-2021,SÃO PEDRO DO SUL,60,4,389,"[240,480]",Elevado,,,,60,Centro,VISEU,1816,34895.09,15403,990,962,861,759,909,1668,2529,3491,4481,44.14,12.84,10.0,7.25
09-09-2021,SÃO ROQUE DO PICO,2,0,61,"[0,120]",Baixo a Moderado,,,,2,Açores,AÇORES,4603,14236.1,3266,199,141,93,96,113,209,302,443,642,22.94,4.51,3.11,2.12
09-09-2021,SÃO VICENTE,12,1,235,"[120,240]",Moderado,,,,12,Madeira,MADEIRA,3110,7883.71,5143,272,264,266,225,280,505,771,1035,1307,65.23,16.58,13.13,9.78
09-09-2021,SARDOAL,2,0,54,"[0,120]",Baixo a Moderado,,,,2,Lisboa e Vale do Tejo,SANTARÉM,1417,9214.72,3741,227,178,148,165,248,413,561,739,966,40.6,10.48,8.02,6.09
09-09-2021,SÁTÃO,29,2,249,"[240,480]",Elevado,,,,29,Centro,VISEU,1817,20194.11,11580,765,671,515,465,476,941,1456,2127,2892,57.34,14.32,10.53,7.21
09-09-2021,SEIA,18,1,81,"[0,120]",Baixo a Moderado,,,,18,Centro,GUARDA,0912,43568.83,22234,1807,1589,1238,1122,721,1843,3081,4670,6477,51.03,14.87,10.72,7.07
09-09-2021,SEIXAL,307,22,183,"[120,240]",Moderado,,,,307,Lisboa e Vale do Tejo,SETÚBAL,1510,9545.17,167752,10586,9270,6661,4391,2930,7321,13982,23252,33838,1757.49,354.51,243.6,146.49
09-09-2021,SERNANCELHE,9,1,167,"[120,240]",Moderado,,,,9,Norte,VISEU,1818,22861.22,5396,305,293,286,273,260,533,819,1112,1417,23.6,6.2,4.86,3.58
09-09-2021,SERPA,39,3,275,"[240,480]",Elevado,,,,39,Alentejo,BEJA,0213,110563.34,14304,903,761,719,697,626,1323,2042,2803,3706,12.94,3.35,2.54,1.85
09-09-2021,SERTÃ,4,0,27,"[0,120]",Baixo a Moderado,,,,4,Centro,CASTELO BRANCO,0509,44673.17,14577,870,779,790,767,1020,1787,2577,3356,4226,32.63,9.46,7.51,5.77
09-09-2021,SESIMBRA,127,9,244,"[240,480]",Elevado,,,,127,Lisboa e Vale do Tejo,SETÚBAL,1511,19571.75,51858,2400,2321,1853,1257,1083,2340,4193,6514,8914,264.96,45.54,33.28,21.42
09-09-2021,SETÚBAL,205,15,178,"[120,240]",Moderado,,,,205,Lisboa e Vale do Tejo,SETÚBAL,1512,23032.5,115126,7425,6929,5075,3775,2655,6430,11505,18434,25859,499.83,112.27,80.03,49.95
09-09-2021,SEVER DO VOUGA,9,1,80,"[0,120]",Baixo a Moderado,,,,9,Centro,AVEIRO,0117,12987.56,11331,766,637,568,540,567,1107,1675,2312,3078,87.24,23.7,17.8,12.9
09-09-2021,SILVES,122,9,337,"[240,480]",Elevado,,,,122,Algarve,FARO,0813,68006.23,36226,2137,1869,1610,1423,1600,3023,4633,6502,8639,53.27,12.7,9.56,6.81
09-09-2021,SINES,48,3,350,"[240,480]",Elevado,,,,48,Alentejo,SETÚBAL,1513,20330.17,13715,888,791,551,416,268,684,1235,2026,2914,67.46,14.33,9.97,6.07
09-09-2021,SINTRA,689,49,176,"[120,240]",Moderado,,,,689,Lisboa e Vale do Tejo,LISBOA,1111,31922.73,391402,20490,18316,13545,9137,7284,16421,29966,48282,68772,1226.08,215.43,151.25,93.87
09-09-2021,SOBRAL DE MONTE AGRAÇO,15,1,138,"[120,240]",Moderado,,,,15,Lisboa e Vale do Tejo,LISBOA,1112,5210.32,10651,564,507,352,272,212,484,836,1343,1907,204.43,36.6,25.78,16.05
09-09-2021,SOURE,39,3,229,"[120,240]",Moderado,,,,39,Centro,COIMBRA,0615,26506.07,17120,1173,1142,1004,883,987,1870,2874,4016,5189,64.59,19.58,15.15,10.84
09-09-2021,SOUSEL,7,1,162,"[120,240]",Moderado,,,,7,Alentejo,PORTALEGRE,1215,27932.18,4412,261,274,208,302,292,594,802,1076,1337,15.8,4.79,3.85,2.87
09-09-2021,TÁBUA,44,3,385,"[240,480]",Elevado,,,,44,Centro,COIMBRA,0616,19978.58,11368,729,584,524,430,464,894,1418,2002,2731,56.9,13.67,10.02,7.1
09-09-2021,TABUAÇO,0,0,0,"[0,120]",Baixo a Moderado,,,,0,Norte,VISEU,1819,13385.67,6033,372,314,217,282,363,645,862,1176,1548,45.07,11.56,8.79,6.44
09-09-2021,TAROUCA,4,0,51,"[0,120]",Baixo a Moderado,,,,4,Norte,VISEU,1820,10008.49,7804,405,335,313,277,324,601,914,1249,1654,77.98,16.53,12.48,9.13
09-09-2021,TAVIRA,63,4,255,"[240,480]",Elevado,,,,63,Algarve,FARO,0814,60696.7,24530,1493,1415,1252,1066,1277,2343,3595,5010,6503,40.41,10.71,8.25,5.92
09-09-2021,TERRAS DE BOURO,21,2,333,"[240,480]",Elevado,,,,21,Norte,BRAGA,0310,27746.07,6361,391,372,296,319,340,659,955,1327,1718,22.93,6.19,4.78,3.44
09-09-2021,TOMAR,58,4,158,"[120,240]",Moderado,,,,58,Lisboa e Vale do Tejo,SANTARÉM,1418,35120.44,36748,2403,2189,1868,1853,1822,3675,5543,7732,10135,104.64,28.86,22.02,15.78
09-09-2021,TONDELA,32,2,121,"[120,240]",Moderado,,,,32,Centro,VISEU,1821,37121.73,26357,1768,1722,1518,1475,1417,2892,4410,6132,7900,71.0,21.28,16.52,11.88
09-09-2021,TORRE DE MONCORVO,3,0,39,"[0,120]",Baixo a Moderado,,,,3,Norte,BRAGANÇA,0409,53155.67,7695,556,478,488,551,719,1270,1758,2236,2792,14.48,5.25,4.21,3.31
09-09-2021,TORRES NOVAS,42,3,120,"[120,240]",Moderado,,,,42,Lisboa e Vale do Tejo,SANTARÉM,1419,26999.68,34933,2324,1979,1738,1406,1475,2881,4619,6598,8922,129.38,33.04,24.44,17.11
09-09-2021,TORRES VEDRAS,178,13,227,"[120,240]",Moderado,,,,178,Lisboa e Vale do Tejo,LISBOA,1113,40714.89,78530,4513,3945,3447,2628,2104,4732,8179,12124,16637,192.88,40.86,29.78,20.09
09-09-2021,TRANCOSO,11,1,124,"[120,240]",Moderado,,,,11,Centro,GUARDA,0913,36152.47,8875,581,557,542,586,496,1082,1624,2181,2762,24.55,7.64,6.03,4.49
09-09-2021,TROFA,65,5,169,"[120,240]",Moderado,,,,65,Norte,PORTO,1318,7201.76,38418,2336,1894,1231,939,684,1623,2854,4748,7084,533.44,98.36,65.93,39.63
09-09-2021,VAGOS,19,1,83,"[0,120]",Baixo a Moderado,,,,19,Centro,AVEIRO,0118,16491.5,22740,1320,1205,922,784,724,1508,2430,3635,4955,137.89,30.04,22.04,14.73
09-09-2021,VALE DE CAMBRA,34,2,160,"[120,240]",Moderado,,,,34,Norte,AVEIRO,0119,14733.47,21327,1491,1363,1005,831,798,1629,2634,3997,5488,144.76,37.25,27.13,17.88
09-09-2021,VALENÇA,20,1,152,"[120,240]",Moderado,,,,20,Norte,VIANA DO CASTELO,1608,11712.86,13290,867,791,582,582,503,1085,1667,2458,3325,113.46,28.39,20.99,14.23
09-09-2021,VALONGO,125,9,128,"[120,240]",Moderado,,,,125,Norte,PORTO,1315,7512.45,97444,5629,4696,3207,2462,1829,4291,7498,12194,17823,1297.18,237.26,162.33,99.81
09-09-2021,VALPAÇOS,63,4,423,"[240,480]",Elevado,,,,63,Norte,VILA REAL,1712,54873.93,14818,1217,1118,999,928,997,1925,2924,4042,5259,27.0,9.58,7.37,5.33
09-09-2021,VELAS,1,0,20,"[0,120]",Baixo a Moderado,,,,1,Açores,AÇORES,4502,11738.38,5093,278,208,166,153,113,266,432,640,918,43.39,7.82,5.45,3.68
09-09-2021,VENDAS NOVAS,43,3,384,"[240,480]",Elevado,,,,43,Alentejo,ÉVORA,0712,22238.88,11255,677,768,655,501,532,1033,1688,2456,3133,50.61,14.09,11.04,7.59
09-09-2021,VIANA DO ALENTEJO,17,1,333,"[240,480]",Elevado,,,,17,Alentejo,ÉVORA,0713,39367.29,5145,245,208,235,210,214,424,659,867,1112,13.07,2.82,2.2,1.67
09-09-2021,VIANA DO CASTELO,171,12,203,"[120,240]",Moderado,,,,171,Norte,VIANA DO CASTELO,1609,31902.01,84417,5470,4433,3591,3061,2982,6043,9634,14067,19537,264.61,61.24,44.09,30.2
09-09-2021,VIDIGUEIRA,11,1,201,"[120,240]",Moderado,,,,11,Alentejo,BEJA,0214,31661.09,5510,300,248,215,233,275,508,723,971,1271,17.4,4.01,3.07,2.28
09-09-2021,VIEIRA DO MINHO,27,2,229,"[120,240]",Moderado,,,,27,Norte,BRAGA,0311,21644.35,11842,703,594,525,548,482,1030,1555,2149,2852,54.71,13.18,9.93,7.18
09-09-2021,VILA DE REI,4,0,120,"[120,240]",Moderado,,,,4,Centro,CASTELO BRANCO,0510,19154.6,3323,169,128,172,247,302,549,721,849,1018,17.35,5.31,4.43,3.76
09-09-2021,VILA DO BISPO,33,2,641,"[480,960]",Muito Elevado,,,,33,Algarve,FARO,0815,17906.06,5154,302,302,314,232,233,465,779,1081,1383,28.78,7.72,6.04,4.35
09-09-2021,VILA DO CONDE,180,13,225,"[120,240]",Moderado,,,,180,Norte,PORTO,1316,14902.77,79899,4726,3875,2819,2070,1743,3813,6632,10507,15233,536.13,102.21,70.5,44.5
09-09-2021,VILA DO PORTO,0,0,0,"[0,120]",Baixo a Moderado,,,,0,Açores,AÇORES,4101,9688.74,5616,274,212,135,96,123,219,354,566,840,57.96,8.67,5.84,3.65
09-09-2021,VILA FLOR,5,0,83,"[0,120]",Baixo a Moderado,,,,5,Norte,BRAGANÇA,0410,26581.14,6044,429,362,422,294,331,625,1047,1409,1838,22.74,6.91,5.3,3.94
09-09-2021,VILA FRANCA DE XIRA,258,18,182,"[120,240]",Moderado,,,,258,Lisboa e Vale do Tejo,LISBOA,1114,31819.39,141957,8501,6852,4869,3425,2472,5897,10766,17618,26119,446.14,82.09,55.37,33.84
09-09-2021,VILA FRANCA DO CAMPO,5,0,46,"[0,120]",Baixo a Moderado,,,,5,Açores,AÇORES,4206,7796.82,11051,450,344,248,217,154,371,619,963,1413,141.73,18.12,12.35,7.94
09-09-2021,VILA NOVA DA BARQUINHA,10,1,132,"[120,240]",Moderado,,,,10,Lisboa e Vale do Tejo,SANTARÉM,1420,4952.97,7461,415,406,392,364,338,702,1094,1500,1915,150.64,38.66,30.28,22.09
09-09-2021,VILA NOVA DE CERVEIRA,12,1,135,"[120,240]",Moderado,,,,12,Norte,VIANA DO CASTELO,1610,10846.66,8910,531,444,410,384,334,718,1128,1572,2103,82.14,19.39,14.49,10.4
09-09-2021,VILA NOVA DE FAMALICÃO,324,23,246,"[240,480]",Elevado,,,,324,Norte,BRAGA,0312,20159.26,131676,7817,6164,4202,3282,2749,6031,10233,16397,24214,653.19,120.12,81.34,50.76
09-09-2021,VILA NOVA DE FOZ CÔA,22,2,343,"[240,480]",Elevado,,,,22,Centro,GUARDA,0914,39815.18,6503,442,385,390,398,429,827,1217,1602,2044,16.33,5.13,4.02,3.06
09-09-2021,VILA NOVA DE GAIA,421,30,140,"[120,240]",Moderado,,,,421,Norte,PORTO,1317,16846.43,300472,18349,15568,10972,8224,6281,14505,25477,41045,59394,1783.64,352.57,243.65,151.23
09-09-2021,VILA NOVA DE PAIVA,20,1,427,"[240,480]",Elevado,,,,20,Centro,VISEU,1822,17553.28,4687,289,272,233,217,241,458,691,963,1252,26.7,7.13,5.49,3.94
09-09-2021,VILA NOVA DE POIARES,18,1,259,"[240,480]",Elevado,,,,18,Centro,COIMBRA,0617,8445.3,6939,380,284,262,235,182,417,679,963,1343,82.17,15.9,11.4,8.04
09-09-2021,VILA POUCA DE AGUIAR,61,4,514,"[480,960]",Muito Elevado,,,,61,Norte,VILA REAL,1713,43706.62,11961,860,817,733,601,627,1228,1961,2778,3638,27.37,8.32,6.36,4.49
09-09-2021,VILA REAL,107,8,215,"[120,240]",Moderado,,,,107,Norte,VILA REAL,1714,37880.28,49962,3025,2498,2065,1579,1466,3045,5110,7608,10633,131.9,28.07,20.08,13.49
09-09-2021,VILA REAL DE SANTO ANTÓNIO,36,3,193,"[120,240]",Moderado,,,,36,Algarve,FARO,0816,6125.0,18749,1172,1069,811,569,586,1155,1966,3035,4207,306.11,68.69,49.55,32.1
09-09-2021,VILA VELHA DE RÓDÃO,3,0,95,"[0,120]",Baixo a Moderado,,,,3,Centro,CASTELO BRANCO,0511,32991.16,3144,209,229,180,283,306,589,769,998,1207,9.53,3.66,3.03,2.33
09-09-2021,VILA VERDE,256,18,545,"[480,960]",Muito Elevado,,,,256,Norte,BRAGA,0313,22866.52,46911,2365,2063,1667,1494,1437,2931,4598,6661,9026,205.15,39.47,29.13,20.11
09-09-2021,VILA VIÇOSA,24,2,317,"[240,480]",Elevado,,,,24,Alentejo,ÉVORA,0714,19485.89,7656,487,379,342,345,324,669,1011,1390,1877,39.29,9.63,7.13,5.19
09-09-2021,VIMIOSO,9,1,227,"[120,240]",Moderado,,,,9,Norte,BRAGANÇA,0411,48158.51,4023,274,230,261,293,335,628,889,1119,1393,8.35,2.89,2.32,1.85
09-09-2021,VINHAIS,9,1,118,"[0,120]",Baixo a Moderado,,,,9,Norte,BRAGANÇA,0412,69475.09,7746,599,577,636,641,815,1456,2092,2669,3268,11.15,4.7,3.84,3.01
09-09-2021,VISEU,258,18,265,"[240,480]",Elevado,,,,258,Centro,VISEU,1823,50710.14,97249,5769,5038,4140,3158,2710,5868,10008,15046,20815,191.77,41.05,29.67,19.74
09-09-2021,VIZELA,69,5,289,"[240,480]",Elevado,,,,69,Norte,BRAGA,0314,2469.83,23897,1258,928,655,509,371,880,1535,2463,3721,967.49,150.65,99.72,62.15
09-09-2021,VOUZELA,12,1,125,"[120,240]",Moderado,,,,12,Centro,VISEU,1824,19369.46,9619,626,605,554,532,507,1039,1593,2198,2824,49.66,14.58,11.35,8.22
16-09-2021,ABRANTES,37,3,106,"[0,120]",Baixo a Moderado,,,,37,Lisboa e Vale do Tejo,SANTARÉM,1401,71469.08,35130,2473,2213,1730,1748,2021,3769,5499,7712,10185,49.15,14.25,10.79,7.69
16-09-2021,ÁGUEDA,24,2,52,"[0,120]",Baixo a Moderado,,,,24,Centro,AVEIRO,0101,33527.44,46075,3237,2713,2090,1635,1496,3131,5221,7934,11171,137.43,33.32,23.66,15.57
16-09-2021,AGUIAR DA BEIRA,3,0,65,"[0,120]",Baixo a Moderado,,,,3,Centro,GUARDA,0901,20676.57,4652,304,281,235,239,148,387,622,903,1207,22.5,5.84,4.37,3.01
16-09-2021,ALANDROAL,5,0,102,"[0,120]",Baixo a Moderado,,,,5,Alentejo,ÉVORA,0701,54267.81,4992,307,256,296,299,377,676,972,1228,1535,9.2,2.83,2.26,1.79
16-09-2021,ALBERGARIA-A-VELHA,21,1,86,"[0,120]",Baixo a Moderado,,,,21,Centro,AVEIRO,0102,15882.5,24144,1550,1298,996,687,680,1367,2363,3661,5211,152.02,32.81,23.05,14.88
16-09-2021,ALBUFEIRA,294,21,708,"[480,960]",Muito Elevado,,,,294,Algarve,FARO,0801,14066.42,41528,2067,1717,1425,985,858,1843,3268,4985,7052,295.24,50.14,35.44,23.23
16-09-2021,ALCÁCER DO SAL,4,0,35,"[0,120]",Baixo a Moderado,,,,4,Alentejo,SETÚBAL,1501,149987.3,11659,884,814,623,623,602,1225,1848,2662,3546,7.77,2.36,1.77,1.23
16-09-2021,ALCANENA,12,1,93,"[0,120]",Baixo a Moderado,,,,12,Lisboa e Vale do Tejo,SANTARÉM,1402,12732.86,12809,891,744,628,536,588,1124,1752,2496,3387,100.6,26.6,19.6,13.76
16-09-2021,ALCOBAÇA,65,5,121,"[120,240]",Moderado,,,,65,Lisboa e Vale do Tejo,LEIRIA,1001,40814.09,53555,3420,2927,2466,2059,1676,3735,6201,9128,12548,131.22,30.74,22.36,15.19
16-09-2021,ALCOCHETE,12,1,60,"[0,120]",Baixo a Moderado,,,,12,Lisboa e Vale do Tejo,SETÚBAL,1502,12836.48,19787,857,834,691,476,447,923,1614,2448,3305,154.15,25.75,19.07,12.57
16-09-2021,ALCOUTIM,0,0,0,"[0,120]",Baixo a Moderado,,,,0,Algarve,FARO,0802,57536.33,2159,191,188,163,190,267,457,620,808,999,3.75,1.74,1.4,1.08
16-09-2021,ALENQUER,47,3,107,"[0,120]",Baixo a Moderado,,,,47,Lisboa e Vale do Tejo,LISBOA,1101,30421.92,44052,2298,2062,1629,1330,1155,2485,4114,6176,8474,144.8,27.85,20.3,13.52
16-09-2021,ALFÂNDEGA DA FÉ,3,0,67,"[0,120]",Baixo a Moderado,,,,3,Norte,BRAGANÇA,0401,32194.64,4550,325,277,301,274,325,599,900,1177,1502,14.13,4.67,3.66,2.8
16-09-2021,ALIJÓ,7,1,66,"[0,120]",Baixo a Moderado,,,,7,Norte,VILA REAL,1701,29759.89,10625,766,687,635,542,666,1208,1843,2530,3296,35.7,11.08,8.5,6.19
16-09-2021,ALJEZUR,8,1,143,"[120,240]",Moderado,,,,8,Algarve,FARO,0803,32349.95,5594,316,336,335,320,410,730,1065,1401,1717,17.29,5.31,4.33,3.29
16-09-2021,ALJUSTREL,20,1,246,"[240,480]",Elevado,,,,20,Alentejo,BEJA,0201,45847.41,8247,635,521,443,347,358,705,1148,1669,2304,17.99,5.03,3.64,2.5
16-09-2021,ALMADA,281,20,166,"[120,240]",Moderado,,,,281,Lisboa e Vale do Tejo,SETÚBAL,1503,7000.89,169039,10469,9777,7876,6144,5111,11255,19131,28908,39377,2414.5,562.45,412.91,273.26
16-09-2021,ALMEIDA,5,0,86,"[0,120]",Baixo a Moderado,,,,5,Centro,GUARDA,0902,51798.46,5830,441,419,396,458,393,851,1247,1666,2107,11.26,4.07,3.22,2.41
16-09-2021,ALMEIRIM,37,3,165,"[120,240]",Moderado,,,,37,Lisboa e Vale do Tejo,SANTARÉM,1403,22212.05,22546,1342,1353,1106,866,843,1709,2815,4168,5510,101.5,24.81,18.76,12.67
16-09-2021,ALMODÔVAR,7,1,105,"[0,120]",Baixo a Moderado,,,,7,Alentejo,BEJA,0202,77788.03,6725,414,443,396,373,328,701,1097,1540,1954,8.65,2.51,1.98,1.41
16-09-2021,ALPIARÇA,9,1,129,"[120,240]",Moderado,,,,9,Lisboa e Vale do Tejo,SANTARÉM,1404,9536.33,7059,515,486,363,333,274,607,970,1456,1971,74.02,20.67,15.27,10.17
16-09-2021,ALTER DO CHÃO,2,0,64,"[0,120]",Baixo a Moderado,,,,2,Alentejo,PORTALEGRE,1201,36206.62,3165,201,163,136,208,187,395,531,694,895,8.74,2.47,1.92,1.47
16-09-2021,ALVAIÁZERE,2,0,30,"[0,120]",Baixo a Moderado,,,,2,Centro,LEIRIA,1002,16047.76,6597,419,389,346,406,539,945,1291,1680,2099,41.11,13.08,10.47,8.04
16-09-2021,ALVITO,5,0,203,"[120,240]",Moderado,,,,5,Alentejo,BEJA,0203,26485.32,2477,145,110,105,111,89,200,305,415,560,9.35,2.11,1.57,1.15
16-09-2021,AMADORA,335,24,182,"[120,240]",Moderado,,,,335,Lisboa e Vale do Tejo,LISBOA,1115,2378.47,184106,11186,10936,8780,6460,5890,12350,21130,32066,43252,7742.05,1818.84,1348.44,888.56
16-09-2021,AMARANTE,78,6,146,"[120,240]",Moderado,,,,78,Norte,PORTO,1301,30133.15,53193,3086,2413,1812,1643,1311,2954,4766,7179,10265,176.53,34.07,23.82,15.82
16-09-2021,AMARES,65,5,359,"[240,480]",Elevado,,,,65,Norte,BRAGA,0301,8195.41,18129,1001,829,622,489,524,1013,1635,2464,3465,221.22,42.28,30.07,19.95
16-09-2021,ANADIA,34,2,124,"[120,240]",Moderado,,,,34,Centro,AVEIRO,0103,21663.48,27258,1931,1698,1376,1208,1262,2470,3846,5544,7475,125.83,34.51,25.59,17.75
16-09-2021,ANGRA DO HEROÍSMO,15,1,45,"[0,120]",Baixo a Moderado,,,,15,Açores,AÇORES,4301,23899.66,33807,2006,1473,1122,768,635,1403,2525,3998,6004,141.45,25.12,16.73,10.56
16-09-2021,ANSIÃO,8,1,66,"[0,120]",Baixo a Moderado,,,,8,Centro,LEIRIA,1003,17609.42,12039,727,709,646,694,530,1224,1870,2579,3306,68.37,18.77,14.65,10.62
16-09-2021,ARCOS DE VALDEVEZ,45,3,217,"[120,240]",Moderado,,,,45,Norte,VIANA DO CASTELO,1601,44759.64,20926,1329,1338,1282,1343,1515,2858,4140,5478,6807,46.75,15.21,12.24,9.25
16-09-2021,ARGANIL,16,1,146,"[120,240]",Moderado,,,,16,Centro,COIMBRA,0601,33283.93,11014,672,648,612,559,596,1155,1767,2415,3087,33.09,9.27,7.26,5.31
16-09-2021,ARMAMAR,0,0,0,"[0,120]",Baixo a Moderado,,,,0,Norte,VISEU,1801,11723.73,5769,357,305,309,285,310,595,904,1209,1566,49.21,13.36,10.31,7.71
16-09-2021,AROUCA,40,3,194,"[120,240]",Moderado,,,,40,Norte,AVEIRO,0104,32910.52,20720,1306,1047,753,683,683,1366,2119,3166,4472,62.96,13.59,9.62,6.44
16-09-2021,ARRAIOLOS,8,1,116,"[0,120]",Baixo a Moderado,,,,8,Alentejo,ÉVORA,0702,68374.55,6928,435,384,283,367,480,847,1130,1514,1949,10.13,2.85,2.21,1.65
16-09-2021,ARRONCHES,1,0,36,"[0,120]",Baixo a Moderado,,,,1,Alentejo,PORTALEGRE,1202,31464.72,2820,155,142,162,187,179,366,528,670,825,8.96,2.62,2.13,1.68
16-09-2021,ARRUDA DOS VINHOS,20,1,133,"[120,240]",Moderado,,,,20,Lisboa e Vale do Tejo,LISBOA,1102,7795.93,15412,738,738,562,509,438,947,1509,2247,2985,197.69,38.29,28.82,19.36
16-09-2021,AVEIRO,77,6,98,"[0,120]",Baixo a Moderado,,,,77,Centro,AVEIRO,0105,19757.57,78734,4520,4004,3050,2250,2103,4353,7403,11407,15927,398.49,80.61,57.73,37.47
16-09-2021,AVIS,1,0,24,"[0,120]",Baixo a Moderado,,,,1,Alentejo,PORTALEGRE,1203,60596.51,4247,315,225,206,251,273,524,730,955,1270,7.01,2.1,1.58,1.2
16-09-2021,AZAMBUJA,13,1,57,"[0,120]",Baixo a Moderado,,,,13,Lisboa e Vale do Tejo,LISBOA,1103,26265.65,22716,1322,1171,1070,798,618,1416,2486,3657,4979,86.48,18.96,13.92,9.46
16-09-2021,BAIÃO,12,1,65,"[0,120]",Baixo a Moderado,,,,12,Norte,PORTO,1302,17452.83,18748,1070,862,714,686,725,1411,2125,2987,4057,107.42,23.25,17.11,12.18
16-09-2021,BARCELOS,250,18,215,"[120,240]",Moderado,,,,250,Norte,BRAGA,0302,37890.14,116187,6721,5325,3619,2991,2562,5553,9172,14497,21218,306.64,56.0,38.26,24.21
16-09-2021,BARRANCOS,12,1,739,"[480,960]",Muito Elevado,,,,12,Alentejo,BEJA,0204,16841.73,1634,90,65,65,94,61,155,220,285,375,9.7,2.23,1.69,1.31
16-09-2021,BARREIRO,112,8,149,"[120,240]",Moderado,,,,112,Lisboa e Vale do Tejo,SETÚBAL,1504,3639.07,75147,5194,5565,4459,3105,1767,4872,9331,14896,20090,2065.05,552.07,409.34,256.42
16-09-2021,BATALHA,24,2,148,"[120,240]",Moderado,,,,24,Centro,LEIRIA,1004,10341.6,15963,873,762,649,529,549,1078,1727,2489,3362,154.35,32.51,24.07,16.7
16-09-2021,BEJA,134,10,399,"[240,480]",Elevado,,,,134,Alentejo,BEJA,0205,114647.55,33579,2005,1840,1386,1272,1039,2311,3697,5537,7542,29.29,6.58,4.83,3.22
16-09-2021,BELMONTE,11,1,172,"[120,240]",Moderado,,,,11,Centro,CASTELO BRANCO,0501,11875.91,6398,444,321,325,310,355,665,990,1311,1755,53.87,14.78,11.04,8.34
16-09-2021,BENAVENTE,70,5,228,"[120,240]",Moderado,,,,70,Lisboa e Vale do Tejo,SANTARÉM,1405,52138.39,30602,1468,1376,1141,876,643,1519,2660,4036,5504,58.69,10.56,7.74,5.1
16-09-2021,BOMBARRAL,15,1,118,"[0,120]",Baixo a Moderado,,,,15,Lisboa e Vale do Tejo,LEIRIA,1005,9128.55,12558,875,714,561,491,429,920,1481,2195,3070,137.56,33.63,24.04,16.22
16-09-2021,BORBA,12,1,180,"[120,240]",Moderado,,,,12,Alentejo,ÉVORA,0703,14518.65,6736,430,375,279,436,392,828,1107,1482,1912,46.39,13.17,10.21,7.62
16-09-2021,BOTICAS,24,2,487,"[480,960]",Muito Elevado,,,,24,Norte,VILA REAL,1702,32195.66,4998,347,306,311,305,380,685,996,1302,1649,15.52,5.12,4.04,3.09
16-09-2021,BRAGA,373,27,204,"[120,240]",Moderado,,,,373,Norte,BRAGA,0303,18339.95,182679,10029,7963,5241,4320,3671,7991,13232,21195,31224,996.07,170.25,115.57,72.15
16-09-2021,BRAGANÇA,53,4,158,"[120,240]",Moderado,,,,53,Norte,BRAGANÇA,0402,117357.27,33607,2402,1855,1652,1393,1163,2556,4208,6063,8465,28.64,7.21,5.17,3.59
16-09-2021,CABECEIRAS DE BASTO,58,4,374,"[240,480]",Elevado,,,,58,Norte,BRAGA,0304,24182.16,15628,774,594,544,575,574,1149,1693,2287,3061,64.63,12.66,9.46,7.0
16-09-2021,CADAVAL,14,1,102,"[0,120]",Baixo a Moderado,,,,14,Lisboa e Vale do Tejo,LISBOA,1104,17489.3,13673,813,796,756,621,625,1246,2002,2798,3611,78.18,20.65,16.0,11.45
16-09-2021,CALDAS DA RAINHA,52,4,101,"[0,120]",Baixo a Moderado,,,,52,Lisboa e Vale do Tejo,LEIRIA,1006,25569.47,51912,3035,2684,2186,1899,1705,3604,5790,8474,11509,203.03,45.01,33.14,22.64
16-09-2021,CALHETA,8,1,74,"[0,120]",Baixo a Moderado,,,,8,Madeira,MADEIRA,3101,11150.43,10867,576,497,507,399,415,814,1321,1818,2394,97.46,21.47,16.3,11.85
16-09-2021,CALHETA (AÇORES),0,0,0,"[0,120]",Baixo a Moderado,,,,0,Açores,AÇORES,4501,12626.4,3184,215,159,141,139,122,261,402,561,776,25.22,6.15,4.44,3.18
16-09-2021,CÂMARA DE LOBOS,12,1,36,"[0,120]",Baixo a Moderado,,,,12,Madeira,MADEIRA,3102,5216.67,33675,1396,1059,834,545,381,926,1760,2819,4215,645.49,80.79,54.03,33.74
16-09-2021,CAMINHA,23,2,146,"[120,240]",Moderado,,,,23,Norte,VIANA DO CASTELO,1602,13652.14,15877,1046,944,818,646,656,1302,2120,3064,4110,116.3,30.11,22.44,15.53
16-09-2021,CAMPO MAIOR,28,2,359,"[240,480]",Elevado,,,,28,Alentejo,PORTALEGRE,1204,24720.16,7874,471,364,351,279,327,606,957,1321,1792,31.85,7.25,5.34,3.87
16-09-2021,CANTANHEDE,81,6,231,"[120,240]",Moderado,,,,81,Centro,COIMBRA,0602,39088.02,35011,2346,2096,1880,1709,1451,3160,5040,7136,9482,89.57,24.26,18.26,12.89
16-09-2021,CARRAZEDA DE ANSIÃES,3,0,53,"[0,120]",Baixo a Moderado,,,,3,Norte,BRAGANÇA,0403,27924.09,5666,424,389,391,312,465,777,1168,1557,1981,20.29,7.09,5.58,4.18
16-09-2021,CARREGAL DO SAL,2,0,21,"[0,120]",Baixo a Moderado,,,,2,Centro,VISEU,1802,11689.21,9271,587,562,486,462,376,838,1324,1886,2473,79.31,21.16,16.13,11.33
16-09-2021,CARTAXO,33,2,139,"[120,240]",Moderado,,,,33,Lisboa e Vale do Tejo,SANTARÉM,1406,15817.28,23843,1415,1376,1142,861,632,1493,2635,4011,5426,150.74,34.3,25.36,16.66
16-09-2021,CASCAIS,389,28,182,"[120,240]",Moderado,,,,389,Lisboa e Vale do Tejo,LISBOA,1105,9740.17,213608,12151,11444,8680,6469,5248,11717,20397,31841,43992,2193.1,451.66,326.91,209.41
16-09-2021,CASTANHEIRA DE PÊRA,3,0,116,"[0,120]",Baixo a Moderado,,,,3,Centro,LEIRIA,1007,6677.45,2614,233,195,157,190,187,377,534,729,962,39.15,14.41,10.92,8.0
16-09-2021,CASTELO BRANCO,142,10,273,"[240,480]",Elevado,,,,142,Centro,CASTELO BRANCO,0502,143819.15,51987,3528,3042,2499,2229,2225,4454,6953,9995,13523,36.15,9.4,6.95,4.83
16-09-2021,CASTELO DE PAIVA,16,1,105,"[0,120]",Baixo a Moderado,,,,16,Norte,AVEIRO,0106,11500.53,15454,881,697,545,420,431,851,1396,2093,2974,134.37,25.86,18.2,12.14
16-09-2021,CASTELO DE VIDE,3,0,104,"[0,120]",Baixo a Moderado,,,,3,Alentejo,PORTALEGRE,1205,26491.24,2919,204,173,179,147,170,317,496,669,873,11.02,3.3,2.53,1.87
16-09-2021,CASTRO DAIRE,20,1,145,"[120,240]",Moderado,,,,20,Centro,VISEU,1803,37904.13,13823,942,857,765,732,773,1505,2270,3127,4069,36.47,10.74,8.25,5.99
16-09-2021,CASTRO MARIM,6,0,97,"[0,120]",Baixo a Moderado,,,,6,Algarve,FARO,0804,30084.37,6237,370,345,334,322,344,666,1000,1345,1715,20.73,5.7,4.47,3.32
16-09-2021,CASTRO VERDE,5,0,73,"[0,120]",Baixo a Moderado,,,,5,Alentejo,BEJA,0206,56944.23,6949,437,347,303,275,227,502,805,1152,1589,12.2,2.79,2.02,1.41
16-09-2021,CELORICO DA BEIRA,57,4,822,"[480,960]",Muito Elevado,,,,57,Centro,GUARDA,0903,24721.63,6928,430,416,363,369,535,904,1267,1683,2113,28.02,8.55,6.81,5.12
16-09-2021,CELORICO DE BASTO,26,2,138,"[120,240]",Moderado,,,,26,Norte,BRAGA,0305,18107.02,19040,1001,802,668,728,729,1457,2125,2927,3928,105.15,21.69,16.17,11.74
16-09-2021,CHAMUSCA,2,0,22,"[0,120]",Baixo a Moderado,,,,2,Lisboa e Vale do Tejo,SANTARÉM,1407,74600.54,9197,629,583,553,465,579,1044,1597,2180,2809,12.33,3.77,2.92,2.14
16-09-2021,CHAVES,71,5,181,"[120,240]",Moderado,,,,71,Norte,VILA REAL,1703,59122.95,39343,2676,2429,1991,1886,1918,3804,5795,8224,10900,66.54,18.44,13.91,9.8
16-09-2021,CINFÃES,33,2,183,"[120,240]",Moderado,,,,33,Norte,VISEU,1804,23928.76,18244,1067,902,779,734,758,1492,2271,3173,4240,76.24,17.72,13.26,9.49
16-09-2021,COIMBRA,188,13,140,"[120,240]",Moderado,,,,188,Centro,COIMBRA,0603,31939.94,134166,9489,8734,6353,5139,5074,10213,16566,25300,34789,420.06,108.92,79.21,51.87
16-09-2021,CONDEIXA-A-NOVA,60,4,341,"[240,480]",Elevado,,,,60,Centro,COIMBRA,0604,13867.47,17733,871,809,717,583,490,1073,1790,2599,3470,127.88,25.02,18.74,12.91
16-09-2021,CONSTÂNCIA,1,0,25,"[0,120]",Baixo a Moderado,,,,1,Lisboa e Vale do Tejo,SANTARÉM,1408,8036.58,4030,211,183,187,148,155,303,490,673,884,50.14,11.0,8.37,6.1
16-09-2021,CORUCHE,4,0,23,"[0,120]",Baixo a Moderado,,,,4,Lisboa e Vale do Tejo,SANTARÉM,1409,111572.03,17471,1294,1090,1095,1096,1019,2115,3210,4300,5594,15.66,5.01,3.85,2.88
16-09-2021,CORVO,0,0,0,"[0,120]",Baixo a Moderado,,,,0,Açores,AÇORES,4901,1711.45,464,22,21,11,13,19,32,43,64,86,27.12,5.03,3.74,2.51
16-09-2021,COVILHÃ,143,10,306,"[240,480]",Elevado,,,,143,Centro,CASTELO BRANCO,0503,55560.06,46787,3533,2998,2365,2111,2193,4304,6669,9667,13200,84.21,23.76,17.4,12.0
16-09-2021,CRATO,3,0,98,"[0,120]",Baixo a Moderado,,,,3,Alentejo,PORTALEGRE,1206,39806.88,3129,229,258,163,182,228,410,573,831,1060,7.86,2.66,2.09,1.44
16-09-2021,CUBA,7,1,154,"[120,240]",Moderado,,,,7,Alentejo,BEJA,0207,17208.72,4595,255,233,206,190,143,333,539,772,1027,26.7,5.97,4.49,3.13
16-09-2021,ELVAS,27,2,133,"[120,240]",Moderado,,,,27,Alentejo,PORTALEGRE,1207,63128.86,20528,1057,1145,902,852,810,1662,2564,3709,4766,32.52,7.55,5.88,4.06
16-09-2021,ENTRONCAMENTO,40,3,187,"[120,240]",Moderado,,,,40,Lisboa e Vale do Tejo,SANTARÉM,1410,1372.81,21558,1066,930,868,695,592,1287,2155,3085,4151,1570.14,302.33,224.69,156.96
16-09-2021,ESPINHO,27,2,92,"[0,120]",Baixo a Moderado,,,,27,Norte,AVEIRO,0107,2105.68,29516,2205,1993,1430,1177,960,2137,3567,5560,7765,1401.52,368.71,264.01,169.37
16-09-2021,ESPOSENDE,75,5,219,"[120,240]",Moderado,,,,75,Norte,BRAGA,0306,9540.98,34177,1831,1522,1095,894,723,1617,2712,4234,6065,358.21,63.57,44.38,28.42
16-09-2021,ESTARREJA,23,2,88,"[0,120]",Baixo a Moderado,,,,23,Centro,AVEIRO,0108,10817.33,26006,1503,1399,1106,953,728,1681,2787,4186,5689,240.42,52.59,38.7,25.76
16-09-2021,ESTREMOZ,8,1,63,"[0,120]",Baixo a Moderado,,,,8,Alentejo,ÉVORA,0704,51379.95,12728,789,613,697,786,877,1663,2360,2973,3762,24.77,7.32,5.79,4.59
16-09-2021,ÉVORA,101,7,192,"[120,240]",Moderado,,,,101,Alentejo,ÉVORA,0705,130707.58,52428,3569,2852,2176,1966,1803,3769,5945,8797,12366,40.11,9.46,6.73,4.55
16-09-2021,FAFE,221,16,459,"[240,480]",Elevado,,,,221,Norte,BRAGA,0307,21908.11,48060,3044,2455,1679,1403,1208,2611,4290,6745,9789,219.37,44.68,30.79,19.58
16-09-2021,FARO,152,11,249,"[240,480]",Elevado,,,,152,Algarve,FARO,0805,20256.79,61015,3847,3364,2604,2055,1601,3656,6260,9624,13471,301.2,66.5,47.51,30.9
16-09-2021,FELGUEIRAS,117,8,207,"[120,240]",Moderado,,,,117,Norte,PORTO,1303,11573.75,56422,2951,2302,1601,1316,973,2289,3890,6192,9143,487.49,79.0,53.5,33.61
16-09-2021,FERREIRA DO ALENTEJO,8,1,102,"[0,120]",Baixo a Moderado,,,,8,Alentejo,BEJA,0208,64820.68,7845,515,414,372,343,345,688,1060,1474,1989,12.1,3.07,2.27,1.64
16-09-2021,FERREIRA DO ZÊZERE,19,1,239,"[120,240]",Moderado,,,,19,Lisboa e Vale do Tejo,SANTARÉM,1411,19038.03,7959,470,370,416,465,456,921,1337,1707,2177,41.81,11.44,8.97,7.02
16-09-2021,FIGUEIRA DA FOZ,89,6,151,"[120,240]",Moderado,,,,89,Centro,COIMBRA,0605,37905.26,58747,4032,3597,2887,2495,2043,4538,7425,11022,15054,154.98,39.72,29.08,19.59
16-09-2021,FIGUEIRA DE CASTELO RODRIGO,19,1,340,"[240,480]",Elevado,,,,19,Centro,GUARDA,0904,50857.46,5584,347,352,290,352,391,743,1033,1385,1732,10.98,3.41,2.72,2.03
16-09-2021,FIGUEIRÓ DOS VINHOS,2,0,36,"[0,120]",Baixo a Moderado,,,,2,Centro,LEIRIA,1008,17344.0,5568,402,386,322,309,351,660,982,1368,1770,32.1,10.21,7.89,5.66
16-09-2021,FORNOS DE ALGODRES,12,1,264,"[240,480]",Elevado,,,,12,Centro,GUARDA,0905,13145.05,4528,261,218,247,256,232,488,735,953,1214,34.45,9.24,7.25,5.59
16-09-2021,FREIXO DE ESPADA À CINTA,0,0,0,"[0,120]",Baixo a Moderado,,,,0,Norte,BRAGANÇA,0404,24414.29,3298,211,177,231,196,189,385,616,793,1004,13.51,4.11,3.25,2.52
16-09-2021,FRONTEIRA,3,0,102,"[0,120]",Baixo a Moderado,,,,3,Alentejo,PORTALEGRE,1208,24859.58,2974,213,182,149,156,168,324,473,655,868,11.96,3.49,2.63,1.9
16-09-2021,FUNCHAL,162,12,156,"[120,240]",Moderado,,,,162,Madeira,MADEIRA,3103,7616.2,104024,6382,5086,3643,2821,1990,4811,8454,13540,19922,1365.86,261.58,177.78,111.0
16-09-2021,FUNDÃO,24,2,91,"[0,120]",Baixo a Moderado,,,,24,Centro,CASTELO BRANCO,0504,70019.79,26495,1781,1464,1432,1357,1643,3000,4432,5896,7677,37.84,10.96,8.42,6.33
16-09-2021,GAVIÃO,2,0,63,"[0,120]",Baixo a Moderado,,,,2,Alentejo,PORTALEGRE,1209,29459.45,3263,189,186,222,263,293,556,778,964,1153,11.08,3.91,3.27,2.64
16-09-2021,GÓIS,0,0,0,"[0,120]",Baixo a Moderado,,,,0,Centro,COIMBRA,0606,26330.19,3805,235,199,240,233,244,477,717,916,1151,14.45,4.37,3.48,2.72
16-09-2021,GOLEGÃ,4,0,76,"[0,120]",Baixo a Moderado,,,,4,Lisboa e Vale do Tejo,SANTARÉM,1412,8431.67,5339,356,299,281,243,255,498,779,1078,1434,63.32,17.01,12.78,9.24
16-09-2021,GONDOMAR,168,12,101,"[0,120]",Baixo a Moderado,,,,168,Norte,PORTO,1304,13191.76,165985,10555,8755,6222,4450,3364,7814,14036,22791,33346,1258.22,252.77,172.76,106.4
16-09-2021,GOUVEIA,6,0,49,"[0,120]",Baixo a Moderado,,,,6,Centro,GUARDA,0906,30061.17,12387,871,931,780,783,810,1593,2373,3304,4175,41.21,13.89,10.99,7.89
16-09-2021,GRÂNDOLA,28,2,192,"[120,240]",Moderado,,,,28,Alentejo,SETÚBAL,1505,82593.66,14639,834,834,708,688,672,1360,2068,2902,3736,17.72,4.52,3.51,2.5
16-09-2021,GUARDA,68,5,174,"[120,240]",Moderado,,,,68,Centro,GUARDA,0907,71209.58,38969,2477,2041,1686,1415,1474,2889,4575,6616,9093,54.72,12.77,9.29,6.42
16-09-2021,GUIMARÃES,373,27,245,"[240,480]",Elevado,,,,373,Norte,BRAGA,0308,24099.96,152309,9394,7074,4809,3877,2948,6825,11634,18708,28102,631.99,116.61,77.63,48.27
16-09-2021,HORTA,5,0,35,"[0,120]",Baixo a Moderado,,,,5,Açores,AÇORES,4701,17305.53,14521,818,658,468,352,302,654,1122,1780,2598,83.91,15.01,10.29,6.48
16-09-2021,IDANHA-A-NOVA,6,0,76,"[0,120]",Baixo a Moderado,,,,6,Centro,CASTELO BRANCO,0505,141633.51,8043,518,490,519,672,974,1646,2165,2655,3173,5.68,2.24,1.87,1.53
16-09-2021,ÍLHAVO,34,2,89,"[0,120]",Baixo a Moderado,,,,34,Centro,AVEIRO,0110,7347.55,38699,2227,1943,1444,1193,850,2043,3487,5430,7657,526.66,104.21,73.9,47.46
16-09-2021,LAGOA (FARO),67,5,295,"[240,480]",Elevado,,,,67,Algarve,FARO,0806,8825.45,22762,1314,1168,919,749,670,1419,2338,3506,4820,257.93,54.62,39.73,26.49
16-09-2021,LAGOA,6,0,41,"[0,120]",Baixo a Moderado,,,,6,Açores,AÇORES,4201,4559.32,14721,536,458,349,238,235,473,822,1280,1816,322.9,39.83,28.08,18.03
16-09-2021,LAGOS,135,10,443,"[240,480]",Elevado,,,,135,Algarve,FARO,0807,21299.27,30374,1744,1434,1247,1053,1029,2082,3329,4763,6507,142.61,30.55,22.36,15.63
16-09-2021,LAJES DAS FLORES,0,0,0,"[0,120]",Baixo a Moderado,,,,0,Açores,AÇORES,4801,7004.79,1463,88,53,62,46,54,100,162,215,303,20.89,4.33,3.07,2.31
16-09-2021,LAJES DO PICO,0,0,0,"[0,120]",Baixo a Moderado,,,,0,Açores,AÇORES,4601,15531.09,4490,304,231,223,159,162,321,544,775,1079,28.91,6.95,4.99,3.5
16-09-2021,LAMEGO,36,3,145,"[120,240]",Moderado,,,,36,Norte,VISEU,1805,16542.11,24895,1639,1284,1124,898,783,1681,2805,4089,5728,150.5,34.63,24.72,16.96
16-09-2021,LEIRIA,318,23,254,"[240,480]",Elevado,,,,318,Centro,LEIRIA,1009,56508.83,125267,7389,6366,5090,3902,3159,7061,12151,18517,25906,221.68,45.84,32.77,21.5
16-09-2021,LISBOA,958,68,188,"[120,240]",Moderado,,,,958,Lisboa e Vale do Tejo,LISBOA,1106,10005.43,509515,33197,33340,27706,23037,26770,49807,77513,110853,144050,5092.6,1439.78,1107.98,774.74
16-09-2021,LOULÉ,317,23,462,"[240,480]",Elevado,,,,317,Algarve,FARO,0808,76366.91,68697,3890,3350,2780,2358,2251,4609,7389,10739,14629,89.96,19.16,14.06,9.68
16-09-2021,LOURES,299,21,140,"[120,240]",Moderado,,,,299,Lisboa e Vale do Tejo,LISBOA,1107,16723.99,213687,12746,12794,9644,6669,5033,11702,21346,34140,46886,1277.73,280.35,204.14,127.64
16-09-2021,LOURINHÃ,47,3,183,"[120,240]",Moderado,,,,47,Lisboa e Vale do Tejo,LISBOA,1108,14717.2,25855,1584,1243,992,842,645,1487,2479,3722,5306,175.68,36.05,25.29,16.84
16-09-2021,LOUSÃ,18,1,104,"[0,120]",Baixo a Moderado,,,,18,Centro,COIMBRA,0607,13840.01,17158,946,866,658,528,450,978,1636,2502,3448,123.97,24.91,18.08,11.82
16-09-2021,LOUSADA,70,5,150,"[120,240]",Moderado,,,,70,Norte,PORTO,1305,9608.01,46755,2289,1698,1176,853,621,1474,2650,4348,6637,486.63,69.08,45.25,27.58
16-09-2021,MAÇÃO,6,0,97,"[0,120]",Baixo a Moderado,,,,6,Lisboa e Vale do Tejo,SANTARÉM,1413,39997.98,6267,386,362,390,440,657,1097,1487,1849,2235,15.67,5.59,4.62,3.72
16-09-2021,MACEDO DE CAVALEIROS,14,1,97,"[0,120]",Baixo a Moderado,,,,14,Norte,BRAGANÇA,0405,69914.08,14516,1082,889,878,823,938,1761,2639,3528,4610,20.76,6.59,5.05,3.77
16-09-2021,MACHICO,5,0,25,"[0,120]",Baixo a Moderado,,,,5,Madeira,MADEIRA,3104,6825.1,19981,1197,860,662,455,331,786,1448,2308,3505,292.76,51.36,33.82,21.22
16-09-2021,MADALENA,22,2,374,"[240,480]",Elevado,,,,22,Açores,AÇORES,4602,14712.33,5895,334,256,173,190,179,369,542,798,1132,40.07,7.69,5.42,3.68
16-09-2021,MAFRA,90,6,106,"[0,120]",Baixo a Moderado,,,,90,Lisboa e Vale do Tejo,LISBOA,1109,29165.5,84816,3613,3334,2839,2089,1899,3988,6827,10161,13774,290.81,47.23,34.84,23.41
16-09-2021,MAIA,145,10,104,"[0,120]",Baixo a Moderado,,,,145,Norte,PORTO,1306,8293.94,138971,7801,6617,4512,3339,2631,5970,10482,17099,24900,1675.56,300.22,206.16,126.38
16-09-2021,MANGUALDE,28,2,151,"[120,240]",Moderado,,,,28,Centro,VISEU,1806,21925.56,18510,1198,1128,885,852,743,1595,2480,3608,4806,84.42,21.92,16.46,11.31
16-09-2021,MANTEIGAS,8,1,268,"[240,480]",Elevado,,,,8,Centro,GUARDA,0908,12197.55,3007,258,197,159,167,146,313,472,669,927,24.65,7.6,5.48,3.87
16-09-2021,MARCO DE CANAVESES,20,1,39,"[0,120]",Baixo a Moderado,,,,20,Norte,PORTO,1307,20188.98,51496,2678,2060,1488,1265,1023,2288,3776,5836,8514,255.07,42.17,28.91,18.7
16-09-2021,MARINHA GRANDE,67,5,175,"[120,240]",Moderado,,,,67,Centro,LEIRIA,1010,18725.19,38508,2365,2302,1638,1359,1058,2417,4055,6357,8722,205.65,46.58,33.95,21.66
16-09-2021,MARVÃO,1,0,34,"[0,120]",Baixo a Moderado,,,,1,Alentejo,PORTALEGRE,1210,15489.9,3005,198,185,142,197,237,434,576,761,959,19.4,6.19,4.91,3.72
16-09-2021,MATOSINHOS,198,14,113,"[0,120]",Baixo a Moderado,,,,198,Norte,PORTO,1308,6241.97,175357,11850,9977,7023,5024,3884,8908,15931,25908,37758,2809.31,604.9,415.06,255.22
16-09-2021,MEALHADA,12,1,60,"[0,120]",Baixo a Moderado,,,,12,Centro,AVEIRO,0111,11065.66,19914,1163,1039,810,828,831,1659,2469,3508,4671,179.96,42.21,31.7,22.31
16-09-2021,MÊDA,6,0,131,"[120,240]",Moderado,,,,6,Centro,GUARDA,0909,28604.92,4587,343,306,290,288,443,731,1021,1327,1670,16.04,5.84,4.64,3.57
16-09-2021,MELGAÇO,11,1,138,"[120,240]",Moderado,,,,11,Norte,VIANA DO CASTELO,1603,23824.58,8093,507,567,578,614,675,1289,1867,2434,2941,33.97,12.34,10.22,7.84
16-09-2021,MÉRTOLA,13,1,215,"[120,240]",Moderado,,,,13,Alentejo,BEJA,0209,129287.34,6142,400,390,378,423,600,1023,1401,1791,2191,4.75,1.69,1.39,1.08
16-09-2021,MESÃO FRIO,7,1,178,"[120,240]",Moderado,,,,7,Norte,VILA REAL,1704,2664.87,3964,265,205,168,157,120,277,445,650,915,148.74,34.33,24.39,16.7
16-09-2021,MIRA,2,0,17,"[0,120]",Baixo a Moderado,,,,2,Centro,COIMBRA,0608,12403.38,11832,727,729,659,550,466,1016,1675,2404,3131,95.4,25.24,19.38,13.5
16-09-2021,MIRANDA DO CORVO,3,0,24,"[0,120]",Baixo a Moderado,,,,3,Centro,COIMBRA,0609,12637.79,12708,706,659,568,498,404,902,1470,2129,2835,100.55,22.43,16.85,11.63
16-09-2021,MIRANDA DO DOURO,0,0,0,"[0,120]",Baixo a Moderado,,,,0,Norte,BRAGANÇA,0406,48718.31,6830,482,429,442,463,470,933,1375,1804,2286,14.02,4.69,3.7,2.82
16-09-2021,MIRANDELA,35,3,162,"[120,240]",Moderado,,,,35,Norte,BRAGANÇA,0407,65895.67,21754,1640,1315,1204,1078,947,2025,3229,4544,6184,33.01,9.38,6.9,4.9
16-09-2021,MOGADOURO,3,0,36,"[0,120]",Baixo a Moderado,,,,3,Norte,BRAGANÇA,0408,76064.93,8392,589,529,576,630,655,1285,1861,2390,2979,11.03,3.92,3.14,2.45
16-09-2021,MOIMENTA DA BEIRA,10,1,103,"[0,120]",Baixo a Moderado,,,,10,Norte,VISEU,1807,21996.9,9736,576,514,471,416,461,877,1348,1862,2438,44.26,11.08,8.46,6.13
16-09-2021,MOITA,109,8,170,"[120,240]",Moderado,,,,109,Lisboa e Vale do Tejo,SETÚBAL,1506,5525.98,64407,4226,3646,2623,1801,1425,3226,5849,9495,13721,1165.53,248.3,171.82,105.85
16-09-2021,MONÇÃO,8,1,45,"[0,120]",Baixo a Moderado,,,,8,Norte,VIANA DO CASTELO,1604,21130.85,17869,1161,1105,1031,1006,972,1978,3009,4114,5275,84.56,24.96,19.47,14.24
16-09-2021,MONCHIQUE,13,1,261,"[240,480]",Elevado,,,,13,Algarve,FARO,0809,39530.43,5077,353,384,321,355,392,747,1068,1452,1805,12.84,4.57,3.67,2.7
16-09-2021,MONDIM DE BASTO,14,1,203,"[120,240]",Moderado,,,,14,Norte,VILA REAL,1705,17207.52,6946,395,300,314,284,283,567,881,1181,1576,40.36,9.16,6.86,5.12
16-09-2021,MONFORTE,4,0,136,"[120,240]",Moderado,,,,4,Alentejo,PORTALEGRE,1211,42024.82,2975,139,115,117,192,168,360,477,592,731,7.08,1.74,1.41,1.14
16-09-2021,MONTALEGRE,58,4,642,"[480,960]",Muito Elevado,,,,58,Norte,VILA REAL,1706,80545.71,8997,699,628,595,603,730,1333,1928,2556,3255,11.17,4.04,3.17,2.39
16-09-2021,MONTEMOR-O-NOVO,16,1,104,"[0,120]",Baixo a Moderado,,,,16,Alentejo,ÉVORA,0706,123296.65,15647,991,953,868,878,971,1849,2717,3670,4661,12.69,3.78,2.98,2.2
16-09-2021,MONTEMOR-O-VELHO,27,2,107,"[0,120]",Baixo a Moderado,,,,27,Centro,COIMBRA,0610,22896.23,25224,1496,1397,1217,1057,988,2045,3262,4659,6155,110.17,26.88,20.35,14.25
16-09-2021,MONTIJO,69,5,120,"[120,240]",Moderado,,,,69,Lisboa e Vale do Tejo,SETÚBAL,1507,34861.64,57614,2771,2441,1990,1554,1109,2663,4653,7094,9865,165.26,28.3,20.35,13.35
16-09-2021,MORA,0,0,0,"[0,120]",Baixo a Moderado,,,,0,Alentejo,ÉVORA,0707,44395.02,4138,336,275,252,238,257,495,747,1022,1358,9.32,3.06,2.3,1.68
16-09-2021,MORTÁGUA,7,0,79,"[0,120]",Baixo a Moderado,,,,7,Centro,VISEU,1808,25117.82,8803,638,584,535,499,460,959,1494,2078,2716,35.05,10.81,8.27,5.95
16-09-2021,MOURA,34,2,250,"[240,480]",Elevado,,,,34,Alentejo,BEJA,0210,95845.55,13718,817,656,665,542,461,1003,1668,2324,3141,14.31,3.28,2.42,1.74
16-09-2021,MOURÃO,6,0,247,"[240,480]",Elevado,,,,6,Alentejo,ÉVORA,0708,27862.98,2450,139,108,80,104,109,213,293,401,540,8.79,1.94,1.44,1.05
16-09-2021,MURÇA,0,0,0,"[0,120]",Baixo a Moderado,,,,0,Norte,VILA REAL,1707,18937.11,5463,384,341,307,306,319,625,932,1273,1657,28.85,8.75,6.72,4.92
16-09-2021,MURTOSA,4,0,38,"[0,120]",Baixo a Moderado,,,,4,Centro,AVEIRO,0112,7308.78,10279,509,473,403,353,409,762,1165,1638,2147,140.63,29.37,22.41,15.94
16-09-2021,NAZARÉ,16,1,112,"[0,120]",Baixo a Moderado,,,,16,Lisboa e Vale do Tejo,LEIRIA,1011,8243.43,14165,967,903,670,420,396,816,1486,2389,3356,171.84,40.71,28.98,18.03
16-09-2021,NELAS,9,1,69,"[0,120]",Baixo a Moderado,,,,9,Centro,VISEU,1809,12571.48,12974,924,787,668,604,583,1187,1855,2642,3566,103.21,28.37,21.02,14.76
16-09-2021,NISA,11,1,185,"[120,240]",Moderado,,,,11,Alentejo,PORTALEGRE,1212,57567.84,6061,405,389,355,483,478,961,1316,1705,2110,10.53,3.67,2.96,2.29
16-09-2021,NORDESTE,0,0,0,"[0,120]",Baixo a Moderado,,,,0,Açores,AÇORES,4202,10146.8,4862,246,180,124,161,162,323,447,627,873,47.92,8.6,6.18,4.41
16-09-2021,ÓBIDOS,19,1,158,"[120,240]",Moderado,,,,19,Lisboa e Vale do Tejo,LEIRIA,1012,14155.44,11850,743,650,574,452,436,888,1462,2112,2855,83.72,20.17,14.92,10.33
16-09-2021,ODEMIRA,60,4,244,"[240,480]",Elevado,,,,60,Alentejo,BEJA,0211,172060.15,24717,1475,1317,1225,1397,1349,2746,3971,5288,6763,14.37,3.93,3.07,2.31
16-09-2021,ODIVELAS,194,14,120,"[120,240]",Moderado,,,,194,Lisboa e Vale do Tejo,LISBOA,1116,2654.36,161774,9562,9038,6952,4641,3812,8453,15405,24443,34005,6095.48,1281.27,920.99,580.44
16-09-2021,OEIRAS,266,19,150,"[120,240]",Moderado,,,,266,Lisboa e Vale do Tejo,LISBOA,1110,4588.31,177408,11580,11575,8566,6211,5855,12066,20632,32207,43787,3866.78,954.38,701.98,449.69
16-09-2021,OLEIROS,1,0,20,"[0,120]",Baixo a Moderado,,,,1,Centro,CASTELO BRANCO,0506,47109.31,5003,384,341,366,397,487,884,1250,1591,1975,10.62,4.19,3.38,2.65
16-09-2021,OLHÃO,87,6,197,"[120,240]",Moderado,,,,87,Algarve,FARO,0810,13086.38,44405,2455,2309,1689,1342,1268,2610,4299,6608,9063,339.33,69.26,50.5,32.85
16-09-2021,OLIVEIRA DE AZEMÉIS,137,10,208,"[120,240]",Moderado,,,,137,Norte,AVEIRO,0113,16110.41,66011,4155,3614,2794,2183,1738,3921,6715,10329,14484,409.75,89.91,64.12,41.68
16-09-2021,OLIVEIRA DE FRADES,13,1,130,"[120,240]",Moderado,,,,13,Centro,VISEU,1810,14534.62,9936,553,475,438,359,415,774,1212,1687,2240,68.36,15.41,11.61,8.34
16-09-2021,OLIVEIRA DO BAIRRO,12,1,49,"[0,120]",Baixo a Moderado,,,,12,Centro,AVEIRO,0114,8731.99,24277,1327,1182,999,786,810,1596,2595,3777,5104,278.02,58.45,43.25,29.72
16-09-2021,OLIVEIRA DO HOSPITAL,17,1,88,"[0,120]",Baixo a Moderado,,,,17,Centro,COIMBRA,0611,23451.66,19253,1161,1097,962,924,960,1884,2846,3943,5104,82.1,21.76,16.81,12.14
16-09-2021,OURÉM,71,5,162,"[120,240]",Moderado,,,,71,Lisboa e Vale do Tejo,SANTARÉM,1421,41668.03,44044,2463,2069,1899,1817,1603,3420,5319,7388,9851,105.7,23.64,17.73,12.77
16-09-2021,OURIQUE,4,0,88,"[0,120]",Baixo a Moderado,,,,4,Alentejo,BEJA,0212,66331.36,4607,313,287,284,268,227,495,779,1066,1379,6.95,2.08,1.61,1.17
16-09-2021,OVAR,46,3,84,"[0,120]",Baixo a Moderado,,,,46,Centro,AVEIRO,0115,14770.25,54260,3294,2709,1994,1636,1234,2870,4864,7573,10867,367.37,73.57,51.27,32.93
16-09-2021,PAÇOS DE FERREIRA,98,7,172,"[120,240]",Moderado,,,,98,Norte,PORTO,1309,7099.29,56728,2903,2193,1518,1135,664,1799,3317,5510,8413,799.1,118.51,77.62,46.72
16-09-2021,PALMELA,84,6,131,"[120,240]",Moderado,,,,84,Lisboa e Vale do Tejo,SETÚBAL,1508,46512.01,64269,3402,3244,2635,1846,1391,3237,5872,9116,12518,138.18,26.91,19.6,12.62
16-09-2021,PAMPILHOSA DA SERRA,4,0,99,"[0,120]",Baixo a Moderado,,,,4,Centro,COIMBRA,0612,39646.24,4037,238,254,295,339,423,762,1057,1311,1549,10.18,3.91,3.31,2.67
16-09-2021,PAREDES,158,11,183,"[120,240]",Moderado,,,,158,Norte,PORTO,1310,15675.69,86067,4272,3532,2412,1717,1258,2975,5387,8919,13191,549.04,84.15,56.9,34.36
16-09-2021,PAREDES DE COURA,8,1,94,"[0,120]",Baixo a Moderado,,,,8,Norte,VIANA DO CASTELO,1605,13818.59,8535,466,528,407,465,515,980,1387,1915,2381,61.76,17.23,13.86,10.04
16-09-2021,PEDRÓGÃO GRANDE,1,0,29,"[0,120]",Baixo a Moderado,,,,1,Centro,LEIRIA,1013,12874.75,3410,175,173,196,221,252,473,669,842,1017,26.49,7.9,6.54,5.2
16-09-2021,PENACOVA,29,2,213,"[120,240]",Moderado,,,,29,Centro,COIMBRA,0613,21673.23,13694,968,923,745,621,703,1324,2069,2992,3960,63.18,18.27,13.81,9.55
16-09-2021,PENAFIEL,144,10,206,"[120,240]",Moderado,,,,144,Norte,PORTO,1311,21224.27,69772,3648,2823,2032,1663,1230,2893,4925,7748,11396,328.74,53.69,36.51,23.2
16-09-2021,PENALVA DO CASTELO,13,1,182,"[120,240]",Moderado,,,,13,Centro,VISEU,1811,13433.92,7115,449,457,413,391,426,817,1230,1687,2136,52.96,15.9,12.56,9.16
16-09-2021,PENAMACOR,1,0,21,"[0,120]",Baixo a Moderado,,,,1,Centro,CASTELO BRANCO,0507,56370.69,4755,262,248,273,451,633,1084,1357,1605,1867,8.44,3.31,2.85,2.41
16-09-2021,PENEDONO,10,1,389,"[240,480]",Elevado,,,,10,Norte,VISEU,1812,13370.75,2591,172,113,129,156,138,294,423,536,708,19.38,5.3,4.01,3.16
16-09-2021,PENELA,31,2,575,"[480,960]",Muito Elevado,,,,31,Centro,COIMBRA,0614,13480.0,5397,314,324,274,359,344,703,977,1301,1615,40.04,11.98,9.65,7.25
16-09-2021,PENICHE,31,2,116,"[0,120]",Baixo a Moderado,,,,31,Lisboa e Vale do Tejo,LEIRIA,1014,7754.98,26501,1746,1504,1203,926,707,1633,2836,4340,6086,341.73,78.48,55.96,36.57
16-09-2021,PESO DA RÉGUA,21,2,134,"[120,240]",Moderado,,,,21,Norte,VILA REAL,1708,9486.01,15773,1076,843,650,659,455,1114,1764,2607,3683,166.28,38.83,27.48,18.6
16-09-2021,PINHEL,8,1,95,"[0,120]",Baixo a Moderado,,,,8,Centro,GUARDA,0910,48452.12,8511,577,566,551,538,689,1227,1778,2344,2921,17.57,6.03,4.84,3.67
16-09-2021,POMBAL,91,6,176,"[120,240]",Moderado,,,,91,Centro,LEIRIA,1015,62600.28,51461,3187,2791,2494,2328,2027,4355,6849,9640,12827,82.21,20.49,15.4,10.94
16-09-2021,PONTA DELGADA,51,4,75,"[0,120]",Baixo a Moderado,,,,51,Açores,AÇORES,4203,23298.65,67935,3108,2435,1726,1133,902,2035,3761,6196,9304,291.58,39.93,26.59,16.14
16-09-2021,PONTA DO SOL,2,0,23,"[0,120]",Baixo a Moderado,,,,2,Madeira,MADEIRA,3105,4622.03,8593,319,283,347,208,221,429,776,1059,1378,185.92,29.81,22.91,16.79
16-09-2021,PONTE DA BARCA,20,1,180,"[120,240]",Moderado,,,,20,Norte,VIANA DO CASTELO,1606,18211.37,11180,635,576,517,554,490,1044,1561,2137,2772,61.39,15.22,11.73,8.57
16-09-2021,PONTE DE LIMA,39,3,95,"[0,120]",Baixo a Moderado,,,,39,Norte,VIANA DO CASTELO,1607,32025.46,41315,2321,2022,1720,1596,1462,3058,4778,6800,9121,129.01,28.48,21.23,14.92
16-09-2021,PONTE DE SOR,24,2,162,"[120,240]",Moderado,,,,24,Alentejo,PORTALEGRE,1213,83971.16,14994,939,800,716,739,831,1570,2286,3086,4025,17.86,4.79,3.68,2.72
16-09-2021,PORTALEGRE,3,0,14,"[0,120]",Baixo a Moderado,,,,3,Alentejo,PORTALEGRE,1214,44713.64,22172,1577,1351,1137,993,984,1977,3114,4465,6042,49.59,13.51,9.99,6.96
16-09-2021,PORTEL,27,2,468,"[240,480]",Elevado,,,,27,Alentejo,ÉVORA,0709,60100.57,5828,336,358,283,331,305,636,919,1277,1613,9.7,2.68,2.12,1.53
16-09-2021,PORTIMÃO,272,19,491,"[480,960]",Muito Elevado,,,,272,Algarve,FARO,0811,18206.29,55483,3182,2927,2116,1582,1400,2982,5098,8025,11207,304.75,61.56,44.08,28.0
16-09-2021,PORTO,427,30,197,"[120,240]",Moderado,,,,427,Norte,PORTO,1312,4142.02,216606,15790,15193,11280,9409,10044,19453,30733,45926,61716,5229.5,1490.0,1108.79,741.98
16-09-2021,PORTO DE MÓS,58,4,249,"[240,480]",Elevado,,,,58,Centro,LEIRIA,1016,26183.41,23275,1355,1210,1034,888,872,1760,2794,4004,5359,88.89,20.47,15.29,10.67
16-09-2021,PORTO MONIZ,1,0,43,"[0,120]",Baixo a Moderado,,,,1,Madeira,MADEIRA,3106,8293.38,2342,143,130,95,98,120,218,313,443,586,28.24,7.07,5.34,3.77
16-09-2021,PORTO SANTO,0,0,0,"[0,120]",Baixo a Moderado,,,,0,Madeira,MADEIRA,3201,4300.7,5202,240,157,134,110,68,178,312,469,709,120.95,16.48,10.9,7.25
16-09-2021,PÓVOA DE LANHOSO,83,6,386,"[240,480]",Elevado,,,,83,Norte,BRAGA,0309,13465.29,21499,1175,909,732,673,624,1297,2029,2938,4113,159.67,30.55,21.82,15.07
16-09-2021,PÓVOA DE VARZIM,109,8,174,"[120,240]",Moderado,,,,109,Norte,PORTO,1313,8220.59,62784,3712,3120,2134,1594,1305,2899,5033,8153,11865,763.7,144.33,99.17,61.22
16-09-2021,POVOAÇÃO,0,0,0,"[0,120]",Baixo a Moderado,,,,0,Açores,AÇORES,4204,10640.77,5927,293,212,191,144,134,278,469,681,974,55.7,9.15,6.4,4.41
16-09-2021,VILA DA PRAIA DA VITÓRIA,8,1,38,"[0,120]",Baixo a Moderado,,,,8,Açores,AÇORES,4302,16127.06,21317,1133,789,619,436,336,772,1391,2180,3313,132.18,20.54,13.52,8.63
16-09-2021,PROENÇA-A-NOVA,3,0,41,"[0,120]",Baixo a Moderado,,,,3,Centro,CASTELO BRANCO,0508,39539.96,7298,508,465,389,400,560,960,1349,1814,2322,18.46,5.87,4.59,3.41
16-09-2021,REDONDO,5,0,80,"[0,120]",Baixo a Moderado,,,,5,Alentejo,ÉVORA,0710,36950.87,6353,349,325,288,288,354,642,930,1255,1604,17.19,4.34,3.4,2.52
16-09-2021,REGUENGOS DE MONSARAZ,5,0,50,"[0,120]",Baixo a Moderado,,,,5,Alentejo,ÉVORA,0711,46399.72,10015,602,511,455,462,473,935,1390,1901,2503,21.58,5.39,4.1,3.0
16-09-2021,RESENDE,5,0,50,"[0,120]",Baixo a Moderado,,,,5,Norte,VISEU,1813,12334.93,10137,560,493,448,433,422,855,1303,1796,2356,82.18,19.1,14.56,10.56
16-09-2021,RIBEIRA BRAVA,3,0,24,"[0,120]",Baixo a Moderado,,,,3,Madeira,MADEIRA,3107,6544.88,12435,648,500,411,311,287,598,1009,1509,2157,189.99,32.96,23.06,15.42
16-09-2021,RIBEIRA DE PENA,13,1,217,"[120,240]",Moderado,,,,13,Norte,VILA REAL,1709,21745.98,6016,371,301,290,310,368,678,968,1269,1640,27.66,7.54,5.84,4.45
16-09-2021,RIBEIRA GRANDE,11,1,34,"[0,120]",Baixo a Moderado,,,,11,Açores,AÇORES,4205,18015.13,32811,1163,689,512,345,253,598,1110,1799,2962,182.13,16.44,9.99,6.16
16-09-2021,RIO MAIOR,43,3,212,"[120,240]",Moderado,,,,43,Lisboa e Vale do Tejo,SANTARÉM,1414,27276.45,20379,1251,1144,941,795,648,1443,2384,3528,4779,74.71,17.52,12.93,8.74
16-09-2021,SABROSA,9,1,153,"[120,240]",Moderado,,,,9,Norte,VILA REAL,1710,15692.45,5918,393,314,304,302,350,652,956,1270,1663,37.71,10.6,8.09,6.09
16-09-2021,SABUGAL,12,1,114,"[0,120]",Baixo a Moderado,,,,12,Centro,GUARDA,0911,82269.82,10585,724,707,694,796,1009,1805,2499,3206,3930,12.87,4.78,3.9,3.04
16-09-2021,SALVATERRA DE MAGOS,33,2,156,"[120,240]",Moderado,,,,33,Lisboa e Vale do Tejo,SANTARÉM,1415,24393.2,21295,1275,1181,1060,799,772,1571,2631,3812,5087,87.3,20.85,15.63,10.79
16-09-2021,SANTA COMBA DÃO,9,1,86,"[0,120]",Baixo a Moderado,,,,9,Centro,VISEU,1814,11194.77,10452,732,684,569,538,464,1002,1571,2255,2987,93.36,26.68,20.14,14.03
16-09-2021,SANTA CRUZ,77,6,171,"[120,240]",Moderado,,,,77,Madeira,MADEIRA,3108,8150.28,45281,1817,1301,974,716,523,1239,2213,3514,5331,555.6,65.41,43.12,27.15
16-09-2021,SANTA CRUZ DA GRACIOSA,0,0,0,"[0,120]",Baixo a Moderado,,,,0,Açores,AÇORES,4401,6065.78,4208,228,180,163,124,145,269,432,612,840,69.37,13.85,10.09,7.12
16-09-2021,SANTA CRUZ DAS FLORES,0,0,0,"[0,120]",Baixo a Moderado,,,,0,Açores,AÇORES,4802,7091.44,2165,125,98,74,56,51,107,181,279,404,30.53,5.7,3.93,2.55
16-09-2021,SANTA MARIA DA FEIRA,152,11,110,"[0,120]",Baixo a Moderado,,,,152,Norte,AVEIRO,0109,21587.65,138636,8182,6743,4771,3856,3079,6935,11706,18449,26631,642.19,123.36,85.46,54.22
16-09-2021,SANTA MARTA DE PENAGUIÃO,8,1,122,"[120,240]",Moderado,,,,8,Norte,VILA REAL,1711,6928.13,6599,483,373,337,316,317,633,970,1343,1826,95.25,26.36,19.39,14.0
16-09-2021,SANTANA,4,0,60,"[0,120]",Baixo a Moderado,,,,4,Madeira,MADEIRA,3109,9547.3,6711,418,353,343,282,277,559,902,1255,1673,70.29,17.52,13.15,9.45
16-09-2021,SANTARÉM,59,4,102,"[0,120]",Baixo a Moderado,,,,59,Lisboa e Vale do Tejo,SANTARÉM,1416,55253.58,57421,3654,3441,2760,2466,2206,4672,7432,10873,14527,103.92,26.29,19.68,13.45
16-09-2021,SANTIAGO DO CACÉM,36,3,126,"[120,240]",Moderado,,,,36,Alentejo,SETÚBAL,1509,105969.29,28791,2144,1689,1472,1295,1215,2510,3982,5671,7815,27.17,7.37,5.35,3.76
16-09-2021,SANTO TIRSO,84,6,123,"[120,240]",Moderado,,,,84,Norte,PORTO,1314,13655.52,68055,4911,3935,2761,2257,1810,4067,6828,10763,15674,498.35,114.78,78.82,50.0
16-09-2021,SÃO BRÁS DE ALPORTEL,59,4,569,"[480,960]",Muito Elevado,,,,59,Algarve,FARO,0812,15336.92,10416,596,468,467,404,401,805,1272,1740,2336,67.91,15.23,11.35,8.29
16-09-2021,SÃO JOÃO DA MADEIRA,49,3,222,"[120,240]",Moderado,,,,49,Norte,AVEIRO,0116,794.3,21958,1347,1069,796,601,593,1194,1990,3059,4406,2765.49,554.91,385.26,250.63
16-09-2021,SÃO JOÃO DA PESQUEIRA,0,0,0,"[0,120]",Baixo a Moderado,,,,0,Norte,VISEU,1815,26610.85,7125,417,330,294,328,328,656,950,1280,1697,26.77,6.38,4.81,3.57
16-09-2021,SÃO PEDRO DO SUL,28,2,182,"[120,240]",Moderado,,,,28,Centro,VISEU,1816,34895.09,15403,990,962,861,759,909,1668,2529,3491,4481,44.14,12.84,10.0,7.25
16-09-2021,SÃO ROQUE DO PICO,2,0,61,"[0,120]",Baixo a Moderado,,,,2,Açores,AÇORES,4603,14236.1,3266,199,141,93,96,113,209,302,443,642,22.94,4.51,3.11,2.12
16-09-2021,SÃO VICENTE,3,0,59,"[0,120]",Baixo a Moderado,,,,3,Madeira,MADEIRA,3110,7883.71,5143,272,264,266,225,280,505,771,1035,1307,65.23,16.58,13.13,9.78
16-09-2021,SARDOAL,3,0,81,"[0,120]",Baixo a Moderado,,,,3,Lisboa e Vale do Tejo,SANTARÉM,1417,9214.72,3741,227,178,148,165,248,413,561,739,966,40.6,10.48,8.02,6.09
16-09-2021,SÁTÃO,23,2,198,"[120,240]",Moderado,,,,23,Centro,VISEU,1817,20194.11,11580,765,671,515,465,476,941,1456,2127,2892,57.34,14.32,10.53,7.21
16-09-2021,SEIA,10,1,45,"[0,120]",Baixo a Moderado,,,,10,Centro,GUARDA,0912,43568.83,22234,1807,1589,1238,1122,721,1843,3081,4670,6477,51.03,14.87,10.72,7.07
16-09-2021,SEIXAL,245,17,146,"[120,240]",Moderado,,,,245,Lisboa e Vale do Tejo,SETÚBAL,1510,9545.17,167752,10586,9270,6661,4391,2930,7321,13982,23252,33838,1757.49,354.51,243.6,146.49
16-09-2021,SERNANCELHE,3,0,56,"[0,120]",Baixo a Moderado,,,,3,Norte,VISEU,1818,22861.22,5396,305,293,286,273,260,533,819,1112,1417,23.6,6.2,4.86,3.58
16-09-2021,SERPA,16,1,113,"[0,120]",Baixo a Moderado,,,,16,Alentejo,BEJA,0213,110563.34,14304,903,761,719,697,626,1323,2042,2803,3706,12.94,3.35,2.54,1.85
16-09-2021,SERTÃ,18,1,124,"[120,240]",Moderado,,,,18,Centro,CASTELO BRANCO,0509,44673.17,14577,870,779,790,767,1020,1787,2577,3356,4226,32.63,9.46,7.51,5.77
16-09-2021,SESIMBRA,80,6,154,"[120,240]",Moderado,,,,80,Lisboa e Vale do Tejo,SETÚBAL,1511,19571.75,51858,2400,2321,1853,1257,1083,2340,4193,6514,8914,264.96,45.54,33.28,21.42
16-09-2021,SETÚBAL,160,11,139,"[120,240]",Moderado,,,,160,Lisboa e Vale do Tejo,SETÚBAL,1512,23032.5,115126,7425,6929,5075,3775,2655,6430,11505,18434,25859,499.83,112.27,80.03,49.95
16-09-2021,SEVER DO VOUGA,9,1,80,"[0,120]",Baixo a Moderado,,,,9,Centro,AVEIRO,0117,12987.56,11331,766,637,568,540,567,1107,1675,2312,3078,87.24,23.7,17.8,12.9
16-09-2021,SILVES,111,8,306,"[240,480]",Elevado,,,,111,Algarve,FARO,0813,68006.23,36226,2137,1869,1610,1423,1600,3023,4633,6502,8639,53.27,12.7,9.56,6.81
16-09-2021,SINES,45,3,328,"[240,480]",Elevado,,,,45,Alentejo,SETÚBAL,1513,20330.17,13715,888,791,551,416,268,684,1235,2026,2914,67.46,14.33,9.97,6.07
16-09-2021,SINTRA,517,37,132,"[120,240]",Moderado,,,,517,Lisboa e Vale do Tejo,LISBOA,1111,31922.73,391402,20490,18316,13545,9137,7284,16421,29966,48282,68772,1226.08,215.43,151.25,93.87
16-09-2021,SOBRAL DE MONTE AGRAÇO,21,1,194,"[120,240]",Moderado,,,,21,Lisboa e Vale do Tejo,LISBOA,1112,5210.32,10651,564,507,352,272,212,484,836,1343,1907,204.43,36.6,25.78,16.05
16-09-2021,SOURE,22,2,129,"[120,240]",Moderado,,,,22,Centro,COIMBRA,0615,26506.07,17120,1173,1142,1004,883,987,1870,2874,4016,5189,64.59,19.58,15.15,10.84
16-09-2021,SOUSEL,5,0,116,"[0,120]",Baixo a Moderado,,,,5,Alentejo,PORTALEGRE,1215,27932.18,4412,261,274,208,302,292,594,802,1076,1337,15.8,4.79,3.85,2.87
16-09-2021,TÁBUA,31,2,271,"[240,480]",Elevado,,,,31,Centro,COIMBRA,0616,19978.58,11368,729,584,524,430,464,894,1418,2002,2731,56.9,13.67,10.02,7.1
16-09-2021,TABUAÇO,1,0,17,"[0,120]",Baixo a Moderado,,,,1,Norte,VISEU,1819,13385.67,6033,372,314,217,282,363,645,862,1176,1548,45.07,11.56,8.79,6.44
16-09-2021,TAROUCA,9,1,115,"[0,120]",Baixo a Moderado,,,,9,Norte,VISEU,1820,10008.49,7804,405,335,313,277,324,601,914,1249,1654,77.98,16.53,12.48,9.13
16-09-2021,TAVIRA,30,2,123,"[120,240]",Moderado,,,,30,Algarve,FARO,0814,60696.7,24530,1493,1415,1252,1066,1277,2343,3595,5010,6503,40.41,10.71,8.25,5.92
16-09-2021,TERRAS DE BOURO,9,1,143,"[120,240]",Moderado,,,,9,Norte,BRAGA,0310,27746.07,6361,391,372,296,319,340,659,955,1327,1718,22.93,6.19,4.78,3.44
16-09-2021,TOMAR,67,5,182,"[120,240]",Moderado,,,,67,Lisboa e Vale do Tejo,SANTARÉM,1418,35120.44,36748,2403,2189,1868,1853,1822,3675,5543,7732,10135,104.64,28.86,22.02,15.78
16-09-2021,TONDELA,15,1,57,"[0,120]",Baixo a Moderado,,,,15,Centro,VISEU,1821,37121.73,26357,1768,1722,1518,1475,1417,2892,4410,6132,7900,71.0,21.28,16.52,11.88
16-09-2021,TORRE DE MONCORVO,4,0,53,"[0,120]",Baixo a Moderado,,,,4,Norte,BRAGANÇA,0409,53155.67,7695,556,478,488,551,719,1270,1758,2236,2792,14.48,5.25,4.21,3.31
16-09-2021,TORRES NOVAS,28,2,80,"[0,120]",Baixo a Moderado,,,,28,Lisboa e Vale do Tejo,SANTARÉM,1419,26999.68,34933,2324,1979,1738,1406,1475,2881,4619,6598,8922,129.38,33.04,24.44,17.11
16-09-2021,TORRES VEDRAS,185,13,235,"[120,240]",Moderado,,,,185,Lisboa e Vale do Tejo,LISBOA,1113,40714.89,78530,4513,3945,3447,2628,2104,4732,8179,12124,16637,192.88,40.86,29.78,20.09
16-09-2021,TRANCOSO,12,1,135,"[120,240]",Moderado,,,,12,Centro,GUARDA,0913,36152.47,8875,581,557,542,586,496,1082,1624,2181,2762,24.55,7.64,6.03,4.49
16-09-2021,TROFA,57,4,148,"[120,240]",Moderado,,,,57,Norte,PORTO,1318,7201.76,38418,2336,1894,1231,939,684,1623,2854,4748,7084,533.44,98.36,65.93,39.63
16-09-2021,VAGOS,11,1,48,"[0,120]",Baixo a Moderado,,,,11,Centro,AVEIRO,0118,16491.5,22740,1320,1205,922,784,724,1508,2430,3635,4955,137.89,30.04,22.04,14.73
16-09-2021,VALE DE CAMBRA,21,2,99,"[0,120]",Baixo a Moderado,,,,21,Norte,AVEIRO,0119,14733.47,21327,1491,1363,1005,831,798,1629,2634,3997,5488,144.76,37.25,27.13,17.88
16-09-2021,VALENÇA,20,1,152,"[120,240]",Moderado,,,,20,Norte,VIANA DO CASTELO,1608,11712.86,13290,867,791,582,582,503,1085,1667,2458,3325,113.46,28.39,20.99,14.23
16-09-2021,VALONGO,102,7,105,"[0,120]",Baixo a Moderado,,,,102,Norte,PORTO,1315,7512.45,97444,5629,4696,3207,2462,1829,4291,7498,12194,17823,1297.18,237.26,162.33,99.81
16-09-2021,VALPAÇOS,49,3,328,"[240,480]",Elevado,,,,49,Norte,VILA REAL,1712,54873.93,14818,1217,1118,999,928,997,1925,2924,4042,5259,27.0,9.58,7.37,5.33
16-09-2021,VELAS,0,0,0,"[0,120]",Baixo a Moderado,,,,0,Açores,AÇORES,4502,11738.38,5093,278,208,166,153,113,266,432,640,918,43.39,7.82,5.45,3.68
16-09-2021,VENDAS NOVAS,25,2,223,"[120,240]",Moderado,,,,25,Alentejo,ÉVORA,0712,22238.88,11255,677,768,655,501,532,1033,1688,2456,3133,50.61,14.09,11.04,7.59
16-09-2021,VIANA DO ALENTEJO,8,1,157,"[120,240]",Moderado,,,,8,Alentejo,ÉVORA,0713,39367.29,5145,245,208,235,210,214,424,659,867,1112,13.07,2.82,2.2,1.67
16-09-2021,VIANA DO CASTELO,111,8,131,"[120,240]",Moderado,,,,111,Norte,VIANA DO CASTELO,1609,31902.01,84417,5470,4433,3591,3061,2982,6043,9634,14067,19537,264.61,61.24,44.09,30.2
16-09-2021,VIDIGUEIRA,21,2,384,"[240,480]",Elevado,,,,21,Alentejo,BEJA,0214,31661.09,5510,300,248,215,233,275,508,723,971,1271,17.4,4.01,3.07,2.28
16-09-2021,VIEIRA DO MINHO,8,1,68,"[0,120]",Baixo a Moderado,,,,8,Norte,BRAGA,0311,21644.35,11842,703,594,525,548,482,1030,1555,2149,2852,54.71,13.18,9.93,7.18
16-09-2021,VILA DE REI,4,0,120,"[120,240]",Moderado,,,,4,Centro,CASTELO BRANCO,0510,19154.6,3323,169,128,172,247,302,549,721,849,1018,17.35,5.31,4.43,3.76
16-09-2021,VILA DO BISPO,21,2,408,"[240,480]",Elevado,,,,21,Algarve,FARO,0815,17906.06,5154,302,302,314,232,233,465,779,1081,1383,28.78,7.72,6.04,4.35
16-09-2021,VILA DO CONDE,113,8,141,"[120,240]",Moderado,,,,113,Norte,PORTO,1316,14902.77,79899,4726,3875,2819,2070,1743,3813,6632,10507,15233,536.13,102.21,70.5,44.5
16-09-2021,VILA DO PORTO,0,0,0,"[0,120]",Baixo a Moderado,,,,0,Açores,AÇORES,4101,9688.74,5616,274,212,135,96,123,219,354,566,840,57.96,8.67,5.84,3.65
16-09-2021,VILA FLOR,4,0,67,"[0,120]",Baixo a Moderado,,,,4,Norte,BRAGANÇA,0410,26581.14,6044,429,362,422,294,331,625,1047,1409,1838,22.74,6.91,5.3,3.94
16-09-2021,VILA FRANCA DE XIRA,199,14,140,"[120,240]",Moderado,,,,199,Lisboa e Vale do Tejo,LISBOA,1114,31819.39,141957,8501,6852,4869,3425,2472,5897,10766,17618,26119,446.14,82.09,55.37,33.84
16-09-2021,VILA FRANCA DO CAMPO,4,0,36,"[0,120]",Baixo a Moderado,,,,4,Açores,AÇORES,4206,7796.82,11051,450,344,248,217,154,371,619,963,1413,141.73,18.12,12.35,7.94
16-09-2021,VILA NOVA DA BARQUINHA,3,0,40,"[0,120]",Baixo a Moderado,,,,3,Lisboa e Vale do Tejo,SANTARÉM,1420,4952.97,7461,415,406,392,364,338,702,1094,1500,1915,150.64,38.66,30.28,22.09
16-09-2021,VILA NOVA DE CERVEIRA,10,1,112,"[0,120]",Baixo a Moderado,,,,10,Norte,VIANA DO CASTELO,1610,10846.66,8910,531,444,410,384,334,718,1128,1572,2103,82.14,19.39,14.49,10.4
16-09-2021,VILA NOVA DE FAMALICÃO,205,15,156,"[120,240]",Moderado,,,,205,Norte,BRAGA,0312,20159.26,131676,7817,6164,4202,3282,2749,6031,10233,16397,24214,653.19,120.12,81.34,50.76
16-09-2021,VILA NOVA DE FOZ CÔA,25,2,389,"[240,480]",Elevado,,,,25,Centro,GUARDA,0914,39815.18,6503,442,385,390,398,429,827,1217,1602,2044,16.33,5.13,4.02,3.06
16-09-2021,VILA NOVA DE GAIA,337,24,112,"[0,120]",Baixo a Moderado,,,,337,Norte,PORTO,1317,16846.43,300472,18349,15568,10972,8224,6281,14505,25477,41045,59394,1783.64,352.57,243.65,151.23
16-09-2021,VILA NOVA DE PAIVA,16,1,341,"[240,480]",Elevado,,,,16,Centro,VISEU,1822,17553.28,4687,289,272,233,217,241,458,691,963,1252,26.7,7.13,5.49,3.94
16-09-2021,VILA NOVA DE POIARES,15,1,216,"[120,240]",Moderado,,,,15,Centro,COIMBRA,0617,8445.3,6939,380,284,262,235,182,417,679,963,1343,82.17,15.9,11.4,8.04
16-09-2021,VILA POUCA DE AGUIAR,29,2,245,"[240,480]",Elevado,,,,29,Norte,VILA REAL,1713,43706.62,11961,860,817,733,601,627,1228,1961,2778,3638,27.37,8.32,6.36,4.49
16-09-2021,VILA REAL,105,8,211,"[120,240]",Moderado,,,,105,Norte,VILA REAL,1714,37880.28,49962,3025,2498,2065,1579,1466,3045,5110,7608,10633,131.9,28.07,20.08,13.49
16-09-2021,VILA REAL DE SANTO ANTÓNIO,22,2,118,"[0,120]",Baixo a Moderado,,,,22,Algarve,FARO,0816,6125.0,18749,1172,1069,811,569,586,1155,1966,3035,4207,306.11,68.69,49.55,32.1
16-09-2021,VILA VELHA DE RÓDÃO,0,0,0,"[0,120]",Baixo a Moderado,,,,0,Centro,CASTELO BRANCO,0511,32991.16,3144,209,229,180,283,306,589,769,998,1207,9.53,3.66,3.03,2.33
16-09-2021,VILA VERDE,124,9,265,"[240,480]",Elevado,,,,124,Norte,BRAGA,0313,22866.52,46911,2365,2063,1667,1494,1437,2931,4598,6661,9026,205.15,39.47,29.13,20.11
16-09-2021,VILA VIÇOSA,10,1,132,"[120,240]",Moderado,,,,10,Alentejo,ÉVORA,0714,19485.89,7656,487,379,342,345,324,669,1011,1390,1877,39.29,9.63,7.13,5.19
16-09-2021,VIMIOSO,4,0,101,"[0,120]",Baixo a Moderado,,,,4,Norte,BRAGANÇA,0411,48158.51,4023,274,230,261,293,335,628,889,1119,1393,8.35,2.89,2.32,1.85
16-09-2021,VINHAIS,5,0,66,"[0,120]",Baixo a Moderado,,,,5,Norte,BRAGANÇA,0412,69475.09,7746,599,577,636,641,815,1456,2092,2669,3268,11.15,4.7,3.84,3.01
16-09-2021,VISEU,186,13,191,"[120,240]",Moderado,,,,186,Centro,VISEU,1823,50710.14,97249,5769,5038,4140,3158,2710,5868,10008,15046,20815,191.77,41.05,29.67,19.74
16-09-2021,VIZELA,51,4,213,"[120,240]",Moderado,,,,51,Norte,BRAGA,0314,2469.83,23897,1258,928,655,509,371,880,1535,2463,3721,967.49,150.65,99.72,62.15
16-09-2021,VOUZELA,5,0,52,"[0,120]",Baixo a Moderado,,,,5,Centro,VISEU,1824,19369.46,9619,626,605,554,532,507,1039,1593,2198,2824,49.66,14.58,11.35,8.22
23-09-2021,ABRANTES,12,1,34,"[0,120]",Baixo a Moderado,,,,12,Lisboa e Vale do Tejo,SANTARÉM,1401,71469.08,35130,2473,2213,1730,1748,2021,3769,5499,7712,10185,49.15,14.25,10.79,7.69
23-09-2021,ÁGUEDA,25,2,54,"[0,120]",Baixo a Moderado,,,,25,Centro,AVEIRO,0101,33527.44,46075,3237,2713,2090,1635,1496,3131,5221,7934,11171,137.43,33.32,23.66,15.57
23-09-2021,AGUIAR DA BEIRA,5,0,108,"[0,120]",Baixo a Moderado,,,,5,Centro,GUARDA,0901,20676.57,4652,304,281,235,239,148,387,622,903,1207,22.5,5.84,4.37,3.01
23-09-2021,ALANDROAL,5,0,102,"[0,120]",Baixo a Moderado,,,,5,Alentejo,ÉVORA,0701,54267.81,4992,307,256,296,299,377,676,972,1228,1535,9.2,2.83,2.26,1.79
23-09-2021,ALBERGARIA-A-VELHA,25,2,103,"[0,120]",Baixo a Moderado,,,,25,Centro,AVEIRO,0102,15882.5,24144,1550,1298,996,687,680,1367,2363,3661,5211,152.02,32.81,23.05,14.88
23-09-2021,ALBUFEIRA,203,15,489,"[480,960]",Muito Elevado,,,,203,Algarve,FARO,0801,14066.42,41528,2067,1717,1425,985,858,1843,3268,4985,7052,295.24,50.14,35.44,23.23
23-09-2021,ALCÁCER DO SAL,12,1,104,"[0,120]",Baixo a Moderado,,,,12,Alentejo,SETÚBAL,1501,149987.3,11659,884,814,623,623,602,1225,1848,2662,3546,7.77,2.36,1.77,1.23
23-09-2021,ALCANENA,10,1,78,"[0,120]",Baixo a Moderado,,,,10,Lisboa e Vale do Tejo,SANTARÉM,1402,12732.86,12809,891,744,628,536,588,1124,1752,2496,3387,100.6,26.6,19.6,13.76
23-09-2021,ALCOBAÇA,71,5,132,"[120,240]",Moderado,,,,71,Lisboa e Vale do Tejo,LEIRIA,1001,40814.09,53555,3420,2927,2466,2059,1676,3735,6201,9128,12548,131.22,30.74,22.36,15.19
23-09-2021,ALCOCHETE,5,0,25,"[0,120]",Baixo a Moderado,,,,5,Lisboa e Vale do Tejo,SETÚBAL,1502,12836.48,19787,857,834,691,476,447,923,1614,2448,3305,154.15,25.75,19.07,12.57
23-09-2021,ALCOUTIM,15,1,674,"[480,960]",Muito Elevado,,,,15,Algarve,FARO,0802,57536.33,2159,191,188,163,190,267,457,620,808,999,3.75,1.74,1.4,1.08
23-09-2021,ALENQUER,44,3,101,"[0,120]",Baixo a Moderado,,,,44,Lisboa e Vale do Tejo,LISBOA,1101,30421.92,44052,2298,2062,1629,1330,1155,2485,4114,6176,8474,144.8,27.85,20.3,13.52
23-09-2021,ALFÂNDEGA DA FÉ,2,0,45,"[0,120]",Baixo a Moderado,,,,2,Norte,BRAGANÇA,0401,32194.64,4550,325,277,301,274,325,599,900,1177,1502,14.13,4.67,3.66,2.8
23-09-2021,ALIJÓ,8,1,76,"[0,120]",Baixo a Moderado,,,,8,Norte,VILA REAL,1701,29759.89,10625,766,687,635,542,666,1208,1843,2530,3296,35.7,11.08,8.5,6.19
23-09-2021,ALJEZUR,2,0,36,"[0,120]",Baixo a Moderado,,,,2,Algarve,FARO,0803,32349.95,5594,316,336,335,320,410,730,1065,1401,1717,17.29,5.31,4.33,3.29
23-09-2021,ALJUSTREL,20,1,246,"[240,480]",Elevado,,,,20,Alentejo,BEJA,0201,45847.41,8247,635,521,443,347,358,705,1148,1669,2304,17.99,5.03,3.64,2.5
23-09-2021,ALMADA,220,16,130,"[120,240]",Moderado,,,,220,Lisboa e Vale do Tejo,SETÚBAL,1503,7000.89,169039,10469,9777,7876,6144,5111,11255,19131,28908,39377,2414.5,562.45,412.91,273.26
23-09-2021,ALMEIDA,3,0,52,"[0,120]",Baixo a Moderado,,,,3,Centro,GUARDA,0902,51798.46,5830,441,419,396,458,393,851,1247,1666,2107,11.26,4.07,3.22,2.41
23-09-2021,ALMEIRIM,25,2,111,"[0,120]",Baixo a Moderado,,,,25,Lisboa e Vale do Tejo,SANTARÉM,1403,22212.05,22546,1342,1353,1106,866,843,1709,2815,4168,5510,101.5,24.81,18.76,12.67
23-09-2021,ALMODÔVAR,3,0,45,"[0,120]",Baixo a Moderado,,,,3,Alentejo,BEJA,0202,77788.03,6725,414,443,396,373,328,701,1097,1540,1954,8.65,2.51,1.98,1.41
23-09-2021,ALPIARÇA,3,0,43,"[0,120]",Baixo a Moderado,,,,3,Lisboa e Vale do Tejo,SANTARÉM,1404,9536.33,7059,515,486,363,333,274,607,970,1456,1971,74.02,20.67,15.27,10.17
23-09-2021,ALTER DO CHÃO,0,0,0,"[0,120]",Baixo a Moderado,,,,0,Alentejo,PORTALEGRE,1201,36206.62,3165,201,163,136,208,187,395,531,694,895,8.74,2.47,1.92,1.47
23-09-2021,ALVAIÁZERE,4,0,61,"[0,120]",Baixo a Moderado,,,,4,Centro,LEIRIA,1002,16047.76,6597,419,389,346,406,539,945,1291,1680,2099,41.11,13.08,10.47,8.04
23-09-2021,ALVITO,2,0,81,"[0,120]",Baixo a Moderado,,,,2,Alentejo,BEJA,0203,26485.32,2477,145,110,105,111,89,200,305,415,560,9.35,2.11,1.57,1.15
23-09-2021,AMADORA,215,15,117,"[0,120]",Baixo a Moderado,,,,215,Lisboa e Vale do Tejo,LISBOA,1115,2378.47,184106,11186,10936,8780,6460,5890,12350,21130,32066,43252,7742.05,1818.84,1348.44,888.56
23-09-2021,AMARANTE,76,5,142,"[120,240]",Moderado,,,,76,Norte,PORTO,1301,30133.15,53193,3086,2413,1812,1643,1311,2954,4766,7179,10265,176.53,34.07,23.82,15.82
23-09-2021,AMARES,44,3,243,"[240,480]",Elevado,,,,44,Norte,BRAGA,0301,8195.41,18129,1001,829,622,489,524,1013,1635,2464,3465,221.22,42.28,30.07,19.95
23-09-2021,ANADIA,50,4,183,"[120,240]",Moderado,,,,50,Centro,AVEIRO,0103,21663.48,27258,1931,1698,1376,1208,1262,2470,3846,5544,7475,125.83,34.51,25.59,17.75
23-09-2021,ANGRA DO HEROÍSMO,21,1,62,"[0,120]",Baixo a Moderado,,,,21,Açores,AÇORES,4301,23899.66,33807,2006,1473,1122,768,635,1403,2525,3998,6004,141.45,25.12,16.73,10.56
23-09-2021,ANSIÃO,13,1,108,"[0,120]",Baixo a Moderado,,,,13,Centro,LEIRIA,1003,17609.42,12039,727,709,646,694,530,1224,1870,2579,3306,68.37,18.77,14.65,10.62
23-09-2021,ARCOS DE VALDEVEZ,28,2,135,"[120,240]",Moderado,,,,28,Norte,VIANA DO CASTELO,1601,44759.64,20926,1329,1338,1282,1343,1515,2858,4140,5478,6807,46.75,15.21,12.24,9.25
23-09-2021,ARGANIL,12,1,109,"[0,120]",Baixo a Moderado,,,,12,Centro,COIMBRA,0601,33283.93,11014,672,648,612,559,596,1155,1767,2415,3087,33.09,9.27,7.26,5.31
23-09-2021,ARMAMAR,1,0,17,"[0,120]",Baixo a Moderado,,,,1,Norte,VISEU,1801,11723.73,5769,357,305,309,285,310,595,904,1209,1566,49.21,13.36,10.31,7.71
23-09-2021,AROUCA,42,3,204,"[120,240]",Moderado,,,,42,Norte,AVEIRO,0104,32910.52,20720,1306,1047,753,683,683,1366,2119,3166,4472,62.96,13.59,9.62,6.44
23-09-2021,ARRAIOLOS,6,0,87,"[0,120]",Baixo a Moderado,,,,6,Alentejo,ÉVORA,0702,68374.55,6928,435,384,283,367,480,847,1130,1514,1949,10.13,2.85,2.21,1.65
23-09-2021,ARRONCHES,1,0,36,"[0,120]",Baixo a Moderado,,,,1,Alentejo,PORTALEGRE,1202,31464.72,2820,155,142,162,187,179,366,528,670,825,8.96,2.62,2.13,1.68
23-09-2021,ARRUDA DOS VINHOS,11,1,70,"[0,120]",Baixo a Moderado,,,,11,Lisboa e Vale do Tejo,LISBOA,1102,7795.93,15412,738,738,562,509,438,947,1509,2247,2985,197.69,38.29,28.82,19.36
23-09-2021,AVEIRO,67,5,85,"[0,120]",Baixo a Moderado,,,,67,Centro,AVEIRO,0105,19757.57,78734,4520,4004,3050,2250,2103,4353,7403,11407,15927,398.49,80.61,57.73,37.47
23-09-2021,AVIS,1,0,24,"[0,120]",Baixo a Moderado,,,,1,Alentejo,PORTALEGRE,1203,60596.51,4247,315,225,206,251,273,524,730,955,1270,7.01,2.1,1.58,1.2
23-09-2021,AZAMBUJA,13,1,57,"[0,120]",Baixo a Moderado,,,,13,Lisboa e Vale do Tejo,LISBOA,1103,26265.65,22716,1322,1171,1070,798,618,1416,2486,3657,4979,86.48,18.96,13.92,9.46
23-09-2021,BAIÃO,10,1,54,"[0,120]",Baixo a Moderado,,,,10,Norte,PORTO,1302,17452.83,18748,1070,862,714,686,725,1411,2125,2987,4057,107.42,23.25,17.11,12.18
23-09-2021,BARCELOS,148,11,127,"[120,240]",Moderado,,,,148,Norte,BRAGA,0302,37890.14,116187,6721,5325,3619,2991,2562,5553,9172,14497,21218,306.64,56.0,38.26,24.21
23-09-2021,BARRANCOS,19,1,1171,"[960,Max]",Extremamente Elevado,,,,19,Alentejo,BEJA,0204,16841.73,1634,90,65,65,94,61,155,220,285,375,9.7,2.23,1.69,1.31
23-09-2021,BARREIRO,90,6,120,"[120,240]",Moderado,,,,90,Lisboa e Vale do Tejo,SETÚBAL,1504,3639.07,75147,5194,5565,4459,3105,1767,4872,9331,14896,20090,2065.05,552.07,409.34,256.42
23-09-2021,BATALHA,12,1,74,"[0,120]",Baixo a Moderado,,,,12,Centro,LEIRIA,1004,10341.6,15963,873,762,649,529,549,1078,1727,2489,3362,154.35,32.51,24.07,16.7
23-09-2021,BEJA,109,8,324,"[240,480]",Elevado,,,,109,Alentejo,BEJA,0205,114647.55,33579,2005,1840,1386,1272,1039,2311,3697,5537,7542,29.29,6.58,4.83,3.22
23-09-2021,BELMONTE,4,0,63,"[0,120]",Baixo a Moderado,,,,4,Centro,CASTELO BRANCO,0501,11875.91,6398,444,321,325,310,355,665,990,1311,1755,53.87,14.78,11.04,8.34
23-09-2021,BENAVENTE,50,4,163,"[120,240]",Moderado,,,,50,Lisboa e Vale do Tejo,SANTARÉM,1405,52138.39,30602,1468,1376,1141,876,643,1519,2660,4036,5504,58.69,10.56,7.74,5.1
23-09-2021,BOMBARRAL,18,1,142,"[120,240]",Moderado,,,,18,Lisboa e Vale do Tejo,LEIRIA,1005,9128.55,12558,875,714,561,491,429,920,1481,2195,3070,137.56,33.63,24.04,16.22
23-09-2021,BORBA,9,1,135,"[120,240]",Moderado,,,,9,Alentejo,ÉVORA,0703,14518.65,6736,430,375,279,436,392,828,1107,1482,1912,46.39,13.17,10.21,7.62
23-09-2021,BOTICAS,13,1,264,"[240,480]",Elevado,,,,13,Norte,VILA REAL,1702,32195.66,4998,347,306,311,305,380,685,996,1302,1649,15.52,5.12,4.04,3.09
23-09-2021,BRAGA,287,20,157,"[120,240]",Moderado,,,,287,Norte,BRAGA,0303,18339.95,182679,10029,7963,5241,4320,3671,7991,13232,21195,31224,996.07,170.25,115.57,72.15
23-09-2021,BRAGANÇA,77,6,230,"[120,240]",Moderado,,,,77,Norte,BRAGANÇA,0402,117357.27,33607,2402,1855,1652,1393,1163,2556,4208,6063,8465,28.64,7.21,5.17,3.59
23-09-2021,CABECEIRAS DE BASTO,57,4,367,"[240,480]",Elevado,,,,57,Norte,BRAGA,0304,24182.16,15628,774,594,544,575,574,1149,1693,2287,3061,64.63,12.66,9.46,7.0
23-09-2021,CADAVAL,6,0,44,"[0,120]",Baixo a Moderado,,,,6,Lisboa e Vale do Tejo,LISBOA,1104,17489.3,13673,813,796,756,621,625,1246,2002,2798,3611,78.18,20.65,16.0,11.45
23-09-2021,CALDAS DA RAINHA,39,3,76,"[0,120]",Baixo a Moderado,,,,39,Lisboa e Vale do Tejo,LEIRIA,1006,25569.47,51912,3035,2684,2186,1899,1705,3604,5790,8474,11509,203.03,45.01,33.14,22.64
23-09-2021,CALHETA,5,0,46,"[0,120]",Baixo a Moderado,,,,5,Madeira,MADEIRA,3101,11150.43,10867,576,497,507,399,415,814,1321,1818,2394,97.46,21.47,16.3,11.85
23-09-2021,CALHETA (AÇORES),0,0,0,"[0,120]",Baixo a Moderado,,,,0,Açores,AÇORES,4501,12626.4,3184,215,159,141,139,122,261,402,561,776,25.22,6.15,4.44,3.18
23-09-2021,CÂMARA DE LOBOS,16,1,48,"[0,120]",Baixo a Moderado,,,,16,Madeira,MADEIRA,3102,5216.67,33675,1396,1059,834,545,381,926,1760,2819,4215,645.49,80.79,54.03,33.74
23-09-2021,CAMINHA,17,1,108,"[0,120]",Baixo a Moderado,,,,17,Norte,VIANA DO CASTELO,1602,13652.14,15877,1046,944,818,646,656,1302,2120,3064,4110,116.3,30.11,22.44,15.53
23-09-2021,CAMPO MAIOR,15,1,193,"[120,240]",Moderado,,,,15,Alentejo,PORTALEGRE,1204,24720.16,7874,471,364,351,279,327,606,957,1321,1792,31.85,7.25,5.34,3.87
23-09-2021,CANTANHEDE,43,3,122,"[120,240]",Moderado,,,,43,Centro,COIMBRA,0602,39088.02,35011,2346,2096,1880,1709,1451,3160,5040,7136,9482,89.57,24.26,18.26,12.89
23-09-2021,CARRAZEDA DE ANSIÃES,1,0,18,"[0,120]",Baixo a Moderado,,,,1,Norte,BRAGANÇA,0403,27924.09,5666,424,389,391,312,465,777,1168,1557,1981,20.29,7.09,5.58,4.18
23-09-2021,CARREGAL DO SAL,3,0,32,"[0,120]",Baixo a Moderado,,,,3,Centro,VISEU,1802,11689.21,9271,587,562,486,462,376,838,1324,1886,2473,79.31,21.16,16.13,11.33
23-09-2021,CARTAXO,38,3,160,"[120,240]",Moderado,,,,38,Lisboa e Vale do Tejo,SANTARÉM,1406,15817.28,23843,1415,1376,1142,861,632,1493,2635,4011,5426,150.74,34.3,25.36,16.66
23-09-2021,CASCAIS,291,21,136,"[120,240]",Moderado,,,,291,Lisboa e Vale do Tejo,LISBOA,1105,9740.17,213608,12151,11444,8680,6469,5248,11717,20397,31841,43992,2193.1,451.66,326.91,209.41
23-09-2021,CASTANHEIRA DE PÊRA,1,0,39,"[0,120]",Baixo a Moderado,,,,1,Centro,LEIRIA,1007,6677.45,2614,233,195,157,190,187,377,534,729,962,39.15,14.41,10.92,8.0
23-09-2021,CASTELO BRANCO,89,6,171,"[120,240]",Moderado,,,,89,Centro,CASTELO BRANCO,0502,143819.15,51987,3528,3042,2499,2229,2225,4454,6953,9995,13523,36.15,9.4,6.95,4.83
23-09-2021,CASTELO DE PAIVA,5,0,33,"[0,120]",Baixo a Moderado,,,,5,Norte,AVEIRO,0106,11500.53,15454,881,697,545,420,431,851,1396,2093,2974,134.37,25.86,18.2,12.14
23-09-2021,CASTELO DE VIDE,3,0,104,"[0,120]",Baixo a Moderado,,,,3,Alentejo,PORTALEGRE,1205,26491.24,2919,204,173,179,147,170,317,496,669,873,11.02,3.3,2.53,1.87
23-09-2021,CASTRO DAIRE,17,1,123,"[120,240]",Moderado,,,,17,Centro,VISEU,1803,37904.13,13823,942,857,765,732,773,1505,2270,3127,4069,36.47,10.74,8.25,5.99
23-09-2021,CASTRO MARIM,9,1,145,"[120,240]",Moderado,,,,9,Algarve,FARO,0804,30084.37,6237,370,345,334,322,344,666,1000,1345,1715,20.73,5.7,4.47,3.32
23-09-2021,CASTRO VERDE,3,0,44,"[0,120]",Baixo a Moderado,,,,3,Alentejo,BEJA,0206,56944.23,6949,437,347,303,275,227,502,805,1152,1589,12.2,2.79,2.02,1.41
23-09-2021,CELORICO DA BEIRA,36,3,519,"[480,960]",Muito Elevado,,,,36,Centro,GUARDA,0903,24721.63,6928,430,416,363,369,535,904,1267,1683,2113,28.02,8.55,6.81,5.12
23-09-2021,CELORICO DE BASTO,18,1,95,"[0,120]",Baixo a Moderado,,,,18,Norte,BRAGA,0305,18107.02,19040,1001,802,668,728,729,1457,2125,2927,3928,105.15,21.69,16.17,11.74
23-09-2021,CHAMUSCA,4,0,44,"[0,120]",Baixo a Moderado,,,,4,Lisboa e Vale do Tejo,SANTARÉM,1407,74600.54,9197,629,583,553,465,579,1044,1597,2180,2809,12.33,3.77,2.92,2.14
23-09-2021,CHAVES,36,3,92,"[0,120]",Baixo a Moderado,,,,36,Norte,VILA REAL,1703,59122.95,39343,2676,2429,1991,1886,1918,3804,5795,8224,10900,66.54,18.44,13.91,9.8
23-09-2021,CINFÃES,25,2,139,"[120,240]",Moderado,,,,25,Norte,VISEU,1804,23928.76,18244,1067,902,779,734,758,1492,2271,3173,4240,76.24,17.72,13.26,9.49
23-09-2021,COIMBRA,122,9,91,"[0,120]",Baixo a Moderado,,,,122,Centro,COIMBRA,0603,31939.94,134166,9489,8734,6353,5139,5074,10213,16566,25300,34789,420.06,108.92,79.21,51.87
23-09-2021,CONDEIXA-A-NOVA,12,1,67,"[0,120]",Baixo a Moderado,,,,12,Centro,COIMBRA,0604,13867.47,17733,871,809,717,583,490,1073,1790,2599,3470,127.88,25.02,18.74,12.91
23-09-2021,CONSTÂNCIA,2,0,49,"[0,120]",Baixo a Moderado,,,,2,Lisboa e Vale do Tejo,SANTARÉM,1408,8036.58,4030,211,183,187,148,155,303,490,673,884,50.14,11.0,8.37,6.1
23-09-2021,CORUCHE,1,0,6,"[0,120]",Baixo a Moderado,,,,1,Lisboa e Vale do Tejo,SANTARÉM,1409,111572.03,17471,1294,1090,1095,1096,1019,2115,3210,4300,5594,15.66,5.01,3.85,2.88
23-09-2021,CORVO,0,0,0,"[0,120]",Baixo a Moderado,,,,0,Açores,AÇORES,4901,1711.45,464,22,21,11,13,19,32,43,64,86,27.12,5.03,3.74,2.51
23-09-2021,COVILHÃ,114,8,244,"[240,480]",Elevado,,,,114,Centro,CASTELO BRANCO,0503,55560.06,46787,3533,2998,2365,2111,2193,4304,6669,9667,13200,84.21,23.76,17.4,12.0
23-09-2021,CRATO,2,0,65,"[0,120]",Baixo a Moderado,,,,2,Alentejo,PORTALEGRE,1206,39806.88,3129,229,258,163,182,228,410,573,831,1060,7.86,2.66,2.09,1.44
23-09-2021,CUBA,9,1,198,"[120,240]",Moderado,,,,9,Alentejo,BEJA,0207,17208.72,4595,255,233,206,190,143,333,539,772,1027,26.7,5.97,4.49,3.13
23-09-2021,ELVAS,13,1,64,"[0,120]",Baixo a Moderado,,,,13,Alentejo,PORTALEGRE,1207,63128.86,20528,1057,1145,902,852,810,1662,2564,3709,4766,32.52,7.55,5.88,4.06
23-09-2021,ENTRONCAMENTO,42,3,196,"[120,240]",Moderado,,,,42,Lisboa e Vale do Tejo,SANTARÉM,1410,1372.81,21558,1066,930,868,695,592,1287,2155,3085,4151,1570.14,302.33,224.69,156.96
23-09-2021,ESPINHO,10,1,34,"[0,120]",Baixo a Moderado,,,,10,Norte,AVEIRO,0107,2105.68,29516,2205,1993,1430,1177,960,2137,3567,5560,7765,1401.52,368.71,264.01,169.37
23-09-2021,ESPOSENDE,54,4,158,"[120,240]",Moderado,,,,54,Norte,BRAGA,0306,9540.98,34177,1831,1522,1095,894,723,1617,2712,4234,6065,358.21,63.57,44.38,28.42
23-09-2021,ESTARREJA,16,1,61,"[0,120]",Baixo a Moderado,,,,16,Centro,AVEIRO,0108,10817.33,26006,1503,1399,1106,953,728,1681,2787,4186,5689,240.42,52.59,38.7,25.76
23-09-2021,ESTREMOZ,9,1,71,"[0,120]",Baixo a Moderado,,,,9,Alentejo,ÉVORA,0704,51379.95,12728,789,613,697,786,877,1663,2360,2973,3762,24.77,7.32,5.79,4.59
23-09-2021,ÉVORA,70,5,134,"[120,240]",Moderado,,,,70,Alentejo,ÉVORA,0705,130707.58,52428,3569,2852,2176,1966,1803,3769,5945,8797,12366,40.11,9.46,6.73,4.55
23-09-2021,FAFE,152,11,316,"[240,480]",Elevado,,,,152,Norte,BRAGA,0307,21908.11,48060,3044,2455,1679,1403,1208,2611,4290,6745,9789,219.37,44.68,30.79,19.58
23-09-2021,FARO,112,8,183,"[120,240]",Moderado,,,,112,Algarve,FARO,0805,20256.79,61015,3847,3364,2604,2055,1601,3656,6260,9624,13471,301.2,66.5,47.51,30.9
23-09-2021,FELGUEIRAS,78,6,139,"[120,240]",Moderado,,,,78,Norte,PORTO,1303,11573.75,56422,2951,2302,1601,1316,973,2289,3890,6192,9143,487.49,79.0,53.5,33.61
23-09-2021,FERREIRA DO ALENTEJO,11,1,141,"[120,240]",Moderado,,,,11,Alentejo,BEJA,0208,64820.68,7845,515,414,372,343,345,688,1060,1474,1989,12.1,3.07,2.27,1.64
23-09-2021,FERREIRA DO ZÊZERE,10,1,126,"[120,240]",Moderado,,,,10,Lisboa e Vale do Tejo,SANTARÉM,1411,19038.03,7959,470,370,416,465,456,921,1337,1707,2177,41.81,11.44,8.97,7.02
23-09-2021,FIGUEIRA DA FOZ,52,4,88,"[0,120]",Baixo a Moderado,,,,52,Centro,COIMBRA,0605,37905.26,58747,4032,3597,2887,2495,2043,4538,7425,11022,15054,154.98,39.72,29.08,19.59
23-09-2021,FIGUEIRA DE CASTELO RODRIGO,4,0,72,"[0,120]",Baixo a Moderado,,,,4,Centro,GUARDA,0904,50857.46,5584,347,352,290,352,391,743,1033,1385,1732,10.98,3.41,2.72,2.03
23-09-2021,FIGUEIRÓ DOS VINHOS,0,0,0,"[0,120]",Baixo a Moderado,,,,0,Centro,LEIRIA,1008,17344.0,5568,402,386,322,309,351,660,982,1368,1770,32.1,10.21,7.89,5.66
23-09-2021,FORNOS DE ALGODRES,8,1,176,"[120,240]",Moderado,,,,8,Centro,GUARDA,0905,13145.05,4528,261,218,247,256,232,488,735,953,1214,34.45,9.24,7.25,5.59
23-09-2021,FREIXO DE ESPADA À CINTA,0,0,0,"[0,120]",Baixo a Moderado,,,,0,Norte,BRAGANÇA,0404,24414.29,3298,211,177,231,196,189,385,616,793,1004,13.51,4.11,3.25,2.52
23-09-2021,FRONTEIRA,0,0,0,"[0,120]",Baixo a Moderado,,,,0,Alentejo,PORTALEGRE,1208,24859.58,2974,213,182,149,156,168,324,473,655,868,11.96,3.49,2.63,1.9
23-09-2021,FUNCHAL,124,9,119,"[0,120]",Baixo a Moderado,,,,124,Madeira,MADEIRA,3103,7616.2,104024,6382,5086,3643,2821,1990,4811,8454,13540,19922,1365.86,261.58,177.78,111.0
23-09-2021,FUNDÃO,21,1,79,"[0,120]",Baixo a Moderado,,,,21,Centro,CASTELO BRANCO,0504,70019.79,26495,1781,1464,1432,1357,1643,3000,4432,5896,7677,37.84,10.96,8.42,6.33
23-09-2021,GAVIÃO,4,0,126,"[120,240]",Moderado,,,,4,Alentejo,PORTALEGRE,1209,29459.45,3263,189,186,222,263,293,556,778,964,1153,11.08,3.91,3.27,2.64
23-09-2021,GÓIS,2,0,53,"[0,120]",Baixo a Moderado,,,,2,Centro,COIMBRA,0606,26330.19,3805,235,199,240,233,244,477,717,916,1151,14.45,4.37,3.48,2.72
23-09-2021,GOLEGÃ,6,0,113,"[0,120]",Baixo a Moderado,,,,6,Lisboa e Vale do Tejo,SANTARÉM,1412,8431.67,5339,356,299,281,243,255,498,779,1078,1434,63.32,17.01,12.78,9.24
23-09-2021,GONDOMAR,123,9,74,"[0,120]",Baixo a Moderado,,,,123,Norte,PORTO,1304,13191.76,165985,10555,8755,6222,4450,3364,7814,14036,22791,33346,1258.22,252.77,172.76,106.4
23-09-2021,GOUVEIA,3,0,24,"[0,120]",Baixo a Moderado,,,,3,Centro,GUARDA,0906,30061.17,12387,871,931,780,783,810,1593,2373,3304,4175,41.21,13.89,10.99,7.89
23-09-2021,GRÂNDOLA,27,2,185,"[120,240]",Moderado,,,,27,Alentejo,SETÚBAL,1505,82593.66,14639,834,834,708,688,672,1360,2068,2902,3736,17.72,4.52,3.51,2.5
23-09-2021,GUARDA,47,3,121,"[120,240]",Moderado,,,,47,Centro,GUARDA,0907,71209.58,38969,2477,2041,1686,1415,1474,2889,4575,6616,9093,54.72,12.77,9.29,6.42
23-09-2021,GUIMARÃES,225,16,148,"[120,240]",Moderado,,,,225,Norte,BRAGA,0308,24099.96,152309,9394,7074,4809,3877,2948,6825,11634,18708,28102,631.99,116.61,77.63,48.27
23-09-2021,HORTA,19,1,132,"[120,240]",Moderado,,,,19,Açores,AÇORES,4701,17305.53,14521,818,658,468,352,302,654,1122,1780,2598,83.91,15.01,10.29,6.48
23-09-2021,IDANHA-A-NOVA,2,0,25,"[0,120]",Baixo a Moderado,,,,2,Centro,CASTELO BRANCO,0505,141633.51,8043,518,490,519,672,974,1646,2165,2655,3173,5.68,2.24,1.87,1.53
23-09-2021,ÍLHAVO,21,1,54,"[0,120]",Baixo a Moderado,,,,21,Centro,AVEIRO,0110,7347.55,38699,2227,1943,1444,1193,850,2043,3487,5430,7657,526.66,104.21,73.9,47.46
23-09-2021,LAGOA (FARO),59,4,259,"[240,480]",Elevado,,,,59,Algarve,FARO,0806,8825.45,22762,1314,1168,919,749,670,1419,2338,3506,4820,257.93,54.62,39.73,26.49
23-09-2021,LAGOA,20,1,136,"[120,240]",Moderado,,,,20,Açores,AÇORES,4201,4559.32,14721,536,458,349,238,235,473,822,1280,1816,322.9,39.83,28.08,18.03
23-09-2021,LAGOS,97,7,320,"[240,480]",Elevado,,,,97,Algarve,FARO,0807,21299.27,30374,1744,1434,1247,1053,1029,2082,3329,4763,6507,142.61,30.55,22.36,15.63
23-09-2021,LAJES DAS FLORES,0,0,0,"[0,120]",Baixo a Moderado,,,,0,Açores,AÇORES,4801,7004.79,1463,88,53,62,46,54,100,162,215,303,20.89,4.33,3.07,2.31
23-09-2021,LAJES DO PICO,0,0,0,"[0,120]",Baixo a Moderado,,,,0,Açores,AÇORES,4601,15531.09,4490,304,231,223,159,162,321,544,775,1079,28.91,6.95,4.99,3.5
23-09-2021,LAMEGO,25,2,101,"[0,120]",Baixo a Moderado,,,,25,Norte,VISEU,1805,16542.11,24895,1639,1284,1124,898,783,1681,2805,4089,5728,150.5,34.63,24.72,16.96
23-09-2021,LEIRIA,219,16,175,"[120,240]",Moderado,,,,219,Centro,LEIRIA,1009,56508.83,125267,7389,6366,5090,3902,3159,7061,12151,18517,25906,221.68,45.84,32.77,21.5
23-09-2021,LISBOA,754,54,148,"[120,240]",Moderado,,,,754,Lisboa e Vale do Tejo,LISBOA,1106,10005.43,509515,33197,33340,27706,23037,26770,49807,77513,110853,144050,5092.6,1439.78,1107.98,774.74
23-09-2021,LOULÉ,206,15,300,"[240,480]",Elevado,,,,206,Algarve,FARO,0808,76366.91,68697,3890,3350,2780,2358,2251,4609,7389,10739,14629,89.96,19.16,14.06,9.68
23-09-2021,LOURES,250,18,117,"[0,120]",Baixo a Moderado,,,,250,Lisboa e Vale do Tejo,LISBOA,1107,16723.99,213687,12746,12794,9644,6669,5033,11702,21346,34140,46886,1277.73,280.35,204.14,127.64
23-09-2021,LOURINHÃ,61,4,237,"[120,240]",Moderado,,,,61,Lisboa e Vale do Tejo,LISBOA,1108,14717.2,25855,1584,1243,992,842,645,1487,2479,3722,5306,175.68,36.05,25.29,16.84
23-09-2021,LOUSÃ,16,1,93,"[0,120]",Baixo a Moderado,,,,16,Centro,COIMBRA,0607,13840.01,17158,946,866,658,528,450,978,1636,2502,3448,123.97,24.91,18.08,11.82
23-09-2021,LOUSADA,52,4,112,"[0,120]",Baixo a Moderado,,,,52,Norte,PORTO,1305,9608.01,46755,2289,1698,1176,853,621,1474,2650,4348,6637,486.63,69.08,45.25,27.58
23-09-2021,MAÇÃO,6,0,97,"[0,120]",Baixo a Moderado,,,,6,Lisboa e Vale do Tejo,SANTARÉM,1413,39997.98,6267,386,362,390,440,657,1097,1487,1849,2235,15.67,5.59,4.62,3.72
23-09-2021,MACEDO DE CAVALEIROS,8,1,55,"[0,120]",Baixo a Moderado,,,,8,Norte,BRAGANÇA,0405,69914.08,14516,1082,889,878,823,938,1761,2639,3528,4610,20.76,6.59,5.05,3.77
23-09-2021,MACHICO,3,0,15,"[0,120]",Baixo a Moderado,,,,3,Madeira,MADEIRA,3104,6825.1,19981,1197,860,662,455,331,786,1448,2308,3505,292.76,51.36,33.82,21.22
23-09-2021,MADALENA,11,1,187,"[120,240]",Moderado,,,,11,Açores,AÇORES,4602,14712.33,5895,334,256,173,190,179,369,542,798,1132,40.07,7.69,5.42,3.68
23-09-2021,MAFRA,53,4,62,"[0,120]",Baixo a Moderado,,,,53,Lisboa e Vale do Tejo,LISBOA,1109,29165.5,84816,3613,3334,2839,2089,1899,3988,6827,10161,13774,290.81,47.23,34.84,23.41
23-09-2021,MAIA,151,11,109,"[0,120]",Baixo a Moderado,,,,151,Norte,PORTO,1306,8293.94,138971,7801,6617,4512,3339,2631,5970,10482,17099,24900,1675.56,300.22,206.16,126.38
23-09-2021,MANGUALDE,27,2,146,"[120,240]",Moderado,,,,27,Centro,VISEU,1806,21925.56,18510,1198,1128,885,852,743,1595,2480,3608,4806,84.42,21.92,16.46,11.31
23-09-2021,MANTEIGAS,2,0,67,"[0,120]",Baixo a Moderado,,,,2,Centro,GUARDA,0908,12197.55,3007,258,197,159,167,146,313,472,669,927,24.65,7.6,5.48,3.87
23-09-2021,MARCO DE CANAVESES,9,1,18,"[0,120]",Baixo a Moderado,,,,9,Norte,PORTO,1307,20188.98,51496,2678,2060,1488,1265,1023,2288,3776,5836,8514,255.07,42.17,28.91,18.7
23-09-2021,MARINHA GRANDE,33,2,85,"[0,120]",Baixo a Moderado,,,,33,Centro,LEIRIA,1010,18725.19,38508,2365,2302,1638,1359,1058,2417,4055,6357,8722,205.65,46.58,33.95,21.66
23-09-2021,MARVÃO,6,0,204,"[120,240]",Moderado,,,,6,Alentejo,PORTALEGRE,1210,15489.9,3005,198,185,142,197,237,434,576,761,959,19.4,6.19,4.91,3.72
23-09-2021,MATOSINHOS,168,12,96,"[0,120]",Baixo a Moderado,,,,168,Norte,PORTO,1308,6241.97,175357,11850,9977,7023,5024,3884,8908,15931,25908,37758,2809.31,604.9,415.06,255.22
23-09-2021,MEALHADA,9,1,45,"[0,120]",Baixo a Moderado,,,,9,Centro,AVEIRO,0111,11065.66,19914,1163,1039,810,828,831,1659,2469,3508,4671,179.96,42.21,31.7,22.31
23-09-2021,MÊDA,6,0,131,"[120,240]",Moderado,,,,6,Centro,GUARDA,0909,28604.92,4587,343,306,290,288,443,731,1021,1327,1670,16.04,5.84,4.64,3.57
23-09-2021,MELGAÇO,8,1,100,"[0,120]",Baixo a Moderado,,,,8,Norte,VIANA DO CASTELO,1603,23824.58,8093,507,567,578,614,675,1289,1867,2434,2941,33.97,12.34,10.22,7.84
23-09-2021,MÉRTOLA,9,1,149,"[120,240]",Moderado,,,,9,Alentejo,BEJA,0209,129287.34,6142,400,390,378,423,600,1023,1401,1791,2191,4.75,1.69,1.39,1.08
23-09-2021,MESÃO FRIO,4,0,102,"[0,120]",Baixo a Moderado,,,,4,Norte,VILA REAL,1704,2664.87,3964,265,205,168,157,120,277,445,650,915,148.74,34.33,24.39,16.7
23-09-2021,MIRA,2,0,17,"[0,120]",Baixo a Moderado,,,,2,Centro,COIMBRA,0608,12403.38,11832,727,729,659,550,466,1016,1675,2404,3131,95.4,25.24,19.38,13.5
23-09-2021,MIRANDA DO CORVO,4,0,31,"[0,120]",Baixo a Moderado,,,,4,Centro,COIMBRA,0609,12637.79,12708,706,659,568,498,404,902,1470,2129,2835,100.55,22.43,16.85,11.63
23-09-2021,MIRANDA DO DOURO,0,0,0,"[0,120]",Baixo a Moderado,,,,0,Norte,BRAGANÇA,0406,48718.31,6830,482,429,442,463,470,933,1375,1804,2286,14.02,4.69,3.7,2.82
23-09-2021,MIRANDELA,24,2,111,"[0,120]",Baixo a Moderado,,,,24,Norte,BRAGANÇA,0407,65895.67,21754,1640,1315,1204,1078,947,2025,3229,4544,6184,33.01,9.38,6.9,4.9
23-09-2021,MOGADOURO,2,0,24,"[0,120]",Baixo a Moderado,,,,2,Norte,BRAGANÇA,0408,76064.93,8392,589,529,576,630,655,1285,1861,2390,2979,11.03,3.92,3.14,2.45
23-09-2021,MOIMENTA DA BEIRA,3,0,31,"[0,120]",Baixo a Moderado,,,,3,Norte,VISEU,1807,21996.9,9736,576,514,471,416,461,877,1348,1862,2438,44.26,11.08,8.46,6.13
23-09-2021,MOITA,77,6,120,"[120,240]",Moderado,,,,77,Lisboa e Vale do Tejo,SETÚBAL,1506,5525.98,64407,4226,3646,2623,1801,1425,3226,5849,9495,13721,1165.53,248.3,171.82,105.85
23-09-2021,MONÇÃO,3,0,17,"[0,120]",Baixo a Moderado,,,,3,Norte,VIANA DO CASTELO,1604,21130.85,17869,1161,1105,1031,1006,972,1978,3009,4114,5275,84.56,24.96,19.47,14.24
23-09-2021,MONCHIQUE,12,1,241,"[240,480]",Elevado,,,,12,Algarve,FARO,0809,39530.43,5077,353,384,321,355,392,747,1068,1452,1805,12.84,4.57,3.67,2.7
23-09-2021,MONDIM DE BASTO,10,1,145,"[120,240]",Moderado,,,,10,Norte,VILA REAL,1705,17207.52,6946,395,300,314,284,283,567,881,1181,1576,40.36,9.16,6.86,5.12
23-09-2021,MONFORTE,6,0,204,"[120,240]",Moderado,,,,6,Alentejo,PORTALEGRE,1211,42024.82,2975,139,115,117,192,168,360,477,592,731,7.08,1.74,1.41,1.14
23-09-2021,MONTALEGRE,38,3,417,"[240,480]",Elevado,,,,38,Norte,VILA REAL,1706,80545.71,8997,699,628,595,603,730,1333,1928,2556,3255,11.17,4.04,3.17,2.39
23-09-2021,MONTEMOR-O-NOVO,16,1,104,"[0,120]",Baixo a Moderado,,,,16,Alentejo,ÉVORA,0706,123296.65,15647,991,953,868,878,971,1849,2717,3670,4661,12.69,3.78,2.98,2.2
23-09-2021,MONTEMOR-O-VELHO,38,3,150,"[120,240]",Moderado,,,,38,Centro,COIMBRA,0610,22896.23,25224,1496,1397,1217,1057,988,2045,3262,4659,6155,110.17,26.88,20.35,14.25
23-09-2021,MONTIJO,52,4,90,"[0,120]",Baixo a Moderado,,,,52,Lisboa e Vale do Tejo,SETÚBAL,1507,34861.64,57614,2771,2441,1990,1554,1109,2663,4653,7094,9865,165.26,28.3,20.35,13.35
23-09-2021,MORA,1,0,25,"[0,120]",Baixo a Moderado,,,,1,Alentejo,ÉVORA,0707,44395.02,4138,336,275,252,238,257,495,747,1022,1358,9.32,3.06,2.3,1.68
23-09-2021,MORTÁGUA,6,0,68,"[0,120]",Baixo a Moderado,,,,6,Centro,VISEU,1808,25117.82,8803,638,584,535,499,460,959,1494,2078,2716,35.05,10.81,8.27,5.95
23-09-2021,MOURA,20,1,147,"[120,240]",Moderado,,,,20,Alentejo,BEJA,0210,95845.55,13718,817,656,665,542,461,1003,1668,2324,3141,14.31,3.28,2.42,1.74
23-09-2021,MOURÃO,1,0,41,"[0,120]",Baixo a Moderado,,,,1,Alentejo,ÉVORA,0708,27862.98,2450,139,108,80,104,109,213,293,401,540,8.79,1.94,1.44,1.05
23-09-2021,MURÇA,2,0,37,"[0,120]",Baixo a Moderado,,,,2,Norte,VILA REAL,1707,18937.11,5463,384,341,307,306,319,625,932,1273,1657,28.85,8.75,6.72,4.92
23-09-2021,MURTOSA,2,0,19,"[0,120]",Baixo a Moderado,,,,2,Centro,AVEIRO,0112,7308.78,10279,509,473,403,353,409,762,1165,1638,2147,140.63,29.37,22.41,15.94
23-09-2021,NAZARÉ,17,1,119,"[0,120]",Baixo a Moderado,,,,17,Lisboa e Vale do Tejo,LEIRIA,1011,8243.43,14165,967,903,670,420,396,816,1486,2389,3356,171.84,40.71,28.98,18.03
23-09-2021,NELAS,12,1,92,"[0,120]",Baixo a Moderado,,,,12,Centro,VISEU,1809,12571.48,12974,924,787,668,604,583,1187,1855,2642,3566,103.21,28.37,21.02,14.76
23-09-2021,NISA,9,1,151,"[120,240]",Moderado,,,,9,Alentejo,PORTALEGRE,1212,57567.84,6061,405,389,355,483,478,961,1316,1705,2110,10.53,3.67,2.96,2.29
23-09-2021,NORDESTE,0,0,0,"[0,120]",Baixo a Moderado,,,,0,Açores,AÇORES,4202,10146.8,4862,246,180,124,161,162,323,447,627,873,47.92,8.6,6.18,4.41
23-09-2021,ÓBIDOS,23,2,191,"[120,240]",Moderado,,,,23,Lisboa e Vale do Tejo,LEIRIA,1012,14155.44,11850,743,650,574,452,436,888,1462,2112,2855,83.72,20.17,14.92,10.33
23-09-2021,ODEMIRA,18,1,73,"[0,120]",Baixo a Moderado,,,,18,Alentejo,BEJA,0211,172060.15,24717,1475,1317,1225,1397,1349,2746,3971,5288,6763,14.37,3.93,3.07,2.31
23-09-2021,ODIVELAS,152,11,94,"[0,120]",Baixo a Moderado,,,,152,Lisboa e Vale do Tejo,LISBOA,1116,2654.36,161774,9562,9038,6952,4641,3812,8453,15405,24443,34005,6095.48,1281.27,920.99,580.44
23-09-2021,OEIRAS,216,15,122,"[120,240]",Moderado,,,,216,Lisboa e Vale do Tejo,LISBOA,1110,4588.31,177408,11580,11575,8566,6211,5855,12066,20632,32207,43787,3866.78,954.38,701.98,449.69
23-09-2021,OLEIROS,0,0,0,"[0,120]",Baixo a Moderado,,,,0,Centro,CASTELO BRANCO,0506,47109.31,5003,384,341,366,397,487,884,1250,1591,1975,10.62,4.19,3.38,2.65
23-09-2021,OLHÃO,48,3,109,"[0,120]",Baixo a Moderado,,,,48,Algarve,FARO,0810,13086.38,44405,2455,2309,1689,1342,1268,2610,4299,6608,9063,339.33,69.26,50.5,32.85
23-09-2021,OLIVEIRA DE AZEMÉIS,118,8,179,"[120,240]",Moderado,,,,118,Norte,AVEIRO,0113,16110.41,66011,4155,3614,2794,2183,1738,3921,6715,10329,14484,409.75,89.91,64.12,41.68
23-09-2021,OLIVEIRA DE FRADES,4,0,40,"[0,120]",Baixo a Moderado,,,,4,Centro,VISEU,1810,14534.62,9936,553,475,438,359,415,774,1212,1687,2240,68.36,15.41,11.61,8.34
23-09-2021,OLIVEIRA DO BAIRRO,16,1,65,"[0,120]",Baixo a Moderado,,,,16,Centro,AVEIRO,0114,8731.99,24277,1327,1182,999,786,810,1596,2595,3777,5104,278.02,58.45,43.25,29.72
23-09-2021,OLIVEIRA DO HOSPITAL,18,1,94,"[0,120]",Baixo a Moderado,,,,18,Centro,COIMBRA,0611,23451.66,19253,1161,1097,962,924,960,1884,2846,3943,5104,82.1,21.76,16.81,12.14
23-09-2021,OURÉM,39,3,88,"[0,120]",Baixo a Moderado,,,,39,Lisboa e Vale do Tejo,SANTARÉM,1421,41668.03,44044,2463,2069,1899,1817,1603,3420,5319,7388,9851,105.7,23.64,17.73,12.77
23-09-2021,OURIQUE,3,0,66,"[0,120]",Baixo a Moderado,,,,3,Alentejo,BEJA,0212,66331.36,4607,313,287,284,268,227,495,779,1066,1379,6.95,2.08,1.61,1.17
23-09-2021,OVAR,39,3,72,"[0,120]",Baixo a Moderado,,,,39,Centro,AVEIRO,0115,14770.25,54260,3294,2709,1994,1636,1234,2870,4864,7573,10867,367.37,73.57,51.27,32.93
23-09-2021,PAÇOS DE FERREIRA,42,3,74,"[0,120]",Baixo a Moderado,,,,42,Norte,PORTO,1309,7099.29,56728,2903,2193,1518,1135,664,1799,3317,5510,8413,799.1,118.51,77.62,46.72
23-09-2021,PALMELA,45,3,70,"[0,120]",Baixo a Moderado,,,,45,Lisboa e Vale do Tejo,SETÚBAL,1508,46512.01,64269,3402,3244,2635,1846,1391,3237,5872,9116,12518,138.18,26.91,19.6,12.62
23-09-2021,PAMPILHOSA DA SERRA,3,0,74,"[0,120]",Baixo a Moderado,,,,3,Centro,COIMBRA,0612,39646.24,4037,238,254,295,339,423,762,1057,1311,1549,10.18,3.91,3.31,2.67
23-09-2021,PAREDES,141,10,164,"[120,240]",Moderado,,,,141,Norte,PORTO,1310,15675.69,86067,4272,3532,2412,1717,1258,2975,5387,8919,13191,549.04,84.15,56.9,34.36
23-09-2021,PAREDES DE COURA,8,1,94,"[0,120]",Baixo a Moderado,,,,8,Norte,VIANA DO CASTELO,1605,13818.59,8535,466,528,407,465,515,980,1387,1915,2381,61.76,17.23,13.86,10.04
23-09-2021,PEDRÓGÃO GRANDE,3,0,88,"[0,120]",Baixo a Moderado,,,,3,Centro,LEIRIA,1013,12874.75,3410,175,173,196,221,252,473,669,842,1017,26.49,7.9,6.54,5.2
23-09-2021,PENACOVA,21,2,154,"[120,240]",Moderado,,,,21,Centro,COIMBRA,0613,21673.23,13694,968,923,745,621,703,1324,2069,2992,3960,63.18,18.27,13.81,9.55
23-09-2021,PENAFIEL,89,6,128,"[120,240]",Moderado,,,,89,Norte,PORTO,1311,21224.27,69772,3648,2823,2032,1663,1230,2893,4925,7748,11396,328.74,53.69,36.51,23.2
23-09-2021,PENALVA DO CASTELO,15,1,210,"[120,240]",Moderado,,,,15,Centro,VISEU,1811,13433.92,7115,449,457,413,391,426,817,1230,1687,2136,52.96,15.9,12.56,9.16
23-09-2021,PENAMACOR,1,0,21,"[0,120]",Baixo a Moderado,,,,1,Centro,CASTELO BRANCO,0507,56370.69,4755,262,248,273,451,633,1084,1357,1605,1867,8.44,3.31,2.85,2.41
23-09-2021,PENEDONO,1,0,39,"[0,120]",Baixo a Moderado,,,,1,Norte,VISEU,1812,13370.75,2591,172,113,129,156,138,294,423,536,708,19.38,5.3,4.01,3.16
23-09-2021,PENELA,32,2,594,"[480,960]",Muito Elevado,,,,32,Centro,COIMBRA,0614,13480.0,5397,314,324,274,359,344,703,977,1301,1615,40.04,11.98,9.65,7.25
23-09-2021,PENICHE,25,2,94,"[0,120]",Baixo a Moderado,,,,25,Lisboa e Vale do Tejo,LEIRIA,1014,7754.98,26501,1746,1504,1203,926,707,1633,2836,4340,6086,341.73,78.48,55.96,36.57
23-09-2021,PESO DA RÉGUA,9,1,57,"[0,120]",Baixo a Moderado,,,,9,Norte,VILA REAL,1708,9486.01,15773,1076,843,650,659,455,1114,1764,2607,3683,166.28,38.83,27.48,18.6
23-09-2021,PINHEL,12,1,142,"[120,240]",Moderado,,,,12,Centro,GUARDA,0910,48452.12,8511,577,566,551,538,689,1227,1778,2344,2921,17.57,6.03,4.84,3.67
23-09-2021,POMBAL,41,3,79,"[0,120]",Baixo a Moderado,,,,41,Centro,LEIRIA,1015,62600.28,51461,3187,2791,2494,2328,2027,4355,6849,9640,12827,82.21,20.49,15.4,10.94
23-09-2021,PONTA DELGADA,48,3,71,"[0,120]",Baixo a Moderado,,,,48,Açores,AÇORES,4203,23298.65,67935,3108,2435,1726,1133,902,2035,3761,6196,9304,291.58,39.93,26.59,16.14
23-09-2021,PONTA DO SOL,3,0,35,"[0,120]",Baixo a Moderado,,,,3,Madeira,MADEIRA,3105,4622.03,8593,319,283,347,208,221,429,776,1059,1378,185.92,29.81,22.91,16.79
23-09-2021,PONTE DA BARCA,9,1,81,"[0,120]",Baixo a Moderado,,,,9,Norte,VIANA DO CASTELO,1606,18211.37,11180,635,576,517,554,490,1044,1561,2137,2772,61.39,15.22,11.73,8.57
23-09-2021,PONTE DE LIMA,35,3,85,"[0,120]",Baixo a Moderado,,,,35,Norte,VIANA DO CASTELO,1607,32025.46,41315,2321,2022,1720,1596,1462,3058,4778,6800,9121,129.01,28.48,21.23,14.92
23-09-2021,PONTE DE SOR,16,1,108,"[0,120]",Baixo a Moderado,,,,16,Alentejo,PORTALEGRE,1213,83971.16,14994,939,800,716,739,831,1570,2286,3086,4025,17.86,4.79,3.68,2.72
23-09-2021,PORTALEGRE,8,1,37,"[0,120]",Baixo a Moderado,,,,8,Alentejo,PORTALEGRE,1214,44713.64,22172,1577,1351,1137,993,984,1977,3114,4465,6042,49.59,13.51,9.99,6.96
23-09-2021,PORTEL,25,2,433,"[240,480]",Elevado,,,,25,Alentejo,ÉVORA,0709,60100.57,5828,336,358,283,331,305,636,919,1277,1613,9.7,2.68,2.12,1.53
23-09-2021,PORTIMÃO,210,15,378,"[240,480]",Elevado,,,,210,Algarve,FARO,0811,18206.29,55483,3182,2927,2116,1582,1400,2982,5098,8025,11207,304.75,61.56,44.08,28.0
23-09-2021,PORTO,366,26,169,"[120,240]",Moderado,,,,366,Norte,PORTO,1312,4142.02,216606,15790,15193,11280,9409,10044,19453,30733,45926,61716,5229.5,1490.0,1108.79,741.98
23-09-2021,PORTO DE MÓS,24,2,103,"[0,120]",Baixo a Moderado,,,,24,Centro,LEIRIA,1016,26183.41,23275,1355,1210,1034,888,872,1760,2794,4004,5359,88.89,20.47,15.29,10.67
23-09-2021,PORTO MONIZ,3,0,130,"[120,240]",Moderado,,,,3,Madeira,MADEIRA,3106,8293.38,2342,143,130,95,98,120,218,313,443,586,28.24,7.07,5.34,3.77
23-09-2021,PORTO SANTO,0,0,0,"[0,120]",Baixo a Moderado,,,,0,Madeira,MADEIRA,3201,4300.7,5202,240,157,134,110,68,178,312,469,709,120.95,16.48,10.9,7.25
23-09-2021,PÓVOA DE LANHOSO,105,8,489,"[480,960]",Muito Elevado,,,,105,Norte,BRAGA,0309,13465.29,21499,1175,909,732,673,624,1297,2029,2938,4113,159.67,30.55,21.82,15.07
23-09-2021,PÓVOA DE VARZIM,62,4,99,"[0,120]",Baixo a Moderado,,,,62,Norte,PORTO,1313,8220.59,62784,3712,3120,2134,1594,1305,2899,5033,8153,11865,763.7,144.33,99.17,61.22
23-09-2021,POVOAÇÃO,0,0,0,"[0,120]",Baixo a Moderado,,,,0,Açores,AÇORES,4204,10640.77,5927,293,212,191,144,134,278,469,681,974,55.7,9.15,6.4,4.41
23-09-2021,VILA DA PRAIA DA VITÓRIA,8,1,38,"[0,120]",Baixo a Moderado,,,,8,Açores,AÇORES,4302,16127.06,21317,1133,789,619,436,336,772,1391,2180,3313,132.18,20.54,13.52,8.63
23-09-2021,PROENÇA-A-NOVA,2,0,28,"[0,120]",Baixo a Moderado,,,,2,Centro,CASTELO BRANCO,0508,39539.96,7298,508,465,389,400,560,960,1349,1814,2322,18.46,5.87,4.59,3.41
23-09-2021,REDONDO,2,0,32,"[0,120]",Baixo a Moderado,,,,2,Alentejo,ÉVORA,0710,36950.87,6353,349,325,288,288,354,642,930,1255,1604,17.19,4.34,3.4,2.52
23-09-2021,REGUENGOS DE MONSARAZ,5,0,50,"[0,120]",Baixo a Moderado,,,,5,Alentejo,ÉVORA,0711,46399.72,10015,602,511,455,462,473,935,1390,1901,2503,21.58,5.39,4.1,3.0
23-09-2021,RESENDE,5,0,50,"[0,120]",Baixo a Moderado,,,,5,Norte,VISEU,1813,12334.93,10137,560,493,448,433,422,855,1303,1796,2356,82.18,19.1,14.56,10.56
23-09-2021,RIBEIRA BRAVA,6,0,49,"[0,120]",Baixo a Moderado,,,,6,Madeira,MADEIRA,3107,6544.88,12435,648,500,411,311,287,598,1009,1509,2157,189.99,32.96,23.06,15.42
23-09-2021,RIBEIRA DE PENA,5,0,84,"[0,120]",Baixo a Moderado,,,,5,Norte,VILA REAL,1709,21745.98,6016,371,301,290,310,368,678,968,1269,1640,27.66,7.54,5.84,4.45
23-09-2021,RIBEIRA GRANDE,17,1,52,"[0,120]",Baixo a Moderado,,,,17,Açores,AÇORES,4205,18015.13,32811,1163,689,512,345,253,598,1110,1799,2962,182.13,16.44,9.99,6.16
23-09-2021,RIO MAIOR,63,5,311,"[240,480]",Elevado,,,,63,Lisboa e Vale do Tejo,SANTARÉM,1414,27276.45,20379,1251,1144,941,795,648,1443,2384,3528,4779,74.71,17.52,12.93,8.74
23-09-2021,SABROSA,3,0,51,"[0,120]",Baixo a Moderado,,,,3,Norte,VILA REAL,1710,15692.45,5918,393,314,304,302,350,652,956,1270,1663,37.71,10.6,8.09,6.09
23-09-2021,SABUGAL,3,0,29,"[0,120]",Baixo a Moderado,,,,3,Centro,GUARDA,0911,82269.82,10585,724,707,694,796,1009,1805,2499,3206,3930,12.87,4.78,3.9,3.04
23-09-2021,SALVATERRA DE MAGOS,22,2,104,"[0,120]",Baixo a Moderado,,,,22,Lisboa e Vale do Tejo,SANTARÉM,1415,24393.2,21295,1275,1181,1060,799,772,1571,2631,3812,5087,87.3,20.85,15.63,10.79
23-09-2021,SANTA COMBA DÃO,1,0,10,"[0,120]",Baixo a Moderado,,,,1,Centro,VISEU,1814,11194.77,10452,732,684,569,538,464,1002,1571,2255,2987,93.36,26.68,20.14,14.03
23-09-2021,SANTA CRUZ,53,4,116,"[0,120]",Baixo a Moderado,,,,53,Madeira,MADEIRA,3108,8150.28,45281,1817,1301,974,716,523,1239,2213,3514,5331,555.6,65.41,43.12,27.15
23-09-2021,SANTA CRUZ DA GRACIOSA,1,0,24,"[0,120]",Baixo a Moderado,,,,1,Açores,AÇORES,4401,6065.78,4208,228,180,163,124,145,269,432,612,840,69.37,13.85,10.09,7.12
23-09-2021,SANTA CRUZ DAS FLORES,0,0,0,"[0,120]",Baixo a Moderado,,,,0,Açores,AÇORES,4802,7091.44,2165,125,98,74,56,51,107,181,279,404,30.53,5.7,3.93,2.55
23-09-2021,SANTA MARIA DA FEIRA,103,7,74,"[0,120]",Baixo a Moderado,,,,103,Norte,AVEIRO,0109,21587.65,138636,8182,6743,4771,3856,3079,6935,11706,18449,26631,642.19,123.36,85.46,54.22
23-09-2021,SANTA MARTA DE PENAGUIÃO,3,0,46,"[0,120]",Baixo a Moderado,,,,3,Norte,VILA REAL,1711,6928.13,6599,483,373,337,316,317,633,970,1343,1826,95.25,26.36,19.39,14.0
23-09-2021,SANTANA,1,0,15,"[0,120]",Baixo a Moderado,,,,1,Madeira,MADEIRA,3109,9547.3,6711,418,353,343,282,277,559,902,1255,1673,70.29,17.52,13.15,9.45
23-09-2021,SANTARÉM,59,4,102,"[0,120]",Baixo a Moderado,,,,59,Lisboa e Vale do Tejo,SANTARÉM,1416,55253.58,57421,3654,3441,2760,2466,2206,4672,7432,10873,14527,103.92,26.29,19.68,13.45
23-09-2021,SANTIAGO DO CACÉM,12,1,42,"[0,120]",Baixo a Moderado,,,,12,Alentejo,SETÚBAL,1509,105969.29,28791,2144,1689,1472,1295,1215,2510,3982,5671,7815,27.17,7.37,5.35,3.76
23-09-2021,SANTO TIRSO,44,3,65,"[0,120]",Baixo a Moderado,,,,44,Norte,PORTO,1314,13655.52,68055,4911,3935,2761,2257,1810,4067,6828,10763,15674,498.35,114.78,78.82,50.0
23-09-2021,SÃO BRÁS DE ALPORTEL,52,4,501,"[480,960]",Muito Elevado,,,,52,Algarve,FARO,0812,15336.92,10416,596,468,467,404,401,805,1272,1740,2336,67.91,15.23,11.35,8.29
23-09-2021,SÃO JOÃO DA MADEIRA,34,2,154,"[120,240]",Moderado,,,,34,Norte,AVEIRO,0116,794.3,21958,1347,1069,796,601,593,1194,1990,3059,4406,2765.49,554.91,385.26,250.63
23-09-2021,SÃO JOÃO DA PESQUEIRA,0,0,0,"[0,120]",Baixo a Moderado,,,,0,Norte,VISEU,1815,26610.85,7125,417,330,294,328,328,656,950,1280,1697,26.77,6.38,4.81,3.57
23-09-2021,SÃO PEDRO DO SUL,22,2,143,"[120,240]",Moderado,,,,22,Centro,VISEU,1816,34895.09,15403,990,962,861,759,909,1668,2529,3491,4481,44.14,12.84,10.0,7.25
23-09-2021,SÃO ROQUE DO PICO,1,0,31,"[0,120]",Baixo a Moderado,,,,1,Açores,AÇORES,4603,14236.1,3266,199,141,93,96,113,209,302,443,642,22.94,4.51,3.11,2.12
23-09-2021,SÃO VICENTE,0,0,0,"[0,120]",Baixo a Moderado,,,,0,Madeira,MADEIRA,3110,7883.71,5143,272,264,266,225,280,505,771,1035,1307,65.23,16.58,13.13,9.78
23-09-2021,SARDOAL,1,0,27,"[0,120]",Baixo a Moderado,,,,1,Lisboa e Vale do Tejo,SANTARÉM,1417,9214.72,3741,227,178,148,165,248,413,561,739,966,40.6,10.48,8.02,6.09
23-09-2021,SÁTÃO,12,1,103,"[0,120]",Baixo a Moderado,,,,12,Centro,VISEU,1817,20194.11,11580,765,671,515,465,476,941,1456,2127,2892,57.34,14.32,10.53,7.21
23-09-2021,SEIA,13,1,59,"[0,120]",Baixo a Moderado,,,,13,Centro,GUARDA,0912,43568.83,22234,1807,1589,1238,1122,721,1843,3081,4670,6477,51.03,14.87,10.72,7.07
23-09-2021,SEIXAL,185,13,110,"[0,120]",Baixo a Moderado,,,,185,Lisboa e Vale do Tejo,SETÚBAL,1510,9545.17,167752,10586,9270,6661,4391,2930,7321,13982,23252,33838,1757.49,354.51,243.6,146.49
23-09-2021,SERNANCELHE,2,0,37,"[0,120]",Baixo a Moderado,,,,2,Norte,VISEU,1818,22861.22,5396,305,293,286,273,260,533,819,1112,1417,23.6,6.2,4.86,3.58
23-09-2021,SERPA,39,3,275,"[240,480]",Elevado,,,,39,Alentejo,BEJA,0213,110563.34,14304,903,761,719,697,626,1323,2042,2803,3706,12.94,3.35,2.54,1.85
23-09-2021,SERTÃ,31,2,213,"[120,240]",Moderado,,,,31,Centro,CASTELO BRANCO,0509,44673.17,14577,870,779,790,767,1020,1787,2577,3356,4226,32.63,9.46,7.51,5.77
23-09-2021,SESIMBRA,69,5,133,"[120,240]",Moderado,,,,69,Lisboa e Vale do Tejo,SETÚBAL,1511,19571.75,51858,2400,2321,1853,1257,1083,2340,4193,6514,8914,264.96,45.54,33.28,21.42
23-09-2021,SETÚBAL,124,9,108,"[0,120]",Baixo a Moderado,,,,124,Lisboa e Vale do Tejo,SETÚBAL,1512,23032.5,115126,7425,6929,5075,3775,2655,6430,11505,18434,25859,499.83,112.27,80.03,49.95
23-09-2021,SEVER DO VOUGA,5,0,44,"[0,120]",Baixo a Moderado,,,,5,Centro,AVEIRO,0117,12987.56,11331,766,637,568,540,567,1107,1675,2312,3078,87.24,23.7,17.8,12.9
23-09-2021,SILVES,99,7,273,"[240,480]",Elevado,,,,99,Algarve,FARO,0813,68006.23,36226,2137,1869,1610,1423,1600,3023,4633,6502,8639,53.27,12.7,9.56,6.81
23-09-2021,SINES,31,2,226,"[120,240]",Moderado,,,,31,Alentejo,SETÚBAL,1513,20330.17,13715,888,791,551,416,268,684,1235,2026,2914,67.46,14.33,9.97,6.07
23-09-2021,SINTRA,384,27,98,"[0,120]",Baixo a Moderado,,,,384,Lisboa e Vale do Tejo,LISBOA,1111,31922.73,391402,20490,18316,13545,9137,7284,16421,29966,48282,68772,1226.08,215.43,151.25,93.87
23-09-2021,SOBRAL DE MONTE AGRAÇO,17,1,157,"[120,240]",Moderado,,,,17,Lisboa e Vale do Tejo,LISBOA,1112,5210.32,10651,564,507,352,272,212,484,836,1343,1907,204.43,36.6,25.78,16.05
23-09-2021,SOURE,20,1,117,"[0,120]",Baixo a Moderado,,,,20,Centro,COIMBRA,0615,26506.07,17120,1173,1142,1004,883,987,1870,2874,4016,5189,64.59,19.58,15.15,10.84
23-09-2021,SOUSEL,2,0,46,"[0,120]",Baixo a Moderado,,,,2,Alentejo,PORTALEGRE,1215,27932.18,4412,261,274,208,302,292,594,802,1076,1337,15.8,4.79,3.85,2.87
23-09-2021,TÁBUA,11,1,96,"[0,120]",Baixo a Moderado,,,,11,Centro,COIMBRA,0616,19978.58,11368,729,584,524,430,464,894,1418,2002,2731,56.9,13.67,10.02,7.1
23-09-2021,TABUAÇO,1,0,17,"[0,120]",Baixo a Moderado,,,,1,Norte,VISEU,1819,13385.67,6033,372,314,217,282,363,645,862,1176,1548,45.07,11.56,8.79,6.44
23-09-2021,TAROUCA,10,1,128,"[120,240]",Moderado,,,,10,Norte,VISEU,1820,10008.49,7804,405,335,313,277,324,601,914,1249,1654,77.98,16.53,12.48,9.13
23-09-2021,TAVIRA,32,2,132,"[120,240]",Moderado,,,,32,Algarve,FARO,0814,60696.7,24530,1493,1415,1252,1066,1277,2343,3595,5010,6503,40.41,10.71,8.25,5.92
23-09-2021,TERRAS DE BOURO,2,0,32,"[0,120]",Baixo a Moderado,,,,2,Norte,BRAGA,0310,27746.07,6361,391,372,296,319,340,659,955,1327,1718,22.93,6.19,4.78,3.44
23-09-2021,TOMAR,45,3,122,"[120,240]",Moderado,,,,45,Lisboa e Vale do Tejo,SANTARÉM,1418,35120.44,36748,2403,2189,1868,1853,1822,3675,5543,7732,10135,104.64,28.86,22.02,15.78
23-09-2021,TONDELA,16,1,61,"[0,120]",Baixo a Moderado,,,,16,Centro,VISEU,1821,37121.73,26357,1768,1722,1518,1475,1417,2892,4410,6132,7900,71.0,21.28,16.52,11.88
23-09-2021,TORRE DE MONCORVO,1,0,13,"[0,120]",Baixo a Moderado,,,,1,Norte,BRAGANÇA,0409,53155.67,7695,556,478,488,551,719,1270,1758,2236,2792,14.48,5.25,4.21,3.31
23-09-2021,TORRES NOVAS,27,2,77,"[0,120]",Baixo a Moderado,,,,27,Lisboa e Vale do Tejo,SANTARÉM,1419,26999.68,34933,2324,1979,1738,1406,1475,2881,4619,6598,8922,129.38,33.04,24.44,17.11
23-09-2021,TORRES VEDRAS,87,6,111,"[0,120]",Baixo a Moderado,,,,87,Lisboa e Vale do Tejo,LISBOA,1113,40714.89,78530,4513,3945,3447,2628,2104,4732,8179,12124,16637,192.88,40.86,29.78,20.09
23-09-2021,TRANCOSO,4,0,45,"[0,120]",Baixo a Moderado,,,,4,Centro,GUARDA,0913,36152.47,8875,581,557,542,586,496,1082,1624,2181,2762,24.55,7.64,6.03,4.49
23-09-2021,TROFA,47,3,122,"[120,240]",Moderado,,,,47,Norte,PORTO,1318,7201.76,38418,2336,1894,1231,939,684,1623,2854,4748,7084,533.44,98.36,65.93,39.63
23-09-2021,VAGOS,9,1,39,"[0,120]",Baixo a Moderado,,,,9,Centro,AVEIRO,0118,16491.5,22740,1320,1205,922,784,724,1508,2430,3635,4955,137.89,30.04,22.04,14.73
23-09-2021,VALE DE CAMBRA,21,2,99,"[0,120]",Baixo a Moderado,,,,21,Norte,AVEIRO,0119,14733.47,21327,1491,1363,1005,831,798,1629,2634,3997,5488,144.76,37.25,27.13,17.88
23-09-2021,VALENÇA,18,1,136,"[120,240]",Moderado,,,,18,Norte,VIANA DO CASTELO,1608,11712.86,13290,867,791,582,582,503,1085,1667,2458,3325,113.46,28.39,20.99,14.23
23-09-2021,VALONGO,77,5,79,"[0,120]",Baixo a Moderado,,,,77,Norte,PORTO,1315,7512.45,97444,5629,4696,3207,2462,1829,4291,7498,12194,17823,1297.18,237.26,162.33,99.81
23-09-2021,VALPAÇOS,50,4,335,"[240,480]",Elevado,,,,50,Norte,VILA REAL,1712,54873.93,14818,1217,1118,999,928,997,1925,2924,4042,5259,27.0,9.58,7.37,5.33
23-09-2021,VELAS,0,0,0,"[0,120]",Baixo a Moderado,,,,0,Açores,AÇORES,4502,11738.38,5093,278,208,166,153,113,266,432,640,918,43.39,7.82,5.45,3.68
23-09-2021,VENDAS NOVAS,9,1,80,"[0,120]",Baixo a Moderado,,,,9,Alentejo,ÉVORA,0712,22238.88,11255,677,768,655,501,532,1033,1688,2456,3133,50.61,14.09,11.04,7.59
23-09-2021,VIANA DO ALENTEJO,4,0,78,"[0,120]",Baixo a Moderado,,,,4,Alentejo,ÉVORA,0713,39367.29,5145,245,208,235,210,214,424,659,867,1112,13.07,2.82,2.2,1.67
23-09-2021,VIANA DO CASTELO,86,6,102,"[0,120]",Baixo a Moderado,,,,86,Norte,VIANA DO CASTELO,1609,31902.01,84417,5470,4433,3591,3061,2982,6043,9634,14067,19537,264.61,61.24,44.09,30.2
23-09-2021,VIDIGUEIRA,31,2,566,"[480,960]",Muito Elevado,,,,31,Alentejo,BEJA,0214,31661.09,5510,300,248,215,233,275,508,723,971,1271,17.4,4.01,3.07,2.28
23-09-2021,VIEIRA DO MINHO,1,0,8,"[0,120]",Baixo a Moderado,,,,1,Norte,BRAGA,0311,21644.35,11842,703,594,525,548,482,1030,1555,2149,2852,54.71,13.18,9.93,7.18
23-09-2021,VILA DE REI,0,0,0,"[0,120]",Baixo a Moderado,,,,0,Centro,CASTELO BRANCO,0510,19154.6,3323,169,128,172,247,302,549,721,849,1018,17.35,5.31,4.43,3.76
23-09-2021,VILA DO BISPO,3,0,58,"[0,120]",Baixo a Moderado,,,,3,Algarve,FARO,0815,17906.06,5154,302,302,314,232,233,465,779,1081,1383,28.78,7.72,6.04,4.35
23-09-2021,VILA DO CONDE,83,6,104,"[0,120]",Baixo a Moderado,,,,83,Norte,PORTO,1316,14902.77,79899,4726,3875,2819,2070,1743,3813,6632,10507,15233,536.13,102.21,70.5,44.5
23-09-2021,VILA DO PORTO,0,0,0,"[0,120]",Baixo a Moderado,,,,0,Açores,AÇORES,4101,9688.74,5616,274,212,135,96,123,219,354,566,840,57.96,8.67,5.84,3.65
23-09-2021,VILA FLOR,3,0,50,"[0,120]",Baixo a Moderado,,,,3,Norte,BRAGANÇA,0410,26581.14,6044,429,362,422,294,331,625,1047,1409,1838,22.74,6.91,5.3,3.94
23-09-2021,VILA FRANCA DE XIRA,138,10,97,"[0,120]",Baixo a Moderado,,,,138,Lisboa e Vale do Tejo,LISBOA,1114,31819.39,141957,8501,6852,4869,3425,2472,5897,10766,17618,26119,446.14,82.09,55.37,33.84
23-09-2021,VILA FRANCA DO CAMPO,3,0,27,"[0,120]",Baixo a Moderado,,,,3,Açores,AÇORES,4206,7796.82,11051,450,344,248,217,154,371,619,963,1413,141.73,18.12,12.35,7.94
23-09-2021,VILA NOVA DA BARQUINHA,1,0,13,"[0,120]",Baixo a Moderado,,,,1,Lisboa e Vale do Tejo,SANTARÉM,1420,4952.97,7461,415,406,392,364,338,702,1094,1500,1915,150.64,38.66,30.28,22.09
23-09-2021,VILA NOVA DE CERVEIRA,13,1,146,"[120,240]",Moderado,,,,13,Norte,VIANA DO CASTELO,1610,10846.66,8910,531,444,410,384,334,718,1128,1572,2103,82.14,19.39,14.49,10.4
23-09-2021,VILA NOVA DE FAMALICÃO,180,13,137,"[120,240]",Moderado,,,,180,Norte,BRAGA,0312,20159.26,131676,7817,6164,4202,3282,2749,6031,10233,16397,24214,653.19,120.12,81.34,50.76
23-09-2021,VILA NOVA DE FOZ CÔA,23,2,358,"[240,480]",Elevado,,,,23,Centro,GUARDA,0914,39815.18,6503,442,385,390,398,429,827,1217,1602,2044,16.33,5.13,4.02,3.06
23-09-2021,VILA NOVA DE GAIA,303,22,101,"[0,120]",Baixo a Moderado,,,,303,Norte,PORTO,1317,16846.43,300472,18349,15568,10972,8224,6281,14505,25477,41045,59394,1783.64,352.57,243.65,151.23
23-09-2021,VILA NOVA DE PAIVA,5,0,107,"[0,120]",Baixo a Moderado,,,,5,Centro,VISEU,1822,17553.28,4687,289,272,233,217,241,458,691,963,1252,26.7,7.13,5.49,3.94
23-09-2021,VILA NOVA DE POIARES,8,1,115,"[0,120]",Baixo a Moderado,,,,8,Centro,COIMBRA,0617,8445.3,6939,380,284,262,235,182,417,679,963,1343,82.17,15.9,11.4,8.04
23-09-2021,VILA POUCA DE AGUIAR,21,2,177,"[120,240]",Moderado,,,,21,Norte,VILA REAL,1713,43706.62,11961,860,817,733,601,627,1228,1961,2778,3638,27.37,8.32,6.36,4.49
23-09-2021,VILA REAL,82,6,164,"[120,240]",Moderado,,,,82,Norte,VILA REAL,1714,37880.28,49962,3025,2498,2065,1579,1466,3045,5110,7608,10633,131.9,28.07,20.08,13.49
23-09-2021,VILA REAL DE SANTO ANTÓNIO,15,1,80,"[0,120]",Baixo a Moderado,,,,15,Algarve,FARO,0816,6125.0,18749,1172,1069,811,569,586,1155,1966,3035,4207,306.11,68.69,49.55,32.1
23-09-2021,VILA VELHA DE RÓDÃO,0,0,0,"[0,120]",Baixo a Moderado,,,,0,Centro,CASTELO BRANCO,0511,32991.16,3144,209,229,180,283,306,589,769,998,1207,9.53,3.66,3.03,2.33
23-09-2021,VILA VERDE,62,4,133,"[120,240]",Moderado,,,,62,Norte,BRAGA,0313,22866.52,46911,2365,2063,1667,1494,1437,2931,4598,6661,9026,205.15,39.47,29.13,20.11
23-09-2021,VILA VIÇOSA,5,0,66,"[0,120]",Baixo a Moderado,,,,5,Alentejo,ÉVORA,0714,19485.89,7656,487,379,342,345,324,669,1011,1390,1877,39.29,9.63,7.13,5.19
23-09-2021,VIMIOSO,0,0,0,"[0,120]",Baixo a Moderado,,,,0,Norte,BRAGANÇA,0411,48158.51,4023,274,230,261,293,335,628,889,1119,1393,8.35,2.89,2.32,1.85
23-09-2021,VINHAIS,1,0,13,"[0,120]",Baixo a Moderado,,,,1,Norte,BRAGANÇA,0412,69475.09,7746,599,577,636,641,815,1456,2092,2669,3268,11.15,4.7,3.84,3.01
23-09-2021,VISEU,148,11,152,"[120,240]",Moderado,,,,148,Centro,VISEU,1823,50710.14,97249,5769,5038,4140,3158,2710,5868,10008,15046,20815,191.77,41.05,29.67,19.74
23-09-2021,VIZELA,34,2,142,"[120,240]",Moderado,,,,34,Norte,BRAGA,0314,2469.83,23897,1258,928,655,509,371,880,1535,2463,3721,967.49,150.65,99.72,62.15
23-09-2021,VOUZELA,6,0,62,"[0,120]",Baixo a Moderado,,,,6,Centro,VISEU,1824,19369.46,9619,626,605,554,532,507,1039,1593,2198,2824,49.66,14.58,11.35,8.22
30-09-2021,ABRANTES,6,0,17,"[0,120]",Baixo a Moderado,,,,6,Lisboa e Vale do Tejo,SANTARÉM,1401,71469.08,35130,2473,2213,1730,1748,2021,3769,5499,7712,10185,49.15,14.25,10.79,7.69
30-09-2021,ÁGUEDA,18,1,39,"[0,120]",Baixo a Moderado,,,,18,Centro,AVEIRO,0101,33527.44,46075,3237,2713,2090,1635,1496,3131,5221,7934,11171,137.43,33.32,23.66,15.57
30-09-2021,AGUIAR DA BEIRA,7,1,151,"[120,240]",Moderado,,,,7,Centro,GUARDA,0901,20676.57,4652,304,281,235,239,148,387,622,903,1207,22.5,5.84,4.37,3.01
30-09-2021,ALANDROAL,2,0,41,"[0,120]",Baixo a Moderado,,,,2,Alentejo,ÉVORA,0701,54267.81,4992,307,256,296,299,377,676,972,1228,1535,9.2,2.83,2.26,1.79
30-09-2021,ALBERGARIA-A-VELHA,14,1,58,"[0,120]",Baixo a Moderado,,,,14,Centro,AVEIRO,0102,15882.5,24144,1550,1298,996,687,680,1367,2363,3661,5211,152.02,32.81,23.05,14.88
30-09-2021,ALBUFEIRA,169,12,406,"[240,480]",Elevado,,,,169,Algarve,FARO,0801,14066.42,41528,2067,1717,1425,985,858,1843,3268,4985,7052,295.24,50.14,35.44,23.23
30-09-2021,ALCÁCER DO SAL,14,1,121,"[120,240]",Moderado,,,,14,Alentejo,SETÚBAL,1501,149987.3,11659,884,814,623,623,602,1225,1848,2662,3546,7.77,2.36,1.77,1.23
30-09-2021,ALCANENA,6,0,47,"[0,120]",Baixo a Moderado,,,,6,Lisboa e Vale do Tejo,SANTARÉM,1402,12732.86,12809,891,744,628,536,588,1124,1752,2496,3387,100.6,26.6,19.6,13.76
30-09-2021,ALCOBAÇA,89,6,167,"[120,240]",Moderado,,,,89,Lisboa e Vale do Tejo,LEIRIA,1001,40814.09,53555,3420,2927,2466,2059,1676,3735,6201,9128,12548,131.22,30.74,22.36,15.19
30-09-2021,ALCOCHETE,5,0,25,"[0,120]",Baixo a Moderado,,,,5,Lisboa e Vale do Tejo,SETÚBAL,1502,12836.48,19787,857,834,691,476,447,923,1614,2448,3305,154.15,25.75,19.07,12.57
30-09-2021,ALCOUTIM,27,2,1252,"[960,Max]",Extremamente Elevado,,,,27,Algarve,FARO,0802,57536.33,2159,191,188,163,190,267,457,620,808,999,3.75,1.74,1.4,1.08
30-09-2021,ALENQUER,33,2,76,"[0,120]",Baixo a Moderado,,,,33,Lisboa e Vale do Tejo,LISBOA,1101,30421.92,44052,2298,2062,1629,1330,1155,2485,4114,6176,8474,144.8,27.85,20.3,13.52
30-09-2021,ALFÂNDEGA DA FÉ,2,0,45,"[0,120]",Baixo a Moderado,,,,2,Norte,BRAGANÇA,0401,32194.64,4550,325,277,301,274,325,599,900,1177,1502,14.13,4.67,3.66,2.8
30-09-2021,ALIJÓ,15,1,142,"[120,240]",Moderado,,,,15,Norte,VILA REAL,1701,29759.89,10625,766,687,635,542,666,1208,1843,2530,3296,35.7,11.08,8.5,6.19
30-09-2021,ALJEZUR,6,0,107,"[0,120]",Baixo a Moderado,,,,6,Algarve,FARO,0803,32349.95,5594,316,336,335,320,410,730,1065,1401,1717,17.29,5.31,4.33,3.29
30-09-2021,ALJUSTREL,16,1,197,"[120,240]",Moderado,,,,16,Alentejo,BEJA,0201,45847.41,8247,635,521,443,347,358,705,1148,1669,2304,17.99,5.03,3.64,2.5
30-09-2021,ALMADA,134,10,79,"[0,120]",Baixo a Moderado,,,,134,Lisboa e Vale do Tejo,SETÚBAL,1503,7000.89,169039,10469,9777,7876,6144,5111,11255,19131,28908,39377,2414.5,562.45,412.91,273.26
30-09-2021,ALMEIDA,2,0,35,"[0,120]",Baixo a Moderado,,,,2,Centro,GUARDA,0902,51798.46,5830,441,419,396,458,393,851,1247,1666,2107,11.26,4.07,3.22,2.41
30-09-2021,ALMEIRIM,31,2,138,"[120,240]",Moderado,,,,31,Lisboa e Vale do Tejo,SANTARÉM,1403,22212.05,22546,1342,1353,1106,866,843,1709,2815,4168,5510,101.5,24.81,18.76,12.67
30-09-2021,ALMODÔVAR,4,0,60,"[0,120]",Baixo a Moderado,,,,4,Alentejo,BEJA,0202,77788.03,6725,414,443,396,373,328,701,1097,1540,1954,8.65,2.51,1.98,1.41
30-09-2021,ALPIARÇA,4,0,57,"[0,120]",Baixo a Moderado,,,,4,Lisboa e Vale do Tejo,SANTARÉM,1404,9536.33,7059,515,486,363,333,274,607,970,1456,1971,74.02,20.67,15.27,10.17
30-09-2021,ALTER DO CHÃO,0,0,0,"[0,120]",Baixo a Moderado,,,,0,Alentejo,PORTALEGRE,1201,36206.62,3165,201,163,136,208,187,395,531,694,895,8.74,2.47,1.92,1.47
30-09-2021,ALVAIÁZERE,3,0,46,"[0,120]",Baixo a Moderado,,,,3,Centro,LEIRIA,1002,16047.76,6597,419,389,346,406,539,945,1291,1680,2099,41.11,13.08,10.47,8.04
30-09-2021,ALVITO,1,0,41,"[0,120]",Baixo a Moderado,,,,1,Alentejo,BEJA,0203,26485.32,2477,145,110,105,111,89,200,305,415,560,9.35,2.11,1.57,1.15
30-09-2021,AMADORA,156,11,85,"[0,120]",Baixo a Moderado,,,,156,Lisboa e Vale do Tejo,LISBOA,1115,2378.47,184106,11186,10936,8780,6460,5890,12350,21130,32066,43252,7742.05,1818.84,1348.44,888.56
30-09-2021,AMARANTE,39,3,74,"[0,120]",Baixo a Moderado,,,,39,Norte,PORTO,1301,30133.15,53193,3086,2413,1812,1643,1311,2954,4766,7179,10265,176.53,34.07,23.82,15.82
30-09-2021,AMARES,31,2,171,"[120,240]",Moderado,,,,31,Norte,BRAGA,0301,8195.41,18129,1001,829,622,489,524,1013,1635,2464,3465,221.22,42.28,30.07,19.95
30-09-2021,ANADIA,32,2,117,"[0,120]",Baixo a Moderado,,,,32,Centro,AVEIRO,0103,21663.48,27258,1931,1698,1376,1208,1262,2470,3846,5544,7475,125.83,34.51,25.59,17.75
30-09-2021,ANGRA DO HEROÍSMO,14,1,42,"[0,120]",Baixo a Moderado,,,,14,Açores,AÇORES,4301,23899.66,33807,2006,1473,1122,768,635,1403,2525,3998,6004,141.45,25.12,16.73,10.56
30-09-2021,ANSIÃO,12,1,99,"[0,120]",Baixo a Moderado,,,,12,Centro,LEIRIA,1003,17609.42,12039,727,709,646,694,530,1224,1870,2579,3306,68.37,18.77,14.65,10.62
30-09-2021,ARCOS DE VALDEVEZ,20,1,96,"[0,120]",Baixo a Moderado,,,,20,Norte,VIANA DO CASTELO,1601,44759.64,20926,1329,1338,1282,1343,1515,2858,4140,5478,6807,46.75,15.21,12.24,9.25
30-09-2021,ARGANIL,37,3,337,"[240,480]",Elevado,,,,37,Centro,COIMBRA,0601,33283.93,11014,672,648,612,559,596,1155,1767,2415,3087,33.09,9.27,7.26,5.31
30-09-2021,ARMAMAR,1,0,17,"[0,120]",Baixo a Moderado,,,,1,Norte,VISEU,1801,11723.73,5769,357,305,309,285,310,595,904,1209,1566,49.21,13.36,10.31,7.71
30-09-2021,AROUCA,39,3,189,"[120,240]",Moderado,,,,39,Norte,AVEIRO,0104,32910.52,20720,1306,1047,753,683,683,1366,2119,3166,4472,62.96,13.59,9.62,6.44
30-09-2021,ARRAIOLOS,2,0,29,"[0,120]",Baixo a Moderado,,,,2,Alentejo,ÉVORA,0702,68374.55,6928,435,384,283,367,480,847,1130,1514,1949,10.13,2.85,2.21,1.65
30-09-2021,ARRONCHES,0,0,0,"[0,120]",Baixo a Moderado,,,,0,Alentejo,PORTALEGRE,1202,31464.72,2820,155,142,162,187,179,366,528,670,825,8.96,2.62,2.13,1.68
30-09-2021,ARRUDA DOS VINHOS,3,0,19,"[0,120]",Baixo a Moderado,,,,3,Lisboa e Vale do Tejo,LISBOA,1102,7795.93,15412,738,738,562,509,438,947,1509,2247,2985,197.69,38.29,28.82,19.36
30-09-2021,AVEIRO,67,5,85,"[0,120]",Baixo a Moderado,,,,67,Centro,AVEIRO,0105,19757.57,78734,4520,4004,3050,2250,2103,4353,7403,11407,15927,398.49,80.61,57.73,37.47
30-09-2021,AVIS,0,0,0,"[0,120]",Baixo a Moderado,,,,0,Alentejo,PORTALEGRE,1203,60596.51,4247,315,225,206,251,273,524,730,955,1270,7.01,2.1,1.58,1.2
30-09-2021,AZAMBUJA,19,1,83,"[0,120]",Baixo a Moderado,,,,19,Lisboa e Vale do Tejo,LISBOA,1103,26265.65,22716,1322,1171,1070,798,618,1416,2486,3657,4979,86.48,18.96,13.92,9.46
30-09-2021,BAIÃO,8,1,43,"[0,120]",Baixo a Moderado,,,,8,Norte,PORTO,1302,17452.83,18748,1070,862,714,686,725,1411,2125,2987,4057,107.42,23.25,17.11,12.18
30-09-2021,BARCELOS,80,6,69,"[0,120]",Baixo a Moderado,,,,80,Norte,BRAGA,0302,37890.14,116187,6721,5325,3619,2991,2562,5553,9172,14497,21218,306.64,56.0,38.26,24.21
30-09-2021,BARRANCOS,13,1,801,"[480,960]",Muito Elevado,,,,13,Alentejo,BEJA,0204,16841.73,1634,90,65,65,94,61,155,220,285,375,9.7,2.23,1.69,1.31
30-09-2021,BARREIRO,50,4,66,"[0,120]",Baixo a Moderado,,,,50,Lisboa e Vale do Tejo,SETÚBAL,1504,3639.07,75147,5194,5565,4459,3105,1767,4872,9331,14896,20090,2065.05,552.07,409.34,256.42
30-09-2021,BATALHA,10,1,62,"[0,120]",Baixo a Moderado,,,,10,Centro,LEIRIA,1004,10341.6,15963,873,762,649,529,549,1078,1727,2489,3362,154.35,32.51,24.07,16.7
30-09-2021,BEJA,154,11,459,"[240,480]",Elevado,,,,154,Alentejo,BEJA,0205,114647.55,33579,2005,1840,1386,1272,1039,2311,3697,5537,7542,29.29,6.58,4.83,3.22
30-09-2021,BELMONTE,2,0,31,"[0,120]",Baixo a Moderado,,,,2,Centro,CASTELO BRANCO,0501,11875.91,6398,444,321,325,310,355,665,990,1311,1755,53.87,14.78,11.04,8.34
30-09-2021,BENAVENTE,33,2,107,"[0,120]",Baixo a Moderado,,,,33,Lisboa e Vale do Tejo,SANTARÉM,1405,52138.39,30602,1468,1376,1141,876,643,1519,2660,4036,5504,58.69,10.56,7.74,5.1
30-09-2021,BOMBARRAL,15,1,118,"[0,120]",Baixo a Moderado,,,,15,Lisboa e Vale do Tejo,LEIRIA,1005,9128.55,12558,875,714,561,491,429,920,1481,2195,3070,137.56,33.63,24.04,16.22
30-09-2021,BORBA,3,0,45,"[0,120]",Baixo a Moderado,,,,3,Alentejo,ÉVORA,0703,14518.65,6736,430,375,279,436,392,828,1107,1482,1912,46.39,13.17,10.21,7.62
30-09-2021,BOTICAS,7,1,142,"[120,240]",Moderado,,,,7,Norte,VILA REAL,1702,32195.66,4998,347,306,311,305,380,685,996,1302,1649,15.52,5.12,4.04,3.09
30-09-2021,BRAGA,221,16,121,"[120,240]",Moderado,,,,221,Norte,BRAGA,0303,18339.95,182679,10029,7963,5241,4320,3671,7991,13232,21195,31224,996.07,170.25,115.57,72.15
30-09-2021,BRAGANÇA,52,4,155,"[120,240]",Moderado,,,,52,Norte,BRAGANÇA,0402,117357.27,33607,2402,1855,1652,1393,1163,2556,4208,6063,8465,28.64,7.21,5.17,3.59
30-09-2021,CABECEIRAS DE BASTO,39,3,251,"[240,480]",Elevado,,,,39,Norte,BRAGA,0304,24182.16,15628,774,594,544,575,574,1149,1693,2287,3061,64.63,12.66,9.46,7.0
30-09-2021,CADAVAL,4,0,29,"[0,120]",Baixo a Moderado,,,,4,Lisboa e Vale do Tejo,LISBOA,1104,17489.3,13673,813,796,756,621,625,1246,2002,2798,3611,78.18,20.65,16.0,11.45
30-09-2021,CALDAS DA RAINHA,48,3,93,"[0,120]",Baixo a Moderado,,,,48,Lisboa e Vale do Tejo,LEIRIA,1006,25569.47,51912,3035,2684,2186,1899,1705,3604,5790,8474,11509,203.03,45.01,33.14,22.64
30-09-2021,CALHETA,2,0,18,"[0,120]",Baixo a Moderado,,,,2,Madeira,MADEIRA,3101,11150.43,10867,576,497,507,399,415,814,1321,1818,2394,97.46,21.47,16.3,11.85
30-09-2021,CALHETA (AÇORES),0,0,0,"[0,120]",Baixo a Moderado,,,,0,Açores,AÇORES,4501,12626.4,3184,215,159,141,139,122,261,402,561,776,25.22,6.15,4.44,3.18
30-09-2021,CÂMARA DE LOBOS,16,1,48,"[0,120]",Baixo a Moderado,,,,16,Madeira,MADEIRA,3102,5216.67,33675,1396,1059,834,545,381,926,1760,2819,4215,645.49,80.79,54.03,33.74
30-09-2021,CAMINHA,23,2,146,"[120,240]",Moderado,,,,23,Norte,VIANA DO CASTELO,1602,13652.14,15877,1046,944,818,646,656,1302,2120,3064,4110,116.3,30.11,22.44,15.53
30-09-2021,CAMPO MAIOR,16,1,205,"[120,240]",Moderado,,,,16,Alentejo,PORTALEGRE,1204,24720.16,7874,471,364,351,279,327,606,957,1321,1792,31.85,7.25,5.34,3.87
30-09-2021,CANTANHEDE,28,2,80,"[0,120]",Baixo a Moderado,,,,28,Centro,COIMBRA,0602,39088.02,35011,2346,2096,1880,1709,1451,3160,5040,7136,9482,89.57,24.26,18.26,12.89
30-09-2021,CARRAZEDA DE ANSIÃES,1,0,18,"[0,120]",Baixo a Moderado,,,,1,Norte,BRAGANÇA,0403,27924.09,5666,424,389,391,312,465,777,1168,1557,1981,20.29,7.09,5.58,4.18
30-09-2021,CARREGAL DO SAL,4,0,43,"[0,120]",Baixo a Moderado,,,,4,Centro,VISEU,1802,11689.21,9271,587,562,486,462,376,838,1324,1886,2473,79.31,21.16,16.13,11.33
30-09-2021,CARTAXO,28,2,118,"[0,120]",Baixo a Moderado,,,,28,Lisboa e Vale do Tejo,SANTARÉM,1406,15817.28,23843,1415,1376,1142,861,632,1493,2635,4011,5426,150.74,34.3,25.36,16.66
30-09-2021,CASCAIS,203,14,95,"[0,120]",Baixo a Moderado,,,,203,Lisboa e Vale do Tejo,LISBOA,1105,9740.17,213608,12151,11444,8680,6469,5248,11717,20397,31841,43992,2193.1,451.66,326.91,209.41
30-09-2021,CASTANHEIRA DE PÊRA,2,0,78,"[0,120]",Baixo a Moderado,,,,2,Centro,LEIRIA,1007,6677.45,2614,233,195,157,190,187,377,534,729,962,39.15,14.41,10.92,8.0
30-09-2021,CASTELO BRANCO,109,8,210,"[120,240]",Moderado,,,,109,Centro,CASTELO BRANCO,0502,143819.15,51987,3528,3042,2499,2229,2225,4454,6953,9995,13523,36.15,9.4,6.95,4.83
30-09-2021,CASTELO DE PAIVA,3,0,20,"[0,120]",Baixo a Moderado,,,,3,Norte,AVEIRO,0106,11500.53,15454,881,697,545,420,431,851,1396,2093,2974,134.37,25.86,18.2,12.14
30-09-2021,CASTELO DE VIDE,0,0,0,"[0,120]",Baixo a Moderado,,,,0,Alentejo,PORTALEGRE,1205,26491.24,2919,204,173,179,147,170,317,496,669,873,11.02,3.3,2.53,1.87
30-09-2021,CASTRO DAIRE,18,1,130,"[120,240]",Moderado,,,,18,Centro,VISEU,1803,37904.13,13823,942,857,765,732,773,1505,2270,3127,4069,36.47,10.74,8.25,5.99
30-09-2021,CASTRO MARIM,5,0,81,"[0,120]",Baixo a Moderado,,,,5,Algarve,FARO,0804,30084.37,6237,370,345,334,322,344,666,1000,1345,1715,20.73,5.7,4.47,3.32
30-09-2021,CASTRO VERDE,4,0,58,"[0,120]",Baixo a Moderado,,,,4,Alentejo,BEJA,0206,56944.23,6949,437,347,303,275,227,502,805,1152,1589,12.2,2.79,2.02,1.41
30-09-2021,CELORICO DA BEIRA,4,0,58,"[0,120]",Baixo a Moderado,,,,4,Centro,GUARDA,0903,24721.63,6928,430,416,363,369,535,904,1267,1683,2113,28.02,8.55,6.81,5.12
30-09-2021,CELORICO DE BASTO,13,1,69,"[0,120]",Baixo a Moderado,,,,13,Norte,BRAGA,0305,18107.02,19040,1001,802,668,728,729,1457,2125,2927,3928,105.15,21.69,16.17,11.74
30-09-2021,CHAMUSCA,5,0,55,"[0,120]",Baixo a Moderado,,,,5,Lisboa e Vale do Tejo,SANTARÉM,1407,74600.54,9197,629,583,553,465,579,1044,1597,2180,2809,12.33,3.77,2.92,2.14
30-09-2021,CHAVES,27,2,69,"[0,120]",Baixo a Moderado,,,,27,Norte,VILA REAL,1703,59122.95,39343,2676,2429,1991,1886,1918,3804,5795,8224,10900,66.54,18.44,13.91,9.8
30-09-2021,CINFÃES,33,2,183,"[120,240]",Moderado,,,,33,Norte,VISEU,1804,23928.76,18244,1067,902,779,734,758,1492,2271,3173,4240,76.24,17.72,13.26,9.49
30-09-2021,COIMBRA,82,6,61,"[0,120]",Baixo a Moderado,,,,82,Centro,COIMBRA,0603,31939.94,134166,9489,8734,6353,5139,5074,10213,16566,25300,34789,420.06,108.92,79.21,51.87
30-09-2021,CONDEIXA-A-NOVA,9,1,50,"[0,120]",Baixo a Moderado,,,,9,Centro,COIMBRA,0604,13867.47,17733,871,809,717,583,490,1073,1790,2599,3470,127.88,25.02,18.74,12.91
30-09-2021,CONSTÂNCIA,2,0,49,"[0,120]",Baixo a Moderado,,,,2,Lisboa e Vale do Tejo,SANTARÉM,1408,8036.58,4030,211,183,187,148,155,303,490,673,884,50.14,11.0,8.37,6.1
30-09-2021,CORUCHE,6,0,35,"[0,120]",Baixo a Moderado,,,,6,Lisboa e Vale do Tejo,SANTARÉM,1409,111572.03,17471,1294,1090,1095,1096,1019,2115,3210,4300,5594,15.66,5.01,3.85,2.88
30-09-2021,CORVO,0,0,0,"[0,120]",Baixo a Moderado,,,,0,Açores,AÇORES,4901,1711.45,464,22,21,11,13,19,32,43,64,86,27.12,5.03,3.74,2.51
30-09-2021,COVILHÃ,75,5,160,"[120,240]",Moderado,,,,75,Centro,CASTELO BRANCO,0503,55560.06,46787,3533,2998,2365,2111,2193,4304,6669,9667,13200,84.21,23.76,17.4,12.0
30-09-2021,CRATO,0,0,0,"[0,120]",Baixo a Moderado,,,,0,Alentejo,PORTALEGRE,1206,39806.88,3129,229,258,163,182,228,410,573,831,1060,7.86,2.66,2.09,1.44
30-09-2021,CUBA,14,1,308,"[240,480]",Elevado,,,,14,Alentejo,BEJA,0207,17208.72,4595,255,233,206,190,143,333,539,772,1027,26.7,5.97,4.49,3.13
30-09-2021,ELVAS,12,1,59,"[0,120]",Baixo a Moderado,,,,12,Alentejo,PORTALEGRE,1207,63128.86,20528,1057,1145,902,852,810,1662,2564,3709,4766,32.52,7.55,5.88,4.06
30-09-2021,ENTRONCAMENTO,28,2,132,"[120,240]",Moderado,,,,28,Lisboa e Vale do Tejo,SANTARÉM,1410,1372.81,21558,1066,930,868,695,592,1287,2155,3085,4151,1570.14,302.33,224.69,156.96
30-09-2021,ESPINHO,5,0,17,"[0,120]",Baixo a Moderado,,,,5,Norte,AVEIRO,0107,2105.68,29516,2205,1993,1430,1177,960,2137,3567,5560,7765,1401.52,368.71,264.01,169.37
30-09-2021,ESPOSENDE,61,4,179,"[120,240]",Moderado,,,,61,Norte,BRAGA,0306,9540.98,34177,1831,1522,1095,894,723,1617,2712,4234,6065,358.21,63.57,44.38,28.42
30-09-2021,ESTARREJA,9,1,34,"[0,120]",Baixo a Moderado,,,,9,Centro,AVEIRO,0108,10817.33,26006,1503,1399,1106,953,728,1681,2787,4186,5689,240.42,52.59,38.7,25.76
30-09-2021,ESTREMOZ,10,1,79,"[0,120]",Baixo a Moderado,,,,10,Alentejo,ÉVORA,0704,51379.95,12728,789,613,697,786,877,1663,2360,2973,3762,24.77,7.32,5.79,4.59
30-09-2021,ÉVORA,36,3,69,"[0,120]",Baixo a Moderado,,,,36,Alentejo,ÉVORA,0705,130707.58,52428,3569,2852,2176,1966,1803,3769,5945,8797,12366,40.11,9.46,6.73,4.55
30-09-2021,FAFE,99,7,205,"[120,240]",Moderado,,,,99,Norte,BRAGA,0307,21908.11,48060,3044,2455,1679,1403,1208,2611,4290,6745,9789,219.37,44.68,30.79,19.58
30-09-2021,FARO,92,7,151,"[120,240]",Moderado,,,,92,Algarve,FARO,0805,20256.79,61015,3847,3364,2604,2055,1601,3656,6260,9624,13471,301.2,66.5,47.51,30.9
30-09-2021,FELGUEIRAS,46,3,82,"[0,120]",Baixo a Moderado,,,,46,Norte,PORTO,1303,11573.75,56422,2951,2302,1601,1316,973,2289,3890,6192,9143,487.49,79.0,53.5,33.61
30-09-2021,FERREIRA DO ALENTEJO,21,2,269,"[240,480]",Elevado,,,,21,Alentejo,BEJA,0208,64820.68,7845,515,414,372,343,345,688,1060,1474,1989,12.1,3.07,2.27,1.64
30-09-2021,FERREIRA DO ZÊZERE,4,0,50,"[0,120]",Baixo a Moderado,,,,4,Lisboa e Vale do Tejo,SANTARÉM,1411,19038.03,7959,470,370,416,465,456,921,1337,1707,2177,41.81,11.44,8.97,7.02
30-09-2021,FIGUEIRA DA FOZ,61,4,104,"[0,120]",Baixo a Moderado,,,,61,Centro,COIMBRA,0605,37905.26,58747,4032,3597,2887,2495,2043,4538,7425,11022,15054,154.98,39.72,29.08,19.59
30-09-2021,FIGUEIRA DE CASTELO RODRIGO,4,0,72,"[0,120]",Baixo a Moderado,,,,4,Centro,GUARDA,0904,50857.46,5584,347,352,290,352,391,743,1033,1385,1732,10.98,3.41,2.72,2.03
30-09-2021,FIGUEIRÓ DOS VINHOS,0,0,0,"[0,120]",Baixo a Moderado,,,,0,Centro,LEIRIA,1008,17344.0,5568,402,386,322,309,351,660,982,1368,1770,32.1,10.21,7.89,5.66
30-09-2021,FORNOS DE ALGODRES,2,0,44,"[0,120]",Baixo a Moderado,,,,2,Centro,GUARDA,0905,13145.05,4528,261,218,247,256,232,488,735,953,1214,34.45,9.24,7.25,5.59
30-09-2021,FREIXO DE ESPADA À CINTA,0,0,0,"[0,120]",Baixo a Moderado,,,,0,Norte,BRAGANÇA,0404,24414.29,3298,211,177,231,196,189,385,616,793,1004,13.51,4.11,3.25,2.52
30-09-2021,FRONTEIRA,0,0,0,"[0,120]",Baixo a Moderado,,,,0,Alentejo,PORTALEGRE,1208,24859.58,2974,213,182,149,156,168,324,473,655,868,11.96,3.49,2.63,1.9
30-09-2021,FUNCHAL,111,8,107,"[0,120]",Baixo a Moderado,,,,111,Madeira,MADEIRA,3103,7616.2,104024,6382,5086,3643,2821,1990,4811,8454,13540,19922,1365.86,261.58,177.78,111.0
30-09-2021,FUNDÃO,22,2,83,"[0,120]",Baixo a Moderado,,,,22,Centro,CASTELO BRANCO,0504,70019.79,26495,1781,1464,1432,1357,1643,3000,4432,5896,7677,37.84,10.96,8.42,6.33
30-09-2021,GAVIÃO,2,0,63,"[0,120]",Baixo a Moderado,,,,2,Alentejo,PORTALEGRE,1209,29459.45,3263,189,186,222,263,293,556,778,964,1153,11.08,3.91,3.27,2.64
30-09-2021,GÓIS,3,0,80,"[0,120]",Baixo a Moderado,,,,3,Centro,COIMBRA,0606,26330.19,3805,235,199,240,233,244,477,717,916,1151,14.45,4.37,3.48,2.72
30-09-2021,GOLEGÃ,5,0,95,"[0,120]",Baixo a Moderado,,,,5,Lisboa e Vale do Tejo,SANTARÉM,1412,8431.67,5339,356,299,281,243,255,498,779,1078,1434,63.32,17.01,12.78,9.24
30-09-2021,GONDOMAR,88,6,53,"[0,120]",Baixo a Moderado,,,,88,Norte,PORTO,1304,13191.76,165985,10555,8755,6222,4450,3364,7814,14036,22791,33346,1258.22,252.77,172.76,106.4
30-09-2021,GOUVEIA,2,0,16,"[0,120]",Baixo a Moderado,,,,2,Centro,GUARDA,0906,30061.17,12387,871,931,780,783,810,1593,2373,3304,4175,41.21,13.89,10.99,7.89
30-09-2021,GRÂNDOLA,40,3,274,"[240,480]",Elevado,,,,40,Alentejo,SETÚBAL,1505,82593.66,14639,834,834,708,688,672,1360,2068,2902,3736,17.72,4.52,3.51,2.5
30-09-2021,GUARDA,31,2,79,"[0,120]",Baixo a Moderado,,,,31,Centro,GUARDA,0907,71209.58,38969,2477,2041,1686,1415,1474,2889,4575,6616,9093,54.72,12.77,9.29,6.42
30-09-2021,GUIMARÃES,221,16,145,"[120,240]",Moderado,,,,221,Norte,BRAGA,0308,24099.96,152309,9394,7074,4809,3877,2948,6825,11634,18708,28102,631.99,116.61,77.63,48.27
30-09-2021,HORTA,22,2,152,"[120,240]",Moderado,,,,22,Açores,AÇORES,4701,17305.53,14521,818,658,468,352,302,654,1122,1780,2598,83.91,15.01,10.29,6.48
30-09-2021,IDANHA-A-NOVA,2,0,25,"[0,120]",Baixo a Moderado,,,,2,Centro,CASTELO BRANCO,0505,141633.51,8043,518,490,519,672,974,1646,2165,2655,3173,5.68,2.24,1.87,1.53
30-09-2021,ÍLHAVO,15,1,38,"[0,120]",Baixo a Moderado,,,,15,Centro,AVEIRO,0110,7347.55,38699,2227,1943,1444,1193,850,2043,3487,5430,7657,526.66,104.21,73.9,47.46
30-09-2021,LAGOA (FARO),54,4,237,"[120,240]",Moderado,,,,54,Algarve,FARO,0806,8825.45,22762,1314,1168,919,749,670,1419,2338,3506,4820,257.93,54.62,39.73,26.49
30-09-2021,LAGOA,28,2,190,"[120,240]",Moderado,,,,28,Açores,AÇORES,4201,4559.32,14721,536,458,349,238,235,473,822,1280,1816,322.9,39.83,28.08,18.03
30-09-2021,LAGOS,70,5,231,"[120,240]",Moderado,,,,70,Algarve,FARO,0807,21299.27,30374,1744,1434,1247,1053,1029,2082,3329,4763,6507,142.61,30.55,22.36,15.63
30-09-2021,LAJES DAS FLORES,0,0,0,"[0,120]",Baixo a Moderado,,,,0,Açores,AÇORES,4801,7004.79,1463,88,53,62,46,54,100,162,215,303,20.89,4.33,3.07,2.31
30-09-2021,LAJES DO PICO,1,0,22,"[0,120]",Baixo a Moderado,,,,1,Açores,AÇORES,4601,15531.09,4490,304,231,223,159,162,321,544,775,1079,28.91,6.95,4.99,3.5
30-09-2021,LAMEGO,31,2,125,"[120,240]",Moderado,,,,31,Norte,VISEU,1805,16542.11,24895,1639,1284,1124,898,783,1681,2805,4089,5728,150.5,34.63,24.72,16.96
30-09-2021,LEIRIA,130,9,104,"[0,120]",Baixo a Moderado,,,,130,Centro,LEIRIA,1009,56508.83,125267,7389,6366,5090,3902,3159,7061,12151,18517,25906,221.68,45.84,32.77,21.5
30-09-2021,LISBOA,596,43,117,"[0,120]",Baixo a Moderado,,,,596,Lisboa e Vale do Tejo,LISBOA,1106,10005.43,509515,33197,33340,27706,23037,26770,49807,77513,110853,144050,5092.6,1439.78,1107.98,774.74
30-09-2021,LOULÉ,122,9,178,"[120,240]",Moderado,,,,122,Algarve,FARO,0808,76366.91,68697,3890,3350,2780,2358,2251,4609,7389,10739,14629,89.96,19.16,14.06,9.68
30-09-2021,LOURES,190,14,89,"[0,120]",Baixo a Moderado,,,,190,Lisboa e Vale do Tejo,LISBOA,1107,16723.99,213687,12746,12794,9644,6669,5033,11702,21346,34140,46886,1277.73,280.35,204.14,127.64
30-09-2021,LOURINHÃ,51,4,199,"[120,240]",Moderado,,,,51,Lisboa e Vale do Tejo,LISBOA,1108,14717.2,25855,1584,1243,992,842,645,1487,2479,3722,5306,175.68,36.05,25.29,16.84
30-09-2021,LOUSÃ,13,1,75,"[0,120]",Baixo a Moderado,,,,13,Centro,COIMBRA,0607,13840.01,17158,946,866,658,528,450,978,1636,2502,3448,123.97,24.91,18.08,11.82
30-09-2021,LOUSADA,43,3,92,"[0,120]",Baixo a Moderado,,,,43,Norte,PORTO,1305,9608.01,46755,2289,1698,1176,853,621,1474,2650,4348,6637,486.63,69.08,45.25,27.58
30-09-2021,MAÇÃO,3,0,48,"[0,120]",Baixo a Moderado,,,,3,Lisboa e Vale do Tejo,SANTARÉM,1413,39997.98,6267,386,362,390,440,657,1097,1487,1849,2235,15.67,5.59,4.62,3.72
30-09-2021,MACEDO DE CAVALEIROS,2,0,14,"[0,120]",Baixo a Moderado,,,,2,Norte,BRAGANÇA,0405,69914.08,14516,1082,889,878,823,938,1761,2639,3528,4610,20.76,6.59,5.05,3.77
30-09-2021,MACHICO,15,1,75,"[0,120]",Baixo a Moderado,,,,15,Madeira,MADEIRA,3104,6825.1,19981,1197,860,662,455,331,786,1448,2308,3505,292.76,51.36,33.82,21.22
30-09-2021,MADALENA,4,0,68,"[0,120]",Baixo a Moderado,,,,4,Açores,AÇORES,4602,14712.33,5895,334,256,173,190,179,369,542,798,1132,40.07,7.69,5.42,3.68
30-09-2021,MAFRA,35,2,41,"[0,120]",Baixo a Moderado,,,,35,Lisboa e Vale do Tejo,LISBOA,1109,29165.5,84816,3613,3334,2839,2089,1899,3988,6827,10161,13774,290.81,47.23,34.84,23.41
30-09-2021,MAIA,129,9,93,"[0,120]",Baixo a Moderado,,,,129,Norte,PORTO,1306,8293.94,138971,7801,6617,4512,3339,2631,5970,10482,17099,24900,1675.56,300.22,206.16,126.38
30-09-2021,MANGUALDE,26,2,140,"[120,240]",Moderado,,,,26,Centro,VISEU,1806,21925.56,18510,1198,1128,885,852,743,1595,2480,3608,4806,84.42,21.92,16.46,11.31
30-09-2021,MANTEIGAS,0,0,0,"[0,120]",Baixo a Moderado,,,,0,Centro,GUARDA,0908,12197.55,3007,258,197,159,167,146,313,472,669,927,24.65,7.6,5.48,3.87
30-09-2021,MARCO DE CANAVESES,10,1,20,"[0,120]",Baixo a Moderado,,,,10,Norte,PORTO,1307,20188.98,51496,2678,2060,1488,1265,1023,2288,3776,5836,8514,255.07,42.17,28.91,18.7
30-09-2021,MARINHA GRANDE,19,1,49,"[0,120]",Baixo a Moderado,,,,19,Centro,LEIRIA,1010,18725.19,38508,2365,2302,1638,1359,1058,2417,4055,6357,8722,205.65,46.58,33.95,21.66
30-09-2021,MARVÃO,6,0,204,"[120,240]",Moderado,,,,6,Alentejo,PORTALEGRE,1210,15489.9,3005,198,185,142,197,237,434,576,761,959,19.4,6.19,4.91,3.72
30-09-2021,MATOSINHOS,170,12,97,"[0,120]",Baixo a Moderado,,,,170,Norte,PORTO,1308,6241.97,175357,11850,9977,7023,5024,3884,8908,15931,25908,37758,2809.31,604.9,415.06,255.22
30-09-2021,MEALHADA,5,0,25,"[0,120]",Baixo a Moderado,,,,5,Centro,AVEIRO,0111,11065.66,19914,1163,1039,810,828,831,1659,2469,3508,4671,179.96,42.21,31.7,22.31
30-09-2021,MÊDA,2,0,44,"[0,120]",Baixo a Moderado,,,,2,Centro,GUARDA,0909,28604.92,4587,343,306,290,288,443,731,1021,1327,1670,16.04,5.84,4.64,3.57
30-09-2021,MELGAÇO,9,1,113,"[0,120]",Baixo a Moderado,,,,9,Norte,VIANA DO CASTELO,1603,23824.58,8093,507,567,578,614,675,1289,1867,2434,2941,33.97,12.34,10.22,7.84
30-09-2021,MÉRTOLA,13,1,215,"[120,240]",Moderado,,,,13,Alentejo,BEJA,0209,129287.34,6142,400,390,378,423,600,1023,1401,1791,2191,4.75,1.69,1.39,1.08
30-09-2021,MESÃO FRIO,7,1,178,"[120,240]",Moderado,,,,7,Norte,VILA REAL,1704,2664.87,3964,265,205,168,157,120,277,445,650,915,148.74,34.33,24.39,16.7
30-09-2021,MIRA,1,0,8,"[0,120]",Baixo a Moderado,,,,1,Centro,COIMBRA,0608,12403.38,11832,727,729,659,550,466,1016,1675,2404,3131,95.4,25.24,19.38,13.5
30-09-2021,MIRANDA DO CORVO,8,1,63,"[0,120]",Baixo a Moderado,,,,8,Centro,COIMBRA,0609,12637.79,12708,706,659,568,498,404,902,1470,2129,2835,100.55,22.43,16.85,11.63
30-09-2021,MIRANDA DO DOURO,0,0,0,"[0,120]",Baixo a Moderado,,,,0,Norte,BRAGANÇA,0406,48718.31,6830,482,429,442,463,470,933,1375,1804,2286,14.02,4.69,3.7,2.82
30-09-2021,MIRANDELA,27,2,125,"[120,240]",Moderado,,,,27,Norte,BRAGANÇA,0407,65895.67,21754,1640,1315,1204,1078,947,2025,3229,4544,6184,33.01,9.38,6.9,4.9
30-09-2021,MOGADOURO,0,0,0,"[0,120]",Baixo a Moderado,,,,0,Norte,BRAGANÇA,0408,76064.93,8392,589,529,576,630,655,1285,1861,2390,2979,11.03,3.92,3.14,2.45
30-09-2021,MOIMENTA DA BEIRA,3,0,31,"[0,120]",Baixo a Moderado,,,,3,Norte,VISEU,1807,21996.9,9736,576,514,471,416,461,877,1348,1862,2438,44.26,11.08,8.46,6.13
30-09-2021,MOITA,79,6,122,"[120,240]",Moderado,,,,79,Lisboa e Vale do Tejo,SETÚBAL,1506,5525.98,64407,4226,3646,2623,1801,1425,3226,5849,9495,13721,1165.53,248.3,171.82,105.85
30-09-2021,MONÇÃO,3,0,17,"[0,120]",Baixo a Moderado,,,,3,Norte,VIANA DO CASTELO,1604,21130.85,17869,1161,1105,1031,1006,972,1978,3009,4114,5275,84.56,24.96,19.47,14.24
30-09-2021,MONCHIQUE,9,1,181,"[120,240]",Moderado,,,,9,Algarve,FARO,0809,39530.43,5077,353,384,321,355,392,747,1068,1452,1805,12.84,4.57,3.67,2.7
30-09-2021,MONDIM DE BASTO,5,0,73,"[0,120]",Baixo a Moderado,,,,5,Norte,VILA REAL,1705,17207.52,6946,395,300,314,284,283,567,881,1181,1576,40.36,9.16,6.86,5.12
30-09-2021,MONFORTE,5,0,170,"[120,240]",Moderado,,,,5,Alentejo,PORTALEGRE,1211,42024.82,2975,139,115,117,192,168,360,477,592,731,7.08,1.74,1.41,1.14
30-09-2021,MONTALEGRE,25,2,281,"[240,480]",Elevado,,,,25,Norte,VILA REAL,1706,80545.71,8997,699,628,595,603,730,1333,1928,2556,3255,11.17,4.04,3.17,2.39
30-09-2021,MONTEMOR-O-NOVO,13,1,84,"[0,120]",Baixo a Moderado,,,,13,Alentejo,ÉVORA,0706,123296.65,15647,991,953,868,878,971,1849,2717,3670,4661,12.69,3.78,2.98,2.2
30-09-2021,MONTEMOR-O-VELHO,56,4,221,"[120,240]",Moderado,,,,56,Centro,COIMBRA,0610,22896.23,25224,1496,1397,1217,1057,988,2045,3262,4659,6155,110.17,26.88,20.35,14.25
30-09-2021,MONTIJO,48,3,83,"[0,120]",Baixo a Moderado,,,,48,Lisboa e Vale do Tejo,SETÚBAL,1507,34861.64,57614,2771,2441,1990,1554,1109,2663,4653,7094,9865,165.26,28.3,20.35,13.35
30-09-2021,MORA,1,0,25,"[0,120]",Baixo a Moderado,,,,1,Alentejo,ÉVORA,0707,44395.02,4138,336,275,252,238,257,495,747,1022,1358,9.32,3.06,2.3,1.68
30-09-2021,MORTÁGUA,5,0,57,"[0,120]",Baixo a Moderado,,,,5,Centro,VISEU,1808,25117.82,8803,638,584,535,499,460,959,1494,2078,2716,35.05,10.81,8.27,5.95
30-09-2021,MOURA,10,1,73,"[0,120]",Baixo a Moderado,,,,10,Alentejo,BEJA,0210,95845.55,13718,817,656,665,542,461,1003,1668,2324,3141,14.31,3.28,2.42,1.74
30-09-2021,MOURÃO,1,0,41,"[0,120]",Baixo a Moderado,,,,1,Alentejo,ÉVORA,0708,27862.98,2450,139,108,80,104,109,213,293,401,540,8.79,1.94,1.44,1.05
30-09-2021,MURÇA,1,0,19,"[0,120]",Baixo a Moderado,,,,1,Norte,VILA REAL,1707,18937.11,5463,384,341,307,306,319,625,932,1273,1657,28.85,8.75,6.72,4.92
30-09-2021,MURTOSA,2,0,19,"[0,120]",Baixo a Moderado,,,,2,Centro,AVEIRO,0112,7308.78,10279,509,473,403,353,409,762,1165,1638,2147,140.63,29.37,22.41,15.94
30-09-2021,NAZARÉ,60,4,421,"[240,480]",Elevado,,,,60,Lisboa e Vale do Tejo,LEIRIA,1011,8243.43,14165,967,903,670,420,396,816,1486,2389,3356,171.84,40.71,28.98,18.03
30-09-2021,NELAS,15,1,116,"[0,120]",Baixo a Moderado,,,,15,Centro,VISEU,1809,12571.48,12974,924,787,668,604,583,1187,1855,2642,3566,103.21,28.37,21.02,14.76
30-09-2021,NISA,4,0,67,"[0,120]",Baixo a Moderado,,,,4,Alentejo,PORTALEGRE,1212,57567.84,6061,405,389,355,483,478,961,1316,1705,2110,10.53,3.67,2.96,2.29
30-09-2021,NORDESTE,0,0,0,"[0,120]",Baixo a Moderado,,,,0,Açores,AÇORES,4202,10146.8,4862,246,180,124,161,162,323,447,627,873,47.92,8.6,6.18,4.41
30-09-2021,ÓBIDOS,19,1,158,"[120,240]",Moderado,,,,19,Lisboa e Vale do Tejo,LEIRIA,1012,14155.44,11850,743,650,574,452,436,888,1462,2112,2855,83.72,20.17,14.92,10.33
30-09-2021,ODEMIRA,8,1,32,"[0,120]",Baixo a Moderado,,,,8,Alentejo,BEJA,0211,172060.15,24717,1475,1317,1225,1397,1349,2746,3971,5288,6763,14.37,3.93,3.07,2.31
30-09-2021,ODIVELAS,150,11,93,"[0,120]",Baixo a Moderado,,,,150,Lisboa e Vale do Tejo,LISBOA,1116,2654.36,161774,9562,9038,6952,4641,3812,8453,15405,24443,34005,6095.48,1281.27,920.99,580.44
30-09-2021,OEIRAS,174,12,98,"[0,120]",Baixo a Moderado,,,,174,Lisboa e Vale do Tejo,LISBOA,1110,4588.31,177408,11580,11575,8566,6211,5855,12066,20632,32207,43787,3866.78,954.38,701.98,449.69
30-09-2021,OLEIROS,0,0,0,"[0,120]",Baixo a Moderado,,,,0,Centro,CASTELO BRANCO,0506,47109.31,5003,384,341,366,397,487,884,1250,1591,1975,10.62,4.19,3.38,2.65
30-09-2021,OLHÃO,44,3,100,"[0,120]",Baixo a Moderado,,,,44,Algarve,FARO,0810,13086.38,44405,2455,2309,1689,1342,1268,2610,4299,6608,9063,339.33,69.26,50.5,32.85
30-09-2021,OLIVEIRA DE AZEMÉIS,93,7,141,"[120,240]",Moderado,,,,93,Norte,AVEIRO,0113,16110.41,66011,4155,3614,2794,2183,1738,3921,6715,10329,14484,409.75,89.91,64.12,41.68
30-09-2021,OLIVEIRA DE FRADES,4,0,40,"[0,120]",Baixo a Moderado,,,,4,Centro,VISEU,1810,14534.62,9936,553,475,438,359,415,774,1212,1687,2240,68.36,15.41,11.61,8.34
30-09-2021,OLIVEIRA DO BAIRRO,11,1,45,"[0,120]",Baixo a Moderado,,,,11,Centro,AVEIRO,0114,8731.99,24277,1327,1182,999,786,810,1596,2595,3777,5104,278.02,58.45,43.25,29.72
30-09-2021,OLIVEIRA DO HOSPITAL,14,1,73,"[0,120]",Baixo a Moderado,,,,14,Centro,COIMBRA,0611,23451.66,19253,1161,1097,962,924,960,1884,2846,3943,5104,82.1,21.76,16.81,12.14
30-09-2021,OURÉM,52,4,119,"[0,120]",Baixo a Moderado,,,,52,Lisboa e Vale do Tejo,SANTARÉM,1421,41668.03,44044,2463,2069,1899,1817,1603,3420,5319,7388,9851,105.7,23.64,17.73,12.77
30-09-2021,OURIQUE,0,0,0,"[0,120]",Baixo a Moderado,,,,0,Alentejo,BEJA,0212,66331.36,4607,313,287,284,268,227,495,779,1066,1379,6.95,2.08,1.61,1.17
30-09-2021,OVAR,21,2,39,"[0,120]",Baixo a Moderado,,,,21,Centro,AVEIRO,0115,14770.25,54260,3294,2709,1994,1636,1234,2870,4864,7573,10867,367.37,73.57,51.27,32.93
30-09-2021,PAÇOS DE FERREIRA,20,1,35,"[0,120]",Baixo a Moderado,,,,20,Norte,PORTO,1309,7099.29,56728,2903,2193,1518,1135,664,1799,3317,5510,8413,799.1,118.51,77.62,46.72
30-09-2021,PALMELA,30,2,47,"[0,120]",Baixo a Moderado,,,,30,Lisboa e Vale do Tejo,SETÚBAL,1508,46512.01,64269,3402,3244,2635,1846,1391,3237,5872,9116,12518,138.18,26.91,19.6,12.62
30-09-2021,PAMPILHOSA DA SERRA,1,0,25,"[0,120]",Baixo a Moderado,,,,1,Centro,COIMBRA,0612,39646.24,4037,238,254,295,339,423,762,1057,1311,1549,10.18,3.91,3.31,2.67
30-09-2021,PAREDES,98,7,114,"[0,120]",Baixo a Moderado,,,,98,Norte,PORTO,1310,15675.69,86067,4272,3532,2412,1717,1258,2975,5387,8919,13191,549.04,84.15,56.9,34.36
30-09-2021,PAREDES DE COURA,9,1,106,"[0,120]",Baixo a Moderado,,,,9,Norte,VIANA DO CASTELO,1605,13818.59,8535,466,528,407,465,515,980,1387,1915,2381,61.76,17.23,13.86,10.04
30-09-2021,PEDRÓGÃO GRANDE,2,0,59,"[0,120]",Baixo a Moderado,,,,2,Centro,LEIRIA,1013,12874.75,3410,175,173,196,221,252,473,669,842,1017,26.49,7.9,6.54,5.2
30-09-2021,PENACOVA,6,0,44,"[0,120]",Baixo a Moderado,,,,6,Centro,COIMBRA,0613,21673.23,13694,968,923,745,621,703,1324,2069,2992,3960,63.18,18.27,13.81,9.55
30-09-2021,PENAFIEL,48,3,69,"[0,120]",Baixo a Moderado,,,,48,Norte,PORTO,1311,21224.27,69772,3648,2823,2032,1663,1230,2893,4925,7748,11396,328.74,53.69,36.51,23.2
30-09-2021,PENALVA DO CASTELO,11,1,154,"[120,240]",Moderado,,,,11,Centro,VISEU,1811,13433.92,7115,449,457,413,391,426,817,1230,1687,2136,52.96,15.9,12.56,9.16
30-09-2021,PENAMACOR,0,0,0,"[0,120]",Baixo a Moderado,,,,0,Centro,CASTELO BRANCO,0507,56370.69,4755,262,248,273,451,633,1084,1357,1605,1867,8.44,3.31,2.85,2.41
30-09-2021,PENEDONO,1,0,39,"[0,120]",Baixo a Moderado,,,,1,Norte,VISEU,1812,13370.75,2591,172,113,129,156,138,294,423,536,708,19.38,5.3,4.01,3.16
30-09-2021,PENELA,1,0,19,"[0,120]",Baixo a Moderado,,,,1,Centro,COIMBRA,0614,13480.0,5397,314,324,274,359,344,703,977,1301,1615,40.04,11.98,9.65,7.25
30-09-2021,PENICHE,13,1,49,"[0,120]",Baixo a Moderado,,,,13,Lisboa e Vale do Tejo,LEIRIA,1014,7754.98,26501,1746,1504,1203,926,707,1633,2836,4340,6086,341.73,78.48,55.96,36.57
30-09-2021,PESO DA RÉGUA,20,1,127,"[120,240]",Moderado,,,,20,Norte,VILA REAL,1708,9486.01,15773,1076,843,650,659,455,1114,1764,2607,3683,166.28,38.83,27.48,18.6
30-09-2021,PINHEL,14,1,166,"[120,240]",Moderado,,,,14,Centro,GUARDA,0910,48452.12,8511,577,566,551,538,689,1227,1778,2344,2921,17.57,6.03,4.84,3.67
30-09-2021,POMBAL,27,2,52,"[0,120]",Baixo a Moderado,,,,27,Centro,LEIRIA,1015,62600.28,51461,3187,2791,2494,2328,2027,4355,6849,9640,12827,82.21,20.49,15.4,10.94
30-09-2021,PONTA DELGADA,64,5,94,"[0,120]",Baixo a Moderado,,,,64,Açores,AÇORES,4203,23298.65,67935,3108,2435,1726,1133,902,2035,3761,6196,9304,291.58,39.93,26.59,16.14
30-09-2021,PONTA DO SOL,1,0,12,"[0,120]",Baixo a Moderado,,,,1,Madeira,MADEIRA,3105,4622.03,8593,319,283,347,208,221,429,776,1059,1378,185.92,29.81,22.91,16.79
30-09-2021,PONTE DA BARCA,4,0,36,"[0,120]",Baixo a Moderado,,,,4,Norte,VIANA DO CASTELO,1606,18211.37,11180,635,576,517,554,490,1044,1561,2137,2772,61.39,15.22,11.73,8.57
30-09-2021,PONTE DE LIMA,27,2,66,"[0,120]",Baixo a Moderado,,,,27,Norte,VIANA DO CASTELO,1607,32025.46,41315,2321,2022,1720,1596,1462,3058,4778,6800,9121,129.01,28.48,21.23,14.92
30-09-2021,PONTE DE SOR,7,1,47,"[0,120]",Baixo a Moderado,,,,7,Alentejo,PORTALEGRE,1213,83971.16,14994,939,800,716,739,831,1570,2286,3086,4025,17.86,4.79,3.68,2.72
30-09-2021,PORTALEGRE,9,1,41,"[0,120]",Baixo a Moderado,,,,9,Alentejo,PORTALEGRE,1214,44713.64,22172,1577,1351,1137,993,984,1977,3114,4465,6042,49.59,13.51,9.99,6.96
30-09-2021,PORTEL,8,1,139,"[120,240]",Moderado,,,,8,Alentejo,ÉVORA,0709,60100.57,5828,336,358,283,331,305,636,919,1277,1613,9.7,2.68,2.12,1.53
30-09-2021,PORTIMÃO,204,15,367,"[240,480]",Elevado,,,,204,Algarve,FARO,0811,18206.29,55483,3182,2927,2116,1582,1400,2982,5098,8025,11207,304.75,61.56,44.08,28.0
30-09-2021,PORTO,279,20,129,"[120,240]",Moderado,,,,279,Norte,PORTO,1312,4142.02,216606,15790,15193,11280,9409,10044,19453,30733,45926,61716,5229.5,1490.0,1108.79,741.98
30-09-2021,PORTO DE MÓS,7,0,30,"[0,120]",Baixo a Moderado,,,,7,Centro,LEIRIA,1016,26183.41,23275,1355,1210,1034,888,872,1760,2794,4004,5359,88.89,20.47,15.29,10.67
30-09-2021,PORTO MONIZ,4,0,173,"[120,240]",Moderado,,,,4,Madeira,MADEIRA,3106,8293.38,2342,143,130,95,98,120,218,313,443,586,28.24,7.07,5.34,3.77
30-09-2021,PORTO SANTO,0,0,0,"[0,120]",Baixo a Moderado,,,,0,Madeira,MADEIRA,3201,4300.7,5202,240,157,134,110,68,178,312,469,709,120.95,16.48,10.9,7.25
30-09-2021,PÓVOA DE LANHOSO,72,5,335,"[240,480]",Elevado,,,,72,Norte,BRAGA,0309,13465.29,21499,1175,909,732,673,624,1297,2029,2938,4113,159.67,30.55,21.82,15.07
30-09-2021,PÓVOA DE VARZIM,40,3,64,"[0,120]",Baixo a Moderado,,,,40,Norte,PORTO,1313,8220.59,62784,3712,3120,2134,1594,1305,2899,5033,8153,11865,763.7,144.33,99.17,61.22
30-09-2021,POVOAÇÃO,0,0,0,"[0,120]",Baixo a Moderado,,,,0,Açores,AÇORES,4204,10640.77,5927,293,212,191,144,134,278,469,681,974,55.7,9.15,6.4,4.41
30-09-2021,VILA DA PRAIA DA VITÓRIA,3,0,14,"[0,120]",Baixo a Moderado,,,,3,Açores,AÇORES,4302,16127.06,21317,1133,789,619,436,336,772,1391,2180,3313,132.18,20.54,13.52,8.63
30-09-2021,PROENÇA-A-NOVA,1,0,14,"[0,120]",Baixo a Moderado,,,,1,Centro,CASTELO BRANCO,0508,39539.96,7298,508,465,389,400,560,960,1349,1814,2322,18.46,5.87,4.59,3.41
30-09-2021,REDONDO,1,0,16,"[0,120]",Baixo a Moderado,,,,1,Alentejo,ÉVORA,0710,36950.87,6353,349,325,288,288,354,642,930,1255,1604,17.19,4.34,3.4,2.52
30-09-2021,REGUENGOS DE MONSARAZ,8,1,81,"[0,120]",Baixo a Moderado,,,,8,Alentejo,ÉVORA,0711,46399.72,10015,602,511,455,462,473,935,1390,1901,2503,21.58,5.39,4.1,3.0
30-09-2021,RESENDE,8,1,80,"[0,120]",Baixo a Moderado,,,,8,Norte,VISEU,1813,12334.93,10137,560,493,448,433,422,855,1303,1796,2356,82.18,19.1,14.56,10.56
30-09-2021,RIBEIRA BRAVA,8,1,65,"[0,120]",Baixo a Moderado,,,,8,Madeira,MADEIRA,3107,6544.88,12435,648,500,411,311,287,598,1009,1509,2157,189.99,32.96,23.06,15.42
30-09-2021,RIBEIRA DE PENA,5,0,84,"[0,120]",Baixo a Moderado,,,,5,Norte,VILA REAL,1709,21745.98,6016,371,301,290,310,368,678,968,1269,1640,27.66,7.54,5.84,4.45
30-09-2021,RIBEIRA GRANDE,44,3,134,"[120,240]",Moderado,,,,44,Açores,AÇORES,4205,18015.13,32811,1163,689,512,345,253,598,1110,1799,2962,182.13,16.44,9.99,6.16
30-09-2021,RIO MAIOR,44,3,217,"[120,240]",Moderado,,,,44,Lisboa e Vale do Tejo,SANTARÉM,1414,27276.45,20379,1251,1144,941,795,648,1443,2384,3528,4779,74.71,17.52,12.93,8.74
30-09-2021,SABROSA,3,0,51,"[0,120]",Baixo a Moderado,,,,3,Norte,VILA REAL,1710,15692.45,5918,393,314,304,302,350,652,956,1270,1663,37.71,10.6,8.09,6.09
30-09-2021,SABUGAL,5,0,48,"[0,120]",Baixo a Moderado,,,,5,Centro,GUARDA,0911,82269.82,10585,724,707,694,796,1009,1805,2499,3206,3930,12.87,4.78,3.9,3.04
30-09-2021,SALVATERRA DE MAGOS,8,1,38,"[0,120]",Baixo a Moderado,,,,8,Lisboa e Vale do Tejo,SANTARÉM,1415,24393.2,21295,1275,1181,1060,799,772,1571,2631,3812,5087,87.3,20.85,15.63,10.79
30-09-2021,SANTA COMBA DÃO,0,0,0,"[0,120]",Baixo a Moderado,,,,0,Centro,VISEU,1814,11194.77,10452,732,684,569,538,464,1002,1571,2255,2987,93.36,26.68,20.14,14.03
30-09-2021,SANTA CRUZ,25,2,55,"[0,120]",Baixo a Moderado,,,,25,Madeira,MADEIRA,3108,8150.28,45281,1817,1301,974,716,523,1239,2213,3514,5331,555.6,65.41,43.12,27.15
30-09-2021,SANTA CRUZ DA GRACIOSA,1,0,24,"[0,120]",Baixo a Moderado,,,,1,Açores,AÇORES,4401,6065.78,4208,228,180,163,124,145,269,432,612,840,69.37,13.85,10.09,7.12
30-09-2021,SANTA CRUZ DAS FLORES,0,0,0,"[0,120]",Baixo a Moderado,,,,0,Açores,AÇORES,4802,7091.44,2165,125,98,74,56,51,107,181,279,404,30.53,5.7,3.93,2.55
30-09-2021,SANTA MARIA DA FEIRA,79,6,57,"[0,120]",Baixo a Moderado,,,,79,Norte,AVEIRO,0109,21587.65,138636,8182,6743,4771,3856,3079,6935,11706,18449,26631,642.19,123.36,85.46,54.22
30-09-2021,SANTA MARTA DE PENAGUIÃO,7,1,107,"[0,120]",Baixo a Moderado,,,,7,Norte,VILA REAL,1711,6928.13,6599,483,373,337,316,317,633,970,1343,1826,95.25,26.36,19.39,14.0
30-09-2021,SANTANA,2,0,30,"[0,120]",Baixo a Moderado,,,,2,Madeira,MADEIRA,3109,9547.3,6711,418,353,343,282,277,559,902,1255,1673,70.29,17.52,13.15,9.45
30-09-2021,SANTARÉM,45,3,79,"[0,120]",Baixo a Moderado,,,,45,Lisboa e Vale do Tejo,SANTARÉM,1416,55253.58,57421,3654,3441,2760,2466,2206,4672,7432,10873,14527,103.92,26.29,19.68,13.45
30-09-2021,SANTIAGO DO CACÉM,6,0,21,"[0,120]",Baixo a Moderado,,,,6,Alentejo,SETÚBAL,1509,105969.29,28791,2144,1689,1472,1295,1215,2510,3982,5671,7815,27.17,7.37,5.35,3.76
30-09-2021,SANTO TIRSO,28,2,41,"[0,120]",Baixo a Moderado,,,,28,Norte,PORTO,1314,13655.52,68055,4911,3935,2761,2257,1810,4067,6828,10763,15674,498.35,114.78,78.82,50.0
30-09-2021,SÃO BRÁS DE ALPORTEL,12,1,116,"[0,120]",Baixo a Moderado,,,,12,Algarve,FARO,0812,15336.92,10416,596,468,467,404,401,805,1272,1740,2336,67.91,15.23,11.35,8.29
30-09-2021,SÃO JOÃO DA MADEIRA,29,2,131,"[120,240]",Moderado,,,,29,Norte,AVEIRO,0116,794.3,21958,1347,1069,796,601,593,1194,1990,3059,4406,2765.49,554.91,385.26,250.63
30-09-2021,SÃO JOÃO DA PESQUEIRA,2,0,28,"[0,120]",Baixo a Moderado,,,,2,Norte,VISEU,1815,26610.85,7125,417,330,294,328,328,656,950,1280,1697,26.77,6.38,4.81,3.57
30-09-2021,SÃO PEDRO DO SUL,26,2,169,"[120,240]",Moderado,,,,26,Centro,VISEU,1816,34895.09,15403,990,962,861,759,909,1668,2529,3491,4481,44.14,12.84,10.0,7.25
30-09-2021,SÃO ROQUE DO PICO,0,0,0,"[0,120]",Baixo a Moderado,,,,0,Açores,AÇORES,4603,14236.1,3266,199,141,93,96,113,209,302,443,642,22.94,4.51,3.11,2.12
30-09-2021,SÃO VICENTE,0,0,0,"[0,120]",Baixo a Moderado,,,,0,Madeira,MADEIRA,3110,7883.71,5143,272,264,266,225,280,505,771,1035,1307,65.23,16.58,13.13,9.78
30-09-2021,SARDOAL,0,0,0,"[0,120]",Baixo a Moderado,,,,0,Lisboa e Vale do Tejo,SANTARÉM,1417,9214.72,3741,227,178,148,165,248,413,561,739,966,40.6,10.48,8.02,6.09
30-09-2021,SÁTÃO,6,0,52,"[0,120]",Baixo a Moderado,,,,6,Centro,VISEU,1817,20194.11,11580,765,671,515,465,476,941,1456,2127,2892,57.34,14.32,10.53,7.21
30-09-2021,SEIA,15,1,68,"[0,120]",Baixo a Moderado,,,,15,Centro,GUARDA,0912,43568.83,22234,1807,1589,1238,1122,721,1843,3081,4670,6477,51.03,14.87,10.72,7.07
30-09-2021,SEIXAL,126,9,75,"[0,120]",Baixo a Moderado,,,,126,Lisboa e Vale do Tejo,SETÚBAL,1510,9545.17,167752,10586,9270,6661,4391,2930,7321,13982,23252,33838,1757.49,354.51,243.6,146.49
30-09-2021,SERNANCELHE,2,0,37,"[0,120]",Baixo a Moderado,,,,2,Norte,VISEU,1818,22861.22,5396,305,293,286,273,260,533,819,1112,1417,23.6,6.2,4.86,3.58
30-09-2021,SERPA,66,5,458,"[240,480]",Elevado,,,,66,Alentejo,BEJA,0213,110563.34,14304,903,761,719,697,626,1323,2042,2803,3706,12.94,3.35,2.54,1.85
30-09-2021,SERTÃ,39,3,268,"[240,480]",Elevado,,,,39,Centro,CASTELO BRANCO,0509,44673.17,14577,870,779,790,767,1020,1787,2577,3356,4226,32.63,9.46,7.51,5.77
30-09-2021,SESIMBRA,42,3,81,"[0,120]",Baixo a Moderado,,,,42,Lisboa e Vale do Tejo,SETÚBAL,1511,19571.75,51858,2400,2321,1853,1257,1083,2340,4193,6514,8914,264.96,45.54,33.28,21.42
30-09-2021,SETÚBAL,104,7,90,"[0,120]",Baixo a Moderado,,,,104,Lisboa e Vale do Tejo,SETÚBAL,1512,23032.5,115126,7425,6929,5075,3775,2655,6430,11505,18434,25859,499.83,112.27,80.03,49.95
30-09-2021,SEVER DO VOUGA,0,0,0,"[0,120]",Baixo a Moderado,,,,0,Centro,AVEIRO,0117,12987.56,11331,766,637,568,540,567,1107,1675,2312,3078,87.24,23.7,17.8,12.9
30-09-2021,SILVES,106,8,293,"[240,480]",Elevado,,,,106,Algarve,FARO,0813,68006.23,36226,2137,1869,1610,1423,1600,3023,4633,6502,8639,53.27,12.7,9.56,6.81
30-09-2021,SINES,14,1,102,"[0,120]",Baixo a Moderado,,,,14,Alentejo,SETÚBAL,1513,20330.17,13715,888,791,551,416,268,684,1235,2026,2914,67.46,14.33,9.97,6.07
30-09-2021,SINTRA,290,21,74,"[0,120]",Baixo a Moderado,,,,290,Lisboa e Vale do Tejo,LISBOA,1111,31922.73,391402,20490,18316,13545,9137,7284,16421,29966,48282,68772,1226.08,215.43,151.25,93.87
30-09-2021,SOBRAL DE MONTE AGRAÇO,15,1,138,"[120,240]",Moderado,,,,15,Lisboa e Vale do Tejo,LISBOA,1112,5210.32,10651,564,507,352,272,212,484,836,1343,1907,204.43,36.6,25.78,16.05
30-09-2021,SOURE,15,1,88,"[0,120]",Baixo a Moderado,,,,15,Centro,COIMBRA,0615,26506.07,17120,1173,1142,1004,883,987,1870,2874,4016,5189,64.59,19.58,15.15,10.84
30-09-2021,SOUSEL,1,0,23,"[0,120]",Baixo a Moderado,,,,1,Alentejo,PORTALEGRE,1215,27932.18,4412,261,274,208,302,292,594,802,1076,1337,15.8,4.79,3.85,2.87
30-09-2021,TÁBUA,4,0,35,"[0,120]",Baixo a Moderado,,,,4,Centro,COIMBRA,0616,19978.58,11368,729,584,524,430,464,894,1418,2002,2731,56.9,13.67,10.02,7.1
30-09-2021,TABUAÇO,0,0,0,"[0,120]",Baixo a Moderado,,,,0,Norte,VISEU,1819,13385.67,6033,372,314,217,282,363,645,862,1176,1548,45.07,11.56,8.79,6.44
30-09-2021,TAROUCA,7,1,90,"[0,120]",Baixo a Moderado,,,,7,Norte,VISEU,1820,10008.49,7804,405,335,313,277,324,601,914,1249,1654,77.98,16.53,12.48,9.13
30-09-2021,TAVIRA,26,2,107,"[0,120]",Baixo a Moderado,,,,26,Algarve,FARO,0814,60696.7,24530,1493,1415,1252,1066,1277,2343,3595,5010,6503,40.41,10.71,8.25,5.92
30-09-2021,TERRAS DE BOURO,2,0,32,"[0,120]",Baixo a Moderado,,,,2,Norte,BRAGA,0310,27746.07,6361,391,372,296,319,340,659,955,1327,1718,22.93,6.19,4.78,3.44
30-09-2021,TOMAR,35,2,95,"[0,120]",Baixo a Moderado,,,,35,Lisboa e Vale do Tejo,SANTARÉM,1418,35120.44,36748,2403,2189,1868,1853,1822,3675,5543,7732,10135,104.64,28.86,22.02,15.78
30-09-2021,TONDELA,13,1,49,"[0,120]",Baixo a Moderado,,,,13,Centro,VISEU,1821,37121.73,26357,1768,1722,1518,1475,1417,2892,4410,6132,7900,71.0,21.28,16.52,11.88
30-09-2021,TORRE DE MONCORVO,2,0,26,"[0,120]",Baixo a Moderado,,,,2,Norte,BRAGANÇA,0409,53155.67,7695,556,478,488,551,719,1270,1758,2236,2792,14.48,5.25,4.21,3.31
30-09-2021,TORRES NOVAS,30,2,85,"[0,120]",Baixo a Moderado,,,,30,Lisboa e Vale do Tejo,SANTARÉM,1419,26999.68,34933,2324,1979,1738,1406,1475,2881,4619,6598,8922,129.38,33.04,24.44,17.11
30-09-2021,TORRES VEDRAS,48,3,61,"[0,120]",Baixo a Moderado,,,,48,Lisboa e Vale do Tejo,LISBOA,1113,40714.89,78530,4513,3945,3447,2628,2104,4732,8179,12124,16637,192.88,40.86,29.78,20.09
30-09-2021,TRANCOSO,5,0,56,"[0,120]",Baixo a Moderado,,,,5,Centro,GUARDA,0913,36152.47,8875,581,557,542,586,496,1082,1624,2181,2762,24.55,7.64,6.03,4.49
30-09-2021,TROFA,28,2,73,"[0,120]",Baixo a Moderado,,,,28,Norte,PORTO,1318,7201.76,38418,2336,1894,1231,939,684,1623,2854,4748,7084,533.44,98.36,65.93,39.63
30-09-2021,VAGOS,7,0,30,"[0,120]",Baixo a Moderado,,,,7,Centro,AVEIRO,0118,16491.5,22740,1320,1205,922,784,724,1508,2430,3635,4955,137.89,30.04,22.04,14.73
30-09-2021,VALE DE CAMBRA,15,1,71,"[0,120]",Baixo a Moderado,,,,15,Norte,AVEIRO,0119,14733.47,21327,1491,1363,1005,831,798,1629,2634,3997,5488,144.76,37.25,27.13,17.88
30-09-2021,VALENÇA,11,1,83,"[0,120]",Baixo a Moderado,,,,11,Norte,VIANA DO CASTELO,1608,11712.86,13290,867,791,582,582,503,1085,1667,2458,3325,113.46,28.39,20.99,14.23
30-09-2021,VALONGO,45,3,46,"[0,120]",Baixo a Moderado,,,,45,Norte,PORTO,1315,7512.45,97444,5629,4696,3207,2462,1829,4291,7498,12194,17823,1297.18,237.26,162.33,99.81
30-09-2021,VALPAÇOS,41,3,280,"[240,480]",Elevado,,,,41,Norte,VILA REAL,1712,54873.93,14818,1217,1118,999,928,997,1925,2924,4042,5259,27.0,9.58,7.37,5.33
30-09-2021,VELAS,0,0,0,"[0,120]",Baixo a Moderado,,,,0,Açores,AÇORES,4502,11738.38,5093,278,208,166,153,113,266,432,640,918,43.39,7.82,5.45,3.68
30-09-2021,VENDAS NOVAS,2,0,18,"[0,120]",Baixo a Moderado,,,,2,Alentejo,ÉVORA,0712,22238.88,11255,677,768,655,501,532,1033,1688,2456,3133,50.61,14.09,11.04,7.59
30-09-2021,VIANA DO ALENTEJO,2,0,39,"[0,120]",Baixo a Moderado,,,,2,Alentejo,ÉVORA,0713,39367.29,5145,245,208,235,210,214,424,659,867,1112,13.07,2.82,2.2,1.67
30-09-2021,VIANA DO CASTELO,51,4,61,"[0,120]",Baixo a Moderado,,,,51,Norte,VIANA DO CASTELO,1609,31902.01,84417,5470,4433,3591,3061,2982,6043,9634,14067,19537,264.61,61.24,44.09,30.2
30-09-2021,VIDIGUEIRA,31,2,566,"[480,960]",Muito Elevado,,,,31,Alentejo,BEJA,0214,31661.09,5510,300,248,215,233,275,508,723,971,1271,17.4,4.01,3.07,2.28
30-09-2021,VIEIRA DO MINHO,10,1,85,"[0,120]",Baixo a Moderado,,,,10,Norte,BRAGA,0311,21644.35,11842,703,594,525,548,482,1030,1555,2149,2852,54.71,13.18,9.93,7.18
30-09-2021,VILA DE REI,0,0,0,"[0,120]",Baixo a Moderado,,,,0,Centro,CASTELO BRANCO,0510,19154.6,3323,169,128,172,247,302,549,721,849,1018,17.35,5.31,4.43,3.76
30-09-2021,VILA DO BISPO,7,1,136,"[120,240]",Moderado,,,,7,Algarve,FARO,0815,17906.06,5154,302,302,314,232,233,465,779,1081,1383,28.78,7.72,6.04,4.35
30-09-2021,VILA DO CONDE,58,4,73,"[0,120]",Baixo a Moderado,,,,58,Norte,PORTO,1316,14902.77,79899,4726,3875,2819,2070,1743,3813,6632,10507,15233,536.13,102.21,70.5,44.5
30-09-2021,VILA DO PORTO,0,0,0,"[0,120]",Baixo a Moderado,,,,0,Açores,AÇORES,4101,9688.74,5616,274,212,135,96,123,219,354,566,840,57.96,8.67,5.84,3.65
30-09-2021,VILA FLOR,2,0,33,"[0,120]",Baixo a Moderado,,,,2,Norte,BRAGANÇA,0410,26581.14,6044,429,362,422,294,331,625,1047,1409,1838,22.74,6.91,5.3,3.94
30-09-2021,VILA FRANCA DE XIRA,87,6,61,"[0,120]",Baixo a Moderado,,,,87,Lisboa e Vale do Tejo,LISBOA,1114,31819.39,141957,8501,6852,4869,3425,2472,5897,10766,17618,26119,446.14,82.09,55.37,33.84
30-09-2021,VILA FRANCA DO CAMPO,2,0,18,"[0,120]",Baixo a Moderado,,,,2,Açores,AÇORES,4206,7796.82,11051,450,344,248,217,154,371,619,963,1413,141.73,18.12,12.35,7.94
30-09-2021,VILA NOVA DA BARQUINHA,1,0,13,"[0,120]",Baixo a Moderado,,,,1,Lisboa e Vale do Tejo,SANTARÉM,1420,4952.97,7461,415,406,392,364,338,702,1094,1500,1915,150.64,38.66,30.28,22.09
30-09-2021,VILA NOVA DE CERVEIRA,5,0,56,"[0,120]",Baixo a Moderado,,,,5,Norte,VIANA DO CASTELO,1610,10846.66,8910,531,444,410,384,334,718,1128,1572,2103,82.14,19.39,14.49,10.4
30-09-2021,VILA NOVA DE FAMALICÃO,125,9,95,"[0,120]",Baixo a Moderado,,,,125,Norte,BRAGA,0312,20159.26,131676,7817,6164,4202,3282,2749,6031,10233,16397,24214,653.19,120.12,81.34,50.76
30-09-2021,VILA NOVA DE FOZ CÔA,22,2,343,"[240,480]",Elevado,,,,22,Centro,GUARDA,0914,39815.18,6503,442,385,390,398,429,827,1217,1602,2044,16.33,5.13,4.02,3.06
30-09-2021,VILA NOVA DE GAIA,222,16,74,"[0,120]",Baixo a Moderado,,,,222,Norte,PORTO,1317,16846.43,300472,18349,15568,10972,8224,6281,14505,25477,41045,59394,1783.64,352.57,243.65,151.23
30-09-2021,VILA NOVA DE PAIVA,0,0,0,"[0,120]",Baixo a Moderado,,,,0,Centro,VISEU,1822,17553.28,4687,289,272,233,217,241,458,691,963,1252,26.7,7.13,5.49,3.94
30-09-2021,VILA NOVA DE POIARES,4,0,57,"[0,120]",Baixo a Moderado,,,,4,Centro,COIMBRA,0617,8445.3,6939,380,284,262,235,182,417,679,963,1343,82.17,15.9,11.4,8.04
30-09-2021,VILA POUCA DE AGUIAR,20,1,169,"[120,240]",Moderado,,,,20,Norte,VILA REAL,1713,43706.62,11961,860,817,733,601,627,1228,1961,2778,3638,27.37,8.32,6.36,4.49
30-09-2021,VILA REAL,51,4,102,"[0,120]",Baixo a Moderado,,,,51,Norte,VILA REAL,1714,37880.28,49962,3025,2498,2065,1579,1466,3045,5110,7608,10633,131.9,28.07,20.08,13.49
30-09-2021,VILA REAL DE SANTO ANTÓNIO,15,1,80,"[0,120]",Baixo a Moderado,,,,15,Algarve,FARO,0816,6125.0,18749,1172,1069,811,569,586,1155,1966,3035,4207,306.11,68.69,49.55,32.1
30-09-2021,VILA VELHA DE RÓDÃO,1,0,32,"[0,120]",Baixo a Moderado,,,,1,Centro,CASTELO BRANCO,0511,32991.16,3144,209,229,180,283,306,589,769,998,1207,9.53,3.66,3.03,2.33
30-09-2021,VILA VERDE,28,2,60,"[0,120]",Baixo a Moderado,,,,28,Norte,BRAGA,0313,22866.52,46911,2365,2063,1667,1494,1437,2931,4598,6661,9026,205.15,39.47,29.13,20.11
30-09-2021,VILA VIÇOSA,2,0,26,"[0,120]",Baixo a Moderado,,,,2,Alentejo,ÉVORA,0714,19485.89,7656,487,379,342,345,324,669,1011,1390,1877,39.29,9.63,7.13,5.19
30-09-2021,VIMIOSO,0,0,0,"[0,120]",Baixo a Moderado,,,,0,Norte,BRAGANÇA,0411,48158.51,4023,274,230,261,293,335,628,889,1119,1393,8.35,2.89,2.32,1.85
30-09-2021,VINHAIS,1,0,13,"[0,120]",Baixo a Moderado,,,,1,Norte,BRAGANÇA,0412,69475.09,7746,599,577,636,641,815,1456,2092,2669,3268,11.15,4.7,3.84,3.01
30-09-2021,VISEU,86,6,88,"[0,120]",Baixo a Moderado,,,,86,Centro,VISEU,1823,50710.14,97249,5769,5038,4140,3158,2710,5868,10008,15046,20815,191.77,41.05,29.67,19.74
30-09-2021,VIZELA,19,1,80,"[0,120]",Baixo a Moderado,,,,19,Norte,BRAGA,0314,2469.83,23897,1258,928,655,509,371,880,1535,2463,3721,967.49,150.65,99.72,62.15
30-09-2021,VOUZELA,8,1,83,"[0,120]",Baixo a Moderado,,,,8,Centro,VISEU,1824,19369.46,9619,626,605,554,532,507,1039,1593,2198,2824,49.66,14.58,11.35,8.22
07-10-2021,ABRANTES,30,2,86,"[0,120]",Baixo a Moderado,,,,30,Lisboa e Vale do Tejo,SANTARÉM,1401,71469.08,35130,2473,2213,1730,1748,2021,3769,5499,7712,10185,49.15,14.25,10.79,7.69
07-10-2021,ÁGUEDA,14,1,30,"[0,120]",Baixo a Moderado,,,,14,Centro,AVEIRO,0101,33527.44,46075,3237,2713,2090,1635,1496,3131,5221,7934,11171,137.43,33.32,23.66,15.57
07-10-2021,AGUIAR DA BEIRA,5,0,108,"[0,120]",Baixo a Moderado,,,,5,Centro,GUARDA,0901,20676.57,4652,304,281,235,239,148,387,622,903,1207,22.5,5.84,4.37,3.01
07-10-2021,ALANDROAL,2,0,41,"[0,120]",Baixo a Moderado,,,,2,Alentejo,ÉVORA,0701,54267.81,4992,307,256,296,299,377,676,972,1228,1535,9.2,2.83,2.26,1.79
07-10-2021,ALBERGARIA-A-VELHA,6,0,25,"[0,120]",Baixo a Moderado,,,,6,Centro,AVEIRO,0102,15882.5,24144,1550,1298,996,687,680,1367,2363,3661,5211,152.02,32.81,23.05,14.88
07-10-2021,ALBUFEIRA,119,8,286,"[240,480]",Elevado,,,,119,Algarve,FARO,0801,14066.42,41528,2067,1717,1425,985,858,1843,3268,4985,7052,295.24,50.14,35.44,23.23
07-10-2021,ALCÁCER DO SAL,9,1,78,"[0,120]",Baixo a Moderado,,,,9,Alentejo,SETÚBAL,1501,149987.3,11659,884,814,623,623,602,1225,1848,2662,3546,7.77,2.36,1.77,1.23
07-10-2021,ALCANENA,2,0,16,"[0,120]",Baixo a Moderado,,,,2,Lisboa e Vale do Tejo,SANTARÉM,1402,12732.86,12809,891,744,628,536,588,1124,1752,2496,3387,100.6,26.6,19.6,13.76
07-10-2021,ALCOBAÇA,72,5,134,"[120,240]",Moderado,,,,72,Lisboa e Vale do Tejo,LEIRIA,1001,40814.09,53555,3420,2927,2466,2059,1676,3735,6201,9128,12548,131.22,30.74,22.36,15.19
07-10-2021,ALCOCHETE,4,0,20,"[0,120]",Baixo a Moderado,,,,4,Lisboa e Vale do Tejo,SETÚBAL,1502,12836.48,19787,857,834,691,476,447,923,1614,2448,3305,154.15,25.75,19.07,12.57
07-10-2021,ALCOUTIM,15,1,674,"[480,960]",Muito Elevado,,,,15,Algarve,FARO,0802,57536.33,2159,191,188,163,190,267,457,620,808,999,3.75,1.74,1.4,1.08
07-10-2021,ALENQUER,18,1,40,"[0,120]",Baixo a Moderado,,,,18,Lisboa e Vale do Tejo,LISBOA,1101,30421.92,44052,2298,2062,1629,1330,1155,2485,4114,6176,8474,144.8,27.85,20.3,13.52
07-10-2021,ALFÂNDEGA DA FÉ,1,0,22,"[0,120]",Baixo a Moderado,,,,1,Norte,BRAGANÇA,0401,32194.64,4550,325,277,301,274,325,599,900,1177,1502,14.13,4.67,3.66,2.8
07-10-2021,ALIJÓ,29,2,275,"[240,480]",Elevado,,,,29,Norte,VILA REAL,1701,29759.89,10625,766,687,635,542,666,1208,1843,2530,3296,35.7,11.08,8.5,6.19
07-10-2021,ALJEZUR,5,0,89,"[0,120]",Baixo a Moderado,,,,5,Algarve,FARO,0803,32349.95,5594,316,336,335,320,410,730,1065,1401,1717,17.29,5.31,4.33,3.29
07-10-2021,ALJUSTREL,10,1,123,"[120,240]",Moderado,,,,10,Alentejo,BEJA,0201,45847.41,8247,635,521,443,347,358,705,1148,1669,2304,17.99,5.03,3.64,2.5
07-10-2021,ALMADA,103,7,61,"[0,120]",Baixo a Moderado,,,,103,Lisboa e Vale do Tejo,SETÚBAL,1503,7000.89,169039,10469,9777,7876,6144,5111,11255,19131,28908,39377,2414.5,562.45,412.91,273.26
07-10-2021,ALMEIDA,0,0,0,"[0,120]",Baixo a Moderado,,,,0,Centro,GUARDA,0902,51798.46,5830,441,419,396,458,393,851,1247,1666,2107,11.26,4.07,3.22,2.41
07-10-2021,ALMEIRIM,46,3,205,"[120,240]",Moderado,,,,46,Lisboa e Vale do Tejo,SANTARÉM,1403,22212.05,22546,1342,1353,1106,866,843,1709,2815,4168,5510,101.5,24.81,18.76,12.67
07-10-2021,ALMODÔVAR,5,0,75,"[0,120]",Baixo a Moderado,,,,5,Alentejo,BEJA,0202,77788.03,6725,414,443,396,373,328,701,1097,1540,1954,8.65,2.51,1.98,1.41
07-10-2021,ALPIARÇA,7,1,100,"[0,120]",Baixo a Moderado,,,,7,Lisboa e Vale do Tejo,SANTARÉM,1404,9536.33,7059,515,486,363,333,274,607,970,1456,1971,74.02,20.67,15.27,10.17
07-10-2021,ALTER DO CHÃO,4,0,128,"[120,240]",Moderado,,,,4,Alentejo,PORTALEGRE,1201,36206.62,3165,201,163,136,208,187,395,531,694,895,8.74,2.47,1.92,1.47
07-10-2021,ALVAIÁZERE,1,0,15,"[0,120]",Baixo a Moderado,,,,1,Centro,LEIRIA,1002,16047.76,6597,419,389,346,406,539,945,1291,1680,2099,41.11,13.08,10.47,8.04
07-10-2021,ALVITO,59,4,2391,"[960,Max]",Extremamente Elevado,,,,59,Alentejo,BEJA,0203,26485.32,2477,145,110,105,111,89,200,305,415,560,9.35,2.11,1.57,1.15
07-10-2021,AMADORA,109,8,59,"[0,120]",Baixo a Moderado,,,,109,Lisboa e Vale do Tejo,LISBOA,1115,2378.47,184106,11186,10936,8780,6460,5890,12350,21130,32066,43252,7742.05,1818.84,1348.44,888.56
07-10-2021,AMARANTE,26,2,49,"[0,120]",Baixo a Moderado,,,,26,Norte,PORTO,1301,30133.15,53193,3086,2413,1812,1643,1311,2954,4766,7179,10265,176.53,34.07,23.82,15.82
07-10-2021,AMARES,22,2,122,"[120,240]",Moderado,,,,22,Norte,BRAGA,0301,8195.41,18129,1001,829,622,489,524,1013,1635,2464,3465,221.22,42.28,30.07,19.95
07-10-2021,ANADIA,11,1,40,"[0,120]",Baixo a Moderado,,,,11,Centro,AVEIRO,0103,21663.48,27258,1931,1698,1376,1208,1262,2470,3846,5544,7475,125.83,34.51,25.59,17.75
07-10-2021,ANGRA DO HEROÍSMO,5,0,15,"[0,120]",Baixo a Moderado,,,,5,Açores,AÇORES,4301,23899.66,33807,2006,1473,1122,768,635,1403,2525,3998,6004,141.45,25.12,16.73,10.56
07-10-2021,ANSIÃO,3,0,25,"[0,120]",Baixo a Moderado,,,,3,Centro,LEIRIA,1003,17609.42,12039,727,709,646,694,530,1224,1870,2579,3306,68.37,18.77,14.65,10.62
07-10-2021,ARCOS DE VALDEVEZ,24,2,115,"[0,120]",Baixo a Moderado,,,,24,Norte,VIANA DO CASTELO,1601,44759.64,20926,1329,1338,1282,1343,1515,2858,4140,5478,6807,46.75,15.21,12.24,9.25
07-10-2021,ARGANIL,90,6,819,"[480,960]",Muito Elevado,,,,90,Centro,COIMBRA,0601,33283.93,11014,672,648,612,559,596,1155,1767,2415,3087,33.09,9.27,7.26,5.31
07-10-2021,ARMAMAR,0,0,0,"[0,120]",Baixo a Moderado,,,,0,Norte,VISEU,1801,11723.73,5769,357,305,309,285,310,595,904,1209,1566,49.21,13.36,10.31,7.71
07-10-2021,AROUCA,88,6,427,"[240,480]",Elevado,,,,88,Norte,AVEIRO,0104,32910.52,20720,1306,1047,753,683,683,1366,2119,3166,4472,62.96,13.59,9.62,6.44
07-10-2021,ARRAIOLOS,0,0,0,"[0,120]",Baixo a Moderado,,,,0,Alentejo,ÉVORA,0702,68374.55,6928,435,384,283,367,480,847,1130,1514,1949,10.13,2.85,2.21,1.65
07-10-2021,ARRONCHES,0,0,0,"[0,120]",Baixo a Moderado,,,,0,Alentejo,PORTALEGRE,1202,31464.72,2820,155,142,162,187,179,366,528,670,825,8.96,2.62,2.13,1.68
07-10-2021,ARRUDA DOS VINHOS,4,0,25,"[0,120]",Baixo a Moderado,,,,4,Lisboa e Vale do Tejo,LISBOA,1102,7795.93,15412,738,738,562,509,438,947,1509,2247,2985,197.69,38.29,28.82,19.36
07-10-2021,AVEIRO,61,4,78,"[0,120]",Baixo a Moderado,,,,61,Centro,AVEIRO,0105,19757.57,78734,4520,4004,3050,2250,2103,4353,7403,11407,15927,398.49,80.61,57.73,37.47
07-10-2021,AVIS,0,0,0,"[0,120]",Baixo a Moderado,,,,0,Alentejo,PORTALEGRE,1203,60596.51,4247,315,225,206,251,273,524,730,955,1270,7.01,2.1,1.58,1.2
07-10-2021,AZAMBUJA,22,2,96,"[0,120]",Baixo a Moderado,,,,22,Lisboa e Vale do Tejo,LISBOA,1103,26265.65,22716,1322,1171,1070,798,618,1416,2486,3657,4979,86.48,18.96,13.92,9.46
07-10-2021,BAIÃO,11,1,59,"[0,120]",Baixo a Moderado,,,,11,Norte,PORTO,1302,17452.83,18748,1070,862,714,686,725,1411,2125,2987,4057,107.42,23.25,17.11,12.18
07-10-2021,BARCELOS,48,3,41,"[0,120]",Baixo a Moderado,,,,48,Norte,BRAGA,0302,37890.14,116187,6721,5325,3619,2991,2562,5553,9172,14497,21218,306.64,56.0,38.26,24.21
07-10-2021,BARRANCOS,7,1,431,"[240,480]",Elevado,,,,7,Alentejo,BEJA,0204,16841.73,1634,90,65,65,94,61,155,220,285,375,9.7,2.23,1.69,1.31
07-10-2021,BARREIRO,29,2,39,"[0,120]",Baixo a Moderado,,,,29,Lisboa e Vale do Tejo,SETÚBAL,1504,3639.07,75147,5194,5565,4459,3105,1767,4872,9331,14896,20090,2065.05,552.07,409.34,256.42
07-10-2021,BATALHA,7,0,43,"[0,120]",Baixo a Moderado,,,,7,Centro,LEIRIA,1004,10341.6,15963,873,762,649,529,549,1078,1727,2489,3362,154.35,32.51,24.07,16.7
07-10-2021,BEJA,174,12,519,"[480,960]",Muito Elevado,,,,174,Alentejo,BEJA,0205,114647.55,33579,2005,1840,1386,1272,1039,2311,3697,5537,7542,29.29,6.58,4.83,3.22
07-10-2021,BELMONTE,2,0,31,"[0,120]",Baixo a Moderado,,,,2,Centro,CASTELO BRANCO,0501,11875.91,6398,444,321,325,310,355,665,990,1311,1755,53.87,14.78,11.04,8.34
07-10-2021,BENAVENTE,22,2,72,"[0,120]",Baixo a Moderado,,,,22,Lisboa e Vale do Tejo,SANTARÉM,1405,52138.39,30602,1468,1376,1141,876,643,1519,2660,4036,5504,58.69,10.56,7.74,5.1
07-10-2021,BOMBARRAL,30,2,237,"[120,240]",Moderado,,,,30,Lisboa e Vale do Tejo,LEIRIA,1005,9128.55,12558,875,714,561,491,429,920,1481,2195,3070,137.56,33.63,24.04,16.22
07-10-2021,BORBA,0,0,0,"[0,120]",Baixo a Moderado,,,,0,Alentejo,ÉVORA,0703,14518.65,6736,430,375,279,436,392,828,1107,1482,1912,46.39,13.17,10.21,7.62
07-10-2021,BOTICAS,4,0,81,"[0,120]",Baixo a Moderado,,,,4,Norte,VILA REAL,1702,32195.66,4998,347,306,311,305,380,685,996,1302,1649,15.52,5.12,4.04,3.09
07-10-2021,BRAGA,195,14,107,"[0,120]",Baixo a Moderado,,,,195,Norte,BRAGA,0303,18339.95,182679,10029,7963,5241,4320,3671,7991,13232,21195,31224,996.07,170.25,115.57,72.15
07-10-2021,BRAGANÇA,17,1,51,"[0,120]",Baixo a Moderado,,,,17,Norte,BRAGANÇA,0402,117357.27,33607,2402,1855,1652,1393,1163,2556,4208,6063,8465,28.64,7.21,5.17,3.59
07-10-2021,CABECEIRAS DE BASTO,14,1,90,"[0,120]",Baixo a Moderado,,,,14,Norte,BRAGA,0304,24182.16,15628,774,594,544,575,574,1149,1693,2287,3061,64.63,12.66,9.46,7.0
07-10-2021,CADAVAL,4,0,29,"[0,120]",Baixo a Moderado,,,,4,Lisboa e Vale do Tejo,LISBOA,1104,17489.3,13673,813,796,756,621,625,1246,2002,2798,3611,78.18,20.65,16.0,11.45
07-10-2021,CALDAS DA RAINHA,50,4,97,"[0,120]",Baixo a Moderado,,,,50,Lisboa e Vale do Tejo,LEIRIA,1006,25569.47,51912,3035,2684,2186,1899,1705,3604,5790,8474,11509,203.03,45.01,33.14,22.64
07-10-2021,CALHETA,5,0,46,"[0,120]",Baixo a Moderado,,,,5,Madeira,MADEIRA,3101,11150.43,10867,576,497,507,399,415,814,1321,1818,2394,97.46,21.47,16.3,11.85
07-10-2021,CALHETA (AÇORES),0,0,0,"[0,120]",Baixo a Moderado,,,,0,Açores,AÇORES,4501,12626.4,3184,215,159,141,139,122,261,402,561,776,25.22,6.15,4.44,3.18
07-10-2021,CÂMARA DE LOBOS,16,1,48,"[0,120]",Baixo a Moderado,,,,16,Madeira,MADEIRA,3102,5216.67,33675,1396,1059,834,545,381,926,1760,2819,4215,645.49,80.79,54.03,33.74
07-10-2021,CAMINHA,17,1,108,"[0,120]",Baixo a Moderado,,,,17,Norte,VIANA DO CASTELO,1602,13652.14,15877,1046,944,818,646,656,1302,2120,3064,4110,116.3,30.11,22.44,15.53
07-10-2021,CAMPO MAIOR,16,1,205,"[120,240]",Moderado,,,,16,Alentejo,PORTALEGRE,1204,24720.16,7874,471,364,351,279,327,606,957,1321,1792,31.85,7.25,5.34,3.87
07-10-2021,CANTANHEDE,26,2,74,"[0,120]",Baixo a Moderado,,,,26,Centro,COIMBRA,0602,39088.02,35011,2346,2096,1880,1709,1451,3160,5040,7136,9482,89.57,24.26,18.26,12.89
07-10-2021,CARRAZEDA DE ANSIÃES,0,0,0,"[0,120]",Baixo a Moderado,,,,0,Norte,BRAGANÇA,0403,27924.09,5666,424,389,391,312,465,777,1168,1557,1981,20.29,7.09,5.58,4.18
07-10-2021,CARREGAL DO SAL,4,0,43,"[0,120]",Baixo a Moderado,,,,4,Centro,VISEU,1802,11689.21,9271,587,562,486,462,376,838,1324,1886,2473,79.31,21.16,16.13,11.33
07-10-2021,CARTAXO,7,0,29,"[0,120]",Baixo a Moderado,,,,7,Lisboa e Vale do Tejo,SANTARÉM,1406,15817.28,23843,1415,1376,1142,861,632,1493,2635,4011,5426,150.74,34.3,25.36,16.66
07-10-2021,CASCAIS,147,11,69,"[0,120]",Baixo a Moderado,,,,147,Lisboa e Vale do Tejo,LISBOA,1105,9740.17,213608,12151,11444,8680,6469,5248,11717,20397,31841,43992,2193.1,451.66,326.91,209.41
07-10-2021,CASTANHEIRA DE PÊRA,2,0,78,"[0,120]",Baixo a Moderado,,,,2,Centro,LEIRIA,1007,6677.45,2614,233,195,157,190,187,377,534,729,962,39.15,14.41,10.92,8.0
07-10-2021,CASTELO BRANCO,206,15,396,"[240,480]",Elevado,,,,206,Centro,CASTELO BRANCO,0502,143819.15,51987,3528,3042,2499,2229,2225,4454,6953,9995,13523,36.15,9.4,6.95,4.83
07-10-2021,CASTELO DE PAIVA,1,0,7,"[0,120]",Baixo a Moderado,,,,1,Norte,AVEIRO,0106,11500.53,15454,881,697,545,420,431,851,1396,2093,2974,134.37,25.86,18.2,12.14
07-10-2021,CASTELO DE VIDE,1,0,35,"[0,120]",Baixo a Moderado,,,,1,Alentejo,PORTALEGRE,1205,26491.24,2919,204,173,179,147,170,317,496,669,873,11.02,3.3,2.53,1.87
07-10-2021,CASTRO DAIRE,11,1,80,"[0,120]",Baixo a Moderado,,,,11,Centro,VISEU,1803,37904.13,13823,942,857,765,732,773,1505,2270,3127,4069,36.47,10.74,8.25,5.99
07-10-2021,CASTRO MARIM,2,0,32,"[0,120]",Baixo a Moderado,,,,2,Algarve,FARO,0804,30084.37,6237,370,345,334,322,344,666,1000,1345,1715,20.73,5.7,4.47,3.32
07-10-2021,CASTRO VERDE,5,0,73,"[0,120]",Baixo a Moderado,,,,5,Alentejo,BEJA,0206,56944.23,6949,437,347,303,275,227,502,805,1152,1589,12.2,2.79,2.02,1.41
07-10-2021,CELORICO DA BEIRA,1,0,14,"[0,120]",Baixo a Moderado,,,,1,Centro,GUARDA,0903,24721.63,6928,430,416,363,369,535,904,1267,1683,2113,28.02,8.55,6.81,5.12
07-10-2021,CELORICO DE BASTO,8,1,42,"[0,120]",Baixo a Moderado,,,,8,Norte,BRAGA,0305,18107.02,19040,1001,802,668,728,729,1457,2125,2927,3928,105.15,21.69,16.17,11.74
07-10-2021,CHAMUSCA,3,0,33,"[0,120]",Baixo a Moderado,,,,3,Lisboa e Vale do Tejo,SANTARÉM,1407,74600.54,9197,629,583,553,465,579,1044,1597,2180,2809,12.33,3.77,2.92,2.14
07-10-2021,CHAVES,18,1,46,"[0,120]",Baixo a Moderado,,,,18,Norte,VILA REAL,1703,59122.95,39343,2676,2429,1991,1886,1918,3804,5795,8224,10900,66.54,18.44,13.91,9.8
07-10-2021,CINFÃES,24,2,133,"[120,240]",Moderado,,,,24,Norte,VISEU,1804,23928.76,18244,1067,902,779,734,758,1492,2271,3173,4240,76.24,17.72,13.26,9.49
07-10-2021,COIMBRA,58,4,43,"[0,120]",Baixo a Moderado,,,,58,Centro,COIMBRA,0603,31939.94,134166,9489,8734,6353,5139,5074,10213,16566,25300,34789,420.06,108.92,79.21,51.87
07-10-2021,CONDEIXA-A-NOVA,6,0,34,"[0,120]",Baixo a Moderado,,,,6,Centro,COIMBRA,0604,13867.47,17733,871,809,717,583,490,1073,1790,2599,3470,127.88,25.02,18.74,12.91
07-10-2021,CONSTÂNCIA,0,0,0,"[0,120]",Baixo a Moderado,,,,0,Lisboa e Vale do Tejo,SANTARÉM,1408,8036.58,4030,211,183,187,148,155,303,490,673,884,50.14,11.0,8.37,6.1
07-10-2021,CORUCHE,14,1,81,"[0,120]",Baixo a Moderado,,,,14,Lisboa e Vale do Tejo,SANTARÉM,1409,111572.03,17471,1294,1090,1095,1096,1019,2115,3210,4300,5594,15.66,5.01,3.85,2.88
07-10-2021,CORVO,0,0,0,"[0,120]",Baixo a Moderado,,,,0,Açores,AÇORES,4901,1711.45,464,22,21,11,13,19,32,43,64,86,27.12,5.03,3.74,2.51
07-10-2021,COVILHÃ,59,4,126,"[120,240]",Moderado,,,,59,Centro,CASTELO BRANCO,0503,55560.06,46787,3533,2998,2365,2111,2193,4304,6669,9667,13200,84.21,23.76,17.4,12.0
07-10-2021,CRATO,0,0,0,"[0,120]",Baixo a Moderado,,,,0,Alentejo,PORTALEGRE,1206,39806.88,3129,229,258,163,182,228,410,573,831,1060,7.86,2.66,2.09,1.44
07-10-2021,CUBA,44,3,968,"[960,Max]",Extremamente Elevado,,,,44,Alentejo,BEJA,0207,17208.72,4595,255,233,206,190,143,333,539,772,1027,26.7,5.97,4.49,3.13
07-10-2021,ELVAS,16,1,79,"[0,120]",Baixo a Moderado,,,,16,Alentejo,PORTALEGRE,1207,63128.86,20528,1057,1145,902,852,810,1662,2564,3709,4766,32.52,7.55,5.88,4.06
07-10-2021,ENTRONCAMENTO,16,1,73,"[0,120]",Baixo a Moderado,,,,16,Lisboa e Vale do Tejo,SANTARÉM,1410,1372.81,21558,1066,930,868,695,592,1287,2155,3085,4151,1570.14,302.33,224.69,156.96
07-10-2021,ESPINHO,6,0,20,"[0,120]",Baixo a Moderado,,,,6,Norte,AVEIRO,0107,2105.68,29516,2205,1993,1430,1177,960,2137,3567,5560,7765,1401.52,368.71,264.01,169.37
07-10-2021,ESPOSENDE,49,3,143,"[120,240]",Moderado,,,,49,Norte,BRAGA,0306,9540.98,34177,1831,1522,1095,894,723,1617,2712,4234,6065,358.21,63.57,44.38,28.42
07-10-2021,ESTARREJA,6,0,23,"[0,120]",Baixo a Moderado,,,,6,Centro,AVEIRO,0108,10817.33,26006,1503,1399,1106,953,728,1681,2787,4186,5689,240.42,52.59,38.7,25.76
07-10-2021,ESTREMOZ,22,2,175,"[120,240]",Moderado,,,,22,Alentejo,ÉVORA,0704,51379.95,12728,789,613,697,786,877,1663,2360,2973,3762,24.77,7.32,5.79,4.59
07-10-2021,ÉVORA,33,2,63,"[0,120]",Baixo a Moderado,,,,33,Alentejo,ÉVORA,0705,130707.58,52428,3569,2852,2176,1966,1803,3769,5945,8797,12366,40.11,9.46,6.73,4.55
07-10-2021,FAFE,50,4,105,"[0,120]",Baixo a Moderado,,,,50,Norte,BRAGA,0307,21908.11,48060,3044,2455,1679,1403,1208,2611,4290,6745,9789,219.37,44.68,30.79,19.58
07-10-2021,FARO,45,3,74,"[0,120]",Baixo a Moderado,,,,45,Algarve,FARO,0805,20256.79,61015,3847,3364,2604,2055,1601,3656,6260,9624,13471,301.2,66.5,47.51,30.9
07-10-2021,FELGUEIRAS,25,2,45,"[0,120]",Baixo a Moderado,,,,25,Norte,PORTO,1303,11573.75,56422,2951,2302,1601,1316,973,2289,3890,6192,9143,487.49,79.0,53.5,33.61
07-10-2021,FERREIRA DO ALENTEJO,47,3,602,"[480,960]",Muito Elevado,,,,47,Alentejo,BEJA,0208,64820.68,7845,515,414,372,343,345,688,1060,1474,1989,12.1,3.07,2.27,1.64
07-10-2021,FERREIRA DO ZÊZERE,4,0,50,"[0,120]",Baixo a Moderado,,,,4,Lisboa e Vale do Tejo,SANTARÉM,1411,19038.03,7959,470,370,416,465,456,921,1337,1707,2177,41.81,11.44,8.97,7.02
07-10-2021,FIGUEIRA DA FOZ,56,4,95,"[0,120]",Baixo a Moderado,,,,56,Centro,COIMBRA,0605,37905.26,58747,4032,3597,2887,2495,2043,4538,7425,11022,15054,154.98,39.72,29.08,19.59
07-10-2021,FIGUEIRA DE CASTELO RODRIGO,4,0,72,"[0,120]",Baixo a Moderado,,,,4,Centro,GUARDA,0904,50857.46,5584,347,352,290,352,391,743,1033,1385,1732,10.98,3.41,2.72,2.03
07-10-2021,FIGUEIRÓ DOS VINHOS,0,0,0,"[0,120]",Baixo a Moderado,,,,0,Centro,LEIRIA,1008,17344.0,5568,402,386,322,309,351,660,982,1368,1770,32.1,10.21,7.89,5.66
07-10-2021,FORNOS DE ALGODRES,2,0,44,"[0,120]",Baixo a Moderado,,,,2,Centro,GUARDA,0905,13145.05,4528,261,218,247,256,232,488,735,953,1214,34.45,9.24,7.25,5.59
07-10-2021,FREIXO DE ESPADA À CINTA,0,0,0,"[0,120]",Baixo a Moderado,,,,0,Norte,BRAGANÇA,0404,24414.29,3298,211,177,231,196,189,385,616,793,1004,13.51,4.11,3.25,2.52
07-10-2021,FRONTEIRA,0,0,0,"[0,120]",Baixo a Moderado,,,,0,Alentejo,PORTALEGRE,1208,24859.58,2974,213,182,149,156,168,324,473,655,868,11.96,3.49,2.63,1.9
07-10-2021,FUNCHAL,117,8,112,"[0,120]",Baixo a Moderado,,,,117,Madeira,MADEIRA,3103,7616.2,104024,6382,5086,3643,2821,1990,4811,8454,13540,19922,1365.86,261.58,177.78,111.0
07-10-2021,FUNDÃO,19,1,72,"[0,120]",Baixo a Moderado,,,,19,Centro,CASTELO BRANCO,0504,70019.79,26495,1781,1464,1432,1357,1643,3000,4432,5896,7677,37.84,10.96,8.42,6.33
07-10-2021,GAVIÃO,0,0,0,"[0,120]",Baixo a Moderado,,,,0,Alentejo,PORTALEGRE,1209,29459.45,3263,189,186,222,263,293,556,778,964,1153,11.08,3.91,3.27,2.64
07-10-2021,GÓIS,2,0,53,"[0,120]",Baixo a Moderado,,,,2,Centro,COIMBRA,0606,26330.19,3805,235,199,240,233,244,477,717,916,1151,14.45,4.37,3.48,2.72
07-10-2021,GOLEGÃ,1,0,19,"[0,120]",Baixo a Moderado,,,,1,Lisboa e Vale do Tejo,SANTARÉM,1412,8431.67,5339,356,299,281,243,255,498,779,1078,1434,63.32,17.01,12.78,9.24
07-10-2021,GONDOMAR,85,6,51,"[0,120]",Baixo a Moderado,,,,85,Norte,PORTO,1304,13191.76,165985,10555,8755,6222,4450,3364,7814,14036,22791,33346,1258.22,252.77,172.76,106.4
07-10-2021,GOUVEIA,3,0,24,"[0,120]",Baixo a Moderado,,,,3,Centro,GUARDA,0906,30061.17,12387,871,931,780,783,810,1593,2373,3304,4175,41.21,13.89,10.99,7.89
07-10-2021,GRÂNDOLA,24,2,164,"[120,240]",Moderado,,,,24,Alentejo,SETÚBAL,1505,82593.66,14639,834,834,708,688,672,1360,2068,2902,3736,17.72,4.52,3.51,2.5
07-10-2021,GUARDA,23,2,59,"[0,120]",Baixo a Moderado,,,,23,Centro,GUARDA,0907,71209.58,38969,2477,2041,1686,1415,1474,2889,4575,6616,9093,54.72,12.77,9.29,6.42
07-10-2021,GUIMARÃES,209,15,137,"[120,240]",Moderado,,,,209,Norte,BRAGA,0308,24099.96,152309,9394,7074,4809,3877,2948,6825,11634,18708,28102,631.99,116.61,77.63,48.27
07-10-2021,HORTA,9,1,62,"[0,120]",Baixo a Moderado,,,,9,Açores,AÇORES,4701,17305.53,14521,818,658,468,352,302,654,1122,1780,2598,83.91,15.01,10.29,6.48
07-10-2021,IDANHA-A-NOVA,7,1,88,"[0,120]",Baixo a Moderado,,,,7,Centro,CASTELO BRANCO,0505,141633.51,8043,518,490,519,672,974,1646,2165,2655,3173,5.68,2.24,1.87,1.53
07-10-2021,ÍLHAVO,10,1,26,"[0,120]",Baixo a Moderado,,,,10,Centro,AVEIRO,0110,7347.55,38699,2227,1943,1444,1193,850,2043,3487,5430,7657,526.66,104.21,73.9,47.46
07-10-2021,LAGOA (FARO),46,3,202,"[120,240]",Moderado,,,,46,Algarve,FARO,0806,8825.45,22762,1314,1168,919,749,670,1419,2338,3506,4820,257.93,54.62,39.73,26.49
07-10-2021,LAGOA,20,1,136,"[120,240]",Moderado,,,,20,Açores,AÇORES,4201,4559.32,14721,536,458,349,238,235,473,822,1280,1816,322.9,39.83,28.08,18.03
07-10-2021,LAGOS,57,4,188,"[120,240]",Moderado,,,,57,Algarve,FARO,0807,21299.27,30374,1744,1434,1247,1053,1029,2082,3329,4763,6507,142.61,30.55,22.36,15.63
07-10-2021,LAJES DAS FLORES,0,0,0,"[0,120]",Baixo a Moderado,,,,0,Açores,AÇORES,4801,7004.79,1463,88,53,62,46,54,100,162,215,303,20.89,4.33,3.07,2.31
07-10-2021,LAJES DO PICO,1,0,22,"[0,120]",Baixo a Moderado,,,,1,Açores,AÇORES,4601,15531.09,4490,304,231,223,159,162,321,544,775,1079,28.91,6.95,4.99,3.5
07-10-2021,LAMEGO,48,3,194,"[120,240]",Moderado,,,,48,Norte,VISEU,1805,16542.11,24895,1639,1284,1124,898,783,1681,2805,4089,5728,150.5,34.63,24.72,16.96
07-10-2021,LEIRIA,68,5,54,"[0,120]",Baixo a Moderado,,,,68,Centro,LEIRIA,1009,56508.83,125267,7389,6366,5090,3902,3159,7061,12151,18517,25906,221.68,45.84,32.77,21.5
07-10-2021,LISBOA,418,30,82,"[0,120]",Baixo a Moderado,,,,418,Lisboa e Vale do Tejo,LISBOA,1106,10005.43,509515,33197,33340,27706,23037,26770,49807,77513,110853,144050,5092.6,1439.78,1107.98,774.74
07-10-2021,LOULÉ,84,6,122,"[120,240]",Moderado,,,,84,Algarve,FARO,0808,76366.91,68697,3890,3350,2780,2358,2251,4609,7389,10739,14629,89.96,19.16,14.06,9.68
07-10-2021,LOURES,143,10,67,"[0,120]",Baixo a Moderado,,,,143,Lisboa e Vale do Tejo,LISBOA,1107,16723.99,213687,12746,12794,9644,6669,5033,11702,21346,34140,46886,1277.73,280.35,204.14,127.64
07-10-2021,LOURINHÃ,32,2,122,"[120,240]",Moderado,,,,32,Lisboa e Vale do Tejo,LISBOA,1108,14717.2,25855,1584,1243,992,842,645,1487,2479,3722,5306,175.68,36.05,25.29,16.84
07-10-2021,LOUSÃ,6,0,35,"[0,120]",Baixo a Moderado,,,,6,Centro,COIMBRA,0607,13840.01,17158,946,866,658,528,450,978,1636,2502,3448,123.97,24.91,18.08,11.82
07-10-2021,LOUSADA,17,1,36,"[0,120]",Baixo a Moderado,,,,17,Norte,PORTO,1305,9608.01,46755,2289,1698,1176,853,621,1474,2650,4348,6637,486.63,69.08,45.25,27.58
07-10-2021,MAÇÃO,2,0,32,"[0,120]",Baixo a Moderado,,,,2,Lisboa e Vale do Tejo,SANTARÉM,1413,39997.98,6267,386,362,390,440,657,1097,1487,1849,2235,15.67,5.59,4.62,3.72
07-10-2021,MACEDO DE CAVALEIROS,6,0,42,"[0,120]",Baixo a Moderado,,,,6,Norte,BRAGANÇA,0405,69914.08,14516,1082,889,878,823,938,1761,2639,3528,4610,20.76,6.59,5.05,3.77
07-10-2021,MACHICO,14,1,70,"[0,120]",Baixo a Moderado,,,,14,Madeira,MADEIRA,3104,6825.1,19981,1197,860,662,455,331,786,1448,2308,3505,292.76,51.36,33.82,21.22
07-10-2021,MADALENA,1,0,17,"[0,120]",Baixo a Moderado,,,,1,Açores,AÇORES,4602,14712.33,5895,334,256,173,190,179,369,542,798,1132,40.07,7.69,5.42,3.68
07-10-2021,MAFRA,33,2,39,"[0,120]",Baixo a Moderado,,,,33,Lisboa e Vale do Tejo,LISBOA,1109,29165.5,84816,3613,3334,2839,2089,1899,3988,6827,10161,13774,290.81,47.23,34.84,23.41
07-10-2021,MAIA,79,6,57,"[0,120]",Baixo a Moderado,,,,79,Norte,PORTO,1306,8293.94,138971,7801,6617,4512,3339,2631,5970,10482,17099,24900,1675.56,300.22,206.16,126.38
07-10-2021,MANGUALDE,14,1,76,"[0,120]",Baixo a Moderado,,,,14,Centro,VISEU,1806,21925.56,18510,1198,1128,885,852,743,1595,2480,3608,4806,84.42,21.92,16.46,11.31
07-10-2021,MANTEIGAS,0,0,0,"[0,120]",Baixo a Moderado,,,,0,Centro,GUARDA,0908,12197.55,3007,258,197,159,167,146,313,472,669,927,24.65,7.6,5.48,3.87
07-10-2021,MARCO DE CANAVESES,23,2,45,"[0,120]",Baixo a Moderado,,,,23,Norte,PORTO,1307,20188.98,51496,2678,2060,1488,1265,1023,2288,3776,5836,8514,255.07,42.17,28.91,18.7
07-10-2021,MARINHA GRANDE,17,1,44,"[0,120]",Baixo a Moderado,,,,17,Centro,LEIRIA,1010,18725.19,38508,2365,2302,1638,1359,1058,2417,4055,6357,8722,205.65,46.58,33.95,21.66
07-10-2021,MARVÃO,0,0,0,"[0,120]",Baixo a Moderado,,,,0,Alentejo,PORTALEGRE,1210,15489.9,3005,198,185,142,197,237,434,576,761,959,19.4,6.19,4.91,3.72
07-10-2021,MATOSINHOS,107,8,61,"[0,120]",Baixo a Moderado,,,,107,Norte,PORTO,1308,6241.97,175357,11850,9977,7023,5024,3884,8908,15931,25908,37758,2809.31,604.9,415.06,255.22
07-10-2021,MEALHADA,2,0,10,"[0,120]",Baixo a Moderado,,,,2,Centro,AVEIRO,0111,11065.66,19914,1163,1039,810,828,831,1659,2469,3508,4671,179.96,42.21,31.7,22.31
07-10-2021,MÊDA,0,0,0,"[0,120]",Baixo a Moderado,,,,0,Centro,GUARDA,0909,28604.92,4587,343,306,290,288,443,731,1021,1327,1670,16.04,5.84,4.64,3.57
07-10-2021,MELGAÇO,11,1,138,"[120,240]",Moderado,,,,11,Norte,VIANA DO CASTELO,1603,23824.58,8093,507,567,578,614,675,1289,1867,2434,2941,33.97,12.34,10.22,7.84
07-10-2021,MÉRTOLA,24,2,397,"[240,480]",Elevado,,,,24,Alentejo,BEJA,0209,129287.34,6142,400,390,378,423,600,1023,1401,1791,2191,4.75,1.69,1.39,1.08
07-10-2021,MESÃO FRIO,7,1,178,"[120,240]",Moderado,,,,7,Norte,VILA REAL,1704,2664.87,3964,265,205,168,157,120,277,445,650,915,148.74,34.33,24.39,16.7
07-10-2021,MIRA,2,0,17,"[0,120]",Baixo a Moderado,,,,2,Centro,COIMBRA,0608,12403.38,11832,727,729,659,550,466,1016,1675,2404,3131,95.4,25.24,19.38,13.5
07-10-2021,MIRANDA DO CORVO,8,1,63,"[0,120]",Baixo a Moderado,,,,8,Centro,COIMBRA,0609,12637.79,12708,706,659,568,498,404,902,1470,2129,2835,100.55,22.43,16.85,11.63
07-10-2021,MIRANDA DO DOURO,8,1,118,"[0,120]",Baixo a Moderado,,,,8,Norte,BRAGANÇA,0406,48718.31,6830,482,429,442,463,470,933,1375,1804,2286,14.02,4.69,3.7,2.82
07-10-2021,MIRANDELA,34,2,158,"[120,240]",Moderado,,,,34,Norte,BRAGANÇA,0407,65895.67,21754,1640,1315,1204,1078,947,2025,3229,4544,6184,33.01,9.38,6.9,4.9
07-10-2021,MOGADOURO,4,0,48,"[0,120]",Baixo a Moderado,,,,4,Norte,BRAGANÇA,0408,76064.93,8392,589,529,576,630,655,1285,1861,2390,2979,11.03,3.92,3.14,2.45
07-10-2021,MOIMENTA DA BEIRA,11,1,113,"[0,120]",Baixo a Moderado,,,,11,Norte,VISEU,1807,21996.9,9736,576,514,471,416,461,877,1348,1862,2438,44.26,11.08,8.46,6.13
07-10-2021,MOITA,63,5,98,"[0,120]",Baixo a Moderado,,,,63,Lisboa e Vale do Tejo,SETÚBAL,1506,5525.98,64407,4226,3646,2623,1801,1425,3226,5849,9495,13721,1165.53,248.3,171.82,105.85
07-10-2021,MONÇÃO,26,2,147,"[120,240]",Moderado,,,,26,Norte,VIANA DO CASTELO,1604,21130.85,17869,1161,1105,1031,1006,972,1978,3009,4114,5275,84.56,24.96,19.47,14.24
07-10-2021,MONCHIQUE,7,1,141,"[120,240]",Moderado,,,,7,Algarve,FARO,0809,39530.43,5077,353,384,321,355,392,747,1068,1452,1805,12.84,4.57,3.67,2.7
07-10-2021,MONDIM DE BASTO,1,0,15,"[0,120]",Baixo a Moderado,,,,1,Norte,VILA REAL,1705,17207.52,6946,395,300,314,284,283,567,881,1181,1576,40.36,9.16,6.86,5.12
07-10-2021,MONFORTE,3,0,102,"[0,120]",Baixo a Moderado,,,,3,Alentejo,PORTALEGRE,1211,42024.82,2975,139,115,117,192,168,360,477,592,731,7.08,1.74,1.41,1.14
07-10-2021,MONTALEGRE,6,0,68,"[0,120]",Baixo a Moderado,,,,6,Norte,VILA REAL,1706,80545.71,8997,699,628,595,603,730,1333,1928,2556,3255,11.17,4.04,3.17,2.39
07-10-2021,MONTEMOR-O-NOVO,9,1,58,"[0,120]",Baixo a Moderado,,,,9,Alentejo,ÉVORA,0706,123296.65,15647,991,953,868,878,971,1849,2717,3670,4661,12.69,3.78,2.98,2.2
07-10-2021,MONTEMOR-O-VELHO,42,3,166,"[120,240]",Moderado,,,,42,Centro,COIMBRA,0610,22896.23,25224,1496,1397,1217,1057,988,2045,3262,4659,6155,110.17,26.88,20.35,14.25
07-10-2021,MONTIJO,36,3,62,"[0,120]",Baixo a Moderado,,,,36,Lisboa e Vale do Tejo,SETÚBAL,1507,34861.64,57614,2771,2441,1990,1554,1109,2663,4653,7094,9865,165.26,28.3,20.35,13.35
07-10-2021,MORA,3,0,74,"[0,120]",Baixo a Moderado,,,,3,Alentejo,ÉVORA,0707,44395.02,4138,336,275,252,238,257,495,747,1022,1358,9.32,3.06,2.3,1.68
07-10-2021,MORTÁGUA,4,0,45,"[0,120]",Baixo a Moderado,,,,4,Centro,VISEU,1808,25117.82,8803,638,584,535,499,460,959,1494,2078,2716,35.05,10.81,8.27,5.95
07-10-2021,MOURA,14,1,103,"[0,120]",Baixo a Moderado,,,,14,Alentejo,BEJA,0210,95845.55,13718,817,656,665,542,461,1003,1668,2324,3141,14.31,3.28,2.42,1.74
07-10-2021,MOURÃO,0,0,0,"[0,120]",Baixo a Moderado,,,,0,Alentejo,ÉVORA,0708,27862.98,2450,139,108,80,104,109,213,293,401,540,8.79,1.94,1.44,1.05
07-10-2021,MURÇA,0,0,0,"[0,120]",Baixo a Moderado,,,,0,Norte,VILA REAL,1707,18937.11,5463,384,341,307,306,319,625,932,1273,1657,28.85,8.75,6.72,4.92
07-10-2021,MURTOSA,6,0,58,"[0,120]",Baixo a Moderado,,,,6,Centro,AVEIRO,0112,7308.78,10279,509,473,403,353,409,762,1165,1638,2147,140.63,29.37,22.41,15.94
07-10-2021,NAZARÉ,64,5,449,"[240,480]",Elevado,,,,64,Lisboa e Vale do Tejo,LEIRIA,1011,8243.43,14165,967,903,670,420,396,816,1486,2389,3356,171.84,40.71,28.98,18.03
07-10-2021,NELAS,14,1,108,"[0,120]",Baixo a Moderado,,,,14,Centro,VISEU,1809,12571.48,12974,924,787,668,604,583,1187,1855,2642,3566,103.21,28.37,21.02,14.76
07-10-2021,NISA,0,0,0,"[0,120]",Baixo a Moderado,,,,0,Alentejo,PORTALEGRE,1212,57567.84,6061,405,389,355,483,478,961,1316,1705,2110,10.53,3.67,2.96,2.29
07-10-2021,NORDESTE,4,0,83,"[0,120]",Baixo a Moderado,,,,4,Açores,AÇORES,4202,10146.8,4862,246,180,124,161,162,323,447,627,873,47.92,8.6,6.18,4.41
07-10-2021,ÓBIDOS,10,1,83,"[0,120]",Baixo a Moderado,,,,10,Lisboa e Vale do Tejo,LEIRIA,1012,14155.44,11850,743,650,574,452,436,888,1462,2112,2855,83.72,20.17,14.92,10.33
07-10-2021,ODEMIRA,12,1,49,"[0,120]",Baixo a Moderado,,,,12,Alentejo,BEJA,0211,172060.15,24717,1475,1317,1225,1397,1349,2746,3971,5288,6763,14.37,3.93,3.07,2.31
07-10-2021,ODIVELAS,128,9,79,"[0,120]",Baixo a Moderado,,,,128,Lisboa e Vale do Tejo,LISBOA,1116,2654.36,161774,9562,9038,6952,4641,3812,8453,15405,24443,34005,6095.48,1281.27,920.99,580.44
07-10-2021,OEIRAS,124,9,70,"[0,120]",Baixo a Moderado,,,,124,Lisboa e Vale do Tejo,LISBOA,1110,4588.31,177408,11580,11575,8566,6211,5855,12066,20632,32207,43787,3866.78,954.38,701.98,449.69
07-10-2021,OLEIROS,0,0,0,"[0,120]",Baixo a Moderado,,,,0,Centro,CASTELO BRANCO,0506,47109.31,5003,384,341,366,397,487,884,1250,1591,1975,10.62,4.19,3.38,2.65
07-10-2021,OLHÃO,28,2,63,"[0,120]",Baixo a Moderado,,,,28,Algarve,FARO,0810,13086.38,44405,2455,2309,1689,1342,1268,2610,4299,6608,9063,339.33,69.26,50.5,32.85
07-10-2021,OLIVEIRA DE AZEMÉIS,65,5,99,"[0,120]",Baixo a Moderado,,,,65,Norte,AVEIRO,0113,16110.41,66011,4155,3614,2794,2183,1738,3921,6715,10329,14484,409.75,89.91,64.12,41.68
07-10-2021,OLIVEIRA DE FRADES,3,0,30,"[0,120]",Baixo a Moderado,,,,3,Centro,VISEU,1810,14534.62,9936,553,475,438,359,415,774,1212,1687,2240,68.36,15.41,11.61,8.34
07-10-2021,OLIVEIRA DO BAIRRO,5,0,20,"[0,120]",Baixo a Moderado,,,,5,Centro,AVEIRO,0114,8731.99,24277,1327,1182,999,786,810,1596,2595,3777,5104,278.02,58.45,43.25,29.72
07-10-2021,OLIVEIRA DO HOSPITAL,18,1,94,"[0,120]",Baixo a Moderado,,,,18,Centro,COIMBRA,0611,23451.66,19253,1161,1097,962,924,960,1884,2846,3943,5104,82.1,21.76,16.81,12.14
07-10-2021,OURÉM,50,4,113,"[0,120]",Baixo a Moderado,,,,50,Lisboa e Vale do Tejo,SANTARÉM,1421,41668.03,44044,2463,2069,1899,1817,1603,3420,5319,7388,9851,105.7,23.64,17.73,12.77
07-10-2021,OURIQUE,0,0,0,"[0,120]",Baixo a Moderado,,,,0,Alentejo,BEJA,0212,66331.36,4607,313,287,284,268,227,495,779,1066,1379,6.95,2.08,1.61,1.17
07-10-2021,OVAR,14,1,26,"[0,120]",Baixo a Moderado,,,,14,Centro,AVEIRO,0115,14770.25,54260,3294,2709,1994,1636,1234,2870,4864,7573,10867,367.37,73.57,51.27,32.93
07-10-2021,PAÇOS DE FERREIRA,16,1,28,"[0,120]",Baixo a Moderado,,,,16,Norte,PORTO,1309,7099.29,56728,2903,2193,1518,1135,664,1799,3317,5510,8413,799.1,118.51,77.62,46.72
07-10-2021,PALMELA,29,2,45,"[0,120]",Baixo a Moderado,,,,29,Lisboa e Vale do Tejo,SETÚBAL,1508,46512.01,64269,3402,3244,2635,1846,1391,3237,5872,9116,12518,138.18,26.91,19.6,12.62
07-10-2021,PAMPILHOSA DA SERRA,2,0,50,"[0,120]",Baixo a Moderado,,,,2,Centro,COIMBRA,0612,39646.24,4037,238,254,295,339,423,762,1057,1311,1549,10.18,3.91,3.31,2.67
07-10-2021,PAREDES,61,4,71,"[0,120]",Baixo a Moderado,,,,61,Norte,PORTO,1310,15675.69,86067,4272,3532,2412,1717,1258,2975,5387,8919,13191,549.04,84.15,56.9,34.36
07-10-2021,PAREDES DE COURA,8,1,94,"[0,120]",Baixo a Moderado,,,,8,Norte,VIANA DO CASTELO,1605,13818.59,8535,466,528,407,465,515,980,1387,1915,2381,61.76,17.23,13.86,10.04
07-10-2021,PEDRÓGÃO GRANDE,12,1,351,"[240,480]",Elevado,,,,12,Centro,LEIRIA,1013,12874.75,3410,175,173,196,221,252,473,669,842,1017,26.49,7.9,6.54,5.2
07-10-2021,PENACOVA,4,0,29,"[0,120]",Baixo a Moderado,,,,4,Centro,COIMBRA,0613,21673.23,13694,968,923,745,621,703,1324,2069,2992,3960,63.18,18.27,13.81,9.55
07-10-2021,PENAFIEL,30,2,43,"[0,120]",Baixo a Moderado,,,,30,Norte,PORTO,1311,21224.27,69772,3648,2823,2032,1663,1230,2893,4925,7748,11396,328.74,53.69,36.51,23.2
07-10-2021,PENALVA DO CASTELO,10,1,140,"[120,240]",Moderado,,,,10,Centro,VISEU,1811,13433.92,7115,449,457,413,391,426,817,1230,1687,2136,52.96,15.9,12.56,9.16
07-10-2021,PENAMACOR,0,0,0,"[0,120]",Baixo a Moderado,,,,0,Centro,CASTELO BRANCO,0507,56370.69,4755,262,248,273,451,633,1084,1357,1605,1867,8.44,3.31,2.85,2.41
07-10-2021,PENEDONO,1,0,39,"[0,120]",Baixo a Moderado,,,,1,Norte,VISEU,1812,13370.75,2591,172,113,129,156,138,294,423,536,708,19.38,5.3,4.01,3.16
07-10-2021,PENELA,1,0,19,"[0,120]",Baixo a Moderado,,,,1,Centro,COIMBRA,0614,13480.0,5397,314,324,274,359,344,703,977,1301,1615,40.04,11.98,9.65,7.25
07-10-2021,PENICHE,6,0,22,"[0,120]",Baixo a Moderado,,,,6,Lisboa e Vale do Tejo,LEIRIA,1014,7754.98,26501,1746,1504,1203,926,707,1633,2836,4340,6086,341.73,78.48,55.96,36.57
07-10-2021,PESO DA RÉGUA,33,2,210,"[120,240]",Moderado,,,,33,Norte,VILA REAL,1708,9486.01,15773,1076,843,650,659,455,1114,1764,2607,3683,166.28,38.83,27.48,18.6
07-10-2021,PINHEL,6,0,71,"[0,120]",Baixo a Moderado,,,,6,Centro,GUARDA,0910,48452.12,8511,577,566,551,538,689,1227,1778,2344,2921,17.57,6.03,4.84,3.67
07-10-2021,POMBAL,24,2,46,"[0,120]",Baixo a Moderado,,,,24,Centro,LEIRIA,1015,62600.28,51461,3187,2791,2494,2328,2027,4355,6849,9640,12827,82.21,20.49,15.4,10.94
07-10-2021,PONTA DELGADA,102,7,150,"[120,240]",Moderado,,,,102,Açores,AÇORES,4203,23298.65,67935,3108,2435,1726,1133,902,2035,3761,6196,9304,291.58,39.93,26.59,16.14
07-10-2021,PONTA DO SOL,1,0,12,"[0,120]",Baixo a Moderado,,,,1,Madeira,MADEIRA,3105,4622.03,8593,319,283,347,208,221,429,776,1059,1378,185.92,29.81,22.91,16.79
07-10-2021,PONTE DA BARCA,4,0,36,"[0,120]",Baixo a Moderado,,,,4,Norte,VIANA DO CASTELO,1606,18211.37,11180,635,576,517,554,490,1044,1561,2137,2772,61.39,15.22,11.73,8.57
07-10-2021,PONTE DE LIMA,10,1,24,"[0,120]",Baixo a Moderado,,,,10,Norte,VIANA DO CASTELO,1607,32025.46,41315,2321,2022,1720,1596,1462,3058,4778,6800,9121,129.01,28.48,21.23,14.92
07-10-2021,PONTE DE SOR,3,0,20,"[0,120]",Baixo a Moderado,,,,3,Alentejo,PORTALEGRE,1213,83971.16,14994,939,800,716,739,831,1570,2286,3086,4025,17.86,4.79,3.68,2.72
07-10-2021,PORTALEGRE,3,0,14,"[0,120]",Baixo a Moderado,,,,3,Alentejo,PORTALEGRE,1214,44713.64,22172,1577,1351,1137,993,984,1977,3114,4465,6042,49.59,13.51,9.99,6.96
07-10-2021,PORTEL,10,1,173,"[120,240]",Moderado,,,,10,Alentejo,ÉVORA,0709,60100.57,5828,336,358,283,331,305,636,919,1277,1613,9.7,2.68,2.12,1.53
07-10-2021,PORTIMÃO,156,11,282,"[240,480]",Elevado,,,,156,Algarve,FARO,0811,18206.29,55483,3182,2927,2116,1582,1400,2982,5098,8025,11207,304.75,61.56,44.08,28.0
07-10-2021,PORTO,227,16,105,"[0,120]",Baixo a Moderado,,,,227,Norte,PORTO,1312,4142.02,216606,15790,15193,11280,9409,10044,19453,30733,45926,61716,5229.5,1490.0,1108.79,741.98
07-10-2021,PORTO DE MÓS,2,0,9,"[0,120]",Baixo a Moderado,,,,2,Centro,LEIRIA,1016,26183.41,23275,1355,1210,1034,888,872,1760,2794,4004,5359,88.89,20.47,15.29,10.67
07-10-2021,PORTO MONIZ,8,1,346,"[240,480]",Elevado,,,,8,Madeira,MADEIRA,3106,8293.38,2342,143,130,95,98,120,218,313,443,586,28.24,7.07,5.34,3.77
07-10-2021,PORTO SANTO,0,0,0,"[0,120]",Baixo a Moderado,,,,0,Madeira,MADEIRA,3201,4300.7,5202,240,157,134,110,68,178,312,469,709,120.95,16.48,10.9,7.25
07-10-2021,PÓVOA DE LANHOSO,24,2,112,"[0,120]",Baixo a Moderado,,,,24,Norte,BRAGA,0309,13465.29,21499,1175,909,732,673,624,1297,2029,2938,4113,159.67,30.55,21.82,15.07
07-10-2021,PÓVOA DE VARZIM,38,3,61,"[0,120]",Baixo a Moderado,,,,38,Norte,PORTO,1313,8220.59,62784,3712,3120,2134,1594,1305,2899,5033,8153,11865,763.7,144.33,99.17,61.22
07-10-2021,POVOAÇÃO,0,0,0,"[0,120]",Baixo a Moderado,,,,0,Açores,AÇORES,4204,10640.77,5927,293,212,191,144,134,278,469,681,974,55.7,9.15,6.4,4.41
07-10-2021,VILA DA PRAIA DA VITÓRIA,2,0,9,"[0,120]",Baixo a Moderado,,,,2,Açores,AÇORES,4302,16127.06,21317,1133,789,619,436,336,772,1391,2180,3313,132.18,20.54,13.52,8.63
07-10-2021,PROENÇA-A-NOVA,1,0,14,"[0,120]",Baixo a Moderado,,,,1,Centro,CASTELO BRANCO,0508,39539.96,7298,508,465,389,400,560,960,1349,1814,2322,18.46,5.87,4.59,3.41
07-10-2021,REDONDO,5,0,80,"[0,120]",Baixo a Moderado,,,,5,Alentejo,ÉVORA,0710,36950.87,6353,349,325,288,288,354,642,930,1255,1604,17.19,4.34,3.4,2.52
07-10-2021,REGUENGOS DE MONSARAZ,38,3,383,"[240,480]",Elevado,,,,38,Alentejo,ÉVORA,0711,46399.72,10015,602,511,455,462,473,935,1390,1901,2503,21.58,5.39,4.1,3.0
07-10-2021,RESENDE,17,1,170,"[120,240]",Moderado,,,,17,Norte,VISEU,1813,12334.93,10137,560,493,448,433,422,855,1303,1796,2356,82.18,19.1,14.56,10.56
07-10-2021,RIBEIRA BRAVA,5,0,40,"[0,120]",Baixo a Moderado,,,,5,Madeira,MADEIRA,3107,6544.88,12435,648,500,411,311,287,598,1009,1509,2157,189.99,32.96,23.06,15.42
07-10-2021,RIBEIRA DE PENA,1,0,17,"[0,120]",Baixo a Moderado,,,,1,Norte,VILA REAL,1709,21745.98,6016,371,301,290,310,368,678,968,1269,1640,27.66,7.54,5.84,4.45
07-10-2021,RIBEIRA GRANDE,53,4,161,"[120,240]",Moderado,,,,53,Açores,AÇORES,4205,18015.13,32811,1163,689,512,345,253,598,1110,1799,2962,182.13,16.44,9.99,6.16
07-10-2021,RIO MAIOR,46,3,227,"[120,240]",Moderado,,,,46,Lisboa e Vale do Tejo,SANTARÉM,1414,27276.45,20379,1251,1144,941,795,648,1443,2384,3528,4779,74.71,17.52,12.93,8.74
07-10-2021,SABROSA,5,0,85,"[0,120]",Baixo a Moderado,,,,5,Norte,VILA REAL,1710,15692.45,5918,393,314,304,302,350,652,956,1270,1663,37.71,10.6,8.09,6.09
07-10-2021,SABUGAL,24,2,228,"[120,240]",Moderado,,,,24,Centro,GUARDA,0911,82269.82,10585,724,707,694,796,1009,1805,2499,3206,3930,12.87,4.78,3.9,3.04
07-10-2021,SALVATERRA DE MAGOS,6,0,28,"[0,120]",Baixo a Moderado,,,,6,Lisboa e Vale do Tejo,SANTARÉM,1415,24393.2,21295,1275,1181,1060,799,772,1571,2631,3812,5087,87.3,20.85,15.63,10.79
07-10-2021,SANTA COMBA DÃO,0,0,0,"[0,120]",Baixo a Moderado,,,,0,Centro,VISEU,1814,11194.77,10452,732,684,569,538,464,1002,1571,2255,2987,93.36,26.68,20.14,14.03
07-10-2021,SANTA CRUZ,23,2,50,"[0,120]",Baixo a Moderado,,,,23,Madeira,MADEIRA,3108,8150.28,45281,1817,1301,974,716,523,1239,2213,3514,5331,555.6,65.41,43.12,27.15
07-10-2021,SANTA CRUZ DA GRACIOSA,0,0,0,"[0,120]",Baixo a Moderado,,,,0,Açores,AÇORES,4401,6065.78,4208,228,180,163,124,145,269,432,612,840,69.37,13.85,10.09,7.12
07-10-2021,SANTA CRUZ DAS FLORES,0,0,0,"[0,120]",Baixo a Moderado,,,,0,Açores,AÇORES,4802,7091.44,2165,125,98,74,56,51,107,181,279,404,30.53,5.7,3.93,2.55
07-10-2021,SANTA MARIA DA FEIRA,65,5,47,"[0,120]",Baixo a Moderado,,,,65,Norte,AVEIRO,0109,21587.65,138636,8182,6743,4771,3856,3079,6935,11706,18449,26631,642.19,123.36,85.46,54.22
07-10-2021,SANTA MARTA DE PENAGUIÃO,23,2,351,"[240,480]",Elevado,,,,23,Norte,VILA REAL,1711,6928.13,6599,483,373,337,316,317,633,970,1343,1826,95.25,26.36,19.39,14.0
07-10-2021,SANTANA,2,0,30,"[0,120]",Baixo a Moderado,,,,2,Madeira,MADEIRA,3109,9547.3,6711,418,353,343,282,277,559,902,1255,1673,70.29,17.52,13.15,9.45
07-10-2021,SANTARÉM,44,3,77,"[0,120]",Baixo a Moderado,,,,44,Lisboa e Vale do Tejo,SANTARÉM,1416,55253.58,57421,3654,3441,2760,2466,2206,4672,7432,10873,14527,103.92,26.29,19.68,13.45
07-10-2021,SANTIAGO DO CACÉM,11,1,38,"[0,120]",Baixo a Moderado,,,,11,Alentejo,SETÚBAL,1509,105969.29,28791,2144,1689,1472,1295,1215,2510,3982,5671,7815,27.17,7.37,5.35,3.76
07-10-2021,SANTO TIRSO,30,2,44,"[0,120]",Baixo a Moderado,,,,30,Norte,PORTO,1314,13655.52,68055,4911,3935,2761,2257,1810,4067,6828,10763,15674,498.35,114.78,78.82,50.0
07-10-2021,SÃO BRÁS DE ALPORTEL,10,1,96,"[0,120]",Baixo a Moderado,,,,10,Algarve,FARO,0812,15336.92,10416,596,468,467,404,401,805,1272,1740,2336,67.91,15.23,11.35,8.29
07-10-2021,SÃO JOÃO DA MADEIRA,38,3,172,"[120,240]",Moderado,,,,38,Norte,AVEIRO,0116,794.3,21958,1347,1069,796,601,593,1194,1990,3059,4406,2765.49,554.91,385.26,250.63
07-10-2021,SÃO JOÃO DA PESQUEIRA,2,0,28,"[0,120]",Baixo a Moderado,,,,2,Norte,VISEU,1815,26610.85,7125,417,330,294,328,328,656,950,1280,1697,26.77,6.38,4.81,3.57
07-10-2021,SÃO PEDRO DO SUL,23,2,149,"[120,240]",Moderado,,,,23,Centro,VISEU,1816,34895.09,15403,990,962,861,759,909,1668,2529,3491,4481,44.14,12.84,10.0,7.25
07-10-2021,SÃO ROQUE DO PICO,0,0,0,"[0,120]",Baixo a Moderado,,,,0,Açores,AÇORES,4603,14236.1,3266,199,141,93,96,113,209,302,443,642,22.94,4.51,3.11,2.12
07-10-2021,SÃO VICENTE,1,0,20,"[0,120]",Baixo a Moderado,,,,1,Madeira,MADEIRA,3110,7883.71,5143,272,264,266,225,280,505,771,1035,1307,65.23,16.58,13.13,9.78
07-10-2021,SARDOAL,0,0,0,"[0,120]",Baixo a Moderado,,,,0,Lisboa e Vale do Tejo,SANTARÉM,1417,9214.72,3741,227,178,148,165,248,413,561,739,966,40.6,10.48,8.02,6.09
07-10-2021,SÁTÃO,2,0,17,"[0,120]",Baixo a Moderado,,,,2,Centro,VISEU,1817,20194.11,11580,765,671,515,465,476,941,1456,2127,2892,57.34,14.32,10.53,7.21
07-10-2021,SEIA,9,1,41,"[0,120]",Baixo a Moderado,,,,9,Centro,GUARDA,0912,43568.83,22234,1807,1589,1238,1122,721,1843,3081,4670,6477,51.03,14.87,10.72,7.07
07-10-2021,SEIXAL,94,7,56,"[0,120]",Baixo a Moderado,,,,94,Lisboa e Vale do Tejo,SETÚBAL,1510,9545.17,167752,10586,9270,6661,4391,2930,7321,13982,23252,33838,1757.49,354.51,243.6,146.49
07-10-2021,SERNANCELHE,1,0,19,"[0,120]",Baixo a Moderado,,,,1,Norte,VISEU,1818,22861.22,5396,305,293,286,273,260,533,819,1112,1417,23.6,6.2,4.86,3.58
07-10-2021,SERPA,40,3,282,"[240,480]",Elevado,,,,40,Alentejo,BEJA,0213,110563.34,14304,903,761,719,697,626,1323,2042,2803,3706,12.94,3.35,2.54,1.85
07-10-2021,SERTÃ,41,3,282,"[240,480]",Elevado,,,,41,Centro,CASTELO BRANCO,0509,44673.17,14577,870,779,790,767,1020,1787,2577,3356,4226,32.63,9.46,7.51,5.77
07-10-2021,SESIMBRA,28,2,54,"[0,120]",Baixo a Moderado,,,,28,Lisboa e Vale do Tejo,SETÚBAL,1511,19571.75,51858,2400,2321,1853,1257,1083,2340,4193,6514,8914,264.96,45.54,33.28,21.42
07-10-2021,SETÚBAL,73,5,63,"[0,120]",Baixo a Moderado,,,,73,Lisboa e Vale do Tejo,SETÚBAL,1512,23032.5,115126,7425,6929,5075,3775,2655,6430,11505,18434,25859,499.83,112.27,80.03,49.95
07-10-2021,SEVER DO VOUGA,0,0,0,"[0,120]",Baixo a Moderado,,,,0,Centro,AVEIRO,0117,12987.56,11331,766,637,568,540,567,1107,1675,2312,3078,87.24,23.7,17.8,12.9
07-10-2021,SILVES,98,7,270,"[240,480]",Elevado,,,,98,Algarve,FARO,0813,68006.23,36226,2137,1869,1610,1423,1600,3023,4633,6502,8639,53.27,12.7,9.56,6.81
07-10-2021,SINES,6,0,44,"[0,120]",Baixo a Moderado,,,,6,Alentejo,SETÚBAL,1513,20330.17,13715,888,791,551,416,268,684,1235,2026,2914,67.46,14.33,9.97,6.07
07-10-2021,SINTRA,184,13,47,"[0,120]",Baixo a Moderado,,,,184,Lisboa e Vale do Tejo,LISBOA,1111,31922.73,391402,20490,18316,13545,9137,7284,16421,29966,48282,68772,1226.08,215.43,151.25,93.87
07-10-2021,SOBRAL DE MONTE AGRAÇO,10,1,92,"[0,120]",Baixo a Moderado,,,,10,Lisboa e Vale do Tejo,LISBOA,1112,5210.32,10651,564,507,352,272,212,484,836,1343,1907,204.43,36.6,25.78,16.05
07-10-2021,SOURE,6,0,35,"[0,120]",Baixo a Moderado,,,,6,Centro,COIMBRA,0615,26506.07,17120,1173,1142,1004,883,987,1870,2874,4016,5189,64.59,19.58,15.15,10.84
07-10-2021,SOUSEL,5,0,116,"[0,120]",Baixo a Moderado,,,,5,Alentejo,PORTALEGRE,1215,27932.18,4412,261,274,208,302,292,594,802,1076,1337,15.8,4.79,3.85,2.87
07-10-2021,TÁBUA,5,0,44,"[0,120]",Baixo a Moderado,,,,5,Centro,COIMBRA,0616,19978.58,11368,729,584,524,430,464,894,1418,2002,2731,56.9,13.67,10.02,7.1
07-10-2021,TABUAÇO,0,0,0,"[0,120]",Baixo a Moderado,,,,0,Norte,VISEU,1819,13385.67,6033,372,314,217,282,363,645,862,1176,1548,45.07,11.56,8.79,6.44
07-10-2021,TAROUCA,7,1,90,"[0,120]",Baixo a Moderado,,,,7,Norte,VISEU,1820,10008.49,7804,405,335,313,277,324,601,914,1249,1654,77.98,16.53,12.48,9.13
07-10-2021,TAVIRA,17,1,70,"[0,120]",Baixo a Moderado,,,,17,Algarve,FARO,0814,60696.7,24530,1493,1415,1252,1066,1277,2343,3595,5010,6503,40.41,10.71,8.25,5.92
07-10-2021,TERRAS DE BOURO,1,0,16,"[0,120]",Baixo a Moderado,,,,1,Norte,BRAGA,0310,27746.07,6361,391,372,296,319,340,659,955,1327,1718,22.93,6.19,4.78,3.44
07-10-2021,TOMAR,24,2,65,"[0,120]",Baixo a Moderado,,,,24,Lisboa e Vale do Tejo,SANTARÉM,1418,35120.44,36748,2403,2189,1868,1853,1822,3675,5543,7732,10135,104.64,28.86,22.02,15.78
07-10-2021,TONDELA,22,2,83,"[0,120]",Baixo a Moderado,,,,22,Centro,VISEU,1821,37121.73,26357,1768,1722,1518,1475,1417,2892,4410,6132,7900,71.0,21.28,16.52,11.88
07-10-2021,TORRE DE MONCORVO,2,0,26,"[0,120]",Baixo a Moderado,,,,2,Norte,BRAGANÇA,0409,53155.67,7695,556,478,488,551,719,1270,1758,2236,2792,14.48,5.25,4.21,3.31
07-10-2021,TORRES NOVAS,22,2,63,"[0,120]",Baixo a Moderado,,,,22,Lisboa e Vale do Tejo,SANTARÉM,1419,26999.68,34933,2324,1979,1738,1406,1475,2881,4619,6598,8922,129.38,33.04,24.44,17.11
07-10-2021,TORRES VEDRAS,97,7,124,"[120,240]",Moderado,,,,97,Lisboa e Vale do Tejo,LISBOA,1113,40714.89,78530,4513,3945,3447,2628,2104,4732,8179,12124,16637,192.88,40.86,29.78,20.09
07-10-2021,TRANCOSO,2,0,22,"[0,120]",Baixo a Moderado,,,,2,Centro,GUARDA,0913,36152.47,8875,581,557,542,586,496,1082,1624,2181,2762,24.55,7.64,6.03,4.49
07-10-2021,TROFA,20,1,52,"[0,120]",Baixo a Moderado,,,,20,Norte,PORTO,1318,7201.76,38418,2336,1894,1231,939,684,1623,2854,4748,7084,533.44,98.36,65.93,39.63
07-10-2021,VAGOS,10,1,44,"[0,120]",Baixo a Moderado,,,,10,Centro,AVEIRO,0118,16491.5,22740,1320,1205,922,784,724,1508,2430,3635,4955,137.89,30.04,22.04,14.73
07-10-2021,VALE DE CAMBRA,8,1,38,"[0,120]",Baixo a Moderado,,,,8,Norte,AVEIRO,0119,14733.47,21327,1491,1363,1005,831,798,1629,2634,3997,5488,144.76,37.25,27.13,17.88
07-10-2021,VALENÇA,4,0,30,"[0,120]",Baixo a Moderado,,,,4,Norte,VIANA DO CASTELO,1608,11712.86,13290,867,791,582,582,503,1085,1667,2458,3325,113.46,28.39,20.99,14.23
07-10-2021,VALONGO,43,3,44,"[0,120]",Baixo a Moderado,,,,43,Norte,PORTO,1315,7512.45,97444,5629,4696,3207,2462,1829,4291,7498,12194,17823,1297.18,237.26,162.33,99.81
07-10-2021,VALPAÇOS,24,2,164,"[120,240]",Moderado,,,,24,Norte,VILA REAL,1712,54873.93,14818,1217,1118,999,928,997,1925,2924,4042,5259,27.0,9.58,7.37,5.33
07-10-2021,VELAS,0,0,0,"[0,120]",Baixo a Moderado,,,,0,Açores,AÇORES,4502,11738.38,5093,278,208,166,153,113,266,432,640,918,43.39,7.82,5.45,3.68
07-10-2021,VENDAS NOVAS,2,0,18,"[0,120]",Baixo a Moderado,,,,2,Alentejo,ÉVORA,0712,22238.88,11255,677,768,655,501,532,1033,1688,2456,3133,50.61,14.09,11.04,7.59
07-10-2021,VIANA DO ALENTEJO,4,0,78,"[0,120]",Baixo a Moderado,,,,4,Alentejo,ÉVORA,0713,39367.29,5145,245,208,235,210,214,424,659,867,1112,13.07,2.82,2.2,1.67
07-10-2021,VIANA DO CASTELO,24,2,29,"[0,120]",Baixo a Moderado,,,,24,Norte,VIANA DO CASTELO,1609,31902.01,84417,5470,4433,3591,3061,2982,6043,9634,14067,19537,264.61,61.24,44.09,30.2
07-10-2021,VIDIGUEIRA,22,2,402,"[240,480]",Elevado,,,,22,Alentejo,BEJA,0214,31661.09,5510,300,248,215,233,275,508,723,971,1271,17.4,4.01,3.07,2.28
07-10-2021,VIEIRA DO MINHO,11,1,93,"[0,120]",Baixo a Moderado,,,,11,Norte,BRAGA,0311,21644.35,11842,703,594,525,548,482,1030,1555,2149,2852,54.71,13.18,9.93,7.18
07-10-2021,VILA DE REI,2,0,60,"[0,120]",Baixo a Moderado,,,,2,Centro,CASTELO BRANCO,0510,19154.6,3323,169,128,172,247,302,549,721,849,1018,17.35,5.31,4.43,3.76
07-10-2021,VILA DO BISPO,10,1,194,"[120,240]",Moderado,,,,10,Algarve,FARO,0815,17906.06,5154,302,302,314,232,233,465,779,1081,1383,28.78,7.72,6.04,4.35
07-10-2021,VILA DO CONDE,45,3,56,"[0,120]",Baixo a Moderado,,,,45,Norte,PORTO,1316,14902.77,79899,4726,3875,2819,2070,1743,3813,6632,10507,15233,536.13,102.21,70.5,44.5
07-10-2021,VILA DO PORTO,0,0,0,"[0,120]",Baixo a Moderado,,,,0,Açores,AÇORES,4101,9688.74,5616,274,212,135,96,123,219,354,566,840,57.96,8.67,5.84,3.65
07-10-2021,VILA FLOR,4,0,67,"[0,120]",Baixo a Moderado,,,,4,Norte,BRAGANÇA,0410,26581.14,6044,429,362,422,294,331,625,1047,1409,1838,22.74,6.91,5.3,3.94
07-10-2021,VILA FRANCA DE XIRA,65,5,46,"[0,120]",Baixo a Moderado,,,,65,Lisboa e Vale do Tejo,LISBOA,1114,31819.39,141957,8501,6852,4869,3425,2472,5897,10766,17618,26119,446.14,82.09,55.37,33.84
07-10-2021,VILA FRANCA DO CAMPO,3,0,27,"[0,120]",Baixo a Moderado,,,,3,Açores,AÇORES,4206,7796.82,11051,450,344,248,217,154,371,619,963,1413,141.73,18.12,12.35,7.94
07-10-2021,VILA NOVA DA BARQUINHA,0,0,0,"[0,120]",Baixo a Moderado,,,,0,Lisboa e Vale do Tejo,SANTARÉM,1420,4952.97,7461,415,406,392,364,338,702,1094,1500,1915,150.64,38.66,30.28,22.09
07-10-2021,VILA NOVA DE CERVEIRA,0,0,0,"[0,120]",Baixo a Moderado,,,,0,Norte,VIANA DO CASTELO,1610,10846.66,8910,531,444,410,384,334,718,1128,1572,2103,82.14,19.39,14.49,10.4
07-10-2021,VILA NOVA DE FAMALICÃO,74,5,56,"[0,120]",Baixo a Moderado,,,,74,Norte,BRAGA,0312,20159.26,131676,7817,6164,4202,3282,2749,6031,10233,16397,24214,653.19,120.12,81.34,50.76
07-10-2021,VILA NOVA DE FOZ CÔA,8,1,125,"[120,240]",Moderado,,,,8,Centro,GUARDA,0914,39815.18,6503,442,385,390,398,429,827,1217,1602,2044,16.33,5.13,4.02,3.06
07-10-2021,VILA NOVA DE GAIA,174,12,58,"[0,120]",Baixo a Moderado,,,,174,Norte,PORTO,1317,16846.43,300472,18349,15568,10972,8224,6281,14505,25477,41045,59394,1783.64,352.57,243.65,151.23
07-10-2021,VILA NOVA DE PAIVA,1,0,21,"[0,120]",Baixo a Moderado,,,,1,Centro,VISEU,1822,17553.28,4687,289,272,233,217,241,458,691,963,1252,26.7,7.13,5.49,3.94
07-10-2021,VILA NOVA DE POIARES,1,0,14,"[0,120]",Baixo a Moderado,,,,1,Centro,COIMBRA,0617,8445.3,6939,380,284,262,235,182,417,679,963,1343,82.17,15.9,11.4,8.04
07-10-2021,VILA POUCA DE AGUIAR,13,1,110,"[0,120]",Baixo a Moderado,,,,13,Norte,VILA REAL,1713,43706.62,11961,860,817,733,601,627,1228,1961,2778,3638,27.37,8.32,6.36,4.49
07-10-2021,VILA REAL,63,4,126,"[120,240]",Moderado,,,,63,Norte,VILA REAL,1714,37880.28,49962,3025,2498,2065,1579,1466,3045,5110,7608,10633,131.9,28.07,20.08,13.49
07-10-2021,VILA REAL DE SANTO ANTÓNIO,12,1,64,"[0,120]",Baixo a Moderado,,,,12,Algarve,FARO,0816,6125.0,18749,1172,1069,811,569,586,1155,1966,3035,4207,306.11,68.69,49.55,32.1
07-10-2021,VILA VELHA DE RÓDÃO,3,0,95,"[0,120]",Baixo a Moderado,,,,3,Centro,CASTELO BRANCO,0511,32991.16,3144,209,229,180,283,306,589,769,998,1207,9.53,3.66,3.03,2.33
07-10-2021,VILA VERDE,39,3,83,"[0,120]",Baixo a Moderado,,,,39,Norte,BRAGA,0313,22866.52,46911,2365,2063,1667,1494,1437,2931,4598,6661,9026,205.15,39.47,29.13,20.11
07-10-2021,VILA VIÇOSA,0,0,0,"[0,120]",Baixo a Moderado,,,,0,Alentejo,ÉVORA,0714,19485.89,7656,487,379,342,345,324,669,1011,1390,1877,39.29,9.63,7.13,5.19
07-10-2021,VIMIOSO,0,0,0,"[0,120]",Baixo a Moderado,,,,0,Norte,BRAGANÇA,0411,48158.51,4023,274,230,261,293,335,628,889,1119,1393,8.35,2.89,2.32,1.85
07-10-2021,VINHAIS,2,0,26,"[0,120]",Baixo a Moderado,,,,2,Norte,BRAGANÇA,0412,69475.09,7746,599,577,636,641,815,1456,2092,2669,3268,11.15,4.7,3.84,3.01
07-10-2021,VISEU,44,3,45,"[0,120]",Baixo a Moderado,,,,44,Centro,VISEU,1823,50710.14,97249,5769,5038,4140,3158,2710,5868,10008,15046,20815,191.77,41.05,29.67,19.74
07-10-2021,VIZELA,19,1,80,"[0,120]",Baixo a Moderado,,,,19,Norte,BRAGA,0314,2469.83,23897,1258,928,655,509,371,880,1535,2463,3721,967.49,150.65,99.72,62.15
07-10-2021,VOUZELA,4,0,42,"[0,120]",Baixo a Moderado,,,,4,Centro,VISEU,1824,19369.46,9619,626,605,554,532,507,1039,1593,2198,2824,49.66,14.58,11.35,8.22
14-10-2021,ABRANTES,44,3,126,"[120,240]",Moderado,,,,44,Lisboa e Vale do Tejo,SANTARÉM,1401,71469.08,35130,2473,2213,1730,1748,2021,3769,5499,7712,10185,49.15,14.25,10.79,7.69
14-10-2021,ÁGUEDA,14,1,30,"[0,120]",Baixo a Moderado,,,,14,Centro,AVEIRO,0101,33527.44,46075,3237,2713,2090,1635,1496,3131,5221,7934,11171,137.43,33.32,23.66,15.57
14-10-2021,AGUIAR DA BEIRA,2,0,43,"[0,120]",Baixo a Moderado,,,,2,Centro,GUARDA,0901,20676.57,4652,304,281,235,239,148,387,622,903,1207,22.5,5.84,4.37,3.01
14-10-2021,ALANDROAL,1,0,20,"[0,120]",Baixo a Moderado,,,,1,Alentejo,ÉVORA,0701,54267.81,4992,307,256,296,299,377,676,972,1228,1535,9.2,2.83,2.26,1.79
14-10-2021,ALBERGARIA-A-VELHA,22,2,91,"[0,120]",Baixo a Moderado,,,,22,Centro,AVEIRO,0102,15882.5,24144,1550,1298,996,687,680,1367,2363,3661,5211,152.02,32.81,23.05,14.88
14-10-2021,ALBUFEIRA,69,5,165,"[120,240]",Moderado,,,,69,Algarve,FARO,0801,14066.42,41528,2067,1717,1425,985,858,1843,3268,4985,7052,295.24,50.14,35.44,23.23
14-10-2021,ALCÁCER DO SAL,13,1,113,"[0,120]",Baixo a Moderado,,,,13,Alentejo,SETÚBAL,1501,149987.3,11659,884,814,623,623,602,1225,1848,2662,3546,7.77,2.36,1.77,1.23
14-10-2021,ALCANENA,11,1,85,"[0,120]",Baixo a Moderado,,,,11,Lisboa e Vale do Tejo,SANTARÉM,1402,12732.86,12809,891,744,628,536,588,1124,1752,2496,3387,100.6,26.6,19.6,13.76
14-10-2021,ALCOBAÇA,42,3,78,"[0,120]",Baixo a Moderado,,,,42,Lisboa e Vale do Tejo,LEIRIA,1001,40814.09,53555,3420,2927,2466,2059,1676,3735,6201,9128,12548,131.22,30.74,22.36,15.19
14-10-2021,ALCOCHETE,0,0,0,"[0,120]",Baixo a Moderado,,,,0,Lisboa e Vale do Tejo,SETÚBAL,1502,12836.48,19787,857,834,691,476,447,923,1614,2448,3305,154.15,25.75,19.07,12.57
14-10-2021,ALCOUTIM,7,1,337,"[240,480]",Elevado,,,,7,Algarve,FARO,0802,57536.33,2159,191,188,163,190,267,457,620,808,999,3.75,1.74,1.4,1.08
14-10-2021,ALENQUER,18,1,40,"[0,120]",Baixo a Moderado,,,,18,Lisboa e Vale do Tejo,LISBOA,1101,30421.92,44052,2298,2062,1629,1330,1155,2485,4114,6176,8474,144.8,27.85,20.3,13.52
14-10-2021,ALFÂNDEGA DA FÉ,0,0,0,"[0,120]",Baixo a Moderado,,,,0,Norte,BRAGANÇA,0401,32194.64,4550,325,277,301,274,325,599,900,1177,1502,14.13,4.67,3.66,2.8
14-10-2021,ALIJÓ,39,3,370,"[240,480]",Elevado,,,,39,Norte,VILA REAL,1701,29759.89,10625,766,687,635,542,666,1208,1843,2530,3296,35.7,11.08,8.5,6.19
14-10-2021,ALJEZUR,2,0,36,"[0,120]",Baixo a Moderado,,,,2,Algarve,FARO,0803,32349.95,5594,316,336,335,320,410,730,1065,1401,1717,17.29,5.31,4.33,3.29
14-10-2021,ALJUSTREL,4,0,49,"[0,120]",Baixo a Moderado,,,,4,Alentejo,BEJA,0201,45847.41,8247,635,521,443,347,358,705,1148,1669,2304,17.99,5.03,3.64,2.5
14-10-2021,ALMADA,100,7,59,"[0,120]",Baixo a Moderado,,,,100,Lisboa e Vale do Tejo,SETÚBAL,1503,7000.89,169039,10469,9777,7876,6144,5111,11255,19131,28908,39377,2414.5,562.45,412.91,273.26
14-10-2021,ALMEIDA,0,0,0,"[0,120]",Baixo a Moderado,,,,0,Centro,GUARDA,0902,51798.46,5830,441,419,396,458,393,851,1247,1666,2107,11.26,4.07,3.22,2.41
14-10-2021,ALMEIRIM,52,4,232,"[120,240]",Moderado,,,,52,Lisboa e Vale do Tejo,SANTARÉM,1403,22212.05,22546,1342,1353,1106,866,843,1709,2815,4168,5510,101.5,24.81,18.76,12.67
14-10-2021,ALMODÔVAR,4,0,60,"[0,120]",Baixo a Moderado,,,,4,Alentejo,BEJA,0202,77788.03,6725,414,443,396,373,328,701,1097,1540,1954,8.65,2.51,1.98,1.41
14-10-2021,ALPIARÇA,7,1,100,"[0,120]",Baixo a Moderado,,,,7,Lisboa e Vale do Tejo,SANTARÉM,1404,9536.33,7059,515,486,363,333,274,607,970,1456,1971,74.02,20.67,15.27,10.17
14-10-2021,ALTER DO CHÃO,5,0,159,"[120,240]",Moderado,,,,5,Alentejo,PORTALEGRE,1201,36206.62,3165,201,163,136,208,187,395,531,694,895,8.74,2.47,1.92,1.47
14-10-2021,ALVAIÁZERE,1,0,15,"[0,120]",Baixo a Moderado,,,,1,Centro,LEIRIA,1002,16047.76,6597,419,389,346,406,539,945,1291,1680,2099,41.11,13.08,10.47,8.04
14-10-2021,ALVITO,73,5,2958,"[960,Max]",Extremamente Elevado,,,,73,Alentejo,BEJA,0203,26485.32,2477,145,110,105,111,89,200,305,415,560,9.35,2.11,1.57,1.15
14-10-2021,AMADORA,83,6,45,"[0,120]",Baixo a Moderado,,,,83,Lisboa e Vale do Tejo,LISBOA,1115,2378.47,184106,11186,10936,8780,6460,5890,12350,21130,32066,43252,7742.05,1818.84,1348.44,888.56
14-10-2021,AMARANTE,20,1,38,"[0,120]",Baixo a Moderado,,,,20,Norte,PORTO,1301,30133.15,53193,3086,2413,1812,1643,1311,2954,4766,7179,10265,176.53,34.07,23.82,15.82
14-10-2021,AMARES,9,1,50,"[0,120]",Baixo a Moderado,,,,9,Norte,BRAGA,0301,8195.41,18129,1001,829,622,489,524,1013,1635,2464,3465,221.22,42.28,30.07,19.95
14-10-2021,ANADIA,9,1,33,"[0,120]",Baixo a Moderado,,,,9,Centro,AVEIRO,0103,21663.48,27258,1931,1698,1376,1208,1262,2470,3846,5544,7475,125.83,34.51,25.59,17.75
14-10-2021,ANGRA DO HEROÍSMO,1,0,3,"[0,120]",Baixo a Moderado,,,,1,Açores,AÇORES,4301,23899.66,33807,2006,1473,1122,768,635,1403,2525,3998,6004,141.45,25.12,16.73,10.56
14-10-2021,ANSIÃO,1,0,8,"[0,120]",Baixo a Moderado,,,,1,Centro,LEIRIA,1003,17609.42,12039,727,709,646,694,530,1224,1870,2579,3306,68.37,18.77,14.65,10.62
14-10-2021,ARCOS DE VALDEVEZ,41,3,197,"[120,240]",Moderado,,,,41,Norte,VIANA DO CASTELO,1601,44759.64,20926,1329,1338,1282,1343,1515,2858,4140,5478,6807,46.75,15.21,12.24,9.25
14-10-2021,ARGANIL,77,6,701,"[480,960]",Muito Elevado,,,,77,Centro,COIMBRA,0601,33283.93,11014,672,648,612,559,596,1155,1767,2415,3087,33.09,9.27,7.26,5.31
14-10-2021,ARMAMAR,0,0,0,"[0,120]",Baixo a Moderado,,,,0,Norte,VISEU,1801,11723.73,5769,357,305,309,285,310,595,904,1209,1566,49.21,13.36,10.31,7.71
14-10-2021,AROUCA,114,8,548,"[480,960]",Muito Elevado,,,,114,Norte,AVEIRO,0104,32910.52,20720,1306,1047,753,683,683,1366,2119,3166,4472,62.96,13.59,9.62,6.44
14-10-2021,ARRAIOLOS,0,0,0,"[0,120]",Baixo a Moderado,,,,0,Alentejo,ÉVORA,0702,68374.55,6928,435,384,283,367,480,847,1130,1514,1949,10.13,2.85,2.21,1.65
14-10-2021,ARRONCHES,0,0,0,"[0,120]",Baixo a Moderado,,,,0,Alentejo,PORTALEGRE,1202,31464.72,2820,155,142,162,187,179,366,528,670,825,8.96,2.62,2.13,1.68
14-10-2021,ARRUDA DOS VINHOS,8,1,51,"[0,120]",Baixo a Moderado,,,,8,Lisboa e Vale do Tejo,LISBOA,1102,7795.93,15412,738,738,562,509,438,947,1509,2247,2985,197.69,38.29,28.82,19.36
14-10-2021,AVEIRO,54,4,69,"[0,120]",Baixo a Moderado,,,,54,Centro,AVEIRO,0105,19757.57,78734,4520,4004,3050,2250,2103,4353,7403,11407,15927,398.49,80.61,57.73,37.47
14-10-2021,AVIS,1,0,24,"[0,120]",Baixo a Moderado,,,,1,Alentejo,PORTALEGRE,1203,60596.51,4247,315,225,206,251,273,524,730,955,1270,7.01,2.1,1.58,1.2
14-10-2021,AZAMBUJA,20,1,88,"[0,120]",Baixo a Moderado,,,,20,Lisboa e Vale do Tejo,LISBOA,1103,26265.65,22716,1322,1171,1070,798,618,1416,2486,3657,4979,86.48,18.96,13.92,9.46
14-10-2021,BAIÃO,14,1,75,"[0,120]",Baixo a Moderado,,,,14,Norte,PORTO,1302,17452.83,18748,1070,862,714,686,725,1411,2125,2987,4057,107.42,23.25,17.11,12.18
14-10-2021,BARCELOS,40,3,34,"[0,120]",Baixo a Moderado,,,,40,Norte,BRAGA,0302,37890.14,116187,6721,5325,3619,2991,2562,5553,9172,14497,21218,306.64,56.0,38.26,24.21
14-10-2021,BARRANCOS,6,0,370,"[240,480]",Elevado,,,,6,Alentejo,BEJA,0204,16841.73,1634,90,65,65,94,61,155,220,285,375,9.7,2.23,1.69,1.31
14-10-2021,BARREIRO,25,2,33,"[0,120]",Baixo a Moderado,,,,25,Lisboa e Vale do Tejo,SETÚBAL,1504,3639.07,75147,5194,5565,4459,3105,1767,4872,9331,14896,20090,2065.05,552.07,409.34,256.42
14-10-2021,BATALHA,7,0,43,"[0,120]",Baixo a Moderado,,,,7,Centro,LEIRIA,1004,10341.6,15963,873,762,649,529,549,1078,1727,2489,3362,154.35,32.51,24.07,16.7
14-10-2021,BEJA,136,10,405,"[240,480]",Elevado,,,,136,Alentejo,BEJA,0205,114647.55,33579,2005,1840,1386,1272,1039,2311,3697,5537,7542,29.29,6.58,4.83,3.22
14-10-2021,BELMONTE,2,0,31,"[0,120]",Baixo a Moderado,,,,2,Centro,CASTELO BRANCO,0501,11875.91,6398,444,321,325,310,355,665,990,1311,1755,53.87,14.78,11.04,8.34
14-10-2021,BENAVENTE,18,1,59,"[0,120]",Baixo a Moderado,,,,18,Lisboa e Vale do Tejo,SANTARÉM,1405,52138.39,30602,1468,1376,1141,876,643,1519,2660,4036,5504,58.69,10.56,7.74,5.1
14-10-2021,BOMBARRAL,31,2,244,"[240,480]",Elevado,,,,31,Lisboa e Vale do Tejo,LEIRIA,1005,9128.55,12558,875,714,561,491,429,920,1481,2195,3070,137.56,33.63,24.04,16.22
14-10-2021,BORBA,0,0,0,"[0,120]",Baixo a Moderado,,,,0,Alentejo,ÉVORA,0703,14518.65,6736,430,375,279,436,392,828,1107,1482,1912,46.39,13.17,10.21,7.62
14-10-2021,BOTICAS,0,0,0,"[0,120]",Baixo a Moderado,,,,0,Norte,VILA REAL,1702,32195.66,4998,347,306,311,305,380,685,996,1302,1649,15.52,5.12,4.04,3.09
14-10-2021,BRAGA,181,13,99,"[0,120]",Baixo a Moderado,,,,181,Norte,BRAGA,0303,18339.95,182679,10029,7963,5241,4320,3671,7991,13232,21195,31224,996.07,170.25,115.57,72.15
14-10-2021,BRAGANÇA,16,1,48,"[0,120]",Baixo a Moderado,,,,16,Norte,BRAGANÇA,0402,117357.27,33607,2402,1855,1652,1393,1163,2556,4208,6063,8465,28.64,7.21,5.17,3.59
14-10-2021,CABECEIRAS DE BASTO,10,1,64,"[0,120]",Baixo a Moderado,,,,10,Norte,BRAGA,0304,24182.16,15628,774,594,544,575,574,1149,1693,2287,3061,64.63,12.66,9.46,7.0
14-10-2021,CADAVAL,8,1,58,"[0,120]",Baixo a Moderado,,,,8,Lisboa e Vale do Tejo,LISBOA,1104,17489.3,13673,813,796,756,621,625,1246,2002,2798,3611,78.18,20.65,16.0,11.45
14-10-2021,CALDAS DA RAINHA,115,8,221,"[120,240]",Moderado,,,,115,Lisboa e Vale do Tejo,LEIRIA,1006,25569.47,51912,3035,2684,2186,1899,1705,3604,5790,8474,11509,203.03,45.01,33.14,22.64
14-10-2021,CALHETA,7,1,65,"[0,120]",Baixo a Moderado,,,,7,Madeira,MADEIRA,3101,11150.43,10867,576,497,507,399,415,814,1321,1818,2394,97.46,21.47,16.3,11.85
14-10-2021,CALHETA (AÇORES),0,0,0,"[0,120]",Baixo a Moderado,,,,0,Açores,AÇORES,4501,12626.4,3184,215,159,141,139,122,261,402,561,776,25.22,6.15,4.44,3.18
14-10-2021,CÂMARA DE LOBOS,16,1,48,"[0,120]",Baixo a Moderado,,,,16,Madeira,MADEIRA,3102,5216.67,33675,1396,1059,834,545,381,926,1760,2819,4215,645.49,80.79,54.03,33.74
14-10-2021,CAMINHA,11,1,70,"[0,120]",Baixo a Moderado,,,,11,Norte,VIANA DO CASTELO,1602,13652.14,15877,1046,944,818,646,656,1302,2120,3064,4110,116.3,30.11,22.44,15.53
14-10-2021,CAMPO MAIOR,70,5,886,"[480,960]",Muito Elevado,,,,70,Alentejo,PORTALEGRE,1204,24720.16,7874,471,364,351,279,327,606,957,1321,1792,31.85,7.25,5.34,3.87
14-10-2021,CANTANHEDE,18,1,51,"[0,120]",Baixo a Moderado,,,,18,Centro,COIMBRA,0602,39088.02,35011,2346,2096,1880,1709,1451,3160,5040,7136,9482,89.57,24.26,18.26,12.89
14-10-2021,CARRAZEDA DE ANSIÃES,0,0,0,"[0,120]",Baixo a Moderado,,,,0,Norte,BRAGANÇA,0403,27924.09,5666,424,389,391,312,465,777,1168,1557,1981,20.29,7.09,5.58,4.18
14-10-2021,CARREGAL DO SAL,6,0,64,"[0,120]",Baixo a Moderado,,,,6,Centro,VISEU,1802,11689.21,9271,587,562,486,462,376,838,1324,1886,2473,79.31,21.16,16.13,11.33
14-10-2021,CARTAXO,11,1,46,"[0,120]",Baixo a Moderado,,,,11,Lisboa e Vale do Tejo,SANTARÉM,1406,15817.28,23843,1415,1376,1142,861,632,1493,2635,4011,5426,150.74,34.3,25.36,16.66
14-10-2021,CASCAIS,164,12,77,"[0,120]",Baixo a Moderado,,,,164,Lisboa e Vale do Tejo,LISBOA,1105,9740.17,213608,12151,11444,8680,6469,5248,11717,20397,31841,43992,2193.1,451.66,326.91,209.41
14-10-2021,CASTANHEIRA DE PÊRA,1,0,39,"[0,120]",Baixo a Moderado,,,,1,Centro,LEIRIA,1007,6677.45,2614,233,195,157,190,187,377,534,729,962,39.15,14.41,10.92,8.0
14-10-2021,CASTELO BRANCO,252,18,485,"[480,960]",Muito Elevado,,,,252,Centro,CASTELO BRANCO,0502,143819.15,51987,3528,3042,2499,2229,2225,4454,6953,9995,13523,36.15,9.4,6.95,4.83
14-10-2021,CASTELO DE PAIVA,2,0,13,"[0,120]",Baixo a Moderado,,,,2,Norte,AVEIRO,0106,11500.53,15454,881,697,545,420,431,851,1396,2093,2974,134.37,25.86,18.2,12.14
14-10-2021,CASTELO DE VIDE,0,0,0,"[0,120]",Baixo a Moderado,,,,0,Alentejo,PORTALEGRE,1205,26491.24,2919,204,173,179,147,170,317,496,669,873,11.02,3.3,2.53,1.87
14-10-2021,CASTRO DAIRE,10,1,72,"[0,120]",Baixo a Moderado,,,,10,Centro,VISEU,1803,37904.13,13823,942,857,765,732,773,1505,2270,3127,4069,36.47,10.74,8.25,5.99
14-10-2021,CASTRO MARIM,0,0,0,"[0,120]",Baixo a Moderado,,,,0,Algarve,FARO,0804,30084.37,6237,370,345,334,322,344,666,1000,1345,1715,20.73,5.7,4.47,3.32
14-10-2021,CASTRO VERDE,2,0,29,"[0,120]",Baixo a Moderado,,,,2,Alentejo,BEJA,0206,56944.23,6949,437,347,303,275,227,502,805,1152,1589,12.2,2.79,2.02,1.41
14-10-2021,CELORICO DA BEIRA,0,0,0,"[0,120]",Baixo a Moderado,,,,0,Centro,GUARDA,0903,24721.63,6928,430,416,363,369,535,904,1267,1683,2113,28.02,8.55,6.81,5.12
14-10-2021,CELORICO DE BASTO,5,0,26,"[0,120]",Baixo a Moderado,,,,5,Norte,BRAGA,0305,18107.02,19040,1001,802,668,728,729,1457,2125,2927,3928,105.15,21.69,16.17,11.74
14-10-2021,CHAMUSCA,8,1,88,"[0,120]",Baixo a Moderado,,,,8,Lisboa e Vale do Tejo,SANTARÉM,1407,74600.54,9197,629,583,553,465,579,1044,1597,2180,2809,12.33,3.77,2.92,2.14
14-10-2021,CHAVES,12,1,31,"[0,120]",Baixo a Moderado,,,,12,Norte,VILA REAL,1703,59122.95,39343,2676,2429,1991,1886,1918,3804,5795,8224,10900,66.54,18.44,13.91,9.8
14-10-2021,CINFÃES,5,0,28,"[0,120]",Baixo a Moderado,,,,5,Norte,VISEU,1804,23928.76,18244,1067,902,779,734,758,1492,2271,3173,4240,76.24,17.72,13.26,9.49
14-10-2021,COIMBRA,63,5,47,"[0,120]",Baixo a Moderado,,,,63,Centro,COIMBRA,0603,31939.94,134166,9489,8734,6353,5139,5074,10213,16566,25300,34789,420.06,108.92,79.21,51.87
14-10-2021,CONDEIXA-A-NOVA,5,0,28,"[0,120]",Baixo a Moderado,,,,5,Centro,COIMBRA,0604,13867.47,17733,871,809,717,583,490,1073,1790,2599,3470,127.88,25.02,18.74,12.91
14-10-2021,CONSTÂNCIA,0,0,0,"[0,120]",Baixo a Moderado,,,,0,Lisboa e Vale do Tejo,SANTARÉM,1408,8036.58,4030,211,183,187,148,155,303,490,673,884,50.14,11.0,8.37,6.1
14-10-2021,CORUCHE,9,1,52,"[0,120]",Baixo a Moderado,,,,9,Lisboa e Vale do Tejo,SANTARÉM,1409,111572.03,17471,1294,1090,1095,1096,1019,2115,3210,4300,5594,15.66,5.01,3.85,2.88
14-10-2021,CORVO,0,0,0,"[0,120]",Baixo a Moderado,,,,0,Açores,AÇORES,4901,1711.45,464,22,21,11,13,19,32,43,64,86,27.12,5.03,3.74,2.51
14-10-2021,COVILHÃ,80,6,171,"[120,240]",Moderado,,,,80,Centro,CASTELO BRANCO,0503,55560.06,46787,3533,2998,2365,2111,2193,4304,6669,9667,13200,84.21,23.76,17.4,12.0
14-10-2021,CRATO,0,0,0,"[0,120]",Baixo a Moderado,,,,0,Alentejo,PORTALEGRE,1206,39806.88,3129,229,258,163,182,228,410,573,831,1060,7.86,2.66,2.09,1.44
14-10-2021,CUBA,51,4,1100,"[960,Max]",Extremamente Elevado,,,,51,Alentejo,BEJA,0207,17208.72,4595,255,233,206,190,143,333,539,772,1027,26.7,5.97,4.49,3.13
14-10-2021,ELVAS,48,3,232,"[120,240]",Moderado,,,,48,Alentejo,PORTALEGRE,1207,63128.86,20528,1057,1145,902,852,810,1662,2564,3709,4766,32.52,7.55,5.88,4.06
14-10-2021,ENTRONCAMENTO,19,1,87,"[0,120]",Baixo a Moderado,,,,19,Lisboa e Vale do Tejo,SANTARÉM,1410,1372.81,21558,1066,930,868,695,592,1287,2155,3085,4151,1570.14,302.33,224.69,156.96
14-10-2021,ESPINHO,6,0,20,"[0,120]",Baixo a Moderado,,,,6,Norte,AVEIRO,0107,2105.68,29516,2205,1993,1430,1177,960,2137,3567,5560,7765,1401.52,368.71,264.01,169.37
14-10-2021,ESPOSENDE,28,2,82,"[0,120]",Baixo a Moderado,,,,28,Norte,BRAGA,0306,9540.98,34177,1831,1522,1095,894,723,1617,2712,4234,6065,358.21,63.57,44.38,28.42
14-10-2021,ESTARREJA,3,0,11,"[0,120]",Baixo a Moderado,,,,3,Centro,AVEIRO,0108,10817.33,26006,1503,1399,1106,953,728,1681,2787,4186,5689,240.42,52.59,38.7,25.76
14-10-2021,ESTREMOZ,18,1,143,"[120,240]",Moderado,,,,18,Alentejo,ÉVORA,0704,51379.95,12728,789,613,697,786,877,1663,2360,2973,3762,24.77,7.32,5.79,4.59
14-10-2021,ÉVORA,31,2,59,"[0,120]",Baixo a Moderado,,,,31,Alentejo,ÉVORA,0705,130707.58,52428,3569,2852,2176,1966,1803,3769,5945,8797,12366,40.11,9.46,6.73,4.55
14-10-2021,FAFE,74,5,155,"[120,240]",Moderado,,,,74,Norte,BRAGA,0307,21908.11,48060,3044,2455,1679,1403,1208,2611,4290,6745,9789,219.37,44.68,30.79,19.58
14-10-2021,FARO,32,2,52,"[0,120]",Baixo a Moderado,,,,32,Algarve,FARO,0805,20256.79,61015,3847,3364,2604,2055,1601,3656,6260,9624,13471,301.2,66.5,47.51,30.9
14-10-2021,FELGUEIRAS,31,2,55,"[0,120]",Baixo a Moderado,,,,31,Norte,PORTO,1303,11573.75,56422,2951,2302,1601,1316,973,2289,3890,6192,9143,487.49,79.0,53.5,33.61
14-10-2021,FERREIRA DO ALENTEJO,64,5,820,"[480,960]",Muito Elevado,,,,64,Alentejo,BEJA,0208,64820.68,7845,515,414,372,343,345,688,1060,1474,1989,12.1,3.07,2.27,1.64
14-10-2021,FERREIRA DO ZÊZERE,8,1,101,"[0,120]",Baixo a Moderado,,,,8,Lisboa e Vale do Tejo,SANTARÉM,1411,19038.03,7959,470,370,416,465,456,921,1337,1707,2177,41.81,11.44,8.97,7.02
14-10-2021,FIGUEIRA DA FOZ,43,3,73,"[0,120]",Baixo a Moderado,,,,43,Centro,COIMBRA,0605,37905.26,58747,4032,3597,2887,2495,2043,4538,7425,11022,15054,154.98,39.72,29.08,19.59
14-10-2021,FIGUEIRA DE CASTELO RODRIGO,2,0,36,"[0,120]",Baixo a Moderado,,,,2,Centro,GUARDA,0904,50857.46,5584,347,352,290,352,391,743,1033,1385,1732,10.98,3.41,2.72,2.03
14-10-2021,FIGUEIRÓ DOS VINHOS,1,0,18,"[0,120]",Baixo a Moderado,,,,1,Centro,LEIRIA,1008,17344.0,5568,402,386,322,309,351,660,982,1368,1770,32.1,10.21,7.89,5.66
14-10-2021,FORNOS DE ALGODRES,0,0,0,"[0,120]",Baixo a Moderado,,,,0,Centro,GUARDA,0905,13145.05,4528,261,218,247,256,232,488,735,953,1214,34.45,9.24,7.25,5.59
14-10-2021,FREIXO DE ESPADA À CINTA,0,0,0,"[0,120]",Baixo a Moderado,,,,0,Norte,BRAGANÇA,0404,24414.29,3298,211,177,231,196,189,385,616,793,1004,13.51,4.11,3.25,2.52
14-10-2021,FRONTEIRA,0,0,0,"[0,120]",Baixo a Moderado,,,,0,Alentejo,PORTALEGRE,1208,24859.58,2974,213,182,149,156,168,324,473,655,868,11.96,3.49,2.63,1.9
14-10-2021,FUNCHAL,95,7,91,"[0,120]",Baixo a Moderado,,,,95,Madeira,MADEIRA,3103,7616.2,104024,6382,5086,3643,2821,1990,4811,8454,13540,19922,1365.86,261.58,177.78,111.0
14-10-2021,FUNDÃO,18,1,68,"[0,120]",Baixo a Moderado,,,,18,Centro,CASTELO BRANCO,0504,70019.79,26495,1781,1464,1432,1357,1643,3000,4432,5896,7677,37.84,10.96,8.42,6.33
14-10-2021,GAVIÃO,0,0,0,"[0,120]",Baixo a Moderado,,,,0,Alentejo,PORTALEGRE,1209,29459.45,3263,189,186,222,263,293,556,778,964,1153,11.08,3.91,3.27,2.64
14-10-2021,GÓIS,3,0,80,"[0,120]",Baixo a Moderado,,,,3,Centro,COIMBRA,0606,26330.19,3805,235,199,240,233,244,477,717,916,1151,14.45,4.37,3.48,2.72
14-10-2021,GOLEGÃ,0,0,0,"[0,120]",Baixo a Moderado,,,,0,Lisboa e Vale do Tejo,SANTARÉM,1412,8431.67,5339,356,299,281,243,255,498,779,1078,1434,63.32,17.01,12.78,9.24
14-10-2021,GONDOMAR,103,7,62,"[0,120]",Baixo a Moderado,,,,103,Norte,PORTO,1304,13191.76,165985,10555,8755,6222,4450,3364,7814,14036,22791,33346,1258.22,252.77,172.76,106.4
14-10-2021,GOUVEIA,5,0,40,"[0,120]",Baixo a Moderado,,,,5,Centro,GUARDA,0906,30061.17,12387,871,931,780,783,810,1593,2373,3304,4175,41.21,13.89,10.99,7.89
14-10-2021,GRÂNDOLA,6,0,41,"[0,120]",Baixo a Moderado,,,,6,Alentejo,SETÚBAL,1505,82593.66,14639,834,834,708,688,672,1360,2068,2902,3736,17.72,4.52,3.51,2.5
14-10-2021,GUARDA,32,2,82,"[0,120]",Baixo a Moderado,,,,32,Centro,GUARDA,0907,71209.58,38969,2477,2041,1686,1415,1474,2889,4575,6616,9093,54.72,12.77,9.29,6.42
14-10-2021,GUIMARÃES,158,11,104,"[0,120]",Baixo a Moderado,,,,158,Norte,BRAGA,0308,24099.96,152309,9394,7074,4809,3877,2948,6825,11634,18708,28102,631.99,116.61,77.63,48.27
14-10-2021,HORTA,3,0,21,"[0,120]",Baixo a Moderado,,,,3,Açores,AÇORES,4701,17305.53,14521,818,658,468,352,302,654,1122,1780,2598,83.91,15.01,10.29,6.48
14-10-2021,IDANHA-A-NOVA,7,1,88,"[0,120]",Baixo a Moderado,,,,7,Centro,CASTELO BRANCO,0505,141633.51,8043,518,490,519,672,974,1646,2165,2655,3173,5.68,2.24,1.87,1.53
14-10-2021,ÍLHAVO,9,1,23,"[0,120]",Baixo a Moderado,,,,9,Centro,AVEIRO,0110,7347.55,38699,2227,1943,1444,1193,850,2043,3487,5430,7657,526.66,104.21,73.9,47.46
14-10-2021,LAGOA (FARO),37,3,163,"[120,240]",Moderado,,,,37,Algarve,FARO,0806,8825.45,22762,1314,1168,919,749,670,1419,2338,3506,4820,257.93,54.62,39.73,26.49
14-10-2021,LAGOA,13,1,88,"[0,120]",Baixo a Moderado,,,,13,Açores,AÇORES,4201,4559.32,14721,536,458,349,238,235,473,822,1280,1816,322.9,39.83,28.08,18.03
14-10-2021,LAGOS,82,6,271,"[240,480]",Elevado,,,,82,Algarve,FARO,0807,21299.27,30374,1744,1434,1247,1053,1029,2082,3329,4763,6507,142.61,30.55,22.36,15.63
14-10-2021,LAJES DAS FLORES,0,0,0,"[0,120]",Baixo a Moderado,,,,0,Açores,AÇORES,4801,7004.79,1463,88,53,62,46,54,100,162,215,303,20.89,4.33,3.07,2.31
14-10-2021,LAJES DO PICO,0,0,0,"[0,120]",Baixo a Moderado,,,,0,Açores,AÇORES,4601,15531.09,4490,304,231,223,159,162,321,544,775,1079,28.91,6.95,4.99,3.5
14-10-2021,LAMEGO,45,3,182,"[120,240]",Moderado,,,,45,Norte,VISEU,1805,16542.11,24895,1639,1284,1124,898,783,1681,2805,4089,5728,150.5,34.63,24.72,16.96
14-10-2021,LEIRIA,106,8,85,"[0,120]",Baixo a Moderado,,,,106,Centro,LEIRIA,1009,56508.83,125267,7389,6366,5090,3902,3159,7061,12151,18517,25906,221.68,45.84,32.77,21.5
14-10-2021,LISBOA,489,35,96,"[0,120]",Baixo a Moderado,,,,489,Lisboa e Vale do Tejo,LISBOA,1106,10005.43,509515,33197,33340,27706,23037,26770,49807,77513,110853,144050,5092.6,1439.78,1107.98,774.74
14-10-2021,LOULÉ,72,5,105,"[0,120]",Baixo a Moderado,,,,72,Algarve,FARO,0808,76366.91,68697,3890,3350,2780,2358,2251,4609,7389,10739,14629,89.96,19.16,14.06,9.68
14-10-2021,LOURES,135,10,63,"[0,120]",Baixo a Moderado,,,,135,Lisboa e Vale do Tejo,LISBOA,1107,16723.99,213687,12746,12794,9644,6669,5033,11702,21346,34140,46886,1277.73,280.35,204.14,127.64
14-10-2021,LOURINHÃ,27,2,103,"[0,120]",Baixo a Moderado,,,,27,Lisboa e Vale do Tejo,LISBOA,1108,14717.2,25855,1584,1243,992,842,645,1487,2479,3722,5306,175.68,36.05,25.29,16.84
14-10-2021,LOUSÃ,9,1,52,"[0,120]",Baixo a Moderado,,,,9,Centro,COIMBRA,0607,13840.01,17158,946,866,658,528,450,978,1636,2502,3448,123.97,24.91,18.08,11.82
14-10-2021,LOUSADA,6,0,13,"[0,120]",Baixo a Moderado,,,,6,Norte,PORTO,1305,9608.01,46755,2289,1698,1176,853,621,1474,2650,4348,6637,486.63,69.08,45.25,27.58
14-10-2021,MAÇÃO,5,0,81,"[0,120]",Baixo a Moderado,,,,5,Lisboa e Vale do Tejo,SANTARÉM,1413,39997.98,6267,386,362,390,440,657,1097,1487,1849,2235,15.67,5.59,4.62,3.72
14-10-2021,MACEDO DE CAVALEIROS,6,0,42,"[0,120]",Baixo a Moderado,,,,6,Norte,BRAGANÇA,0405,69914.08,14516,1082,889,878,823,938,1761,2639,3528,4610,20.76,6.59,5.05,3.77
14-10-2021,MACHICO,4,0,20,"[0,120]",Baixo a Moderado,,,,4,Madeira,MADEIRA,3104,6825.1,19981,1197,860,662,455,331,786,1448,2308,3505,292.76,51.36,33.82,21.22
14-10-2021,MADALENA,1,0,17,"[0,120]",Baixo a Moderado,,,,1,Açores,AÇORES,4602,14712.33,5895,334,256,173,190,179,369,542,798,1132,40.07,7.69,5.42,3.68
14-10-2021,MAFRA,41,3,48,"[0,120]",Baixo a Moderado,,,,41,Lisboa e Vale do Tejo,LISBOA,1109,29165.5,84816,3613,3334,2839,2089,1899,3988,6827,10161,13774,290.81,47.23,34.84,23.41
14-10-2021,MAIA,75,5,54,"[0,120]",Baixo a Moderado,,,,75,Norte,PORTO,1306,8293.94,138971,7801,6617,4512,3339,2631,5970,10482,17099,24900,1675.56,300.22,206.16,126.38
14-10-2021,MANGUALDE,7,1,38,"[0,120]",Baixo a Moderado,,,,7,Centro,VISEU,1806,21925.56,18510,1198,1128,885,852,743,1595,2480,3608,4806,84.42,21.92,16.46,11.31
14-10-2021,MANTEIGAS,4,0,134,"[120,240]",Moderado,,,,4,Centro,GUARDA,0908,12197.55,3007,258,197,159,167,146,313,472,669,927,24.65,7.6,5.48,3.87
14-10-2021,MARCO DE CANAVESES,38,3,74,"[0,120]",Baixo a Moderado,,,,38,Norte,PORTO,1307,20188.98,51496,2678,2060,1488,1265,1023,2288,3776,5836,8514,255.07,42.17,28.91,18.7
14-10-2021,MARINHA GRANDE,16,1,41,"[0,120]",Baixo a Moderado,,,,16,Centro,LEIRIA,1010,18725.19,38508,2365,2302,1638,1359,1058,2417,4055,6357,8722,205.65,46.58,33.95,21.66
14-10-2021,MARVÃO,0,0,0,"[0,120]",Baixo a Moderado,,,,0,Alentejo,PORTALEGRE,1210,15489.9,3005,198,185,142,197,237,434,576,761,959,19.4,6.19,4.91,3.72
14-10-2021,MATOSINHOS,84,6,48,"[0,120]",Baixo a Moderado,,,,84,Norte,PORTO,1308,6241.97,175357,11850,9977,7023,5024,3884,8908,15931,25908,37758,2809.31,604.9,415.06,255.22
14-10-2021,MEALHADA,8,1,40,"[0,120]",Baixo a Moderado,,,,8,Centro,AVEIRO,0111,11065.66,19914,1163,1039,810,828,831,1659,2469,3508,4671,179.96,42.21,31.7,22.31
14-10-2021,MÊDA,0,0,0,"[0,120]",Baixo a Moderado,,,,0,Centro,GUARDA,0909,28604.92,4587,343,306,290,288,443,731,1021,1327,1670,16.04,5.84,4.64,3.57
14-10-2021,MELGAÇO,8,1,100,"[0,120]",Baixo a Moderado,,,,8,Norte,VIANA DO CASTELO,1603,23824.58,8093,507,567,578,614,675,1289,1867,2434,2941,33.97,12.34,10.22,7.84
14-10-2021,MÉRTOLA,22,2,364,"[240,480]",Elevado,,,,22,Alentejo,BEJA,0209,129287.34,6142,400,390,378,423,600,1023,1401,1791,2191,4.75,1.69,1.39,1.08
14-10-2021,MESÃO FRIO,11,1,279,"[240,480]",Elevado,,,,11,Norte,VILA REAL,1704,2664.87,3964,265,205,168,157,120,277,445,650,915,148.74,34.33,24.39,16.7
14-10-2021,MIRA,6,0,51,"[0,120]",Baixo a Moderado,,,,6,Centro,COIMBRA,0608,12403.38,11832,727,729,659,550,466,1016,1675,2404,3131,95.4,25.24,19.38,13.5
14-10-2021,MIRANDA DO CORVO,15,1,118,"[0,120]",Baixo a Moderado,,,,15,Centro,COIMBRA,0609,12637.79,12708,706,659,568,498,404,902,1470,2129,2835,100.55,22.43,16.85,11.63
14-10-2021,MIRANDA DO DOURO,11,1,163,"[120,240]",Moderado,,,,11,Norte,BRAGANÇA,0406,48718.31,6830,482,429,442,463,470,933,1375,1804,2286,14.02,4.69,3.7,2.82
14-10-2021,MIRANDELA,29,2,134,"[120,240]",Moderado,,,,29,Norte,BRAGANÇA,0407,65895.67,21754,1640,1315,1204,1078,947,2025,3229,4544,6184,33.01,9.38,6.9,4.9
14-10-2021,MOGADOURO,4,0,48,"[0,120]",Baixo a Moderado,,,,4,Norte,BRAGANÇA,0408,76064.93,8392,589,529,576,630,655,1285,1861,2390,2979,11.03,3.92,3.14,2.45
14-10-2021,MOIMENTA DA BEIRA,15,1,154,"[120,240]",Moderado,,,,15,Norte,VISEU,1807,21996.9,9736,576,514,471,416,461,877,1348,1862,2438,44.26,11.08,8.46,6.13
14-10-2021,MOITA,27,2,42,"[0,120]",Baixo a Moderado,,,,27,Lisboa e Vale do Tejo,SETÚBAL,1506,5525.98,64407,4226,3646,2623,1801,1425,3226,5849,9495,13721,1165.53,248.3,171.82,105.85
14-10-2021,MONÇÃO,29,2,164,"[120,240]",Moderado,,,,29,Norte,VIANA DO CASTELO,1604,21130.85,17869,1161,1105,1031,1006,972,1978,3009,4114,5275,84.56,24.96,19.47,14.24
14-10-2021,MONCHIQUE,10,1,201,"[120,240]",Moderado,,,,10,Algarve,FARO,0809,39530.43,5077,353,384,321,355,392,747,1068,1452,1805,12.84,4.57,3.67,2.7
14-10-2021,MONDIM DE BASTO,0,0,0,"[0,120]",Baixo a Moderado,,,,0,Norte,VILA REAL,1705,17207.52,6946,395,300,314,284,283,567,881,1181,1576,40.36,9.16,6.86,5.12
14-10-2021,MONFORTE,2,0,68,"[0,120]",Baixo a Moderado,,,,2,Alentejo,PORTALEGRE,1211,42024.82,2975,139,115,117,192,168,360,477,592,731,7.08,1.74,1.41,1.14
14-10-2021,MONTALEGRE,9,1,101,"[0,120]",Baixo a Moderado,,,,9,Norte,VILA REAL,1706,80545.71,8997,699,628,595,603,730,1333,1928,2556,3255,11.17,4.04,3.17,2.39
14-10-2021,MONTEMOR-O-NOVO,21,2,136,"[120,240]",Moderado,,,,21,Alentejo,ÉVORA,0706,123296.65,15647,991,953,868,878,971,1849,2717,3670,4661,12.69,3.78,2.98,2.2
14-10-2021,MONTEMOR-O-VELHO,23,2,91,"[0,120]",Baixo a Moderado,,,,23,Centro,COIMBRA,0610,22896.23,25224,1496,1397,1217,1057,988,2045,3262,4659,6155,110.17,26.88,20.35,14.25
14-10-2021,MONTIJO,24,2,41,"[0,120]",Baixo a Moderado,,,,24,Lisboa e Vale do Tejo,SETÚBAL,1507,34861.64,57614,2771,2441,1990,1554,1109,2663,4653,7094,9865,165.26,28.3,20.35,13.35
14-10-2021,MORA,8,1,198,"[120,240]",Moderado,,,,8,Alentejo,ÉVORA,0707,44395.02,4138,336,275,252,238,257,495,747,1022,1358,9.32,3.06,2.3,1.68
14-10-2021,MORTÁGUA,1,0,11,"[0,120]",Baixo a Moderado,,,,1,Centro,VISEU,1808,25117.82,8803,638,584,535,499,460,959,1494,2078,2716,35.05,10.81,8.27,5.95
14-10-2021,MOURA,20,1,147,"[120,240]",Moderado,,,,20,Alentejo,BEJA,0210,95845.55,13718,817,656,665,542,461,1003,1668,2324,3141,14.31,3.28,2.42,1.74
14-10-2021,MOURÃO,1,0,41,"[0,120]",Baixo a Moderado,,,,1,Alentejo,ÉVORA,0708,27862.98,2450,139,108,80,104,109,213,293,401,540,8.79,1.94,1.44,1.05
14-10-2021,MURÇA,6,0,111,"[0,120]",Baixo a Moderado,,,,6,Norte,VILA REAL,1707,18937.11,5463,384,341,307,306,319,625,932,1273,1657,28.85,8.75,6.72,4.92
14-10-2021,MURTOSA,6,0,58,"[0,120]",Baixo a Moderado,,,,6,Centro,AVEIRO,0112,7308.78,10279,509,473,403,353,409,762,1165,1638,2147,140.63,29.37,22.41,15.94
14-10-2021,NAZARÉ,19,1,133,"[120,240]",Moderado,,,,19,Lisboa e Vale do Tejo,LEIRIA,1011,8243.43,14165,967,903,670,420,396,816,1486,2389,3356,171.84,40.71,28.98,18.03
14-10-2021,NELAS,7,1,54,"[0,120]",Baixo a Moderado,,,,7,Centro,VISEU,1809,12571.48,12974,924,787,668,604,583,1187,1855,2642,3566,103.21,28.37,21.02,14.76
14-10-2021,NISA,4,0,67,"[0,120]",Baixo a Moderado,,,,4,Alentejo,PORTALEGRE,1212,57567.84,6061,405,389,355,483,478,961,1316,1705,2110,10.53,3.67,2.96,2.29
14-10-2021,NORDESTE,6,0,125,"[120,240]",Moderado,,,,6,Açores,AÇORES,4202,10146.8,4862,246,180,124,161,162,323,447,627,873,47.92,8.6,6.18,4.41
14-10-2021,ÓBIDOS,8,1,67,"[0,120]",Baixo a Moderado,,,,8,Lisboa e Vale do Tejo,LEIRIA,1012,14155.44,11850,743,650,574,452,436,888,1462,2112,2855,83.72,20.17,14.92,10.33
14-10-2021,ODEMIRA,17,1,69,"[0,120]",Baixo a Moderado,,,,17,Alentejo,BEJA,0211,172060.15,24717,1475,1317,1225,1397,1349,2746,3971,5288,6763,14.37,3.93,3.07,2.31
14-10-2021,ODIVELAS,100,7,62,"[0,120]",Baixo a Moderado,,,,100,Lisboa e Vale do Tejo,LISBOA,1116,2654.36,161774,9562,9038,6952,4641,3812,8453,15405,24443,34005,6095.48,1281.27,920.99,580.44
14-10-2021,OEIRAS,112,8,63,"[0,120]",Baixo a Moderado,,,,112,Lisboa e Vale do Tejo,LISBOA,1110,4588.31,177408,11580,11575,8566,6211,5855,12066,20632,32207,43787,3866.78,954.38,701.98,449.69
14-10-2021,OLEIROS,3,0,60,"[0,120]",Baixo a Moderado,,,,3,Centro,CASTELO BRANCO,0506,47109.31,5003,384,341,366,397,487,884,1250,1591,1975,10.62,4.19,3.38,2.65
14-10-2021,OLHÃO,25,2,57,"[0,120]",Baixo a Moderado,,,,25,Algarve,FARO,0810,13086.38,44405,2455,2309,1689,1342,1268,2610,4299,6608,9063,339.33,69.26,50.5,32.85
14-10-2021,OLIVEIRA DE AZEMÉIS,67,5,102,"[0,120]",Baixo a Moderado,,,,67,Norte,AVEIRO,0113,16110.41,66011,4155,3614,2794,2183,1738,3921,6715,10329,14484,409.75,89.91,64.12,41.68
14-10-2021,OLIVEIRA DE FRADES,1,0,10,"[0,120]",Baixo a Moderado,,,,1,Centro,VISEU,1810,14534.62,9936,553,475,438,359,415,774,1212,1687,2240,68.36,15.41,11.61,8.34
14-10-2021,OLIVEIRA DO BAIRRO,5,0,20,"[0,120]",Baixo a Moderado,,,,5,Centro,AVEIRO,0114,8731.99,24277,1327,1182,999,786,810,1596,2595,3777,5104,278.02,58.45,43.25,29.72
14-10-2021,OLIVEIRA DO HOSPITAL,36,3,187,"[120,240]",Moderado,,,,36,Centro,COIMBRA,0611,23451.66,19253,1161,1097,962,924,960,1884,2846,3943,5104,82.1,21.76,16.81,12.14
14-10-2021,OURÉM,34,2,77,"[0,120]",Baixo a Moderado,,,,34,Lisboa e Vale do Tejo,SANTARÉM,1421,41668.03,44044,2463,2069,1899,1817,1603,3420,5319,7388,9851,105.7,23.64,17.73,12.77
14-10-2021,OURIQUE,0,0,0,"[0,120]",Baixo a Moderado,,,,0,Alentejo,BEJA,0212,66331.36,4607,313,287,284,268,227,495,779,1066,1379,6.95,2.08,1.61,1.17
14-10-2021,OVAR,12,1,22,"[0,120]",Baixo a Moderado,,,,12,Centro,AVEIRO,0115,14770.25,54260,3294,2709,1994,1636,1234,2870,4864,7573,10867,367.37,73.57,51.27,32.93
14-10-2021,PAÇOS DE FERREIRA,14,1,25,"[0,120]",Baixo a Moderado,,,,14,Norte,PORTO,1309,7099.29,56728,2903,2193,1518,1135,664,1799,3317,5510,8413,799.1,118.51,77.62,46.72
14-10-2021,PALMELA,33,2,51,"[0,120]",Baixo a Moderado,,,,33,Lisboa e Vale do Tejo,SETÚBAL,1508,46512.01,64269,3402,3244,2635,1846,1391,3237,5872,9116,12518,138.18,26.91,19.6,12.62
14-10-2021,PAMPILHOSA DA SERRA,2,0,50,"[0,120]",Baixo a Moderado,,,,2,Centro,COIMBRA,0612,39646.24,4037,238,254,295,339,423,762,1057,1311,1549,10.18,3.91,3.31,2.67
14-10-2021,PAREDES,40,3,47,"[0,120]",Baixo a Moderado,,,,40,Norte,PORTO,1310,15675.69,86067,4272,3532,2412,1717,1258,2975,5387,8919,13191,549.04,84.15,56.9,34.36
14-10-2021,PAREDES DE COURA,3,0,35,"[0,120]",Baixo a Moderado,,,,3,Norte,VIANA DO CASTELO,1605,13818.59,8535,466,528,407,465,515,980,1387,1915,2381,61.76,17.23,13.86,10.04
14-10-2021,PEDRÓGÃO GRANDE,25,2,732,"[480,960]",Muito Elevado,,,,25,Centro,LEIRIA,1013,12874.75,3410,175,173,196,221,252,473,669,842,1017,26.49,7.9,6.54,5.2
14-10-2021,PENACOVA,2,0,15,"[0,120]",Baixo a Moderado,,,,2,Centro,COIMBRA,0613,21673.23,13694,968,923,745,621,703,1324,2069,2992,3960,63.18,18.27,13.81,9.55
14-10-2021,PENAFIEL,29,2,42,"[0,120]",Baixo a Moderado,,,,29,Norte,PORTO,1311,21224.27,69772,3648,2823,2032,1663,1230,2893,4925,7748,11396,328.74,53.69,36.51,23.2
14-10-2021,PENALVA DO CASTELO,8,1,112,"[0,120]",Baixo a Moderado,,,,8,Centro,VISEU,1811,13433.92,7115,449,457,413,391,426,817,1230,1687,2136,52.96,15.9,12.56,9.16
14-10-2021,PENAMACOR,7,1,148,"[120,240]",Moderado,,,,7,Centro,CASTELO BRANCO,0507,56370.69,4755,262,248,273,451,633,1084,1357,1605,1867,8.44,3.31,2.85,2.41
14-10-2021,PENEDONO,30,2,1166,"[960,Max]",Extremamente Elevado,,,,30,Norte,VISEU,1812,13370.75,2591,172,113,129,156,138,294,423,536,708,19.38,5.3,4.01,3.16
14-10-2021,PENELA,0,0,0,"[0,120]",Baixo a Moderado,,,,0,Centro,COIMBRA,0614,13480.0,5397,314,324,274,359,344,703,977,1301,1615,40.04,11.98,9.65,7.25
14-10-2021,PENICHE,11,1,41,"[0,120]",Baixo a Moderado,,,,11,Lisboa e Vale do Tejo,LEIRIA,1014,7754.98,26501,1746,1504,1203,926,707,1633,2836,4340,6086,341.73,78.48,55.96,36.57
14-10-2021,PESO DA RÉGUA,19,1,121,"[120,240]",Moderado,,,,19,Norte,VILA REAL,1708,9486.01,15773,1076,843,650,659,455,1114,1764,2607,3683,166.28,38.83,27.48,18.6
14-10-2021,PINHEL,2,0,24,"[0,120]",Baixo a Moderado,,,,2,Centro,GUARDA,0910,48452.12,8511,577,566,551,538,689,1227,1778,2344,2921,17.57,6.03,4.84,3.67
14-10-2021,POMBAL,31,2,60,"[0,120]",Baixo a Moderado,,,,31,Centro,LEIRIA,1015,62600.28,51461,3187,2791,2494,2328,2027,4355,6849,9640,12827,82.21,20.49,15.4,10.94
14-10-2021,PONTA DELGADA,113,8,167,"[120,240]",Moderado,,,,113,Açores,AÇORES,4203,23298.65,67935,3108,2435,1726,1133,902,2035,3761,6196,9304,291.58,39.93,26.59,16.14
14-10-2021,PONTA DO SOL,1,0,12,"[0,120]",Baixo a Moderado,,,,1,Madeira,MADEIRA,3105,4622.03,8593,319,283,347,208,221,429,776,1059,1378,185.92,29.81,22.91,16.79
14-10-2021,PONTE DA BARCA,4,0,36,"[0,120]",Baixo a Moderado,,,,4,Norte,VIANA DO CASTELO,1606,18211.37,11180,635,576,517,554,490,1044,1561,2137,2772,61.39,15.22,11.73,8.57
14-10-2021,PONTE DE LIMA,8,1,19,"[0,120]",Baixo a Moderado,,,,8,Norte,VIANA DO CASTELO,1607,32025.46,41315,2321,2022,1720,1596,1462,3058,4778,6800,9121,129.01,28.48,21.23,14.92
14-10-2021,PONTE DE SOR,1,0,7,"[0,120]",Baixo a Moderado,,,,1,Alentejo,PORTALEGRE,1213,83971.16,14994,939,800,716,739,831,1570,2286,3086,4025,17.86,4.79,3.68,2.72
14-10-2021,PORTALEGRE,4,0,18,"[0,120]",Baixo a Moderado,,,,4,Alentejo,PORTALEGRE,1214,44713.64,22172,1577,1351,1137,993,984,1977,3114,4465,6042,49.59,13.51,9.99,6.96
14-10-2021,PORTEL,6,0,104,"[0,120]",Baixo a Moderado,,,,6,Alentejo,ÉVORA,0709,60100.57,5828,336,358,283,331,305,636,919,1277,1613,9.7,2.68,2.12,1.53
14-10-2021,PORTIMÃO,143,10,257,"[240,480]",Elevado,,,,143,Algarve,FARO,0811,18206.29,55483,3182,2927,2116,1582,1400,2982,5098,8025,11207,304.75,61.56,44.08,28.0
14-10-2021,PORTO,236,17,109,"[0,120]",Baixo a Moderado,,,,236,Norte,PORTO,1312,4142.02,216606,15790,15193,11280,9409,10044,19453,30733,45926,61716,5229.5,1490.0,1108.79,741.98
14-10-2021,PORTO DE MÓS,7,0,30,"[0,120]",Baixo a Moderado,,,,7,Centro,LEIRIA,1016,26183.41,23275,1355,1210,1034,888,872,1760,2794,4004,5359,88.89,20.47,15.29,10.67
14-10-2021,PORTO MONIZ,7,1,303,"[240,480]",Elevado,,,,7,Madeira,MADEIRA,3106,8293.38,2342,143,130,95,98,120,218,313,443,586,28.24,7.07,5.34,3.77
14-10-2021,PORTO SANTO,1,0,19,"[0,120]",Baixo a Moderado,,,,1,Madeira,MADEIRA,3201,4300.7,5202,240,157,134,110,68,178,312,469,709,120.95,16.48,10.9,7.25
14-10-2021,PÓVOA DE LANHOSO,11,1,51,"[0,120]",Baixo a Moderado,,,,11,Norte,BRAGA,0309,13465.29,21499,1175,909,732,673,624,1297,2029,2938,4113,159.67,30.55,21.82,15.07
14-10-2021,PÓVOA DE VARZIM,19,1,30,"[0,120]",Baixo a Moderado,,,,19,Norte,PORTO,1313,8220.59,62784,3712,3120,2134,1594,1305,2899,5033,8153,11865,763.7,144.33,99.17,61.22
14-10-2021,POVOAÇÃO,0,0,0,"[0,120]",Baixo a Moderado,,,,0,Açores,AÇORES,4204,10640.77,5927,293,212,191,144,134,278,469,681,974,55.7,9.15,6.4,4.41
14-10-2021,VILA DA PRAIA DA VITÓRIA,0,0,0,"[0,120]",Baixo a Moderado,,,,0,Açores,AÇORES,4302,16127.06,21317,1133,789,619,436,336,772,1391,2180,3313,132.18,20.54,13.52,8.63
14-10-2021,PROENÇA-A-NOVA,38,3,525,"[480,960]",Muito Elevado,,,,38,Centro,CASTELO BRANCO,0508,39539.96,7298,508,465,389,400,560,960,1349,1814,2322,18.46,5.87,4.59,3.41
14-10-2021,REDONDO,13,1,207,"[120,240]",Moderado,,,,13,Alentejo,ÉVORA,0710,36950.87,6353,349,325,288,288,354,642,930,1255,1604,17.19,4.34,3.4,2.52
14-10-2021,REGUENGOS DE MONSARAZ,52,4,524,"[480,960]",Muito Elevado,,,,52,Alentejo,ÉVORA,0711,46399.72,10015,602,511,455,462,473,935,1390,1901,2503,21.58,5.39,4.1,3.0
14-10-2021,RESENDE,30,2,299,"[240,480]",Elevado,,,,30,Norte,VISEU,1813,12334.93,10137,560,493,448,433,422,855,1303,1796,2356,82.18,19.1,14.56,10.56
14-10-2021,RIBEIRA BRAVA,4,0,32,"[0,120]",Baixo a Moderado,,,,4,Madeira,MADEIRA,3107,6544.88,12435,648,500,411,311,287,598,1009,1509,2157,189.99,32.96,23.06,15.42
14-10-2021,RIBEIRA DE PENA,2,0,33,"[0,120]",Baixo a Moderado,,,,2,Norte,VILA REAL,1709,21745.98,6016,371,301,290,310,368,678,968,1269,1640,27.66,7.54,5.84,4.45
14-10-2021,RIBEIRA GRANDE,88,6,268,"[240,480]",Elevado,,,,88,Açores,AÇORES,4205,18015.13,32811,1163,689,512,345,253,598,1110,1799,2962,182.13,16.44,9.99,6.16
14-10-2021,RIO MAIOR,93,7,458,"[240,480]",Elevado,,,,93,Lisboa e Vale do Tejo,SANTARÉM,1414,27276.45,20379,1251,1144,941,795,648,1443,2384,3528,4779,74.71,17.52,12.93,8.74
14-10-2021,SABROSA,3,0,51,"[0,120]",Baixo a Moderado,,,,3,Norte,VILA REAL,1710,15692.45,5918,393,314,304,302,350,652,956,1270,1663,37.71,10.6,8.09,6.09
14-10-2021,SABUGAL,24,2,228,"[120,240]",Moderado,,,,24,Centro,GUARDA,0911,82269.82,10585,724,707,694,796,1009,1805,2499,3206,3930,12.87,4.78,3.9,3.04
14-10-2021,SALVATERRA DE MAGOS,2,0,9,"[0,120]",Baixo a Moderado,,,,2,Lisboa e Vale do Tejo,SANTARÉM,1415,24393.2,21295,1275,1181,1060,799,772,1571,2631,3812,5087,87.3,20.85,15.63,10.79
14-10-2021,SANTA COMBA DÃO,0,0,0,"[0,120]",Baixo a Moderado,,,,0,Centro,VISEU,1814,11194.77,10452,732,684,569,538,464,1002,1571,2255,2987,93.36,26.68,20.14,14.03
14-10-2021,SANTA CRUZ,18,1,39,"[0,120]",Baixo a Moderado,,,,18,Madeira,MADEIRA,3108,8150.28,45281,1817,1301,974,716,523,1239,2213,3514,5331,555.6,65.41,43.12,27.15
14-10-2021,SANTA CRUZ DA GRACIOSA,0,0,0,"[0,120]",Baixo a Moderado,,,,0,Açores,AÇORES,4401,6065.78,4208,228,180,163,124,145,269,432,612,840,69.37,13.85,10.09,7.12
14-10-2021,SANTA CRUZ DAS FLORES,0,0,0,"[0,120]",Baixo a Moderado,,,,0,Açores,AÇORES,4802,7091.44,2165,125,98,74,56,51,107,181,279,404,30.53,5.7,3.93,2.55
14-10-2021,SANTA MARIA DA FEIRA,85,6,61,"[0,120]",Baixo a Moderado,,,,85,Norte,AVEIRO,0109,21587.65,138636,8182,6743,4771,3856,3079,6935,11706,18449,26631,642.19,123.36,85.46,54.22
14-10-2021,SANTA MARTA DE PENAGUIÃO,31,2,473,"[240,480]",Elevado,,,,31,Norte,VILA REAL,1711,6928.13,6599,483,373,337,316,317,633,970,1343,1826,95.25,26.36,19.39,14.0
14-10-2021,SANTANA,0,0,0,"[0,120]",Baixo a Moderado,,,,0,Madeira,MADEIRA,3109,9547.3,6711,418,353,343,282,277,559,902,1255,1673,70.29,17.52,13.15,9.45
14-10-2021,SANTARÉM,75,5,130,"[120,240]",Moderado,,,,75,Lisboa e Vale do Tejo,SANTARÉM,1416,55253.58,57421,3654,3441,2760,2466,2206,4672,7432,10873,14527,103.92,26.29,19.68,13.45
14-10-2021,SANTIAGO DO CACÉM,21,2,73,"[0,120]",Baixo a Moderado,,,,21,Alentejo,SETÚBAL,1509,105969.29,28791,2144,1689,1472,1295,1215,2510,3982,5671,7815,27.17,7.37,5.35,3.76
14-10-2021,SANTO TIRSO,33,2,49,"[0,120]",Baixo a Moderado,,,,33,Norte,PORTO,1314,13655.52,68055,4911,3935,2761,2257,1810,4067,6828,10763,15674,498.35,114.78,78.82,50.0
14-10-2021,SÃO BRÁS DE ALPORTEL,12,1,116,"[0,120]",Baixo a Moderado,,,,12,Algarve,FARO,0812,15336.92,10416,596,468,467,404,401,805,1272,1740,2336,67.91,15.23,11.35,8.29
14-10-2021,SÃO JOÃO DA MADEIRA,33,2,150,"[120,240]",Moderado,,,,33,Norte,AVEIRO,0116,794.3,21958,1347,1069,796,601,593,1194,1990,3059,4406,2765.49,554.91,385.26,250.63
14-10-2021,SÃO JOÃO DA PESQUEIRA,0,0,0,"[0,120]",Baixo a Moderado,,,,0,Norte,VISEU,1815,26610.85,7125,417,330,294,328,328,656,950,1280,1697,26.77,6.38,4.81,3.57
14-10-2021,SÃO PEDRO DO SUL,49,3,318,"[240,480]",Elevado,,,,49,Centro,VISEU,1816,34895.09,15403,990,962,861,759,909,1668,2529,3491,4481,44.14,12.84,10.0,7.25
14-10-2021,SÃO ROQUE DO PICO,0,0,0,"[0,120]",Baixo a Moderado,,,,0,Açores,AÇORES,4603,14236.1,3266,199,141,93,96,113,209,302,443,642,22.94,4.51,3.11,2.12
14-10-2021,SÃO VICENTE,2,0,39,"[0,120]",Baixo a Moderado,,,,2,Madeira,MADEIRA,3110,7883.71,5143,272,264,266,225,280,505,771,1035,1307,65.23,16.58,13.13,9.78
14-10-2021,SARDOAL,3,0,81,"[0,120]",Baixo a Moderado,,,,3,Lisboa e Vale do Tejo,SANTARÉM,1417,9214.72,3741,227,178,148,165,248,413,561,739,966,40.6,10.48,8.02,6.09
14-10-2021,SÁTÃO,3,0,26,"[0,120]",Baixo a Moderado,,,,3,Centro,VISEU,1817,20194.11,11580,765,671,515,465,476,941,1456,2127,2892,57.34,14.32,10.53,7.21
14-10-2021,SEIA,45,3,203,"[120,240]",Moderado,,,,45,Centro,GUARDA,0912,43568.83,22234,1807,1589,1238,1122,721,1843,3081,4670,6477,51.03,14.87,10.72,7.07
14-10-2021,SEIXAL,96,7,57,"[0,120]",Baixo a Moderado,,,,96,Lisboa e Vale do Tejo,SETÚBAL,1510,9545.17,167752,10586,9270,6661,4391,2930,7321,13982,23252,33838,1757.49,354.51,243.6,146.49
14-10-2021,SERNANCELHE,2,0,37,"[0,120]",Baixo a Moderado,,,,2,Norte,VISEU,1818,22861.22,5396,305,293,286,273,260,533,819,1112,1417,23.6,6.2,4.86,3.58
14-10-2021,SERPA,18,1,127,"[120,240]",Moderado,,,,18,Alentejo,BEJA,0213,110563.34,14304,903,761,719,697,626,1323,2042,2803,3706,12.94,3.35,2.54,1.85
14-10-2021,SERTÃ,32,2,220,"[120,240]",Moderado,,,,32,Centro,CASTELO BRANCO,0509,44673.17,14577,870,779,790,767,1020,1787,2577,3356,4226,32.63,9.46,7.51,5.77
14-10-2021,SESIMBRA,32,2,62,"[0,120]",Baixo a Moderado,,,,32,Lisboa e Vale do Tejo,SETÚBAL,1511,19571.75,51858,2400,2321,1853,1257,1083,2340,4193,6514,8914,264.96,45.54,33.28,21.42
14-10-2021,SETÚBAL,53,4,46,"[0,120]",Baixo a Moderado,,,,53,Lisboa e Vale do Tejo,SETÚBAL,1512,23032.5,115126,7425,6929,5075,3775,2655,6430,11505,18434,25859,499.83,112.27,80.03,49.95
14-10-2021,SEVER DO VOUGA,2,0,18,"[0,120]",Baixo a Moderado,,,,2,Centro,AVEIRO,0117,12987.56,11331,766,637,568,540,567,1107,1675,2312,3078,87.24,23.7,17.8,12.9
14-10-2021,SILVES,59,4,163,"[120,240]",Moderado,,,,59,Algarve,FARO,0813,68006.23,36226,2137,1869,1610,1423,1600,3023,4633,6502,8639,53.27,12.7,9.56,6.81
14-10-2021,SINES,9,1,66,"[0,120]",Baixo a Moderado,,,,9,Alentejo,SETÚBAL,1513,20330.17,13715,888,791,551,416,268,684,1235,2026,2914,67.46,14.33,9.97,6.07
14-10-2021,SINTRA,168,12,43,"[0,120]",Baixo a Moderado,,,,168,Lisboa e Vale do Tejo,LISBOA,1111,31922.73,391402,20490,18316,13545,9137,7284,16421,29966,48282,68772,1226.08,215.43,151.25,93.87
14-10-2021,SOBRAL DE MONTE AGRAÇO,7,0,65,"[0,120]",Baixo a Moderado,,,,7,Lisboa e Vale do Tejo,LISBOA,1112,5210.32,10651,564,507,352,272,212,484,836,1343,1907,204.43,36.6,25.78,16.05
14-10-2021,SOURE,5,0,29,"[0,120]",Baixo a Moderado,,,,5,Centro,COIMBRA,0615,26506.07,17120,1173,1142,1004,883,987,1870,2874,4016,5189,64.59,19.58,15.15,10.84
14-10-2021,SOUSEL,4,0,92,"[0,120]",Baixo a Moderado,,,,4,Alentejo,PORTALEGRE,1215,27932.18,4412,261,274,208,302,292,594,802,1076,1337,15.8,4.79,3.85,2.87
14-10-2021,TÁBUA,8,1,70,"[0,120]",Baixo a Moderado,,,,8,Centro,COIMBRA,0616,19978.58,11368,729,584,524,430,464,894,1418,2002,2731,56.9,13.67,10.02,7.1
14-10-2021,TABUAÇO,0,0,0,"[0,120]",Baixo a Moderado,,,,0,Norte,VISEU,1819,13385.67,6033,372,314,217,282,363,645,862,1176,1548,45.07,11.56,8.79,6.44
14-10-2021,TAROUCA,4,0,51,"[0,120]",Baixo a Moderado,,,,4,Norte,VISEU,1820,10008.49,7804,405,335,313,277,324,601,914,1249,1654,77.98,16.53,12.48,9.13
14-10-2021,TAVIRA,17,1,70,"[0,120]",Baixo a Moderado,,,,17,Algarve,FARO,0814,60696.7,24530,1493,1415,1252,1066,1277,2343,3595,5010,6503,40.41,10.71,8.25,5.92
14-10-2021,TERRAS DE BOURO,0,0,0,"[0,120]",Baixo a Moderado,,,,0,Norte,BRAGA,0310,27746.07,6361,391,372,296,319,340,659,955,1327,1718,22.93,6.19,4.78,3.44
14-10-2021,TOMAR,25,2,68,"[0,120]",Baixo a Moderado,,,,25,Lisboa e Vale do Tejo,SANTARÉM,1418,35120.44,36748,2403,2189,1868,1853,1822,3675,5543,7732,10135,104.64,28.86,22.02,15.78
14-10-2021,TONDELA,34,2,129,"[120,240]",Moderado,,,,34,Centro,VISEU,1821,37121.73,26357,1768,1722,1518,1475,1417,2892,4410,6132,7900,71.0,21.28,16.52,11.88
14-10-2021,TORRE DE MONCORVO,2,0,26,"[0,120]",Baixo a Moderado,,,,2,Norte,BRAGANÇA,0409,53155.67,7695,556,478,488,551,719,1270,1758,2236,2792,14.48,5.25,4.21,3.31
14-10-2021,TORRES NOVAS,26,2,74,"[0,120]",Baixo a Moderado,,,,26,Lisboa e Vale do Tejo,SANTARÉM,1419,26999.68,34933,2324,1979,1738,1406,1475,2881,4619,6598,8922,129.38,33.04,24.44,17.11
14-10-2021,TORRES VEDRAS,149,11,190,"[120,240]",Moderado,,,,149,Lisboa e Vale do Tejo,LISBOA,1113,40714.89,78530,4513,3945,3447,2628,2104,4732,8179,12124,16637,192.88,40.86,29.78,20.09
14-10-2021,TRANCOSO,1,0,11,"[0,120]",Baixo a Moderado,,,,1,Centro,GUARDA,0913,36152.47,8875,581,557,542,586,496,1082,1624,2181,2762,24.55,7.64,6.03,4.49
14-10-2021,TROFA,12,1,31,"[0,120]",Baixo a Moderado,,,,12,Norte,PORTO,1318,7201.76,38418,2336,1894,1231,939,684,1623,2854,4748,7084,533.44,98.36,65.93,39.63
14-10-2021,VAGOS,13,1,57,"[0,120]",Baixo a Moderado,,,,13,Centro,AVEIRO,0118,16491.5,22740,1320,1205,922,784,724,1508,2430,3635,4955,137.89,30.04,22.04,14.73
14-10-2021,VALE DE CAMBRA,5,0,24,"[0,120]",Baixo a Moderado,,,,5,Norte,AVEIRO,0119,14733.47,21327,1491,1363,1005,831,798,1629,2634,3997,5488,144.76,37.25,27.13,17.88
14-10-2021,VALENÇA,1,0,8,"[0,120]",Baixo a Moderado,,,,1,Norte,VIANA DO CASTELO,1608,11712.86,13290,867,791,582,582,503,1085,1667,2458,3325,113.46,28.39,20.99,14.23
14-10-2021,VALONGO,51,4,52,"[0,120]",Baixo a Moderado,,,,51,Norte,PORTO,1315,7512.45,97444,5629,4696,3207,2462,1829,4291,7498,12194,17823,1297.18,237.26,162.33,99.81
14-10-2021,VALPAÇOS,6,0,41,"[0,120]",Baixo a Moderado,,,,6,Norte,VILA REAL,1712,54873.93,14818,1217,1118,999,928,997,1925,2924,4042,5259,27.0,9.58,7.37,5.33
14-10-2021,VELAS,1,0,20,"[0,120]",Baixo a Moderado,,,,1,Açores,AÇORES,4502,11738.38,5093,278,208,166,153,113,266,432,640,918,43.39,7.82,5.45,3.68
14-10-2021,VENDAS NOVAS,0,0,0,"[0,120]",Baixo a Moderado,,,,0,Alentejo,ÉVORA,0712,22238.88,11255,677,768,655,501,532,1033,1688,2456,3133,50.61,14.09,11.04,7.59
14-10-2021,VIANA DO ALENTEJO,9,1,176,"[120,240]",Moderado,,,,9,Alentejo,ÉVORA,0713,39367.29,5145,245,208,235,210,214,424,659,867,1112,13.07,2.82,2.2,1.67
14-10-2021,VIANA DO CASTELO,30,2,35,"[0,120]",Baixo a Moderado,,,,30,Norte,VIANA DO CASTELO,1609,31902.01,84417,5470,4433,3591,3061,2982,6043,9634,14067,19537,264.61,61.24,44.09,30.2
14-10-2021,VIDIGUEIRA,13,1,237,"[120,240]",Moderado,,,,13,Alentejo,BEJA,0214,31661.09,5510,300,248,215,233,275,508,723,971,1271,17.4,4.01,3.07,2.28
14-10-2021,VIEIRA DO MINHO,8,1,68,"[0,120]",Baixo a Moderado,,,,8,Norte,BRAGA,0311,21644.35,11842,703,594,525,548,482,1030,1555,2149,2852,54.71,13.18,9.93,7.18
14-10-2021,VILA DE REI,5,0,150,"[120,240]",Moderado,,,,5,Centro,CASTELO BRANCO,0510,19154.6,3323,169,128,172,247,302,549,721,849,1018,17.35,5.31,4.43,3.76
14-10-2021,VILA DO BISPO,6,0,117,"[0,120]",Baixo a Moderado,,,,6,Algarve,FARO,0815,17906.06,5154,302,302,314,232,233,465,779,1081,1383,28.78,7.72,6.04,4.35
14-10-2021,VILA DO CONDE,46,3,58,"[0,120]",Baixo a Moderado,,,,46,Norte,PORTO,1316,14902.77,79899,4726,3875,2819,2070,1743,3813,6632,10507,15233,536.13,102.21,70.5,44.5
14-10-2021,VILA DO PORTO,2,0,36,"[0,120]",Baixo a Moderado,,,,2,Açores,AÇORES,4101,9688.74,5616,274,212,135,96,123,219,354,566,840,57.96,8.67,5.84,3.65
14-10-2021,VILA FLOR,2,0,33,"[0,120]",Baixo a Moderado,,,,2,Norte,BRAGANÇA,0410,26581.14,6044,429,362,422,294,331,625,1047,1409,1838,22.74,6.91,5.3,3.94
14-10-2021,VILA FRANCA DE XIRA,82,6,58,"[0,120]",Baixo a Moderado,,,,82,Lisboa e Vale do Tejo,LISBOA,1114,31819.39,141957,8501,6852,4869,3425,2472,5897,10766,17618,26119,446.14,82.09,55.37,33.84
14-10-2021,VILA FRANCA DO CAMPO,2,0,18,"[0,120]",Baixo a Moderado,,,,2,Açores,AÇORES,4206,7796.82,11051,450,344,248,217,154,371,619,963,1413,141.73,18.12,12.35,7.94
14-10-2021,VILA NOVA DA BARQUINHA,2,0,26,"[0,120]",Baixo a Moderado,,,,2,Lisboa e Vale do Tejo,SANTARÉM,1420,4952.97,7461,415,406,392,364,338,702,1094,1500,1915,150.64,38.66,30.28,22.09
14-10-2021,VILA NOVA DE CERVEIRA,1,0,11,"[0,120]",Baixo a Moderado,,,,1,Norte,VIANA DO CASTELO,1610,10846.66,8910,531,444,410,384,334,718,1128,1572,2103,82.14,19.39,14.49,10.4
14-10-2021,VILA NOVA DE FAMALICÃO,49,3,37,"[0,120]",Baixo a Moderado,,,,49,Norte,BRAGA,0312,20159.26,131676,7817,6164,4202,3282,2749,6031,10233,16397,24214,653.19,120.12,81.34,50.76
14-10-2021,VILA NOVA DE FOZ CÔA,4,0,62,"[0,120]",Baixo a Moderado,,,,4,Centro,GUARDA,0914,39815.18,6503,442,385,390,398,429,827,1217,1602,2044,16.33,5.13,4.02,3.06
14-10-2021,VILA NOVA DE GAIA,165,12,55,"[0,120]",Baixo a Moderado,,,,165,Norte,PORTO,1317,16846.43,300472,18349,15568,10972,8224,6281,14505,25477,41045,59394,1783.64,352.57,243.65,151.23
14-10-2021,VILA NOVA DE PAIVA,1,0,21,"[0,120]",Baixo a Moderado,,,,1,Centro,VISEU,1822,17553.28,4687,289,272,233,217,241,458,691,963,1252,26.7,7.13,5.49,3.94
14-10-2021,VILA NOVA DE POIARES,1,0,14,"[0,120]",Baixo a Moderado,,,,1,Centro,COIMBRA,0617,8445.3,6939,380,284,262,235,182,417,679,963,1343,82.17,15.9,11.4,8.04
14-10-2021,VILA POUCA DE AGUIAR,16,1,135,"[120,240]",Moderado,,,,16,Norte,VILA REAL,1713,43706.62,11961,860,817,733,601,627,1228,1961,2778,3638,27.37,8.32,6.36,4.49
14-10-2021,VILA REAL,63,4,126,"[120,240]",Moderado,,,,63,Norte,VILA REAL,1714,37880.28,49962,3025,2498,2065,1579,1466,3045,5110,7608,10633,131.9,28.07,20.08,13.49
14-10-2021,VILA REAL DE SANTO ANTÓNIO,4,0,21,"[0,120]",Baixo a Moderado,,,,4,Algarve,FARO,0816,6125.0,18749,1172,1069,811,569,586,1155,1966,3035,4207,306.11,68.69,49.55,32.1
14-10-2021,VILA VELHA DE RÓDÃO,2,0,64,"[0,120]",Baixo a Moderado,,,,2,Centro,CASTELO BRANCO,0511,32991.16,3144,209,229,180,283,306,589,769,998,1207,9.53,3.66,3.03,2.33
14-10-2021,VILA VERDE,61,4,130,"[120,240]",Moderado,,,,61,Norte,BRAGA,0313,22866.52,46911,2365,2063,1667,1494,1437,2931,4598,6661,9026,205.15,39.47,29.13,20.11
14-10-2021,VILA VIÇOSA,0,0,0,"[0,120]",Baixo a Moderado,,,,0,Alentejo,ÉVORA,0714,19485.89,7656,487,379,342,345,324,669,1011,1390,1877,39.29,9.63,7.13,5.19
14-10-2021,VIMIOSO,0,0,0,"[0,120]",Baixo a Moderado,,,,0,Norte,BRAGANÇA,0411,48158.51,4023,274,230,261,293,335,628,889,1119,1393,8.35,2.89,2.32,1.85
14-10-2021,VINHAIS,2,0,26,"[0,120]",Baixo a Moderado,,,,2,Norte,BRAGANÇA,0412,69475.09,7746,599,577,636,641,815,1456,2092,2669,3268,11.15,4.7,3.84,3.01
14-10-2021,VISEU,58,4,60,"[0,120]",Baixo a Moderado,,,,58,Centro,VISEU,1823,50710.14,97249,5769,5038,4140,3158,2710,5868,10008,15046,20815,191.77,41.05,29.67,19.74
14-10-2021,VIZELA,17,1,71,"[0,120]",Baixo a Moderado,,,,17,Norte,BRAGA,0314,2469.83,23897,1258,928,655,509,371,880,1535,2463,3721,967.49,150.65,99.72,62.15
14-10-2021,VOUZELA,6,0,62,"[0,120]",Baixo a Moderado,,,,6,Centro,VISEU,1824,19369.46,9619,626,605,554,532,507,1039,1593,2198,2824,49.66,14.58,11.35,8.22
21-10-2021,ABRANTES,24,2,69,"[0,120]",Baixo a Moderado,,,,24,Lisboa e Vale do Tejo,SANTARÉM,1401,71469.08,35130,2473,2213,1730,1748,2021,3769,5499,7712,10185,49.15,14.25,10.79,7.69
21-10-2021,ÁGUEDA,16,1,35,"[0,120]",Baixo a Moderado,,,,16,Centro,AVEIRO,0101,33527.44,46075,3237,2713,2090,1635,1496,3131,5221,7934,11171,137.43,33.32,23.66,15.57
21-10-2021,AGUIAR DA BEIRA,0,0,0,"[0,120]",Baixo a Moderado,,,,0,Centro,GUARDA,0901,20676.57,4652,304,281,235,239,148,387,622,903,1207,22.5,5.84,4.37,3.01
21-10-2021,ALANDROAL,1,0,20,"[0,120]",Baixo a Moderado,,,,1,Alentejo,ÉVORA,0701,54267.81,4992,307,256,296,299,377,676,972,1228,1535,9.2,2.83,2.26,1.79
21-10-2021,ALBERGARIA-A-VELHA,59,4,243,"[240,480]",Elevado,,,,59,Centro,AVEIRO,0102,15882.5,24144,1550,1298,996,687,680,1367,2363,3661,5211,152.02,32.81,23.05,14.88
21-10-2021,ALBUFEIRA,79,6,191,"[120,240]",Moderado,,,,79,Algarve,FARO,0801,14066.42,41528,2067,1717,1425,985,858,1843,3268,4985,7052,295.24,50.14,35.44,23.23
21-10-2021,ALCÁCER DO SAL,9,1,78,"[0,120]",Baixo a Moderado,,,,9,Alentejo,SETÚBAL,1501,149987.3,11659,884,814,623,623,602,1225,1848,2662,3546,7.77,2.36,1.77,1.23
21-10-2021,ALCANENA,17,1,132,"[120,240]",Moderado,,,,17,Lisboa e Vale do Tejo,SANTARÉM,1402,12732.86,12809,891,744,628,536,588,1124,1752,2496,3387,100.6,26.6,19.6,13.76
21-10-2021,ALCOBAÇA,55,4,102,"[0,120]",Baixo a Moderado,,,,55,Lisboa e Vale do Tejo,LEIRIA,1001,40814.09,53555,3420,2927,2466,2059,1676,3735,6201,9128,12548,131.22,30.74,22.36,15.19
21-10-2021,ALCOCHETE,4,0,20,"[0,120]",Baixo a Moderado,,,,4,Lisboa e Vale do Tejo,SETÚBAL,1502,12836.48,19787,857,834,691,476,447,923,1614,2448,3305,154.15,25.75,19.07,12.57
21-10-2021,ALCOUTIM,0,0,0,"[0,120]",Baixo a Moderado,,,,0,Algarve,FARO,0802,57536.33,2159,191,188,163,190,267,457,620,808,999,3.75,1.74,1.4,1.08
21-10-2021,ALENQUER,21,1,47,"[0,120]",Baixo a Moderado,,,,21,Lisboa e Vale do Tejo,LISBOA,1101,30421.92,44052,2298,2062,1629,1330,1155,2485,4114,6176,8474,144.8,27.85,20.3,13.52
21-10-2021,ALFÂNDEGA DA FÉ,0,0,0,"[0,120]",Baixo a Moderado,,,,0,Norte,BRAGANÇA,0401,32194.64,4550,325,277,301,274,325,599,900,1177,1502,14.13,4.67,3.66,2.8
21-10-2021,ALIJÓ,19,1,180,"[120,240]",Moderado,,,,19,Norte,VILA REAL,1701,29759.89,10625,766,687,635,542,666,1208,1843,2530,3296,35.7,11.08,8.5,6.19
21-10-2021,ALJEZUR,5,0,89,"[0,120]",Baixo a Moderado,,,,5,Algarve,FARO,0803,32349.95,5594,316,336,335,320,410,730,1065,1401,1717,17.29,5.31,4.33,3.29
21-10-2021,ALJUSTREL,0,0,0,"[0,120]",Baixo a Moderado,,,,0,Alentejo,BEJA,0201,45847.41,8247,635,521,443,347,358,705,1148,1669,2304,17.99,5.03,3.64,2.5
21-10-2021,ALMADA,96,7,57,"[0,120]",Baixo a Moderado,,,,96,Lisboa e Vale do Tejo,SETÚBAL,1503,7000.89,169039,10469,9777,7876,6144,5111,11255,19131,28908,39377,2414.5,562.45,412.91,273.26
21-10-2021,ALMEIDA,1,0,17,"[0,120]",Baixo a Moderado,,,,1,Centro,GUARDA,0902,51798.46,5830,441,419,396,458,393,851,1247,1666,2107,11.26,4.07,3.22,2.41
21-10-2021,ALMEIRIM,49,4,219,"[120,240]",Moderado,,,,49,Lisboa e Vale do Tejo,SANTARÉM,1403,22212.05,22546,1342,1353,1106,866,843,1709,2815,4168,5510,101.5,24.81,18.76,12.67
21-10-2021,ALMODÔVAR,15,1,225,"[120,240]",Moderado,,,,15,Alentejo,BEJA,0202,77788.03,6725,414,443,396,373,328,701,1097,1540,1954,8.65,2.51,1.98,1.41
21-10-2021,ALPIARÇA,8,1,115,"[0,120]",Baixo a Moderado,,,,8,Lisboa e Vale do Tejo,SANTARÉM,1404,9536.33,7059,515,486,363,333,274,607,970,1456,1971,74.02,20.67,15.27,10.17
21-10-2021,ALTER DO CHÃO,2,0,64,"[0,120]",Baixo a Moderado,,,,2,Alentejo,PORTALEGRE,1201,36206.62,3165,201,163,136,208,187,395,531,694,895,8.74,2.47,1.92,1.47
21-10-2021,ALVAIÁZERE,1,0,15,"[0,120]",Baixo a Moderado,,,,1,Centro,LEIRIA,1002,16047.76,6597,419,389,346,406,539,945,1291,1680,2099,41.11,13.08,10.47,8.04
21-10-2021,ALVITO,20,1,810,"[480,960]",Muito Elevado,,,,20,Alentejo,BEJA,0203,26485.32,2477,145,110,105,111,89,200,305,415,560,9.35,2.11,1.57,1.15
21-10-2021,AMADORA,98,7,53,"[0,120]",Baixo a Moderado,,,,98,Lisboa e Vale do Tejo,LISBOA,1115,2378.47,184106,11186,10936,8780,6460,5890,12350,21130,32066,43252,7742.05,1818.84,1348.44,888.56
21-10-2021,AMARANTE,20,1,38,"[0,120]",Baixo a Moderado,,,,20,Norte,PORTO,1301,30133.15,53193,3086,2413,1812,1643,1311,2954,4766,7179,10265,176.53,34.07,23.82,15.82
21-10-2021,AMARES,5,0,28,"[0,120]",Baixo a Moderado,,,,5,Norte,BRAGA,0301,8195.41,18129,1001,829,622,489,524,1013,1635,2464,3465,221.22,42.28,30.07,19.95
21-10-2021,ANADIA,9,1,33,"[0,120]",Baixo a Moderado,,,,9,Centro,AVEIRO,0103,21663.48,27258,1931,1698,1376,1208,1262,2470,3846,5544,7475,125.83,34.51,25.59,17.75
21-10-2021,ANGRA DO HEROÍSMO,2,0,6,"[0,120]",Baixo a Moderado,,,,2,Açores,AÇORES,4301,23899.66,33807,2006,1473,1122,768,635,1403,2525,3998,6004,141.45,25.12,16.73,10.56
21-10-2021,ANSIÃO,1,0,8,"[0,120]",Baixo a Moderado,,,,1,Centro,LEIRIA,1003,17609.42,12039,727,709,646,694,530,1224,1870,2579,3306,68.37,18.77,14.65,10.62
21-10-2021,ARCOS DE VALDEVEZ,48,3,231,"[120,240]",Moderado,,,,48,Norte,VIANA DO CASTELO,1601,44759.64,20926,1329,1338,1282,1343,1515,2858,4140,5478,6807,46.75,15.21,12.24,9.25
21-10-2021,ARGANIL,27,2,246,"[240,480]",Elevado,,,,27,Centro,COIMBRA,0601,33283.93,11014,672,648,612,559,596,1155,1767,2415,3087,33.09,9.27,7.26,5.31
21-10-2021,ARMAMAR,0,0,0,"[0,120]",Baixo a Moderado,,,,0,Norte,VISEU,1801,11723.73,5769,357,305,309,285,310,595,904,1209,1566,49.21,13.36,10.31,7.71
21-10-2021,AROUCA,48,3,233,"[120,240]",Moderado,,,,48,Norte,AVEIRO,0104,32910.52,20720,1306,1047,753,683,683,1366,2119,3166,4472,62.96,13.59,9.62,6.44
21-10-2021,ARRAIOLOS,0,0,0,"[0,120]",Baixo a Moderado,,,,0,Alentejo,ÉVORA,0702,68374.55,6928,435,384,283,367,480,847,1130,1514,1949,10.13,2.85,2.21,1.65
21-10-2021,ARRONCHES,0,0,0,"[0,120]",Baixo a Moderado,,,,0,Alentejo,PORTALEGRE,1202,31464.72,2820,155,142,162,187,179,366,528,670,825,8.96,2.62,2.13,1.68
21-10-2021,ARRUDA DOS VINHOS,10,1,63,"[0,120]",Baixo a Moderado,,,,10,Lisboa e Vale do Tejo,LISBOA,1102,7795.93,15412,738,738,562,509,438,947,1509,2247,2985,197.69,38.29,28.82,19.36
21-10-2021,AVEIRO,64,5,81,"[0,120]",Baixo a Moderado,,,,64,Centro,AVEIRO,0105,19757.57,78734,4520,4004,3050,2250,2103,4353,7403,11407,15927,398.49,80.61,57.73,37.47
21-10-2021,AVIS,1,0,24,"[0,120]",Baixo a Moderado,,,,1,Alentejo,PORTALEGRE,1203,60596.51,4247,315,225,206,251,273,524,730,955,1270,7.01,2.1,1.58,1.2
21-10-2021,AZAMBUJA,20,1,88,"[0,120]",Baixo a Moderado,,,,20,Lisboa e Vale do Tejo,LISBOA,1103,26265.65,22716,1322,1171,1070,798,618,1416,2486,3657,4979,86.48,18.96,13.92,9.46
21-10-2021,BAIÃO,8,1,43,"[0,120]",Baixo a Moderado,,,,8,Norte,PORTO,1302,17452.83,18748,1070,862,714,686,725,1411,2125,2987,4057,107.42,23.25,17.11,12.18
21-10-2021,BARCELOS,33,2,28,"[0,120]",Baixo a Moderado,,,,33,Norte,BRAGA,0302,37890.14,116187,6721,5325,3619,2991,2562,5553,9172,14497,21218,306.64,56.0,38.26,24.21
21-10-2021,BARRANCOS,2,0,123,"[120,240]",Moderado,,,,2,Alentejo,BEJA,0204,16841.73,1634,90,65,65,94,61,155,220,285,375,9.7,2.23,1.69,1.31
21-10-2021,BARREIRO,26,2,35,"[0,120]",Baixo a Moderado,,,,26,Lisboa e Vale do Tejo,SETÚBAL,1504,3639.07,75147,5194,5565,4459,3105,1767,4872,9331,14896,20090,2065.05,552.07,409.34,256.42
21-10-2021,BATALHA,10,1,62,"[0,120]",Baixo a Moderado,,,,10,Centro,LEIRIA,1004,10341.6,15963,873,762,649,529,549,1078,1727,2489,3362,154.35,32.51,24.07,16.7
21-10-2021,BEJA,84,6,249,"[240,480]",Elevado,,,,84,Alentejo,BEJA,0205,114647.55,33579,2005,1840,1386,1272,1039,2311,3697,5537,7542,29.29,6.58,4.83,3.22
21-10-2021,BELMONTE,3,0,47,"[0,120]",Baixo a Moderado,,,,3,Centro,CASTELO BRANCO,0501,11875.91,6398,444,321,325,310,355,665,990,1311,1755,53.87,14.78,11.04,8.34
21-10-2021,BENAVENTE,23,2,75,"[0,120]",Baixo a Moderado,,,,23,Lisboa e Vale do Tejo,SANTARÉM,1405,52138.39,30602,1468,1376,1141,876,643,1519,2660,4036,5504,58.69,10.56,7.74,5.1
21-10-2021,BOMBARRAL,14,1,110,"[0,120]",Baixo a Moderado,,,,14,Lisboa e Vale do Tejo,LEIRIA,1005,9128.55,12558,875,714,561,491,429,920,1481,2195,3070,137.56,33.63,24.04,16.22
21-10-2021,BORBA,1,0,15,"[0,120]",Baixo a Moderado,,,,1,Alentejo,ÉVORA,0703,14518.65,6736,430,375,279,436,392,828,1107,1482,1912,46.39,13.17,10.21,7.62
21-10-2021,BOTICAS,0,0,0,"[0,120]",Baixo a Moderado,,,,0,Norte,VILA REAL,1702,32195.66,4998,347,306,311,305,380,685,996,1302,1649,15.52,5.12,4.04,3.09
21-10-2021,BRAGA,183,13,100,"[0,120]",Baixo a Moderado,,,,183,Norte,BRAGA,0303,18339.95,182679,10029,7963,5241,4320,3671,7991,13232,21195,31224,996.07,170.25,115.57,72.15
21-10-2021,BRAGANÇA,16,1,48,"[0,120]",Baixo a Moderado,,,,16,Norte,BRAGANÇA,0402,117357.27,33607,2402,1855,1652,1393,1163,2556,4208,6063,8465,28.64,7.21,5.17,3.59
21-10-2021,CABECEIRAS DE BASTO,6,0,39,"[0,120]",Baixo a Moderado,,,,6,Norte,BRAGA,0304,24182.16,15628,774,594,544,575,574,1149,1693,2287,3061,64.63,12.66,9.46,7.0
21-10-2021,CADAVAL,11,1,80,"[0,120]",Baixo a Moderado,,,,11,Lisboa e Vale do Tejo,LISBOA,1104,17489.3,13673,813,796,756,621,625,1246,2002,2798,3611,78.18,20.65,16.0,11.45
21-10-2021,CALDAS DA RAINHA,135,10,261,"[240,480]",Elevado,,,,135,Lisboa e Vale do Tejo,LEIRIA,1006,25569.47,51912,3035,2684,2186,1899,1705,3604,5790,8474,11509,203.03,45.01,33.14,22.64
21-10-2021,CALHETA,2,0,18,"[0,120]",Baixo a Moderado,,,,2,Madeira,MADEIRA,3101,11150.43,10867,576,497,507,399,415,814,1321,1818,2394,97.46,21.47,16.3,11.85
21-10-2021,CALHETA (AÇORES),1,0,32,"[0,120]",Baixo a Moderado,,,,1,Açores,AÇORES,4501,12626.4,3184,215,159,141,139,122,261,402,561,776,25.22,6.15,4.44,3.18
21-10-2021,CÂMARA DE LOBOS,13,1,39,"[0,120]",Baixo a Moderado,,,,13,Madeira,MADEIRA,3102,5216.67,33675,1396,1059,834,545,381,926,1760,2819,4215,645.49,80.79,54.03,33.74
21-10-2021,CAMINHA,14,1,89,"[0,120]",Baixo a Moderado,,,,14,Norte,VIANA DO CASTELO,1602,13652.14,15877,1046,944,818,646,656,1302,2120,3064,4110,116.3,30.11,22.44,15.53
21-10-2021,CAMPO MAIOR,72,5,911,"[480,960]",Muito Elevado,,,,72,Alentejo,PORTALEGRE,1204,24720.16,7874,471,364,351,279,327,606,957,1321,1792,31.85,7.25,5.34,3.87
21-10-2021,CANTANHEDE,16,1,46,"[0,120]",Baixo a Moderado,,,,16,Centro,COIMBRA,0602,39088.02,35011,2346,2096,1880,1709,1451,3160,5040,7136,9482,89.57,24.26,18.26,12.89
21-10-2021,CARRAZEDA DE ANSIÃES,1,0,18,"[0,120]",Baixo a Moderado,,,,1,Norte,BRAGANÇA,0403,27924.09,5666,424,389,391,312,465,777,1168,1557,1981,20.29,7.09,5.58,4.18
21-10-2021,CARREGAL DO SAL,6,0,64,"[0,120]",Baixo a Moderado,,,,6,Centro,VISEU,1802,11689.21,9271,587,562,486,462,376,838,1324,1886,2473,79.31,21.16,16.13,11.33
21-10-2021,CARTAXO,19,1,80,"[0,120]",Baixo a Moderado,,,,19,Lisboa e Vale do Tejo,SANTARÉM,1406,15817.28,23843,1415,1376,1142,861,632,1493,2635,4011,5426,150.74,34.3,25.36,16.66
21-10-2021,CASCAIS,177,13,83,"[0,120]",Baixo a Moderado,,,,177,Lisboa e Vale do Tejo,LISBOA,1105,9740.17,213608,12151,11444,8680,6469,5248,11717,20397,31841,43992,2193.1,451.66,326.91,209.41
21-10-2021,CASTANHEIRA DE PÊRA,0,0,0,"[0,120]",Baixo a Moderado,,,,0,Centro,LEIRIA,1007,6677.45,2614,233,195,157,190,187,377,534,729,962,39.15,14.41,10.92,8.0
21-10-2021,CASTELO BRANCO,177,13,340,"[240,480]",Elevado,,,,177,Centro,CASTELO BRANCO,0502,143819.15,51987,3528,3042,2499,2229,2225,4454,6953,9995,13523,36.15,9.4,6.95,4.83
21-10-2021,CASTELO DE PAIVA,4,0,26,"[0,120]",Baixo a Moderado,,,,4,Norte,AVEIRO,0106,11500.53,15454,881,697,545,420,431,851,1396,2093,2974,134.37,25.86,18.2,12.14
21-10-2021,CASTELO DE VIDE,0,0,0,"[0,120]",Baixo a Moderado,,,,0,Alentejo,PORTALEGRE,1205,26491.24,2919,204,173,179,147,170,317,496,669,873,11.02,3.3,2.53,1.87
21-10-2021,CASTRO DAIRE,15,1,109,"[0,120]",Baixo a Moderado,,,,15,Centro,VISEU,1803,37904.13,13823,942,857,765,732,773,1505,2270,3127,4069,36.47,10.74,8.25,5.99
21-10-2021,CASTRO MARIM,4,0,65,"[0,120]",Baixo a Moderado,,,,4,Algarve,FARO,0804,30084.37,6237,370,345,334,322,344,666,1000,1345,1715,20.73,5.7,4.47,3.32
21-10-2021,CASTRO VERDE,2,0,29,"[0,120]",Baixo a Moderado,,,,2,Alentejo,BEJA,0206,56944.23,6949,437,347,303,275,227,502,805,1152,1589,12.2,2.79,2.02,1.41
21-10-2021,CELORICO DA BEIRA,0,0,0,"[0,120]",Baixo a Moderado,,,,0,Centro,GUARDA,0903,24721.63,6928,430,416,363,369,535,904,1267,1683,2113,28.02,8.55,6.81,5.12
21-10-2021,CELORICO DE BASTO,10,1,53,"[0,120]",Baixo a Moderado,,,,10,Norte,BRAGA,0305,18107.02,19040,1001,802,668,728,729,1457,2125,2927,3928,105.15,21.69,16.17,11.74
21-10-2021,CHAMUSCA,14,1,154,"[120,240]",Moderado,,,,14,Lisboa e Vale do Tejo,SANTARÉM,1407,74600.54,9197,629,583,553,465,579,1044,1597,2180,2809,12.33,3.77,2.92,2.14
21-10-2021,CHAVES,6,0,15,"[0,120]",Baixo a Moderado,,,,6,Norte,VILA REAL,1703,59122.95,39343,2676,2429,1991,1886,1918,3804,5795,8224,10900,66.54,18.44,13.91,9.8
21-10-2021,CINFÃES,2,0,11,"[0,120]",Baixo a Moderado,,,,2,Norte,VISEU,1804,23928.76,18244,1067,902,779,734,758,1492,2271,3173,4240,76.24,17.72,13.26,9.49
21-10-2021,COIMBRA,63,5,47,"[0,120]",Baixo a Moderado,,,,63,Centro,COIMBRA,0603,31939.94,134166,9489,8734,6353,5139,5074,10213,16566,25300,34789,420.06,108.92,79.21,51.87
21-10-2021,CONDEIXA-A-NOVA,10,1,56,"[0,120]",Baixo a Moderado,,,,10,Centro,COIMBRA,0604,13867.47,17733,871,809,717,583,490,1073,1790,2599,3470,127.88,25.02,18.74,12.91
21-10-2021,CONSTÂNCIA,0,0,0,"[0,120]",Baixo a Moderado,,,,0,Lisboa e Vale do Tejo,SANTARÉM,1408,8036.58,4030,211,183,187,148,155,303,490,673,884,50.14,11.0,8.37,6.1
21-10-2021,CORUCHE,8,1,47,"[0,120]",Baixo a Moderado,,,,8,Lisboa e Vale do Tejo,SANTARÉM,1409,111572.03,17471,1294,1090,1095,1096,1019,2115,3210,4300,5594,15.66,5.01,3.85,2.88
21-10-2021,CORVO,0,0,0,"[0,120]",Baixo a Moderado,,,,0,Açores,AÇORES,4901,1711.45,464,22,21,11,13,19,32,43,64,86,27.12,5.03,3.74,2.51
21-10-2021,COVILHÃ,118,8,252,"[240,480]",Elevado,,,,118,Centro,CASTELO BRANCO,0503,55560.06,46787,3533,2998,2365,2111,2193,4304,6669,9667,13200,84.21,23.76,17.4,12.0
21-10-2021,CRATO,1,0,33,"[0,120]",Baixo a Moderado,,,,1,Alentejo,PORTALEGRE,1206,39806.88,3129,229,258,163,182,228,410,573,831,1060,7.86,2.66,2.09,1.44
21-10-2021,CUBA,34,2,748,"[480,960]",Muito Elevado,,,,34,Alentejo,BEJA,0207,17208.72,4595,255,233,206,190,143,333,539,772,1027,26.7,5.97,4.49,3.13
21-10-2021,ELVAS,46,3,222,"[120,240]",Moderado,,,,46,Alentejo,PORTALEGRE,1207,63128.86,20528,1057,1145,902,852,810,1662,2564,3709,4766,32.52,7.55,5.88,4.06
21-10-2021,ENTRONCAMENTO,17,1,78,"[0,120]",Baixo a Moderado,,,,17,Lisboa e Vale do Tejo,SANTARÉM,1410,1372.81,21558,1066,930,868,695,592,1287,2155,3085,4151,1570.14,302.33,224.69,156.96
21-10-2021,ESPINHO,12,1,41,"[0,120]",Baixo a Moderado,,,,12,Norte,AVEIRO,0107,2105.68,29516,2205,1993,1430,1177,960,2137,3567,5560,7765,1401.52,368.71,264.01,169.37
21-10-2021,ESPOSENDE,22,2,64,"[0,120]",Baixo a Moderado,,,,22,Norte,BRAGA,0306,9540.98,34177,1831,1522,1095,894,723,1617,2712,4234,6065,358.21,63.57,44.38,28.42
21-10-2021,ESTARREJA,5,0,19,"[0,120]",Baixo a Moderado,,,,5,Centro,AVEIRO,0108,10817.33,26006,1503,1399,1106,953,728,1681,2787,4186,5689,240.42,52.59,38.7,25.76
21-10-2021,ESTREMOZ,7,1,56,"[0,120]",Baixo a Moderado,,,,7,Alentejo,ÉVORA,0704,51379.95,12728,789,613,697,786,877,1663,2360,2973,3762,24.77,7.32,5.79,4.59
21-10-2021,ÉVORA,52,4,100,"[0,120]",Baixo a Moderado,,,,52,Alentejo,ÉVORA,0705,130707.58,52428,3569,2852,2176,1966,1803,3769,5945,8797,12366,40.11,9.46,6.73,4.55
21-10-2021,FAFE,73,5,151,"[120,240]",Moderado,,,,73,Norte,BRAGA,0307,21908.11,48060,3044,2455,1679,1403,1208,2611,4290,6745,9789,219.37,44.68,30.79,19.58
21-10-2021,FARO,67,5,110,"[0,120]",Baixo a Moderado,,,,67,Algarve,FARO,0805,20256.79,61015,3847,3364,2604,2055,1601,3656,6260,9624,13471,301.2,66.5,47.51,30.9
21-10-2021,FELGUEIRAS,41,3,73,"[0,120]",Baixo a Moderado,,,,41,Norte,PORTO,1303,11573.75,56422,2951,2302,1601,1316,973,2289,3890,6192,9143,487.49,79.0,53.5,33.61
21-10-2021,FERREIRA DO ALENTEJO,44,3,564,"[480,960]",Muito Elevado,,,,44,Alentejo,BEJA,0208,64820.68,7845,515,414,372,343,345,688,1060,1474,1989,12.1,3.07,2.27,1.64
21-10-2021,FERREIRA DO ZÊZERE,9,1,113,"[0,120]",Baixo a Moderado,,,,9,Lisboa e Vale do Tejo,SANTARÉM,1411,19038.03,7959,470,370,416,465,456,921,1337,1707,2177,41.81,11.44,8.97,7.02
21-10-2021,FIGUEIRA DA FOZ,33,2,56,"[0,120]",Baixo a Moderado,,,,33,Centro,COIMBRA,0605,37905.26,58747,4032,3597,2887,2495,2043,4538,7425,11022,15054,154.98,39.72,29.08,19.59
21-10-2021,FIGUEIRA DE CASTELO RODRIGO,3,0,54,"[0,120]",Baixo a Moderado,,,,3,Centro,GUARDA,0904,50857.46,5584,347,352,290,352,391,743,1033,1385,1732,10.98,3.41,2.72,2.03
21-10-2021,FIGUEIRÓ DOS VINHOS,3,0,54,"[0,120]",Baixo a Moderado,,,,3,Centro,LEIRIA,1008,17344.0,5568,402,386,322,309,351,660,982,1368,1770,32.1,10.21,7.89,5.66
21-10-2021,FORNOS DE ALGODRES,0,0,0,"[0,120]",Baixo a Moderado,,,,0,Centro,GUARDA,0905,13145.05,4528,261,218,247,256,232,488,735,953,1214,34.45,9.24,7.25,5.59
21-10-2021,FREIXO DE ESPADA À CINTA,0,0,0,"[0,120]",Baixo a Moderado,,,,0,Norte,BRAGANÇA,0404,24414.29,3298,211,177,231,196,189,385,616,793,1004,13.51,4.11,3.25,2.52
21-10-2021,FRONTEIRA,0,0,0,"[0,120]",Baixo a Moderado,,,,0,Alentejo,PORTALEGRE,1208,24859.58,2974,213,182,149,156,168,324,473,655,868,11.96,3.49,2.63,1.9
21-10-2021,FUNCHAL,97,7,93,"[0,120]",Baixo a Moderado,,,,97,Madeira,MADEIRA,3103,7616.2,104024,6382,5086,3643,2821,1990,4811,8454,13540,19922,1365.86,261.58,177.78,111.0
21-10-2021,FUNDÃO,36,3,136,"[120,240]",Moderado,,,,36,Centro,CASTELO BRANCO,0504,70019.79,26495,1781,1464,1432,1357,1643,3000,4432,5896,7677,37.84,10.96,8.42,6.33
21-10-2021,GAVIÃO,0,0,0,"[0,120]",Baixo a Moderado,,,,0,Alentejo,PORTALEGRE,1209,29459.45,3263,189,186,222,263,293,556,778,964,1153,11.08,3.91,3.27,2.64
21-10-2021,GÓIS,2,0,53,"[0,120]",Baixo a Moderado,,,,2,Centro,COIMBRA,0606,26330.19,3805,235,199,240,233,244,477,717,916,1151,14.45,4.37,3.48,2.72
21-10-2021,GOLEGÃ,1,0,19,"[0,120]",Baixo a Moderado,,,,1,Lisboa e Vale do Tejo,SANTARÉM,1412,8431.67,5339,356,299,281,243,255,498,779,1078,1434,63.32,17.01,12.78,9.24
21-10-2021,GONDOMAR,83,6,50,"[0,120]",Baixo a Moderado,,,,83,Norte,PORTO,1304,13191.76,165985,10555,8755,6222,4450,3364,7814,14036,22791,33346,1258.22,252.77,172.76,106.4
21-10-2021,GOUVEIA,35,3,283,"[240,480]",Elevado,,,,35,Centro,GUARDA,0906,30061.17,12387,871,931,780,783,810,1593,2373,3304,4175,41.21,13.89,10.99,7.89
21-10-2021,GRÂNDOLA,4,0,27,"[0,120]",Baixo a Moderado,,,,4,Alentejo,SETÚBAL,1505,82593.66,14639,834,834,708,688,672,1360,2068,2902,3736,17.72,4.52,3.51,2.5
21-10-2021,GUARDA,40,3,103,"[0,120]",Baixo a Moderado,,,,40,Centro,GUARDA,0907,71209.58,38969,2477,2041,1686,1415,1474,2889,4575,6616,9093,54.72,12.77,9.29,6.42
21-10-2021,GUIMARÃES,119,8,78,"[0,120]",Baixo a Moderado,,,,119,Norte,BRAGA,0308,24099.96,152309,9394,7074,4809,3877,2948,6825,11634,18708,28102,631.99,116.61,77.63,48.27
21-10-2021,HORTA,16,1,111,"[0,120]",Baixo a Moderado,,,,16,Açores,AÇORES,4701,17305.53,14521,818,658,468,352,302,654,1122,1780,2598,83.91,15.01,10.29,6.48
21-10-2021,IDANHA-A-NOVA,5,0,63,"[0,120]",Baixo a Moderado,,,,5,Centro,CASTELO BRANCO,0505,141633.51,8043,518,490,519,672,974,1646,2165,2655,3173,5.68,2.24,1.87,1.53
21-10-2021,ÍLHAVO,13,1,33,"[0,120]",Baixo a Moderado,,,,13,Centro,AVEIRO,0110,7347.55,38699,2227,1943,1444,1193,850,2043,3487,5430,7657,526.66,104.21,73.9,47.46
21-10-2021,LAGOA (FARO),34,2,149,"[120,240]",Moderado,,,,34,Algarve,FARO,0806,8825.45,22762,1314,1168,919,749,670,1419,2338,3506,4820,257.93,54.62,39.73,26.49
21-10-2021,LAGOA,10,1,68,"[0,120]",Baixo a Moderado,,,,10,Açores,AÇORES,4201,4559.32,14721,536,458,349,238,235,473,822,1280,1816,322.9,39.83,28.08,18.03
21-10-2021,LAGOS,82,6,271,"[240,480]",Elevado,,,,82,Algarve,FARO,0807,21299.27,30374,1744,1434,1247,1053,1029,2082,3329,4763,6507,142.61,30.55,22.36,15.63
21-10-2021,LAJES DAS FLORES,0,0,0,"[0,120]",Baixo a Moderado,,,,0,Açores,AÇORES,4801,7004.79,1463,88,53,62,46,54,100,162,215,303,20.89,4.33,3.07,2.31
21-10-2021,LAJES DO PICO,2,0,45,"[0,120]",Baixo a Moderado,,,,2,Açores,AÇORES,4601,15531.09,4490,304,231,223,159,162,321,544,775,1079,28.91,6.95,4.99,3.5
21-10-2021,LAMEGO,30,2,121,"[120,240]",Moderado,,,,30,Norte,VISEU,1805,16542.11,24895,1639,1284,1124,898,783,1681,2805,4089,5728,150.5,34.63,24.72,16.96
21-10-2021,LEIRIA,135,10,108,"[0,120]",Baixo a Moderado,,,,135,Centro,LEIRIA,1009,56508.83,125267,7389,6366,5090,3902,3159,7061,12151,18517,25906,221.68,45.84,32.77,21.5
21-10-2021,LISBOA,667,48,131,"[120,240]",Moderado,,,,667,Lisboa e Vale do Tejo,LISBOA,1106,10005.43,509515,33197,33340,27706,23037,26770,49807,77513,110853,144050,5092.6,1439.78,1107.98,774.74
21-10-2021,LOULÉ,67,5,98,"[0,120]",Baixo a Moderado,,,,67,Algarve,FARO,0808,76366.91,68697,3890,3350,2780,2358,2251,4609,7389,10739,14629,89.96,19.16,14.06,9.68
21-10-2021,LOURES,128,9,60,"[0,120]",Baixo a Moderado,,,,128,Lisboa e Vale do Tejo,LISBOA,1107,16723.99,213687,12746,12794,9644,6669,5033,11702,21346,34140,46886,1277.73,280.35,204.14,127.64
21-10-2021,LOURINHÃ,41,3,157,"[120,240]",Moderado,,,,41,Lisboa e Vale do Tejo,LISBOA,1108,14717.2,25855,1584,1243,992,842,645,1487,2479,3722,5306,175.68,36.05,25.29,16.84
21-10-2021,LOUSÃ,38,3,220,"[120,240]",Moderado,,,,38,Centro,COIMBRA,0607,13840.01,17158,946,866,658,528,450,978,1636,2502,3448,123.97,24.91,18.08,11.82
21-10-2021,LOUSADA,7,1,15,"[0,120]",Baixo a Moderado,,,,7,Norte,PORTO,1305,9608.01,46755,2289,1698,1176,853,621,1474,2650,4348,6637,486.63,69.08,45.25,27.58
21-10-2021,MAÇÃO,5,0,81,"[0,120]",Baixo a Moderado,,,,5,Lisboa e Vale do Tejo,SANTARÉM,1413,39997.98,6267,386,362,390,440,657,1097,1487,1849,2235,15.67,5.59,4.62,3.72
21-10-2021,MACEDO DE CAVALEIROS,5,0,35,"[0,120]",Baixo a Moderado,,,,5,Norte,BRAGANÇA,0405,69914.08,14516,1082,889,878,823,938,1761,2639,3528,4610,20.76,6.59,5.05,3.77
21-10-2021,MACHICO,3,0,15,"[0,120]",Baixo a Moderado,,,,3,Madeira,MADEIRA,3104,6825.1,19981,1197,860,662,455,331,786,1448,2308,3505,292.76,51.36,33.82,21.22
21-10-2021,MADALENA,1,0,17,"[0,120]",Baixo a Moderado,,,,1,Açores,AÇORES,4602,14712.33,5895,334,256,173,190,179,369,542,798,1132,40.07,7.69,5.42,3.68
21-10-2021,MAFRA,62,4,73,"[0,120]",Baixo a Moderado,,,,62,Lisboa e Vale do Tejo,LISBOA,1109,29165.5,84816,3613,3334,2839,2089,1899,3988,6827,10161,13774,290.81,47.23,34.84,23.41
21-10-2021,MAIA,136,10,98,"[0,120]",Baixo a Moderado,,,,136,Norte,PORTO,1306,8293.94,138971,7801,6617,4512,3339,2631,5970,10482,17099,24900,1675.56,300.22,206.16,126.38
21-10-2021,MANGUALDE,29,2,156,"[120,240]",Moderado,,,,29,Centro,VISEU,1806,21925.56,18510,1198,1128,885,852,743,1595,2480,3608,4806,84.42,21.92,16.46,11.31
21-10-2021,MANTEIGAS,6,0,201,"[120,240]",Moderado,,,,6,Centro,GUARDA,0908,12197.55,3007,258,197,159,167,146,313,472,669,927,24.65,7.6,5.48,3.87
21-10-2021,MARCO DE CANAVESES,47,3,92,"[0,120]",Baixo a Moderado,,,,47,Norte,PORTO,1307,20188.98,51496,2678,2060,1488,1265,1023,2288,3776,5836,8514,255.07,42.17,28.91,18.7
21-10-2021,MARINHA GRANDE,29,2,75,"[0,120]",Baixo a Moderado,,,,29,Centro,LEIRIA,1010,18725.19,38508,2365,2302,1638,1359,1058,2417,4055,6357,8722,205.65,46.58,33.95,21.66
21-10-2021,MARVÃO,1,0,34,"[0,120]",Baixo a Moderado,,,,1,Alentejo,PORTALEGRE,1210,15489.9,3005,198,185,142,197,237,434,576,761,959,19.4,6.19,4.91,3.72
21-10-2021,MATOSINHOS,119,9,68,"[0,120]",Baixo a Moderado,,,,119,Norte,PORTO,1308,6241.97,175357,11850,9977,7023,5024,3884,8908,15931,25908,37758,2809.31,604.9,415.06,255.22
21-10-2021,MEALHADA,8,1,40,"[0,120]",Baixo a Moderado,,,,8,Centro,AVEIRO,0111,11065.66,19914,1163,1039,810,828,831,1659,2469,3508,4671,179.96,42.21,31.7,22.31
21-10-2021,MÊDA,0,0,0,"[0,120]",Baixo a Moderado,,,,0,Centro,GUARDA,0909,28604.92,4587,343,306,290,288,443,731,1021,1327,1670,16.04,5.84,4.64,3.57
21-10-2021,MELGAÇO,1,0,13,"[0,120]",Baixo a Moderado,,,,1,Norte,VIANA DO CASTELO,1603,23824.58,8093,507,567,578,614,675,1289,1867,2434,2941,33.97,12.34,10.22,7.84
21-10-2021,MÉRTOLA,12,1,198,"[120,240]",Moderado,,,,12,Alentejo,BEJA,0209,129287.34,6142,400,390,378,423,600,1023,1401,1791,2191,4.75,1.69,1.39,1.08
21-10-2021,MESÃO FRIO,9,1,228,"[120,240]",Moderado,,,,9,Norte,VILA REAL,1704,2664.87,3964,265,205,168,157,120,277,445,650,915,148.74,34.33,24.39,16.7
21-10-2021,MIRA,6,0,51,"[0,120]",Baixo a Moderado,,,,6,Centro,COIMBRA,0608,12403.38,11832,727,729,659,550,466,1016,1675,2404,3131,95.4,25.24,19.38,13.5
21-10-2021,MIRANDA DO CORVO,24,2,189,"[120,240]",Moderado,,,,24,Centro,COIMBRA,0609,12637.79,12708,706,659,568,498,404,902,1470,2129,2835,100.55,22.43,16.85,11.63
21-10-2021,MIRANDA DO DOURO,3,0,44,"[0,120]",Baixo a Moderado,,,,3,Norte,BRAGANÇA,0406,48718.31,6830,482,429,442,463,470,933,1375,1804,2286,14.02,4.69,3.7,2.82
21-10-2021,MIRANDELA,25,2,116,"[0,120]",Baixo a Moderado,,,,25,Norte,BRAGANÇA,0407,65895.67,21754,1640,1315,1204,1078,947,2025,3229,4544,6184,33.01,9.38,6.9,4.9
21-10-2021,MOGADOURO,3,0,36,"[0,120]",Baixo a Moderado,,,,3,Norte,BRAGANÇA,0408,76064.93,8392,589,529,576,630,655,1285,1861,2390,2979,11.03,3.92,3.14,2.45
21-10-2021,MOIMENTA DA BEIRA,6,0,62,"[0,120]",Baixo a Moderado,,,,6,Norte,VISEU,1807,21996.9,9736,576,514,471,416,461,877,1348,1862,2438,44.26,11.08,8.46,6.13
21-10-2021,MOITA,21,2,33,"[0,120]",Baixo a Moderado,,,,21,Lisboa e Vale do Tejo,SETÚBAL,1506,5525.98,64407,4226,3646,2623,1801,1425,3226,5849,9495,13721,1165.53,248.3,171.82,105.85
21-10-2021,MONÇÃO,9,1,51,"[0,120]",Baixo a Moderado,,,,9,Norte,VIANA DO CASTELO,1604,21130.85,17869,1161,1105,1031,1006,972,1978,3009,4114,5275,84.56,24.96,19.47,14.24
21-10-2021,MONCHIQUE,9,1,181,"[120,240]",Moderado,,,,9,Algarve,FARO,0809,39530.43,5077,353,384,321,355,392,747,1068,1452,1805,12.84,4.57,3.67,2.7
21-10-2021,MONDIM DE BASTO,1,0,15,"[0,120]",Baixo a Moderado,,,,1,Norte,VILA REAL,1705,17207.52,6946,395,300,314,284,283,567,881,1181,1576,40.36,9.16,6.86,5.12
21-10-2021,MONFORTE,0,0,0,"[0,120]",Baixo a Moderado,,,,0,Alentejo,PORTALEGRE,1211,42024.82,2975,139,115,117,192,168,360,477,592,731,7.08,1.74,1.41,1.14
21-10-2021,MONTALEGRE,3,0,34,"[0,120]",Baixo a Moderado,,,,3,Norte,VILA REAL,1706,80545.71,8997,699,628,595,603,730,1333,1928,2556,3255,11.17,4.04,3.17,2.39
21-10-2021,MONTEMOR-O-NOVO,18,1,117,"[0,120]",Baixo a Moderado,,,,18,Alentejo,ÉVORA,0706,123296.65,15647,991,953,868,878,971,1849,2717,3670,4661,12.69,3.78,2.98,2.2
21-10-2021,MONTEMOR-O-VELHO,15,1,59,"[0,120]",Baixo a Moderado,,,,15,Centro,COIMBRA,0610,22896.23,25224,1496,1397,1217,1057,988,2045,3262,4659,6155,110.17,26.88,20.35,14.25
21-10-2021,MONTIJO,23,2,40,"[0,120]",Baixo a Moderado,,,,23,Lisboa e Vale do Tejo,SETÚBAL,1507,34861.64,57614,2771,2441,1990,1554,1109,2663,4653,7094,9865,165.26,28.3,20.35,13.35
21-10-2021,MORA,6,0,149,"[120,240]",Moderado,,,,6,Alentejo,ÉVORA,0707,44395.02,4138,336,275,252,238,257,495,747,1022,1358,9.32,3.06,2.3,1.68
21-10-2021,MORTÁGUA,0,0,0,"[0,120]",Baixo a Moderado,,,,0,Centro,VISEU,1808,25117.82,8803,638,584,535,499,460,959,1494,2078,2716,35.05,10.81,8.27,5.95
21-10-2021,MOURA,16,1,118,"[0,120]",Baixo a Moderado,,,,16,Alentejo,BEJA,0210,95845.55,13718,817,656,665,542,461,1003,1668,2324,3141,14.31,3.28,2.42,1.74
21-10-2021,MOURÃO,1,0,41,"[0,120]",Baixo a Moderado,,,,1,Alentejo,ÉVORA,0708,27862.98,2450,139,108,80,104,109,213,293,401,540,8.79,1.94,1.44,1.05
21-10-2021,MURÇA,6,0,111,"[0,120]",Baixo a Moderado,,,,6,Norte,VILA REAL,1707,18937.11,5463,384,341,307,306,319,625,932,1273,1657,28.85,8.75,6.72,4.92
21-10-2021,MURTOSA,7,0,67,"[0,120]",Baixo a Moderado,,,,7,Centro,AVEIRO,0112,7308.78,10279,509,473,403,353,409,762,1165,1638,2147,140.63,29.37,22.41,15.94
21-10-2021,NAZARÉ,12,1,84,"[0,120]",Baixo a Moderado,,,,12,Lisboa e Vale do Tejo,LEIRIA,1011,8243.43,14165,967,903,670,420,396,816,1486,2389,3356,171.84,40.71,28.98,18.03
21-10-2021,NELAS,5,0,39,"[0,120]",Baixo a Moderado,,,,5,Centro,VISEU,1809,12571.48,12974,924,787,668,604,583,1187,1855,2642,3566,103.21,28.37,21.02,14.76
21-10-2021,NISA,6,0,101,"[0,120]",Baixo a Moderado,,,,6,Alentejo,PORTALEGRE,1212,57567.84,6061,405,389,355,483,478,961,1316,1705,2110,10.53,3.67,2.96,2.29
21-10-2021,NORDESTE,3,0,62,"[0,120]",Baixo a Moderado,,,,3,Açores,AÇORES,4202,10146.8,4862,246,180,124,161,162,323,447,627,873,47.92,8.6,6.18,4.41
21-10-2021,ÓBIDOS,13,1,108,"[0,120]",Baixo a Moderado,,,,13,Lisboa e Vale do Tejo,LEIRIA,1012,14155.44,11850,743,650,574,452,436,888,1462,2112,2855,83.72,20.17,14.92,10.33
21-10-2021,ODEMIRA,31,2,126,"[120,240]",Moderado,,,,31,Alentejo,BEJA,0211,172060.15,24717,1475,1317,1225,1397,1349,2746,3971,5288,6763,14.37,3.93,3.07,2.31
21-10-2021,ODIVELAS,108,8,67,"[0,120]",Baixo a Moderado,,,,108,Lisboa e Vale do Tejo,LISBOA,1116,2654.36,161774,9562,9038,6952,4641,3812,8453,15405,24443,34005,6095.48,1281.27,920.99,580.44
21-10-2021,OEIRAS,124,9,70,"[0,120]",Baixo a Moderado,,,,124,Lisboa e Vale do Tejo,LISBOA,1110,4588.31,177408,11580,11575,8566,6211,5855,12066,20632,32207,43787,3866.78,954.38,701.98,449.69
21-10-2021,OLEIROS,4,0,80,"[0,120]",Baixo a Moderado,,,,4,Centro,CASTELO BRANCO,0506,47109.31,5003,384,341,366,397,487,884,1250,1591,1975,10.62,4.19,3.38,2.65
21-10-2021,OLHÃO,16,1,36,"[0,120]",Baixo a Moderado,,,,16,Algarve,FARO,0810,13086.38,44405,2455,2309,1689,1342,1268,2610,4299,6608,9063,339.33,69.26,50.5,32.85
21-10-2021,OLIVEIRA DE AZEMÉIS,65,5,99,"[0,120]",Baixo a Moderado,,,,65,Norte,AVEIRO,0113,16110.41,66011,4155,3614,2794,2183,1738,3921,6715,10329,14484,409.75,89.91,64.12,41.68
21-10-2021,OLIVEIRA DE FRADES,7,0,70,"[0,120]",Baixo a Moderado,,,,7,Centro,VISEU,1810,14534.62,9936,553,475,438,359,415,774,1212,1687,2240,68.36,15.41,11.61,8.34
21-10-2021,OLIVEIRA DO BAIRRO,10,1,40,"[0,120]",Baixo a Moderado,,,,10,Centro,AVEIRO,0114,8731.99,24277,1327,1182,999,786,810,1596,2595,3777,5104,278.02,58.45,43.25,29.72
21-10-2021,OLIVEIRA DO HOSPITAL,35,3,182,"[120,240]",Moderado,,,,35,Centro,COIMBRA,0611,23451.66,19253,1161,1097,962,924,960,1884,2846,3943,5104,82.1,21.76,16.81,12.14
21-10-2021,OURÉM,56,4,128,"[120,240]",Moderado,,,,56,Lisboa e Vale do Tejo,SANTARÉM,1421,41668.03,44044,2463,2069,1899,1817,1603,3420,5319,7388,9851,105.7,23.64,17.73,12.77
21-10-2021,OURIQUE,2,0,44,"[0,120]",Baixo a Moderado,,,,2,Alentejo,BEJA,0212,66331.36,4607,313,287,284,268,227,495,779,1066,1379,6.95,2.08,1.61,1.17
21-10-2021,OVAR,29,2,53,"[0,120]",Baixo a Moderado,,,,29,Centro,AVEIRO,0115,14770.25,54260,3294,2709,1994,1636,1234,2870,4864,7573,10867,367.37,73.57,51.27,32.93
21-10-2021,PAÇOS DE FERREIRA,17,1,30,"[0,120]",Baixo a Moderado,,,,17,Norte,PORTO,1309,7099.29,56728,2903,2193,1518,1135,664,1799,3317,5510,8413,799.1,118.51,77.62,46.72
21-10-2021,PALMELA,36,3,56,"[0,120]",Baixo a Moderado,,,,36,Lisboa e Vale do Tejo,SETÚBAL,1508,46512.01,64269,3402,3244,2635,1846,1391,3237,5872,9116,12518,138.18,26.91,19.6,12.62
21-10-2021,PAMPILHOSA DA SERRA,2,0,50,"[0,120]",Baixo a Moderado,,,,2,Centro,COIMBRA,0612,39646.24,4037,238,254,295,339,423,762,1057,1311,1549,10.18,3.91,3.31,2.67
21-10-2021,PAREDES,32,2,37,"[0,120]",Baixo a Moderado,,,,32,Norte,PORTO,1310,15675.69,86067,4272,3532,2412,1717,1258,2975,5387,8919,13191,549.04,84.15,56.9,34.36
21-10-2021,PAREDES DE COURA,3,0,35,"[0,120]",Baixo a Moderado,,,,3,Norte,VIANA DO CASTELO,1605,13818.59,8535,466,528,407,465,515,980,1387,1915,2381,61.76,17.23,13.86,10.04
21-10-2021,PEDRÓGÃO GRANDE,17,1,498,"[480,960]",Muito Elevado,,,,17,Centro,LEIRIA,1013,12874.75,3410,175,173,196,221,252,473,669,842,1017,26.49,7.9,6.54,5.2
21-10-2021,PENACOVA,1,0,7,"[0,120]",Baixo a Moderado,,,,1,Centro,COIMBRA,0613,21673.23,13694,968,923,745,621,703,1324,2069,2992,3960,63.18,18.27,13.81,9.55
21-10-2021,PENAFIEL,28,2,40,"[0,120]",Baixo a Moderado,,,,28,Norte,PORTO,1311,21224.27,69772,3648,2823,2032,1663,1230,2893,4925,7748,11396,328.74,53.69,36.51,23.2
21-10-2021,PENALVA DO CASTELO,4,0,56,"[0,120]",Baixo a Moderado,,,,4,Centro,VISEU,1811,13433.92,7115,449,457,413,391,426,817,1230,1687,2136,52.96,15.9,12.56,9.16
21-10-2021,PENAMACOR,40,3,847,"[480,960]",Muito Elevado,,,,40,Centro,CASTELO BRANCO,0507,56370.69,4755,262,248,273,451,633,1084,1357,1605,1867,8.44,3.31,2.85,2.41
21-10-2021,PENEDONO,55,4,2138,"[960,Max]",Extremamente Elevado,,,,55,Norte,VISEU,1812,13370.75,2591,172,113,129,156,138,294,423,536,708,19.38,5.3,4.01,3.16
21-10-2021,PENELA,0,0,0,"[0,120]",Baixo a Moderado,,,,0,Centro,COIMBRA,0614,13480.0,5397,314,324,274,359,344,703,977,1301,1615,40.04,11.98,9.65,7.25
21-10-2021,PENICHE,26,2,97,"[0,120]",Baixo a Moderado,,,,26,Lisboa e Vale do Tejo,LEIRIA,1014,7754.98,26501,1746,1504,1203,926,707,1633,2836,4340,6086,341.73,78.48,55.96,36.57
21-10-2021,PESO DA RÉGUA,14,1,89,"[0,120]",Baixo a Moderado,,,,14,Norte,VILA REAL,1708,9486.01,15773,1076,843,650,659,455,1114,1764,2607,3683,166.28,38.83,27.48,18.6
21-10-2021,PINHEL,2,0,24,"[0,120]",Baixo a Moderado,,,,2,Centro,GUARDA,0910,48452.12,8511,577,566,551,538,689,1227,1778,2344,2921,17.57,6.03,4.84,3.67
21-10-2021,POMBAL,38,3,74,"[0,120]",Baixo a Moderado,,,,38,Centro,LEIRIA,1015,62600.28,51461,3187,2791,2494,2328,2027,4355,6849,9640,12827,82.21,20.49,15.4,10.94
21-10-2021,PONTA DELGADA,123,9,181,"[120,240]",Moderado,,,,123,Açores,AÇORES,4203,23298.65,67935,3108,2435,1726,1133,902,2035,3761,6196,9304,291.58,39.93,26.59,16.14
21-10-2021,PONTA DO SOL,0,0,0,"[0,120]",Baixo a Moderado,,,,0,Madeira,MADEIRA,3105,4622.03,8593,319,283,347,208,221,429,776,1059,1378,185.92,29.81,22.91,16.79
21-10-2021,PONTE DA BARCA,16,1,144,"[120,240]",Moderado,,,,16,Norte,VIANA DO CASTELO,1606,18211.37,11180,635,576,517,554,490,1044,1561,2137,2772,61.39,15.22,11.73,8.57
21-10-2021,PONTE DE LIMA,12,1,29,"[0,120]",Baixo a Moderado,,,,12,Norte,VIANA DO CASTELO,1607,32025.46,41315,2321,2022,1720,1596,1462,3058,4778,6800,9121,129.01,28.48,21.23,14.92
21-10-2021,PONTE DE SOR,3,0,20,"[0,120]",Baixo a Moderado,,,,3,Alentejo,PORTALEGRE,1213,83971.16,14994,939,800,716,739,831,1570,2286,3086,4025,17.86,4.79,3.68,2.72
21-10-2021,PORTALEGRE,4,0,18,"[0,120]",Baixo a Moderado,,,,4,Alentejo,PORTALEGRE,1214,44713.64,22172,1577,1351,1137,993,984,1977,3114,4465,6042,49.59,13.51,9.99,6.96
21-10-2021,PORTEL,2,0,35,"[0,120]",Baixo a Moderado,,,,2,Alentejo,ÉVORA,0709,60100.57,5828,336,358,283,331,305,636,919,1277,1613,9.7,2.68,2.12,1.53
21-10-2021,PORTIMÃO,141,10,255,"[240,480]",Elevado,,,,141,Algarve,FARO,0811,18206.29,55483,3182,2927,2116,1582,1400,2982,5098,8025,11207,304.75,61.56,44.08,28.0
21-10-2021,PORTO,292,21,135,"[120,240]",Moderado,,,,292,Norte,PORTO,1312,4142.02,216606,15790,15193,11280,9409,10044,19453,30733,45926,61716,5229.5,1490.0,1108.79,741.98
21-10-2021,PORTO DE MÓS,11,1,47,"[0,120]",Baixo a Moderado,,,,11,Centro,LEIRIA,1016,26183.41,23275,1355,1210,1034,888,872,1760,2794,4004,5359,88.89,20.47,15.29,10.67
21-10-2021,PORTO MONIZ,2,0,87,"[0,120]",Baixo a Moderado,,,,2,Madeira,MADEIRA,3106,8293.38,2342,143,130,95,98,120,218,313,443,586,28.24,7.07,5.34,3.77
21-10-2021,PORTO SANTO,3,0,58,"[0,120]",Baixo a Moderado,,,,3,Madeira,MADEIRA,3201,4300.7,5202,240,157,134,110,68,178,312,469,709,120.95,16.48,10.9,7.25
21-10-2021,PÓVOA DE LANHOSO,6,0,28,"[0,120]",Baixo a Moderado,,,,6,Norte,BRAGA,0309,13465.29,21499,1175,909,732,673,624,1297,2029,2938,4113,159.67,30.55,21.82,15.07
21-10-2021,PÓVOA DE VARZIM,36,3,57,"[0,120]",Baixo a Moderado,,,,36,Norte,PORTO,1313,8220.59,62784,3712,3120,2134,1594,1305,2899,5033,8153,11865,763.7,144.33,99.17,61.22
21-10-2021,POVOAÇÃO,2,0,34,"[0,120]",Baixo a Moderado,,,,2,Açores,AÇORES,4204,10640.77,5927,293,212,191,144,134,278,469,681,974,55.7,9.15,6.4,4.41
21-10-2021,VILA DA PRAIA DA VITÓRIA,4,0,19,"[0,120]",Baixo a Moderado,,,,4,Açores,AÇORES,4302,16127.06,21317,1133,789,619,436,336,772,1391,2180,3313,132.18,20.54,13.52,8.63
21-10-2021,PROENÇA-A-NOVA,41,3,566,"[480,960]",Muito Elevado,,,,41,Centro,CASTELO BRANCO,0508,39539.96,7298,508,465,389,400,560,960,1349,1814,2322,18.46,5.87,4.59,3.41
21-10-2021,REDONDO,11,1,175,"[120,240]",Moderado,,,,11,Alentejo,ÉVORA,0710,36950.87,6353,349,325,288,288,354,642,930,1255,1604,17.19,4.34,3.4,2.52
21-10-2021,REGUENGOS DE MONSARAZ,38,3,383,"[240,480]",Elevado,,,,38,Alentejo,ÉVORA,0711,46399.72,10015,602,511,455,462,473,935,1390,1901,2503,21.58,5.39,4.1,3.0
21-10-2021,RESENDE,24,2,239,"[120,240]",Moderado,,,,24,Norte,VISEU,1813,12334.93,10137,560,493,448,433,422,855,1303,1796,2356,82.18,19.1,14.56,10.56
21-10-2021,RIBEIRA BRAVA,2,0,16,"[0,120]",Baixo a Moderado,,,,2,Madeira,MADEIRA,3107,6544.88,12435,648,500,411,311,287,598,1009,1509,2157,189.99,32.96,23.06,15.42
21-10-2021,RIBEIRA DE PENA,5,0,84,"[0,120]",Baixo a Moderado,,,,5,Norte,VILA REAL,1709,21745.98,6016,371,301,290,310,368,678,968,1269,1640,27.66,7.54,5.84,4.45
21-10-2021,RIBEIRA GRANDE,84,6,256,"[240,480]",Elevado,,,,84,Açores,AÇORES,4205,18015.13,32811,1163,689,512,345,253,598,1110,1799,2962,182.13,16.44,9.99,6.16
21-10-2021,RIO MAIOR,104,7,508,"[480,960]",Muito Elevado,,,,104,Lisboa e Vale do Tejo,SANTARÉM,1414,27276.45,20379,1251,1144,941,795,648,1443,2384,3528,4779,74.71,17.52,12.93,8.74
21-10-2021,SABROSA,3,0,51,"[0,120]",Baixo a Moderado,,,,3,Norte,VILA REAL,1710,15692.45,5918,393,314,304,302,350,652,956,1270,1663,37.71,10.6,8.09,6.09
21-10-2021,SABUGAL,10,1,95,"[0,120]",Baixo a Moderado,,,,10,Centro,GUARDA,0911,82269.82,10585,724,707,694,796,1009,1805,2499,3206,3930,12.87,4.78,3.9,3.04
21-10-2021,SALVATERRA DE MAGOS,11,1,52,"[0,120]",Baixo a Moderado,,,,11,Lisboa e Vale do Tejo,SANTARÉM,1415,24393.2,21295,1275,1181,1060,799,772,1571,2631,3812,5087,87.3,20.85,15.63,10.79
21-10-2021,SANTA COMBA DÃO,2,0,19,"[0,120]",Baixo a Moderado,,,,2,Centro,VISEU,1814,11194.77,10452,732,684,569,538,464,1002,1571,2255,2987,93.36,26.68,20.14,14.03
21-10-2021,SANTA CRUZ,22,2,48,"[0,120]",Baixo a Moderado,,,,22,Madeira,MADEIRA,3108,8150.28,45281,1817,1301,974,716,523,1239,2213,3514,5331,555.6,65.41,43.12,27.15
21-10-2021,SANTA CRUZ DA GRACIOSA,0,0,0,"[0,120]",Baixo a Moderado,,,,0,Açores,AÇORES,4401,6065.78,4208,228,180,163,124,145,269,432,612,840,69.37,13.85,10.09,7.12
21-10-2021,SANTA CRUZ DAS FLORES,0,0,0,"[0,120]",Baixo a Moderado,,,,0,Açores,AÇORES,4802,7091.44,2165,125,98,74,56,51,107,181,279,404,30.53,5.7,3.93,2.55
21-10-2021,SANTA MARIA DA FEIRA,105,8,76,"[0,120]",Baixo a Moderado,,,,105,Norte,AVEIRO,0109,21587.65,138636,8182,6743,4771,3856,3079,6935,11706,18449,26631,642.19,123.36,85.46,54.22
21-10-2021,SANTA MARTA DE PENAGUIÃO,25,2,381,"[240,480]",Elevado,,,,25,Norte,VILA REAL,1711,6928.13,6599,483,373,337,316,317,633,970,1343,1826,95.25,26.36,19.39,14.0
21-10-2021,SANTANA,1,0,15,"[0,120]",Baixo a Moderado,,,,1,Madeira,MADEIRA,3109,9547.3,6711,418,353,343,282,277,559,902,1255,1673,70.29,17.52,13.15,9.45
21-10-2021,SANTARÉM,86,6,149,"[120,240]",Moderado,,,,86,Lisboa e Vale do Tejo,SANTARÉM,1416,55253.58,57421,3654,3441,2760,2466,2206,4672,7432,10873,14527,103.92,26.29,19.68,13.45
21-10-2021,SANTIAGO DO CACÉM,17,1,59,"[0,120]",Baixo a Moderado,,,,17,Alentejo,SETÚBAL,1509,105969.29,28791,2144,1689,1472,1295,1215,2510,3982,5671,7815,27.17,7.37,5.35,3.76
21-10-2021,SANTO TIRSO,49,3,72,"[0,120]",Baixo a Moderado,,,,49,Norte,PORTO,1314,13655.52,68055,4911,3935,2761,2257,1810,4067,6828,10763,15674,498.35,114.78,78.82,50.0
21-10-2021,SÃO BRÁS DE ALPORTEL,6,0,58,"[0,120]",Baixo a Moderado,,,,6,Algarve,FARO,0812,15336.92,10416,596,468,467,404,401,805,1272,1740,2336,67.91,15.23,11.35,8.29
21-10-2021,SÃO JOÃO DA MADEIRA,24,2,109,"[0,120]",Baixo a Moderado,,,,24,Norte,AVEIRO,0116,794.3,21958,1347,1069,796,601,593,1194,1990,3059,4406,2765.49,554.91,385.26,250.63
21-10-2021,SÃO JOÃO DA PESQUEIRA,4,0,57,"[0,120]",Baixo a Moderado,,,,4,Norte,VISEU,1815,26610.85,7125,417,330,294,328,328,656,950,1280,1697,26.77,6.38,4.81,3.57
21-10-2021,SÃO PEDRO DO SUL,95,7,616,"[480,960]",Muito Elevado,,,,95,Centro,VISEU,1816,34895.09,15403,990,962,861,759,909,1668,2529,3491,4481,44.14,12.84,10.0,7.25
21-10-2021,SÃO ROQUE DO PICO,2,0,61,"[0,120]",Baixo a Moderado,,,,2,Açores,AÇORES,4603,14236.1,3266,199,141,93,96,113,209,302,443,642,22.94,4.51,3.11,2.12
21-10-2021,SÃO VICENTE,1,0,20,"[0,120]",Baixo a Moderado,,,,1,Madeira,MADEIRA,3110,7883.71,5143,272,264,266,225,280,505,771,1035,1307,65.23,16.58,13.13,9.78
21-10-2021,SARDOAL,7,1,188,"[120,240]",Moderado,,,,7,Lisboa e Vale do Tejo,SANTARÉM,1417,9214.72,3741,227,178,148,165,248,413,561,739,966,40.6,10.48,8.02,6.09
21-10-2021,SÁTÃO,9,1,77,"[0,120]",Baixo a Moderado,,,,9,Centro,VISEU,1817,20194.11,11580,765,671,515,465,476,941,1456,2127,2892,57.34,14.32,10.53,7.21
21-10-2021,SEIA,102,7,460,"[240,480]",Elevado,,,,102,Centro,GUARDA,0912,43568.83,22234,1807,1589,1238,1122,721,1843,3081,4670,6477,51.03,14.87,10.72,7.07
21-10-2021,SEIXAL,104,7,62,"[0,120]",Baixo a Moderado,,,,104,Lisboa e Vale do Tejo,SETÚBAL,1510,9545.17,167752,10586,9270,6661,4391,2930,7321,13982,23252,33838,1757.49,354.51,243.6,146.49
21-10-2021,SERNANCELHE,4,0,74,"[0,120]",Baixo a Moderado,,,,4,Norte,VISEU,1818,22861.22,5396,305,293,286,273,260,533,819,1112,1417,23.6,6.2,4.86,3.58
21-10-2021,SERPA,23,2,162,"[120,240]",Moderado,,,,23,Alentejo,BEJA,0213,110563.34,14304,903,761,719,697,626,1323,2042,2803,3706,12.94,3.35,2.54,1.85
21-10-2021,SERTÃ,16,1,110,"[0,120]",Baixo a Moderado,,,,16,Centro,CASTELO BRANCO,0509,44673.17,14577,870,779,790,767,1020,1787,2577,3356,4226,32.63,9.46,7.51,5.77
21-10-2021,SESIMBRA,33,2,64,"[0,120]",Baixo a Moderado,,,,33,Lisboa e Vale do Tejo,SETÚBAL,1511,19571.75,51858,2400,2321,1853,1257,1083,2340,4193,6514,8914,264.96,45.54,33.28,21.42
21-10-2021,SETÚBAL,74,5,64,"[0,120]",Baixo a Moderado,,,,74,Lisboa e Vale do Tejo,SETÚBAL,1512,23032.5,115126,7425,6929,5075,3775,2655,6430,11505,18434,25859,499.83,112.27,80.03,49.95
21-10-2021,SEVER DO VOUGA,7,1,62,"[0,120]",Baixo a Moderado,,,,7,Centro,AVEIRO,0117,12987.56,11331,766,637,568,540,567,1107,1675,2312,3078,87.24,23.7,17.8,12.9
21-10-2021,SILVES,41,3,113,"[0,120]",Baixo a Moderado,,,,41,Algarve,FARO,0813,68006.23,36226,2137,1869,1610,1423,1600,3023,4633,6502,8639,53.27,12.7,9.56,6.81
21-10-2021,SINES,8,1,58,"[0,120]",Baixo a Moderado,,,,8,Alentejo,SETÚBAL,1513,20330.17,13715,888,791,551,416,268,684,1235,2026,2914,67.46,14.33,9.97,6.07
21-10-2021,SINTRA,204,15,52,"[0,120]",Baixo a Moderado,,,,204,Lisboa e Vale do Tejo,LISBOA,1111,31922.73,391402,20490,18316,13545,9137,7284,16421,29966,48282,68772,1226.08,215.43,151.25,93.87
21-10-2021,SOBRAL DE MONTE AGRAÇO,8,1,74,"[0,120]",Baixo a Moderado,,,,8,Lisboa e Vale do Tejo,LISBOA,1112,5210.32,10651,564,507,352,272,212,484,836,1343,1907,204.43,36.6,25.78,16.05
21-10-2021,SOURE,18,1,106,"[0,120]",Baixo a Moderado,,,,18,Centro,COIMBRA,0615,26506.07,17120,1173,1142,1004,883,987,1870,2874,4016,5189,64.59,19.58,15.15,10.84
21-10-2021,SOUSEL,1,0,23,"[0,120]",Baixo a Moderado,,,,1,Alentejo,PORTALEGRE,1215,27932.18,4412,261,274,208,302,292,594,802,1076,1337,15.8,4.79,3.85,2.87
21-10-2021,TÁBUA,7,0,61,"[0,120]",Baixo a Moderado,,,,7,Centro,COIMBRA,0616,19978.58,11368,729,584,524,430,464,894,1418,2002,2731,56.9,13.67,10.02,7.1
21-10-2021,TABUAÇO,0,0,0,"[0,120]",Baixo a Moderado,,,,0,Norte,VISEU,1819,13385.67,6033,372,314,217,282,363,645,862,1176,1548,45.07,11.56,8.79,6.44
21-10-2021,TAROUCA,1,0,13,"[0,120]",Baixo a Moderado,,,,1,Norte,VISEU,1820,10008.49,7804,405,335,313,277,324,601,914,1249,1654,77.98,16.53,12.48,9.13
21-10-2021,TAVIRA,18,1,74,"[0,120]",Baixo a Moderado,,,,18,Algarve,FARO,0814,60696.7,24530,1493,1415,1252,1066,1277,2343,3595,5010,6503,40.41,10.71,8.25,5.92
21-10-2021,TERRAS DE BOURO,0,0,0,"[0,120]",Baixo a Moderado,,,,0,Norte,BRAGA,0310,27746.07,6361,391,372,296,319,340,659,955,1327,1718,22.93,6.19,4.78,3.44
21-10-2021,TOMAR,48,3,131,"[120,240]",Moderado,,,,48,Lisboa e Vale do Tejo,SANTARÉM,1418,35120.44,36748,2403,2189,1868,1853,1822,3675,5543,7732,10135,104.64,28.86,22.02,15.78
21-10-2021,TONDELA,22,2,83,"[0,120]",Baixo a Moderado,,,,22,Centro,VISEU,1821,37121.73,26357,1768,1722,1518,1475,1417,2892,4410,6132,7900,71.0,21.28,16.52,11.88
21-10-2021,TORRE DE MONCORVO,2,0,26,"[0,120]",Baixo a Moderado,,,,2,Norte,BRAGANÇA,0409,53155.67,7695,556,478,488,551,719,1270,1758,2236,2792,14.48,5.25,4.21,3.31
21-10-2021,TORRES NOVAS,37,3,105,"[0,120]",Baixo a Moderado,,,,37,Lisboa e Vale do Tejo,SANTARÉM,1419,26999.68,34933,2324,1979,1738,1406,1475,2881,4619,6598,8922,129.38,33.04,24.44,17.11
21-10-2021,TORRES VEDRAS,156,11,199,"[120,240]",Moderado,,,,156,Lisboa e Vale do Tejo,LISBOA,1113,40714.89,78530,4513,3945,3447,2628,2104,4732,8179,12124,16637,192.88,40.86,29.78,20.09
21-10-2021,TRANCOSO,2,0,22,"[0,120]",Baixo a Moderado,,,,2,Centro,GUARDA,0913,36152.47,8875,581,557,542,586,496,1082,1624,2181,2762,24.55,7.64,6.03,4.49
21-10-2021,TROFA,12,1,31,"[0,120]",Baixo a Moderado,,,,12,Norte,PORTO,1318,7201.76,38418,2336,1894,1231,939,684,1623,2854,4748,7084,533.44,98.36,65.93,39.63
21-10-2021,VAGOS,6,0,26,"[0,120]",Baixo a Moderado,,,,6,Centro,AVEIRO,0118,16491.5,22740,1320,1205,922,784,724,1508,2430,3635,4955,137.89,30.04,22.04,14.73
21-10-2021,VALE DE CAMBRA,16,1,75,"[0,120]",Baixo a Moderado,,,,16,Norte,AVEIRO,0119,14733.47,21327,1491,1363,1005,831,798,1629,2634,3997,5488,144.76,37.25,27.13,17.88
21-10-2021,VALENÇA,1,0,8,"[0,120]",Baixo a Moderado,,,,1,Norte,VIANA DO CASTELO,1608,11712.86,13290,867,791,582,582,503,1085,1667,2458,3325,113.46,28.39,20.99,14.23
21-10-2021,VALONGO,62,4,64,"[0,120]",Baixo a Moderado,,,,62,Norte,PORTO,1315,7512.45,97444,5629,4696,3207,2462,1829,4291,7498,12194,17823,1297.18,237.26,162.33,99.81
21-10-2021,VALPAÇOS,4,0,27,"[0,120]",Baixo a Moderado,,,,4,Norte,VILA REAL,1712,54873.93,14818,1217,1118,999,928,997,1925,2924,4042,5259,27.0,9.58,7.37,5.33
21-10-2021,VELAS,1,0,20,"[0,120]",Baixo a Moderado,,,,1,Açores,AÇORES,4502,11738.38,5093,278,208,166,153,113,266,432,640,918,43.39,7.82,5.45,3.68
21-10-2021,VENDAS NOVAS,1,0,9,"[0,120]",Baixo a Moderado,,,,1,Alentejo,ÉVORA,0712,22238.88,11255,677,768,655,501,532,1033,1688,2456,3133,50.61,14.09,11.04,7.59
21-10-2021,VIANA DO ALENTEJO,9,1,176,"[120,240]",Moderado,,,,9,Alentejo,ÉVORA,0713,39367.29,5145,245,208,235,210,214,424,659,867,1112,13.07,2.82,2.2,1.67
21-10-2021,VIANA DO CASTELO,35,3,42,"[0,120]",Baixo a Moderado,,,,35,Norte,VIANA DO CASTELO,1609,31902.01,84417,5470,4433,3591,3061,2982,6043,9634,14067,19537,264.61,61.24,44.09,30.2
21-10-2021,VIDIGUEIRA,4,0,73,"[0,120]",Baixo a Moderado,,,,4,Alentejo,BEJA,0214,31661.09,5510,300,248,215,233,275,508,723,971,1271,17.4,4.01,3.07,2.28
21-10-2021,VIEIRA DO MINHO,19,1,161,"[120,240]",Moderado,,,,19,Norte,BRAGA,0311,21644.35,11842,703,594,525,548,482,1030,1555,2149,2852,54.71,13.18,9.93,7.18
21-10-2021,VILA DE REI,4,0,120,"[120,240]",Moderado,,,,4,Centro,CASTELO BRANCO,0510,19154.6,3323,169,128,172,247,302,549,721,849,1018,17.35,5.31,4.43,3.76
21-10-2021,VILA DO BISPO,6,0,117,"[0,120]",Baixo a Moderado,,,,6,Algarve,FARO,0815,17906.06,5154,302,302,314,232,233,465,779,1081,1383,28.78,7.72,6.04,4.35
21-10-2021,VILA DO CONDE,38,3,48,"[0,120]",Baixo a Moderado,,,,38,Norte,PORTO,1316,14902.77,79899,4726,3875,2819,2070,1743,3813,6632,10507,15233,536.13,102.21,70.5,44.5
21-10-2021,VILA DO PORTO,6,0,107,"[0,120]",Baixo a Moderado,,,,6,Açores,AÇORES,4101,9688.74,5616,274,212,135,96,123,219,354,566,840,57.96,8.67,5.84,3.65
21-10-2021,VILA FLOR,0,0,0,"[0,120]",Baixo a Moderado,,,,0,Norte,BRAGANÇA,0410,26581.14,6044,429,362,422,294,331,625,1047,1409,1838,22.74,6.91,5.3,3.94
21-10-2021,VILA FRANCA DE XIRA,94,7,66,"[0,120]",Baixo a Moderado,,,,94,Lisboa e Vale do Tejo,LISBOA,1114,31819.39,141957,8501,6852,4869,3425,2472,5897,10766,17618,26119,446.14,82.09,55.37,33.84
21-10-2021,VILA FRANCA DO CAMPO,2,0,18,"[0,120]",Baixo a Moderado,,,,2,Açores,AÇORES,4206,7796.82,11051,450,344,248,217,154,371,619,963,1413,141.73,18.12,12.35,7.94
21-10-2021,VILA NOVA DA BARQUINHA,5,0,66,"[0,120]",Baixo a Moderado,,,,5,Lisboa e Vale do Tejo,SANTARÉM,1420,4952.97,7461,415,406,392,364,338,702,1094,1500,1915,150.64,38.66,30.28,22.09
21-10-2021,VILA NOVA DE CERVEIRA,3,0,34,"[0,120]",Baixo a Moderado,,,,3,Norte,VIANA DO CASTELO,1610,10846.66,8910,531,444,410,384,334,718,1128,1572,2103,82.14,19.39,14.49,10.4
21-10-2021,VILA NOVA DE FAMALICÃO,74,5,56,"[0,120]",Baixo a Moderado,,,,74,Norte,BRAGA,0312,20159.26,131676,7817,6164,4202,3282,2749,6031,10233,16397,24214,653.19,120.12,81.34,50.76
21-10-2021,VILA NOVA DE FOZ CÔA,3,0,47,"[0,120]",Baixo a Moderado,,,,3,Centro,GUARDA,0914,39815.18,6503,442,385,390,398,429,827,1217,1602,2044,16.33,5.13,4.02,3.06
21-10-2021,VILA NOVA DE GAIA,201,14,67,"[0,120]",Baixo a Moderado,,,,201,Norte,PORTO,1317,16846.43,300472,18349,15568,10972,8224,6281,14505,25477,41045,59394,1783.64,352.57,243.65,151.23
21-10-2021,VILA NOVA DE PAIVA,0,0,0,"[0,120]",Baixo a Moderado,,,,0,Centro,VISEU,1822,17553.28,4687,289,272,233,217,241,458,691,963,1252,26.7,7.13,5.49,3.94
21-10-2021,VILA NOVA DE POIARES,0,0,0,"[0,120]",Baixo a Moderado,,,,0,Centro,COIMBRA,0617,8445.3,6939,380,284,262,235,182,417,679,963,1343,82.17,15.9,11.4,8.04
21-10-2021,VILA POUCA DE AGUIAR,10,1,84,"[0,120]",Baixo a Moderado,,,,10,Norte,VILA REAL,1713,43706.62,11961,860,817,733,601,627,1228,1961,2778,3638,27.37,8.32,6.36,4.49
21-10-2021,VILA REAL,45,3,90,"[0,120]",Baixo a Moderado,,,,45,Norte,VILA REAL,1714,37880.28,49962,3025,2498,2065,1579,1466,3045,5110,7608,10633,131.9,28.07,20.08,13.49
21-10-2021,VILA REAL DE SANTO ANTÓNIO,2,0,11,"[0,120]",Baixo a Moderado,,,,2,Algarve,FARO,0816,6125.0,18749,1172,1069,811,569,586,1155,1966,3035,4207,306.11,68.69,49.55,32.1
21-10-2021,VILA VELHA DE RÓDÃO,0,0,0,"[0,120]",Baixo a Moderado,,,,0,Centro,CASTELO BRANCO,0511,32991.16,3144,209,229,180,283,306,589,769,998,1207,9.53,3.66,3.03,2.33
21-10-2021,VILA VERDE,48,3,103,"[0,120]",Baixo a Moderado,,,,48,Norte,BRAGA,0313,22866.52,46911,2365,2063,1667,1494,1437,2931,4598,6661,9026,205.15,39.47,29.13,20.11
21-10-2021,VILA VIÇOSA,0,0,0,"[0,120]",Baixo a Moderado,,,,0,Alentejo,ÉVORA,0714,19485.89,7656,487,379,342,345,324,669,1011,1390,1877,39.29,9.63,7.13,5.19
21-10-2021,VIMIOSO,0,0,0,"[0,120]",Baixo a Moderado,,,,0,Norte,BRAGANÇA,0411,48158.51,4023,274,230,261,293,335,628,889,1119,1393,8.35,2.89,2.32,1.85
21-10-2021,VINHAIS,1,0,13,"[0,120]",Baixo a Moderado,,,,1,Norte,BRAGANÇA,0412,69475.09,7746,599,577,636,641,815,1456,2092,2669,3268,11.15,4.7,3.84,3.01
21-10-2021,VISEU,85,6,87,"[0,120]",Baixo a Moderado,,,,85,Centro,VISEU,1823,50710.14,97249,5769,5038,4140,3158,2710,5868,10008,15046,20815,191.77,41.05,29.67,19.74
21-10-2021,VIZELA,8,1,33,"[0,120]",Baixo a Moderado,,,,8,Norte,BRAGA,0314,2469.83,23897,1258,928,655,509,371,880,1535,2463,3721,967.49,150.65,99.72,62.15
21-10-2021,VOUZELA,11,1,114,"[0,120]",Baixo a Moderado,,,,11,Centro,VISEU,1824,19369.46,9619,626,605,554,532,507,1039,1593,2198,2824,49.66,14.58,11.35,8.22
28-10-2021,ABRANTES,22,2,63,"[0,120]",Baixo a Moderado,,,,22,Lisboa e Vale do Tejo,SANTARÉM,1401,71469.08,35130,2473,2213,1730,1748,2021,3769,5499,7712,10185,49.15,14.25,10.79,7.69
28-10-2021,ÁGUEDA,26,2,56,"[0,120]",Baixo a Moderado,,,,26,Centro,AVEIRO,0101,33527.44,46075,3237,2713,2090,1635,1496,3131,5221,7934,11171,137.43,33.32,23.66,15.57
28-10-2021,AGUIAR DA BEIRA,0,0,0,"[0,120]",Baixo a Moderado,,,,0,Centro,GUARDA,0901,20676.57,4652,304,281,235,239,148,387,622,903,1207,22.5,5.84,4.37,3.01
28-10-2021,ALANDROAL,3,0,61,"[0,120]",Baixo a Moderado,,,,3,Alentejo,ÉVORA,0701,54267.81,4992,307,256,296,299,377,676,972,1228,1535,9.2,2.83,2.26,1.79
28-10-2021,ALBERGARIA-A-VELHA,68,5,280,"[240,480]",Elevado,,,,68,Centro,AVEIRO,0102,15882.5,24144,1550,1298,996,687,680,1367,2363,3661,5211,152.02,32.81,23.05,14.88
28-10-2021,ALBUFEIRA,86,6,208,"[120,240]",Moderado,,,,86,Algarve,FARO,0801,14066.42,41528,2067,1717,1425,985,858,1843,3268,4985,7052,295.24,50.14,35.44,23.23
28-10-2021,ALCÁCER DO SAL,7,1,61,"[0,120]",Baixo a Moderado,,,,7,Alentejo,SETÚBAL,1501,149987.3,11659,884,814,623,623,602,1225,1848,2662,3546,7.77,2.36,1.77,1.23
28-10-2021,ALCANENA,14,1,109,"[0,120]",Baixo a Moderado,,,,14,Lisboa e Vale do Tejo,SANTARÉM,1402,12732.86,12809,891,744,628,536,588,1124,1752,2496,3387,100.6,26.6,19.6,13.76
28-10-2021,ALCOBAÇA,77,5,143,"[120,240]",Moderado,,,,77,Lisboa e Vale do Tejo,LEIRIA,1001,40814.09,53555,3420,2927,2466,2059,1676,3735,6201,9128,12548,131.22,30.74,22.36,15.19
28-10-2021,ALCOCHETE,12,1,60,"[0,120]",Baixo a Moderado,,,,12,Lisboa e Vale do Tejo,SETÚBAL,1502,12836.48,19787,857,834,691,476,447,923,1614,2448,3305,154.15,25.75,19.07,12.57
28-10-2021,ALCOUTIM,0,0,0,"[0,120]",Baixo a Moderado,,,,0,Algarve,FARO,0802,57536.33,2159,191,188,163,190,267,457,620,808,999,3.75,1.74,1.4,1.08
28-10-2021,ALENQUER,11,1,25,"[0,120]",Baixo a Moderado,,,,11,Lisboa e Vale do Tejo,LISBOA,1101,30421.92,44052,2298,2062,1629,1330,1155,2485,4114,6176,8474,144.8,27.85,20.3,13.52
28-10-2021,ALFÂNDEGA DA FÉ,2,0,45,"[0,120]",Baixo a Moderado,,,,2,Norte,BRAGANÇA,0401,32194.64,4550,325,277,301,274,325,599,900,1177,1502,14.13,4.67,3.66,2.8
28-10-2021,ALIJÓ,14,1,133,"[120,240]",Moderado,,,,14,Norte,VILA REAL,1701,29759.89,10625,766,687,635,542,666,1208,1843,2530,3296,35.7,11.08,8.5,6.19
28-10-2021,ALJEZUR,5,0,89,"[0,120]",Baixo a Moderado,,,,5,Algarve,FARO,0803,32349.95,5594,316,336,335,320,410,730,1065,1401,1717,17.29,5.31,4.33,3.29
28-10-2021,ALJUSTREL,2,0,25,"[0,120]",Baixo a Moderado,,,,2,Alentejo,BEJA,0201,45847.41,8247,635,521,443,347,358,705,1148,1669,2304,17.99,5.03,3.64,2.5
28-10-2021,ALMADA,115,8,68,"[0,120]",Baixo a Moderado,,,,115,Lisboa e Vale do Tejo,SETÚBAL,1503,7000.89,169039,10469,9777,7876,6144,5111,11255,19131,28908,39377,2414.5,562.45,412.91,273.26
28-10-2021,ALMEIDA,2,0,35,"[0,120]",Baixo a Moderado,,,,2,Centro,GUARDA,0902,51798.46,5830,441,419,396,458,393,851,1247,1666,2107,11.26,4.07,3.22,2.41
28-10-2021,ALMEIRIM,53,4,236,"[120,240]",Moderado,,,,53,Lisboa e Vale do Tejo,SANTARÉM,1403,22212.05,22546,1342,1353,1106,866,843,1709,2815,4168,5510,101.5,24.81,18.76,12.67
28-10-2021,ALMODÔVAR,22,2,330,"[240,480]",Elevado,,,,22,Alentejo,BEJA,0202,77788.03,6725,414,443,396,373,328,701,1097,1540,1954,8.65,2.51,1.98,1.41
28-10-2021,ALPIARÇA,9,1,129,"[120,240]",Moderado,,,,9,Lisboa e Vale do Tejo,SANTARÉM,1404,9536.33,7059,515,486,363,333,274,607,970,1456,1971,74.02,20.67,15.27,10.17
28-10-2021,ALTER DO CHÃO,1,0,32,"[0,120]",Baixo a Moderado,,,,1,Alentejo,PORTALEGRE,1201,36206.62,3165,201,163,136,208,187,395,531,694,895,8.74,2.47,1.92,1.47
28-10-2021,ALVAIÁZERE,3,0,46,"[0,120]",Baixo a Moderado,,,,3,Centro,LEIRIA,1002,16047.76,6597,419,389,346,406,539,945,1291,1680,2099,41.11,13.08,10.47,8.04
28-10-2021,ALVITO,9,1,365,"[240,480]",Elevado,,,,9,Alentejo,BEJA,0203,26485.32,2477,145,110,105,111,89,200,305,415,560,9.35,2.11,1.57,1.15
28-10-2021,AMADORA,98,7,53,"[0,120]",Baixo a Moderado,,,,98,Lisboa e Vale do Tejo,LISBOA,1115,2378.47,184106,11186,10936,8780,6460,5890,12350,21130,32066,43252,7742.05,1818.84,1348.44,888.56
28-10-2021,AMARANTE,30,2,57,"[0,120]",Baixo a Moderado,,,,30,Norte,PORTO,1301,30133.15,53193,3086,2413,1812,1643,1311,2954,4766,7179,10265,176.53,34.07,23.82,15.82
28-10-2021,AMARES,7,1,39,"[0,120]",Baixo a Moderado,,,,7,Norte,BRAGA,0301,8195.41,18129,1001,829,622,489,524,1013,1635,2464,3465,221.22,42.28,30.07,19.95
28-10-2021,ANADIA,20,1,73,"[0,120]",Baixo a Moderado,,,,20,Centro,AVEIRO,0103,21663.48,27258,1931,1698,1376,1208,1262,2470,3846,5544,7475,125.83,34.51,25.59,17.75
28-10-2021,ANGRA DO HEROÍSMO,6,0,18,"[0,120]",Baixo a Moderado,,,,6,Açores,AÇORES,4301,23899.66,33807,2006,1473,1122,768,635,1403,2525,3998,6004,141.45,25.12,16.73,10.56
28-10-2021,ANSIÃO,3,0,25,"[0,120]",Baixo a Moderado,,,,3,Centro,LEIRIA,1003,17609.42,12039,727,709,646,694,530,1224,1870,2579,3306,68.37,18.77,14.65,10.62
28-10-2021,ARCOS DE VALDEVEZ,56,4,269,"[240,480]",Elevado,,,,56,Norte,VIANA DO CASTELO,1601,44759.64,20926,1329,1338,1282,1343,1515,2858,4140,5478,6807,46.75,15.21,12.24,9.25
28-10-2021,ARGANIL,5,0,45,"[0,120]",Baixo a Moderado,,,,5,Centro,COIMBRA,0601,33283.93,11014,672,648,612,559,596,1155,1767,2415,3087,33.09,9.27,7.26,5.31
28-10-2021,ARMAMAR,0,0,0,"[0,120]",Baixo a Moderado,,,,0,Norte,VISEU,1801,11723.73,5769,357,305,309,285,310,595,904,1209,1566,49.21,13.36,10.31,7.71
28-10-2021,AROUCA,29,2,141,"[120,240]",Moderado,,,,29,Norte,AVEIRO,0104,32910.52,20720,1306,1047,753,683,683,1366,2119,3166,4472,62.96,13.59,9.62,6.44
28-10-2021,ARRAIOLOS,0,0,0,"[0,120]",Baixo a Moderado,,,,0,Alentejo,ÉVORA,0702,68374.55,6928,435,384,283,367,480,847,1130,1514,1949,10.13,2.85,2.21,1.65
28-10-2021,ARRONCHES,1,0,36,"[0,120]",Baixo a Moderado,,,,1,Alentejo,PORTALEGRE,1202,31464.72,2820,155,142,162,187,179,366,528,670,825,8.96,2.62,2.13,1.68
28-10-2021,ARRUDA DOS VINHOS,8,1,51,"[0,120]",Baixo a Moderado,,,,8,Lisboa e Vale do Tejo,LISBOA,1102,7795.93,15412,738,738,562,509,438,947,1509,2247,2985,197.69,38.29,28.82,19.36
28-10-2021,AVEIRO,109,8,138,"[120,240]",Moderado,,,,109,Centro,AVEIRO,0105,19757.57,78734,4520,4004,3050,2250,2103,4353,7403,11407,15927,398.49,80.61,57.73,37.47
28-10-2021,AVIS,0,0,0,"[0,120]",Baixo a Moderado,,,,0,Alentejo,PORTALEGRE,1203,60596.51,4247,315,225,206,251,273,524,730,955,1270,7.01,2.1,1.58,1.2
28-10-2021,AZAMBUJA,40,3,175,"[120,240]",Moderado,,,,40,Lisboa e Vale do Tejo,LISBOA,1103,26265.65,22716,1322,1171,1070,798,618,1416,2486,3657,4979,86.48,18.96,13.92,9.46
28-10-2021,BAIÃO,5,0,27,"[0,120]",Baixo a Moderado,,,,5,Norte,PORTO,1302,17452.83,18748,1070,862,714,686,725,1411,2125,2987,4057,107.42,23.25,17.11,12.18
28-10-2021,BARCELOS,40,3,34,"[0,120]",Baixo a Moderado,,,,40,Norte,BRAGA,0302,37890.14,116187,6721,5325,3619,2991,2562,5553,9172,14497,21218,306.64,56.0,38.26,24.21
28-10-2021,BARRANCOS,0,0,0,"[0,120]",Baixo a Moderado,,,,0,Alentejo,BEJA,0204,16841.73,1634,90,65,65,94,61,155,220,285,375,9.7,2.23,1.69,1.31
28-10-2021,BARREIRO,51,4,68,"[0,120]",Baixo a Moderado,,,,51,Lisboa e Vale do Tejo,SETÚBAL,1504,3639.07,75147,5194,5565,4459,3105,1767,4872,9331,14896,20090,2065.05,552.07,409.34,256.42
28-10-2021,BATALHA,9,1,56,"[0,120]",Baixo a Moderado,,,,9,Centro,LEIRIA,1004,10341.6,15963,873,762,649,529,549,1078,1727,2489,3362,154.35,32.51,24.07,16.7
28-10-2021,BEJA,71,5,210,"[120,240]",Moderado,,,,71,Alentejo,BEJA,0205,114647.55,33579,2005,1840,1386,1272,1039,2311,3697,5537,7542,29.29,6.58,4.83,3.22
28-10-2021,BELMONTE,5,0,78,"[0,120]",Baixo a Moderado,,,,5,Centro,CASTELO BRANCO,0501,11875.91,6398,444,321,325,310,355,665,990,1311,1755,53.87,14.78,11.04,8.34
28-10-2021,BENAVENTE,36,3,117,"[0,120]",Baixo a Moderado,,,,36,Lisboa e Vale do Tejo,SANTARÉM,1405,52138.39,30602,1468,1376,1141,876,643,1519,2660,4036,5504,58.69,10.56,7.74,5.1
28-10-2021,BOMBARRAL,9,1,71,"[0,120]",Baixo a Moderado,,,,9,Lisboa e Vale do Tejo,LEIRIA,1005,9128.55,12558,875,714,561,491,429,920,1481,2195,3070,137.56,33.63,24.04,16.22
28-10-2021,BORBA,3,0,45,"[0,120]",Baixo a Moderado,,,,3,Alentejo,ÉVORA,0703,14518.65,6736,430,375,279,436,392,828,1107,1482,1912,46.39,13.17,10.21,7.62
28-10-2021,BOTICAS,0,0,0,"[0,120]",Baixo a Moderado,,,,0,Norte,VILA REAL,1702,32195.66,4998,347,306,311,305,380,685,996,1302,1649,15.52,5.12,4.04,3.09
28-10-2021,BRAGA,168,12,92,"[0,120]",Baixo a Moderado,,,,168,Norte,BRAGA,0303,18339.95,182679,10029,7963,5241,4320,3671,7991,13232,21195,31224,996.07,170.25,115.57,72.15
28-10-2021,BRAGANÇA,31,2,93,"[0,120]",Baixo a Moderado,,,,31,Norte,BRAGANÇA,0402,117357.27,33607,2402,1855,1652,1393,1163,2556,4208,6063,8465,28.64,7.21,5.17,3.59
28-10-2021,CABECEIRAS DE BASTO,4,0,26,"[0,120]",Baixo a Moderado,,,,4,Norte,BRAGA,0304,24182.16,15628,774,594,544,575,574,1149,1693,2287,3061,64.63,12.66,9.46,7.0
28-10-2021,CADAVAL,43,3,313,"[240,480]",Elevado,,,,43,Lisboa e Vale do Tejo,LISBOA,1104,17489.3,13673,813,796,756,621,625,1246,2002,2798,3611,78.18,20.65,16.0,11.45
28-10-2021,CALDAS DA RAINHA,77,6,149,"[120,240]",Moderado,,,,77,Lisboa e Vale do Tejo,LEIRIA,1006,25569.47,51912,3035,2684,2186,1899,1705,3604,5790,8474,11509,203.03,45.01,33.14,22.64
28-10-2021,CALHETA,3,0,28,"[0,120]",Baixo a Moderado,,,,3,Madeira,MADEIRA,3101,11150.43,10867,576,497,507,399,415,814,1321,1818,2394,97.46,21.47,16.3,11.85
28-10-2021,CALHETA (AÇORES),1,0,32,"[0,120]",Baixo a Moderado,,,,1,Açores,AÇORES,4501,12626.4,3184,215,159,141,139,122,261,402,561,776,25.22,6.15,4.44,3.18
28-10-2021,CÂMARA DE LOBOS,12,1,36,"[0,120]",Baixo a Moderado,,,,12,Madeira,MADEIRA,3102,5216.67,33675,1396,1059,834,545,381,926,1760,2819,4215,645.49,80.79,54.03,33.74
28-10-2021,CAMINHA,13,1,82,"[0,120]",Baixo a Moderado,,,,13,Norte,VIANA DO CASTELO,1602,13652.14,15877,1046,944,818,646,656,1302,2120,3064,4110,116.3,30.11,22.44,15.53
28-10-2021,CAMPO MAIOR,4,0,51,"[0,120]",Baixo a Moderado,,,,4,Alentejo,PORTALEGRE,1204,24720.16,7874,471,364,351,279,327,606,957,1321,1792,31.85,7.25,5.34,3.87
28-10-2021,CANTANHEDE,15,1,43,"[0,120]",Baixo a Moderado,,,,15,Centro,COIMBRA,0602,39088.02,35011,2346,2096,1880,1709,1451,3160,5040,7136,9482,89.57,24.26,18.26,12.89
28-10-2021,CARRAZEDA DE ANSIÃES,1,0,18,"[0,120]",Baixo a Moderado,,,,1,Norte,BRAGANÇA,0403,27924.09,5666,424,389,391,312,465,777,1168,1557,1981,20.29,7.09,5.58,4.18
28-10-2021,CARREGAL DO SAL,8,1,86,"[0,120]",Baixo a Moderado,,,,8,Centro,VISEU,1802,11689.21,9271,587,562,486,462,376,838,1324,1886,2473,79.31,21.16,16.13,11.33
28-10-2021,CARTAXO,31,2,130,"[120,240]",Moderado,,,,31,Lisboa e Vale do Tejo,SANTARÉM,1406,15817.28,23843,1415,1376,1142,861,632,1493,2635,4011,5426,150.74,34.3,25.36,16.66
28-10-2021,CASCAIS,229,16,107,"[0,120]",Baixo a Moderado,,,,229,Lisboa e Vale do Tejo,LISBOA,1105,9740.17,213608,12151,11444,8680,6469,5248,11717,20397,31841,43992,2193.1,451.66,326.91,209.41
28-10-2021,CASTANHEIRA DE PÊRA,0,0,0,"[0,120]",Baixo a Moderado,,,,0,Centro,LEIRIA,1007,6677.45,2614,233,195,157,190,187,377,534,729,962,39.15,14.41,10.92,8.0
28-10-2021,CASTELO BRANCO,148,11,285,"[240,480]",Elevado,,,,148,Centro,CASTELO BRANCO,0502,143819.15,51987,3528,3042,2499,2229,2225,4454,6953,9995,13523,36.15,9.4,6.95,4.83
28-10-2021,CASTELO DE PAIVA,9,1,59,"[0,120]",Baixo a Moderado,,,,9,Norte,AVEIRO,0106,11500.53,15454,881,697,545,420,431,851,1396,2093,2974,134.37,25.86,18.2,12.14
28-10-2021,CASTELO DE VIDE,0,0,0,"[0,120]",Baixo a Moderado,,,,0,Alentejo,PORTALEGRE,1205,26491.24,2919,204,173,179,147,170,317,496,669,873,11.02,3.3,2.53,1.87
28-10-2021,CASTRO DAIRE,18,1,130,"[120,240]",Moderado,,,,18,Centro,VISEU,1803,37904.13,13823,942,857,765,732,773,1505,2270,3127,4069,36.47,10.74,8.25,5.99
28-10-2021,CASTRO MARIM,8,1,129,"[120,240]",Moderado,,,,8,Algarve,FARO,0804,30084.37,6237,370,345,334,322,344,666,1000,1345,1715,20.73,5.7,4.47,3.32
28-10-2021,CASTRO VERDE,10,1,145,"[120,240]",Moderado,,,,10,Alentejo,BEJA,0206,56944.23,6949,437,347,303,275,227,502,805,1152,1589,12.2,2.79,2.02,1.41
28-10-2021,CELORICO DA BEIRA,0,0,0,"[0,120]",Baixo a Moderado,,,,0,Centro,GUARDA,0903,24721.63,6928,430,416,363,369,535,904,1267,1683,2113,28.02,8.55,6.81,5.12
28-10-2021,CELORICO DE BASTO,12,1,63,"[0,120]",Baixo a Moderado,,,,12,Norte,BRAGA,0305,18107.02,19040,1001,802,668,728,729,1457,2125,2927,3928,105.15,21.69,16.17,11.74
28-10-2021,CHAMUSCA,9,1,99,"[0,120]",Baixo a Moderado,,,,9,Lisboa e Vale do Tejo,SANTARÉM,1407,74600.54,9197,629,583,553,465,579,1044,1597,2180,2809,12.33,3.77,2.92,2.14
28-10-2021,CHAVES,7,1,18,"[0,120]",Baixo a Moderado,,,,7,Norte,VILA REAL,1703,59122.95,39343,2676,2429,1991,1886,1918,3804,5795,8224,10900,66.54,18.44,13.91,9.8
28-10-2021,CINFÃES,1,0,6,"[0,120]",Baixo a Moderado,,,,1,Norte,VISEU,1804,23928.76,18244,1067,902,779,734,758,1492,2271,3173,4240,76.24,17.72,13.26,9.49
28-10-2021,COIMBRA,62,4,46,"[0,120]",Baixo a Moderado,,,,62,Centro,COIMBRA,0603,31939.94,134166,9489,8734,6353,5139,5074,10213,16566,25300,34789,420.06,108.92,79.21,51.87
28-10-2021,CONDEIXA-A-NOVA,20,1,112,"[0,120]",Baixo a Moderado,,,,20,Centro,COIMBRA,0604,13867.47,17733,871,809,717,583,490,1073,1790,2599,3470,127.88,25.02,18.74,12.91
28-10-2021,CONSTÂNCIA,0,0,0,"[0,120]",Baixo a Moderado,,,,0,Lisboa e Vale do Tejo,SANTARÉM,1408,8036.58,4030,211,183,187,148,155,303,490,673,884,50.14,11.0,8.37,6.1
28-10-2021,CORUCHE,15,1,87,"[0,120]",Baixo a Moderado,,,,15,Lisboa e Vale do Tejo,SANTARÉM,1409,111572.03,17471,1294,1090,1095,1096,1019,2115,3210,4300,5594,15.66,5.01,3.85,2.88
28-10-2021,CORVO,0,0,0,"[0,120]",Baixo a Moderado,,,,0,Açores,AÇORES,4901,1711.45,464,22,21,11,13,19,32,43,64,86,27.12,5.03,3.74,2.51
28-10-2021,COVILHÃ,156,11,334,"[240,480]",Elevado,,,,156,Centro,CASTELO BRANCO,0503,55560.06,46787,3533,2998,2365,2111,2193,4304,6669,9667,13200,84.21,23.76,17.4,12.0
28-10-2021,CRATO,1,0,33,"[0,120]",Baixo a Moderado,,,,1,Alentejo,PORTALEGRE,1206,39806.88,3129,229,258,163,182,228,410,573,831,1060,7.86,2.66,2.09,1.44
28-10-2021,CUBA,21,2,462,"[240,480]",Elevado,,,,21,Alentejo,BEJA,0207,17208.72,4595,255,233,206,190,143,333,539,772,1027,26.7,5.97,4.49,3.13
28-10-2021,ELVAS,5,0,25,"[0,120]",Baixo a Moderado,,,,5,Alentejo,PORTALEGRE,1207,63128.86,20528,1057,1145,902,852,810,1662,2564,3709,4766,32.52,7.55,5.88,4.06
28-10-2021,ENTRONCAMENTO,27,2,123,"[120,240]",Moderado,,,,27,Lisboa e Vale do Tejo,SANTARÉM,1410,1372.81,21558,1066,930,868,695,592,1287,2155,3085,4151,1570.14,302.33,224.69,156.96
28-10-2021,ESPINHO,25,2,85,"[0,120]",Baixo a Moderado,,,,25,Norte,AVEIRO,0107,2105.68,29516,2205,1993,1430,1177,960,2137,3567,5560,7765,1401.52,368.71,264.01,169.37
28-10-2021,ESPOSENDE,19,1,56,"[0,120]",Baixo a Moderado,,,,19,Norte,BRAGA,0306,9540.98,34177,1831,1522,1095,894,723,1617,2712,4234,6065,358.21,63.57,44.38,28.42
28-10-2021,ESTARREJA,11,1,42,"[0,120]",Baixo a Moderado,,,,11,Centro,AVEIRO,0108,10817.33,26006,1503,1399,1106,953,728,1681,2787,4186,5689,240.42,52.59,38.7,25.76
28-10-2021,ESTREMOZ,5,0,40,"[0,120]",Baixo a Moderado,,,,5,Alentejo,ÉVORA,0704,51379.95,12728,789,613,697,786,877,1663,2360,2973,3762,24.77,7.32,5.79,4.59
28-10-2021,ÉVORA,45,3,86,"[0,120]",Baixo a Moderado,,,,45,Alentejo,ÉVORA,0705,130707.58,52428,3569,2852,2176,1966,1803,3769,5945,8797,12366,40.11,9.46,6.73,4.55
28-10-2021,FAFE,27,2,57,"[0,120]",Baixo a Moderado,,,,27,Norte,BRAGA,0307,21908.11,48060,3044,2455,1679,1403,1208,2611,4290,6745,9789,219.37,44.68,30.79,19.58
28-10-2021,FARO,92,7,151,"[120,240]",Moderado,,,,92,Algarve,FARO,0805,20256.79,61015,3847,3364,2604,2055,1601,3656,6260,9624,13471,301.2,66.5,47.51,30.9
28-10-2021,FELGUEIRAS,42,3,75,"[0,120]",Baixo a Moderado,,,,42,Norte,PORTO,1303,11573.75,56422,2951,2302,1601,1316,973,2289,3890,6192,9143,487.49,79.0,53.5,33.61
28-10-2021,FERREIRA DO ALENTEJO,31,2,397,"[240,480]",Elevado,,,,31,Alentejo,BEJA,0208,64820.68,7845,515,414,372,343,345,688,1060,1474,1989,12.1,3.07,2.27,1.64
28-10-2021,FERREIRA DO ZÊZERE,1,0,13,"[0,120]",Baixo a Moderado,,,,1,Lisboa e Vale do Tejo,SANTARÉM,1411,19038.03,7959,470,370,416,465,456,921,1337,1707,2177,41.81,11.44,8.97,7.02
28-10-2021,FIGUEIRA DA FOZ,41,3,70,"[0,120]",Baixo a Moderado,,,,41,Centro,COIMBRA,0605,37905.26,58747,4032,3597,2887,2495,2043,4538,7425,11022,15054,154.98,39.72,29.08,19.59
28-10-2021,FIGUEIRA DE CASTELO RODRIGO,1,0,18,"[0,120]",Baixo a Moderado,,,,1,Centro,GUARDA,0904,50857.46,5584,347,352,290,352,391,743,1033,1385,1732,10.98,3.41,2.72,2.03
28-10-2021,FIGUEIRÓ DOS VINHOS,3,0,54,"[0,120]",Baixo a Moderado,,,,3,Centro,LEIRIA,1008,17344.0,5568,402,386,322,309,351,660,982,1368,1770,32.1,10.21,7.89,5.66
28-10-2021,FORNOS DE ALGODRES,1,0,22,"[0,120]",Baixo a Moderado,,,,1,Centro,GUARDA,0905,13145.05,4528,261,218,247,256,232,488,735,953,1214,34.45,9.24,7.25,5.59
28-10-2021,FREIXO DE ESPADA À CINTA,1,0,31,"[0,120]",Baixo a Moderado,,,,1,Norte,BRAGANÇA,0404,24414.29,3298,211,177,231,196,189,385,616,793,1004,13.51,4.11,3.25,2.52
28-10-2021,FRONTEIRA,0,0,0,"[0,120]",Baixo a Moderado,,,,0,Alentejo,PORTALEGRE,1208,24859.58,2974,213,182,149,156,168,324,473,655,868,11.96,3.49,2.63,1.9
28-10-2021,FUNCHAL,136,10,131,"[120,240]",Moderado,,,,136,Madeira,MADEIRA,3103,7616.2,104024,6382,5086,3643,2821,1990,4811,8454,13540,19922,1365.86,261.58,177.78,111.0
28-10-2021,FUNDÃO,51,4,193,"[120,240]",Moderado,,,,51,Centro,CASTELO BRANCO,0504,70019.79,26495,1781,1464,1432,1357,1643,3000,4432,5896,7677,37.84,10.96,8.42,6.33
28-10-2021,GAVIÃO,2,0,63,"[0,120]",Baixo a Moderado,,,,2,Alentejo,PORTALEGRE,1209,29459.45,3263,189,186,222,263,293,556,778,964,1153,11.08,3.91,3.27,2.64
28-10-2021,GÓIS,1,0,27,"[0,120]",Baixo a Moderado,,,,1,Centro,COIMBRA,0606,26330.19,3805,235,199,240,233,244,477,717,916,1151,14.45,4.37,3.48,2.72
28-10-2021,GOLEGÃ,1,0,19,"[0,120]",Baixo a Moderado,,,,1,Lisboa e Vale do Tejo,SANTARÉM,1412,8431.67,5339,356,299,281,243,255,498,779,1078,1434,63.32,17.01,12.78,9.24
28-10-2021,GONDOMAR,80,6,48,"[0,120]",Baixo a Moderado,,,,80,Norte,PORTO,1304,13191.76,165985,10555,8755,6222,4450,3364,7814,14036,22791,33346,1258.22,252.77,172.76,106.4
28-10-2021,GOUVEIA,48,3,388,"[240,480]",Elevado,,,,48,Centro,GUARDA,0906,30061.17,12387,871,931,780,783,810,1593,2373,3304,4175,41.21,13.89,10.99,7.89
28-10-2021,GRÂNDOLA,3,0,21,"[0,120]",Baixo a Moderado,,,,3,Alentejo,SETÚBAL,1505,82593.66,14639,834,834,708,688,672,1360,2068,2902,3736,17.72,4.52,3.51,2.5
28-10-2021,GUARDA,35,3,90,"[0,120]",Baixo a Moderado,,,,35,Centro,GUARDA,0907,71209.58,38969,2477,2041,1686,1415,1474,2889,4575,6616,9093,54.72,12.77,9.29,6.42
28-10-2021,GUIMARÃES,85,6,56,"[0,120]",Baixo a Moderado,,,,85,Norte,BRAGA,0308,24099.96,152309,9394,7074,4809,3877,2948,6825,11634,18708,28102,631.99,116.61,77.63,48.27
28-10-2021,HORTA,22,2,152,"[120,240]",Moderado,,,,22,Açores,AÇORES,4701,17305.53,14521,818,658,468,352,302,654,1122,1780,2598,83.91,15.01,10.29,6.48
28-10-2021,IDANHA-A-NOVA,10,1,126,"[120,240]",Moderado,,,,10,Centro,CASTELO BRANCO,0505,141633.51,8043,518,490,519,672,974,1646,2165,2655,3173,5.68,2.24,1.87,1.53
28-10-2021,ÍLHAVO,30,2,77,"[0,120]",Baixo a Moderado,,,,30,Centro,AVEIRO,0110,7347.55,38699,2227,1943,1444,1193,850,2043,3487,5430,7657,526.66,104.21,73.9,47.46
28-10-2021,LAGOA (FARO),49,3,215,"[120,240]",Moderado,,,,49,Algarve,FARO,0806,8825.45,22762,1314,1168,919,749,670,1419,2338,3506,4820,257.93,54.62,39.73,26.49
28-10-2021,LAGOA,5,0,34,"[0,120]",Baixo a Moderado,,,,5,Açores,AÇORES,4201,4559.32,14721,536,458,349,238,235,473,822,1280,1816,322.9,39.83,28.08,18.03
28-10-2021,LAGOS,48,3,159,"[120,240]",Moderado,,,,48,Algarve,FARO,0807,21299.27,30374,1744,1434,1247,1053,1029,2082,3329,4763,6507,142.61,30.55,22.36,15.63
28-10-2021,LAJES DAS FLORES,0,0,0,"[0,120]",Baixo a Moderado,,,,0,Açores,AÇORES,4801,7004.79,1463,88,53,62,46,54,100,162,215,303,20.89,4.33,3.07,2.31
28-10-2021,LAJES DO PICO,3,0,67,"[0,120]",Baixo a Moderado,,,,3,Açores,AÇORES,4601,15531.09,4490,304,231,223,159,162,321,544,775,1079,28.91,6.95,4.99,3.5
28-10-2021,LAMEGO,20,1,81,"[0,120]",Baixo a Moderado,,,,20,Norte,VISEU,1805,16542.11,24895,1639,1284,1124,898,783,1681,2805,4089,5728,150.5,34.63,24.72,16.96
28-10-2021,LEIRIA,210,15,168,"[120,240]",Moderado,,,,210,Centro,LEIRIA,1009,56508.83,125267,7389,6366,5090,3902,3159,7061,12151,18517,25906,221.68,45.84,32.77,21.5
28-10-2021,LISBOA,810,58,159,"[120,240]",Moderado,,,,810,Lisboa e Vale do Tejo,LISBOA,1106,10005.43,509515,33197,33340,27706,23037,26770,49807,77513,110853,144050,5092.6,1439.78,1107.98,774.74
28-10-2021,LOULÉ,99,7,144,"[120,240]",Moderado,,,,99,Algarve,FARO,0808,76366.91,68697,3890,3350,2780,2358,2251,4609,7389,10739,14629,89.96,19.16,14.06,9.68
28-10-2021,LOURES,122,9,57,"[0,120]",Baixo a Moderado,,,,122,Lisboa e Vale do Tejo,LISBOA,1107,16723.99,213687,12746,12794,9644,6669,5033,11702,21346,34140,46886,1277.73,280.35,204.14,127.64
28-10-2021,LOURINHÃ,69,5,267,"[240,480]",Elevado,,,,69,Lisboa e Vale do Tejo,LISBOA,1108,14717.2,25855,1584,1243,992,842,645,1487,2479,3722,5306,175.68,36.05,25.29,16.84
28-10-2021,LOUSÃ,39,3,226,"[120,240]",Moderado,,,,39,Centro,COIMBRA,0607,13840.01,17158,946,866,658,528,450,978,1636,2502,3448,123.97,24.91,18.08,11.82
28-10-2021,LOUSADA,12,1,26,"[0,120]",Baixo a Moderado,,,,12,Norte,PORTO,1305,9608.01,46755,2289,1698,1176,853,621,1474,2650,4348,6637,486.63,69.08,45.25,27.58
28-10-2021,MAÇÃO,6,0,97,"[0,120]",Baixo a Moderado,,,,6,Lisboa e Vale do Tejo,SANTARÉM,1413,39997.98,6267,386,362,390,440,657,1097,1487,1849,2235,15.67,5.59,4.62,3.72
28-10-2021,MACEDO DE CAVALEIROS,5,0,35,"[0,120]",Baixo a Moderado,,,,5,Norte,BRAGANÇA,0405,69914.08,14516,1082,889,878,823,938,1761,2639,3528,4610,20.76,6.59,5.05,3.77
28-10-2021,MACHICO,7,0,35,"[0,120]",Baixo a Moderado,,,,7,Madeira,MADEIRA,3104,6825.1,19981,1197,860,662,455,331,786,1448,2308,3505,292.76,51.36,33.82,21.22
28-10-2021,MADALENA,1,0,17,"[0,120]",Baixo a Moderado,,,,1,Açores,AÇORES,4602,14712.33,5895,334,256,173,190,179,369,542,798,1132,40.07,7.69,5.42,3.68
28-10-2021,MAFRA,103,7,122,"[120,240]",Moderado,,,,103,Lisboa e Vale do Tejo,LISBOA,1109,29165.5,84816,3613,3334,2839,2089,1899,3988,6827,10161,13774,290.81,47.23,34.84,23.41
28-10-2021,MAIA,165,12,119,"[0,120]",Baixo a Moderado,,,,165,Norte,PORTO,1306,8293.94,138971,7801,6617,4512,3339,2631,5970,10482,17099,24900,1675.56,300.22,206.16,126.38
28-10-2021,MANGUALDE,51,4,275,"[240,480]",Elevado,,,,51,Centro,VISEU,1806,21925.56,18510,1198,1128,885,852,743,1595,2480,3608,4806,84.42,21.92,16.46,11.31
28-10-2021,MANTEIGAS,4,0,134,"[120,240]",Moderado,,,,4,Centro,GUARDA,0908,12197.55,3007,258,197,159,167,146,313,472,669,927,24.65,7.6,5.48,3.87
28-10-2021,MARCO DE CANAVESES,46,3,90,"[0,120]",Baixo a Moderado,,,,46,Norte,PORTO,1307,20188.98,51496,2678,2060,1488,1265,1023,2288,3776,5836,8514,255.07,42.17,28.91,18.7
28-10-2021,MARINHA GRANDE,39,3,100,"[0,120]",Baixo a Moderado,,,,39,Centro,LEIRIA,1010,18725.19,38508,2365,2302,1638,1359,1058,2417,4055,6357,8722,205.65,46.58,33.95,21.66
28-10-2021,MARVÃO,1,0,34,"[0,120]",Baixo a Moderado,,,,1,Alentejo,PORTALEGRE,1210,15489.9,3005,198,185,142,197,237,434,576,761,959,19.4,6.19,4.91,3.72
28-10-2021,MATOSINHOS,125,9,71,"[0,120]",Baixo a Moderado,,,,125,Norte,PORTO,1308,6241.97,175357,11850,9977,7023,5024,3884,8908,15931,25908,37758,2809.31,604.9,415.06,255.22
28-10-2021,MEALHADA,1,0,5,"[0,120]",Baixo a Moderado,,,,1,Centro,AVEIRO,0111,11065.66,19914,1163,1039,810,828,831,1659,2469,3508,4671,179.96,42.21,31.7,22.31
28-10-2021,MÊDA,4,0,87,"[0,120]",Baixo a Moderado,,,,4,Centro,GUARDA,0909,28604.92,4587,343,306,290,288,443,731,1021,1327,1670,16.04,5.84,4.64,3.57
28-10-2021,MELGAÇO,1,0,13,"[0,120]",Baixo a Moderado,,,,1,Norte,VIANA DO CASTELO,1603,23824.58,8093,507,567,578,614,675,1289,1867,2434,2941,33.97,12.34,10.22,7.84
28-10-2021,MÉRTOLA,4,0,66,"[0,120]",Baixo a Moderado,,,,4,Alentejo,BEJA,0209,129287.34,6142,400,390,378,423,600,1023,1401,1791,2191,4.75,1.69,1.39,1.08
28-10-2021,MESÃO FRIO,2,0,51,"[0,120]",Baixo a Moderado,,,,2,Norte,VILA REAL,1704,2664.87,3964,265,205,168,157,120,277,445,650,915,148.74,34.33,24.39,16.7
28-10-2021,MIRA,14,1,118,"[0,120]",Baixo a Moderado,,,,14,Centro,COIMBRA,0608,12403.38,11832,727,729,659,550,466,1016,1675,2404,3131,95.4,25.24,19.38,13.5
28-10-2021,MIRANDA DO CORVO,18,1,142,"[120,240]",Moderado,,,,18,Centro,COIMBRA,0609,12637.79,12708,706,659,568,498,404,902,1470,2129,2835,100.55,22.43,16.85,11.63
28-10-2021,MIRANDA DO DOURO,3,0,44,"[0,120]",Baixo a Moderado,,,,3,Norte,BRAGANÇA,0406,48718.31,6830,482,429,442,463,470,933,1375,1804,2286,14.02,4.69,3.7,2.82
28-10-2021,MIRANDELA,23,2,107,"[0,120]",Baixo a Moderado,,,,23,Norte,BRAGANÇA,0407,65895.67,21754,1640,1315,1204,1078,947,2025,3229,4544,6184,33.01,9.38,6.9,4.9
28-10-2021,MOGADOURO,2,0,24,"[0,120]",Baixo a Moderado,,,,2,Norte,BRAGANÇA,0408,76064.93,8392,589,529,576,630,655,1285,1861,2390,2979,11.03,3.92,3.14,2.45
28-10-2021,MOIMENTA DA BEIRA,4,0,41,"[0,120]",Baixo a Moderado,,,,4,Norte,VISEU,1807,21996.9,9736,576,514,471,416,461,877,1348,1862,2438,44.26,11.08,8.46,6.13
28-10-2021,MOITA,29,2,45,"[0,120]",Baixo a Moderado,,,,29,Lisboa e Vale do Tejo,SETÚBAL,1506,5525.98,64407,4226,3646,2623,1801,1425,3226,5849,9495,13721,1165.53,248.3,171.82,105.85
28-10-2021,MONÇÃO,7,0,39,"[0,120]",Baixo a Moderado,,,,7,Norte,VIANA DO CASTELO,1604,21130.85,17869,1161,1105,1031,1006,972,1978,3009,4114,5275,84.56,24.96,19.47,14.24
28-10-2021,MONCHIQUE,1,0,20,"[0,120]",Baixo a Moderado,,,,1,Algarve,FARO,0809,39530.43,5077,353,384,321,355,392,747,1068,1452,1805,12.84,4.57,3.67,2.7
28-10-2021,MONDIM DE BASTO,6,0,87,"[0,120]",Baixo a Moderado,,,,6,Norte,VILA REAL,1705,17207.52,6946,395,300,314,284,283,567,881,1181,1576,40.36,9.16,6.86,5.12
28-10-2021,MONFORTE,1,0,34,"[0,120]",Baixo a Moderado,,,,1,Alentejo,PORTALEGRE,1211,42024.82,2975,139,115,117,192,168,360,477,592,731,7.08,1.74,1.41,1.14
28-10-2021,MONTALEGRE,1,0,11,"[0,120]",Baixo a Moderado,,,,1,Norte,VILA REAL,1706,80545.71,8997,699,628,595,603,730,1333,1928,2556,3255,11.17,4.04,3.17,2.39
28-10-2021,MONTEMOR-O-NOVO,3,0,19,"[0,120]",Baixo a Moderado,,,,3,Alentejo,ÉVORA,0706,123296.65,15647,991,953,868,878,971,1849,2717,3670,4661,12.69,3.78,2.98,2.2
28-10-2021,MONTEMOR-O-VELHO,12,1,47,"[0,120]",Baixo a Moderado,,,,12,Centro,COIMBRA,0610,22896.23,25224,1496,1397,1217,1057,988,2045,3262,4659,6155,110.17,26.88,20.35,14.25
28-10-2021,MONTIJO,14,1,24,"[0,120]",Baixo a Moderado,,,,14,Lisboa e Vale do Tejo,SETÚBAL,1507,34861.64,57614,2771,2441,1990,1554,1109,2663,4653,7094,9865,165.26,28.3,20.35,13.35
28-10-2021,MORA,2,0,50,"[0,120]",Baixo a Moderado,,,,2,Alentejo,ÉVORA,0707,44395.02,4138,336,275,252,238,257,495,747,1022,1358,9.32,3.06,2.3,1.68
28-10-2021,MORTÁGUA,0,0,0,"[0,120]",Baixo a Moderado,,,,0,Centro,VISEU,1808,25117.82,8803,638,584,535,499,460,959,1494,2078,2716,35.05,10.81,8.27,5.95
28-10-2021,MOURA,19,1,140,"[120,240]",Moderado,,,,19,Alentejo,BEJA,0210,95845.55,13718,817,656,665,542,461,1003,1668,2324,3141,14.31,3.28,2.42,1.74
28-10-2021,MOURÃO,0,0,0,"[0,120]",Baixo a Moderado,,,,0,Alentejo,ÉVORA,0708,27862.98,2450,139,108,80,104,109,213,293,401,540,8.79,1.94,1.44,1.05
28-10-2021,MURÇA,0,0,0,"[0,120]",Baixo a Moderado,,,,0,Norte,VILA REAL,1707,18937.11,5463,384,341,307,306,319,625,932,1273,1657,28.85,8.75,6.72,4.92
28-10-2021,MURTOSA,7,0,67,"[0,120]",Baixo a Moderado,,,,7,Centro,AVEIRO,0112,7308.78,10279,509,473,403,353,409,762,1165,1638,2147,140.63,29.37,22.41,15.94
28-10-2021,NAZARÉ,19,1,133,"[120,240]",Moderado,,,,19,Lisboa e Vale do Tejo,LEIRIA,1011,8243.43,14165,967,903,670,420,396,816,1486,2389,3356,171.84,40.71,28.98,18.03
28-10-2021,NELAS,15,1,116,"[0,120]",Baixo a Moderado,,,,15,Centro,VISEU,1809,12571.48,12974,924,787,668,604,583,1187,1855,2642,3566,103.21,28.37,21.02,14.76
28-10-2021,NISA,2,0,34,"[0,120]",Baixo a Moderado,,,,2,Alentejo,PORTALEGRE,1212,57567.84,6061,405,389,355,483,478,961,1316,1705,2110,10.53,3.67,2.96,2.29
28-10-2021,NORDESTE,1,0,21,"[0,120]",Baixo a Moderado,,,,1,Açores,AÇORES,4202,10146.8,4862,246,180,124,161,162,323,447,627,873,47.92,8.6,6.18,4.41
28-10-2021,ÓBIDOS,17,1,141,"[120,240]",Moderado,,,,17,Lisboa e Vale do Tejo,LEIRIA,1012,14155.44,11850,743,650,574,452,436,888,1462,2112,2855,83.72,20.17,14.92,10.33
28-10-2021,ODEMIRA,51,4,207,"[120,240]",Moderado,,,,51,Alentejo,BEJA,0211,172060.15,24717,1475,1317,1225,1397,1349,2746,3971,5288,6763,14.37,3.93,3.07,2.31
28-10-2021,ODIVELAS,113,8,70,"[0,120]",Baixo a Moderado,,,,113,Lisboa e Vale do Tejo,LISBOA,1116,2654.36,161774,9562,9038,6952,4641,3812,8453,15405,24443,34005,6095.48,1281.27,920.99,580.44
28-10-2021,OEIRAS,131,9,74,"[0,120]",Baixo a Moderado,,,,131,Lisboa e Vale do Tejo,LISBOA,1110,4588.31,177408,11580,11575,8566,6211,5855,12066,20632,32207,43787,3866.78,954.38,701.98,449.69
28-10-2021,OLEIROS,2,0,40,"[0,120]",Baixo a Moderado,,,,2,Centro,CASTELO BRANCO,0506,47109.31,5003,384,341,366,397,487,884,1250,1591,1975,10.62,4.19,3.38,2.65
28-10-2021,OLHÃO,35,3,79,"[0,120]",Baixo a Moderado,,,,35,Algarve,FARO,0810,13086.38,44405,2455,2309,1689,1342,1268,2610,4299,6608,9063,339.33,69.26,50.5,32.85
28-10-2021,OLIVEIRA DE AZEMÉIS,52,4,79,"[0,120]",Baixo a Moderado,,,,52,Norte,AVEIRO,0113,16110.41,66011,4155,3614,2794,2183,1738,3921,6715,10329,14484,409.75,89.91,64.12,41.68
28-10-2021,OLIVEIRA DE FRADES,10,1,100,"[0,120]",Baixo a Moderado,,,,10,Centro,VISEU,1810,14534.62,9936,553,475,438,359,415,774,1212,1687,2240,68.36,15.41,11.61,8.34
28-10-2021,OLIVEIRA DO BAIRRO,8,1,32,"[0,120]",Baixo a Moderado,,,,8,Centro,AVEIRO,0114,8731.99,24277,1327,1182,999,786,810,1596,2595,3777,5104,278.02,58.45,43.25,29.72
28-10-2021,OLIVEIRA DO HOSPITAL,55,4,286,"[240,480]",Elevado,,,,55,Centro,COIMBRA,0611,23451.66,19253,1161,1097,962,924,960,1884,2846,3943,5104,82.1,21.76,16.81,12.14
28-10-2021,OURÉM,92,7,210,"[120,240]",Moderado,,,,92,Lisboa e Vale do Tejo,SANTARÉM,1421,41668.03,44044,2463,2069,1899,1817,1603,3420,5319,7388,9851,105.7,23.64,17.73,12.77
28-10-2021,OURIQUE,3,0,66,"[0,120]",Baixo a Moderado,,,,3,Alentejo,BEJA,0212,66331.36,4607,313,287,284,268,227,495,779,1066,1379,6.95,2.08,1.61,1.17
28-10-2021,OVAR,44,3,81,"[0,120]",Baixo a Moderado,,,,44,Centro,AVEIRO,0115,14770.25,54260,3294,2709,1994,1636,1234,2870,4864,7573,10867,367.37,73.57,51.27,32.93
28-10-2021,PAÇOS DE FERREIRA,51,4,90,"[0,120]",Baixo a Moderado,,,,51,Norte,PORTO,1309,7099.29,56728,2903,2193,1518,1135,664,1799,3317,5510,8413,799.1,118.51,77.62,46.72
28-10-2021,PALMELA,37,3,58,"[0,120]",Baixo a Moderado,,,,37,Lisboa e Vale do Tejo,SETÚBAL,1508,46512.01,64269,3402,3244,2635,1846,1391,3237,5872,9116,12518,138.18,26.91,19.6,12.62
28-10-2021,PAMPILHOSA DA SERRA,3,0,74,"[0,120]",Baixo a Moderado,,,,3,Centro,COIMBRA,0612,39646.24,4037,238,254,295,339,423,762,1057,1311,1549,10.18,3.91,3.31,2.67
28-10-2021,PAREDES,34,2,40,"[0,120]",Baixo a Moderado,,,,34,Norte,PORTO,1310,15675.69,86067,4272,3532,2412,1717,1258,2975,5387,8919,13191,549.04,84.15,56.9,34.36
28-10-2021,PAREDES DE COURA,2,0,24,"[0,120]",Baixo a Moderado,,,,2,Norte,VIANA DO CASTELO,1605,13818.59,8535,466,528,407,465,515,980,1387,1915,2381,61.76,17.23,13.86,10.04
28-10-2021,PEDRÓGÃO GRANDE,8,1,234,"[120,240]",Moderado,,,,8,Centro,LEIRIA,1013,12874.75,3410,175,173,196,221,252,473,669,842,1017,26.49,7.9,6.54,5.2
28-10-2021,PENACOVA,1,0,7,"[0,120]",Baixo a Moderado,,,,1,Centro,COIMBRA,0613,21673.23,13694,968,923,745,621,703,1324,2069,2992,3960,63.18,18.27,13.81,9.55
28-10-2021,PENAFIEL,26,2,37,"[0,120]",Baixo a Moderado,,,,26,Norte,PORTO,1311,21224.27,69772,3648,2823,2032,1663,1230,2893,4925,7748,11396,328.74,53.69,36.51,23.2
28-10-2021,PENALVA DO CASTELO,0,0,0,"[0,120]",Baixo a Moderado,,,,0,Centro,VISEU,1811,13433.92,7115,449,457,413,391,426,817,1230,1687,2136,52.96,15.9,12.56,9.16
28-10-2021,PENAMACOR,56,4,1185,"[960,Max]",Extremamente Elevado,,,,56,Centro,CASTELO BRANCO,0507,56370.69,4755,262,248,273,451,633,1084,1357,1605,1867,8.44,3.31,2.85,2.41
28-10-2021,PENEDONO,36,3,1400,"[960,Max]",Extremamente Elevado,,,,36,Norte,VISEU,1812,13370.75,2591,172,113,129,156,138,294,423,536,708,19.38,5.3,4.01,3.16
28-10-2021,PENELA,0,0,0,"[0,120]",Baixo a Moderado,,,,0,Centro,COIMBRA,0614,13480.0,5397,314,324,274,359,344,703,977,1301,1615,40.04,11.98,9.65,7.25
28-10-2021,PENICHE,44,3,165,"[120,240]",Moderado,,,,44,Lisboa e Vale do Tejo,LEIRIA,1014,7754.98,26501,1746,1504,1203,926,707,1633,2836,4340,6086,341.73,78.48,55.96,36.57
28-10-2021,PESO DA RÉGUA,15,1,96,"[0,120]",Baixo a Moderado,,,,15,Norte,VILA REAL,1708,9486.01,15773,1076,843,650,659,455,1114,1764,2607,3683,166.28,38.83,27.48,18.6
28-10-2021,PINHEL,0,0,0,"[0,120]",Baixo a Moderado,,,,0,Centro,GUARDA,0910,48452.12,8511,577,566,551,538,689,1227,1778,2344,2921,17.57,6.03,4.84,3.67
28-10-2021,POMBAL,33,2,64,"[0,120]",Baixo a Moderado,,,,33,Centro,LEIRIA,1015,62600.28,51461,3187,2791,2494,2328,2027,4355,6849,9640,12827,82.21,20.49,15.4,10.94
28-10-2021,PONTA DELGADA,136,10,200,"[120,240]",Moderado,,,,136,Açores,AÇORES,4203,23298.65,67935,3108,2435,1726,1133,902,2035,3761,6196,9304,291.58,39.93,26.59,16.14
28-10-2021,PONTA DO SOL,0,0,0,"[0,120]",Baixo a Moderado,,,,0,Madeira,MADEIRA,3105,4622.03,8593,319,283,347,208,221,429,776,1059,1378,185.92,29.81,22.91,16.79
28-10-2021,PONTE DA BARCA,58,4,523,"[480,960]",Muito Elevado,,,,58,Norte,VIANA DO CASTELO,1606,18211.37,11180,635,576,517,554,490,1044,1561,2137,2772,61.39,15.22,11.73,8.57
28-10-2021,PONTE DE LIMA,17,1,41,"[0,120]",Baixo a Moderado,,,,17,Norte,VIANA DO CASTELO,1607,32025.46,41315,2321,2022,1720,1596,1462,3058,4778,6800,9121,129.01,28.48,21.23,14.92
28-10-2021,PONTE DE SOR,5,0,34,"[0,120]",Baixo a Moderado,,,,5,Alentejo,PORTALEGRE,1213,83971.16,14994,939,800,716,739,831,1570,2286,3086,4025,17.86,4.79,3.68,2.72
28-10-2021,PORTALEGRE,4,0,18,"[0,120]",Baixo a Moderado,,,,4,Alentejo,PORTALEGRE,1214,44713.64,22172,1577,1351,1137,993,984,1977,3114,4465,6042,49.59,13.51,9.99,6.96
28-10-2021,PORTEL,1,0,17,"[0,120]",Baixo a Moderado,,,,1,Alentejo,ÉVORA,0709,60100.57,5828,336,358,283,331,305,636,919,1277,1613,9.7,2.68,2.12,1.53
28-10-2021,PORTIMÃO,109,8,196,"[120,240]",Moderado,,,,109,Algarve,FARO,0811,18206.29,55483,3182,2927,2116,1582,1400,2982,5098,8025,11207,304.75,61.56,44.08,28.0
28-10-2021,PORTO,362,26,167,"[120,240]",Moderado,,,,362,Norte,PORTO,1312,4142.02,216606,15790,15193,11280,9409,10044,19453,30733,45926,61716,5229.5,1490.0,1108.79,741.98
28-10-2021,PORTO DE MÓS,13,1,56,"[0,120]",Baixo a Moderado,,,,13,Centro,LEIRIA,1016,26183.41,23275,1355,1210,1034,888,872,1760,2794,4004,5359,88.89,20.47,15.29,10.67
28-10-2021,PORTO MONIZ,2,0,87,"[0,120]",Baixo a Moderado,,,,2,Madeira,MADEIRA,3106,8293.38,2342,143,130,95,98,120,218,313,443,586,28.24,7.07,5.34,3.77
28-10-2021,PORTO SANTO,3,0,58,"[0,120]",Baixo a Moderado,,,,3,Madeira,MADEIRA,3201,4300.7,5202,240,157,134,110,68,178,312,469,709,120.95,16.48,10.9,7.25
28-10-2021,PÓVOA DE LANHOSO,5,0,23,"[0,120]",Baixo a Moderado,,,,5,Norte,BRAGA,0309,13465.29,21499,1175,909,732,673,624,1297,2029,2938,4113,159.67,30.55,21.82,15.07
28-10-2021,PÓVOA DE VARZIM,33,2,53,"[0,120]",Baixo a Moderado,,,,33,Norte,PORTO,1313,8220.59,62784,3712,3120,2134,1594,1305,2899,5033,8153,11865,763.7,144.33,99.17,61.22
28-10-2021,POVOAÇÃO,2,0,34,"[0,120]",Baixo a Moderado,,,,2,Açores,AÇORES,4204,10640.77,5927,293,212,191,144,134,278,469,681,974,55.7,9.15,6.4,4.41
28-10-2021,VILA DA PRAIA DA VITÓRIA,7,1,33,"[0,120]",Baixo a Moderado,,,,7,Açores,AÇORES,4302,16127.06,21317,1133,789,619,436,336,772,1391,2180,3313,132.18,20.54,13.52,8.63
28-10-2021,PROENÇA-A-NOVA,13,1,179,"[120,240]",Moderado,,,,13,Centro,CASTELO BRANCO,0508,39539.96,7298,508,465,389,400,560,960,1349,1814,2322,18.46,5.87,4.59,3.41
28-10-2021,REDONDO,13,1,207,"[120,240]",Moderado,,,,13,Alentejo,ÉVORA,0710,36950.87,6353,349,325,288,288,354,642,930,1255,1604,17.19,4.34,3.4,2.52
28-10-2021,REGUENGOS DE MONSARAZ,38,3,383,"[240,480]",Elevado,,,,38,Alentejo,ÉVORA,0711,46399.72,10015,602,511,455,462,473,935,1390,1901,2503,21.58,5.39,4.1,3.0
28-10-2021,RESENDE,7,1,70,"[0,120]",Baixo a Moderado,,,,7,Norte,VISEU,1813,12334.93,10137,560,493,448,433,422,855,1303,1796,2356,82.18,19.1,14.56,10.56
28-10-2021,RIBEIRA BRAVA,0,0,0,"[0,120]",Baixo a Moderado,,,,0,Madeira,MADEIRA,3107,6544.88,12435,648,500,411,311,287,598,1009,1509,2157,189.99,32.96,23.06,15.42
28-10-2021,RIBEIRA DE PENA,3,0,50,"[0,120]",Baixo a Moderado,,,,3,Norte,VILA REAL,1709,21745.98,6016,371,301,290,310,368,678,968,1269,1640,27.66,7.54,5.84,4.45
28-10-2021,RIBEIRA GRANDE,38,3,116,"[0,120]",Baixo a Moderado,,,,38,Açores,AÇORES,4205,18015.13,32811,1163,689,512,345,253,598,1110,1799,2962,182.13,16.44,9.99,6.16
28-10-2021,RIO MAIOR,92,7,449,"[240,480]",Elevado,,,,92,Lisboa e Vale do Tejo,SANTARÉM,1414,27276.45,20379,1251,1144,941,795,648,1443,2384,3528,4779,74.71,17.52,12.93,8.74
28-10-2021,SABROSA,3,0,51,"[0,120]",Baixo a Moderado,,,,3,Norte,VILA REAL,1710,15692.45,5918,393,314,304,302,350,652,956,1270,1663,37.71,10.6,8.09,6.09
28-10-2021,SABUGAL,7,1,67,"[0,120]",Baixo a Moderado,,,,7,Centro,GUARDA,0911,82269.82,10585,724,707,694,796,1009,1805,2499,3206,3930,12.87,4.78,3.9,3.04
28-10-2021,SALVATERRA DE MAGOS,13,1,61,"[0,120]",Baixo a Moderado,,,,13,Lisboa e Vale do Tejo,SANTARÉM,1415,24393.2,21295,1275,1181,1060,799,772,1571,2631,3812,5087,87.3,20.85,15.63,10.79
28-10-2021,SANTA COMBA DÃO,4,0,38,"[0,120]",Baixo a Moderado,,,,4,Centro,VISEU,1814,11194.77,10452,732,684,569,538,464,1002,1571,2255,2987,93.36,26.68,20.14,14.03
28-10-2021,SANTA CRUZ,30,2,66,"[0,120]",Baixo a Moderado,,,,30,Madeira,MADEIRA,3108,8150.28,45281,1817,1301,974,716,523,1239,2213,3514,5331,555.6,65.41,43.12,27.15
28-10-2021,SANTA CRUZ DA GRACIOSA,0,0,0,"[0,120]",Baixo a Moderado,,,,0,Açores,AÇORES,4401,6065.78,4208,228,180,163,124,145,269,432,612,840,69.37,13.85,10.09,7.12
28-10-2021,SANTA CRUZ DAS FLORES,0,0,0,"[0,120]",Baixo a Moderado,,,,0,Açores,AÇORES,4802,7091.44,2165,125,98,74,56,51,107,181,279,404,30.53,5.7,3.93,2.55
28-10-2021,SANTA MARIA DA FEIRA,98,7,71,"[0,120]",Baixo a Moderado,,,,98,Norte,AVEIRO,0109,21587.65,138636,8182,6743,4771,3856,3079,6935,11706,18449,26631,642.19,123.36,85.46,54.22
28-10-2021,SANTA MARTA DE PENAGUIÃO,18,1,275,"[240,480]",Elevado,,,,18,Norte,VILA REAL,1711,6928.13,6599,483,373,337,316,317,633,970,1343,1826,95.25,26.36,19.39,14.0
28-10-2021,SANTANA,1,0,15,"[0,120]",Baixo a Moderado,,,,1,Madeira,MADEIRA,3109,9547.3,6711,418,353,343,282,277,559,902,1255,1673,70.29,17.52,13.15,9.45
28-10-2021,SANTARÉM,87,6,152,"[120,240]",Moderado,,,,87,Lisboa e Vale do Tejo,SANTARÉM,1416,55253.58,57421,3654,3441,2760,2466,2206,4672,7432,10873,14527,103.92,26.29,19.68,13.45
28-10-2021,SANTIAGO DO CACÉM,9,1,31,"[0,120]",Baixo a Moderado,,,,9,Alentejo,SETÚBAL,1509,105969.29,28791,2144,1689,1472,1295,1215,2510,3982,5671,7815,27.17,7.37,5.35,3.76
28-10-2021,SANTO TIRSO,50,4,74,"[0,120]",Baixo a Moderado,,,,50,Norte,PORTO,1314,13655.52,68055,4911,3935,2761,2257,1810,4067,6828,10763,15674,498.35,114.78,78.82,50.0
28-10-2021,SÃO BRÁS DE ALPORTEL,4,0,39,"[0,120]",Baixo a Moderado,,,,4,Algarve,FARO,0812,15336.92,10416,596,468,467,404,401,805,1272,1740,2336,67.91,15.23,11.35,8.29
28-10-2021,SÃO JOÃO DA MADEIRA,32,2,145,"[120,240]",Moderado,,,,32,Norte,AVEIRO,0116,794.3,21958,1347,1069,796,601,593,1194,1990,3059,4406,2765.49,554.91,385.26,250.63
28-10-2021,SÃO JOÃO DA PESQUEIRA,4,0,57,"[0,120]",Baixo a Moderado,,,,4,Norte,VISEU,1815,26610.85,7125,417,330,294,328,328,656,950,1280,1697,26.77,6.38,4.81,3.57
28-10-2021,SÃO PEDRO DO SUL,76,5,493,"[480,960]",Muito Elevado,,,,76,Centro,VISEU,1816,34895.09,15403,990,962,861,759,909,1668,2529,3491,4481,44.14,12.84,10.0,7.25
28-10-2021,SÃO ROQUE DO PICO,5,0,153,"[120,240]",Moderado,,,,5,Açores,AÇORES,4603,14236.1,3266,199,141,93,96,113,209,302,443,642,22.94,4.51,3.11,2.12
28-10-2021,SÃO VICENTE,2,0,39,"[0,120]",Baixo a Moderado,,,,2,Madeira,MADEIRA,3110,7883.71,5143,272,264,266,225,280,505,771,1035,1307,65.23,16.58,13.13,9.78
28-10-2021,SARDOAL,5,0,135,"[120,240]",Moderado,,,,5,Lisboa e Vale do Tejo,SANTARÉM,1417,9214.72,3741,227,178,148,165,248,413,561,739,966,40.6,10.48,8.02,6.09
28-10-2021,SÁTÃO,10,1,86,"[0,120]",Baixo a Moderado,,,,10,Centro,VISEU,1817,20194.11,11580,765,671,515,465,476,941,1456,2127,2892,57.34,14.32,10.53,7.21
28-10-2021,SEIA,107,8,483,"[480,960]",Muito Elevado,,,,107,Centro,GUARDA,0912,43568.83,22234,1807,1589,1238,1122,721,1843,3081,4670,6477,51.03,14.87,10.72,7.07
28-10-2021,SEIXAL,99,7,59,"[0,120]",Baixo a Moderado,,,,99,Lisboa e Vale do Tejo,SETÚBAL,1510,9545.17,167752,10586,9270,6661,4391,2930,7321,13982,23252,33838,1757.49,354.51,243.6,146.49
28-10-2021,SERNANCELHE,3,0,56,"[0,120]",Baixo a Moderado,,,,3,Norte,VISEU,1818,22861.22,5396,305,293,286,273,260,533,819,1112,1417,23.6,6.2,4.86,3.58
28-10-2021,SERPA,27,2,190,"[120,240]",Moderado,,,,27,Alentejo,BEJA,0213,110563.34,14304,903,761,719,697,626,1323,2042,2803,3706,12.94,3.35,2.54,1.85
28-10-2021,SERTÃ,6,0,41,"[0,120]",Baixo a Moderado,,,,6,Centro,CASTELO BRANCO,0509,44673.17,14577,870,779,790,767,1020,1787,2577,3356,4226,32.63,9.46,7.51,5.77
28-10-2021,SESIMBRA,27,2,52,"[0,120]",Baixo a Moderado,,,,27,Lisboa e Vale do Tejo,SETÚBAL,1511,19571.75,51858,2400,2321,1853,1257,1083,2340,4193,6514,8914,264.96,45.54,33.28,21.42
28-10-2021,SETÚBAL,94,7,82,"[0,120]",Baixo a Moderado,,,,94,Lisboa e Vale do Tejo,SETÚBAL,1512,23032.5,115126,7425,6929,5075,3775,2655,6430,11505,18434,25859,499.83,112.27,80.03,49.95
28-10-2021,SEVER DO VOUGA,9,1,80,"[0,120]",Baixo a Moderado,,,,9,Centro,AVEIRO,0117,12987.56,11331,766,637,568,540,567,1107,1675,2312,3078,87.24,23.7,17.8,12.9
28-10-2021,SILVES,22,2,61,"[0,120]",Baixo a Moderado,,,,22,Algarve,FARO,0813,68006.23,36226,2137,1869,1610,1423,1600,3023,4633,6502,8639,53.27,12.7,9.56,6.81
28-10-2021,SINES,8,1,58,"[0,120]",Baixo a Moderado,,,,8,Alentejo,SETÚBAL,1513,20330.17,13715,888,791,551,416,268,684,1235,2026,2914,67.46,14.33,9.97,6.07
28-10-2021,SINTRA,247,18,63,"[0,120]",Baixo a Moderado,,,,247,Lisboa e Vale do Tejo,LISBOA,1111,31922.73,391402,20490,18316,13545,9137,7284,16421,29966,48282,68772,1226.08,215.43,151.25,93.87
28-10-2021,SOBRAL DE MONTE AGRAÇO,3,0,28,"[0,120]",Baixo a Moderado,,,,3,Lisboa e Vale do Tejo,LISBOA,1112,5210.32,10651,564,507,352,272,212,484,836,1343,1907,204.43,36.6,25.78,16.05
28-10-2021,SOURE,26,2,152,"[120,240]",Moderado,,,,26,Centro,COIMBRA,0615,26506.07,17120,1173,1142,1004,883,987,1870,2874,4016,5189,64.59,19.58,15.15,10.84
28-10-2021,SOUSEL,1,0,23,"[0,120]",Baixo a Moderado,,,,1,Alentejo,PORTALEGRE,1215,27932.18,4412,261,274,208,302,292,594,802,1076,1337,15.8,4.79,3.85,2.87
28-10-2021,TÁBUA,6,0,53,"[0,120]",Baixo a Moderado,,,,6,Centro,COIMBRA,0616,19978.58,11368,729,584,524,430,464,894,1418,2002,2731,56.9,13.67,10.02,7.1
28-10-2021,TABUAÇO,0,0,0,"[0,120]",Baixo a Moderado,,,,0,Norte,VISEU,1819,13385.67,6033,372,314,217,282,363,645,862,1176,1548,45.07,11.56,8.79,6.44
28-10-2021,TAROUCA,1,0,13,"[0,120]",Baixo a Moderado,,,,1,Norte,VISEU,1820,10008.49,7804,405,335,313,277,324,601,914,1249,1654,77.98,16.53,12.48,9.13
28-10-2021,TAVIRA,19,1,78,"[0,120]",Baixo a Moderado,,,,19,Algarve,FARO,0814,60696.7,24530,1493,1415,1252,1066,1277,2343,3595,5010,6503,40.41,10.71,8.25,5.92
28-10-2021,TERRAS DE BOURO,3,0,48,"[0,120]",Baixo a Moderado,,,,3,Norte,BRAGA,0310,27746.07,6361,391,372,296,319,340,659,955,1327,1718,22.93,6.19,4.78,3.44
28-10-2021,TOMAR,66,5,179,"[120,240]",Moderado,,,,66,Lisboa e Vale do Tejo,SANTARÉM,1418,35120.44,36748,2403,2189,1868,1853,1822,3675,5543,7732,10135,104.64,28.86,22.02,15.78
28-10-2021,TONDELA,15,1,57,"[0,120]",Baixo a Moderado,,,,15,Centro,VISEU,1821,37121.73,26357,1768,1722,1518,1475,1417,2892,4410,6132,7900,71.0,21.28,16.52,11.88
28-10-2021,TORRE DE MONCORVO,0,0,0,"[0,120]",Baixo a Moderado,,,,0,Norte,BRAGANÇA,0409,53155.67,7695,556,478,488,551,719,1270,1758,2236,2792,14.48,5.25,4.21,3.31
28-10-2021,TORRES NOVAS,31,2,88,"[0,120]",Baixo a Moderado,,,,31,Lisboa e Vale do Tejo,SANTARÉM,1419,26999.68,34933,2324,1979,1738,1406,1475,2881,4619,6598,8922,129.38,33.04,24.44,17.11
28-10-2021,TORRES VEDRAS,126,9,160,"[120,240]",Moderado,,,,126,Lisboa e Vale do Tejo,LISBOA,1113,40714.89,78530,4513,3945,3447,2628,2104,4732,8179,12124,16637,192.88,40.86,29.78,20.09
28-10-2021,TRANCOSO,4,0,45,"[0,120]",Baixo a Moderado,,,,4,Centro,GUARDA,0913,36152.47,8875,581,557,542,586,496,1082,1624,2181,2762,24.55,7.64,6.03,4.49
28-10-2021,TROFA,13,1,34,"[0,120]",Baixo a Moderado,,,,13,Norte,PORTO,1318,7201.76,38418,2336,1894,1231,939,684,1623,2854,4748,7084,533.44,98.36,65.93,39.63
28-10-2021,VAGOS,8,1,35,"[0,120]",Baixo a Moderado,,,,8,Centro,AVEIRO,0118,16491.5,22740,1320,1205,922,784,724,1508,2430,3635,4955,137.89,30.04,22.04,14.73
28-10-2021,VALE DE CAMBRA,18,1,85,"[0,120]",Baixo a Moderado,,,,18,Norte,AVEIRO,0119,14733.47,21327,1491,1363,1005,831,798,1629,2634,3997,5488,144.76,37.25,27.13,17.88
28-10-2021,VALENÇA,1,0,8,"[0,120]",Baixo a Moderado,,,,1,Norte,VIANA DO CASTELO,1608,11712.86,13290,867,791,582,582,503,1085,1667,2458,3325,113.46,28.39,20.99,14.23
28-10-2021,VALONGO,63,5,65,"[0,120]",Baixo a Moderado,,,,63,Norte,PORTO,1315,7512.45,97444,5629,4696,3207,2462,1829,4291,7498,12194,17823,1297.18,237.26,162.33,99.81
28-10-2021,VALPAÇOS,3,0,20,"[0,120]",Baixo a Moderado,,,,3,Norte,VILA REAL,1712,54873.93,14818,1217,1118,999,928,997,1925,2924,4042,5259,27.0,9.58,7.37,5.33
28-10-2021,VELAS,0,0,0,"[0,120]",Baixo a Moderado,,,,0,Açores,AÇORES,4502,11738.38,5093,278,208,166,153,113,266,432,640,918,43.39,7.82,5.45,3.68
28-10-2021,VENDAS NOVAS,2,0,18,"[0,120]",Baixo a Moderado,,,,2,Alentejo,ÉVORA,0712,22238.88,11255,677,768,655,501,532,1033,1688,2456,3133,50.61,14.09,11.04,7.59
28-10-2021,VIANA DO ALENTEJO,11,1,215,"[120,240]",Moderado,,,,11,Alentejo,ÉVORA,0713,39367.29,5145,245,208,235,210,214,424,659,867,1112,13.07,2.82,2.2,1.67
28-10-2021,VIANA DO CASTELO,47,3,56,"[0,120]",Baixo a Moderado,,,,47,Norte,VIANA DO CASTELO,1609,31902.01,84417,5470,4433,3591,3061,2982,6043,9634,14067,19537,264.61,61.24,44.09,30.2
28-10-2021,VIDIGUEIRA,4,0,73,"[0,120]",Baixo a Moderado,,,,4,Alentejo,BEJA,0214,31661.09,5510,300,248,215,233,275,508,723,971,1271,17.4,4.01,3.07,2.28
28-10-2021,VIEIRA DO MINHO,21,2,178,"[120,240]",Moderado,,,,21,Norte,BRAGA,0311,21644.35,11842,703,594,525,548,482,1030,1555,2149,2852,54.71,13.18,9.93,7.18
28-10-2021,VILA DE REI,1,0,30,"[0,120]",Baixo a Moderado,,,,1,Centro,CASTELO BRANCO,0510,19154.6,3323,169,128,172,247,302,549,721,849,1018,17.35,5.31,4.43,3.76
28-10-2021,VILA DO BISPO,18,1,350,"[240,480]",Elevado,,,,18,Algarve,FARO,0815,17906.06,5154,302,302,314,232,233,465,779,1081,1383,28.78,7.72,6.04,4.35
28-10-2021,VILA DO CONDE,25,2,31,"[0,120]",Baixo a Moderado,,,,25,Norte,PORTO,1316,14902.77,79899,4726,3875,2819,2070,1743,3813,6632,10507,15233,536.13,102.21,70.5,44.5
28-10-2021,VILA DO PORTO,0,0,0,"[0,120]",Baixo a Moderado,,,,0,Açores,AÇORES,4101,9688.74,5616,274,212,135,96,123,219,354,566,840,57.96,8.67,5.84,3.65
28-10-2021,VILA FLOR,0,0,0,"[0,120]",Baixo a Moderado,,,,0,Norte,BRAGANÇA,0410,26581.14,6044,429,362,422,294,331,625,1047,1409,1838,22.74,6.91,5.3,3.94
28-10-2021,VILA FRANCA DE XIRA,79,6,56,"[0,120]",Baixo a Moderado,,,,79,Lisboa e Vale do Tejo,LISBOA,1114,31819.39,141957,8501,6852,4869,3425,2472,5897,10766,17618,26119,446.14,82.09,55.37,33.84
28-10-2021,VILA FRANCA DO CAMPO,2,0,18,"[0,120]",Baixo a Moderado,,,,2,Açores,AÇORES,4206,7796.82,11051,450,344,248,217,154,371,619,963,1413,141.73,18.12,12.35,7.94
28-10-2021,VILA NOVA DA BARQUINHA,19,1,252,"[240,480]",Elevado,,,,19,Lisboa e Vale do Tejo,SANTARÉM,1420,4952.97,7461,415,406,392,364,338,702,1094,1500,1915,150.64,38.66,30.28,22.09
28-10-2021,VILA NOVA DE CERVEIRA,2,0,22,"[0,120]",Baixo a Moderado,,,,2,Norte,VIANA DO CASTELO,1610,10846.66,8910,531,444,410,384,334,718,1128,1572,2103,82.14,19.39,14.49,10.4
28-10-2021,VILA NOVA DE FAMALICÃO,84,6,64,"[0,120]",Baixo a Moderado,,,,84,Norte,BRAGA,0312,20159.26,131676,7817,6164,4202,3282,2749,6031,10233,16397,24214,653.19,120.12,81.34,50.76
28-10-2021,VILA NOVA DE FOZ CÔA,4,0,62,"[0,120]",Baixo a Moderado,,,,4,Centro,GUARDA,0914,39815.18,6503,442,385,390,398,429,827,1217,1602,2044,16.33,5.13,4.02,3.06
28-10-2021,VILA NOVA DE GAIA,273,20,91,"[0,120]",Baixo a Moderado,,,,273,Norte,PORTO,1317,16846.43,300472,18349,15568,10972,8224,6281,14505,25477,41045,59394,1783.64,352.57,243.65,151.23
28-10-2021,VILA NOVA DE PAIVA,1,0,21,"[0,120]",Baixo a Moderado,,,,1,Centro,VISEU,1822,17553.28,4687,289,272,233,217,241,458,691,963,1252,26.7,7.13,5.49,3.94
28-10-2021,VILA NOVA DE POIARES,3,0,43,"[0,120]",Baixo a Moderado,,,,3,Centro,COIMBRA,0617,8445.3,6939,380,284,262,235,182,417,679,963,1343,82.17,15.9,11.4,8.04
28-10-2021,VILA POUCA DE AGUIAR,3,0,25,"[0,120]",Baixo a Moderado,,,,3,Norte,VILA REAL,1713,43706.62,11961,860,817,733,601,627,1228,1961,2778,3638,27.37,8.32,6.36,4.49
28-10-2021,VILA REAL,35,2,70,"[0,120]",Baixo a Moderado,,,,35,Norte,VILA REAL,1714,37880.28,49962,3025,2498,2065,1579,1466,3045,5110,7608,10633,131.9,28.07,20.08,13.49
28-10-2021,VILA REAL DE SANTO ANTÓNIO,9,1,48,"[0,120]",Baixo a Moderado,,,,9,Algarve,FARO,0816,6125.0,18749,1172,1069,811,569,586,1155,1966,3035,4207,306.11,68.69,49.55,32.1
28-10-2021,VILA VELHA DE RÓDÃO,1,0,32,"[0,120]",Baixo a Moderado,,,,1,Centro,CASTELO BRANCO,0511,32991.16,3144,209,229,180,283,306,589,769,998,1207,9.53,3.66,3.03,2.33
28-10-2021,VILA VERDE,47,3,100,"[0,120]",Baixo a Moderado,,,,47,Norte,BRAGA,0313,22866.52,46911,2365,2063,1667,1494,1437,2931,4598,6661,9026,205.15,39.47,29.13,20.11
28-10-2021,VILA VIÇOSA,0,0,0,"[0,120]",Baixo a Moderado,,,,0,Alentejo,ÉVORA,0714,19485.89,7656,487,379,342,345,324,669,1011,1390,1877,39.29,9.63,7.13,5.19
28-10-2021,VIMIOSO,0,0,0,"[0,120]",Baixo a Moderado,,,,0,Norte,BRAGANÇA,0411,48158.51,4023,274,230,261,293,335,628,889,1119,1393,8.35,2.89,2.32,1.85
28-10-2021,VINHAIS,1,0,13,"[0,120]",Baixo a Moderado,,,,1,Norte,BRAGANÇA,0412,69475.09,7746,599,577,636,641,815,1456,2092,2669,3268,11.15,4.7,3.84,3.01
28-10-2021,VISEU,132,9,136,"[120,240]",Moderado,,,,132,Centro,VISEU,1823,50710.14,97249,5769,5038,4140,3158,2710,5868,10008,15046,20815,191.77,41.05,29.67,19.74
28-10-2021,VIZELA,5,0,21,"[0,120]",Baixo a Moderado,,,,5,Norte,BRAGA,0314,2469.83,23897,1258,928,655,509,371,880,1535,2463,3721,967.49,150.65,99.72,62.15
28-10-2021,VOUZELA,29,2,301,"[240,480]",Elevado,,,,29,Centro,VISEU,1824,19369.46,9619,626,605,554,532,507,1039,1593,2198,2824,49.66,14.58,11.35,8.22
04-11-2021,ABRANTES,27,2,77,"[0,120]",Baixo a Moderado,,,,27,Lisboa e Vale do Tejo,SANTARÉM,1401,71469.08,35130,2473,2213,1730,1748,2021,3769,5499,7712,10185,49.15,14.25,10.79,7.69
04-11-2021,ÁGUEDA,38,3,82,"[0,120]",Baixo a Moderado,,,,38,Centro,AVEIRO,0101,33527.44,46075,3237,2713,2090,1635,1496,3131,5221,7934,11171,137.43,33.32,23.66,15.57
04-11-2021,AGUIAR DA BEIRA,1,0,22,"[0,120]",Baixo a Moderado,,,,1,Centro,GUARDA,0901,20676.57,4652,304,281,235,239,148,387,622,903,1207,22.5,5.84,4.37,3.01
04-11-2021,ALANDROAL,2,0,41,"[0,120]",Baixo a Moderado,,,,2,Alentejo,ÉVORA,0701,54267.81,4992,307,256,296,299,377,676,972,1228,1535,9.2,2.83,2.26,1.79
04-11-2021,ALBERGARIA-A-VELHA,53,4,218,"[120,240]",Moderado,,,,53,Centro,AVEIRO,0102,15882.5,24144,1550,1298,996,687,680,1367,2363,3661,5211,152.02,32.81,23.05,14.88
04-11-2021,ALBUFEIRA,69,5,167,"[120,240]",Moderado,,,,69,Algarve,FARO,0801,14066.42,41528,2067,1717,1425,985,858,1843,3268,4985,7052,295.24,50.14,35.44,23.23
04-11-2021,ALCÁCER DO SAL,6,0,52,"[0,120]",Baixo a Moderado,,,,6,Alentejo,SETÚBAL,1501,149987.3,11659,884,814,623,623,602,1225,1848,2662,3546,7.77,2.36,1.77,1.23
04-11-2021,ALCANENA,20,1,155,"[120,240]",Moderado,,,,20,Lisboa e Vale do Tejo,SANTARÉM,1402,12732.86,12809,891,744,628,536,588,1124,1752,2496,3387,100.6,26.6,19.6,13.76
04-11-2021,ALCOBAÇA,89,6,167,"[120,240]",Moderado,,,,89,Lisboa e Vale do Tejo,LEIRIA,1001,40814.09,53555,3420,2927,2466,2059,1676,3735,6201,9128,12548,131.22,30.74,22.36,15.19
04-11-2021,ALCOCHETE,27,2,135,"[120,240]",Moderado,,,,27,Lisboa e Vale do Tejo,SETÚBAL,1502,12836.48,19787,857,834,691,476,447,923,1614,2448,3305,154.15,25.75,19.07,12.57
04-11-2021,ALCOUTIM,1,0,48,"[0,120]",Baixo a Moderado,,,,1,Algarve,FARO,0802,57536.33,2159,191,188,163,190,267,457,620,808,999,3.75,1.74,1.4,1.08
04-11-2021,ALENQUER,12,1,27,"[0,120]",Baixo a Moderado,,,,12,Lisboa e Vale do Tejo,LISBOA,1101,30421.92,44052,2298,2062,1629,1330,1155,2485,4114,6176,8474,144.8,27.85,20.3,13.52
04-11-2021,ALFÂNDEGA DA FÉ,5,0,111,"[0,120]",Baixo a Moderado,,,,5,Norte,BRAGANÇA,0401,32194.64,4550,325,277,301,274,325,599,900,1177,1502,14.13,4.67,3.66,2.8
04-11-2021,ALIJÓ,13,1,123,"[120,240]",Moderado,,,,13,Norte,VILA REAL,1701,29759.89,10625,766,687,635,542,666,1208,1843,2530,3296,35.7,11.08,8.5,6.19
04-11-2021,ALJEZUR,4,0,71,"[0,120]",Baixo a Moderado,,,,4,Algarve,FARO,0803,32349.95,5594,316,336,335,320,410,730,1065,1401,1717,17.29,5.31,4.33,3.29
04-11-2021,ALJUSTREL,3,0,37,"[0,120]",Baixo a Moderado,,,,3,Alentejo,BEJA,0201,45847.41,8247,635,521,443,347,358,705,1148,1669,2304,17.99,5.03,3.64,2.5
04-11-2021,ALMADA,150,11,89,"[0,120]",Baixo a Moderado,,,,150,Lisboa e Vale do Tejo,SETÚBAL,1503,7000.89,169039,10469,9777,7876,6144,5111,11255,19131,28908,39377,2414.5,562.45,412.91,273.26
04-11-2021,ALMEIDA,2,0,35,"[0,120]",Baixo a Moderado,,,,2,Centro,GUARDA,0902,51798.46,5830,441,419,396,458,393,851,1247,1666,2107,11.26,4.07,3.22,2.41
04-11-2021,ALMEIRIM,67,5,299,"[240,480]",Elevado,,,,67,Lisboa e Vale do Tejo,SANTARÉM,1403,22212.05,22546,1342,1353,1106,866,843,1709,2815,4168,5510,101.5,24.81,18.76,12.67
04-11-2021,ALMODÔVAR,18,1,270,"[240,480]",Elevado,,,,18,Alentejo,BEJA,0202,77788.03,6725,414,443,396,373,328,701,1097,1540,1954,8.65,2.51,1.98,1.41
04-11-2021,ALPIARÇA,17,1,243,"[240,480]",Elevado,,,,17,Lisboa e Vale do Tejo,SANTARÉM,1404,9536.33,7059,515,486,363,333,274,607,970,1456,1971,74.02,20.67,15.27,10.17
04-11-2021,ALTER DO CHÃO,0,0,0,"[0,120]",Baixo a Moderado,,,,0,Alentejo,PORTALEGRE,1201,36206.62,3165,201,163,136,208,187,395,531,694,895,8.74,2.47,1.92,1.47
04-11-2021,ALVAIÁZERE,2,0,30,"[0,120]",Baixo a Moderado,,,,2,Centro,LEIRIA,1002,16047.76,6597,419,389,346,406,539,945,1291,1680,2099,41.11,13.08,10.47,8.04
04-11-2021,ALVITO,1,0,41,"[0,120]",Baixo a Moderado,,,,1,Alentejo,BEJA,0203,26485.32,2477,145,110,105,111,89,200,305,415,560,9.35,2.11,1.57,1.15
04-11-2021,AMADORA,98,7,53,"[0,120]",Baixo a Moderado,,,,98,Lisboa e Vale do Tejo,LISBOA,1115,2378.47,184106,11186,10936,8780,6460,5890,12350,21130,32066,43252,7742.05,1818.84,1348.44,888.56
04-11-2021,AMARANTE,38,3,72,"[0,120]",Baixo a Moderado,,,,38,Norte,PORTO,1301,30133.15,53193,3086,2413,1812,1643,1311,2954,4766,7179,10265,176.53,34.07,23.82,15.82
04-11-2021,AMARES,7,1,39,"[0,120]",Baixo a Moderado,,,,7,Norte,BRAGA,0301,8195.41,18129,1001,829,622,489,524,1013,1635,2464,3465,221.22,42.28,30.07,19.95
04-11-2021,ANADIA,25,2,91,"[0,120]",Baixo a Moderado,,,,25,Centro,AVEIRO,0103,21663.48,27258,1931,1698,1376,1208,1262,2470,3846,5544,7475,125.83,34.51,25.59,17.75
04-11-2021,ANGRA DO HEROÍSMO,8,1,24,"[0,120]",Baixo a Moderado,,,,8,Açores,AÇORES,4301,23899.66,33807,2006,1473,1122,768,635,1403,2525,3998,6004,141.45,25.12,16.73,10.56
04-11-2021,ANSIÃO,14,1,116,"[0,120]",Baixo a Moderado,,,,14,Centro,LEIRIA,1003,17609.42,12039,727,709,646,694,530,1224,1870,2579,3306,68.37,18.77,14.65,10.62
04-11-2021,ARCOS DE VALDEVEZ,60,4,289,"[240,480]",Elevado,,,,60,Norte,VIANA DO CASTELO,1601,44759.64,20926,1329,1338,1282,1343,1515,2858,4140,5478,6807,46.75,15.21,12.24,9.25
04-11-2021,ARGANIL,2,0,18,"[0,120]",Baixo a Moderado,,,,2,Centro,COIMBRA,0601,33283.93,11014,672,648,612,559,596,1155,1767,2415,3087,33.09,9.27,7.26,5.31
04-11-2021,ARMAMAR,1,0,17,"[0,120]",Baixo a Moderado,,,,1,Norte,VISEU,1801,11723.73,5769,357,305,309,285,310,595,904,1209,1566,49.21,13.36,10.31,7.71
04-11-2021,AROUCA,50,4,243,"[240,480]",Elevado,,,,50,Norte,AVEIRO,0104,32910.52,20720,1306,1047,753,683,683,1366,2119,3166,4472,62.96,13.59,9.62,6.44
04-11-2021,ARRAIOLOS,0,0,0,"[0,120]",Baixo a Moderado,,,,0,Alentejo,ÉVORA,0702,68374.55,6928,435,384,283,367,480,847,1130,1514,1949,10.13,2.85,2.21,1.65
04-11-2021,ARRONCHES,1,0,36,"[0,120]",Baixo a Moderado,,,,1,Alentejo,PORTALEGRE,1202,31464.72,2820,155,142,162,187,179,366,528,670,825,8.96,2.62,2.13,1.68
04-11-2021,ARRUDA DOS VINHOS,7,0,44,"[0,120]",Baixo a Moderado,,,,7,Lisboa e Vale do Tejo,LISBOA,1102,7795.93,15412,738,738,562,509,438,947,1509,2247,2985,197.69,38.29,28.82,19.36
04-11-2021,AVEIRO,176,13,224,"[120,240]",Moderado,,,,176,Centro,AVEIRO,0105,19757.57,78734,4520,4004,3050,2250,2103,4353,7403,11407,15927,398.49,80.61,57.73,37.47
04-11-2021,AVIS,0,0,0,"[0,120]",Baixo a Moderado,,,,0,Alentejo,PORTALEGRE,1203,60596.51,4247,315,225,206,251,273,524,730,955,1270,7.01,2.1,1.58,1.2
04-11-2021,AZAMBUJA,60,4,263,"[240,480]",Elevado,,,,60,Lisboa e Vale do Tejo,LISBOA,1103,26265.65,22716,1322,1171,1070,798,618,1416,2486,3657,4979,86.48,18.96,13.92,9.46
04-11-2021,BAIÃO,9,1,48,"[0,120]",Baixo a Moderado,,,,9,Norte,PORTO,1302,17452.83,18748,1070,862,714,686,725,1411,2125,2987,4057,107.42,23.25,17.11,12.18
04-11-2021,BARCELOS,52,4,45,"[0,120]",Baixo a Moderado,,,,52,Norte,BRAGA,0302,37890.14,116187,6721,5325,3619,2991,2562,5553,9172,14497,21218,306.64,56.0,38.26,24.21
04-11-2021,BARRANCOS,0,0,0,"[0,120]",Baixo a Moderado,,,,0,Alentejo,BEJA,0204,16841.73,1634,90,65,65,94,61,155,220,285,375,9.7,2.23,1.69,1.31
04-11-2021,BARREIRO,86,6,114,"[0,120]",Baixo a Moderado,,,,86,Lisboa e Vale do Tejo,SETÚBAL,1504,3639.07,75147,5194,5565,4459,3105,1767,4872,9331,14896,20090,2065.05,552.07,409.34,256.42
04-11-2021,BATALHA,7,0,43,"[0,120]",Baixo a Moderado,,,,7,Centro,LEIRIA,1004,10341.6,15963,873,762,649,529,549,1078,1727,2489,3362,154.35,32.51,24.07,16.7
04-11-2021,BEJA,52,4,156,"[120,240]",Moderado,,,,52,Alentejo,BEJA,0205,114647.55,33579,2005,1840,1386,1272,1039,2311,3697,5537,7542,29.29,6.58,4.83,3.22
04-11-2021,BELMONTE,5,0,78,"[0,120]",Baixo a Moderado,,,,5,Centro,CASTELO BRANCO,0501,11875.91,6398,444,321,325,310,355,665,990,1311,1755,53.87,14.78,11.04,8.34
04-11-2021,BENAVENTE,62,4,202,"[120,240]",Moderado,,,,62,Lisboa e Vale do Tejo,SANTARÉM,1405,52138.39,30602,1468,1376,1141,876,643,1519,2660,4036,5504,58.69,10.56,7.74,5.1
04-11-2021,BOMBARRAL,6,0,47,"[0,120]",Baixo a Moderado,,,,6,Lisboa e Vale do Tejo,LEIRIA,1005,9128.55,12558,875,714,561,491,429,920,1481,2195,3070,137.56,33.63,24.04,16.22
04-11-2021,BORBA,2,0,30,"[0,120]",Baixo a Moderado,,,,2,Alentejo,ÉVORA,0703,14518.65,6736,430,375,279,436,392,828,1107,1482,1912,46.39,13.17,10.21,7.62
04-11-2021,BOTICAS,0,0,0,"[0,120]",Baixo a Moderado,,,,0,Norte,VILA REAL,1702,32195.66,4998,347,306,311,305,380,685,996,1302,1649,15.52,5.12,4.04,3.09
04-11-2021,BRAGA,152,11,83,"[0,120]",Baixo a Moderado,,,,152,Norte,BRAGA,0303,18339.95,182679,10029,7963,5241,4320,3671,7991,13232,21195,31224,996.07,170.25,115.57,72.15
04-11-2021,BRAGANÇA,77,6,230,"[120,240]",Moderado,,,,77,Norte,BRAGANÇA,0402,117357.27,33607,2402,1855,1652,1393,1163,2556,4208,6063,8465,28.64,7.21,5.17,3.59
04-11-2021,CABECEIRAS DE BASTO,3,0,19,"[0,120]",Baixo a Moderado,,,,3,Norte,BRAGA,0304,24182.16,15628,774,594,544,575,574,1149,1693,2287,3061,64.63,12.66,9.46,7.0
04-11-2021,CADAVAL,54,4,393,"[240,480]",Elevado,,,,54,Lisboa e Vale do Tejo,LISBOA,1104,17489.3,13673,813,796,756,621,625,1246,2002,2798,3611,78.18,20.65,16.0,11.45
04-11-2021,CALDAS DA RAINHA,65,5,126,"[120,240]",Moderado,,,,65,Lisboa e Vale do Tejo,LEIRIA,1006,25569.47,51912,3035,2684,2186,1899,1705,3604,5790,8474,11509,203.03,45.01,33.14,22.64
04-11-2021,CALHETA,5,0,46,"[0,120]",Baixo a Moderado,,,,5,Madeira,MADEIRA,3101,11150.43,10867,576,497,507,399,415,814,1321,1818,2394,97.46,21.47,16.3,11.85
04-11-2021,CALHETA (AÇORES),0,0,0,"[0,120]",Baixo a Moderado,,,,0,Açores,AÇORES,4501,12626.4,3184,215,159,141,139,122,261,402,561,776,25.22,6.15,4.44,3.18
04-11-2021,CÂMARA DE LOBOS,18,1,54,"[0,120]",Baixo a Moderado,,,,18,Madeira,MADEIRA,3102,5216.67,33675,1396,1059,834,545,381,926,1760,2819,4215,645.49,80.79,54.03,33.74
04-11-2021,CAMINHA,18,1,114,"[0,120]",Baixo a Moderado,,,,18,Norte,VIANA DO CASTELO,1602,13652.14,15877,1046,944,818,646,656,1302,2120,3064,4110,116.3,30.11,22.44,15.53
04-11-2021,CAMPO MAIOR,1,0,13,"[0,120]",Baixo a Moderado,,,,1,Alentejo,PORTALEGRE,1204,24720.16,7874,471,364,351,279,327,606,957,1321,1792,31.85,7.25,5.34,3.87
04-11-2021,CANTANHEDE,20,1,57,"[0,120]",Baixo a Moderado,,,,20,Centro,COIMBRA,0602,39088.02,35011,2346,2096,1880,1709,1451,3160,5040,7136,9482,89.57,24.26,18.26,12.89
04-11-2021,CARRAZEDA DE ANSIÃES,1,0,18,"[0,120]",Baixo a Moderado,,,,1,Norte,BRAGANÇA,0403,27924.09,5666,424,389,391,312,465,777,1168,1557,1981,20.29,7.09,5.58,4.18
04-11-2021,CARREGAL DO SAL,16,1,172,"[120,240]",Moderado,,,,16,Centro,VISEU,1802,11689.21,9271,587,562,486,462,376,838,1324,1886,2473,79.31,21.16,16.13,11.33
04-11-2021,CARTAXO,41,3,172,"[120,240]",Moderado,,,,41,Lisboa e Vale do Tejo,SANTARÉM,1406,15817.28,23843,1415,1376,1142,861,632,1493,2635,4011,5426,150.74,34.3,25.36,16.66
04-11-2021,CASCAIS,329,23,154,"[120,240]",Moderado,,,,329,Lisboa e Vale do Tejo,LISBOA,1105,9740.17,213608,12151,11444,8680,6469,5248,11717,20397,31841,43992,2193.1,451.66,326.91,209.41
04-11-2021,CASTANHEIRA DE PÊRA,4,0,155,"[120,240]",Moderado,,,,4,Centro,LEIRIA,1007,6677.45,2614,233,195,157,190,187,377,534,729,962,39.15,14.41,10.92,8.0
04-11-2021,CASTELO BRANCO,151,11,290,"[240,480]",Elevado,,,,151,Centro,CASTELO BRANCO,0502,143819.15,51987,3528,3042,2499,2229,2225,4454,6953,9995,13523,36.15,9.4,6.95,4.83
04-11-2021,CASTELO DE PAIVA,10,1,65,"[0,120]",Baixo a Moderado,,,,10,Norte,AVEIRO,0106,11500.53,15454,881,697,545,420,431,851,1396,2093,2974,134.37,25.86,18.2,12.14
04-11-2021,CASTELO DE VIDE,1,0,35,"[0,120]",Baixo a Moderado,,,,1,Alentejo,PORTALEGRE,1205,26491.24,2919,204,173,179,147,170,317,496,669,873,11.02,3.3,2.53,1.87
04-11-2021,CASTRO DAIRE,18,1,130,"[120,240]",Moderado,,,,18,Centro,VISEU,1803,37904.13,13823,942,857,765,732,773,1505,2270,3127,4069,36.47,10.74,8.25,5.99
04-11-2021,CASTRO MARIM,7,1,113,"[0,120]",Baixo a Moderado,,,,7,Algarve,FARO,0804,30084.37,6237,370,345,334,322,344,666,1000,1345,1715,20.73,5.7,4.47,3.32
04-11-2021,CASTRO VERDE,14,1,203,"[120,240]",Moderado,,,,14,Alentejo,BEJA,0206,56944.23,6949,437,347,303,275,227,502,805,1152,1589,12.2,2.79,2.02,1.41
04-11-2021,CELORICO DA BEIRA,4,0,58,"[0,120]",Baixo a Moderado,,,,4,Centro,GUARDA,0903,24721.63,6928,430,416,363,369,535,904,1267,1683,2113,28.02,8.55,6.81,5.12
04-11-2021,CELORICO DE BASTO,6,0,32,"[0,120]",Baixo a Moderado,,,,6,Norte,BRAGA,0305,18107.02,19040,1001,802,668,728,729,1457,2125,2927,3928,105.15,21.69,16.17,11.74
04-11-2021,CHAMUSCA,5,0,55,"[0,120]",Baixo a Moderado,,,,5,Lisboa e Vale do Tejo,SANTARÉM,1407,74600.54,9197,629,583,553,465,579,1044,1597,2180,2809,12.33,3.77,2.92,2.14
04-11-2021,CHAVES,10,1,26,"[0,120]",Baixo a Moderado,,,,10,Norte,VILA REAL,1703,59122.95,39343,2676,2429,1991,1886,1918,3804,5795,8224,10900,66.54,18.44,13.91,9.8
04-11-2021,CINFÃES,3,0,17,"[0,120]",Baixo a Moderado,,,,3,Norte,VISEU,1804,23928.76,18244,1067,902,779,734,758,1492,2271,3173,4240,76.24,17.72,13.26,9.49
04-11-2021,COIMBRA,130,9,97,"[0,120]",Baixo a Moderado,,,,130,Centro,COIMBRA,0603,31939.94,134166,9489,8734,6353,5139,5074,10213,16566,25300,34789,420.06,108.92,79.21,51.87
04-11-2021,CONDEIXA-A-NOVA,20,1,112,"[0,120]",Baixo a Moderado,,,,20,Centro,COIMBRA,0604,13867.47,17733,871,809,717,583,490,1073,1790,2599,3470,127.88,25.02,18.74,12.91
04-11-2021,CONSTÂNCIA,1,0,25,"[0,120]",Baixo a Moderado,,,,1,Lisboa e Vale do Tejo,SANTARÉM,1408,8036.58,4030,211,183,187,148,155,303,490,673,884,50.14,11.0,8.37,6.1
04-11-2021,CORUCHE,16,1,93,"[0,120]",Baixo a Moderado,,,,16,Lisboa e Vale do Tejo,SANTARÉM,1409,111572.03,17471,1294,1090,1095,1096,1019,2115,3210,4300,5594,15.66,5.01,3.85,2.88
04-11-2021,CORVO,0,0,0,"[0,120]",Baixo a Moderado,,,,0,Açores,AÇORES,4901,1711.45,464,22,21,11,13,19,32,43,64,86,27.12,5.03,3.74,2.51
04-11-2021,COVILHÃ,198,14,423,"[240,480]",Elevado,,,,198,Centro,CASTELO BRANCO,0503,55560.06,46787,3533,2998,2365,2111,2193,4304,6669,9667,13200,84.21,23.76,17.4,12.0
04-11-2021,CRATO,1,0,33,"[0,120]",Baixo a Moderado,,,,1,Alentejo,PORTALEGRE,1206,39806.88,3129,229,258,163,182,228,410,573,831,1060,7.86,2.66,2.09,1.44
04-11-2021,CUBA,4,0,88,"[0,120]",Baixo a Moderado,,,,4,Alentejo,BEJA,0207,17208.72,4595,255,233,206,190,143,333,539,772,1027,26.7,5.97,4.49,3.13
04-11-2021,ELVAS,11,1,54,"[0,120]",Baixo a Moderado,,,,11,Alentejo,PORTALEGRE,1207,63128.86,20528,1057,1145,902,852,810,1662,2564,3709,4766,32.52,7.55,5.88,4.06
04-11-2021,ENTRONCAMENTO,50,4,233,"[120,240]",Moderado,,,,50,Lisboa e Vale do Tejo,SANTARÉM,1410,1372.81,21558,1066,930,868,695,592,1287,2155,3085,4151,1570.14,302.33,224.69,156.96
04-11-2021,ESPINHO,28,2,95,"[0,120]",Baixo a Moderado,,,,28,Norte,AVEIRO,0107,2105.68,29516,2205,1993,1430,1177,960,2137,3567,5560,7765,1401.52,368.71,264.01,169.37
04-11-2021,ESPOSENDE,24,2,70,"[0,120]",Baixo a Moderado,,,,24,Norte,BRAGA,0306,9540.98,34177,1831,1522,1095,894,723,1617,2712,4234,6065,358.21,63.57,44.38,28.42
04-11-2021,ESTARREJA,23,2,88,"[0,120]",Baixo a Moderado,,,,23,Centro,AVEIRO,0108,10817.33,26006,1503,1399,1106,953,728,1681,2787,4186,5689,240.42,52.59,38.7,25.76
04-11-2021,ESTREMOZ,2,0,16,"[0,120]",Baixo a Moderado,,,,2,Alentejo,ÉVORA,0704,51379.95,12728,789,613,697,786,877,1663,2360,2973,3762,24.77,7.32,5.79,4.59
04-11-2021,ÉVORA,22,2,42,"[0,120]",Baixo a Moderado,,,,22,Alentejo,ÉVORA,0705,130707.58,52428,3569,2852,2176,1966,1803,3769,5945,8797,12366,40.11,9.46,6.73,4.55
04-11-2021,FAFE,31,2,65,"[0,120]",Baixo a Moderado,,,,31,Norte,BRAGA,0307,21908.11,48060,3044,2455,1679,1403,1208,2611,4290,6745,9789,219.37,44.68,30.79,19.58
04-11-2021,FARO,93,7,152,"[120,240]",Moderado,,,,93,Algarve,FARO,0805,20256.79,61015,3847,3364,2604,2055,1601,3656,6260,9624,13471,301.2,66.5,47.51,30.9
04-11-2021,FELGUEIRAS,36,3,64,"[0,120]",Baixo a Moderado,,,,36,Norte,PORTO,1303,11573.75,56422,2951,2302,1601,1316,973,2289,3890,6192,9143,487.49,79.0,53.5,33.61
04-11-2021,FERREIRA DO ALENTEJO,19,1,243,"[240,480]",Elevado,,,,19,Alentejo,BEJA,0208,64820.68,7845,515,414,372,343,345,688,1060,1474,1989,12.1,3.07,2.27,1.64
04-11-2021,FERREIRA DO ZÊZERE,3,0,38,"[0,120]",Baixo a Moderado,,,,3,Lisboa e Vale do Tejo,SANTARÉM,1411,19038.03,7959,470,370,416,465,456,921,1337,1707,2177,41.81,11.44,8.97,7.02
04-11-2021,FIGUEIRA DA FOZ,72,5,122,"[120,240]",Moderado,,,,72,Centro,COIMBRA,0605,37905.26,58747,4032,3597,2887,2495,2043,4538,7425,11022,15054,154.98,39.72,29.08,19.59
04-11-2021,FIGUEIRA DE CASTELO RODRIGO,1,0,18,"[0,120]",Baixo a Moderado,,,,1,Centro,GUARDA,0904,50857.46,5584,347,352,290,352,391,743,1033,1385,1732,10.98,3.41,2.72,2.03
04-11-2021,FIGUEIRÓ DOS VINHOS,4,0,72,"[0,120]",Baixo a Moderado,,,,4,Centro,LEIRIA,1008,17344.0,5568,402,386,322,309,351,660,982,1368,1770,32.1,10.21,7.89,5.66
04-11-2021,FORNOS DE ALGODRES,2,0,44,"[0,120]",Baixo a Moderado,,,,2,Centro,GUARDA,0905,13145.05,4528,261,218,247,256,232,488,735,953,1214,34.45,9.24,7.25,5.59
04-11-2021,FREIXO DE ESPADA À CINTA,1,0,31,"[0,120]",Baixo a Moderado,,,,1,Norte,BRAGANÇA,0404,24414.29,3298,211,177,231,196,189,385,616,793,1004,13.51,4.11,3.25,2.52
04-11-2021,FRONTEIRA,0,0,0,"[0,120]",Baixo a Moderado,,,,0,Alentejo,PORTALEGRE,1208,24859.58,2974,213,182,149,156,168,324,473,655,868,11.96,3.49,2.63,1.9
04-11-2021,FUNCHAL,221,16,212,"[120,240]",Moderado,,,,221,Madeira,MADEIRA,3103,7616.2,104024,6382,5086,3643,2821,1990,4811,8454,13540,19922,1365.86,261.58,177.78,111.0
04-11-2021,FUNDÃO,58,4,219,"[120,240]",Moderado,,,,58,Centro,CASTELO BRANCO,0504,70019.79,26495,1781,1464,1432,1357,1643,3000,4432,5896,7677,37.84,10.96,8.42,6.33
04-11-2021,GAVIÃO,2,0,63,"[0,120]",Baixo a Moderado,,,,2,Alentejo,PORTALEGRE,1209,29459.45,3263,189,186,222,263,293,556,778,964,1153,11.08,3.91,3.27,2.64
04-11-2021,GÓIS,5,0,133,"[120,240]",Moderado,,,,5,Centro,COIMBRA,0606,26330.19,3805,235,199,240,233,244,477,717,916,1151,14.45,4.37,3.48,2.72
04-11-2021,GOLEGÃ,19,1,359,"[240,480]",Elevado,,,,19,Lisboa e Vale do Tejo,SANTARÉM,1412,8431.67,5339,356,299,281,243,255,498,779,1078,1434,63.32,17.01,12.78,9.24
04-11-2021,GONDOMAR,103,7,62,"[0,120]",Baixo a Moderado,,,,103,Norte,PORTO,1304,13191.76,165985,10555,8755,6222,4450,3364,7814,14036,22791,33346,1258.22,252.77,172.76,106.4
04-11-2021,GOUVEIA,34,2,275,"[240,480]",Elevado,,,,34,Centro,GUARDA,0906,30061.17,12387,871,931,780,783,810,1593,2373,3304,4175,41.21,13.89,10.99,7.89
04-11-2021,GRÂNDOLA,2,0,14,"[0,120]",Baixo a Moderado,,,,2,Alentejo,SETÚBAL,1505,82593.66,14639,834,834,708,688,672,1360,2068,2902,3736,17.72,4.52,3.51,2.5
04-11-2021,GUARDA,45,3,115,"[0,120]",Baixo a Moderado,,,,45,Centro,GUARDA,0907,71209.58,38969,2477,2041,1686,1415,1474,2889,4575,6616,9093,54.72,12.77,9.29,6.42
04-11-2021,GUIMARÃES,78,6,51,"[0,120]",Baixo a Moderado,,,,78,Norte,BRAGA,0308,24099.96,152309,9394,7074,4809,3877,2948,6825,11634,18708,28102,631.99,116.61,77.63,48.27
04-11-2021,HORTA,15,1,104,"[0,120]",Baixo a Moderado,,,,15,Açores,AÇORES,4701,17305.53,14521,818,658,468,352,302,654,1122,1780,2598,83.91,15.01,10.29,6.48
04-11-2021,IDANHA-A-NOVA,28,2,353,"[240,480]",Elevado,,,,28,Centro,CASTELO BRANCO,0505,141633.51,8043,518,490,519,672,974,1646,2165,2655,3173,5.68,2.24,1.87,1.53
04-11-2021,ÍLHAVO,43,3,112,"[0,120]",Baixo a Moderado,,,,43,Centro,AVEIRO,0110,7347.55,38699,2227,1943,1444,1193,850,2043,3487,5430,7657,526.66,104.21,73.9,47.46
04-11-2021,LAGOA (FARO),52,4,229,"[120,240]",Moderado,,,,52,Algarve,FARO,0806,8825.45,22762,1314,1168,919,749,670,1419,2338,3506,4820,257.93,54.62,39.73,26.49
04-11-2021,LAGOA,11,1,75,"[0,120]",Baixo a Moderado,,,,11,Açores,AÇORES,4201,4559.32,14721,536,458,349,238,235,473,822,1280,1816,322.9,39.83,28.08,18.03
04-11-2021,LAGOS,60,4,198,"[120,240]",Moderado,,,,60,Algarve,FARO,0807,21299.27,30374,1744,1434,1247,1053,1029,2082,3329,4763,6507,142.61,30.55,22.36,15.63
04-11-2021,LAJES DAS FLORES,0,0,0,"[0,120]",Baixo a Moderado,,,,0,Açores,AÇORES,4801,7004.79,1463,88,53,62,46,54,100,162,215,303,20.89,4.33,3.07,2.31
04-11-2021,LAJES DO PICO,1,0,22,"[0,120]",Baixo a Moderado,,,,1,Açores,AÇORES,4601,15531.09,4490,304,231,223,159,162,321,544,775,1079,28.91,6.95,4.99,3.5
04-11-2021,LAMEGO,16,1,65,"[0,120]",Baixo a Moderado,,,,16,Norte,VISEU,1805,16542.11,24895,1639,1284,1124,898,783,1681,2805,4089,5728,150.5,34.63,24.72,16.96
04-11-2021,LEIRIA,234,17,187,"[120,240]",Moderado,,,,234,Centro,LEIRIA,1009,56508.83,125267,7389,6366,5090,3902,3159,7061,12151,18517,25906,221.68,45.84,32.77,21.5
04-11-2021,LISBOA,836,60,164,"[120,240]",Moderado,,,,836,Lisboa e Vale do Tejo,LISBOA,1106,10005.43,509515,33197,33340,27706,23037,26770,49807,77513,110853,144050,5092.6,1439.78,1107.98,774.74
04-11-2021,LOULÉ,157,11,229,"[120,240]",Moderado,,,,157,Algarve,FARO,0808,76366.91,68697,3890,3350,2780,2358,2251,4609,7389,10739,14629,89.96,19.16,14.06,9.68
04-11-2021,LOURES,141,10,66,"[0,120]",Baixo a Moderado,,,,141,Lisboa e Vale do Tejo,LISBOA,1107,16723.99,213687,12746,12794,9644,6669,5033,11702,21346,34140,46886,1277.73,280.35,204.14,127.64
04-11-2021,LOURINHÃ,78,6,302,"[240,480]",Elevado,,,,78,Lisboa e Vale do Tejo,LISBOA,1108,14717.2,25855,1584,1243,992,842,645,1487,2479,3722,5306,175.68,36.05,25.29,16.84
04-11-2021,LOUSÃ,25,2,145,"[120,240]",Moderado,,,,25,Centro,COIMBRA,0607,13840.01,17158,946,866,658,528,450,978,1636,2502,3448,123.97,24.91,18.08,11.82
04-11-2021,LOUSADA,12,1,26,"[0,120]",Baixo a Moderado,,,,12,Norte,PORTO,1305,9608.01,46755,2289,1698,1176,853,621,1474,2650,4348,6637,486.63,69.08,45.25,27.58
04-11-2021,MAÇÃO,8,1,129,"[120,240]",Moderado,,,,8,Lisboa e Vale do Tejo,SANTARÉM,1413,39997.98,6267,386,362,390,440,657,1097,1487,1849,2235,15.67,5.59,4.62,3.72
04-11-2021,MACEDO DE CAVALEIROS,6,0,42,"[0,120]",Baixo a Moderado,,,,6,Norte,BRAGANÇA,0405,69914.08,14516,1082,889,878,823,938,1761,2639,3528,4610,20.76,6.59,5.05,3.77
04-11-2021,MACHICO,13,1,65,"[0,120]",Baixo a Moderado,,,,13,Madeira,MADEIRA,3104,6825.1,19981,1197,860,662,455,331,786,1448,2308,3505,292.76,51.36,33.82,21.22
04-11-2021,MADALENA,1,0,17,"[0,120]",Baixo a Moderado,,,,1,Açores,AÇORES,4602,14712.33,5895,334,256,173,190,179,369,542,798,1132,40.07,7.69,5.42,3.68
04-11-2021,MAFRA,105,8,124,"[120,240]",Moderado,,,,105,Lisboa e Vale do Tejo,LISBOA,1109,29165.5,84816,3613,3334,2839,2089,1899,3988,6827,10161,13774,290.81,47.23,34.84,23.41
04-11-2021,MAIA,151,11,109,"[0,120]",Baixo a Moderado,,,,151,Norte,PORTO,1306,8293.94,138971,7801,6617,4512,3339,2631,5970,10482,17099,24900,1675.56,300.22,206.16,126.38
04-11-2021,MANGUALDE,46,3,248,"[240,480]",Elevado,,,,46,Centro,VISEU,1806,21925.56,18510,1198,1128,885,852,743,1595,2480,3608,4806,84.42,21.92,16.46,11.31
04-11-2021,MANTEIGAS,2,0,67,"[0,120]",Baixo a Moderado,,,,2,Centro,GUARDA,0908,12197.55,3007,258,197,159,167,146,313,472,669,927,24.65,7.6,5.48,3.87
04-11-2021,MARCO DE CANAVESES,45,3,88,"[0,120]",Baixo a Moderado,,,,45,Norte,PORTO,1307,20188.98,51496,2678,2060,1488,1265,1023,2288,3776,5836,8514,255.07,42.17,28.91,18.7
04-11-2021,MARINHA GRANDE,39,3,100,"[0,120]",Baixo a Moderado,,,,39,Centro,LEIRIA,1010,18725.19,38508,2365,2302,1638,1359,1058,2417,4055,6357,8722,205.65,46.58,33.95,21.66
04-11-2021,MARVÃO,1,0,34,"[0,120]",Baixo a Moderado,,,,1,Alentejo,PORTALEGRE,1210,15489.9,3005,198,185,142,197,237,434,576,761,959,19.4,6.19,4.91,3.72
04-11-2021,MATOSINHOS,125,9,71,"[0,120]",Baixo a Moderado,,,,125,Norte,PORTO,1308,6241.97,175357,11850,9977,7023,5024,3884,8908,15931,25908,37758,2809.31,604.9,415.06,255.22
04-11-2021,MEALHADA,19,1,95,"[0,120]",Baixo a Moderado,,,,19,Centro,AVEIRO,0111,11065.66,19914,1163,1039,810,828,831,1659,2469,3508,4671,179.96,42.21,31.7,22.31
04-11-2021,MÊDA,13,1,284,"[240,480]",Elevado,,,,13,Centro,GUARDA,0909,28604.92,4587,343,306,290,288,443,731,1021,1327,1670,16.04,5.84,4.64,3.57
04-11-2021,MELGAÇO,1,0,13,"[0,120]",Baixo a Moderado,,,,1,Norte,VIANA DO CASTELO,1603,23824.58,8093,507,567,578,614,675,1289,1867,2434,2941,33.97,12.34,10.22,7.84
04-11-2021,MÉRTOLA,2,0,33,"[0,120]",Baixo a Moderado,,,,2,Alentejo,BEJA,0209,129287.34,6142,400,390,378,423,600,1023,1401,1791,2191,4.75,1.69,1.39,1.08
04-11-2021,MESÃO FRIO,2,0,51,"[0,120]",Baixo a Moderado,,,,2,Norte,VILA REAL,1704,2664.87,3964,265,205,168,157,120,277,445,650,915,148.74,34.33,24.39,16.7
04-11-2021,MIRA,26,2,219,"[120,240]",Moderado,,,,26,Centro,COIMBRA,0608,12403.38,11832,727,729,659,550,466,1016,1675,2404,3131,95.4,25.24,19.38,13.5
04-11-2021,MIRANDA DO CORVO,33,2,260,"[240,480]",Elevado,,,,33,Centro,COIMBRA,0609,12637.79,12708,706,659,568,498,404,902,1470,2129,2835,100.55,22.43,16.85,11.63
04-11-2021,MIRANDA DO DOURO,6,0,89,"[0,120]",Baixo a Moderado,,,,6,Norte,BRAGANÇA,0406,48718.31,6830,482,429,442,463,470,933,1375,1804,2286,14.02,4.69,3.7,2.82
04-11-2021,MIRANDELA,23,2,107,"[0,120]",Baixo a Moderado,,,,23,Norte,BRAGANÇA,0407,65895.67,21754,1640,1315,1204,1078,947,2025,3229,4544,6184,33.01,9.38,6.9,4.9
04-11-2021,MOGADOURO,5,0,60,"[0,120]",Baixo a Moderado,,,,5,Norte,BRAGANÇA,0408,76064.93,8392,589,529,576,630,655,1285,1861,2390,2979,11.03,3.92,3.14,2.45
04-11-2021,MOIMENTA DA BEIRA,12,1,124,"[120,240]",Moderado,,,,12,Norte,VISEU,1807,21996.9,9736,576,514,471,416,461,877,1348,1862,2438,44.26,11.08,8.46,6.13
04-11-2021,MOITA,44,3,69,"[0,120]",Baixo a Moderado,,,,44,Lisboa e Vale do Tejo,SETÚBAL,1506,5525.98,64407,4226,3646,2623,1801,1425,3226,5849,9495,13721,1165.53,248.3,171.82,105.85
04-11-2021,MONÇÃO,10,1,56,"[0,120]",Baixo a Moderado,,,,10,Norte,VIANA DO CASTELO,1604,21130.85,17869,1161,1105,1031,1006,972,1978,3009,4114,5275,84.56,24.96,19.47,14.24
04-11-2021,MONCHIQUE,0,0,0,"[0,120]",Baixo a Moderado,,,,0,Algarve,FARO,0809,39530.43,5077,353,384,321,355,392,747,1068,1452,1805,12.84,4.57,3.67,2.7
04-11-2021,MONDIM DE BASTO,5,0,73,"[0,120]",Baixo a Moderado,,,,5,Norte,VILA REAL,1705,17207.52,6946,395,300,314,284,283,567,881,1181,1576,40.36,9.16,6.86,5.12
04-11-2021,MONFORTE,1,0,34,"[0,120]",Baixo a Moderado,,,,1,Alentejo,PORTALEGRE,1211,42024.82,2975,139,115,117,192,168,360,477,592,731,7.08,1.74,1.41,1.14
04-11-2021,MONTALEGRE,2,0,23,"[0,120]",Baixo a Moderado,,,,2,Norte,VILA REAL,1706,80545.71,8997,699,628,595,603,730,1333,1928,2556,3255,11.17,4.04,3.17,2.39
04-11-2021,MONTEMOR-O-NOVO,5,0,32,"[0,120]",Baixo a Moderado,,,,5,Alentejo,ÉVORA,0706,123296.65,15647,991,953,868,878,971,1849,2717,3670,4661,12.69,3.78,2.98,2.2
04-11-2021,MONTEMOR-O-VELHO,37,3,146,"[120,240]",Moderado,,,,37,Centro,COIMBRA,0610,22896.23,25224,1496,1397,1217,1057,988,2045,3262,4659,6155,110.17,26.88,20.35,14.25
04-11-2021,MONTIJO,26,2,45,"[0,120]",Baixo a Moderado,,,,26,Lisboa e Vale do Tejo,SETÚBAL,1507,34861.64,57614,2771,2441,1990,1554,1109,2663,4653,7094,9865,165.26,28.3,20.35,13.35
04-11-2021,MORA,6,0,149,"[120,240]",Moderado,,,,6,Alentejo,ÉVORA,0707,44395.02,4138,336,275,252,238,257,495,747,1022,1358,9.32,3.06,2.3,1.68
04-11-2021,MORTÁGUA,1,0,11,"[0,120]",Baixo a Moderado,,,,1,Centro,VISEU,1808,25117.82,8803,638,584,535,499,460,959,1494,2078,2716,35.05,10.81,8.27,5.95
04-11-2021,MOURA,26,2,191,"[120,240]",Moderado,,,,26,Alentejo,BEJA,0210,95845.55,13718,817,656,665,542,461,1003,1668,2324,3141,14.31,3.28,2.42,1.74
04-11-2021,MOURÃO,0,0,0,"[0,120]",Baixo a Moderado,,,,0,Alentejo,ÉVORA,0708,27862.98,2450,139,108,80,104,109,213,293,401,540,8.79,1.94,1.44,1.05
04-11-2021,MURÇA,1,0,19,"[0,120]",Baixo a Moderado,,,,1,Norte,VILA REAL,1707,18937.11,5463,384,341,307,306,319,625,932,1273,1657,28.85,8.75,6.72,4.92
04-11-2021,MURTOSA,2,0,19,"[0,120]",Baixo a Moderado,,,,2,Centro,AVEIRO,0112,7308.78,10279,509,473,403,353,409,762,1165,1638,2147,140.63,29.37,22.41,15.94
04-11-2021,NAZARÉ,22,2,154,"[120,240]",Moderado,,,,22,Lisboa e Vale do Tejo,LEIRIA,1011,8243.43,14165,967,903,670,420,396,816,1486,2389,3356,171.84,40.71,28.98,18.03
04-11-2021,NELAS,22,2,169,"[120,240]",Moderado,,,,22,Centro,VISEU,1809,12571.48,12974,924,787,668,604,583,1187,1855,2642,3566,103.21,28.37,21.02,14.76
04-11-2021,NISA,0,0,0,"[0,120]",Baixo a Moderado,,,,0,Alentejo,PORTALEGRE,1212,57567.84,6061,405,389,355,483,478,961,1316,1705,2110,10.53,3.67,2.96,2.29
04-11-2021,NORDESTE,1,0,21,"[0,120]",Baixo a Moderado,,,,1,Açores,AÇORES,4202,10146.8,4862,246,180,124,161,162,323,447,627,873,47.92,8.6,6.18,4.41
04-11-2021,ÓBIDOS,13,1,108,"[0,120]",Baixo a Moderado,,,,13,Lisboa e Vale do Tejo,LEIRIA,1012,14155.44,11850,743,650,574,452,436,888,1462,2112,2855,83.72,20.17,14.92,10.33
04-11-2021,ODEMIRA,36,3,146,"[120,240]",Moderado,,,,36,Alentejo,BEJA,0211,172060.15,24717,1475,1317,1225,1397,1349,2746,3971,5288,6763,14.37,3.93,3.07,2.31
04-11-2021,ODIVELAS,97,7,60,"[0,120]",Baixo a Moderado,,,,97,Lisboa e Vale do Tejo,LISBOA,1116,2654.36,161774,9562,9038,6952,4641,3812,8453,15405,24443,34005,6095.48,1281.27,920.99,580.44
04-11-2021,OEIRAS,140,10,79,"[0,120]",Baixo a Moderado,,,,140,Lisboa e Vale do Tejo,LISBOA,1110,4588.31,177408,11580,11575,8566,6211,5855,12066,20632,32207,43787,3866.78,954.38,701.98,449.69
04-11-2021,OLEIROS,10,1,200,"[120,240]",Moderado,,,,10,Centro,CASTELO BRANCO,0506,47109.31,5003,384,341,366,397,487,884,1250,1591,1975,10.62,4.19,3.38,2.65
04-11-2021,OLHÃO,57,4,129,"[120,240]",Moderado,,,,57,Algarve,FARO,0810,13086.38,44405,2455,2309,1689,1342,1268,2610,4299,6608,9063,339.33,69.26,50.5,32.85
04-11-2021,OLIVEIRA DE AZEMÉIS,75,5,113,"[0,120]",Baixo a Moderado,,,,75,Norte,AVEIRO,0113,16110.41,66011,4155,3614,2794,2183,1738,3921,6715,10329,14484,409.75,89.91,64.12,41.68
04-11-2021,OLIVEIRA DE FRADES,4,0,40,"[0,120]",Baixo a Moderado,,,,4,Centro,VISEU,1810,14534.62,9936,553,475,438,359,415,774,1212,1687,2240,68.36,15.41,11.61,8.34
04-11-2021,OLIVEIRA DO BAIRRO,8,1,32,"[0,120]",Baixo a Moderado,,,,8,Centro,AVEIRO,0114,8731.99,24277,1327,1182,999,786,810,1596,2595,3777,5104,278.02,58.45,43.25,29.72
04-11-2021,OLIVEIRA DO HOSPITAL,46,3,239,"[120,240]",Moderado,,,,46,Centro,COIMBRA,0611,23451.66,19253,1161,1097,962,924,960,1884,2846,3943,5104,82.1,21.76,16.81,12.14
04-11-2021,OURÉM,105,8,239,"[120,240]",Moderado,,,,105,Lisboa e Vale do Tejo,SANTARÉM,1421,41668.03,44044,2463,2069,1899,1817,1603,3420,5319,7388,9851,105.7,23.64,17.73,12.77
04-11-2021,OURIQUE,3,0,66,"[0,120]",Baixo a Moderado,,,,3,Alentejo,BEJA,0212,66331.36,4607,313,287,284,268,227,495,779,1066,1379,6.95,2.08,1.61,1.17
04-11-2021,OVAR,59,4,108,"[0,120]",Baixo a Moderado,,,,59,Centro,AVEIRO,0115,14770.25,54260,3294,2709,1994,1636,1234,2870,4864,7573,10867,367.37,73.57,51.27,32.93
04-11-2021,PAÇOS DE FERREIRA,52,4,92,"[0,120]",Baixo a Moderado,,,,52,Norte,PORTO,1309,7099.29,56728,2903,2193,1518,1135,664,1799,3317,5510,8413,799.1,118.51,77.62,46.72
04-11-2021,PALMELA,51,4,80,"[0,120]",Baixo a Moderado,,,,51,Lisboa e Vale do Tejo,SETÚBAL,1508,46512.01,64269,3402,3244,2635,1846,1391,3237,5872,9116,12518,138.18,26.91,19.6,12.62
04-11-2021,PAMPILHOSA DA SERRA,43,3,1066,"[960,Max]",Extremamente Elevado,,,,43,Centro,COIMBRA,0612,39646.24,4037,238,254,295,339,423,762,1057,1311,1549,10.18,3.91,3.31,2.67
04-11-2021,PAREDES,41,3,48,"[0,120]",Baixo a Moderado,,,,41,Norte,PORTO,1310,15675.69,86067,4272,3532,2412,1717,1258,2975,5387,8919,13191,549.04,84.15,56.9,34.36
04-11-2021,PAREDES DE COURA,0,0,0,"[0,120]",Baixo a Moderado,,,,0,Norte,VIANA DO CASTELO,1605,13818.59,8535,466,528,407,465,515,980,1387,1915,2381,61.76,17.23,13.86,10.04
04-11-2021,PEDRÓGÃO GRANDE,4,0,117,"[0,120]",Baixo a Moderado,,,,4,Centro,LEIRIA,1013,12874.75,3410,175,173,196,221,252,473,669,842,1017,26.49,7.9,6.54,5.2
04-11-2021,PENACOVA,5,0,37,"[0,120]",Baixo a Moderado,,,,5,Centro,COIMBRA,0613,21673.23,13694,968,923,745,621,703,1324,2069,2992,3960,63.18,18.27,13.81,9.55
04-11-2021,PENAFIEL,19,1,27,"[0,120]",Baixo a Moderado,,,,19,Norte,PORTO,1311,21224.27,69772,3648,2823,2032,1663,1230,2893,4925,7748,11396,328.74,53.69,36.51,23.2
04-11-2021,PENALVA DO CASTELO,3,0,42,"[0,120]",Baixo a Moderado,,,,3,Centro,VISEU,1811,13433.92,7115,449,457,413,391,426,817,1230,1687,2136,52.96,15.9,12.56,9.16
04-11-2021,PENAMACOR,35,3,741,"[480,960]",Muito Elevado,,,,35,Centro,CASTELO BRANCO,0507,56370.69,4755,262,248,273,451,633,1084,1357,1605,1867,8.44,3.31,2.85,2.41
04-11-2021,PENEDONO,15,1,583,"[480,960]",Muito Elevado,,,,15,Norte,VISEU,1812,13370.75,2591,172,113,129,156,138,294,423,536,708,19.38,5.3,4.01,3.16
04-11-2021,PENELA,1,0,19,"[0,120]",Baixo a Moderado,,,,1,Centro,COIMBRA,0614,13480.0,5397,314,324,274,359,344,703,977,1301,1615,40.04,11.98,9.65,7.25
04-11-2021,PENICHE,48,3,180,"[120,240]",Moderado,,,,48,Lisboa e Vale do Tejo,LEIRIA,1014,7754.98,26501,1746,1504,1203,926,707,1633,2836,4340,6086,341.73,78.48,55.96,36.57
04-11-2021,PESO DA RÉGUA,6,0,38,"[0,120]",Baixo a Moderado,,,,6,Norte,VILA REAL,1708,9486.01,15773,1076,843,650,659,455,1114,1764,2607,3683,166.28,38.83,27.48,18.6
04-11-2021,PINHEL,0,0,0,"[0,120]",Baixo a Moderado,,,,0,Centro,GUARDA,0910,48452.12,8511,577,566,551,538,689,1227,1778,2344,2921,17.57,6.03,4.84,3.67
04-11-2021,POMBAL,29,2,56,"[0,120]",Baixo a Moderado,,,,29,Centro,LEIRIA,1015,62600.28,51461,3187,2791,2494,2328,2027,4355,6849,9640,12827,82.21,20.49,15.4,10.94
04-11-2021,PONTA DELGADA,132,9,195,"[120,240]",Moderado,,,,132,Açores,AÇORES,4203,23298.65,67935,3108,2435,1726,1133,902,2035,3761,6196,9304,291.58,39.93,26.59,16.14
04-11-2021,PONTA DO SOL,3,0,35,"[0,120]",Baixo a Moderado,,,,3,Madeira,MADEIRA,3105,4622.03,8593,319,283,347,208,221,429,776,1059,1378,185.92,29.81,22.91,16.79
04-11-2021,PONTE DA BARCA,64,5,568,"[480,960]",Muito Elevado,,,,64,Norte,VIANA DO CASTELO,1606,18211.37,11180,635,576,517,554,490,1044,1561,2137,2772,61.39,15.22,11.73,8.57
04-11-2021,PONTE DE LIMA,26,2,63,"[0,120]",Baixo a Moderado,,,,26,Norte,VIANA DO CASTELO,1607,32025.46,41315,2321,2022,1720,1596,1462,3058,4778,6800,9121,129.01,28.48,21.23,14.92
04-11-2021,PONTE DE SOR,2,0,13,"[0,120]",Baixo a Moderado,,,,2,Alentejo,PORTALEGRE,1213,83971.16,14994,939,800,716,739,831,1570,2286,3086,4025,17.86,4.79,3.68,2.72
04-11-2021,PORTALEGRE,7,1,32,"[0,120]",Baixo a Moderado,,,,7,Alentejo,PORTALEGRE,1214,44713.64,22172,1577,1351,1137,993,984,1977,3114,4465,6042,49.59,13.51,9.99,6.96
04-11-2021,PORTEL,0,0,0,"[0,120]",Baixo a Moderado,,,,0,Alentejo,ÉVORA,0709,60100.57,5828,336,358,283,331,305,636,919,1277,1613,9.7,2.68,2.12,1.53
04-11-2021,PORTIMÃO,108,8,194,"[120,240]",Moderado,,,,108,Algarve,FARO,0811,18206.29,55483,3182,2927,2116,1582,1400,2982,5098,8025,11207,304.75,61.56,44.08,28.0
04-11-2021,PORTO,314,22,145,"[120,240]",Moderado,,,,314,Norte,PORTO,1312,4142.02,216606,15790,15193,11280,9409,10044,19453,30733,45926,61716,5229.5,1490.0,1108.79,741.98
04-11-2021,PORTO DE MÓS,21,1,90,"[0,120]",Baixo a Moderado,,,,21,Centro,LEIRIA,1016,26183.41,23275,1355,1210,1034,888,872,1760,2794,4004,5359,88.89,20.47,15.29,10.67
04-11-2021,PORTO MONIZ,1,0,43,"[0,120]",Baixo a Moderado,,,,1,Madeira,MADEIRA,3106,8293.38,2342,143,130,95,98,120,218,313,443,586,28.24,7.07,5.34,3.77
04-11-2021,PORTO SANTO,6,0,115,"[0,120]",Baixo a Moderado,,,,6,Madeira,MADEIRA,3201,4300.7,5202,240,157,134,110,68,178,312,469,709,120.95,16.48,10.9,7.25
04-11-2021,PÓVOA DE LANHOSO,5,0,23,"[0,120]",Baixo a Moderado,,,,5,Norte,BRAGA,0309,13465.29,21499,1175,909,732,673,624,1297,2029,2938,4113,159.67,30.55,21.82,15.07
04-11-2021,PÓVOA DE VARZIM,32,2,51,"[0,120]",Baixo a Moderado,,,,32,Norte,PORTO,1313,8220.59,62784,3712,3120,2134,1594,1305,2899,5033,8153,11865,763.7,144.33,99.17,61.22
04-11-2021,POVOAÇÃO,1,0,17,"[0,120]",Baixo a Moderado,,,,1,Açores,AÇORES,4204,10640.77,5927,293,212,191,144,134,278,469,681,974,55.7,9.15,6.4,4.41
04-11-2021,VILA DA PRAIA DA VITÓRIA,11,1,52,"[0,120]",Baixo a Moderado,,,,11,Açores,AÇORES,4302,16127.06,21317,1133,789,619,436,336,772,1391,2180,3313,132.18,20.54,13.52,8.63
04-11-2021,PROENÇA-A-NOVA,11,1,152,"[120,240]",Moderado,,,,11,Centro,CASTELO BRANCO,0508,39539.96,7298,508,465,389,400,560,960,1349,1814,2322,18.46,5.87,4.59,3.41
04-11-2021,REDONDO,40,3,637,"[480,960]",Muito Elevado,,,,40,Alentejo,ÉVORA,0710,36950.87,6353,349,325,288,288,354,642,930,1255,1604,17.19,4.34,3.4,2.52
04-11-2021,REGUENGOS DE MONSARAZ,27,2,272,"[240,480]",Elevado,,,,27,Alentejo,ÉVORA,0711,46399.72,10015,602,511,455,462,473,935,1390,1901,2503,21.58,5.39,4.1,3.0
04-11-2021,RESENDE,4,0,40,"[0,120]",Baixo a Moderado,,,,4,Norte,VISEU,1813,12334.93,10137,560,493,448,433,422,855,1303,1796,2356,82.18,19.1,14.56,10.56
04-11-2021,RIBEIRA BRAVA,4,0,32,"[0,120]",Baixo a Moderado,,,,4,Madeira,MADEIRA,3107,6544.88,12435,648,500,411,311,287,598,1009,1509,2157,189.99,32.96,23.06,15.42
04-11-2021,RIBEIRA DE PENA,3,0,50,"[0,120]",Baixo a Moderado,,,,3,Norte,VILA REAL,1709,21745.98,6016,371,301,290,310,368,678,968,1269,1640,27.66,7.54,5.84,4.45
04-11-2021,RIBEIRA GRANDE,34,2,104,"[0,120]",Baixo a Moderado,,,,34,Açores,AÇORES,4205,18015.13,32811,1163,689,512,345,253,598,1110,1799,2962,182.13,16.44,9.99,6.16
04-11-2021,RIO MAIOR,86,6,424,"[240,480]",Elevado,,,,86,Lisboa e Vale do Tejo,SANTARÉM,1414,27276.45,20379,1251,1144,941,795,648,1443,2384,3528,4779,74.71,17.52,12.93,8.74
04-11-2021,SABROSA,1,0,17,"[0,120]",Baixo a Moderado,,,,1,Norte,VILA REAL,1710,15692.45,5918,393,314,304,302,350,652,956,1270,1663,37.71,10.6,8.09,6.09
04-11-2021,SABUGAL,2,0,19,"[0,120]",Baixo a Moderado,,,,2,Centro,GUARDA,0911,82269.82,10585,724,707,694,796,1009,1805,2499,3206,3930,12.87,4.78,3.9,3.04
04-11-2021,SALVATERRA DE MAGOS,11,1,52,"[0,120]",Baixo a Moderado,,,,11,Lisboa e Vale do Tejo,SANTARÉM,1415,24393.2,21295,1275,1181,1060,799,772,1571,2631,3812,5087,87.3,20.85,15.63,10.79
04-11-2021,SANTA COMBA DÃO,5,0,48,"[0,120]",Baixo a Moderado,,,,5,Centro,VISEU,1814,11194.77,10452,732,684,569,538,464,1002,1571,2255,2987,93.36,26.68,20.14,14.03
04-11-2021,SANTA CRUZ,67,5,149,"[120,240]",Moderado,,,,67,Madeira,MADEIRA,3108,8150.28,45281,1817,1301,974,716,523,1239,2213,3514,5331,555.6,65.41,43.12,27.15
04-11-2021,SANTA CRUZ DA GRACIOSA,0,0,0,"[0,120]",Baixo a Moderado,,,,0,Açores,AÇORES,4401,6065.78,4208,228,180,163,124,145,269,432,612,840,69.37,13.85,10.09,7.12
04-11-2021,SANTA CRUZ DAS FLORES,0,0,0,"[0,120]",Baixo a Moderado,,,,0,Açores,AÇORES,4802,7091.44,2165,125,98,74,56,51,107,181,279,404,30.53,5.7,3.93,2.55
04-11-2021,SANTA MARIA DA FEIRA,96,7,69,"[0,120]",Baixo a Moderado,,,,96,Norte,AVEIRO,0109,21587.65,138636,8182,6743,4771,3856,3079,6935,11706,18449,26631,642.19,123.36,85.46,54.22
04-11-2021,SANTA MARTA DE PENAGUIÃO,11,1,168,"[120,240]",Moderado,,,,11,Norte,VILA REAL,1711,6928.13,6599,483,373,337,316,317,633,970,1343,1826,95.25,26.36,19.39,14.0
04-11-2021,SANTANA,2,0,30,"[0,120]",Baixo a Moderado,,,,2,Madeira,MADEIRA,3109,9547.3,6711,418,353,343,282,277,559,902,1255,1673,70.29,17.52,13.15,9.45
04-11-2021,SANTARÉM,110,8,191,"[120,240]",Moderado,,,,110,Lisboa e Vale do Tejo,SANTARÉM,1416,55253.58,57421,3654,3441,2760,2466,2206,4672,7432,10873,14527,103.92,26.29,19.68,13.45
04-11-2021,SANTIAGO DO CACÉM,18,1,63,"[0,120]",Baixo a Moderado,,,,18,Alentejo,SETÚBAL,1509,105969.29,28791,2144,1689,1472,1295,1215,2510,3982,5671,7815,27.17,7.37,5.35,3.76
04-11-2021,SANTO TIRSO,42,3,62,"[0,120]",Baixo a Moderado,,,,42,Norte,PORTO,1314,13655.52,68055,4911,3935,2761,2257,1810,4067,6828,10763,15674,498.35,114.78,78.82,50.0
04-11-2021,SÃO BRÁS DE ALPORTEL,15,1,145,"[120,240]",Moderado,,,,15,Algarve,FARO,0812,15336.92,10416,596,468,467,404,401,805,1272,1740,2336,67.91,15.23,11.35,8.29
04-11-2021,SÃO JOÃO DA MADEIRA,31,2,141,"[120,240]",Moderado,,,,31,Norte,AVEIRO,0116,794.3,21958,1347,1069,796,601,593,1194,1990,3059,4406,2765.49,554.91,385.26,250.63
04-11-2021,SÃO JOÃO DA PESQUEIRA,4,0,57,"[0,120]",Baixo a Moderado,,,,4,Norte,VISEU,1815,26610.85,7125,417,330,294,328,328,656,950,1280,1697,26.77,6.38,4.81,3.57
04-11-2021,SÃO PEDRO DO SUL,40,3,259,"[240,480]",Elevado,,,,40,Centro,VISEU,1816,34895.09,15403,990,962,861,759,909,1668,2529,3491,4481,44.14,12.84,10.0,7.25
04-11-2021,SÃO ROQUE DO PICO,3,0,92,"[0,120]",Baixo a Moderado,,,,3,Açores,AÇORES,4603,14236.1,3266,199,141,93,96,113,209,302,443,642,22.94,4.51,3.11,2.12
04-11-2021,SÃO VICENTE,4,0,78,"[0,120]",Baixo a Moderado,,,,4,Madeira,MADEIRA,3110,7883.71,5143,272,264,266,225,280,505,771,1035,1307,65.23,16.58,13.13,9.78
04-11-2021,SARDOAL,2,0,54,"[0,120]",Baixo a Moderado,,,,2,Lisboa e Vale do Tejo,SANTARÉM,1417,9214.72,3741,227,178,148,165,248,413,561,739,966,40.6,10.48,8.02,6.09
04-11-2021,SÁTÃO,8,1,69,"[0,120]",Baixo a Moderado,,,,8,Centro,VISEU,1817,20194.11,11580,765,671,515,465,476,941,1456,2127,2892,57.34,14.32,10.53,7.21
04-11-2021,SEIA,66,5,298,"[240,480]",Elevado,,,,66,Centro,GUARDA,0912,43568.83,22234,1807,1589,1238,1122,721,1843,3081,4670,6477,51.03,14.87,10.72,7.07
04-11-2021,SEIXAL,112,8,67,"[0,120]",Baixo a Moderado,,,,112,Lisboa e Vale do Tejo,SETÚBAL,1510,9545.17,167752,10586,9270,6661,4391,2930,7321,13982,23252,33838,1757.49,354.51,243.6,146.49
04-11-2021,SERNANCELHE,3,0,56,"[0,120]",Baixo a Moderado,,,,3,Norte,VISEU,1818,22861.22,5396,305,293,286,273,260,533,819,1112,1417,23.6,6.2,4.86,3.58
04-11-2021,SERPA,22,2,155,"[120,240]",Moderado,,,,22,Alentejo,BEJA,0213,110563.34,14304,903,761,719,697,626,1323,2042,2803,3706,12.94,3.35,2.54,1.85
04-11-2021,SERTÃ,15,1,103,"[0,120]",Baixo a Moderado,,,,15,Centro,CASTELO BRANCO,0509,44673.17,14577,870,779,790,767,1020,1787,2577,3356,4226,32.63,9.46,7.51,5.77
04-11-2021,SESIMBRA,21,1,40,"[0,120]",Baixo a Moderado,,,,21,Lisboa e Vale do Tejo,SETÚBAL,1511,19571.75,51858,2400,2321,1853,1257,1083,2340,4193,6514,8914,264.96,45.54,33.28,21.42
04-11-2021,SETÚBAL,120,9,104,"[0,120]",Baixo a Moderado,,,,120,Lisboa e Vale do Tejo,SETÚBAL,1512,23032.5,115126,7425,6929,5075,3775,2655,6430,11505,18434,25859,499.83,112.27,80.03,49.95
04-11-2021,SEVER DO VOUGA,5,0,44,"[0,120]",Baixo a Moderado,,,,5,Centro,AVEIRO,0117,12987.56,11331,766,637,568,540,567,1107,1675,2312,3078,87.24,23.7,17.8,12.9
04-11-2021,SILVES,27,2,75,"[0,120]",Baixo a Moderado,,,,27,Algarve,FARO,0813,68006.23,36226,2137,1869,1610,1423,1600,3023,4633,6502,8639,53.27,12.7,9.56,6.81
04-11-2021,SINES,6,0,44,"[0,120]",Baixo a Moderado,,,,6,Alentejo,SETÚBAL,1513,20330.17,13715,888,791,551,416,268,684,1235,2026,2914,67.46,14.33,9.97,6.07
04-11-2021,SINTRA,325,23,83,"[0,120]",Baixo a Moderado,,,,325,Lisboa e Vale do Tejo,LISBOA,1111,31922.73,391402,20490,18316,13545,9137,7284,16421,29966,48282,68772,1226.08,215.43,151.25,93.87
04-11-2021,SOBRAL DE MONTE AGRAÇO,4,0,37,"[0,120]",Baixo a Moderado,,,,4,Lisboa e Vale do Tejo,LISBOA,1112,5210.32,10651,564,507,352,272,212,484,836,1343,1907,204.43,36.6,25.78,16.05
04-11-2021,SOURE,26,2,152,"[120,240]",Moderado,,,,26,Centro,COIMBRA,0615,26506.07,17120,1173,1142,1004,883,987,1870,2874,4016,5189,64.59,19.58,15.15,10.84
04-11-2021,SOUSEL,0,0,0,"[0,120]",Baixo a Moderado,,,,0,Alentejo,PORTALEGRE,1215,27932.18,4412,261,274,208,302,292,594,802,1076,1337,15.8,4.79,3.85,2.87
04-11-2021,TÁBUA,4,0,35,"[0,120]",Baixo a Moderado,,,,4,Centro,COIMBRA,0616,19978.58,11368,729,584,524,430,464,894,1418,2002,2731,56.9,13.67,10.02,7.1
04-11-2021,TABUAÇO,0,0,0,"[0,120]",Baixo a Moderado,,,,0,Norte,VISEU,1819,13385.67,6033,372,314,217,282,363,645,862,1176,1548,45.07,11.56,8.79,6.44
04-11-2021,TAROUCA,0,0,0,"[0,120]",Baixo a Moderado,,,,0,Norte,VISEU,1820,10008.49,7804,405,335,313,277,324,601,914,1249,1654,77.98,16.53,12.48,9.13
04-11-2021,TAVIRA,23,2,95,"[0,120]",Baixo a Moderado,,,,23,Algarve,FARO,0814,60696.7,24530,1493,1415,1252,1066,1277,2343,3595,5010,6503,40.41,10.71,8.25,5.92
04-11-2021,TERRAS DE BOURO,5,0,79,"[0,120]",Baixo a Moderado,,,,5,Norte,BRAGA,0310,27746.07,6361,391,372,296,319,340,659,955,1327,1718,22.93,6.19,4.78,3.44
04-11-2021,TOMAR,70,5,190,"[120,240]",Moderado,,,,70,Lisboa e Vale do Tejo,SANTARÉM,1418,35120.44,36748,2403,2189,1868,1853,1822,3675,5543,7732,10135,104.64,28.86,22.02,15.78
04-11-2021,TONDELA,18,1,68,"[0,120]",Baixo a Moderado,,,,18,Centro,VISEU,1821,37121.73,26357,1768,1722,1518,1475,1417,2892,4410,6132,7900,71.0,21.28,16.52,11.88
04-11-2021,TORRE DE MONCORVO,0,0,0,"[0,120]",Baixo a Moderado,,,,0,Norte,BRAGANÇA,0409,53155.67,7695,556,478,488,551,719,1270,1758,2236,2792,14.48,5.25,4.21,3.31
04-11-2021,TORRES NOVAS,55,4,157,"[120,240]",Moderado,,,,55,Lisboa e Vale do Tejo,SANTARÉM,1419,26999.68,34933,2324,1979,1738,1406,1475,2881,4619,6598,8922,129.38,33.04,24.44,17.11
04-11-2021,TORRES VEDRAS,81,6,103,"[0,120]",Baixo a Moderado,,,,81,Lisboa e Vale do Tejo,LISBOA,1113,40714.89,78530,4513,3945,3447,2628,2104,4732,8179,12124,16637,192.88,40.86,29.78,20.09
04-11-2021,TRANCOSO,11,1,124,"[120,240]",Moderado,,,,11,Centro,GUARDA,0913,36152.47,8875,581,557,542,586,496,1082,1624,2181,2762,24.55,7.64,6.03,4.49
04-11-2021,TROFA,22,2,57,"[0,120]",Baixo a Moderado,,,,22,Norte,PORTO,1318,7201.76,38418,2336,1894,1231,939,684,1623,2854,4748,7084,533.44,98.36,65.93,39.63
04-11-2021,VAGOS,23,2,100,"[0,120]",Baixo a Moderado,,,,23,Centro,AVEIRO,0118,16491.5,22740,1320,1205,922,784,724,1508,2430,3635,4955,137.89,30.04,22.04,14.73
04-11-2021,VALE DE CAMBRA,15,1,71,"[0,120]",Baixo a Moderado,,,,15,Norte,AVEIRO,0119,14733.47,21327,1491,1363,1005,831,798,1629,2634,3997,5488,144.76,37.25,27.13,17.88
04-11-2021,VALENÇA,1,0,8,"[0,120]",Baixo a Moderado,,,,1,Norte,VIANA DO CASTELO,1608,11712.86,13290,867,791,582,582,503,1085,1667,2458,3325,113.46,28.39,20.99,14.23
04-11-2021,VALONGO,51,4,52,"[0,120]",Baixo a Moderado,,,,51,Norte,PORTO,1315,7512.45,97444,5629,4696,3207,2462,1829,4291,7498,12194,17823,1297.18,237.26,162.33,99.81
04-11-2021,VALPAÇOS,5,0,34,"[0,120]",Baixo a Moderado,,,,5,Norte,VILA REAL,1712,54873.93,14818,1217,1118,999,928,997,1925,2924,4042,5259,27.0,9.58,7.37,5.33
04-11-2021,VELAS,0,0,0,"[0,120]",Baixo a Moderado,,,,0,Açores,AÇORES,4502,11738.38,5093,278,208,166,153,113,266,432,640,918,43.39,7.82,5.45,3.68
04-11-2021,VENDAS NOVAS,3,0,27,"[0,120]",Baixo a Moderado,,,,3,Alentejo,ÉVORA,0712,22238.88,11255,677,768,655,501,532,1033,1688,2456,3133,50.61,14.09,11.04,7.59
04-11-2021,VIANA DO ALENTEJO,13,1,255,"[240,480]",Elevado,,,,13,Alentejo,ÉVORA,0713,39367.29,5145,245,208,235,210,214,424,659,867,1112,13.07,2.82,2.2,1.67
04-11-2021,VIANA DO CASTELO,105,7,124,"[120,240]",Moderado,,,,105,Norte,VIANA DO CASTELO,1609,31902.01,84417,5470,4433,3591,3061,2982,6043,9634,14067,19537,264.61,61.24,44.09,30.2
04-11-2021,VIDIGUEIRA,3,0,55,"[0,120]",Baixo a Moderado,,,,3,Alentejo,BEJA,0214,31661.09,5510,300,248,215,233,275,508,723,971,1271,17.4,4.01,3.07,2.28
04-11-2021,VIEIRA DO MINHO,21,2,178,"[120,240]",Moderado,,,,21,Norte,BRAGA,0311,21644.35,11842,703,594,525,548,482,1030,1555,2149,2852,54.71,13.18,9.93,7.18
04-11-2021,VILA DE REI,0,0,0,"[0,120]",Baixo a Moderado,,,,0,Centro,CASTELO BRANCO,0510,19154.6,3323,169,128,172,247,302,549,721,849,1018,17.35,5.31,4.43,3.76
04-11-2021,VILA DO BISPO,23,2,447,"[240,480]",Elevado,,,,23,Algarve,FARO,0815,17906.06,5154,302,302,314,232,233,465,779,1081,1383,28.78,7.72,6.04,4.35
04-11-2021,VILA DO CONDE,31,2,39,"[0,120]",Baixo a Moderado,,,,31,Norte,PORTO,1316,14902.77,79899,4726,3875,2819,2070,1743,3813,6632,10507,15233,536.13,102.21,70.5,44.5
04-11-2021,VILA DO PORTO,1,0,18,"[0,120]",Baixo a Moderado,,,,1,Açores,AÇORES,4101,9688.74,5616,274,212,135,96,123,219,354,566,840,57.96,8.67,5.84,3.65
04-11-2021,VILA FLOR,1,0,17,"[0,120]",Baixo a Moderado,,,,1,Norte,BRAGANÇA,0410,26581.14,6044,429,362,422,294,331,625,1047,1409,1838,22.74,6.91,5.3,3.94
04-11-2021,VILA FRANCA DE XIRA,82,6,58,"[0,120]",Baixo a Moderado,,,,82,Lisboa e Vale do Tejo,LISBOA,1114,31819.39,141957,8501,6852,4869,3425,2472,5897,10766,17618,26119,446.14,82.09,55.37,33.84
04-11-2021,VILA FRANCA DO CAMPO,3,0,27,"[0,120]",Baixo a Moderado,,,,3,Açores,AÇORES,4206,7796.82,11051,450,344,248,217,154,371,619,963,1413,141.73,18.12,12.35,7.94
04-11-2021,VILA NOVA DA BARQUINHA,40,3,530,"[480,960]",Muito Elevado,,,,40,Lisboa e Vale do Tejo,SANTARÉM,1420,4952.97,7461,415,406,392,364,338,702,1094,1500,1915,150.64,38.66,30.28,22.09
04-11-2021,VILA NOVA DE CERVEIRA,0,0,0,"[0,120]",Baixo a Moderado,,,,0,Norte,VIANA DO CASTELO,1610,10846.66,8910,531,444,410,384,334,718,1128,1572,2103,82.14,19.39,14.49,10.4
04-11-2021,VILA NOVA DE FAMALICÃO,76,5,58,"[0,120]",Baixo a Moderado,,,,76,Norte,BRAGA,0312,20159.26,131676,7817,6164,4202,3282,2749,6031,10233,16397,24214,653.19,120.12,81.34,50.76
04-11-2021,VILA NOVA DE FOZ CÔA,6,0,93,"[0,120]",Baixo a Moderado,,,,6,Centro,GUARDA,0914,39815.18,6503,442,385,390,398,429,827,1217,1602,2044,16.33,5.13,4.02,3.06
04-11-2021,VILA NOVA DE GAIA,291,21,97,"[0,120]",Baixo a Moderado,,,,291,Norte,PORTO,1317,16846.43,300472,18349,15568,10972,8224,6281,14505,25477,41045,59394,1783.64,352.57,243.65,151.23
04-11-2021,VILA NOVA DE PAIVA,1,0,21,"[0,120]",Baixo a Moderado,,,,1,Centro,VISEU,1822,17553.28,4687,289,272,233,217,241,458,691,963,1252,26.7,7.13,5.49,3.94
04-11-2021,VILA NOVA DE POIARES,5,0,72,"[0,120]",Baixo a Moderado,,,,5,Centro,COIMBRA,0617,8445.3,6939,380,284,262,235,182,417,679,963,1343,82.17,15.9,11.4,8.04
04-11-2021,VILA POUCA DE AGUIAR,3,0,25,"[0,120]",Baixo a Moderado,,,,3,Norte,VILA REAL,1713,43706.62,11961,860,817,733,601,627,1228,1961,2778,3638,27.37,8.32,6.36,4.49
04-11-2021,VILA REAL,36,3,72,"[0,120]",Baixo a Moderado,,,,36,Norte,VILA REAL,1714,37880.28,49962,3025,2498,2065,1579,1466,3045,5110,7608,10633,131.9,28.07,20.08,13.49
04-11-2021,VILA REAL DE SANTO ANTÓNIO,9,1,48,"[0,120]",Baixo a Moderado,,,,9,Algarve,FARO,0816,6125.0,18749,1172,1069,811,569,586,1155,1966,3035,4207,306.11,68.69,49.55,32.1
04-11-2021,VILA VELHA DE RÓDÃO,1,0,32,"[0,120]",Baixo a Moderado,,,,1,Centro,CASTELO BRANCO,0511,32991.16,3144,209,229,180,283,306,589,769,998,1207,9.53,3.66,3.03,2.33
04-11-2021,VILA VERDE,50,4,107,"[0,120]",Baixo a Moderado,,,,50,Norte,BRAGA,0313,22866.52,46911,2365,2063,1667,1494,1437,2931,4598,6661,9026,205.15,39.47,29.13,20.11
04-11-2021,VILA VIÇOSA,1,0,13,"[0,120]",Baixo a Moderado,,,,1,Alentejo,ÉVORA,0714,19485.89,7656,487,379,342,345,324,669,1011,1390,1877,39.29,9.63,7.13,5.19
04-11-2021,VIMIOSO,4,0,101,"[0,120]",Baixo a Moderado,,,,4,Norte,BRAGANÇA,0411,48158.51,4023,274,230,261,293,335,628,889,1119,1393,8.35,2.89,2.32,1.85
04-11-2021,VINHAIS,6,0,79,"[0,120]",Baixo a Moderado,,,,6,Norte,BRAGANÇA,0412,69475.09,7746,599,577,636,641,815,1456,2092,2669,3268,11.15,4.7,3.84,3.01
04-11-2021,VISEU,145,10,149,"[120,240]",Moderado,,,,145,Centro,VISEU,1823,50710.14,97249,5769,5038,4140,3158,2710,5868,10008,15046,20815,191.77,41.05,29.67,19.74
04-11-2021,VIZELA,4,0,17,"[0,120]",Baixo a Moderado,,,,4,Norte,BRAGA,0314,2469.83,23897,1258,928,655,509,371,880,1535,2463,3721,967.49,150.65,99.72,62.15
04-11-2021,VOUZELA,35,3,364,"[240,480]",Elevado,,,,35,Centro,VISEU,1824,19369.46,9619,626,605,554,532,507,1039,1593,2198,2824,49.66,14.58,11.35,8.22
11-11-2021,ABRANTES,38,3,109,"[0,120]",Baixo a Moderado,,,,38,Lisboa e Vale do Tejo,SANTARÉM,1401,71469.08,35130,2473,2213,1730,1748,2021,3769,5499,7712,10185,49.15,14.25,10.79,7.69
11-11-2021,ÁGUEDA,71,5,155,"[120,240]",Moderado,,,,71,Centro,AVEIRO,0101,33527.44,46075,3237,2713,2090,1635,1496,3131,5221,7934,11171,137.43,33.32,23.66,15.57
11-11-2021,AGUIAR DA BEIRA,2,0,43,"[0,120]",Baixo a Moderado,,,,2,Centro,GUARDA,0901,20676.57,4652,304,281,235,239,148,387,622,903,1207,22.5,5.84,4.37,3.01
11-11-2021,ALANDROAL,1,0,20,"[0,120]",Baixo a Moderado,,,,1,Alentejo,ÉVORA,0701,54267.81,4992,307,256,296,299,377,676,972,1228,1535,9.2,2.83,2.26,1.79
11-11-2021,ALBERGARIA-A-VELHA,53,4,218,"[120,240]",Moderado,,,,53,Centro,AVEIRO,0102,15882.5,24144,1550,1298,996,687,680,1367,2363,3661,5211,152.02,32.81,23.05,14.88
11-11-2021,ALBUFEIRA,97,7,234,"[120,240]",Moderado,,,,97,Algarve,FARO,0801,14066.42,41528,2067,1717,1425,985,858,1843,3268,4985,7052,295.24,50.14,35.44,23.23
11-11-2021,ALCÁCER DO SAL,8,1,69,"[0,120]",Baixo a Moderado,,,,8,Alentejo,SETÚBAL,1501,149987.3,11659,884,814,623,623,602,1225,1848,2662,3546,7.77,2.36,1.77,1.23
11-11-2021,ALCANENA,22,2,171,"[120,240]",Moderado,,,,22,Lisboa e Vale do Tejo,SANTARÉM,1402,12732.86,12809,891,744,628,536,588,1124,1752,2496,3387,100.6,26.6,19.6,13.76
11-11-2021,ALCOBAÇA,88,6,164,"[120,240]",Moderado,,,,88,Lisboa e Vale do Tejo,LEIRIA,1001,40814.09,53555,3420,2927,2466,2059,1676,3735,6201,9128,12548,131.22,30.74,22.36,15.19
11-11-2021,ALCOCHETE,38,3,191,"[120,240]",Moderado,,,,38,Lisboa e Vale do Tejo,SETÚBAL,1502,12836.48,19787,857,834,691,476,447,923,1614,2448,3305,154.15,25.75,19.07,12.57
11-11-2021,ALCOUTIM,2,0,96,"[0,120]",Baixo a Moderado,,,,2,Algarve,FARO,0802,57536.33,2159,191,188,163,190,267,457,620,808,999,3.75,1.74,1.4,1.08
11-11-2021,ALENQUER,20,1,45,"[0,120]",Baixo a Moderado,,,,20,Lisboa e Vale do Tejo,LISBOA,1101,30421.92,44052,2298,2062,1629,1330,1155,2485,4114,6176,8474,144.8,27.85,20.3,13.52
11-11-2021,ALFÂNDEGA DA FÉ,4,0,89,"[0,120]",Baixo a Moderado,,,,4,Norte,BRAGANÇA,0401,32194.64,4550,325,277,301,274,325,599,900,1177,1502,14.13,4.67,3.66,2.8
11-11-2021,ALIJÓ,6,0,57,"[0,120]",Baixo a Moderado,,,,6,Norte,VILA REAL,1701,29759.89,10625,766,687,635,542,666,1208,1843,2530,3296,35.7,11.08,8.5,6.19
11-11-2021,ALJEZUR,14,1,250,"[240,480]",Elevado,,,,14,Algarve,FARO,0803,32349.95,5594,316,336,335,320,410,730,1065,1401,1717,17.29,5.31,4.33,3.29
11-11-2021,ALJUSTREL,5,0,61,"[0,120]",Baixo a Moderado,,,,5,Alentejo,BEJA,0201,45847.41,8247,635,521,443,347,358,705,1148,1669,2304,17.99,5.03,3.64,2.5
11-11-2021,ALMADA,213,15,126,"[120,240]",Moderado,,,,213,Lisboa e Vale do Tejo,SETÚBAL,1503,7000.89,169039,10469,9777,7876,6144,5111,11255,19131,28908,39377,2414.5,562.45,412.91,273.26
11-11-2021,ALMEIDA,5,0,86,"[0,120]",Baixo a Moderado,,,,5,Centro,GUARDA,0902,51798.46,5830,441,419,396,458,393,851,1247,1666,2107,11.26,4.07,3.22,2.41
11-11-2021,ALMEIRIM,67,5,299,"[240,480]",Elevado,,,,67,Lisboa e Vale do Tejo,SANTARÉM,1403,22212.05,22546,1342,1353,1106,866,843,1709,2815,4168,5510,101.5,24.81,18.76,12.67
11-11-2021,ALMODÔVAR,16,1,240,"[240,480]",Elevado,,,,16,Alentejo,BEJA,0202,77788.03,6725,414,443,396,373,328,701,1097,1540,1954,8.65,2.51,1.98,1.41
11-11-2021,ALPIARÇA,41,3,587,"[480,960]",Muito Elevado,,,,41,Lisboa e Vale do Tejo,SANTARÉM,1404,9536.33,7059,515,486,363,333,274,607,970,1456,1971,74.02,20.67,15.27,10.17
11-11-2021,ALTER DO CHÃO,0,0,0,"[0,120]",Baixo a Moderado,,,,0,Alentejo,PORTALEGRE,1201,36206.62,3165,201,163,136,208,187,395,531,694,895,8.74,2.47,1.92,1.47
11-11-2021,ALVAIÁZERE,2,0,30,"[0,120]",Baixo a Moderado,,,,2,Centro,LEIRIA,1002,16047.76,6597,419,389,346,406,539,945,1291,1680,2099,41.11,13.08,10.47,8.04
11-11-2021,ALVITO,0,0,0,"[0,120]",Baixo a Moderado,,,,0,Alentejo,BEJA,0203,26485.32,2477,145,110,105,111,89,200,305,415,560,9.35,2.11,1.57,1.15
11-11-2021,AMADORA,133,9,72,"[0,120]",Baixo a Moderado,,,,133,Lisboa e Vale do Tejo,LISBOA,1115,2378.47,184106,11186,10936,8780,6460,5890,12350,21130,32066,43252,7742.05,1818.84,1348.44,888.56
11-11-2021,AMARANTE,62,4,117,"[0,120]",Baixo a Moderado,,,,62,Norte,PORTO,1301,30133.15,53193,3086,2413,1812,1643,1311,2954,4766,7179,10265,176.53,34.07,23.82,15.82
11-11-2021,AMARES,5,0,28,"[0,120]",Baixo a Moderado,,,,5,Norte,BRAGA,0301,8195.41,18129,1001,829,622,489,524,1013,1635,2464,3465,221.22,42.28,30.07,19.95
11-11-2021,ANADIA,62,4,227,"[120,240]",Moderado,,,,62,Centro,AVEIRO,0103,21663.48,27258,1931,1698,1376,1208,1262,2470,3846,5544,7475,125.83,34.51,25.59,17.75
11-11-2021,ANGRA DO HEROÍSMO,13,1,39,"[0,120]",Baixo a Moderado,,,,13,Açores,AÇORES,4301,23899.66,33807,2006,1473,1122,768,635,1403,2525,3998,6004,141.45,25.12,16.73,10.56
11-11-2021,ANSIÃO,15,1,124,"[120,240]",Moderado,,,,15,Centro,LEIRIA,1003,17609.42,12039,727,709,646,694,530,1224,1870,2579,3306,68.37,18.77,14.65,10.62
11-11-2021,ARCOS DE VALDEVEZ,43,3,207,"[120,240]",Moderado,,,,43,Norte,VIANA DO CASTELO,1601,44759.64,20926,1329,1338,1282,1343,1515,2858,4140,5478,6807,46.75,15.21,12.24,9.25
11-11-2021,ARGANIL,4,0,36,"[0,120]",Baixo a Moderado,,,,4,Centro,COIMBRA,0601,33283.93,11014,672,648,612,559,596,1155,1767,2415,3087,33.09,9.27,7.26,5.31
11-11-2021,ARMAMAR,1,0,17,"[0,120]",Baixo a Moderado,,,,1,Norte,VISEU,1801,11723.73,5769,357,305,309,285,310,595,904,1209,1566,49.21,13.36,10.31,7.71
11-11-2021,AROUCA,65,5,315,"[240,480]",Elevado,,,,65,Norte,AVEIRO,0104,32910.52,20720,1306,1047,753,683,683,1366,2119,3166,4472,62.96,13.59,9.62,6.44
11-11-2021,ARRAIOLOS,0,0,0,"[0,120]",Baixo a Moderado,,,,0,Alentejo,ÉVORA,0702,68374.55,6928,435,384,283,367,480,847,1130,1514,1949,10.13,2.85,2.21,1.65
11-11-2021,ARRONCHES,0,0,0,"[0,120]",Baixo a Moderado,,,,0,Alentejo,PORTALEGRE,1202,31464.72,2820,155,142,162,187,179,366,528,670,825,8.96,2.62,2.13,1.68
11-11-2021,ARRUDA DOS VINHOS,5,0,32,"[0,120]",Baixo a Moderado,,,,5,Lisboa e Vale do Tejo,LISBOA,1102,7795.93,15412,738,738,562,509,438,947,1509,2247,2985,197.69,38.29,28.82,19.36
11-11-2021,AVEIRO,224,16,284,"[240,480]",Elevado,,,,224,Centro,AVEIRO,0105,19757.57,78734,4520,4004,3050,2250,2103,4353,7403,11407,15927,398.49,80.61,57.73,37.47
11-11-2021,AVIS,1,0,24,"[0,120]",Baixo a Moderado,,,,1,Alentejo,PORTALEGRE,1203,60596.51,4247,315,225,206,251,273,524,730,955,1270,7.01,2.1,1.58,1.2
11-11-2021,AZAMBUJA,40,3,175,"[120,240]",Moderado,,,,40,Lisboa e Vale do Tejo,LISBOA,1103,26265.65,22716,1322,1171,1070,798,618,1416,2486,3657,4979,86.48,18.96,13.92,9.46
11-11-2021,BAIÃO,11,1,59,"[0,120]",Baixo a Moderado,,,,11,Norte,PORTO,1302,17452.83,18748,1070,862,714,686,725,1411,2125,2987,4057,107.42,23.25,17.11,12.18
11-11-2021,BARCELOS,70,5,60,"[0,120]",Baixo a Moderado,,,,70,Norte,BRAGA,0302,37890.14,116187,6721,5325,3619,2991,2562,5553,9172,14497,21218,306.64,56.0,38.26,24.21
11-11-2021,BARRANCOS,1,0,62,"[0,120]",Baixo a Moderado,,,,1,Alentejo,BEJA,0204,16841.73,1634,90,65,65,94,61,155,220,285,375,9.7,2.23,1.69,1.31
11-11-2021,BARREIRO,129,9,171,"[120,240]",Moderado,,,,129,Lisboa e Vale do Tejo,SETÚBAL,1504,3639.07,75147,5194,5565,4459,3105,1767,4872,9331,14896,20090,2065.05,552.07,409.34,256.42
11-11-2021,BATALHA,25,2,155,"[120,240]",Moderado,,,,25,Centro,LEIRIA,1004,10341.6,15963,873,762,649,529,549,1078,1727,2489,3362,154.35,32.51,24.07,16.7
11-11-2021,BEJA,36,3,108,"[0,120]",Baixo a Moderado,,,,36,Alentejo,BEJA,0205,114647.55,33579,2005,1840,1386,1272,1039,2311,3697,5537,7542,29.29,6.58,4.83,3.22
11-11-2021,BELMONTE,9,1,141,"[120,240]",Moderado,,,,9,Centro,CASTELO BRANCO,0501,11875.91,6398,444,321,325,310,355,665,990,1311,1755,53.87,14.78,11.04,8.34
11-11-2021,BENAVENTE,80,6,260,"[240,480]",Elevado,,,,80,Lisboa e Vale do Tejo,SANTARÉM,1405,52138.39,30602,1468,1376,1141,876,643,1519,2660,4036,5504,58.69,10.56,7.74,5.1
11-11-2021,BOMBARRAL,15,1,118,"[0,120]",Baixo a Moderado,,,,15,Lisboa e Vale do Tejo,LEIRIA,1005,9128.55,12558,875,714,561,491,429,920,1481,2195,3070,137.56,33.63,24.04,16.22
11-11-2021,BORBA,2,0,30,"[0,120]",Baixo a Moderado,,,,2,Alentejo,ÉVORA,0703,14518.65,6736,430,375,279,436,392,828,1107,1482,1912,46.39,13.17,10.21,7.62
11-11-2021,BOTICAS,1,0,20,"[0,120]",Baixo a Moderado,,,,1,Norte,VILA REAL,1702,32195.66,4998,347,306,311,305,380,685,996,1302,1649,15.52,5.12,4.04,3.09
11-11-2021,BRAGA,219,16,120,"[120,240]",Moderado,,,,219,Norte,BRAGA,0303,18339.95,182679,10029,7963,5241,4320,3671,7991,13232,21195,31224,996.07,170.25,115.57,72.15
11-11-2021,BRAGANÇA,109,8,323,"[240,480]",Elevado,,,,109,Norte,BRAGANÇA,0402,117357.27,33607,2402,1855,1652,1393,1163,2556,4208,6063,8465,28.64,7.21,5.17,3.59
11-11-2021,CABECEIRAS DE BASTO,1,0,6,"[0,120]",Baixo a Moderado,,,,1,Norte,BRAGA,0304,24182.16,15628,774,594,544,575,574,1149,1693,2287,3061,64.63,12.66,9.46,7.0
11-11-2021,CADAVAL,20,1,146,"[120,240]",Moderado,,,,20,Lisboa e Vale do Tejo,LISBOA,1104,17489.3,13673,813,796,756,621,625,1246,2002,2798,3611,78.18,20.65,16.0,11.45
11-11-2021,CALDAS DA RAINHA,110,8,212,"[120,240]",Moderado,,,,110,Lisboa e Vale do Tejo,LEIRIA,1006,25569.47,51912,3035,2684,2186,1899,1705,3604,5790,8474,11509,203.03,45.01,33.14,22.64
11-11-2021,CALHETA,9,1,83,"[0,120]",Baixo a Moderado,,,,9,Madeira,MADEIRA,3101,11150.43,10867,576,497,507,399,415,814,1321,1818,2394,97.46,21.47,16.3,11.85
11-11-2021,CALHETA (AÇORES),1,0,32,"[0,120]",Baixo a Moderado,,,,1,Açores,AÇORES,4501,12626.4,3184,215,159,141,139,122,261,402,561,776,25.22,6.15,4.44,3.18
11-11-2021,CÂMARA DE LOBOS,34,2,101,"[0,120]",Baixo a Moderado,,,,34,Madeira,MADEIRA,3102,5216.67,33675,1396,1059,834,545,381,926,1760,2819,4215,645.49,80.79,54.03,33.74
11-11-2021,CAMINHA,17,1,108,"[0,120]",Baixo a Moderado,,,,17,Norte,VIANA DO CASTELO,1602,13652.14,15877,1046,944,818,646,656,1302,2120,3064,4110,116.3,30.11,22.44,15.53
11-11-2021,CAMPO MAIOR,6,0,77,"[0,120]",Baixo a Moderado,,,,6,Alentejo,PORTALEGRE,1204,24720.16,7874,471,364,351,279,327,606,957,1321,1792,31.85,7.25,5.34,3.87
11-11-2021,CANTANHEDE,37,3,105,"[0,120]",Baixo a Moderado,,,,37,Centro,COIMBRA,0602,39088.02,35011,2346,2096,1880,1709,1451,3160,5040,7136,9482,89.57,24.26,18.26,12.89
11-11-2021,CARRAZEDA DE ANSIÃES,10,1,178,"[120,240]",Moderado,,,,10,Norte,BRAGANÇA,0403,27924.09,5666,424,389,391,312,465,777,1168,1557,1981,20.29,7.09,5.58,4.18
11-11-2021,CARREGAL DO SAL,19,1,204,"[120,240]",Moderado,,,,19,Centro,VISEU,1802,11689.21,9271,587,562,486,462,376,838,1324,1886,2473,79.31,21.16,16.13,11.33
11-11-2021,CARTAXO,59,4,248,"[240,480]",Elevado,,,,59,Lisboa e Vale do Tejo,SANTARÉM,1406,15817.28,23843,1415,1376,1142,861,632,1493,2635,4011,5426,150.74,34.3,25.36,16.66
11-11-2021,CASCAIS,367,26,172,"[120,240]",Moderado,,,,367,Lisboa e Vale do Tejo,LISBOA,1105,9740.17,213608,12151,11444,8680,6469,5248,11717,20397,31841,43992,2193.1,451.66,326.91,209.41
11-11-2021,CASTANHEIRA DE PÊRA,8,1,310,"[240,480]",Elevado,,,,8,Centro,LEIRIA,1007,6677.45,2614,233,195,157,190,187,377,534,729,962,39.15,14.41,10.92,8.0
11-11-2021,CASTELO BRANCO,145,10,279,"[240,480]",Elevado,,,,145,Centro,CASTELO BRANCO,0502,143819.15,51987,3528,3042,2499,2229,2225,4454,6953,9995,13523,36.15,9.4,6.95,4.83
11-11-2021,CASTELO DE PAIVA,8,1,52,"[0,120]",Baixo a Moderado,,,,8,Norte,AVEIRO,0106,11500.53,15454,881,697,545,420,431,851,1396,2093,2974,134.37,25.86,18.2,12.14
11-11-2021,CASTELO DE VIDE,1,0,35,"[0,120]",Baixo a Moderado,,,,1,Alentejo,PORTALEGRE,1205,26491.24,2919,204,173,179,147,170,317,496,669,873,11.02,3.3,2.53,1.87
11-11-2021,CASTRO DAIRE,20,1,145,"[120,240]",Moderado,,,,20,Centro,VISEU,1803,37904.13,13823,942,857,765,732,773,1505,2270,3127,4069,36.47,10.74,8.25,5.99
11-11-2021,CASTRO MARIM,6,0,97,"[0,120]",Baixo a Moderado,,,,6,Algarve,FARO,0804,30084.37,6237,370,345,334,322,344,666,1000,1345,1715,20.73,5.7,4.47,3.32
11-11-2021,CASTRO VERDE,13,1,189,"[120,240]",Moderado,,,,13,Alentejo,BEJA,0206,56944.23,6949,437,347,303,275,227,502,805,1152,1589,12.2,2.79,2.02,1.41
11-11-2021,CELORICO DA BEIRA,5,0,72,"[0,120]",Baixo a Moderado,,,,5,Centro,GUARDA,0903,24721.63,6928,430,416,363,369,535,904,1267,1683,2113,28.02,8.55,6.81,5.12
11-11-2021,CELORICO DE BASTO,10,1,53,"[0,120]",Baixo a Moderado,,,,10,Norte,BRAGA,0305,18107.02,19040,1001,802,668,728,729,1457,2125,2927,3928,105.15,21.69,16.17,11.74
11-11-2021,CHAMUSCA,9,1,99,"[0,120]",Baixo a Moderado,,,,9,Lisboa e Vale do Tejo,SANTARÉM,1407,74600.54,9197,629,583,553,465,579,1044,1597,2180,2809,12.33,3.77,2.92,2.14
11-11-2021,CHAVES,13,1,33,"[0,120]",Baixo a Moderado,,,,13,Norte,VILA REAL,1703,59122.95,39343,2676,2429,1991,1886,1918,3804,5795,8224,10900,66.54,18.44,13.91,9.8
11-11-2021,CINFÃES,6,0,33,"[0,120]",Baixo a Moderado,,,,6,Norte,VISEU,1804,23928.76,18244,1067,902,779,734,758,1492,2271,3173,4240,76.24,17.72,13.26,9.49
11-11-2021,COIMBRA,292,21,218,"[120,240]",Moderado,,,,292,Centro,COIMBRA,0603,31939.94,134166,9489,8734,6353,5139,5074,10213,16566,25300,34789,420.06,108.92,79.21,51.87
11-11-2021,CONDEIXA-A-NOVA,34,2,190,"[120,240]",Moderado,,,,34,Centro,COIMBRA,0604,13867.47,17733,871,809,717,583,490,1073,1790,2599,3470,127.88,25.02,18.74,12.91
11-11-2021,CONSTÂNCIA,2,0,49,"[0,120]",Baixo a Moderado,,,,2,Lisboa e Vale do Tejo,SANTARÉM,1408,8036.58,4030,211,183,187,148,155,303,490,673,884,50.14,11.0,8.37,6.1
11-11-2021,CORUCHE,38,3,215,"[120,240]",Moderado,,,,38,Lisboa e Vale do Tejo,SANTARÉM,1409,111572.03,17471,1294,1090,1095,1096,1019,2115,3210,4300,5594,15.66,5.01,3.85,2.88
11-11-2021,CORVO,0,0,0,"[0,120]",Baixo a Moderado,,,,0,Açores,AÇORES,4901,1711.45,464,22,21,11,13,19,32,43,64,86,27.12,5.03,3.74,2.51
11-11-2021,COVILHÃ,192,14,411,"[240,480]",Elevado,,,,192,Centro,CASTELO BRANCO,0503,55560.06,46787,3533,2998,2365,2111,2193,4304,6669,9667,13200,84.21,23.76,17.4,12.0
11-11-2021,CRATO,2,0,65,"[0,120]",Baixo a Moderado,,,,2,Alentejo,PORTALEGRE,1206,39806.88,3129,229,258,163,182,228,410,573,831,1060,7.86,2.66,2.09,1.44
11-11-2021,CUBA,6,0,132,"[120,240]",Moderado,,,,6,Alentejo,BEJA,0207,17208.72,4595,255,233,206,190,143,333,539,772,1027,26.7,5.97,4.49,3.13
11-11-2021,ELVAS,15,1,74,"[0,120]",Baixo a Moderado,,,,15,Alentejo,PORTALEGRE,1207,63128.86,20528,1057,1145,902,852,810,1662,2564,3709,4766,32.52,7.55,5.88,4.06
11-11-2021,ENTRONCAMENTO,72,5,333,"[240,480]",Elevado,,,,72,Lisboa e Vale do Tejo,SANTARÉM,1410,1372.81,21558,1066,930,868,695,592,1287,2155,3085,4151,1570.14,302.33,224.69,156.96
11-11-2021,ESPINHO,26,2,88,"[0,120]",Baixo a Moderado,,,,26,Norte,AVEIRO,0107,2105.68,29516,2205,1993,1430,1177,960,2137,3567,5560,7765,1401.52,368.71,264.01,169.37
11-11-2021,ESPOSENDE,27,2,79,"[0,120]",Baixo a Moderado,,,,27,Norte,BRAGA,0306,9540.98,34177,1831,1522,1095,894,723,1617,2712,4234,6065,358.21,63.57,44.38,28.42
11-11-2021,ESTARREJA,55,4,210,"[120,240]",Moderado,,,,55,Centro,AVEIRO,0108,10817.33,26006,1503,1399,1106,953,728,1681,2787,4186,5689,240.42,52.59,38.7,25.76
11-11-2021,ESTREMOZ,3,0,24,"[0,120]",Baixo a Moderado,,,,3,Alentejo,ÉVORA,0704,51379.95,12728,789,613,697,786,877,1663,2360,2973,3762,24.77,7.32,5.79,4.59
11-11-2021,ÉVORA,28,2,54,"[0,120]",Baixo a Moderado,,,,28,Alentejo,ÉVORA,0705,130707.58,52428,3569,2852,2176,1966,1803,3769,5945,8797,12366,40.11,9.46,6.73,4.55
11-11-2021,FAFE,50,4,103,"[0,120]",Baixo a Moderado,,,,50,Norte,BRAGA,0307,21908.11,48060,3044,2455,1679,1403,1208,2611,4290,6745,9789,219.37,44.68,30.79,19.58
11-11-2021,FARO,130,9,213,"[120,240]",Moderado,,,,130,Algarve,FARO,0805,20256.79,61015,3847,3364,2604,2055,1601,3656,6260,9624,13471,301.2,66.5,47.51,30.9
11-11-2021,FELGUEIRAS,33,2,59,"[0,120]",Baixo a Moderado,,,,33,Norte,PORTO,1303,11573.75,56422,2951,2302,1601,1316,973,2289,3890,6192,9143,487.49,79.0,53.5,33.61
11-11-2021,FERREIRA DO ALENTEJO,6,0,77,"[0,120]",Baixo a Moderado,,,,6,Alentejo,BEJA,0208,64820.68,7845,515,414,372,343,345,688,1060,1474,1989,12.1,3.07,2.27,1.64
11-11-2021,FERREIRA DO ZÊZERE,6,0,75,"[0,120]",Baixo a Moderado,,,,6,Lisboa e Vale do Tejo,SANTARÉM,1411,19038.03,7959,470,370,416,465,456,921,1337,1707,2177,41.81,11.44,8.97,7.02
11-11-2021,FIGUEIRA DA FOZ,122,9,207,"[120,240]",Moderado,,,,122,Centro,COIMBRA,0605,37905.26,58747,4032,3597,2887,2495,2043,4538,7425,11022,15054,154.98,39.72,29.08,19.59
11-11-2021,FIGUEIRA DE CASTELO RODRIGO,6,0,107,"[0,120]",Baixo a Moderado,,,,6,Centro,GUARDA,0904,50857.46,5584,347,352,290,352,391,743,1033,1385,1732,10.98,3.41,2.72,2.03
11-11-2021,FIGUEIRÓ DOS VINHOS,12,1,216,"[120,240]",Moderado,,,,12,Centro,LEIRIA,1008,17344.0,5568,402,386,322,309,351,660,982,1368,1770,32.1,10.21,7.89,5.66
11-11-2021,FORNOS DE ALGODRES,3,0,66,"[0,120]",Baixo a Moderado,,,,3,Centro,GUARDA,0905,13145.05,4528,261,218,247,256,232,488,735,953,1214,34.45,9.24,7.25,5.59
11-11-2021,FREIXO DE ESPADA À CINTA,3,0,93,"[0,120]",Baixo a Moderado,,,,3,Norte,BRAGANÇA,0404,24414.29,3298,211,177,231,196,189,385,616,793,1004,13.51,4.11,3.25,2.52
11-11-2021,FRONTEIRA,0,0,0,"[0,120]",Baixo a Moderado,,,,0,Alentejo,PORTALEGRE,1208,24859.58,2974,213,182,149,156,168,324,473,655,868,11.96,3.49,2.63,1.9
11-11-2021,FUNCHAL,291,21,280,"[240,480]",Elevado,,,,291,Madeira,MADEIRA,3103,7616.2,104024,6382,5086,3643,2821,1990,4811,8454,13540,19922,1365.86,261.58,177.78,111.0
11-11-2021,FUNDÃO,55,4,208,"[120,240]",Moderado,,,,55,Centro,CASTELO BRANCO,0504,70019.79,26495,1781,1464,1432,1357,1643,3000,4432,5896,7677,37.84,10.96,8.42,6.33
11-11-2021,GAVIÃO,0,0,0,"[0,120]",Baixo a Moderado,,,,0,Alentejo,PORTALEGRE,1209,29459.45,3263,189,186,222,263,293,556,778,964,1153,11.08,3.91,3.27,2.64
11-11-2021,GÓIS,8,1,212,"[120,240]",Moderado,,,,8,Centro,COIMBRA,0606,26330.19,3805,235,199,240,233,244,477,717,916,1151,14.45,4.37,3.48,2.72
11-11-2021,GOLEGÃ,47,3,889,"[480,960]",Muito Elevado,,,,47,Lisboa e Vale do Tejo,SANTARÉM,1412,8431.67,5339,356,299,281,243,255,498,779,1078,1434,63.32,17.01,12.78,9.24
11-11-2021,GONDOMAR,138,10,83,"[0,120]",Baixo a Moderado,,,,138,Norte,PORTO,1304,13191.76,165985,10555,8755,6222,4450,3364,7814,14036,22791,33346,1258.22,252.77,172.76,106.4
11-11-2021,GOUVEIA,30,2,243,"[240,480]",Elevado,,,,30,Centro,GUARDA,0906,30061.17,12387,871,931,780,783,810,1593,2373,3304,4175,41.21,13.89,10.99,7.89
11-11-2021,GRÂNDOLA,2,0,14,"[0,120]",Baixo a Moderado,,,,2,Alentejo,SETÚBAL,1505,82593.66,14639,834,834,708,688,672,1360,2068,2902,3736,17.72,4.52,3.51,2.5
11-11-2021,GUARDA,88,6,226,"[120,240]",Moderado,,,,88,Centro,GUARDA,0907,71209.58,38969,2477,2041,1686,1415,1474,2889,4575,6616,9093,54.72,12.77,9.29,6.42
11-11-2021,GUIMARÃES,76,5,50,"[0,120]",Baixo a Moderado,,,,76,Norte,BRAGA,0308,24099.96,152309,9394,7074,4809,3877,2948,6825,11634,18708,28102,631.99,116.61,77.63,48.27
11-11-2021,HORTA,10,1,69,"[0,120]",Baixo a Moderado,,,,10,Açores,AÇORES,4701,17305.53,14521,818,658,468,352,302,654,1122,1780,2598,83.91,15.01,10.29,6.48
11-11-2021,IDANHA-A-NOVA,25,2,315,"[240,480]",Elevado,,,,25,Centro,CASTELO BRANCO,0505,141633.51,8043,518,490,519,672,974,1646,2165,2655,3173,5.68,2.24,1.87,1.53
11-11-2021,ÍLHAVO,65,5,169,"[120,240]",Moderado,,,,65,Centro,AVEIRO,0110,7347.55,38699,2227,1943,1444,1193,850,2043,3487,5430,7657,526.66,104.21,73.9,47.46
11-11-2021,LAGOA (FARO),50,4,220,"[120,240]",Moderado,,,,50,Algarve,FARO,0806,8825.45,22762,1314,1168,919,749,670,1419,2338,3506,4820,257.93,54.62,39.73,26.49
11-11-2021,LAGOA,25,2,169,"[120,240]",Moderado,,,,25,Açores,AÇORES,4201,4559.32,14721,536,458,349,238,235,473,822,1280,1816,322.9,39.83,28.08,18.03
11-11-2021,LAGOS,88,6,291,"[240,480]",Elevado,,,,88,Algarve,FARO,0807,21299.27,30374,1744,1434,1247,1053,1029,2082,3329,4763,6507,142.61,30.55,22.36,15.63
11-11-2021,LAJES DAS FLORES,1,0,68,"[0,120]",Baixo a Moderado,,,,1,Açores,AÇORES,4801,7004.79,1463,88,53,62,46,54,100,162,215,303,20.89,4.33,3.07,2.31
11-11-2021,LAJES DO PICO,0,0,0,"[0,120]",Baixo a Moderado,,,,0,Açores,AÇORES,4601,15531.09,4490,304,231,223,159,162,321,544,775,1079,28.91,6.95,4.99,3.5
11-11-2021,LAMEGO,16,1,65,"[0,120]",Baixo a Moderado,,,,16,Norte,VISEU,1805,16542.11,24895,1639,1284,1124,898,783,1681,2805,4089,5728,150.5,34.63,24.72,16.96
11-11-2021,LEIRIA,258,18,206,"[120,240]",Moderado,,,,258,Centro,LEIRIA,1009,56508.83,125267,7389,6366,5090,3902,3159,7061,12151,18517,25906,221.68,45.84,32.77,21.5
11-11-2021,LISBOA,851,61,167,"[120,240]",Moderado,,,,851,Lisboa e Vale do Tejo,LISBOA,1106,10005.43,509515,33197,33340,27706,23037,26770,49807,77513,110853,144050,5092.6,1439.78,1107.98,774.74
11-11-2021,LOULÉ,230,16,335,"[240,480]",Elevado,,,,230,Algarve,FARO,0808,76366.91,68697,3890,3350,2780,2358,2251,4609,7389,10739,14629,89.96,19.16,14.06,9.68
11-11-2021,LOURES,169,12,79,"[0,120]",Baixo a Moderado,,,,169,Lisboa e Vale do Tejo,LISBOA,1107,16723.99,213687,12746,12794,9644,6669,5033,11702,21346,34140,46886,1277.73,280.35,204.14,127.64
11-11-2021,LOURINHÃ,58,4,225,"[120,240]",Moderado,,,,58,Lisboa e Vale do Tejo,LISBOA,1108,14717.2,25855,1584,1243,992,842,645,1487,2479,3722,5306,175.68,36.05,25.29,16.84
11-11-2021,LOUSÃ,39,3,226,"[120,240]",Moderado,,,,39,Centro,COIMBRA,0607,13840.01,17158,946,866,658,528,450,978,1636,2502,3448,123.97,24.91,18.08,11.82
11-11-2021,LOUSADA,22,2,47,"[0,120]",Baixo a Moderado,,,,22,Norte,PORTO,1305,9608.01,46755,2289,1698,1176,853,621,1474,2650,4348,6637,486.63,69.08,45.25,27.58
11-11-2021,MAÇÃO,4,0,65,"[0,120]",Baixo a Moderado,,,,4,Lisboa e Vale do Tejo,SANTARÉM,1413,39997.98,6267,386,362,390,440,657,1097,1487,1849,2235,15.67,5.59,4.62,3.72
11-11-2021,MACEDO DE CAVALEIROS,18,1,125,"[120,240]",Moderado,,,,18,Norte,BRAGANÇA,0405,69914.08,14516,1082,889,878,823,938,1761,2639,3528,4610,20.76,6.59,5.05,3.77
11-11-2021,MACHICO,21,2,106,"[0,120]",Baixo a Moderado,,,,21,Madeira,MADEIRA,3104,6825.1,19981,1197,860,662,455,331,786,1448,2308,3505,292.76,51.36,33.82,21.22
11-11-2021,MADALENA,1,0,17,"[0,120]",Baixo a Moderado,,,,1,Açores,AÇORES,4602,14712.33,5895,334,256,173,190,179,369,542,798,1132,40.07,7.69,5.42,3.68
11-11-2021,MAFRA,70,5,82,"[0,120]",Baixo a Moderado,,,,70,Lisboa e Vale do Tejo,LISBOA,1109,29165.5,84816,3613,3334,2839,2089,1899,3988,6827,10161,13774,290.81,47.23,34.84,23.41
11-11-2021,MAIA,160,11,115,"[0,120]",Baixo a Moderado,,,,160,Norte,PORTO,1306,8293.94,138971,7801,6617,4512,3339,2631,5970,10482,17099,24900,1675.56,300.22,206.16,126.38
11-11-2021,MANGUALDE,74,5,399,"[240,480]",Elevado,,,,74,Centro,VISEU,1806,21925.56,18510,1198,1128,885,852,743,1595,2480,3608,4806,84.42,21.92,16.46,11.31
11-11-2021,MANTEIGAS,0,0,0,"[0,120]",Baixo a Moderado,,,,0,Centro,GUARDA,0908,12197.55,3007,258,197,159,167,146,313,472,669,927,24.65,7.6,5.48,3.87
11-11-2021,MARCO DE CANAVESES,66,5,129,"[120,240]",Moderado,,,,66,Norte,PORTO,1307,20188.98,51496,2678,2060,1488,1265,1023,2288,3776,5836,8514,255.07,42.17,28.91,18.7
11-11-2021,MARINHA GRANDE,69,5,180,"[120,240]",Moderado,,,,69,Centro,LEIRIA,1010,18725.19,38508,2365,2302,1638,1359,1058,2417,4055,6357,8722,205.65,46.58,33.95,21.66
11-11-2021,MARVÃO,53,4,1770,"[960,Max]",Extremamente Elevado,,,,53,Alentejo,PORTALEGRE,1210,15489.9,3005,198,185,142,197,237,434,576,761,959,19.4,6.19,4.91,3.72
11-11-2021,MATOSINHOS,140,10,80,"[0,120]",Baixo a Moderado,,,,140,Norte,PORTO,1308,6241.97,175357,11850,9977,7023,5024,3884,8908,15931,25908,37758,2809.31,604.9,415.06,255.22
11-11-2021,MEALHADA,35,2,175,"[120,240]",Moderado,,,,35,Centro,AVEIRO,0111,11065.66,19914,1163,1039,810,828,831,1659,2469,3508,4671,179.96,42.21,31.7,22.31
11-11-2021,MÊDA,18,1,393,"[240,480]",Elevado,,,,18,Centro,GUARDA,0909,28604.92,4587,343,306,290,288,443,731,1021,1327,1670,16.04,5.84,4.64,3.57
11-11-2021,MELGAÇO,0,0,0,"[0,120]",Baixo a Moderado,,,,0,Norte,VIANA DO CASTELO,1603,23824.58,8093,507,567,578,614,675,1289,1867,2434,2941,33.97,12.34,10.22,7.84
11-11-2021,MÉRTOLA,2,0,33,"[0,120]",Baixo a Moderado,,,,2,Alentejo,BEJA,0209,129287.34,6142,400,390,378,423,600,1023,1401,1791,2191,4.75,1.69,1.39,1.08
11-11-2021,MESÃO FRIO,1,0,25,"[0,120]",Baixo a Moderado,,,,1,Norte,VILA REAL,1704,2664.87,3964,265,205,168,157,120,277,445,650,915,148.74,34.33,24.39,16.7
11-11-2021,MIRA,48,3,404,"[240,480]",Elevado,,,,48,Centro,COIMBRA,0608,12403.38,11832,727,729,659,550,466,1016,1675,2404,3131,95.4,25.24,19.38,13.5
11-11-2021,MIRANDA DO CORVO,75,5,590,"[480,960]",Muito Elevado,,,,75,Centro,COIMBRA,0609,12637.79,12708,706,659,568,498,404,902,1470,2129,2835,100.55,22.43,16.85,11.63
11-11-2021,MIRANDA DO DOURO,7,1,104,"[0,120]",Baixo a Moderado,,,,7,Norte,BRAGANÇA,0406,48718.31,6830,482,429,442,463,470,933,1375,1804,2286,14.02,4.69,3.7,2.82
11-11-2021,MIRANDELA,39,3,181,"[120,240]",Moderado,,,,39,Norte,BRAGANÇA,0407,65895.67,21754,1640,1315,1204,1078,947,2025,3229,4544,6184,33.01,9.38,6.9,4.9
11-11-2021,MOGADOURO,16,1,193,"[120,240]",Moderado,,,,16,Norte,BRAGANÇA,0408,76064.93,8392,589,529,576,630,655,1285,1861,2390,2979,11.03,3.92,3.14,2.45
11-11-2021,MOIMENTA DA BEIRA,15,1,154,"[120,240]",Moderado,,,,15,Norte,VISEU,1807,21996.9,9736,576,514,471,416,461,877,1348,1862,2438,44.26,11.08,8.46,6.13
11-11-2021,MOITA,81,6,125,"[120,240]",Moderado,,,,81,Lisboa e Vale do Tejo,SETÚBAL,1506,5525.98,64407,4226,3646,2623,1801,1425,3226,5849,9495,13721,1165.53,248.3,171.82,105.85
11-11-2021,MONÇÃO,9,1,51,"[0,120]",Baixo a Moderado,,,,9,Norte,VIANA DO CASTELO,1604,21130.85,17869,1161,1105,1031,1006,972,1978,3009,4114,5275,84.56,24.96,19.47,14.24
11-11-2021,MONCHIQUE,5,0,100,"[0,120]",Baixo a Moderado,,,,5,Algarve,FARO,0809,39530.43,5077,353,384,321,355,392,747,1068,1452,1805,12.84,4.57,3.67,2.7
11-11-2021,MONDIM DE BASTO,0,0,0,"[0,120]",Baixo a Moderado,,,,0,Norte,VILA REAL,1705,17207.52,6946,395,300,314,284,283,567,881,1181,1576,40.36,9.16,6.86,5.12
11-11-2021,MONFORTE,1,0,34,"[0,120]",Baixo a Moderado,,,,1,Alentejo,PORTALEGRE,1211,42024.82,2975,139,115,117,192,168,360,477,592,731,7.08,1.74,1.41,1.14
11-11-2021,MONTALEGRE,9,1,101,"[0,120]",Baixo a Moderado,,,,9,Norte,VILA REAL,1706,80545.71,8997,699,628,595,603,730,1333,1928,2556,3255,11.17,4.04,3.17,2.39
11-11-2021,MONTEMOR-O-NOVO,7,1,45,"[0,120]",Baixo a Moderado,,,,7,Alentejo,ÉVORA,0706,123296.65,15647,991,953,868,878,971,1849,2717,3670,4661,12.69,3.78,2.98,2.2
11-11-2021,MONTEMOR-O-VELHO,65,5,257,"[240,480]",Elevado,,,,65,Centro,COIMBRA,0610,22896.23,25224,1496,1397,1217,1057,988,2045,3262,4659,6155,110.17,26.88,20.35,14.25
11-11-2021,MONTIJO,56,4,98,"[0,120]",Baixo a Moderado,,,,56,Lisboa e Vale do Tejo,SETÚBAL,1507,34861.64,57614,2771,2441,1990,1554,1109,2663,4653,7094,9865,165.26,28.3,20.35,13.35
11-11-2021,MORA,10,1,248,"[240,480]",Elevado,,,,10,Alentejo,ÉVORA,0707,44395.02,4138,336,275,252,238,257,495,747,1022,1358,9.32,3.06,2.3,1.68
11-11-2021,MORTÁGUA,7,0,79,"[0,120]",Baixo a Moderado,,,,7,Centro,VISEU,1808,25117.82,8803,638,584,535,499,460,959,1494,2078,2716,35.05,10.81,8.27,5.95
11-11-2021,MOURA,57,4,412,"[240,480]",Elevado,,,,57,Alentejo,BEJA,0210,95845.55,13718,817,656,665,542,461,1003,1668,2324,3141,14.31,3.28,2.42,1.74
11-11-2021,MOURÃO,0,0,0,"[0,120]",Baixo a Moderado,,,,0,Alentejo,ÉVORA,0708,27862.98,2450,139,108,80,104,109,213,293,401,540,8.79,1.94,1.44,1.05
11-11-2021,MURÇA,16,1,296,"[240,480]",Elevado,,,,16,Norte,VILA REAL,1707,18937.11,5463,384,341,307,306,319,625,932,1273,1657,28.85,8.75,6.72,4.92
11-11-2021,MURTOSA,8,1,77,"[0,120]",Baixo a Moderado,,,,8,Centro,AVEIRO,0112,7308.78,10279,509,473,403,353,409,762,1165,1638,2147,140.63,29.37,22.41,15.94
11-11-2021,NAZARÉ,66,5,463,"[240,480]",Elevado,,,,66,Lisboa e Vale do Tejo,LEIRIA,1011,8243.43,14165,967,903,670,420,396,816,1486,2389,3356,171.84,40.71,28.98,18.03
11-11-2021,NELAS,21,2,162,"[120,240]",Moderado,,,,21,Centro,VISEU,1809,12571.48,12974,924,787,668,604,583,1187,1855,2642,3566,103.21,28.37,21.02,14.76
11-11-2021,NISA,2,0,34,"[0,120]",Baixo a Moderado,,,,2,Alentejo,PORTALEGRE,1212,57567.84,6061,405,389,355,483,478,961,1316,1705,2110,10.53,3.67,2.96,2.29
11-11-2021,NORDESTE,1,0,21,"[0,120]",Baixo a Moderado,,,,1,Açores,AÇORES,4202,10146.8,4862,246,180,124,161,162,323,447,627,873,47.92,8.6,6.18,4.41
11-11-2021,ÓBIDOS,13,1,108,"[0,120]",Baixo a Moderado,,,,13,Lisboa e Vale do Tejo,LEIRIA,1012,14155.44,11850,743,650,574,452,436,888,1462,2112,2855,83.72,20.17,14.92,10.33
11-11-2021,ODEMIRA,39,3,158,"[120,240]",Moderado,,,,39,Alentejo,BEJA,0211,172060.15,24717,1475,1317,1225,1397,1349,2746,3971,5288,6763,14.37,3.93,3.07,2.31
11-11-2021,ODIVELAS,110,8,68,"[0,120]",Baixo a Moderado,,,,110,Lisboa e Vale do Tejo,LISBOA,1116,2654.36,161774,9562,9038,6952,4641,3812,8453,15405,24443,34005,6095.48,1281.27,920.99,580.44
11-11-2021,OEIRAS,193,14,109,"[0,120]",Baixo a Moderado,,,,193,Lisboa e Vale do Tejo,LISBOA,1110,4588.31,177408,11580,11575,8566,6211,5855,12066,20632,32207,43787,3866.78,954.38,701.98,449.69
11-11-2021,OLEIROS,11,1,220,"[120,240]",Moderado,,,,11,Centro,CASTELO BRANCO,0506,47109.31,5003,384,341,366,397,487,884,1250,1591,1975,10.62,4.19,3.38,2.65
11-11-2021,OLHÃO,62,4,140,"[120,240]",Moderado,,,,62,Algarve,FARO,0810,13086.38,44405,2455,2309,1689,1342,1268,2610,4299,6608,9063,339.33,69.26,50.5,32.85
11-11-2021,OLIVEIRA DE AZEMÉIS,81,6,123,"[120,240]",Moderado,,,,81,Norte,AVEIRO,0113,16110.41,66011,4155,3614,2794,2183,1738,3921,6715,10329,14484,409.75,89.91,64.12,41.68
11-11-2021,OLIVEIRA DE FRADES,4,0,40,"[0,120]",Baixo a Moderado,,,,4,Centro,VISEU,1810,14534.62,9936,553,475,438,359,415,774,1212,1687,2240,68.36,15.41,11.61,8.34
11-11-2021,OLIVEIRA DO BAIRRO,25,2,105,"[0,120]",Baixo a Moderado,,,,25,Centro,AVEIRO,0114,8731.99,24277,1327,1182,999,786,810,1596,2595,3777,5104,278.02,58.45,43.25,29.72
11-11-2021,OLIVEIRA DO HOSPITAL,9,1,47,"[0,120]",Baixo a Moderado,,,,9,Centro,COIMBRA,0611,23451.66,19253,1161,1097,962,924,960,1884,2846,3943,5104,82.1,21.76,16.81,12.14
11-11-2021,OURÉM,136,10,309,"[240,480]",Elevado,,,,136,Lisboa e Vale do Tejo,SANTARÉM,1421,41668.03,44044,2463,2069,1899,1817,1603,3420,5319,7388,9851,105.7,23.64,17.73,12.77
11-11-2021,OURIQUE,3,0,66,"[0,120]",Baixo a Moderado,,,,3,Alentejo,BEJA,0212,66331.36,4607,313,287,284,268,227,495,779,1066,1379,6.95,2.08,1.61,1.17
11-11-2021,OVAR,95,7,176,"[120,240]",Moderado,,,,95,Centro,AVEIRO,0115,14770.25,54260,3294,2709,1994,1636,1234,2870,4864,7573,10867,367.37,73.57,51.27,32.93
11-11-2021,PAÇOS DE FERREIRA,31,2,55,"[0,120]",Baixo a Moderado,,,,31,Norte,PORTO,1309,7099.29,56728,2903,2193,1518,1135,664,1799,3317,5510,8413,799.1,118.51,77.62,46.72
11-11-2021,PALMELA,82,6,128,"[120,240]",Moderado,,,,82,Lisboa e Vale do Tejo,SETÚBAL,1508,46512.01,64269,3402,3244,2635,1846,1391,3237,5872,9116,12518,138.18,26.91,19.6,12.62
11-11-2021,PAMPILHOSA DA SERRA,65,5,1612,"[960,Max]",Extremamente Elevado,,,,65,Centro,COIMBRA,0612,39646.24,4037,238,254,295,339,423,762,1057,1311,1549,10.18,3.91,3.31,2.67
11-11-2021,PAREDES,36,3,42,"[0,120]",Baixo a Moderado,,,,36,Norte,PORTO,1310,15675.69,86067,4272,3532,2412,1717,1258,2975,5387,8919,13191,549.04,84.15,56.9,34.36
11-11-2021,PAREDES DE COURA,1,0,12,"[0,120]",Baixo a Moderado,,,,1,Norte,VIANA DO CASTELO,1605,13818.59,8535,466,528,407,465,515,980,1387,1915,2381,61.76,17.23,13.86,10.04
11-11-2021,PEDRÓGÃO GRANDE,6,0,176,"[120,240]",Moderado,,,,6,Centro,LEIRIA,1013,12874.75,3410,175,173,196,221,252,473,669,842,1017,26.49,7.9,6.54,5.2
11-11-2021,PENACOVA,13,1,95,"[0,120]",Baixo a Moderado,,,,13,Centro,COIMBRA,0613,21673.23,13694,968,923,745,621,703,1324,2069,2992,3960,63.18,18.27,13.81,9.55
11-11-2021,PENAFIEL,24,2,35,"[0,120]",Baixo a Moderado,,,,24,Norte,PORTO,1311,21224.27,69772,3648,2823,2032,1663,1230,2893,4925,7748,11396,328.74,53.69,36.51,23.2
11-11-2021,PENALVA DO CASTELO,12,1,168,"[120,240]",Moderado,,,,12,Centro,VISEU,1811,13433.92,7115,449,457,413,391,426,817,1230,1687,2136,52.96,15.9,12.56,9.16
11-11-2021,PENAMACOR,23,2,487,"[480,960]",Muito Elevado,,,,23,Centro,CASTELO BRANCO,0507,56370.69,4755,262,248,273,451,633,1084,1357,1605,1867,8.44,3.31,2.85,2.41
11-11-2021,PENEDONO,7,1,272,"[240,480]",Elevado,,,,7,Norte,VISEU,1812,13370.75,2591,172,113,129,156,138,294,423,536,708,19.38,5.3,4.01,3.16
11-11-2021,PENELA,4,0,74,"[0,120]",Baixo a Moderado,,,,4,Centro,COIMBRA,0614,13480.0,5397,314,324,274,359,344,703,977,1301,1615,40.04,11.98,9.65,7.25
11-11-2021,PENICHE,67,5,251,"[240,480]",Elevado,,,,67,Lisboa e Vale do Tejo,LEIRIA,1014,7754.98,26501,1746,1504,1203,926,707,1633,2836,4340,6086,341.73,78.48,55.96,36.57
11-11-2021,PESO DA RÉGUA,12,1,76,"[0,120]",Baixo a Moderado,,,,12,Norte,VILA REAL,1708,9486.01,15773,1076,843,650,659,455,1114,1764,2607,3683,166.28,38.83,27.48,18.6
11-11-2021,PINHEL,3,0,36,"[0,120]",Baixo a Moderado,,,,3,Centro,GUARDA,0910,48452.12,8511,577,566,551,538,689,1227,1778,2344,2921,17.57,6.03,4.84,3.67
11-11-2021,POMBAL,57,4,110,"[0,120]",Baixo a Moderado,,,,57,Centro,LEIRIA,1015,62600.28,51461,3187,2791,2494,2328,2027,4355,6849,9640,12827,82.21,20.49,15.4,10.94
11-11-2021,PONTA DELGADA,127,9,187,"[120,240]",Moderado,,,,127,Açores,AÇORES,4203,23298.65,67935,3108,2435,1726,1133,902,2035,3761,6196,9304,291.58,39.93,26.59,16.14
11-11-2021,PONTA DO SOL,13,1,152,"[120,240]",Moderado,,,,13,Madeira,MADEIRA,3105,4622.03,8593,319,283,347,208,221,429,776,1059,1378,185.92,29.81,22.91,16.79
11-11-2021,PONTE DA BARCA,27,2,243,"[240,480]",Elevado,,,,27,Norte,VIANA DO CASTELO,1606,18211.37,11180,635,576,517,554,490,1044,1561,2137,2772,61.39,15.22,11.73,8.57
11-11-2021,PONTE DE LIMA,59,4,144,"[120,240]",Moderado,,,,59,Norte,VIANA DO CASTELO,1607,32025.46,41315,2321,2022,1720,1596,1462,3058,4778,6800,9121,129.01,28.48,21.23,14.92
11-11-2021,PONTE DE SOR,4,0,27,"[0,120]",Baixo a Moderado,,,,4,Alentejo,PORTALEGRE,1213,83971.16,14994,939,800,716,739,831,1570,2286,3086,4025,17.86,4.79,3.68,2.72
11-11-2021,PORTALEGRE,23,2,105,"[0,120]",Baixo a Moderado,,,,23,Alentejo,PORTALEGRE,1214,44713.64,22172,1577,1351,1137,993,984,1977,3114,4465,6042,49.59,13.51,9.99,6.96
11-11-2021,PORTEL,0,0,0,"[0,120]",Baixo a Moderado,,,,0,Alentejo,ÉVORA,0709,60100.57,5828,336,358,283,331,305,636,919,1277,1613,9.7,2.68,2.12,1.53
11-11-2021,PORTIMÃO,169,12,304,"[240,480]",Elevado,,,,169,Algarve,FARO,0811,18206.29,55483,3182,2927,2116,1582,1400,2982,5098,8025,11207,304.75,61.56,44.08,28.0
11-11-2021,PORTO,329,24,152,"[120,240]",Moderado,,,,329,Norte,PORTO,1312,4142.02,216606,15790,15193,11280,9409,10044,19453,30733,45926,61716,5229.5,1490.0,1108.79,741.98
11-11-2021,PORTO DE MÓS,34,2,146,"[120,240]",Moderado,,,,34,Centro,LEIRIA,1016,26183.41,23275,1355,1210,1034,888,872,1760,2794,4004,5359,88.89,20.47,15.29,10.67
11-11-2021,PORTO MONIZ,5,0,216,"[120,240]",Moderado,,,,5,Madeira,MADEIRA,3106,8293.38,2342,143,130,95,98,120,218,313,443,586,28.24,7.07,5.34,3.77
11-11-2021,PORTO SANTO,9,1,173,"[120,240]",Moderado,,,,9,Madeira,MADEIRA,3201,4300.7,5202,240,157,134,110,68,178,312,469,709,120.95,16.48,10.9,7.25
11-11-2021,PÓVOA DE LANHOSO,6,0,28,"[0,120]",Baixo a Moderado,,,,6,Norte,BRAGA,0309,13465.29,21499,1175,909,732,673,624,1297,2029,2938,4113,159.67,30.55,21.82,15.07
11-11-2021,PÓVOA DE VARZIM,57,4,91,"[0,120]",Baixo a Moderado,,,,57,Norte,PORTO,1313,8220.59,62784,3712,3120,2134,1594,1305,2899,5033,8153,11865,763.7,144.33,99.17,61.22
11-11-2021,POVOAÇÃO,2,0,34,"[0,120]",Baixo a Moderado,,,,2,Açores,AÇORES,4204,10640.77,5927,293,212,191,144,134,278,469,681,974,55.7,9.15,6.4,4.41
11-11-2021,VILA DA PRAIA DA VITÓRIA,9,1,42,"[0,120]",Baixo a Moderado,,,,9,Açores,AÇORES,4302,16127.06,21317,1133,789,619,436,336,772,1391,2180,3313,132.18,20.54,13.52,8.63
11-11-2021,PROENÇA-A-NOVA,9,1,124,"[120,240]",Moderado,,,,9,Centro,CASTELO BRANCO,0508,39539.96,7298,508,465,389,400,560,960,1349,1814,2322,18.46,5.87,4.59,3.41
11-11-2021,REDONDO,40,3,637,"[480,960]",Muito Elevado,,,,40,Alentejo,ÉVORA,0710,36950.87,6353,349,325,288,288,354,642,930,1255,1604,17.19,4.34,3.4,2.52
11-11-2021,REGUENGOS DE MONSARAZ,7,1,71,"[0,120]",Baixo a Moderado,,,,7,Alentejo,ÉVORA,0711,46399.72,10015,602,511,455,462,473,935,1390,1901,2503,21.58,5.39,4.1,3.0
11-11-2021,RESENDE,10,1,100,"[0,120]",Baixo a Moderado,,,,10,Norte,VISEU,1813,12334.93,10137,560,493,448,433,422,855,1303,1796,2356,82.18,19.1,14.56,10.56
11-11-2021,RIBEIRA BRAVA,12,1,97,"[0,120]",Baixo a Moderado,,,,12,Madeira,MADEIRA,3107,6544.88,12435,648,500,411,311,287,598,1009,1509,2157,189.99,32.96,23.06,15.42
11-11-2021,RIBEIRA DE PENA,6,0,100,"[0,120]",Baixo a Moderado,,,,6,Norte,VILA REAL,1709,21745.98,6016,371,301,290,310,368,678,968,1269,1640,27.66,7.54,5.84,4.45
11-11-2021,RIBEIRA GRANDE,30,2,91,"[0,120]",Baixo a Moderado,,,,30,Açores,AÇORES,4205,18015.13,32811,1163,689,512,345,253,598,1110,1799,2962,182.13,16.44,9.99,6.16
11-11-2021,RIO MAIOR,61,4,301,"[240,480]",Elevado,,,,61,Lisboa e Vale do Tejo,SANTARÉM,1414,27276.45,20379,1251,1144,941,795,648,1443,2384,3528,4779,74.71,17.52,12.93,8.74
11-11-2021,SABROSA,1,0,17,"[0,120]",Baixo a Moderado,,,,1,Norte,VILA REAL,1710,15692.45,5918,393,314,304,302,350,652,956,1270,1663,37.71,10.6,8.09,6.09
11-11-2021,SABUGAL,3,0,29,"[0,120]",Baixo a Moderado,,,,3,Centro,GUARDA,0911,82269.82,10585,724,707,694,796,1009,1805,2499,3206,3930,12.87,4.78,3.9,3.04
11-11-2021,SALVATERRA DE MAGOS,25,2,118,"[0,120]",Baixo a Moderado,,,,25,Lisboa e Vale do Tejo,SANTARÉM,1415,24393.2,21295,1275,1181,1060,799,772,1571,2631,3812,5087,87.3,20.85,15.63,10.79
11-11-2021,SANTA COMBA DÃO,5,0,48,"[0,120]",Baixo a Moderado,,,,5,Centro,VISEU,1814,11194.77,10452,732,684,569,538,464,1002,1571,2255,2987,93.36,26.68,20.14,14.03
11-11-2021,SANTA CRUZ,94,7,208,"[120,240]",Moderado,,,,94,Madeira,MADEIRA,3108,8150.28,45281,1817,1301,974,716,523,1239,2213,3514,5331,555.6,65.41,43.12,27.15
11-11-2021,SANTA CRUZ DA GRACIOSA,1,0,24,"[0,120]",Baixo a Moderado,,,,1,Açores,AÇORES,4401,6065.78,4208,228,180,163,124,145,269,432,612,840,69.37,13.85,10.09,7.12
11-11-2021,SANTA CRUZ DAS FLORES,3,0,139,"[120,240]",Moderado,,,,3,Açores,AÇORES,4802,7091.44,2165,125,98,74,56,51,107,181,279,404,30.53,5.7,3.93,2.55
11-11-2021,SANTA MARIA DA FEIRA,129,9,93,"[0,120]",Baixo a Moderado,,,,129,Norte,AVEIRO,0109,21587.65,138636,8182,6743,4771,3856,3079,6935,11706,18449,26631,642.19,123.36,85.46,54.22
11-11-2021,SANTA MARTA DE PENAGUIÃO,7,1,107,"[0,120]",Baixo a Moderado,,,,7,Norte,VILA REAL,1711,6928.13,6599,483,373,337,316,317,633,970,1343,1826,95.25,26.36,19.39,14.0
11-11-2021,SANTANA,4,0,60,"[0,120]",Baixo a Moderado,,,,4,Madeira,MADEIRA,3109,9547.3,6711,418,353,343,282,277,559,902,1255,1673,70.29,17.52,13.15,9.45
11-11-2021,SANTARÉM,123,9,215,"[120,240]",Moderado,,,,123,Lisboa e Vale do Tejo,SANTARÉM,1416,55253.58,57421,3654,3441,2760,2466,2206,4672,7432,10873,14527,103.92,26.29,19.68,13.45
11-11-2021,SANTIAGO DO CACÉM,21,2,73,"[0,120]",Baixo a Moderado,,,,21,Alentejo,SETÚBAL,1509,105969.29,28791,2144,1689,1472,1295,1215,2510,3982,5671,7815,27.17,7.37,5.35,3.76
11-11-2021,SANTO TIRSO,54,4,80,"[0,120]",Baixo a Moderado,,,,54,Norte,PORTO,1314,13655.52,68055,4911,3935,2761,2257,1810,4067,6828,10763,15674,498.35,114.78,78.82,50.0
11-11-2021,SÃO BRÁS DE ALPORTEL,19,1,183,"[120,240]",Moderado,,,,19,Algarve,FARO,0812,15336.92,10416,596,468,467,404,401,805,1272,1740,2336,67.91,15.23,11.35,8.29
11-11-2021,SÃO JOÃO DA MADEIRA,24,2,109,"[0,120]",Baixo a Moderado,,,,24,Norte,AVEIRO,0116,794.3,21958,1347,1069,796,601,593,1194,1990,3059,4406,2765.49,554.91,385.26,250.63
11-11-2021,SÃO JOÃO DA PESQUEIRA,47,3,666,"[480,960]",Muito Elevado,,,,47,Norte,VISEU,1815,26610.85,7125,417,330,294,328,328,656,950,1280,1697,26.77,6.38,4.81,3.57
11-11-2021,SÃO PEDRO DO SUL,54,4,350,"[240,480]",Elevado,,,,54,Centro,VISEU,1816,34895.09,15403,990,962,861,759,909,1668,2529,3491,4481,44.14,12.84,10.0,7.25
11-11-2021,SÃO ROQUE DO PICO,0,0,0,"[0,120]",Baixo a Moderado,,,,0,Açores,AÇORES,4603,14236.1,3266,199,141,93,96,113,209,302,443,642,22.94,4.51,3.11,2.12
11-11-2021,SÃO VICENTE,6,0,117,"[0,120]",Baixo a Moderado,,,,6,Madeira,MADEIRA,3110,7883.71,5143,272,264,266,225,280,505,771,1035,1307,65.23,16.58,13.13,9.78
11-11-2021,SARDOAL,1,0,27,"[0,120]",Baixo a Moderado,,,,1,Lisboa e Vale do Tejo,SANTARÉM,1417,9214.72,3741,227,178,148,165,248,413,561,739,966,40.6,10.48,8.02,6.09
11-11-2021,SÁTÃO,19,1,163,"[120,240]",Moderado,,,,19,Centro,VISEU,1817,20194.11,11580,765,671,515,465,476,941,1456,2127,2892,57.34,14.32,10.53,7.21
11-11-2021,SEIA,41,3,185,"[120,240]",Moderado,,,,41,Centro,GUARDA,0912,43568.83,22234,1807,1589,1238,1122,721,1843,3081,4670,6477,51.03,14.87,10.72,7.07
11-11-2021,SEIXAL,153,11,91,"[0,120]",Baixo a Moderado,,,,153,Lisboa e Vale do Tejo,SETÚBAL,1510,9545.17,167752,10586,9270,6661,4391,2930,7321,13982,23252,33838,1757.49,354.51,243.6,146.49
11-11-2021,SERNANCELHE,15,1,279,"[240,480]",Elevado,,,,15,Norte,VISEU,1818,22861.22,5396,305,293,286,273,260,533,819,1112,1417,23.6,6.2,4.86,3.58
11-11-2021,SERPA,23,2,162,"[120,240]",Moderado,,,,23,Alentejo,BEJA,0213,110563.34,14304,903,761,719,697,626,1323,2042,2803,3706,12.94,3.35,2.54,1.85
11-11-2021,SERTÃ,18,1,124,"[120,240]",Moderado,,,,18,Centro,CASTELO BRANCO,0509,44673.17,14577,870,779,790,767,1020,1787,2577,3356,4226,32.63,9.46,7.51,5.77
11-11-2021,SESIMBRA,50,4,96,"[0,120]",Baixo a Moderado,,,,50,Lisboa e Vale do Tejo,SETÚBAL,1511,19571.75,51858,2400,2321,1853,1257,1083,2340,4193,6514,8914,264.96,45.54,33.28,21.42
11-11-2021,SETÚBAL,150,11,130,"[120,240]",Moderado,,,,150,Lisboa e Vale do Tejo,SETÚBAL,1512,23032.5,115126,7425,6929,5075,3775,2655,6430,11505,18434,25859,499.83,112.27,80.03,49.95
11-11-2021,SEVER DO VOUGA,2,0,18,"[0,120]",Baixo a Moderado,,,,2,Centro,AVEIRO,0117,12987.56,11331,766,637,568,540,567,1107,1675,2312,3078,87.24,23.7,17.8,12.9
11-11-2021,SILVES,61,4,168,"[120,240]",Moderado,,,,61,Algarve,FARO,0813,68006.23,36226,2137,1869,1610,1423,1600,3023,4633,6502,8639,53.27,12.7,9.56,6.81
11-11-2021,SINES,7,0,51,"[0,120]",Baixo a Moderado,,,,7,Alentejo,SETÚBAL,1513,20330.17,13715,888,791,551,416,268,684,1235,2026,2914,67.46,14.33,9.97,6.07
11-11-2021,SINTRA,399,29,102,"[0,120]",Baixo a Moderado,,,,399,Lisboa e Vale do Tejo,LISBOA,1111,31922.73,391402,20490,18316,13545,9137,7284,16421,29966,48282,68772,1226.08,215.43,151.25,93.87
11-11-2021,SOBRAL DE MONTE AGRAÇO,4,0,37,"[0,120]",Baixo a Moderado,,,,4,Lisboa e Vale do Tejo,LISBOA,1112,5210.32,10651,564,507,352,272,212,484,836,1343,1907,204.43,36.6,25.78,16.05
11-11-2021,SOURE,32,2,188,"[120,240]",Moderado,,,,32,Centro,COIMBRA,0615,26506.07,17120,1173,1142,1004,883,987,1870,2874,4016,5189,64.59,19.58,15.15,10.84
11-11-2021,SOUSEL,1,0,23,"[0,120]",Baixo a Moderado,,,,1,Alentejo,PORTALEGRE,1215,27932.18,4412,261,274,208,302,292,594,802,1076,1337,15.8,4.79,3.85,2.87
11-11-2021,TÁBUA,3,0,26,"[0,120]",Baixo a Moderado,,,,3,Centro,COIMBRA,0616,19978.58,11368,729,584,524,430,464,894,1418,2002,2731,56.9,13.67,10.02,7.1
11-11-2021,TABUAÇO,6,0,100,"[0,120]",Baixo a Moderado,,,,6,Norte,VISEU,1819,13385.67,6033,372,314,217,282,363,645,862,1176,1548,45.07,11.56,8.79,6.44
11-11-2021,TAROUCA,2,0,26,"[0,120]",Baixo a Moderado,,,,2,Norte,VISEU,1820,10008.49,7804,405,335,313,277,324,601,914,1249,1654,77.98,16.53,12.48,9.13
11-11-2021,TAVIRA,30,2,123,"[120,240]",Moderado,,,,30,Algarve,FARO,0814,60696.7,24530,1493,1415,1252,1066,1277,2343,3595,5010,6503,40.41,10.71,8.25,5.92
11-11-2021,TERRAS DE BOURO,30,2,475,"[240,480]",Elevado,,,,30,Norte,BRAGA,0310,27746.07,6361,391,372,296,319,340,659,955,1327,1718,22.93,6.19,4.78,3.44
11-11-2021,TOMAR,68,5,185,"[120,240]",Moderado,,,,68,Lisboa e Vale do Tejo,SANTARÉM,1418,35120.44,36748,2403,2189,1868,1853,1822,3675,5543,7732,10135,104.64,28.86,22.02,15.78
11-11-2021,TONDELA,29,2,110,"[0,120]",Baixo a Moderado,,,,29,Centro,VISEU,1821,37121.73,26357,1768,1722,1518,1475,1417,2892,4410,6132,7900,71.0,21.28,16.52,11.88
11-11-2021,TORRE DE MONCORVO,9,1,118,"[0,120]",Baixo a Moderado,,,,9,Norte,BRAGANÇA,0409,53155.67,7695,556,478,488,551,719,1270,1758,2236,2792,14.48,5.25,4.21,3.31
11-11-2021,TORRES NOVAS,123,9,353,"[240,480]",Elevado,,,,123,Lisboa e Vale do Tejo,SANTARÉM,1419,26999.68,34933,2324,1979,1738,1406,1475,2881,4619,6598,8922,129.38,33.04,24.44,17.11
11-11-2021,TORRES VEDRAS,73,5,93,"[0,120]",Baixo a Moderado,,,,73,Lisboa e Vale do Tejo,LISBOA,1113,40714.89,78530,4513,3945,3447,2628,2104,4732,8179,12124,16637,192.88,40.86,29.78,20.09
11-11-2021,TRANCOSO,16,1,180,"[120,240]",Moderado,,,,16,Centro,GUARDA,0913,36152.47,8875,581,557,542,586,496,1082,1624,2181,2762,24.55,7.64,6.03,4.49
11-11-2021,TROFA,31,2,81,"[0,120]",Baixo a Moderado,,,,31,Norte,PORTO,1318,7201.76,38418,2336,1894,1231,939,684,1623,2854,4748,7084,533.44,98.36,65.93,39.63
11-11-2021,VAGOS,37,3,161,"[120,240]",Moderado,,,,37,Centro,AVEIRO,0118,16491.5,22740,1320,1205,922,784,724,1508,2430,3635,4955,137.89,30.04,22.04,14.73
11-11-2021,VALE DE CAMBRA,37,3,174,"[120,240]",Moderado,,,,37,Norte,AVEIRO,0119,14733.47,21327,1491,1363,1005,831,798,1629,2634,3997,5488,144.76,37.25,27.13,17.88
11-11-2021,VALENÇA,6,0,45,"[0,120]",Baixo a Moderado,,,,6,Norte,VIANA DO CASTELO,1608,11712.86,13290,867,791,582,582,503,1085,1667,2458,3325,113.46,28.39,20.99,14.23
11-11-2021,VALONGO,74,5,76,"[0,120]",Baixo a Moderado,,,,74,Norte,PORTO,1315,7512.45,97444,5629,4696,3207,2462,1829,4291,7498,12194,17823,1297.18,237.26,162.33,99.81
11-11-2021,VALPAÇOS,14,1,96,"[0,120]",Baixo a Moderado,,,,14,Norte,VILA REAL,1712,54873.93,14818,1217,1118,999,928,997,1925,2924,4042,5259,27.0,9.58,7.37,5.33
11-11-2021,VELAS,0,0,0,"[0,120]",Baixo a Moderado,,,,0,Açores,AÇORES,4502,11738.38,5093,278,208,166,153,113,266,432,640,918,43.39,7.82,5.45,3.68
11-11-2021,VENDAS NOVAS,4,0,36,"[0,120]",Baixo a Moderado,,,,4,Alentejo,ÉVORA,0712,22238.88,11255,677,768,655,501,532,1033,1688,2456,3133,50.61,14.09,11.04,7.59
11-11-2021,VIANA DO ALENTEJO,12,1,235,"[120,240]",Moderado,,,,12,Alentejo,ÉVORA,0713,39367.29,5145,245,208,235,210,214,424,659,867,1112,13.07,2.82,2.2,1.67
11-11-2021,VIANA DO CASTELO,143,10,169,"[120,240]",Moderado,,,,143,Norte,VIANA DO CASTELO,1609,31902.01,84417,5470,4433,3591,3061,2982,6043,9634,14067,19537,264.61,61.24,44.09,30.2
11-11-2021,VIDIGUEIRA,0,0,0,"[0,120]",Baixo a Moderado,,,,0,Alentejo,BEJA,0214,31661.09,5510,300,248,215,233,275,508,723,971,1271,17.4,4.01,3.07,2.28
11-11-2021,VIEIRA DO MINHO,13,1,110,"[0,120]",Baixo a Moderado,,,,13,Norte,BRAGA,0311,21644.35,11842,703,594,525,548,482,1030,1555,2149,2852,54.71,13.18,9.93,7.18
11-11-2021,VILA DE REI,1,0,30,"[0,120]",Baixo a Moderado,,,,1,Centro,CASTELO BRANCO,0510,19154.6,3323,169,128,172,247,302,549,721,849,1018,17.35,5.31,4.43,3.76
11-11-2021,VILA DO BISPO,13,1,253,"[240,480]",Elevado,,,,13,Algarve,FARO,0815,17906.06,5154,302,302,314,232,233,465,779,1081,1383,28.78,7.72,6.04,4.35
11-11-2021,VILA DO CONDE,49,3,61,"[0,120]",Baixo a Moderado,,,,49,Norte,PORTO,1316,14902.77,79899,4726,3875,2819,2070,1743,3813,6632,10507,15233,536.13,102.21,70.5,44.5
11-11-2021,VILA DO PORTO,5,0,89,"[0,120]",Baixo a Moderado,,,,5,Açores,AÇORES,4101,9688.74,5616,274,212,135,96,123,219,354,566,840,57.96,8.67,5.84,3.65
11-11-2021,VILA FLOR,9,1,150,"[120,240]",Moderado,,,,9,Norte,BRAGANÇA,0410,26581.14,6044,429,362,422,294,331,625,1047,1409,1838,22.74,6.91,5.3,3.94
11-11-2021,VILA FRANCA DE XIRA,89,6,63,"[0,120]",Baixo a Moderado,,,,89,Lisboa e Vale do Tejo,LISBOA,1114,31819.39,141957,8501,6852,4869,3425,2472,5897,10766,17618,26119,446.14,82.09,55.37,33.84
11-11-2021,VILA FRANCA DO CAMPO,5,0,46,"[0,120]",Baixo a Moderado,,,,5,Açores,AÇORES,4206,7796.82,11051,450,344,248,217,154,371,619,963,1413,141.73,18.12,12.35,7.94
11-11-2021,VILA NOVA DA BARQUINHA,43,3,570,"[480,960]",Muito Elevado,,,,43,Lisboa e Vale do Tejo,SANTARÉM,1420,4952.97,7461,415,406,392,364,338,702,1094,1500,1915,150.64,38.66,30.28,22.09
11-11-2021,VILA NOVA DE CERVEIRA,3,0,34,"[0,120]",Baixo a Moderado,,,,3,Norte,VIANA DO CASTELO,1610,10846.66,8910,531,444,410,384,334,718,1128,1572,2103,82.14,19.39,14.49,10.4
11-11-2021,VILA NOVA DE FAMALICÃO,74,5,56,"[0,120]",Baixo a Moderado,,,,74,Norte,BRAGA,0312,20159.26,131676,7817,6164,4202,3282,2749,6031,10233,16397,24214,653.19,120.12,81.34,50.76
11-11-2021,VILA NOVA DE FOZ CÔA,8,1,125,"[120,240]",Moderado,,,,8,Centro,GUARDA,0914,39815.18,6503,442,385,390,398,429,827,1217,1602,2044,16.33,5.13,4.02,3.06
11-11-2021,VILA NOVA DE GAIA,288,21,96,"[0,120]",Baixo a Moderado,,,,288,Norte,PORTO,1317,16846.43,300472,18349,15568,10972,8224,6281,14505,25477,41045,59394,1783.64,352.57,243.65,151.23
11-11-2021,VILA NOVA DE PAIVA,0,0,0,"[0,120]",Baixo a Moderado,,,,0,Centro,VISEU,1822,17553.28,4687,289,272,233,217,241,458,691,963,1252,26.7,7.13,5.49,3.94
11-11-2021,VILA NOVA DE POIARES,3,0,43,"[0,120]",Baixo a Moderado,,,,3,Centro,COIMBRA,0617,8445.3,6939,380,284,262,235,182,417,679,963,1343,82.17,15.9,11.4,8.04
11-11-2021,VILA POUCA DE AGUIAR,5,0,42,"[0,120]",Baixo a Moderado,,,,5,Norte,VILA REAL,1713,43706.62,11961,860,817,733,601,627,1228,1961,2778,3638,27.37,8.32,6.36,4.49
11-11-2021,VILA REAL,61,4,122,"[120,240]",Moderado,,,,61,Norte,VILA REAL,1714,37880.28,49962,3025,2498,2065,1579,1466,3045,5110,7608,10633,131.9,28.07,20.08,13.49
11-11-2021,VILA REAL DE SANTO ANTÓNIO,3,0,16,"[0,120]",Baixo a Moderado,,,,3,Algarve,FARO,0816,6125.0,18749,1172,1069,811,569,586,1155,1966,3035,4207,306.11,68.69,49.55,32.1
11-11-2021,VILA VELHA DE RÓDÃO,16,1,509,"[480,960]",Muito Elevado,,,,16,Centro,CASTELO BRANCO,0511,32991.16,3144,209,229,180,283,306,589,769,998,1207,9.53,3.66,3.03,2.33
11-11-2021,VILA VERDE,36,3,77,"[0,120]",Baixo a Moderado,,,,36,Norte,BRAGA,0313,22866.52,46911,2365,2063,1667,1494,1437,2931,4598,6661,9026,205.15,39.47,29.13,20.11
11-11-2021,VILA VIÇOSA,3,0,40,"[0,120]",Baixo a Moderado,,,,3,Alentejo,ÉVORA,0714,19485.89,7656,487,379,342,345,324,669,1011,1390,1877,39.29,9.63,7.13,5.19
11-11-2021,VIMIOSO,12,1,303,"[240,480]",Elevado,,,,12,Norte,BRAGANÇA,0411,48158.51,4023,274,230,261,293,335,628,889,1119,1393,8.35,2.89,2.32,1.85
11-11-2021,VINHAIS,20,1,263,"[240,480]",Elevado,,,,20,Norte,BRAGANÇA,0412,69475.09,7746,599,577,636,641,815,1456,2092,2669,3268,11.15,4.7,3.84,3.01
11-11-2021,VISEU,208,15,214,"[120,240]",Moderado,,,,208,Centro,VISEU,1823,50710.14,97249,5769,5038,4140,3158,2710,5868,10008,15046,20815,191.77,41.05,29.67,19.74
11-11-2021,VIZELA,13,1,54,"[0,120]",Baixo a Moderado,,,,13,Norte,BRAGA,0314,2469.83,23897,1258,928,655,509,371,880,1535,2463,3721,967.49,150.65,99.72,62.15
11-11-2021,VOUZELA,17,1,177,"[120,240]",Moderado,,,,17,Centro,VISEU,1824,19369.46,9619,626,605,554,532,507,1039,1593,2198,2824,49.66,14.58,11.35,8.22
18-11-2021,ABRANTES,42,3,120,"[120,240]",Moderado,,,,42,Lisboa e Vale do Tejo,SANTARÉM,1401,71469.08,35130,2473,2213,1730,1748,2021,3769,5499,7712,10185,49.15,14.25,10.79,7.69
18-11-2021,ÁGUEDA,101,7,220,"[120,240]",Moderado,,,,101,Centro,AVEIRO,0101,33527.44,46075,3237,2713,2090,1635,1496,3131,5221,7934,11171,137.43,33.32,23.66,15.57
18-11-2021,AGUIAR DA BEIRA,3,0,65,"[0,120]",Baixo a Moderado,,,,3,Centro,GUARDA,0901,20676.57,4652,304,281,235,239,148,387,622,903,1207,22.5,5.84,4.37,3.01
18-11-2021,ALANDROAL,1,0,20,"[0,120]",Baixo a Moderado,,,,1,Alentejo,ÉVORA,0701,54267.81,4992,307,256,296,299,377,676,972,1228,1535,9.2,2.83,2.26,1.79
18-11-2021,ALBERGARIA-A-VELHA,55,4,226,"[120,240]",Moderado,,,,55,Centro,AVEIRO,0102,15882.5,24144,1550,1298,996,687,680,1367,2363,3661,5211,152.02,32.81,23.05,14.88
18-11-2021,ALBUFEIRA,150,11,360,"[240,480]",Elevado,,,,150,Algarve,FARO,0801,14066.42,41528,2067,1717,1425,985,858,1843,3268,4985,7052,295.24,50.14,35.44,23.23
18-11-2021,ALCÁCER DO SAL,10,1,87,"[0,120]",Baixo a Moderado,,,,10,Alentejo,SETÚBAL,1501,149987.3,11659,884,814,623,623,602,1225,1848,2662,3546,7.77,2.36,1.77,1.23
18-11-2021,ALCANENA,27,2,210,"[120,240]",Moderado,,,,27,Lisboa e Vale do Tejo,SANTARÉM,1402,12732.86,12809,891,744,628,536,588,1124,1752,2496,3387,100.6,26.6,19.6,13.76
18-11-2021,ALCOBAÇA,133,10,249,"[240,480]",Elevado,,,,133,Lisboa e Vale do Tejo,LEIRIA,1001,40814.09,53555,3420,2927,2466,2059,1676,3735,6201,9128,12548,131.22,30.74,22.36,15.19
18-11-2021,ALCOCHETE,41,3,206,"[120,240]",Moderado,,,,41,Lisboa e Vale do Tejo,SETÚBAL,1502,12836.48,19787,857,834,691,476,447,923,1614,2448,3305,154.15,25.75,19.07,12.57
18-11-2021,ALCOUTIM,0,0,0,"[0,120]",Baixo a Moderado,,,,0,Algarve,FARO,0802,57536.33,2159,191,188,163,190,267,457,620,808,999,3.75,1.74,1.4,1.08
18-11-2021,ALENQUER,34,2,78,"[0,120]",Baixo a Moderado,,,,34,Lisboa e Vale do Tejo,LISBOA,1101,30421.92,44052,2298,2062,1629,1330,1155,2485,4114,6176,8474,144.8,27.85,20.3,13.52
18-11-2021,ALFÂNDEGA DA FÉ,3,0,67,"[0,120]",Baixo a Moderado,,,,3,Norte,BRAGANÇA,0401,32194.64,4550,325,277,301,274,325,599,900,1177,1502,14.13,4.67,3.66,2.8
18-11-2021,ALIJÓ,16,1,152,"[120,240]",Moderado,,,,16,Norte,VILA REAL,1701,29759.89,10625,766,687,635,542,666,1208,1843,2530,3296,35.7,11.08,8.5,6.19
18-11-2021,ALJEZUR,17,1,304,"[240,480]",Elevado,,,,17,Algarve,FARO,0803,32349.95,5594,316,336,335,320,410,730,1065,1401,1717,17.29,5.31,4.33,3.29
18-11-2021,ALJUSTREL,7,1,86,"[0,120]",Baixo a Moderado,,,,7,Alentejo,BEJA,0201,45847.41,8247,635,521,443,347,358,705,1148,1669,2304,17.99,5.03,3.64,2.5
18-11-2021,ALMADA,380,27,225,"[120,240]",Moderado,,,,380,Lisboa e Vale do Tejo,SETÚBAL,1503,7000.89,169039,10469,9777,7876,6144,5111,11255,19131,28908,39377,2414.5,562.45,412.91,273.26
18-11-2021,ALMEIDA,8,1,138,"[120,240]",Moderado,,,,8,Centro,GUARDA,0902,51798.46,5830,441,419,396,458,393,851,1247,1666,2107,11.26,4.07,3.22,2.41
18-11-2021,ALMEIRIM,70,5,312,"[240,480]",Elevado,,,,70,Lisboa e Vale do Tejo,SANTARÉM,1403,22212.05,22546,1342,1353,1106,866,843,1709,2815,4168,5510,101.5,24.81,18.76,12.67
18-11-2021,ALMODÔVAR,7,1,105,"[0,120]",Baixo a Moderado,,,,7,Alentejo,BEJA,0202,77788.03,6725,414,443,396,373,328,701,1097,1540,1954,8.65,2.51,1.98,1.41
18-11-2021,ALPIARÇA,62,4,873,"[480,960]",Muito Elevado,,,,62,Lisboa e Vale do Tejo,SANTARÉM,1404,9536.33,7059,515,486,363,333,274,607,970,1456,1971,74.02,20.67,15.27,10.17
18-11-2021,ALTER DO CHÃO,0,0,0,"[0,120]",Baixo a Moderado,,,,0,Alentejo,PORTALEGRE,1201,36206.62,3165,201,163,136,208,187,395,531,694,895,8.74,2.47,1.92,1.47
18-11-2021,ALVAIÁZERE,9,1,137,"[120,240]",Moderado,,,,9,Centro,LEIRIA,1002,16047.76,6597,419,389,346,406,539,945,1291,1680,2099,41.11,13.08,10.47,8.04
18-11-2021,ALVITO,0,0,0,"[0,120]",Baixo a Moderado,,,,0,Alentejo,BEJA,0203,26485.32,2477,145,110,105,111,89,200,305,415,560,9.35,2.11,1.57,1.15
18-11-2021,AMADORA,223,16,121,"[120,240]",Moderado,,,,223,Lisboa e Vale do Tejo,LISBOA,1115,2378.47,184106,11186,10936,8780,6460,5890,12350,21130,32066,43252,7742.05,1818.84,1348.44,888.56
18-11-2021,AMARANTE,102,7,191,"[120,240]",Moderado,,,,102,Norte,PORTO,1301,30133.15,53193,3086,2413,1812,1643,1311,2954,4766,7179,10265,176.53,34.07,23.82,15.82
18-11-2021,AMARES,13,1,72,"[0,120]",Baixo a Moderado,,,,13,Norte,BRAGA,0301,8195.41,18129,1001,829,622,489,524,1013,1635,2464,3465,221.22,42.28,30.07,19.95
18-11-2021,ANADIA,107,8,391,"[240,480]",Elevado,,,,107,Centro,AVEIRO,0103,21663.48,27258,1931,1698,1376,1208,1262,2470,3846,5544,7475,125.83,34.51,25.59,17.75
18-11-2021,ANGRA DO HEROÍSMO,17,1,51,"[0,120]",Baixo a Moderado,,,,17,Açores,AÇORES,4301,23899.66,33807,2006,1473,1122,768,635,1403,2525,3998,6004,141.45,25.12,16.73,10.56
18-11-2021,ANSIÃO,34,2,282,"[240,480]",Elevado,,,,34,Centro,LEIRIA,1003,17609.42,12039,727,709,646,694,530,1224,1870,2579,3306,68.37,18.77,14.65,10.62
18-11-2021,ARCOS DE VALDEVEZ,31,2,149,"[120,240]",Moderado,,,,31,Norte,VIANA DO CASTELO,1601,44759.64,20926,1329,1338,1282,1343,1515,2858,4140,5478,6807,46.75,15.21,12.24,9.25
18-11-2021,ARGANIL,8,1,73,"[0,120]",Baixo a Moderado,,,,8,Centro,COIMBRA,0601,33283.93,11014,672,648,612,559,596,1155,1767,2415,3087,33.09,9.27,7.26,5.31
18-11-2021,ARMAMAR,2,0,35,"[0,120]",Baixo a Moderado,,,,2,Norte,VISEU,1801,11723.73,5769,357,305,309,285,310,595,904,1209,1566,49.21,13.36,10.31,7.71
18-11-2021,AROUCA,59,4,286,"[240,480]",Elevado,,,,59,Norte,AVEIRO,0104,32910.52,20720,1306,1047,753,683,683,1366,2119,3166,4472,62.96,13.59,9.62,6.44
18-11-2021,ARRAIOLOS,3,0,44,"[0,120]",Baixo a Moderado,,,,3,Alentejo,ÉVORA,0702,68374.55,6928,435,384,283,367,480,847,1130,1514,1949,10.13,2.85,2.21,1.65
18-11-2021,ARRONCHES,0,0,0,"[0,120]",Baixo a Moderado,,,,0,Alentejo,PORTALEGRE,1202,31464.72,2820,155,142,162,187,179,366,528,670,825,8.96,2.62,2.13,1.68
18-11-2021,ARRUDA DOS VINHOS,5,0,32,"[0,120]",Baixo a Moderado,,,,5,Lisboa e Vale do Tejo,LISBOA,1102,7795.93,15412,738,738,562,509,438,947,1509,2247,2985,197.69,38.29,28.82,19.36
18-11-2021,AVEIRO,242,17,307,"[240,480]",Elevado,,,,242,Centro,AVEIRO,0105,19757.57,78734,4520,4004,3050,2250,2103,4353,7403,11407,15927,398.49,80.61,57.73,37.47
18-11-2021,AVIS,2,0,48,"[0,120]",Baixo a Moderado,,,,2,Alentejo,PORTALEGRE,1203,60596.51,4247,315,225,206,251,273,524,730,955,1270,7.01,2.1,1.58,1.2
18-11-2021,AZAMBUJA,26,2,114,"[0,120]",Baixo a Moderado,,,,26,Lisboa e Vale do Tejo,LISBOA,1103,26265.65,22716,1322,1171,1070,798,618,1416,2486,3657,4979,86.48,18.96,13.92,9.46
18-11-2021,BAIÃO,25,2,135,"[120,240]",Moderado,,,,25,Norte,PORTO,1302,17452.83,18748,1070,862,714,686,725,1411,2125,2987,4057,107.42,23.25,17.11,12.18
18-11-2021,BARCELOS,115,8,99,"[0,120]",Baixo a Moderado,,,,115,Norte,BRAGA,0302,37890.14,116187,6721,5325,3619,2991,2562,5553,9172,14497,21218,306.64,56.0,38.26,24.21
18-11-2021,BARRANCOS,2,0,123,"[120,240]",Moderado,,,,2,Alentejo,BEJA,0204,16841.73,1634,90,65,65,94,61,155,220,285,375,9.7,2.23,1.69,1.31
18-11-2021,BARREIRO,178,13,237,"[120,240]",Moderado,,,,178,Lisboa e Vale do Tejo,SETÚBAL,1504,3639.07,75147,5194,5565,4459,3105,1767,4872,9331,14896,20090,2065.05,552.07,409.34,256.42
18-11-2021,BATALHA,92,7,575,"[480,960]",Muito Elevado,,,,92,Centro,LEIRIA,1004,10341.6,15963,873,762,649,529,549,1078,1727,2489,3362,154.35,32.51,24.07,16.7
18-11-2021,BEJA,66,5,198,"[120,240]",Moderado,,,,66,Alentejo,BEJA,0205,114647.55,33579,2005,1840,1386,1272,1039,2311,3697,5537,7542,29.29,6.58,4.83,3.22
18-11-2021,BELMONTE,15,1,235,"[120,240]",Moderado,,,,15,Centro,CASTELO BRANCO,0501,11875.91,6398,444,321,325,310,355,665,990,1311,1755,53.87,14.78,11.04,8.34
18-11-2021,BENAVENTE,86,6,280,"[240,480]",Elevado,,,,86,Lisboa e Vale do Tejo,SANTARÉM,1405,52138.39,30602,1468,1376,1141,876,643,1519,2660,4036,5504,58.69,10.56,7.74,5.1
18-11-2021,BOMBARRAL,28,2,221,"[120,240]",Moderado,,,,28,Lisboa e Vale do Tejo,LEIRIA,1005,9128.55,12558,875,714,561,491,429,920,1481,2195,3070,137.56,33.63,24.04,16.22
18-11-2021,BORBA,4,0,60,"[0,120]",Baixo a Moderado,,,,4,Alentejo,ÉVORA,0703,14518.65,6736,430,375,279,436,392,828,1107,1482,1912,46.39,13.17,10.21,7.62
18-11-2021,BOTICAS,1,0,20,"[0,120]",Baixo a Moderado,,,,1,Norte,VILA REAL,1702,32195.66,4998,347,306,311,305,380,685,996,1302,1649,15.52,5.12,4.04,3.09
18-11-2021,BRAGA,418,30,229,"[120,240]",Moderado,,,,418,Norte,BRAGA,0303,18339.95,182679,10029,7963,5241,4320,3671,7991,13232,21195,31224,996.07,170.25,115.57,72.15
18-11-2021,BRAGANÇA,181,13,538,"[480,960]",Muito Elevado,,,,181,Norte,BRAGANÇA,0402,117357.27,33607,2402,1855,1652,1393,1163,2556,4208,6063,8465,28.64,7.21,5.17,3.59
18-11-2021,CABECEIRAS DE BASTO,3,0,19,"[0,120]",Baixo a Moderado,,,,3,Norte,BRAGA,0304,24182.16,15628,774,594,544,575,574,1149,1693,2287,3061,64.63,12.66,9.46,7.0
18-11-2021,CADAVAL,14,1,102,"[0,120]",Baixo a Moderado,,,,14,Lisboa e Vale do Tejo,LISBOA,1104,17489.3,13673,813,796,756,621,625,1246,2002,2798,3611,78.18,20.65,16.0,11.45
18-11-2021,CALDAS DA RAINHA,182,13,351,"[240,480]",Elevado,,,,182,Lisboa e Vale do Tejo,LEIRIA,1006,25569.47,51912,3035,2684,2186,1899,1705,3604,5790,8474,11509,203.03,45.01,33.14,22.64
18-11-2021,CALHETA,21,2,194,"[120,240]",Moderado,,,,21,Madeira,MADEIRA,3101,11150.43,10867,576,497,507,399,415,814,1321,1818,2394,97.46,21.47,16.3,11.85
18-11-2021,CALHETA (AÇORES),3,0,95,"[0,120]",Baixo a Moderado,,,,3,Açores,AÇORES,4501,12626.4,3184,215,159,141,139,122,261,402,561,776,25.22,6.15,4.44,3.18
18-11-2021,CÂMARA DE LOBOS,64,5,190,"[120,240]",Moderado,,,,64,Madeira,MADEIRA,3102,5216.67,33675,1396,1059,834,545,381,926,1760,2819,4215,645.49,80.79,54.03,33.74
18-11-2021,CAMINHA,8,1,51,"[0,120]",Baixo a Moderado,,,,8,Norte,VIANA DO CASTELO,1602,13652.14,15877,1046,944,818,646,656,1302,2120,3064,4110,116.3,30.11,22.44,15.53
18-11-2021,CAMPO MAIOR,7,1,90,"[0,120]",Baixo a Moderado,,,,7,Alentejo,PORTALEGRE,1204,24720.16,7874,471,364,351,279,327,606,957,1321,1792,31.85,7.25,5.34,3.87
18-11-2021,CANTANHEDE,84,6,239,"[120,240]",Moderado,,,,84,Centro,COIMBRA,0602,39088.02,35011,2346,2096,1880,1709,1451,3160,5040,7136,9482,89.57,24.26,18.26,12.89
18-11-2021,CARRAZEDA DE ANSIÃES,17,1,303,"[240,480]",Elevado,,,,17,Norte,BRAGANÇA,0403,27924.09,5666,424,389,391,312,465,777,1168,1557,1981,20.29,7.09,5.58,4.18
18-11-2021,CARREGAL DO SAL,12,1,129,"[120,240]",Moderado,,,,12,Centro,VISEU,1802,11689.21,9271,587,562,486,462,376,838,1324,1886,2473,79.31,21.16,16.13,11.33
18-11-2021,CARTAXO,70,5,294,"[240,480]",Elevado,,,,70,Lisboa e Vale do Tejo,SANTARÉM,1406,15817.28,23843,1415,1376,1142,861,632,1493,2635,4011,5426,150.74,34.3,25.36,16.66
18-11-2021,CASCAIS,429,31,201,"[120,240]",Moderado,,,,429,Lisboa e Vale do Tejo,LISBOA,1105,9740.17,213608,12151,11444,8680,6469,5248,11717,20397,31841,43992,2193.1,451.66,326.91,209.41
18-11-2021,CASTANHEIRA DE PÊRA,7,1,272,"[240,480]",Elevado,,,,7,Centro,LEIRIA,1007,6677.45,2614,233,195,157,190,187,377,534,729,962,39.15,14.41,10.92,8.0
18-11-2021,CASTELO BRANCO,95,7,183,"[120,240]",Moderado,,,,95,Centro,CASTELO BRANCO,0502,143819.15,51987,3528,3042,2499,2229,2225,4454,6953,9995,13523,36.15,9.4,6.95,4.83
18-11-2021,CASTELO DE PAIVA,22,2,144,"[120,240]",Moderado,,,,22,Norte,AVEIRO,0106,11500.53,15454,881,697,545,420,431,851,1396,2093,2974,134.37,25.86,18.2,12.14
18-11-2021,CASTELO DE VIDE,0,0,0,"[0,120]",Baixo a Moderado,,,,0,Alentejo,PORTALEGRE,1205,26491.24,2919,204,173,179,147,170,317,496,669,873,11.02,3.3,2.53,1.87
18-11-2021,CASTRO DAIRE,34,2,246,"[240,480]",Elevado,,,,34,Centro,VISEU,1803,37904.13,13823,942,857,765,732,773,1505,2270,3127,4069,36.47,10.74,8.25,5.99
18-11-2021,CASTRO MARIM,10,1,161,"[120,240]",Moderado,,,,10,Algarve,FARO,0804,30084.37,6237,370,345,334,322,344,666,1000,1345,1715,20.73,5.7,4.47,3.32
18-11-2021,CASTRO VERDE,13,1,189,"[120,240]",Moderado,,,,13,Alentejo,BEJA,0206,56944.23,6949,437,347,303,275,227,502,805,1152,1589,12.2,2.79,2.02,1.41
18-11-2021,CELORICO DA BEIRA,2,0,29,"[0,120]",Baixo a Moderado,,,,2,Centro,GUARDA,0903,24721.63,6928,430,416,363,369,535,904,1267,1683,2113,28.02,8.55,6.81,5.12
18-11-2021,CELORICO DE BASTO,14,1,74,"[0,120]",Baixo a Moderado,,,,14,Norte,BRAGA,0305,18107.02,19040,1001,802,668,728,729,1457,2125,2927,3928,105.15,21.69,16.17,11.74
18-11-2021,CHAMUSCA,15,1,165,"[120,240]",Moderado,,,,15,Lisboa e Vale do Tejo,SANTARÉM,1407,74600.54,9197,629,583,553,465,579,1044,1597,2180,2809,12.33,3.77,2.92,2.14
18-11-2021,CHAVES,24,2,61,"[0,120]",Baixo a Moderado,,,,24,Norte,VILA REAL,1703,59122.95,39343,2676,2429,1991,1886,1918,3804,5795,8224,10900,66.54,18.44,13.91,9.8
18-11-2021,CINFÃES,8,1,44,"[0,120]",Baixo a Moderado,,,,8,Norte,VISEU,1804,23928.76,18244,1067,902,779,734,758,1492,2271,3173,4240,76.24,17.72,13.26,9.49
18-11-2021,COIMBRA,441,32,329,"[240,480]",Elevado,,,,441,Centro,COIMBRA,0603,31939.94,134166,9489,8734,6353,5139,5074,10213,16566,25300,34789,420.06,108.92,79.21,51.87
18-11-2021,CONDEIXA-A-NOVA,52,4,291,"[240,480]",Elevado,,,,52,Centro,COIMBRA,0604,13867.47,17733,871,809,717,583,490,1073,1790,2599,3470,127.88,25.02,18.74,12.91
18-11-2021,CONSTÂNCIA,9,1,222,"[120,240]",Moderado,,,,9,Lisboa e Vale do Tejo,SANTARÉM,1408,8036.58,4030,211,183,187,148,155,303,490,673,884,50.14,11.0,8.37,6.1
18-11-2021,CORUCHE,54,4,308,"[240,480]",Elevado,,,,54,Lisboa e Vale do Tejo,SANTARÉM,1409,111572.03,17471,1294,1090,1095,1096,1019,2115,3210,4300,5594,15.66,5.01,3.85,2.88
18-11-2021,CORVO,0,0,0,"[0,120]",Baixo a Moderado,,,,0,Açores,AÇORES,4901,1711.45,464,22,21,11,13,19,32,43,64,86,27.12,5.03,3.74,2.51
18-11-2021,COVILHÃ,216,15,462,"[240,480]",Elevado,,,,216,Centro,CASTELO BRANCO,0503,55560.06,46787,3533,2998,2365,2111,2193,4304,6669,9667,13200,84.21,23.76,17.4,12.0
18-11-2021,CRATO,2,0,65,"[0,120]",Baixo a Moderado,,,,2,Alentejo,PORTALEGRE,1206,39806.88,3129,229,258,163,182,228,410,573,831,1060,7.86,2.66,2.09,1.44
18-11-2021,CUBA,11,1,242,"[240,480]",Elevado,,,,11,Alentejo,BEJA,0207,17208.72,4595,255,233,206,190,143,333,539,772,1027,26.7,5.97,4.49,3.13
18-11-2021,ELVAS,10,1,49,"[0,120]",Baixo a Moderado,,,,10,Alentejo,PORTALEGRE,1207,63128.86,20528,1057,1145,902,852,810,1662,2564,3709,4766,32.52,7.55,5.88,4.06
18-11-2021,ENTRONCAMENTO,100,7,465,"[240,480]",Elevado,,,,100,Lisboa e Vale do Tejo,SANTARÉM,1410,1372.81,21558,1066,930,868,695,592,1287,2155,3085,4151,1570.14,302.33,224.69,156.96
18-11-2021,ESPINHO,55,4,187,"[120,240]",Moderado,,,,55,Norte,AVEIRO,0107,2105.68,29516,2205,1993,1430,1177,960,2137,3567,5560,7765,1401.52,368.71,264.01,169.37
18-11-2021,ESPOSENDE,27,2,79,"[0,120]",Baixo a Moderado,,,,27,Norte,BRAGA,0306,9540.98,34177,1831,1522,1095,894,723,1617,2712,4234,6065,358.21,63.57,44.38,28.42
18-11-2021,ESTARREJA,148,11,570,"[480,960]",Muito Elevado,,,,148,Centro,AVEIRO,0108,10817.33,26006,1503,1399,1106,953,728,1681,2787,4186,5689,240.42,52.59,38.7,25.76
18-11-2021,ESTREMOZ,6,0,48,"[0,120]",Baixo a Moderado,,,,6,Alentejo,ÉVORA,0704,51379.95,12728,789,613,697,786,877,1663,2360,2973,3762,24.77,7.32,5.79,4.59
18-11-2021,ÉVORA,96,7,184,"[120,240]",Moderado,,,,96,Alentejo,ÉVORA,0705,130707.58,52428,3569,2852,2176,1966,1803,3769,5945,8797,12366,40.11,9.46,6.73,4.55
18-11-2021,FAFE,74,5,153,"[120,240]",Moderado,,,,74,Norte,BRAGA,0307,21908.11,48060,3044,2455,1679,1403,1208,2611,4290,6745,9789,219.37,44.68,30.79,19.58
18-11-2021,FARO,217,16,356,"[240,480]",Elevado,,,,217,Algarve,FARO,0805,20256.79,61015,3847,3364,2604,2055,1601,3656,6260,9624,13471,301.2,66.5,47.51,30.9
18-11-2021,FELGUEIRAS,50,4,89,"[0,120]",Baixo a Moderado,,,,50,Norte,PORTO,1303,11573.75,56422,2951,2302,1601,1316,973,2289,3890,6192,9143,487.49,79.0,53.5,33.61
18-11-2021,FERREIRA DO ALENTEJO,4,0,51,"[0,120]",Baixo a Moderado,,,,4,Alentejo,BEJA,0208,64820.68,7845,515,414,372,343,345,688,1060,1474,1989,12.1,3.07,2.27,1.64
18-11-2021,FERREIRA DO ZÊZERE,21,2,264,"[240,480]",Elevado,,,,21,Lisboa e Vale do Tejo,SANTARÉM,1411,19038.03,7959,470,370,416,465,456,921,1337,1707,2177,41.81,11.44,8.97,7.02
18-11-2021,FIGUEIRA DA FOZ,127,9,216,"[120,240]",Moderado,,,,127,Centro,COIMBRA,0605,37905.26,58747,4032,3597,2887,2495,2043,4538,7425,11022,15054,154.98,39.72,29.08,19.59
18-11-2021,FIGUEIRA DE CASTELO RODRIGO,6,0,107,"[0,120]",Baixo a Moderado,,,,6,Centro,GUARDA,0904,50857.46,5584,347,352,290,352,391,743,1033,1385,1732,10.98,3.41,2.72,2.03
18-11-2021,FIGUEIRÓ DOS VINHOS,19,1,341,"[240,480]",Elevado,,,,19,Centro,LEIRIA,1008,17344.0,5568,402,386,322,309,351,660,982,1368,1770,32.1,10.21,7.89,5.66
18-11-2021,FORNOS DE ALGODRES,6,0,132,"[120,240]",Moderado,,,,6,Centro,GUARDA,0905,13145.05,4528,261,218,247,256,232,488,735,953,1214,34.45,9.24,7.25,5.59
18-11-2021,FREIXO DE ESPADA À CINTA,5,0,154,"[120,240]",Moderado,,,,5,Norte,BRAGANÇA,0404,24414.29,3298,211,177,231,196,189,385,616,793,1004,13.51,4.11,3.25,2.52
18-11-2021,FRONTEIRA,0,0,0,"[0,120]",Baixo a Moderado,,,,0,Alentejo,PORTALEGRE,1208,24859.58,2974,213,182,149,156,168,324,473,655,868,11.96,3.49,2.63,1.9
18-11-2021,FUNCHAL,331,24,318,"[240,480]",Elevado,,,,331,Madeira,MADEIRA,3103,7616.2,104024,6382,5086,3643,2821,1990,4811,8454,13540,19922,1365.86,261.58,177.78,111.0
18-11-2021,FUNDÃO,81,6,306,"[240,480]",Elevado,,,,81,Centro,CASTELO BRANCO,0504,70019.79,26495,1781,1464,1432,1357,1643,3000,4432,5896,7677,37.84,10.96,8.42,6.33
18-11-2021,GAVIÃO,0,0,0,"[0,120]",Baixo a Moderado,,,,0,Alentejo,PORTALEGRE,1209,29459.45,3263,189,186,222,263,293,556,778,964,1153,11.08,3.91,3.27,2.64
18-11-2021,GÓIS,6,0,159,"[120,240]",Moderado,,,,6,Centro,COIMBRA,0606,26330.19,3805,235,199,240,233,244,477,717,916,1151,14.45,4.37,3.48,2.72
18-11-2021,GOLEGÃ,46,3,870,"[480,960]",Muito Elevado,,,,46,Lisboa e Vale do Tejo,SANTARÉM,1412,8431.67,5339,356,299,281,243,255,498,779,1078,1434,63.32,17.01,12.78,9.24
18-11-2021,GONDOMAR,216,15,130,"[120,240]",Moderado,,,,216,Norte,PORTO,1304,13191.76,165985,10555,8755,6222,4450,3364,7814,14036,22791,33346,1258.22,252.77,172.76,106.4
18-11-2021,GOUVEIA,27,2,218,"[120,240]",Moderado,,,,27,Centro,GUARDA,0906,30061.17,12387,871,931,780,783,810,1593,2373,3304,4175,41.21,13.89,10.99,7.89
18-11-2021,GRÂNDOLA,7,1,48,"[0,120]",Baixo a Moderado,,,,7,Alentejo,SETÚBAL,1505,82593.66,14639,834,834,708,688,672,1360,2068,2902,3736,17.72,4.52,3.51,2.5
18-11-2021,GUARDA,142,10,364,"[240,480]",Elevado,,,,142,Centro,GUARDA,0907,71209.58,38969,2477,2041,1686,1415,1474,2889,4575,6616,9093,54.72,12.77,9.29,6.42
18-11-2021,GUIMARÃES,117,8,77,"[0,120]",Baixo a Moderado,,,,117,Norte,BRAGA,0308,24099.96,152309,9394,7074,4809,3877,2948,6825,11634,18708,28102,631.99,116.61,77.63,48.27
18-11-2021,HORTA,12,1,83,"[0,120]",Baixo a Moderado,,,,12,Açores,AÇORES,4701,17305.53,14521,818,658,468,352,302,654,1122,1780,2598,83.91,15.01,10.29,6.48
18-11-2021,IDANHA-A-NOVA,6,0,76,"[0,120]",Baixo a Moderado,,,,6,Centro,CASTELO BRANCO,0505,141633.51,8043,518,490,519,672,974,1646,2165,2655,3173,5.68,2.24,1.87,1.53
18-11-2021,ÍLHAVO,151,11,391,"[240,480]",Elevado,,,,151,Centro,AVEIRO,0110,7347.55,38699,2227,1943,1444,1193,850,2043,3487,5430,7657,526.66,104.21,73.9,47.46
18-11-2021,LAGOA (FARO),85,6,374,"[240,480]",Elevado,,,,85,Algarve,FARO,0806,8825.45,22762,1314,1168,919,749,670,1419,2338,3506,4820,257.93,54.62,39.73,26.49
18-11-2021,LAGOA,40,3,271,"[240,480]",Elevado,,,,40,Açores,AÇORES,4201,4559.32,14721,536,458,349,238,235,473,822,1280,1816,322.9,39.83,28.08,18.03
18-11-2021,LAGOS,123,9,406,"[240,480]",Elevado,,,,123,Algarve,FARO,0807,21299.27,30374,1744,1434,1247,1053,1029,2082,3329,4763,6507,142.61,30.55,22.36,15.63
18-11-2021,LAJES DAS FLORES,1,0,68,"[0,120]",Baixo a Moderado,,,,1,Açores,AÇORES,4801,7004.79,1463,88,53,62,46,54,100,162,215,303,20.89,4.33,3.07,2.31
18-11-2021,LAJES DO PICO,0,0,0,"[0,120]",Baixo a Moderado,,,,0,Açores,AÇORES,4601,15531.09,4490,304,231,223,159,162,321,544,775,1079,28.91,6.95,4.99,3.5
18-11-2021,LAMEGO,30,2,121,"[120,240]",Moderado,,,,30,Norte,VISEU,1805,16542.11,24895,1639,1284,1124,898,783,1681,2805,4089,5728,150.5,34.63,24.72,16.96
18-11-2021,LEIRIA,491,35,392,"[240,480]",Elevado,,,,491,Centro,LEIRIA,1009,56508.83,125267,7389,6366,5090,3902,3159,7061,12151,18517,25906,221.68,45.84,32.77,21.5
18-11-2021,LISBOA,1274,91,250,"[240,480]",Elevado,,,,1274,Lisboa e Vale do Tejo,LISBOA,1106,10005.43,509515,33197,33340,27706,23037,26770,49807,77513,110853,144050,5092.6,1439.78,1107.98,774.74
18-11-2021,LOULÉ,414,30,603,"[480,960]",Muito Elevado,,,,414,Algarve,FARO,0808,76366.91,68697,3890,3350,2780,2358,2251,4609,7389,10739,14629,89.96,19.16,14.06,9.68
18-11-2021,LOURES,227,16,106,"[0,120]",Baixo a Moderado,,,,227,Lisboa e Vale do Tejo,LISBOA,1107,16723.99,213687,12746,12794,9644,6669,5033,11702,21346,34140,46886,1277.73,280.35,204.14,127.64
18-11-2021,LOURINHÃ,57,4,222,"[120,240]",Moderado,,,,57,Lisboa e Vale do Tejo,LISBOA,1108,14717.2,25855,1584,1243,992,842,645,1487,2479,3722,5306,175.68,36.05,25.29,16.84
18-11-2021,LOUSÃ,105,8,614,"[480,960]",Muito Elevado,,,,105,Centro,COIMBRA,0607,13840.01,17158,946,866,658,528,450,978,1636,2502,3448,123.97,24.91,18.08,11.82
18-11-2021,LOUSADA,46,3,99,"[0,120]",Baixo a Moderado,,,,46,Norte,PORTO,1305,9608.01,46755,2289,1698,1176,853,621,1474,2650,4348,6637,486.63,69.08,45.25,27.58
18-11-2021,MAÇÃO,3,0,48,"[0,120]",Baixo a Moderado,,,,3,Lisboa e Vale do Tejo,SANTARÉM,1413,39997.98,6267,386,362,390,440,657,1097,1487,1849,2235,15.67,5.59,4.62,3.72
18-11-2021,MACEDO DE CAVALEIROS,29,2,201,"[120,240]",Moderado,,,,29,Norte,BRAGANÇA,0405,69914.08,14516,1082,889,878,823,938,1761,2639,3528,4610,20.76,6.59,5.05,3.77
18-11-2021,MACHICO,35,3,176,"[120,240]",Moderado,,,,35,Madeira,MADEIRA,3104,6825.1,19981,1197,860,662,455,331,786,1448,2308,3505,292.76,51.36,33.82,21.22
18-11-2021,MADALENA,5,0,85,"[0,120]",Baixo a Moderado,,,,5,Açores,AÇORES,4602,14712.33,5895,334,256,173,190,179,369,542,798,1132,40.07,7.69,5.42,3.68
18-11-2021,MAFRA,85,6,100,"[0,120]",Baixo a Moderado,,,,85,Lisboa e Vale do Tejo,LISBOA,1109,29165.5,84816,3613,3334,2839,2089,1899,3988,6827,10161,13774,290.81,47.23,34.84,23.41
18-11-2021,MAIA,188,13,135,"[120,240]",Moderado,,,,188,Norte,PORTO,1306,8293.94,138971,7801,6617,4512,3339,2631,5970,10482,17099,24900,1675.56,300.22,206.16,126.38
18-11-2021,MANGUALDE,86,6,464,"[240,480]",Elevado,,,,86,Centro,VISEU,1806,21925.56,18510,1198,1128,885,852,743,1595,2480,3608,4806,84.42,21.92,16.46,11.31
18-11-2021,MANTEIGAS,2,0,67,"[0,120]",Baixo a Moderado,,,,2,Centro,GUARDA,0908,12197.55,3007,258,197,159,167,146,313,472,669,927,24.65,7.6,5.48,3.87
18-11-2021,MARCO DE CANAVESES,70,5,135,"[120,240]",Moderado,,,,70,Norte,PORTO,1307,20188.98,51496,2678,2060,1488,1265,1023,2288,3776,5836,8514,255.07,42.17,28.91,18.7
18-11-2021,MARINHA GRANDE,139,10,360,"[240,480]",Elevado,,,,139,Centro,LEIRIA,1010,18725.19,38508,2365,2302,1638,1359,1058,2417,4055,6357,8722,205.65,46.58,33.95,21.66
18-11-2021,MARVÃO,74,5,2451,"[960,Max]",Extremamente Elevado,,,,74,Alentejo,PORTALEGRE,1210,15489.9,3005,198,185,142,197,237,434,576,761,959,19.4,6.19,4.91,3.72
18-11-2021,MATOSINHOS,217,16,124,"[120,240]",Moderado,,,,217,Norte,PORTO,1308,6241.97,175357,11850,9977,7023,5024,3884,8908,15931,25908,37758,2809.31,604.9,415.06,255.22
18-11-2021,MEALHADA,36,3,180,"[120,240]",Moderado,,,,36,Centro,AVEIRO,0111,11065.66,19914,1163,1039,810,828,831,1659,2469,3508,4671,179.96,42.21,31.7,22.31
18-11-2021,MÊDA,12,1,262,"[240,480]",Elevado,,,,12,Centro,GUARDA,0909,28604.92,4587,343,306,290,288,443,731,1021,1327,1670,16.04,5.84,4.64,3.57
18-11-2021,MELGAÇO,4,0,50,"[0,120]",Baixo a Moderado,,,,4,Norte,VIANA DO CASTELO,1603,23824.58,8093,507,567,578,614,675,1289,1867,2434,2941,33.97,12.34,10.22,7.84
18-11-2021,MÉRTOLA,4,0,66,"[0,120]",Baixo a Moderado,,,,4,Alentejo,BEJA,0209,129287.34,6142,400,390,378,423,600,1023,1401,1791,2191,4.75,1.69,1.39,1.08
18-11-2021,MESÃO FRIO,3,0,76,"[0,120]",Baixo a Moderado,,,,3,Norte,VILA REAL,1704,2664.87,3964,265,205,168,157,120,277,445,650,915,148.74,34.33,24.39,16.7
18-11-2021,MIRA,96,7,808,"[480,960]",Muito Elevado,,,,96,Centro,COIMBRA,0608,12403.38,11832,727,729,659,550,466,1016,1675,2404,3131,95.4,25.24,19.38,13.5
18-11-2021,MIRANDA DO CORVO,80,6,629,"[480,960]",Muito Elevado,,,,80,Centro,COIMBRA,0609,12637.79,12708,706,659,568,498,404,902,1470,2129,2835,100.55,22.43,16.85,11.63
18-11-2021,MIRANDA DO DOURO,30,2,444,"[240,480]",Elevado,,,,30,Norte,BRAGANÇA,0406,48718.31,6830,482,429,442,463,470,933,1375,1804,2286,14.02,4.69,3.7,2.82
18-11-2021,MIRANDELA,75,5,343,"[240,480]",Elevado,,,,75,Norte,BRAGANÇA,0407,65895.67,21754,1640,1315,1204,1078,947,2025,3229,4544,6184,33.01,9.38,6.9,4.9
18-11-2021,MOGADOURO,22,2,266,"[240,480]",Elevado,,,,22,Norte,BRAGANÇA,0408,76064.93,8392,589,529,576,630,655,1285,1861,2390,2979,11.03,3.92,3.14,2.45
18-11-2021,MOIMENTA DA BEIRA,17,1,175,"[120,240]",Moderado,,,,17,Norte,VISEU,1807,21996.9,9736,576,514,471,416,461,877,1348,1862,2438,44.26,11.08,8.46,6.13
18-11-2021,MOITA,119,9,185,"[120,240]",Moderado,,,,119,Lisboa e Vale do Tejo,SETÚBAL,1506,5525.98,64407,4226,3646,2623,1801,1425,3226,5849,9495,13721,1165.53,248.3,171.82,105.85
18-11-2021,MONÇÃO,4,0,23,"[0,120]",Baixo a Moderado,,,,4,Norte,VIANA DO CASTELO,1604,21130.85,17869,1161,1105,1031,1006,972,1978,3009,4114,5275,84.56,24.96,19.47,14.24
18-11-2021,MONCHIQUE,21,2,422,"[240,480]",Elevado,,,,21,Algarve,FARO,0809,39530.43,5077,353,384,321,355,392,747,1068,1452,1805,12.84,4.57,3.67,2.7
18-11-2021,MONDIM DE BASTO,1,0,15,"[0,120]",Baixo a Moderado,,,,1,Norte,VILA REAL,1705,17207.52,6946,395,300,314,284,283,567,881,1181,1576,40.36,9.16,6.86,5.12
18-11-2021,MONFORTE,3,0,102,"[0,120]",Baixo a Moderado,,,,3,Alentejo,PORTALEGRE,1211,42024.82,2975,139,115,117,192,168,360,477,592,731,7.08,1.74,1.41,1.14
18-11-2021,MONTALEGRE,18,1,203,"[120,240]",Moderado,,,,18,Norte,VILA REAL,1706,80545.71,8997,699,628,595,603,730,1333,1928,2556,3255,11.17,4.04,3.17,2.39
18-11-2021,MONTEMOR-O-NOVO,11,1,71,"[0,120]",Baixo a Moderado,,,,11,Alentejo,ÉVORA,0706,123296.65,15647,991,953,868,878,971,1849,2717,3670,4661,12.69,3.78,2.98,2.2
18-11-2021,MONTEMOR-O-VELHO,88,6,348,"[240,480]",Elevado,,,,88,Centro,COIMBRA,0610,22896.23,25224,1496,1397,1217,1057,988,2045,3262,4659,6155,110.17,26.88,20.35,14.25
18-11-2021,MONTIJO,94,7,164,"[120,240]",Moderado,,,,94,Lisboa e Vale do Tejo,SETÚBAL,1507,34861.64,57614,2771,2441,1990,1554,1109,2663,4653,7094,9865,165.26,28.3,20.35,13.35
18-11-2021,MORA,55,4,1338,"[960,Max]",Extremamente Elevado,,,,55,Alentejo,ÉVORA,0707,44395.02,4138,336,275,252,238,257,495,747,1022,1358,9.32,3.06,2.3,1.68
18-11-2021,MORTÁGUA,11,1,125,"[120,240]",Moderado,,,,11,Centro,VISEU,1808,25117.82,8803,638,584,535,499,460,959,1494,2078,2716,35.05,10.81,8.27,5.95
18-11-2021,MOURA,87,6,632,"[480,960]",Muito Elevado,,,,87,Alentejo,BEJA,0210,95845.55,13718,817,656,665,542,461,1003,1668,2324,3141,14.31,3.28,2.42,1.74
18-11-2021,MOURÃO,0,0,0,"[0,120]",Baixo a Moderado,,,,0,Alentejo,ÉVORA,0708,27862.98,2450,139,108,80,104,109,213,293,401,540,8.79,1.94,1.44,1.05
18-11-2021,MURÇA,54,4,982,"[960,Max]",Extremamente Elevado,,,,54,Norte,VILA REAL,1707,18937.11,5463,384,341,307,306,319,625,932,1273,1657,28.85,8.75,6.72,4.92
18-11-2021,MURTOSA,13,1,125,"[120,240]",Moderado,,,,13,Centro,AVEIRO,0112,7308.78,10279,509,473,403,353,409,762,1165,1638,2147,140.63,29.37,22.41,15.94
18-11-2021,NAZARÉ,106,8,750,"[480,960]",Muito Elevado,,,,106,Lisboa e Vale do Tejo,LEIRIA,1011,8243.43,14165,967,903,670,420,396,816,1486,2389,3356,171.84,40.71,28.98,18.03
18-11-2021,NELAS,17,1,131,"[120,240]",Moderado,,,,17,Centro,VISEU,1809,12571.48,12974,924,787,668,604,583,1187,1855,2642,3566,103.21,28.37,21.02,14.76
18-11-2021,NISA,9,1,151,"[120,240]",Moderado,,,,9,Alentejo,PORTALEGRE,1212,57567.84,6061,405,389,355,483,478,961,1316,1705,2110,10.53,3.67,2.96,2.29
18-11-2021,NORDESTE,0,0,0,"[0,120]",Baixo a Moderado,,,,0,Açores,AÇORES,4202,10146.8,4862,246,180,124,161,162,323,447,627,873,47.92,8.6,6.18,4.41
18-11-2021,ÓBIDOS,30,2,250,"[240,480]",Elevado,,,,30,Lisboa e Vale do Tejo,LEIRIA,1012,14155.44,11850,743,650,574,452,436,888,1462,2112,2855,83.72,20.17,14.92,10.33
18-11-2021,ODEMIRA,77,6,313,"[240,480]",Elevado,,,,77,Alentejo,BEJA,0211,172060.15,24717,1475,1317,1225,1397,1349,2746,3971,5288,6763,14.37,3.93,3.07,2.31
18-11-2021,ODIVELAS,175,12,108,"[0,120]",Baixo a Moderado,,,,175,Lisboa e Vale do Tejo,LISBOA,1116,2654.36,161774,9562,9038,6952,4641,3812,8453,15405,24443,34005,6095.48,1281.27,920.99,580.44
18-11-2021,OEIRAS,273,20,154,"[120,240]",Moderado,,,,273,Lisboa e Vale do Tejo,LISBOA,1110,4588.31,177408,11580,11575,8566,6211,5855,12066,20632,32207,43787,3866.78,954.38,701.98,449.69
18-11-2021,OLEIROS,3,0,60,"[0,120]",Baixo a Moderado,,,,3,Centro,CASTELO BRANCO,0506,47109.31,5003,384,341,366,397,487,884,1250,1591,1975,10.62,4.19,3.38,2.65
18-11-2021,OLHÃO,144,10,324,"[240,480]",Elevado,,,,144,Algarve,FARO,0810,13086.38,44405,2455,2309,1689,1342,1268,2610,4299,6608,9063,339.33,69.26,50.5,32.85
18-11-2021,OLIVEIRA DE AZEMÉIS,114,8,173,"[120,240]",Moderado,,,,114,Norte,AVEIRO,0113,16110.41,66011,4155,3614,2794,2183,1738,3921,6715,10329,14484,409.75,89.91,64.12,41.68
18-11-2021,OLIVEIRA DE FRADES,4,0,40,"[0,120]",Baixo a Moderado,,,,4,Centro,VISEU,1810,14534.62,9936,553,475,438,359,415,774,1212,1687,2240,68.36,15.41,11.61,8.34
18-11-2021,OLIVEIRA DO BAIRRO,47,3,194,"[120,240]",Moderado,,,,47,Centro,AVEIRO,0114,8731.99,24277,1327,1182,999,786,810,1596,2595,3777,5104,278.02,58.45,43.25,29.72
18-11-2021,OLIVEIRA DO HOSPITAL,15,1,78,"[0,120]",Baixo a Moderado,,,,15,Centro,COIMBRA,0611,23451.66,19253,1161,1097,962,924,960,1884,2846,3943,5104,82.1,21.76,16.81,12.14
18-11-2021,OURÉM,175,12,397,"[240,480]",Elevado,,,,175,Lisboa e Vale do Tejo,SANTARÉM,1421,41668.03,44044,2463,2069,1899,1817,1603,3420,5319,7388,9851,105.7,23.64,17.73,12.77
18-11-2021,OURIQUE,2,0,44,"[0,120]",Baixo a Moderado,,,,2,Alentejo,BEJA,0212,66331.36,4607,313,287,284,268,227,495,779,1066,1379,6.95,2.08,1.61,1.17
18-11-2021,OVAR,154,11,283,"[240,480]",Elevado,,,,154,Centro,AVEIRO,0115,14770.25,54260,3294,2709,1994,1636,1234,2870,4864,7573,10867,367.37,73.57,51.27,32.93
18-11-2021,PAÇOS DE FERREIRA,39,3,69,"[0,120]",Baixo a Moderado,,,,39,Norte,PORTO,1309,7099.29,56728,2903,2193,1518,1135,664,1799,3317,5510,8413,799.1,118.51,77.62,46.72
18-11-2021,PALMELA,113,8,176,"[120,240]",Moderado,,,,113,Lisboa e Vale do Tejo,SETÚBAL,1508,46512.01,64269,3402,3244,2635,1846,1391,3237,5872,9116,12518,138.18,26.91,19.6,12.62
18-11-2021,PAMPILHOSA DA SERRA,39,3,967,"[960,Max]",Extremamente Elevado,,,,39,Centro,COIMBRA,0612,39646.24,4037,238,254,295,339,423,762,1057,1311,1549,10.18,3.91,3.31,2.67
18-11-2021,PAREDES,43,3,50,"[0,120]",Baixo a Moderado,,,,43,Norte,PORTO,1310,15675.69,86067,4272,3532,2412,1717,1258,2975,5387,8919,13191,549.04,84.15,56.9,34.36
18-11-2021,PAREDES DE COURA,10,1,118,"[0,120]",Baixo a Moderado,,,,10,Norte,VIANA DO CASTELO,1605,13818.59,8535,466,528,407,465,515,980,1387,1915,2381,61.76,17.23,13.86,10.04
18-11-2021,PEDRÓGÃO GRANDE,10,1,293,"[240,480]",Elevado,,,,10,Centro,LEIRIA,1013,12874.75,3410,175,173,196,221,252,473,669,842,1017,26.49,7.9,6.54,5.2
18-11-2021,PENACOVA,15,1,110,"[0,120]",Baixo a Moderado,,,,15,Centro,COIMBRA,0613,21673.23,13694,968,923,745,621,703,1324,2069,2992,3960,63.18,18.27,13.81,9.55
18-11-2021,PENAFIEL,41,3,59,"[0,120]",Baixo a Moderado,,,,41,Norte,PORTO,1311,21224.27,69772,3648,2823,2032,1663,1230,2893,4925,7748,11396,328.74,53.69,36.51,23.2
18-11-2021,PENALVA DO CASTELO,25,2,350,"[240,480]",Elevado,,,,25,Centro,VISEU,1811,13433.92,7115,449,457,413,391,426,817,1230,1687,2136,52.96,15.9,12.56,9.16
18-11-2021,PENAMACOR,16,1,339,"[240,480]",Elevado,,,,16,Centro,CASTELO BRANCO,0507,56370.69,4755,262,248,273,451,633,1084,1357,1605,1867,8.44,3.31,2.85,2.41
18-11-2021,PENEDONO,4,0,156,"[120,240]",Moderado,,,,4,Norte,VISEU,1812,13370.75,2591,172,113,129,156,138,294,423,536,708,19.38,5.3,4.01,3.16
18-11-2021,PENELA,5,0,93,"[0,120]",Baixo a Moderado,,,,5,Centro,COIMBRA,0614,13480.0,5397,314,324,274,359,344,703,977,1301,1615,40.04,11.98,9.65,7.25
18-11-2021,PENICHE,111,8,419,"[240,480]",Elevado,,,,111,Lisboa e Vale do Tejo,LEIRIA,1014,7754.98,26501,1746,1504,1203,926,707,1633,2836,4340,6086,341.73,78.48,55.96,36.57
18-11-2021,PESO DA RÉGUA,17,1,108,"[0,120]",Baixo a Moderado,,,,17,Norte,VILA REAL,1708,9486.01,15773,1076,843,650,659,455,1114,1764,2607,3683,166.28,38.83,27.48,18.6
18-11-2021,PINHEL,4,0,47,"[0,120]",Baixo a Moderado,,,,4,Centro,GUARDA,0910,48452.12,8511,577,566,551,538,689,1227,1778,2344,2921,17.57,6.03,4.84,3.67
18-11-2021,POMBAL,107,8,207,"[120,240]",Moderado,,,,107,Centro,LEIRIA,1015,62600.28,51461,3187,2791,2494,2328,2027,4355,6849,9640,12827,82.21,20.49,15.4,10.94
18-11-2021,PONTA DELGADA,138,10,203,"[120,240]",Moderado,,,,138,Açores,AÇORES,4203,23298.65,67935,3108,2435,1726,1133,902,2035,3761,6196,9304,291.58,39.93,26.59,16.14
18-11-2021,PONTA DO SOL,15,1,175,"[120,240]",Moderado,,,,15,Madeira,MADEIRA,3105,4622.03,8593,319,283,347,208,221,429,776,1059,1378,185.92,29.81,22.91,16.79
18-11-2021,PONTE DA BARCA,23,2,207,"[120,240]",Moderado,,,,23,Norte,VIANA DO CASTELO,1606,18211.37,11180,635,576,517,554,490,1044,1561,2137,2772,61.39,15.22,11.73,8.57
18-11-2021,PONTE DE LIMA,102,7,248,"[240,480]",Elevado,,,,102,Norte,VIANA DO CASTELO,1607,32025.46,41315,2321,2022,1720,1596,1462,3058,4778,6800,9121,129.01,28.48,21.23,14.92
18-11-2021,PONTE DE SOR,8,1,54,"[0,120]",Baixo a Moderado,,,,8,Alentejo,PORTALEGRE,1213,83971.16,14994,939,800,716,739,831,1570,2286,3086,4025,17.86,4.79,3.68,2.72
18-11-2021,PORTALEGRE,35,3,160,"[120,240]",Moderado,,,,35,Alentejo,PORTALEGRE,1214,44713.64,22172,1577,1351,1137,993,984,1977,3114,4465,6042,49.59,13.51,9.99,6.96
18-11-2021,PORTEL,14,1,242,"[240,480]",Elevado,,,,14,Alentejo,ÉVORA,0709,60100.57,5828,336,358,283,331,305,636,919,1277,1613,9.7,2.68,2.12,1.53
18-11-2021,PORTIMÃO,274,20,493,"[480,960]",Muito Elevado,,,,274,Algarve,FARO,0811,18206.29,55483,3182,2927,2116,1582,1400,2982,5098,8025,11207,304.75,61.56,44.08,28.0
18-11-2021,PORTO,524,37,242,"[240,480]",Elevado,,,,524,Norte,PORTO,1312,4142.02,216606,15790,15193,11280,9409,10044,19453,30733,45926,61716,5229.5,1490.0,1108.79,741.98
18-11-2021,PORTO DE MÓS,63,4,270,"[240,480]",Elevado,,,,63,Centro,LEIRIA,1016,26183.41,23275,1355,1210,1034,888,872,1760,2794,4004,5359,88.89,20.47,15.29,10.67
18-11-2021,PORTO MONIZ,10,1,433,"[240,480]",Elevado,,,,10,Madeira,MADEIRA,3106,8293.38,2342,143,130,95,98,120,218,313,443,586,28.24,7.07,5.34,3.77
18-11-2021,PORTO SANTO,5,0,96,"[0,120]",Baixo a Moderado,,,,5,Madeira,MADEIRA,3201,4300.7,5202,240,157,134,110,68,178,312,469,709,120.95,16.48,10.9,7.25
18-11-2021,PÓVOA DE LANHOSO,7,1,33,"[0,120]",Baixo a Moderado,,,,7,Norte,BRAGA,0309,13465.29,21499,1175,909,732,673,624,1297,2029,2938,4113,159.67,30.55,21.82,15.07
18-11-2021,PÓVOA DE VARZIM,66,5,105,"[0,120]",Baixo a Moderado,,,,66,Norte,PORTO,1313,8220.59,62784,3712,3120,2134,1594,1305,2899,5033,8153,11865,763.7,144.33,99.17,61.22
18-11-2021,POVOAÇÃO,9,1,153,"[120,240]",Moderado,,,,9,Açores,AÇORES,4204,10640.77,5927,293,212,191,144,134,278,469,681,974,55.7,9.15,6.4,4.41
18-11-2021,VILA DA PRAIA DA VITÓRIA,2,0,9,"[0,120]",Baixo a Moderado,,,,2,Açores,AÇORES,4302,16127.06,21317,1133,789,619,436,336,772,1391,2180,3313,132.18,20.54,13.52,8.63
18-11-2021,PROENÇA-A-NOVA,8,1,110,"[0,120]",Baixo a Moderado,,,,8,Centro,CASTELO BRANCO,0508,39539.96,7298,508,465,389,400,560,960,1349,1814,2322,18.46,5.87,4.59,3.41
18-11-2021,REDONDO,20,1,318,"[240,480]",Elevado,,,,20,Alentejo,ÉVORA,0710,36950.87,6353,349,325,288,288,354,642,930,1255,1604,17.19,4.34,3.4,2.52
18-11-2021,REGUENGOS DE MONSARAZ,13,1,131,"[120,240]",Moderado,,,,13,Alentejo,ÉVORA,0711,46399.72,10015,602,511,455,462,473,935,1390,1901,2503,21.58,5.39,4.1,3.0
18-11-2021,RESENDE,10,1,100,"[0,120]",Baixo a Moderado,,,,10,Norte,VISEU,1813,12334.93,10137,560,493,448,433,422,855,1303,1796,2356,82.18,19.1,14.56,10.56
18-11-2021,RIBEIRA BRAVA,25,2,202,"[120,240]",Moderado,,,,25,Madeira,MADEIRA,3107,6544.88,12435,648,500,411,311,287,598,1009,1509,2157,189.99,32.96,23.06,15.42
18-11-2021,RIBEIRA DE PENA,7,1,117,"[0,120]",Baixo a Moderado,,,,7,Norte,VILA REAL,1709,21745.98,6016,371,301,290,310,368,678,968,1269,1640,27.66,7.54,5.84,4.45
18-11-2021,RIBEIRA GRANDE,43,3,131,"[120,240]",Moderado,,,,43,Açores,AÇORES,4205,18015.13,32811,1163,689,512,345,253,598,1110,1799,2962,182.13,16.44,9.99,6.16
18-11-2021,RIO MAIOR,46,3,227,"[120,240]",Moderado,,,,46,Lisboa e Vale do Tejo,SANTARÉM,1414,27276.45,20379,1251,1144,941,795,648,1443,2384,3528,4779,74.71,17.52,12.93,8.74
18-11-2021,SABROSA,1,0,17,"[0,120]",Baixo a Moderado,,,,1,Norte,VILA REAL,1710,15692.45,5918,393,314,304,302,350,652,956,1270,1663,37.71,10.6,8.09,6.09
18-11-2021,SABUGAL,17,1,162,"[120,240]",Moderado,,,,17,Centro,GUARDA,0911,82269.82,10585,724,707,694,796,1009,1805,2499,3206,3930,12.87,4.78,3.9,3.04
18-11-2021,SALVATERRA DE MAGOS,46,3,217,"[120,240]",Moderado,,,,46,Lisboa e Vale do Tejo,SANTARÉM,1415,24393.2,21295,1275,1181,1060,799,772,1571,2631,3812,5087,87.3,20.85,15.63,10.79
18-11-2021,SANTA COMBA DÃO,12,1,115,"[0,120]",Baixo a Moderado,,,,12,Centro,VISEU,1814,11194.77,10452,732,684,569,538,464,1002,1571,2255,2987,93.36,26.68,20.14,14.03
18-11-2021,SANTA CRUZ,111,8,245,"[240,480]",Elevado,,,,111,Madeira,MADEIRA,3108,8150.28,45281,1817,1301,974,716,523,1239,2213,3514,5331,555.6,65.41,43.12,27.15
18-11-2021,SANTA CRUZ DA GRACIOSA,18,1,431,"[240,480]",Elevado,,,,18,Açores,AÇORES,4401,6065.78,4208,228,180,163,124,145,269,432,612,840,69.37,13.85,10.09,7.12
18-11-2021,SANTA CRUZ DAS FLORES,5,0,231,"[120,240]",Moderado,,,,5,Açores,AÇORES,4802,7091.44,2165,125,98,74,56,51,107,181,279,404,30.53,5.7,3.93,2.55
18-11-2021,SANTA MARIA DA FEIRA,262,19,189,"[120,240]",Moderado,,,,262,Norte,AVEIRO,0109,21587.65,138636,8182,6743,4771,3856,3079,6935,11706,18449,26631,642.19,123.36,85.46,54.22
18-11-2021,SANTA MARTA DE PENAGUIÃO,4,0,61,"[0,120]",Baixo a Moderado,,,,4,Norte,VILA REAL,1711,6928.13,6599,483,373,337,316,317,633,970,1343,1826,95.25,26.36,19.39,14.0
18-11-2021,SANTANA,7,1,105,"[0,120]",Baixo a Moderado,,,,7,Madeira,MADEIRA,3109,9547.3,6711,418,353,343,282,277,559,902,1255,1673,70.29,17.52,13.15,9.45
18-11-2021,SANTARÉM,107,8,187,"[120,240]",Moderado,,,,107,Lisboa e Vale do Tejo,SANTARÉM,1416,55253.58,57421,3654,3441,2760,2466,2206,4672,7432,10873,14527,103.92,26.29,19.68,13.45
18-11-2021,SANTIAGO DO CACÉM,44,3,154,"[120,240]",Moderado,,,,44,Alentejo,SETÚBAL,1509,105969.29,28791,2144,1689,1472,1295,1215,2510,3982,5671,7815,27.17,7.37,5.35,3.76
18-11-2021,SANTO TIRSO,59,4,87,"[0,120]",Baixo a Moderado,,,,59,Norte,PORTO,1314,13655.52,68055,4911,3935,2761,2257,1810,4067,6828,10763,15674,498.35,114.78,78.82,50.0
18-11-2021,SÃO BRÁS DE ALPORTEL,12,1,116,"[0,120]",Baixo a Moderado,,,,12,Algarve,FARO,0812,15336.92,10416,596,468,467,404,401,805,1272,1740,2336,67.91,15.23,11.35,8.29
18-11-2021,SÃO JOÃO DA MADEIRA,40,3,181,"[120,240]",Moderado,,,,40,Norte,AVEIRO,0116,794.3,21958,1347,1069,796,601,593,1194,1990,3059,4406,2765.49,554.91,385.26,250.63
18-11-2021,SÃO JOÃO DA PESQUEIRA,59,4,822,"[480,960]",Muito Elevado,,,,59,Norte,VISEU,1815,26610.85,7125,417,330,294,328,328,656,950,1280,1697,26.77,6.38,4.81,3.57
18-11-2021,SÃO PEDRO DO SUL,66,5,428,"[240,480]",Elevado,,,,66,Centro,VISEU,1816,34895.09,15403,990,962,861,759,909,1668,2529,3491,4481,44.14,12.84,10.0,7.25
18-11-2021,SÃO ROQUE DO PICO,3,0,92,"[0,120]",Baixo a Moderado,,,,3,Açores,AÇORES,4603,14236.1,3266,199,141,93,96,113,209,302,443,642,22.94,4.51,3.11,2.12
18-11-2021,SÃO VICENTE,14,1,274,"[240,480]",Elevado,,,,14,Madeira,MADEIRA,3110,7883.71,5143,272,264,266,225,280,505,771,1035,1307,65.23,16.58,13.13,9.78
18-11-2021,SARDOAL,0,0,0,"[0,120]",Baixo a Moderado,,,,0,Lisboa e Vale do Tejo,SANTARÉM,1417,9214.72,3741,227,178,148,165,248,413,561,739,966,40.6,10.48,8.02,6.09
18-11-2021,SÁTÃO,26,2,223,"[120,240]",Moderado,,,,26,Centro,VISEU,1817,20194.11,11580,765,671,515,465,476,941,1456,2127,2892,57.34,14.32,10.53,7.21
18-11-2021,SEIA,36,3,162,"[120,240]",Moderado,,,,36,Centro,GUARDA,0912,43568.83,22234,1807,1589,1238,1122,721,1843,3081,4670,6477,51.03,14.87,10.72,7.07
18-11-2021,SEIXAL,252,18,150,"[120,240]",Moderado,,,,252,Lisboa e Vale do Tejo,SETÚBAL,1510,9545.17,167752,10586,9270,6661,4391,2930,7321,13982,23252,33838,1757.49,354.51,243.6,146.49
18-11-2021,SERNANCELHE,40,3,744,"[480,960]",Muito Elevado,,,,40,Norte,VISEU,1818,22861.22,5396,305,293,286,273,260,533,819,1112,1417,23.6,6.2,4.86,3.58
18-11-2021,SERPA,61,4,423,"[240,480]",Elevado,,,,61,Alentejo,BEJA,0213,110563.34,14304,903,761,719,697,626,1323,2042,2803,3706,12.94,3.35,2.54,1.85
18-11-2021,SERTÃ,25,2,172,"[120,240]",Moderado,,,,25,Centro,CASTELO BRANCO,0509,44673.17,14577,870,779,790,767,1020,1787,2577,3356,4226,32.63,9.46,7.51,5.77
18-11-2021,SESIMBRA,81,6,156,"[120,240]",Moderado,,,,81,Lisboa e Vale do Tejo,SETÚBAL,1511,19571.75,51858,2400,2321,1853,1257,1083,2340,4193,6514,8914,264.96,45.54,33.28,21.42
18-11-2021,SETÚBAL,198,14,172,"[120,240]",Moderado,,,,198,Lisboa e Vale do Tejo,SETÚBAL,1512,23032.5,115126,7425,6929,5075,3775,2655,6430,11505,18434,25859,499.83,112.27,80.03,49.95
18-11-2021,SEVER DO VOUGA,3,0,27,"[0,120]",Baixo a Moderado,,,,3,Centro,AVEIRO,0117,12987.56,11331,766,637,568,540,567,1107,1675,2312,3078,87.24,23.7,17.8,12.9
18-11-2021,SILVES,99,7,273,"[240,480]",Elevado,,,,99,Algarve,FARO,0813,68006.23,36226,2137,1869,1610,1423,1600,3023,4633,6502,8639,53.27,12.7,9.56,6.81
18-11-2021,SINES,14,1,102,"[0,120]",Baixo a Moderado,,,,14,Alentejo,SETÚBAL,1513,20330.17,13715,888,791,551,416,268,684,1235,2026,2914,67.46,14.33,9.97,6.07
18-11-2021,SINTRA,552,39,141,"[120,240]",Moderado,,,,552,Lisboa e Vale do Tejo,LISBOA,1111,31922.73,391402,20490,18316,13545,9137,7284,16421,29966,48282,68772,1226.08,215.43,151.25,93.87
18-11-2021,SOBRAL DE MONTE AGRAÇO,0,0,0,"[0,120]",Baixo a Moderado,,,,0,Lisboa e Vale do Tejo,LISBOA,1112,5210.32,10651,564,507,352,272,212,484,836,1343,1907,204.43,36.6,25.78,16.05
18-11-2021,SOURE,49,4,287,"[240,480]",Elevado,,,,49,Centro,COIMBRA,0615,26506.07,17120,1173,1142,1004,883,987,1870,2874,4016,5189,64.59,19.58,15.15,10.84
18-11-2021,SOUSEL,3,0,69,"[0,120]",Baixo a Moderado,,,,3,Alentejo,PORTALEGRE,1215,27932.18,4412,261,274,208,302,292,594,802,1076,1337,15.8,4.79,3.85,2.87
18-11-2021,TÁBUA,16,1,140,"[120,240]",Moderado,,,,16,Centro,COIMBRA,0616,19978.58,11368,729,584,524,430,464,894,1418,2002,2731,56.9,13.67,10.02,7.1
18-11-2021,TABUAÇO,6,0,100,"[0,120]",Baixo a Moderado,,,,6,Norte,VISEU,1819,13385.67,6033,372,314,217,282,363,645,862,1176,1548,45.07,11.56,8.79,6.44
18-11-2021,TAROUCA,5,0,64,"[0,120]",Baixo a Moderado,,,,5,Norte,VISEU,1820,10008.49,7804,405,335,313,277,324,601,914,1249,1654,77.98,16.53,12.48,9.13
18-11-2021,TAVIRA,52,4,214,"[120,240]",Moderado,,,,52,Algarve,FARO,0814,60696.7,24530,1493,1415,1252,1066,1277,2343,3595,5010,6503,40.41,10.71,8.25,5.92
18-11-2021,TERRAS DE BOURO,38,3,602,"[480,960]",Muito Elevado,,,,38,Norte,BRAGA,0310,27746.07,6361,391,372,296,319,340,659,955,1327,1718,22.93,6.19,4.78,3.44
18-11-2021,TOMAR,83,6,226,"[120,240]",Moderado,,,,83,Lisboa e Vale do Tejo,SANTARÉM,1418,35120.44,36748,2403,2189,1868,1853,1822,3675,5543,7732,10135,104.64,28.86,22.02,15.78
18-11-2021,TONDELA,71,5,269,"[240,480]",Elevado,,,,71,Centro,VISEU,1821,37121.73,26357,1768,1722,1518,1475,1417,2892,4410,6132,7900,71.0,21.28,16.52,11.88
18-11-2021,TORRE DE MONCORVO,17,1,223,"[120,240]",Moderado,,,,17,Norte,BRAGANÇA,0409,53155.67,7695,556,478,488,551,719,1270,1758,2236,2792,14.48,5.25,4.21,3.31
18-11-2021,TORRES NOVAS,206,15,590,"[480,960]",Muito Elevado,,,,206,Lisboa e Vale do Tejo,SANTARÉM,1419,26999.68,34933,2324,1979,1738,1406,1475,2881,4619,6598,8922,129.38,33.04,24.44,17.11
18-11-2021,TORRES VEDRAS,90,6,115,"[0,120]",Baixo a Moderado,,,,90,Lisboa e Vale do Tejo,LISBOA,1113,40714.89,78530,4513,3945,3447,2628,2104,4732,8179,12124,16637,192.88,40.86,29.78,20.09
18-11-2021,TRANCOSO,13,1,146,"[120,240]",Moderado,,,,13,Centro,GUARDA,0913,36152.47,8875,581,557,542,586,496,1082,1624,2181,2762,24.55,7.64,6.03,4.49
18-11-2021,TROFA,40,3,104,"[0,120]",Baixo a Moderado,,,,40,Norte,PORTO,1318,7201.76,38418,2336,1894,1231,939,684,1623,2854,4748,7084,533.44,98.36,65.93,39.63
18-11-2021,VAGOS,58,4,257,"[240,480]",Elevado,,,,58,Centro,AVEIRO,0118,16491.5,22740,1320,1205,922,784,724,1508,2430,3635,4955,137.89,30.04,22.04,14.73
18-11-2021,VALE DE CAMBRA,61,4,288,"[240,480]",Elevado,,,,61,Norte,AVEIRO,0119,14733.47,21327,1491,1363,1005,831,798,1629,2634,3997,5488,144.76,37.25,27.13,17.88
18-11-2021,VALENÇA,26,2,197,"[120,240]",Moderado,,,,26,Norte,VIANA DO CASTELO,1608,11712.86,13290,867,791,582,582,503,1085,1667,2458,3325,113.46,28.39,20.99,14.23
18-11-2021,VALONGO,103,7,106,"[0,120]",Baixo a Moderado,,,,103,Norte,PORTO,1315,7512.45,97444,5629,4696,3207,2462,1829,4291,7498,12194,17823,1297.18,237.26,162.33,99.81
18-11-2021,VALPAÇOS,19,1,130,"[120,240]",Moderado,,,,19,Norte,VILA REAL,1712,54873.93,14818,1217,1118,999,928,997,1925,2924,4042,5259,27.0,9.58,7.37,5.33
18-11-2021,VELAS,14,1,276,"[240,480]",Elevado,,,,14,Açores,AÇORES,4502,11738.38,5093,278,208,166,153,113,266,432,640,918,43.39,7.82,5.45,3.68
18-11-2021,VENDAS NOVAS,6,0,54,"[0,120]",Baixo a Moderado,,,,6,Alentejo,ÉVORA,0712,22238.88,11255,677,768,655,501,532,1033,1688,2456,3133,50.61,14.09,11.04,7.59
18-11-2021,VIANA DO ALENTEJO,13,1,255,"[240,480]",Elevado,,,,13,Alentejo,ÉVORA,0713,39367.29,5145,245,208,235,210,214,424,659,867,1112,13.07,2.82,2.2,1.67
18-11-2021,VIANA DO CASTELO,149,11,177,"[120,240]",Moderado,,,,149,Norte,VIANA DO CASTELO,1609,31902.01,84417,5470,4433,3591,3061,2982,6043,9634,14067,19537,264.61,61.24,44.09,30.2
18-11-2021,VIDIGUEIRA,1,0,18,"[0,120]",Baixo a Moderado,,,,1,Alentejo,BEJA,0214,31661.09,5510,300,248,215,233,275,508,723,971,1271,17.4,4.01,3.07,2.28
18-11-2021,VIEIRA DO MINHO,5,0,42,"[0,120]",Baixo a Moderado,,,,5,Norte,BRAGA,0311,21644.35,11842,703,594,525,548,482,1030,1555,2149,2852,54.71,13.18,9.93,7.18
18-11-2021,VILA DE REI,2,0,60,"[0,120]",Baixo a Moderado,,,,2,Centro,CASTELO BRANCO,0510,19154.6,3323,169,128,172,247,302,549,721,849,1018,17.35,5.31,4.43,3.76
18-11-2021,VILA DO BISPO,10,1,194,"[120,240]",Moderado,,,,10,Algarve,FARO,0815,17906.06,5154,302,302,314,232,233,465,779,1081,1383,28.78,7.72,6.04,4.35
18-11-2021,VILA DO CONDE,84,6,105,"[0,120]",Baixo a Moderado,,,,84,Norte,PORTO,1316,14902.77,79899,4726,3875,2819,2070,1743,3813,6632,10507,15233,536.13,102.21,70.5,44.5
18-11-2021,VILA DO PORTO,4,0,71,"[0,120]",Baixo a Moderado,,,,4,Açores,AÇORES,4101,9688.74,5616,274,212,135,96,123,219,354,566,840,57.96,8.67,5.84,3.65
18-11-2021,VILA FLOR,15,1,250,"[240,480]",Elevado,,,,15,Norte,BRAGANÇA,0410,26581.14,6044,429,362,422,294,331,625,1047,1409,1838,22.74,6.91,5.3,3.94
18-11-2021,VILA FRANCA DE XIRA,152,11,107,"[0,120]",Baixo a Moderado,,,,152,Lisboa e Vale do Tejo,LISBOA,1114,31819.39,141957,8501,6852,4869,3425,2472,5897,10766,17618,26119,446.14,82.09,55.37,33.84
18-11-2021,VILA FRANCA DO CAMPO,4,0,36,"[0,120]",Baixo a Moderado,,,,4,Açores,AÇORES,4206,7796.82,11051,450,344,248,217,154,371,619,963,1413,141.73,18.12,12.35,7.94
18-11-2021,VILA NOVA DA BARQUINHA,34,2,450,"[240,480]",Elevado,,,,34,Lisboa e Vale do Tejo,SANTARÉM,1420,4952.97,7461,415,406,392,364,338,702,1094,1500,1915,150.64,38.66,30.28,22.09
18-11-2021,VILA NOVA DE CERVEIRA,5,0,56,"[0,120]",Baixo a Moderado,,,,5,Norte,VIANA DO CASTELO,1610,10846.66,8910,531,444,410,384,334,718,1128,1572,2103,82.14,19.39,14.49,10.4
18-11-2021,VILA NOVA DE FAMALICÃO,91,6,69,"[0,120]",Baixo a Moderado,,,,91,Norte,BRAGA,0312,20159.26,131676,7817,6164,4202,3282,2749,6031,10233,16397,24214,653.19,120.12,81.34,50.76
18-11-2021,VILA NOVA DE FOZ CÔA,6,0,93,"[0,120]",Baixo a Moderado,,,,6,Centro,GUARDA,0914,39815.18,6503,442,385,390,398,429,827,1217,1602,2044,16.33,5.13,4.02,3.06
18-11-2021,VILA NOVA DE GAIA,475,34,158,"[120,240]",Moderado,,,,475,Norte,PORTO,1317,16846.43,300472,18349,15568,10972,8224,6281,14505,25477,41045,59394,1783.64,352.57,243.65,151.23
18-11-2021,VILA NOVA DE PAIVA,3,0,64,"[0,120]",Baixo a Moderado,,,,3,Centro,VISEU,1822,17553.28,4687,289,272,233,217,241,458,691,963,1252,26.7,7.13,5.49,3.94
18-11-2021,VILA NOVA DE POIARES,3,0,43,"[0,120]",Baixo a Moderado,,,,3,Centro,COIMBRA,0617,8445.3,6939,380,284,262,235,182,417,679,963,1343,82.17,15.9,11.4,8.04
18-11-2021,VILA POUCA DE AGUIAR,6,0,51,"[0,120]",Baixo a Moderado,,,,6,Norte,VILA REAL,1713,43706.62,11961,860,817,733,601,627,1228,1961,2778,3638,27.37,8.32,6.36,4.49
18-11-2021,VILA REAL,77,5,154,"[120,240]",Moderado,,,,77,Norte,VILA REAL,1714,37880.28,49962,3025,2498,2065,1579,1466,3045,5110,7608,10633,131.9,28.07,20.08,13.49
18-11-2021,VILA REAL DE SANTO ANTÓNIO,29,2,156,"[120,240]",Moderado,,,,29,Algarve,FARO,0816,6125.0,18749,1172,1069,811,569,586,1155,1966,3035,4207,306.11,68.69,49.55,32.1
18-11-2021,VILA VELHA DE RÓDÃO,22,2,700,"[480,960]",Muito Elevado,,,,22,Centro,CASTELO BRANCO,0511,32991.16,3144,209,229,180,283,306,589,769,998,1207,9.53,3.66,3.03,2.33
18-11-2021,VILA VERDE,39,3,83,"[0,120]",Baixo a Moderado,,,,39,Norte,BRAGA,0313,22866.52,46911,2365,2063,1667,1494,1437,2931,4598,6661,9026,205.15,39.47,29.13,20.11
18-11-2021,VILA VIÇOSA,4,0,53,"[0,120]",Baixo a Moderado,,,,4,Alentejo,ÉVORA,0714,19485.89,7656,487,379,342,345,324,669,1011,1390,1877,39.29,9.63,7.13,5.19
18-11-2021,VIMIOSO,27,2,682,"[480,960]",Muito Elevado,,,,27,Norte,BRAGANÇA,0411,48158.51,4023,274,230,261,293,335,628,889,1119,1393,8.35,2.89,2.32,1.85
18-11-2021,VINHAIS,64,5,828,"[480,960]",Muito Elevado,,,,64,Norte,BRAGANÇA,0412,69475.09,7746,599,577,636,641,815,1456,2092,2669,3268,11.15,4.7,3.84,3.01
18-11-2021,VISEU,337,24,347,"[240,480]",Elevado,,,,337,Centro,VISEU,1823,50710.14,97249,5769,5038,4140,3158,2710,5868,10008,15046,20815,191.77,41.05,29.67,19.74
18-11-2021,VIZELA,20,1,84,"[0,120]",Baixo a Moderado,,,,20,Norte,BRAGA,0314,2469.83,23897,1258,928,655,509,371,880,1535,2463,3721,967.49,150.65,99.72,62.15
18-11-2021,VOUZELA,7,1,73,"[0,120]",Baixo a Moderado,,,,7,Centro,VISEU,1824,19369.46,9619,626,605,554,532,507,1039,1593,2198,2824,49.66,14.58,11.35,8.22
25-11-2021,ABRANTES,73,5,209,"[120,240]",Moderado,,,,73,Lisboa e Vale do Tejo,SANTARÉM,1401,71469.08,35130,2473,2213,1730,1748,2021,3769,5499,7712,10185,49.15,14.25,10.79,7.69
25-11-2021,ÁGUEDA,180,13,391,"[240,480]",Elevado,,,,180,Centro,AVEIRO,0101,33527.44,46075,3237,2713,2090,1635,1496,3131,5221,7934,11171,137.43,33.32,23.66,15.57
25-11-2021,AGUIAR DA BEIRA,2,0,43,"[0,120]",Baixo a Moderado,,,,2,Centro,GUARDA,0901,20676.57,4652,304,281,235,239,148,387,622,903,1207,22.5,5.84,4.37,3.01
25-11-2021,ALANDROAL,1,0,20,"[0,120]",Baixo a Moderado,,,,1,Alentejo,ÉVORA,0701,54267.81,4992,307,256,296,299,377,676,972,1228,1535,9.2,2.83,2.26,1.79
25-11-2021,ALBERGARIA-A-VELHA,59,4,243,"[240,480]",Elevado,,,,59,Centro,AVEIRO,0102,15882.5,24144,1550,1298,996,687,680,1367,2363,3661,5211,152.02,32.81,23.05,14.88
25-11-2021,ALBUFEIRA,187,13,451,"[240,480]",Elevado,,,,187,Algarve,FARO,0801,14066.42,41528,2067,1717,1425,985,858,1843,3268,4985,7052,295.24,50.14,35.44,23.23
25-11-2021,ALCÁCER DO SAL,22,2,191,"[120,240]",Moderado,,,,22,Alentejo,SETÚBAL,1501,149987.3,11659,884,814,623,623,602,1225,1848,2662,3546,7.77,2.36,1.77,1.23
25-11-2021,ALCANENA,32,2,249,"[240,480]",Elevado,,,,32,Lisboa e Vale do Tejo,SANTARÉM,1402,12732.86,12809,891,744,628,536,588,1124,1752,2496,3387,100.6,26.6,19.6,13.76
25-11-2021,ALCOBAÇA,231,17,432,"[240,480]",Elevado,,,,231,Lisboa e Vale do Tejo,LEIRIA,1001,40814.09,53555,3420,2927,2466,2059,1676,3735,6201,9128,12548,131.22,30.74,22.36,15.19
25-11-2021,ALCOCHETE,48,3,241,"[240,480]",Elevado,,,,48,Lisboa e Vale do Tejo,SETÚBAL,1502,12836.48,19787,857,834,691,476,447,923,1614,2448,3305,154.15,25.75,19.07,12.57
25-11-2021,ALCOUTIM,1,0,48,"[0,120]",Baixo a Moderado,,,,1,Algarve,FARO,0802,57536.33,2159,191,188,163,190,267,457,620,808,999,3.75,1.74,1.4,1.08
25-11-2021,ALENQUER,86,6,195,"[120,240]",Moderado,,,,86,Lisboa e Vale do Tejo,LISBOA,1101,30421.92,44052,2298,2062,1629,1330,1155,2485,4114,6176,8474,144.8,27.85,20.3,13.52
25-11-2021,ALFÂNDEGA DA FÉ,4,0,89,"[0,120]",Baixo a Moderado,,,,4,Norte,BRAGANÇA,0401,32194.64,4550,325,277,301,274,325,599,900,1177,1502,14.13,4.67,3.66,2.8
25-11-2021,ALIJÓ,32,2,304,"[240,480]",Elevado,,,,32,Norte,VILA REAL,1701,29759.89,10625,766,687,635,542,666,1208,1843,2530,3296,35.7,11.08,8.5,6.19
25-11-2021,ALJEZUR,13,1,232,"[120,240]",Moderado,,,,13,Algarve,FARO,0803,32349.95,5594,316,336,335,320,410,730,1065,1401,1717,17.29,5.31,4.33,3.29
25-11-2021,ALJUSTREL,9,1,111,"[0,120]",Baixo a Moderado,,,,9,Alentejo,BEJA,0201,45847.41,8247,635,521,443,347,358,705,1148,1669,2304,17.99,5.03,3.64,2.5
25-11-2021,ALMADA,541,39,320,"[240,480]",Elevado,,,,541,Lisboa e Vale do Tejo,SETÚBAL,1503,7000.89,169039,10469,9777,7876,6144,5111,11255,19131,28908,39377,2414.5,562.45,412.91,273.26
25-11-2021,ALMEIDA,13,1,225,"[120,240]",Moderado,,,,13,Centro,GUARDA,0902,51798.46,5830,441,419,396,458,393,851,1247,1666,2107,11.26,4.07,3.22,2.41
25-11-2021,ALMEIRIM,99,7,441,"[240,480]",Elevado,,,,99,Lisboa e Vale do Tejo,SANTARÉM,1403,22212.05,22546,1342,1353,1106,866,843,1709,2815,4168,5510,101.5,24.81,18.76,12.67
25-11-2021,ALMODÔVAR,2,0,30,"[0,120]",Baixo a Moderado,,,,2,Alentejo,BEJA,0202,77788.03,6725,414,443,396,373,328,701,1097,1540,1954,8.65,2.51,1.98,1.41
25-11-2021,ALPIARÇA,64,5,902,"[480,960]",Muito Elevado,,,,64,Lisboa e Vale do Tejo,SANTARÉM,1404,9536.33,7059,515,486,363,333,274,607,970,1456,1971,74.02,20.67,15.27,10.17
25-11-2021,ALTER DO CHÃO,0,0,0,"[0,120]",Baixo a Moderado,,,,0,Alentejo,PORTALEGRE,1201,36206.62,3165,201,163,136,208,187,395,531,694,895,8.74,2.47,1.92,1.47
25-11-2021,ALVAIÁZERE,17,1,258,"[240,480]",Elevado,,,,17,Centro,LEIRIA,1002,16047.76,6597,419,389,346,406,539,945,1291,1680,2099,41.11,13.08,10.47,8.04
25-11-2021,ALVITO,1,0,41,"[0,120]",Baixo a Moderado,,,,1,Alentejo,BEJA,0203,26485.32,2477,145,110,105,111,89,200,305,415,560,9.35,2.11,1.57,1.15
25-11-2021,AMADORA,377,27,205,"[120,240]",Moderado,,,,377,Lisboa e Vale do Tejo,LISBOA,1115,2378.47,184106,11186,10936,8780,6460,5890,12350,21130,32066,43252,7742.05,1818.84,1348.44,888.56
25-11-2021,AMARANTE,147,10,276,"[240,480]",Elevado,,,,147,Norte,PORTO,1301,30133.15,53193,3086,2413,1812,1643,1311,2954,4766,7179,10265,176.53,34.07,23.82,15.82
25-11-2021,AMARES,40,3,221,"[120,240]",Moderado,,,,40,Norte,BRAGA,0301,8195.41,18129,1001,829,622,489,524,1013,1635,2464,3465,221.22,42.28,30.07,19.95
25-11-2021,ANADIA,125,9,460,"[240,480]",Elevado,,,,125,Centro,AVEIRO,0103,21663.48,27258,1931,1698,1376,1208,1262,2470,3846,5544,7475,125.83,34.51,25.59,17.75
25-11-2021,ANGRA DO HEROÍSMO,21,1,62,"[0,120]",Baixo a Moderado,,,,21,Açores,AÇORES,4301,23899.66,33807,2006,1473,1122,768,635,1403,2525,3998,6004,141.45,25.12,16.73,10.56
25-11-2021,ANSIÃO,65,5,539,"[480,960]",Muito Elevado,,,,65,Centro,LEIRIA,1003,17609.42,12039,727,709,646,694,530,1224,1870,2579,3306,68.37,18.77,14.65,10.62
25-11-2021,ARCOS DE VALDEVEZ,27,2,130,"[120,240]",Moderado,,,,27,Norte,VIANA DO CASTELO,1601,44759.64,20926,1329,1338,1282,1343,1515,2858,4140,5478,6807,46.75,15.21,12.24,9.25
25-11-2021,ARGANIL,14,1,127,"[120,240]",Moderado,,,,14,Centro,COIMBRA,0601,33283.93,11014,672,648,612,559,596,1155,1767,2415,3087,33.09,9.27,7.26,5.31
25-11-2021,ARMAMAR,2,0,35,"[0,120]",Baixo a Moderado,,,,2,Norte,VISEU,1801,11723.73,5769,357,305,309,285,310,595,904,1209,1566,49.21,13.36,10.31,7.71
25-11-2021,AROUCA,43,3,209,"[120,240]",Moderado,,,,43,Norte,AVEIRO,0104,32910.52,20720,1306,1047,753,683,683,1366,2119,3166,4472,62.96,13.59,9.62,6.44
25-11-2021,ARRAIOLOS,5,0,73,"[0,120]",Baixo a Moderado,,,,5,Alentejo,ÉVORA,0702,68374.55,6928,435,384,283,367,480,847,1130,1514,1949,10.13,2.85,2.21,1.65
25-11-2021,ARRONCHES,1,0,36,"[0,120]",Baixo a Moderado,,,,1,Alentejo,PORTALEGRE,1202,31464.72,2820,155,142,162,187,179,366,528,670,825,8.96,2.62,2.13,1.68
25-11-2021,ARRUDA DOS VINHOS,13,1,82,"[0,120]",Baixo a Moderado,,,,13,Lisboa e Vale do Tejo,LISBOA,1102,7795.93,15412,738,738,562,509,438,947,1509,2247,2985,197.69,38.29,28.82,19.36
25-11-2021,AVEIRO,280,20,355,"[240,480]",Elevado,,,,280,Centro,AVEIRO,0105,19757.57,78734,4520,4004,3050,2250,2103,4353,7403,11407,15927,398.49,80.61,57.73,37.47
25-11-2021,AVIS,2,0,48,"[0,120]",Baixo a Moderado,,,,2,Alentejo,PORTALEGRE,1203,60596.51,4247,315,225,206,251,273,524,730,955,1270,7.01,2.1,1.58,1.2
25-11-2021,AZAMBUJA,47,3,206,"[120,240]",Moderado,,,,47,Lisboa e Vale do Tejo,LISBOA,1103,26265.65,22716,1322,1171,1070,798,618,1416,2486,3657,4979,86.48,18.96,13.92,9.46
25-11-2021,BAIÃO,31,2,167,"[120,240]",Moderado,,,,31,Norte,PORTO,1302,17452.83,18748,1070,862,714,686,725,1411,2125,2987,4057,107.42,23.25,17.11,12.18
25-11-2021,BARCELOS,216,15,186,"[120,240]",Moderado,,,,216,Norte,BRAGA,0302,37890.14,116187,6721,5325,3619,2991,2562,5553,9172,14497,21218,306.64,56.0,38.26,24.21
25-11-2021,BARRANCOS,52,4,3204,"[960,Max]",Extremamente Elevado,,,,52,Alentejo,BEJA,0204,16841.73,1634,90,65,65,94,61,155,220,285,375,9.7,2.23,1.69,1.31
25-11-2021,BARREIRO,239,17,318,"[240,480]",Elevado,,,,239,Lisboa e Vale do Tejo,SETÚBAL,1504,3639.07,75147,5194,5565,4459,3105,1767,4872,9331,14896,20090,2065.05,552.07,409.34,256.42
25-11-2021,BATALHA,122,9,767,"[480,960]",Muito Elevado,,,,122,Centro,LEIRIA,1004,10341.6,15963,873,762,649,529,549,1078,1727,2489,3362,154.35,32.51,24.07,16.7
25-11-2021,BEJA,162,12,483,"[480,960]",Muito Elevado,,,,162,Alentejo,BEJA,0205,114647.55,33579,2005,1840,1386,1272,1039,2311,3697,5537,7542,29.29,6.58,4.83,3.22
25-11-2021,BELMONTE,21,2,329,"[240,480]",Elevado,,,,21,Centro,CASTELO BRANCO,0501,11875.91,6398,444,321,325,310,355,665,990,1311,1755,53.87,14.78,11.04,8.34
25-11-2021,BENAVENTE,94,7,306,"[240,480]",Elevado,,,,94,Lisboa e Vale do Tejo,SANTARÉM,1405,52138.39,30602,1468,1376,1141,876,643,1519,2660,4036,5504,58.69,10.56,7.74,5.1
25-11-2021,BOMBARRAL,25,2,197,"[120,240]",Moderado,,,,25,Lisboa e Vale do Tejo,LEIRIA,1005,9128.55,12558,875,714,561,491,429,920,1481,2195,3070,137.56,33.63,24.04,16.22
25-11-2021,BORBA,26,2,390,"[240,480]",Elevado,,,,26,Alentejo,ÉVORA,0703,14518.65,6736,430,375,279,436,392,828,1107,1482,1912,46.39,13.17,10.21,7.62
25-11-2021,BOTICAS,4,0,81,"[0,120]",Baixo a Moderado,,,,4,Norte,VILA REAL,1702,32195.66,4998,347,306,311,305,380,685,996,1302,1649,15.52,5.12,4.04,3.09
25-11-2021,BRAGA,754,54,413,"[240,480]",Elevado,,,,754,Norte,BRAGA,0303,18339.95,182679,10029,7963,5241,4320,3671,7991,13232,21195,31224,996.07,170.25,115.57,72.15
25-11-2021,BRAGANÇA,235,17,700,"[480,960]",Muito Elevado,,,,235,Norte,BRAGANÇA,0402,117357.27,33607,2402,1855,1652,1393,1163,2556,4208,6063,8465,28.64,7.21,5.17,3.59
25-11-2021,CABECEIRAS DE BASTO,13,1,84,"[0,120]",Baixo a Moderado,,,,13,Norte,BRAGA,0304,24182.16,15628,774,594,544,575,574,1149,1693,2287,3061,64.63,12.66,9.46,7.0
25-11-2021,CADAVAL,17,1,124,"[120,240]",Moderado,,,,17,Lisboa e Vale do Tejo,LISBOA,1104,17489.3,13673,813,796,756,621,625,1246,2002,2798,3611,78.18,20.65,16.0,11.45
25-11-2021,CALDAS DA RAINHA,213,15,410,"[240,480]",Elevado,,,,213,Lisboa e Vale do Tejo,LEIRIA,1006,25569.47,51912,3035,2684,2186,1899,1705,3604,5790,8474,11509,203.03,45.01,33.14,22.64
25-11-2021,CALHETA,32,2,295,"[240,480]",Elevado,,,,32,Madeira,MADEIRA,3101,11150.43,10867,576,497,507,399,415,814,1321,1818,2394,97.46,21.47,16.3,11.85
25-11-2021,CALHETA (AÇORES),3,0,95,"[0,120]",Baixo a Moderado,,,,3,Açores,AÇORES,4501,12626.4,3184,215,159,141,139,122,261,402,561,776,25.22,6.15,4.44,3.18
25-11-2021,CÂMARA DE LOBOS,156,11,464,"[240,480]",Elevado,,,,156,Madeira,MADEIRA,3102,5216.67,33675,1396,1059,834,545,381,926,1760,2819,4215,645.49,80.79,54.03,33.74
25-11-2021,CAMINHA,13,1,82,"[0,120]",Baixo a Moderado,,,,13,Norte,VIANA DO CASTELO,1602,13652.14,15877,1046,944,818,646,656,1302,2120,3064,4110,116.3,30.11,22.44,15.53
25-11-2021,CAMPO MAIOR,20,1,257,"[240,480]",Elevado,,,,20,Alentejo,PORTALEGRE,1204,24720.16,7874,471,364,351,279,327,606,957,1321,1792,31.85,7.25,5.34,3.87
25-11-2021,CANTANHEDE,125,9,356,"[240,480]",Elevado,,,,125,Centro,COIMBRA,0602,39088.02,35011,2346,2096,1880,1709,1451,3160,5040,7136,9482,89.57,24.26,18.26,12.89
25-11-2021,CARRAZEDA DE ANSIÃES,14,1,250,"[240,480]",Elevado,,,,14,Norte,BRAGANÇA,0403,27924.09,5666,424,389,391,312,465,777,1168,1557,1981,20.29,7.09,5.58,4.18
25-11-2021,CARREGAL DO SAL,20,1,215,"[120,240]",Moderado,,,,20,Centro,VISEU,1802,11689.21,9271,587,562,486,462,376,838,1324,1886,2473,79.31,21.16,16.13,11.33
25-11-2021,CARTAXO,88,6,370,"[240,480]",Elevado,,,,88,Lisboa e Vale do Tejo,SANTARÉM,1406,15817.28,23843,1415,1376,1142,861,632,1493,2635,4011,5426,150.74,34.3,25.36,16.66
25-11-2021,CASCAIS,592,42,277,"[240,480]",Elevado,,,,592,Lisboa e Vale do Tejo,LISBOA,1105,9740.17,213608,12151,11444,8680,6469,5248,11717,20397,31841,43992,2193.1,451.66,326.91,209.41
25-11-2021,CASTANHEIRA DE PÊRA,6,0,233,"[120,240]",Moderado,,,,6,Centro,LEIRIA,1007,6677.45,2614,233,195,157,190,187,377,534,729,962,39.15,14.41,10.92,8.0
25-11-2021,CASTELO BRANCO,95,7,183,"[120,240]",Moderado,,,,95,Centro,CASTELO BRANCO,0502,143819.15,51987,3528,3042,2499,2229,2225,4454,6953,9995,13523,36.15,9.4,6.95,4.83
25-11-2021,CASTELO DE PAIVA,23,2,150,"[120,240]",Moderado,,,,23,Norte,AVEIRO,0106,11500.53,15454,881,697,545,420,431,851,1396,2093,2974,134.37,25.86,18.2,12.14
25-11-2021,CASTELO DE VIDE,7,1,242,"[240,480]",Elevado,,,,7,Alentejo,PORTALEGRE,1205,26491.24,2919,204,173,179,147,170,317,496,669,873,11.02,3.3,2.53,1.87
25-11-2021,CASTRO DAIRE,51,4,369,"[240,480]",Elevado,,,,51,Centro,VISEU,1803,37904.13,13823,942,857,765,732,773,1505,2270,3127,4069,36.47,10.74,8.25,5.99
25-11-2021,CASTRO MARIM,14,1,226,"[120,240]",Moderado,,,,14,Algarve,FARO,0804,30084.37,6237,370,345,334,322,344,666,1000,1345,1715,20.73,5.7,4.47,3.32
25-11-2021,CASTRO VERDE,8,1,116,"[0,120]",Baixo a Moderado,,,,8,Alentejo,BEJA,0206,56944.23,6949,437,347,303,275,227,502,805,1152,1589,12.2,2.79,2.02,1.41
25-11-2021,CELORICO DA BEIRA,10,1,144,"[120,240]",Moderado,,,,10,Centro,GUARDA,0903,24721.63,6928,430,416,363,369,535,904,1267,1683,2113,28.02,8.55,6.81,5.12
25-11-2021,CELORICO DE BASTO,25,2,132,"[120,240]",Moderado,,,,25,Norte,BRAGA,0305,18107.02,19040,1001,802,668,728,729,1457,2125,2927,3928,105.15,21.69,16.17,11.74
25-11-2021,CHAMUSCA,23,2,254,"[240,480]",Elevado,,,,23,Lisboa e Vale do Tejo,SANTARÉM,1407,74600.54,9197,629,583,553,465,579,1044,1597,2180,2809,12.33,3.77,2.92,2.14
25-11-2021,CHAVES,53,4,135,"[120,240]",Moderado,,,,53,Norte,VILA REAL,1703,59122.95,39343,2676,2429,1991,1886,1918,3804,5795,8224,10900,66.54,18.44,13.91,9.8
25-11-2021,CINFÃES,15,1,83,"[0,120]",Baixo a Moderado,,,,15,Norte,VISEU,1804,23928.76,18244,1067,902,779,734,758,1492,2271,3173,4240,76.24,17.72,13.26,9.49
25-11-2021,COIMBRA,525,37,391,"[240,480]",Elevado,,,,525,Centro,COIMBRA,0603,31939.94,134166,9489,8734,6353,5139,5074,10213,16566,25300,34789,420.06,108.92,79.21,51.87
25-11-2021,CONDEIXA-A-NOVA,79,6,447,"[240,480]",Elevado,,,,79,Centro,COIMBRA,0604,13867.47,17733,871,809,717,583,490,1073,1790,2599,3470,127.88,25.02,18.74,12.91
25-11-2021,CONSTÂNCIA,22,2,543,"[480,960]",Muito Elevado,,,,22,Lisboa e Vale do Tejo,SANTARÉM,1408,8036.58,4030,211,183,187,148,155,303,490,673,884,50.14,11.0,8.37,6.1
25-11-2021,CORUCHE,77,6,442,"[240,480]",Elevado,,,,77,Lisboa e Vale do Tejo,SANTARÉM,1409,111572.03,17471,1294,1090,1095,1096,1019,2115,3210,4300,5594,15.66,5.01,3.85,2.88
25-11-2021,CORVO,0,0,0,"[0,120]",Baixo a Moderado,,,,0,Açores,AÇORES,4901,1711.45,464,22,21,11,13,19,32,43,64,86,27.12,5.03,3.74,2.51
25-11-2021,COVILHÃ,318,23,680,"[480,960]",Muito Elevado,,,,318,Centro,CASTELO BRANCO,0503,55560.06,46787,3533,2998,2365,2111,2193,4304,6669,9667,13200,84.21,23.76,17.4,12.0
25-11-2021,CRATO,0,0,0,"[0,120]",Baixo a Moderado,,,,0,Alentejo,PORTALEGRE,1206,39806.88,3129,229,258,163,182,228,410,573,831,1060,7.86,2.66,2.09,1.44
25-11-2021,CUBA,19,1,418,"[240,480]",Elevado,,,,19,Alentejo,BEJA,0207,17208.72,4595,255,233,206,190,143,333,539,772,1027,26.7,5.97,4.49,3.13
25-11-2021,ELVAS,12,1,59,"[0,120]",Baixo a Moderado,,,,12,Alentejo,PORTALEGRE,1207,63128.86,20528,1057,1145,902,852,810,1662,2564,3709,4766,32.52,7.55,5.88,4.06
25-11-2021,ENTRONCAMENTO,155,11,721,"[480,960]",Muito Elevado,,,,155,Lisboa e Vale do Tejo,SANTARÉM,1410,1372.81,21558,1066,930,868,695,592,1287,2155,3085,4151,1570.14,302.33,224.69,156.96
25-11-2021,ESPINHO,92,7,313,"[240,480]",Elevado,,,,92,Norte,AVEIRO,0107,2105.68,29516,2205,1993,1430,1177,960,2137,3567,5560,7765,1401.52,368.71,264.01,169.37
25-11-2021,ESPOSENDE,60,4,176,"[120,240]",Moderado,,,,60,Norte,BRAGA,0306,9540.98,34177,1831,1522,1095,894,723,1617,2712,4234,6065,358.21,63.57,44.38,28.42
25-11-2021,ESTARREJA,205,15,788,"[480,960]",Muito Elevado,,,,205,Centro,AVEIRO,0108,10817.33,26006,1503,1399,1106,953,728,1681,2787,4186,5689,240.42,52.59,38.7,25.76
25-11-2021,ESTREMOZ,10,1,79,"[0,120]",Baixo a Moderado,,,,10,Alentejo,ÉVORA,0704,51379.95,12728,789,613,697,786,877,1663,2360,2973,3762,24.77,7.32,5.79,4.59
25-11-2021,ÉVORA,201,14,383,"[240,480]",Elevado,,,,201,Alentejo,ÉVORA,0705,130707.58,52428,3569,2852,2176,1966,1803,3769,5945,8797,12366,40.11,9.46,6.73,4.55
25-11-2021,FAFE,86,6,178,"[120,240]",Moderado,,,,86,Norte,BRAGA,0307,21908.11,48060,3044,2455,1679,1403,1208,2611,4290,6745,9789,219.37,44.68,30.79,19.58
25-11-2021,FARO,318,23,521,"[480,960]",Muito Elevado,,,,318,Algarve,FARO,0805,20256.79,61015,3847,3364,2604,2055,1601,3656,6260,9624,13471,301.2,66.5,47.51,30.9
25-11-2021,FELGUEIRAS,69,5,123,"[120,240]",Moderado,,,,69,Norte,PORTO,1303,11573.75,56422,2951,2302,1601,1316,973,2289,3890,6192,9143,487.49,79.0,53.5,33.61
25-11-2021,FERREIRA DO ALENTEJO,6,0,77,"[0,120]",Baixo a Moderado,,,,6,Alentejo,BEJA,0208,64820.68,7845,515,414,372,343,345,688,1060,1474,1989,12.1,3.07,2.27,1.64
25-11-2021,FERREIRA DO ZÊZERE,29,2,365,"[240,480]",Elevado,,,,29,Lisboa e Vale do Tejo,SANTARÉM,1411,19038.03,7959,470,370,416,465,456,921,1337,1707,2177,41.81,11.44,8.97,7.02
25-11-2021,FIGUEIRA DA FOZ,176,13,300,"[240,480]",Elevado,,,,176,Centro,COIMBRA,0605,37905.26,58747,4032,3597,2887,2495,2043,4538,7425,11022,15054,154.98,39.72,29.08,19.59
25-11-2021,FIGUEIRA DE CASTELO RODRIGO,2,0,36,"[0,120]",Baixo a Moderado,,,,2,Centro,GUARDA,0904,50857.46,5584,347,352,290,352,391,743,1033,1385,1732,10.98,3.41,2.72,2.03
25-11-2021,FIGUEIRÓ DOS VINHOS,27,2,485,"[480,960]",Muito Elevado,,,,27,Centro,LEIRIA,1008,17344.0,5568,402,386,322,309,351,660,982,1368,1770,32.1,10.21,7.89,5.66
25-11-2021,FORNOS DE ALGODRES,6,0,132,"[120,240]",Moderado,,,,6,Centro,GUARDA,0905,13145.05,4528,261,218,247,256,232,488,735,953,1214,34.45,9.24,7.25,5.59
25-11-2021,FREIXO DE ESPADA À CINTA,3,0,93,"[0,120]",Baixo a Moderado,,,,3,Norte,BRAGANÇA,0404,24414.29,3298,211,177,231,196,189,385,616,793,1004,13.51,4.11,3.25,2.52
25-11-2021,FRONTEIRA,6,0,205,"[120,240]",Moderado,,,,6,Alentejo,PORTALEGRE,1208,24859.58,2974,213,182,149,156,168,324,473,655,868,11.96,3.49,2.63,1.9
25-11-2021,FUNCHAL,434,31,417,"[240,480]",Elevado,,,,434,Madeira,MADEIRA,3103,7616.2,104024,6382,5086,3643,2821,1990,4811,8454,13540,19922,1365.86,261.58,177.78,111.0
25-11-2021,FUNDÃO,151,11,571,"[480,960]",Muito Elevado,,,,151,Centro,CASTELO BRANCO,0504,70019.79,26495,1781,1464,1432,1357,1643,3000,4432,5896,7677,37.84,10.96,8.42,6.33
25-11-2021,GAVIÃO,8,1,251,"[240,480]",Elevado,,,,8,Alentejo,PORTALEGRE,1209,29459.45,3263,189,186,222,263,293,556,778,964,1153,11.08,3.91,3.27,2.64
25-11-2021,GÓIS,5,0,133,"[120,240]",Moderado,,,,5,Centro,COIMBRA,0606,26330.19,3805,235,199,240,233,244,477,717,916,1151,14.45,4.37,3.48,2.72
25-11-2021,GOLEGÃ,39,3,737,"[480,960]",Muito Elevado,,,,39,Lisboa e Vale do Tejo,SANTARÉM,1412,8431.67,5339,356,299,281,243,255,498,779,1078,1434,63.32,17.01,12.78,9.24
25-11-2021,GONDOMAR,320,23,193,"[120,240]",Moderado,,,,320,Norte,PORTO,1304,13191.76,165985,10555,8755,6222,4450,3364,7814,14036,22791,33346,1258.22,252.77,172.76,106.4
25-11-2021,GOUVEIA,34,2,275,"[240,480]",Elevado,,,,34,Centro,GUARDA,0906,30061.17,12387,871,931,780,783,810,1593,2373,3304,4175,41.21,13.89,10.99,7.89
25-11-2021,GRÂNDOLA,31,2,212,"[120,240]",Moderado,,,,31,Alentejo,SETÚBAL,1505,82593.66,14639,834,834,708,688,672,1360,2068,2902,3736,17.72,4.52,3.51,2.5
25-11-2021,GUARDA,150,11,385,"[240,480]",Elevado,,,,150,Centro,GUARDA,0907,71209.58,38969,2477,2041,1686,1415,1474,2889,4575,6616,9093,54.72,12.77,9.29,6.42
25-11-2021,GUIMARÃES,192,14,126,"[120,240]",Moderado,,,,192,Norte,BRAGA,0308,24099.96,152309,9394,7074,4809,3877,2948,6825,11634,18708,28102,631.99,116.61,77.63,48.27
25-11-2021,HORTA,12,1,83,"[0,120]",Baixo a Moderado,,,,12,Açores,AÇORES,4701,17305.53,14521,818,658,468,352,302,654,1122,1780,2598,83.91,15.01,10.29,6.48
25-11-2021,IDANHA-A-NOVA,25,2,315,"[240,480]",Elevado,,,,25,Centro,CASTELO BRANCO,0505,141633.51,8043,518,490,519,672,974,1646,2165,2655,3173,5.68,2.24,1.87,1.53
25-11-2021,ÍLHAVO,230,16,595,"[480,960]",Muito Elevado,,,,230,Centro,AVEIRO,0110,7347.55,38699,2227,1943,1444,1193,850,2043,3487,5430,7657,526.66,104.21,73.9,47.46
25-11-2021,LAGOA (FARO),154,11,677,"[480,960]",Muito Elevado,,,,154,Algarve,FARO,0806,8825.45,22762,1314,1168,919,749,670,1419,2338,3506,4820,257.93,54.62,39.73,26.49
25-11-2021,LAGOA,41,3,278,"[240,480]",Elevado,,,,41,Açores,AÇORES,4201,4559.32,14721,536,458,349,238,235,473,822,1280,1816,322.9,39.83,28.08,18.03
25-11-2021,LAGOS,151,11,496,"[480,960]",Muito Elevado,,,,151,Algarve,FARO,0807,21299.27,30374,1744,1434,1247,1053,1029,2082,3329,4763,6507,142.61,30.55,22.36,15.63
25-11-2021,LAJES DAS FLORES,0,0,0,"[0,120]",Baixo a Moderado,,,,0,Açores,AÇORES,4801,7004.79,1463,88,53,62,46,54,100,162,215,303,20.89,4.33,3.07,2.31
25-11-2021,LAJES DO PICO,0,0,0,"[0,120]",Baixo a Moderado,,,,0,Açores,AÇORES,4601,15531.09,4490,304,231,223,159,162,321,544,775,1079,28.91,6.95,4.99,3.5
25-11-2021,LAMEGO,45,3,182,"[120,240]",Moderado,,,,45,Norte,VISEU,1805,16542.11,24895,1639,1284,1124,898,783,1681,2805,4089,5728,150.5,34.63,24.72,16.96
25-11-2021,LEIRIA,690,49,551,"[480,960]",Muito Elevado,,,,690,Centro,LEIRIA,1009,56508.83,125267,7389,6366,5090,3902,3159,7061,12151,18517,25906,221.68,45.84,32.77,21.5
25-11-2021,LISBOA,1972,141,387,"[240,480]",Elevado,,,,1972,Lisboa e Vale do Tejo,LISBOA,1106,10005.43,509515,33197,33340,27706,23037,26770,49807,77513,110853,144050,5092.6,1439.78,1107.98,774.74
25-11-2021,LOULÉ,523,37,761,"[480,960]",Muito Elevado,,,,523,Algarve,FARO,0808,76366.91,68697,3890,3350,2780,2358,2251,4609,7389,10739,14629,89.96,19.16,14.06,9.68
25-11-2021,LOURES,359,26,168,"[120,240]",Moderado,,,,359,Lisboa e Vale do Tejo,LISBOA,1107,16723.99,213687,12746,12794,9644,6669,5033,11702,21346,34140,46886,1277.73,280.35,204.14,127.64
25-11-2021,LOURINHÃ,52,4,202,"[120,240]",Moderado,,,,52,Lisboa e Vale do Tejo,LISBOA,1108,14717.2,25855,1584,1243,992,842,645,1487,2479,3722,5306,175.68,36.05,25.29,16.84
25-11-2021,LOUSÃ,138,10,805,"[480,960]",Muito Elevado,,,,138,Centro,COIMBRA,0607,13840.01,17158,946,866,658,528,450,978,1636,2502,3448,123.97,24.91,18.08,11.82
25-11-2021,LOUSADA,55,4,118,"[0,120]",Baixo a Moderado,,,,55,Norte,PORTO,1305,9608.01,46755,2289,1698,1176,853,621,1474,2650,4348,6637,486.63,69.08,45.25,27.58
25-11-2021,MAÇÃO,1,0,16,"[0,120]",Baixo a Moderado,,,,1,Lisboa e Vale do Tejo,SANTARÉM,1413,39997.98,6267,386,362,390,440,657,1097,1487,1849,2235,15.67,5.59,4.62,3.72
25-11-2021,MACEDO DE CAVALEIROS,43,3,298,"[240,480]",Elevado,,,,43,Norte,BRAGANÇA,0405,69914.08,14516,1082,889,878,823,938,1761,2639,3528,4610,20.76,6.59,5.05,3.77
25-11-2021,MACHICO,51,4,257,"[240,480]",Elevado,,,,51,Madeira,MADEIRA,3104,6825.1,19981,1197,860,662,455,331,786,1448,2308,3505,292.76,51.36,33.82,21.22
25-11-2021,MADALENA,6,0,102,"[0,120]",Baixo a Moderado,,,,6,Açores,AÇORES,4602,14712.33,5895,334,256,173,190,179,369,542,798,1132,40.07,7.69,5.42,3.68
25-11-2021,MAFRA,85,6,100,"[0,120]",Baixo a Moderado,,,,85,Lisboa e Vale do Tejo,LISBOA,1109,29165.5,84816,3613,3334,2839,2089,1899,3988,6827,10161,13774,290.81,47.23,34.84,23.41
25-11-2021,MAIA,256,18,184,"[120,240]",Moderado,,,,256,Norte,PORTO,1306,8293.94,138971,7801,6617,4512,3339,2631,5970,10482,17099,24900,1675.56,300.22,206.16,126.38
25-11-2021,MANGUALDE,71,5,383,"[240,480]",Elevado,,,,71,Centro,VISEU,1806,21925.56,18510,1198,1128,885,852,743,1595,2480,3608,4806,84.42,21.92,16.46,11.31
25-11-2021,MANTEIGAS,4,0,134,"[120,240]",Moderado,,,,4,Centro,GUARDA,0908,12197.55,3007,258,197,159,167,146,313,472,669,927,24.65,7.6,5.48,3.87
25-11-2021,MARCO DE CANAVESES,56,4,109,"[0,120]",Baixo a Moderado,,,,56,Norte,PORTO,1307,20188.98,51496,2678,2060,1488,1265,1023,2288,3776,5836,8514,255.07,42.17,28.91,18.7
25-11-2021,MARINHA GRANDE,147,11,383,"[240,480]",Elevado,,,,147,Centro,LEIRIA,1010,18725.19,38508,2365,2302,1638,1359,1058,2417,4055,6357,8722,205.65,46.58,33.95,21.66
25-11-2021,MARVÃO,31,2,1021,"[960,Max]",Extremamente Elevado,,,,31,Alentejo,PORTALEGRE,1210,15489.9,3005,198,185,142,197,237,434,576,761,959,19.4,6.19,4.91,3.72
25-11-2021,MATOSINHOS,217,16,124,"[120,240]",Moderado,,,,217,Norte,PORTO,1308,6241.97,175357,11850,9977,7023,5024,3884,8908,15931,25908,37758,2809.31,604.9,415.06,255.22
25-11-2021,MEALHADA,36,3,180,"[120,240]",Moderado,,,,36,Centro,AVEIRO,0111,11065.66,19914,1163,1039,810,828,831,1659,2469,3508,4671,179.96,42.21,31.7,22.31
25-11-2021,MÊDA,12,1,262,"[240,480]",Elevado,,,,12,Centro,GUARDA,0909,28604.92,4587,343,306,290,288,443,731,1021,1327,1670,16.04,5.84,4.64,3.57
25-11-2021,MELGAÇO,8,1,100,"[0,120]",Baixo a Moderado,,,,8,Norte,VIANA DO CASTELO,1603,23824.58,8093,507,567,578,614,675,1289,1867,2434,2941,33.97,12.34,10.22,7.84
25-11-2021,MÉRTOLA,5,0,83,"[0,120]",Baixo a Moderado,,,,5,Alentejo,BEJA,0209,129287.34,6142,400,390,378,423,600,1023,1401,1791,2191,4.75,1.69,1.39,1.08
25-11-2021,MESÃO FRIO,4,0,102,"[0,120]",Baixo a Moderado,,,,4,Norte,VILA REAL,1704,2664.87,3964,265,205,168,157,120,277,445,650,915,148.74,34.33,24.39,16.7
25-11-2021,MIRA,145,10,1229,"[960,Max]",Extremamente Elevado,,,,145,Centro,COIMBRA,0608,12403.38,11832,727,729,659,550,466,1016,1675,2404,3131,95.4,25.24,19.38,13.5
25-11-2021,MIRANDA DO CORVO,47,3,370,"[240,480]",Elevado,,,,47,Centro,COIMBRA,0609,12637.79,12708,706,659,568,498,404,902,1470,2129,2835,100.55,22.43,16.85,11.63
25-11-2021,MIRANDA DO DOURO,46,3,680,"[480,960]",Muito Elevado,,,,46,Norte,BRAGANÇA,0406,48718.31,6830,482,429,442,463,470,933,1375,1804,2286,14.02,4.69,3.7,2.82
25-11-2021,MIRANDELA,75,5,343,"[240,480]",Elevado,,,,75,Norte,BRAGANÇA,0407,65895.67,21754,1640,1315,1204,1078,947,2025,3229,4544,6184,33.01,9.38,6.9,4.9
25-11-2021,MOGADOURO,22,2,266,"[240,480]",Elevado,,,,22,Norte,BRAGANÇA,0408,76064.93,8392,589,529,576,630,655,1285,1861,2390,2979,11.03,3.92,3.14,2.45
25-11-2021,MOIMENTA DA BEIRA,29,2,299,"[240,480]",Elevado,,,,29,Norte,VISEU,1807,21996.9,9736,576,514,471,416,461,877,1348,1862,2438,44.26,11.08,8.46,6.13
25-11-2021,MOITA,185,13,287,"[240,480]",Elevado,,,,185,Lisboa e Vale do Tejo,SETÚBAL,1506,5525.98,64407,4226,3646,2623,1801,1425,3226,5849,9495,13721,1165.53,248.3,171.82,105.85
25-11-2021,MONÇÃO,6,0,34,"[0,120]",Baixo a Moderado,,,,6,Norte,VIANA DO CASTELO,1604,21130.85,17869,1161,1105,1031,1006,972,1978,3009,4114,5275,84.56,24.96,19.47,14.24
25-11-2021,MONCHIQUE,39,3,763,"[480,960]",Muito Elevado,,,,39,Algarve,FARO,0809,39530.43,5077,353,384,321,355,392,747,1068,1452,1805,12.84,4.57,3.67,2.7
25-11-2021,MONDIM DE BASTO,1,0,15,"[0,120]",Baixo a Moderado,,,,1,Norte,VILA REAL,1705,17207.52,6946,395,300,314,284,283,567,881,1181,1576,40.36,9.16,6.86,5.12
25-11-2021,MONFORTE,3,0,102,"[0,120]",Baixo a Moderado,,,,3,Alentejo,PORTALEGRE,1211,42024.82,2975,139,115,117,192,168,360,477,592,731,7.08,1.74,1.41,1.14
25-11-2021,MONTALEGRE,12,1,135,"[120,240]",Moderado,,,,12,Norte,VILA REAL,1706,80545.71,8997,699,628,595,603,730,1333,1928,2556,3255,11.17,4.04,3.17,2.39
25-11-2021,MONTEMOR-O-NOVO,14,1,91,"[0,120]",Baixo a Moderado,,,,14,Alentejo,ÉVORA,0706,123296.65,15647,991,953,868,878,971,1849,2717,3670,4661,12.69,3.78,2.98,2.2
25-11-2021,MONTEMOR-O-VELHO,123,9,486,"[480,960]",Muito Elevado,,,,123,Centro,COIMBRA,0610,22896.23,25224,1496,1397,1217,1057,988,2045,3262,4659,6155,110.17,26.88,20.35,14.25
25-11-2021,MONTIJO,134,10,232,"[120,240]",Moderado,,,,134,Lisboa e Vale do Tejo,SETÚBAL,1507,34861.64,57614,2771,2441,1990,1554,1109,2663,4653,7094,9865,165.26,28.3,20.35,13.35
25-11-2021,MORA,67,5,1611,"[960,Max]",Extremamente Elevado,,,,67,Alentejo,ÉVORA,0707,44395.02,4138,336,275,252,238,257,495,747,1022,1358,9.32,3.06,2.3,1.68
25-11-2021,MORTÁGUA,20,1,227,"[120,240]",Moderado,,,,20,Centro,VISEU,1808,25117.82,8803,638,584,535,499,460,959,1494,2078,2716,35.05,10.81,8.27,5.95
25-11-2021,MOURA,104,7,757,"[480,960]",Muito Elevado,,,,104,Alentejo,BEJA,0210,95845.55,13718,817,656,665,542,461,1003,1668,2324,3141,14.31,3.28,2.42,1.74
25-11-2021,MOURÃO,5,0,206,"[120,240]",Moderado,,,,5,Alentejo,ÉVORA,0708,27862.98,2450,139,108,80,104,109,213,293,401,540,8.79,1.94,1.44,1.05
25-11-2021,MURÇA,43,3,796,"[480,960]",Muito Elevado,,,,43,Norte,VILA REAL,1707,18937.11,5463,384,341,307,306,319,625,932,1273,1657,28.85,8.75,6.72,4.92
25-11-2021,MURTOSA,23,2,221,"[120,240]",Moderado,,,,23,Centro,AVEIRO,0112,7308.78,10279,509,473,403,353,409,762,1165,1638,2147,140.63,29.37,22.41,15.94
25-11-2021,NAZARÉ,111,8,785,"[480,960]",Muito Elevado,,,,111,Lisboa e Vale do Tejo,LEIRIA,1011,8243.43,14165,967,903,670,420,396,816,1486,2389,3356,171.84,40.71,28.98,18.03
25-11-2021,NELAS,28,2,216,"[120,240]",Moderado,,,,28,Centro,VISEU,1809,12571.48,12974,924,787,668,604,583,1187,1855,2642,3566,103.21,28.37,21.02,14.76
25-11-2021,NISA,47,3,772,"[480,960]",Muito Elevado,,,,47,Alentejo,PORTALEGRE,1212,57567.84,6061,405,389,355,483,478,961,1316,1705,2110,10.53,3.67,2.96,2.29
25-11-2021,NORDESTE,1,0,21,"[0,120]",Baixo a Moderado,,,,1,Açores,AÇORES,4202,10146.8,4862,246,180,124,161,162,323,447,627,873,47.92,8.6,6.18,4.41
25-11-2021,ÓBIDOS,48,3,408,"[240,480]",Elevado,,,,48,Lisboa e Vale do Tejo,LEIRIA,1012,14155.44,11850,743,650,574,452,436,888,1462,2112,2855,83.72,20.17,14.92,10.33
25-11-2021,ODEMIRA,123,9,499,"[480,960]",Muito Elevado,,,,123,Alentejo,BEJA,0211,172060.15,24717,1475,1317,1225,1397,1349,2746,3971,5288,6763,14.37,3.93,3.07,2.31
25-11-2021,ODIVELAS,288,21,178,"[120,240]",Moderado,,,,288,Lisboa e Vale do Tejo,LISBOA,1116,2654.36,161774,9562,9038,6952,4641,3812,8453,15405,24443,34005,6095.48,1281.27,920.99,580.44
25-11-2021,OEIRAS,419,30,236,"[120,240]",Moderado,,,,419,Lisboa e Vale do Tejo,LISBOA,1110,4588.31,177408,11580,11575,8566,6211,5855,12066,20632,32207,43787,3866.78,954.38,701.98,449.69
25-11-2021,OLEIROS,5,0,100,"[0,120]",Baixo a Moderado,,,,5,Centro,CASTELO BRANCO,0506,47109.31,5003,384,341,366,397,487,884,1250,1591,1975,10.62,4.19,3.38,2.65
25-11-2021,OLHÃO,232,17,523,"[480,960]",Muito Elevado,,,,232,Algarve,FARO,0810,13086.38,44405,2455,2309,1689,1342,1268,2610,4299,6608,9063,339.33,69.26,50.5,32.85
25-11-2021,OLIVEIRA DE AZEMÉIS,263,19,398,"[240,480]",Elevado,,,,263,Norte,AVEIRO,0113,16110.41,66011,4155,3614,2794,2183,1738,3921,6715,10329,14484,409.75,89.91,64.12,41.68
25-11-2021,OLIVEIRA DE FRADES,2,0,20,"[0,120]",Baixo a Moderado,,,,2,Centro,VISEU,1810,14534.62,9936,553,475,438,359,415,774,1212,1687,2240,68.36,15.41,11.61,8.34
25-11-2021,OLIVEIRA DO BAIRRO,85,6,352,"[240,480]",Elevado,,,,85,Centro,AVEIRO,0114,8731.99,24277,1327,1182,999,786,810,1596,2595,3777,5104,278.02,58.45,43.25,29.72
25-11-2021,OLIVEIRA DO HOSPITAL,17,1,88,"[0,120]",Baixo a Moderado,,,,17,Centro,COIMBRA,0611,23451.66,19253,1161,1097,962,924,960,1884,2846,3943,5104,82.1,21.76,16.81,12.14
25-11-2021,OURÉM,189,14,430,"[240,480]",Elevado,,,,189,Lisboa e Vale do Tejo,SANTARÉM,1421,41668.03,44044,2463,2069,1899,1817,1603,3420,5319,7388,9851,105.7,23.64,17.73,12.77
25-11-2021,OURIQUE,9,1,198,"[120,240]",Moderado,,,,9,Alentejo,BEJA,0212,66331.36,4607,313,287,284,268,227,495,779,1066,1379,6.95,2.08,1.61,1.17
25-11-2021,OVAR,191,14,352,"[240,480]",Elevado,,,,191,Centro,AVEIRO,0115,14770.25,54260,3294,2709,1994,1636,1234,2870,4864,7573,10867,367.37,73.57,51.27,32.93
25-11-2021,PAÇOS DE FERREIRA,60,4,106,"[0,120]",Baixo a Moderado,,,,60,Norte,PORTO,1309,7099.29,56728,2903,2193,1518,1135,664,1799,3317,5510,8413,799.1,118.51,77.62,46.72
25-11-2021,PALMELA,136,10,211,"[120,240]",Moderado,,,,136,Lisboa e Vale do Tejo,SETÚBAL,1508,46512.01,64269,3402,3244,2635,1846,1391,3237,5872,9116,12518,138.18,26.91,19.6,12.62
25-11-2021,PAMPILHOSA DA SERRA,20,1,496,"[480,960]",Muito Elevado,,,,20,Centro,COIMBRA,0612,39646.24,4037,238,254,295,339,423,762,1057,1311,1549,10.18,3.91,3.31,2.67
25-11-2021,PAREDES,109,8,127,"[120,240]",Moderado,,,,109,Norte,PORTO,1310,15675.69,86067,4272,3532,2412,1717,1258,2975,5387,8919,13191,549.04,84.15,56.9,34.36
25-11-2021,PAREDES DE COURA,19,1,224,"[120,240]",Moderado,,,,19,Norte,VIANA DO CASTELO,1605,13818.59,8535,466,528,407,465,515,980,1387,1915,2381,61.76,17.23,13.86,10.04
25-11-2021,PEDRÓGÃO GRANDE,4,0,117,"[0,120]",Baixo a Moderado,,,,4,Centro,LEIRIA,1013,12874.75,3410,175,173,196,221,252,473,669,842,1017,26.49,7.9,6.54,5.2
25-11-2021,PENACOVA,23,2,169,"[120,240]",Moderado,,,,23,Centro,COIMBRA,0613,21673.23,13694,968,923,745,621,703,1324,2069,2992,3960,63.18,18.27,13.81,9.55
25-11-2021,PENAFIEL,84,6,120,"[120,240]",Moderado,,,,84,Norte,PORTO,1311,21224.27,69772,3648,2823,2032,1663,1230,2893,4925,7748,11396,328.74,53.69,36.51,23.2
25-11-2021,PENALVA DO CASTELO,25,2,350,"[240,480]",Elevado,,,,25,Centro,VISEU,1811,13433.92,7115,449,457,413,391,426,817,1230,1687,2136,52.96,15.9,12.56,9.16
25-11-2021,PENAMACOR,13,1,275,"[240,480]",Elevado,,,,13,Centro,CASTELO BRANCO,0507,56370.69,4755,262,248,273,451,633,1084,1357,1605,1867,8.44,3.31,2.85,2.41
25-11-2021,PENEDONO,4,0,156,"[120,240]",Moderado,,,,4,Norte,VISEU,1812,13370.75,2591,172,113,129,156,138,294,423,536,708,19.38,5.3,4.01,3.16
25-11-2021,PENELA,10,1,186,"[120,240]",Moderado,,,,10,Centro,COIMBRA,0614,13480.0,5397,314,324,274,359,344,703,977,1301,1615,40.04,11.98,9.65,7.25
25-11-2021,PENICHE,123,9,464,"[240,480]",Elevado,,,,123,Lisboa e Vale do Tejo,LEIRIA,1014,7754.98,26501,1746,1504,1203,926,707,1633,2836,4340,6086,341.73,78.48,55.96,36.57
25-11-2021,PESO DA RÉGUA,16,1,102,"[0,120]",Baixo a Moderado,,,,16,Norte,VILA REAL,1708,9486.01,15773,1076,843,650,659,455,1114,1764,2607,3683,166.28,38.83,27.48,18.6
25-11-2021,PINHEL,2,0,24,"[0,120]",Baixo a Moderado,,,,2,Centro,GUARDA,0910,48452.12,8511,577,566,551,538,689,1227,1778,2344,2921,17.57,6.03,4.84,3.67
25-11-2021,POMBAL,214,15,416,"[240,480]",Elevado,,,,214,Centro,LEIRIA,1015,62600.28,51461,3187,2791,2494,2328,2027,4355,6849,9640,12827,82.21,20.49,15.4,10.94
25-11-2021,PONTA DELGADA,167,12,246,"[240,480]",Elevado,,,,167,Açores,AÇORES,4203,23298.65,67935,3108,2435,1726,1133,902,2035,3761,6196,9304,291.58,39.93,26.59,16.14
25-11-2021,PONTA DO SOL,13,1,152,"[120,240]",Moderado,,,,13,Madeira,MADEIRA,3105,4622.03,8593,319,283,347,208,221,429,776,1059,1378,185.92,29.81,22.91,16.79
25-11-2021,PONTE DA BARCA,50,4,451,"[240,480]",Elevado,,,,50,Norte,VIANA DO CASTELO,1606,18211.37,11180,635,576,517,554,490,1044,1561,2137,2772,61.39,15.22,11.73,8.57
25-11-2021,PONTE DE LIMA,155,11,375,"[240,480]",Elevado,,,,155,Norte,VIANA DO CASTELO,1607,32025.46,41315,2321,2022,1720,1596,1462,3058,4778,6800,9121,129.01,28.48,21.23,14.92
25-11-2021,PONTE DE SOR,7,1,47,"[0,120]",Baixo a Moderado,,,,7,Alentejo,PORTALEGRE,1213,83971.16,14994,939,800,716,739,831,1570,2286,3086,4025,17.86,4.79,3.68,2.72
25-11-2021,PORTALEGRE,32,2,146,"[120,240]",Moderado,,,,32,Alentejo,PORTALEGRE,1214,44713.64,22172,1577,1351,1137,993,984,1977,3114,4465,6042,49.59,13.51,9.99,6.96
25-11-2021,PORTEL,21,2,364,"[240,480]",Elevado,,,,21,Alentejo,ÉVORA,0709,60100.57,5828,336,358,283,331,305,636,919,1277,1613,9.7,2.68,2.12,1.53
25-11-2021,PORTIMÃO,458,33,826,"[480,960]",Muito Elevado,,,,458,Algarve,FARO,0811,18206.29,55483,3182,2927,2116,1582,1400,2982,5098,8025,11207,304.75,61.56,44.08,28.0
25-11-2021,PORTO,780,56,360,"[240,480]",Elevado,,,,780,Norte,PORTO,1312,4142.02,216606,15790,15193,11280,9409,10044,19453,30733,45926,61716,5229.5,1490.0,1108.79,741.98
25-11-2021,PORTO DE MÓS,121,9,519,"[480,960]",Muito Elevado,,,,121,Centro,LEIRIA,1016,26183.41,23275,1355,1210,1034,888,872,1760,2794,4004,5359,88.89,20.47,15.29,10.67
25-11-2021,PORTO MONIZ,7,1,303,"[240,480]",Elevado,,,,7,Madeira,MADEIRA,3106,8293.38,2342,143,130,95,98,120,218,313,443,586,28.24,7.07,5.34,3.77
25-11-2021,PORTO SANTO,2,0,38,"[0,120]",Baixo a Moderado,,,,2,Madeira,MADEIRA,3201,4300.7,5202,240,157,134,110,68,178,312,469,709,120.95,16.48,10.9,7.25
25-11-2021,PÓVOA DE LANHOSO,28,2,130,"[120,240]",Moderado,,,,28,Norte,BRAGA,0309,13465.29,21499,1175,909,732,673,624,1297,2029,2938,4113,159.67,30.55,21.82,15.07
25-11-2021,PÓVOA DE VARZIM,88,6,140,"[120,240]",Moderado,,,,88,Norte,PORTO,1313,8220.59,62784,3712,3120,2134,1594,1305,2899,5033,8153,11865,763.7,144.33,99.17,61.22
25-11-2021,POVOAÇÃO,11,1,187,"[120,240]",Moderado,,,,11,Açores,AÇORES,4204,10640.77,5927,293,212,191,144,134,278,469,681,974,55.7,9.15,6.4,4.41
25-11-2021,VILA DA PRAIA DA VITÓRIA,6,0,28,"[0,120]",Baixo a Moderado,,,,6,Açores,AÇORES,4302,16127.06,21317,1133,789,619,436,336,772,1391,2180,3313,132.18,20.54,13.52,8.63
25-11-2021,PROENÇA-A-NOVA,8,1,110,"[0,120]",Baixo a Moderado,,,,8,Centro,CASTELO BRANCO,0508,39539.96,7298,508,465,389,400,560,960,1349,1814,2322,18.46,5.87,4.59,3.41
25-11-2021,REDONDO,15,1,239,"[120,240]",Moderado,,,,15,Alentejo,ÉVORA,0710,36950.87,6353,349,325,288,288,354,642,930,1255,1604,17.19,4.34,3.4,2.52
25-11-2021,REGUENGOS DE MONSARAZ,15,1,151,"[120,240]",Moderado,,,,15,Alentejo,ÉVORA,0711,46399.72,10015,602,511,455,462,473,935,1390,1901,2503,21.58,5.39,4.1,3.0
25-11-2021,RESENDE,3,0,30,"[0,120]",Baixo a Moderado,,,,3,Norte,VISEU,1813,12334.93,10137,560,493,448,433,422,855,1303,1796,2356,82.18,19.1,14.56,10.56
25-11-2021,RIBEIRA BRAVA,42,3,340,"[240,480]",Elevado,,,,42,Madeira,MADEIRA,3107,6544.88,12435,648,500,411,311,287,598,1009,1509,2157,189.99,32.96,23.06,15.42
25-11-2021,RIBEIRA DE PENA,4,0,67,"[0,120]",Baixo a Moderado,,,,4,Norte,VILA REAL,1709,21745.98,6016,371,301,290,310,368,678,968,1269,1640,27.66,7.54,5.84,4.45
25-11-2021,RIBEIRA GRANDE,120,9,366,"[240,480]",Elevado,,,,120,Açores,AÇORES,4205,18015.13,32811,1163,689,512,345,253,598,1110,1799,2962,182.13,16.44,9.99,6.16
25-11-2021,RIO MAIOR,54,4,266,"[240,480]",Elevado,,,,54,Lisboa e Vale do Tejo,SANTARÉM,1414,27276.45,20379,1251,1144,941,795,648,1443,2384,3528,4779,74.71,17.52,12.93,8.74
25-11-2021,SABROSA,8,1,136,"[120,240]",Moderado,,,,8,Norte,VILA REAL,1710,15692.45,5918,393,314,304,302,350,652,956,1270,1663,37.71,10.6,8.09,6.09
25-11-2021,SABUGAL,28,2,266,"[240,480]",Elevado,,,,28,Centro,GUARDA,0911,82269.82,10585,724,707,694,796,1009,1805,2499,3206,3930,12.87,4.78,3.9,3.04
25-11-2021,SALVATERRA DE MAGOS,67,5,316,"[240,480]",Elevado,,,,67,Lisboa e Vale do Tejo,SANTARÉM,1415,24393.2,21295,1275,1181,1060,799,772,1571,2631,3812,5087,87.3,20.85,15.63,10.79
25-11-2021,SANTA COMBA DÃO,25,2,239,"[120,240]",Moderado,,,,25,Centro,VISEU,1814,11194.77,10452,732,684,569,538,464,1002,1571,2255,2987,93.36,26.68,20.14,14.03
25-11-2021,SANTA CRUZ,165,12,364,"[240,480]",Elevado,,,,165,Madeira,MADEIRA,3108,8150.28,45281,1817,1301,974,716,523,1239,2213,3514,5331,555.6,65.41,43.12,27.15
25-11-2021,SANTA CRUZ DA GRACIOSA,26,2,622,"[480,960]",Muito Elevado,,,,26,Açores,AÇORES,4401,6065.78,4208,228,180,163,124,145,269,432,612,840,69.37,13.85,10.09,7.12
25-11-2021,SANTA CRUZ DAS FLORES,3,0,139,"[120,240]",Moderado,,,,3,Açores,AÇORES,4802,7091.44,2165,125,98,74,56,51,107,181,279,404,30.53,5.7,3.93,2.55
25-11-2021,SANTA MARIA DA FEIRA,489,35,353,"[240,480]",Elevado,,,,489,Norte,AVEIRO,0109,21587.65,138636,8182,6743,4771,3856,3079,6935,11706,18449,26631,642.19,123.36,85.46,54.22
25-11-2021,SANTA MARTA DE PENAGUIÃO,3,0,46,"[0,120]",Baixo a Moderado,,,,3,Norte,VILA REAL,1711,6928.13,6599,483,373,337,316,317,633,970,1343,1826,95.25,26.36,19.39,14.0
25-11-2021,SANTANA,7,1,105,"[0,120]",Baixo a Moderado,,,,7,Madeira,MADEIRA,3109,9547.3,6711,418,353,343,282,277,559,902,1255,1673,70.29,17.52,13.15,9.45
25-11-2021,SANTARÉM,145,10,252,"[240,480]",Elevado,,,,145,Lisboa e Vale do Tejo,SANTARÉM,1416,55253.58,57421,3654,3441,2760,2466,2206,4672,7432,10873,14527,103.92,26.29,19.68,13.45
25-11-2021,SANTIAGO DO CACÉM,65,5,227,"[120,240]",Moderado,,,,65,Alentejo,SETÚBAL,1509,105969.29,28791,2144,1689,1472,1295,1215,2510,3982,5671,7815,27.17,7.37,5.35,3.76
25-11-2021,SANTO TIRSO,71,5,104,"[0,120]",Baixo a Moderado,,,,71,Norte,PORTO,1314,13655.52,68055,4911,3935,2761,2257,1810,4067,6828,10763,15674,498.35,114.78,78.82,50.0
25-11-2021,SÃO BRÁS DE ALPORTEL,29,2,280,"[240,480]",Elevado,,,,29,Algarve,FARO,0812,15336.92,10416,596,468,467,404,401,805,1272,1740,2336,67.91,15.23,11.35,8.29
25-11-2021,SÃO JOÃO DA MADEIRA,101,7,462,"[240,480]",Elevado,,,,101,Norte,AVEIRO,0116,794.3,21958,1347,1069,796,601,593,1194,1990,3059,4406,2765.49,554.91,385.26,250.63
25-11-2021,SÃO JOÃO DA PESQUEIRA,26,2,368,"[240,480]",Elevado,,,,26,Norte,VISEU,1815,26610.85,7125,417,330,294,328,328,656,950,1280,1697,26.77,6.38,4.81,3.57
25-11-2021,SÃO PEDRO DO SUL,74,5,480,"[480,960]",Muito Elevado,,,,74,Centro,VISEU,1816,34895.09,15403,990,962,861,759,909,1668,2529,3491,4481,44.14,12.84,10.0,7.25
25-11-2021,SÃO ROQUE DO PICO,4,0,122,"[120,240]",Moderado,,,,4,Açores,AÇORES,4603,14236.1,3266,199,141,93,96,113,209,302,443,642,22.94,4.51,3.11,2.12
25-11-2021,SÃO VICENTE,21,2,411,"[240,480]",Elevado,,,,21,Madeira,MADEIRA,3110,7883.71,5143,272,264,266,225,280,505,771,1035,1307,65.23,16.58,13.13,9.78
25-11-2021,SARDOAL,2,0,54,"[0,120]",Baixo a Moderado,,,,2,Lisboa e Vale do Tejo,SANTARÉM,1417,9214.72,3741,227,178,148,165,248,413,561,739,966,40.6,10.48,8.02,6.09
25-11-2021,SÁTÃO,23,2,198,"[120,240]",Moderado,,,,23,Centro,VISEU,1817,20194.11,11580,765,671,515,465,476,941,1456,2127,2892,57.34,14.32,10.53,7.21
25-11-2021,SEIA,29,2,131,"[120,240]",Moderado,,,,29,Centro,GUARDA,0912,43568.83,22234,1807,1589,1238,1122,721,1843,3081,4670,6477,51.03,14.87,10.72,7.07
25-11-2021,SEIXAL,433,31,258,"[240,480]",Elevado,,,,433,Lisboa e Vale do Tejo,SETÚBAL,1510,9545.17,167752,10586,9270,6661,4391,2930,7321,13982,23252,33838,1757.49,354.51,243.6,146.49
25-11-2021,SERNANCELHE,57,4,1060,"[960,Max]",Extremamente Elevado,,,,57,Norte,VISEU,1818,22861.22,5396,305,293,286,273,260,533,819,1112,1417,23.6,6.2,4.86,3.58
25-11-2021,SERPA,120,9,839,"[480,960]",Muito Elevado,,,,120,Alentejo,BEJA,0213,110563.34,14304,903,761,719,697,626,1323,2042,2803,3706,12.94,3.35,2.54,1.85
25-11-2021,SERTÃ,80,6,549,"[480,960]",Muito Elevado,,,,80,Centro,CASTELO BRANCO,0509,44673.17,14577,870,779,790,767,1020,1787,2577,3356,4226,32.63,9.46,7.51,5.77
25-11-2021,SESIMBRA,141,10,271,"[240,480]",Elevado,,,,141,Lisboa e Vale do Tejo,SETÚBAL,1511,19571.75,51858,2400,2321,1853,1257,1083,2340,4193,6514,8914,264.96,45.54,33.28,21.42
25-11-2021,SETÚBAL,236,17,205,"[120,240]",Moderado,,,,236,Lisboa e Vale do Tejo,SETÚBAL,1512,23032.5,115126,7425,6929,5075,3775,2655,6430,11505,18434,25859,499.83,112.27,80.03,49.95
25-11-2021,SEVER DO VOUGA,12,1,106,"[0,120]",Baixo a Moderado,,,,12,Centro,AVEIRO,0117,12987.56,11331,766,637,568,540,567,1107,1675,2312,3078,87.24,23.7,17.8,12.9
25-11-2021,SILVES,172,12,475,"[240,480]",Elevado,,,,172,Algarve,FARO,0813,68006.23,36226,2137,1869,1610,1423,1600,3023,4633,6502,8639,53.27,12.7,9.56,6.81
25-11-2021,SINES,14,1,102,"[0,120]",Baixo a Moderado,,,,14,Alentejo,SETÚBAL,1513,20330.17,13715,888,791,551,416,268,684,1235,2026,2914,67.46,14.33,9.97,6.07
25-11-2021,SINTRA,771,55,197,"[120,240]",Moderado,,,,771,Lisboa e Vale do Tejo,LISBOA,1111,31922.73,391402,20490,18316,13545,9137,7284,16421,29966,48282,68772,1226.08,215.43,151.25,93.87
25-11-2021,SOBRAL DE MONTE AGRAÇO,15,1,138,"[120,240]",Moderado,,,,15,Lisboa e Vale do Tejo,LISBOA,1112,5210.32,10651,564,507,352,272,212,484,836,1343,1907,204.43,36.6,25.78,16.05
25-11-2021,SOURE,131,9,768,"[480,960]",Muito Elevado,,,,131,Centro,COIMBRA,0615,26506.07,17120,1173,1142,1004,883,987,1870,2874,4016,5189,64.59,19.58,15.15,10.84
25-11-2021,SOUSEL,3,0,69,"[0,120]",Baixo a Moderado,,,,3,Alentejo,PORTALEGRE,1215,27932.18,4412,261,274,208,302,292,594,802,1076,1337,15.8,4.79,3.85,2.87
25-11-2021,TÁBUA,30,2,263,"[240,480]",Elevado,,,,30,Centro,COIMBRA,0616,19978.58,11368,729,584,524,430,464,894,1418,2002,2731,56.9,13.67,10.02,7.1
25-11-2021,TABUAÇO,1,0,17,"[0,120]",Baixo a Moderado,,,,1,Norte,VISEU,1819,13385.67,6033,372,314,217,282,363,645,862,1176,1548,45.07,11.56,8.79,6.44
25-11-2021,TAROUCA,6,0,77,"[0,120]",Baixo a Moderado,,,,6,Norte,VISEU,1820,10008.49,7804,405,335,313,277,324,601,914,1249,1654,77.98,16.53,12.48,9.13
25-11-2021,TAVIRA,121,9,494,"[480,960]",Muito Elevado,,,,121,Algarve,FARO,0814,60696.7,24530,1493,1415,1252,1066,1277,2343,3595,5010,6503,40.41,10.71,8.25,5.92
25-11-2021,TERRAS DE BOURO,44,3,697,"[480,960]",Muito Elevado,,,,44,Norte,BRAGA,0310,27746.07,6361,391,372,296,319,340,659,955,1327,1718,22.93,6.19,4.78,3.44
25-11-2021,TOMAR,121,9,329,"[240,480]",Elevado,,,,121,Lisboa e Vale do Tejo,SANTARÉM,1418,35120.44,36748,2403,2189,1868,1853,1822,3675,5543,7732,10135,104.64,28.86,22.02,15.78
25-11-2021,TONDELA,87,6,330,"[240,480]",Elevado,,,,87,Centro,VISEU,1821,37121.73,26357,1768,1722,1518,1475,1417,2892,4410,6132,7900,71.0,21.28,16.52,11.88
25-11-2021,TORRE DE MONCORVO,15,1,197,"[120,240]",Moderado,,,,15,Norte,BRAGANÇA,0409,53155.67,7695,556,478,488,551,719,1270,1758,2236,2792,14.48,5.25,4.21,3.31
25-11-2021,TORRES NOVAS,232,17,664,"[480,960]",Muito Elevado,,,,232,Lisboa e Vale do Tejo,SANTARÉM,1419,26999.68,34933,2324,1979,1738,1406,1475,2881,4619,6598,8922,129.38,33.04,24.44,17.11
25-11-2021,TORRES VEDRAS,189,14,241,"[240,480]",Elevado,,,,189,Lisboa e Vale do Tejo,LISBOA,1113,40714.89,78530,4513,3945,3447,2628,2104,4732,8179,12124,16637,192.88,40.86,29.78,20.09
25-11-2021,TRANCOSO,12,1,135,"[120,240]",Moderado,,,,12,Centro,GUARDA,0913,36152.47,8875,581,557,542,586,496,1082,1624,2181,2762,24.55,7.64,6.03,4.49
25-11-2021,TROFA,56,4,146,"[120,240]",Moderado,,,,56,Norte,PORTO,1318,7201.76,38418,2336,1894,1231,939,684,1623,2854,4748,7084,533.44,98.36,65.93,39.63
25-11-2021,VAGOS,94,7,413,"[240,480]",Elevado,,,,94,Centro,AVEIRO,0118,16491.5,22740,1320,1205,922,784,724,1508,2430,3635,4955,137.89,30.04,22.04,14.73
25-11-2021,VALE DE CAMBRA,61,4,288,"[240,480]",Elevado,,,,61,Norte,AVEIRO,0119,14733.47,21327,1491,1363,1005,831,798,1629,2634,3997,5488,144.76,37.25,27.13,17.88
25-11-2021,VALENÇA,56,4,424,"[240,480]",Elevado,,,,56,Norte,VIANA DO CASTELO,1608,11712.86,13290,867,791,582,582,503,1085,1667,2458,3325,113.46,28.39,20.99,14.23
25-11-2021,VALONGO,152,11,156,"[120,240]",Moderado,,,,152,Norte,PORTO,1315,7512.45,97444,5629,4696,3207,2462,1829,4291,7498,12194,17823,1297.18,237.26,162.33,99.81
25-11-2021,VALPAÇOS,28,2,191,"[120,240]",Moderado,,,,28,Norte,VILA REAL,1712,54873.93,14818,1217,1118,999,928,997,1925,2924,4042,5259,27.0,9.58,7.37,5.33
25-11-2021,VELAS,21,2,414,"[240,480]",Elevado,,,,21,Açores,AÇORES,4502,11738.38,5093,278,208,166,153,113,266,432,640,918,43.39,7.82,5.45,3.68
25-11-2021,VENDAS NOVAS,8,1,72,"[0,120]",Baixo a Moderado,,,,8,Alentejo,ÉVORA,0712,22238.88,11255,677,768,655,501,532,1033,1688,2456,3133,50.61,14.09,11.04,7.59
25-11-2021,VIANA DO ALENTEJO,8,1,157,"[120,240]",Moderado,,,,8,Alentejo,ÉVORA,0713,39367.29,5145,245,208,235,210,214,424,659,867,1112,13.07,2.82,2.2,1.67
25-11-2021,VIANA DO CASTELO,181,13,215,"[120,240]",Moderado,,,,181,Norte,VIANA DO CASTELO,1609,31902.01,84417,5470,4433,3591,3061,2982,6043,9634,14067,19537,264.61,61.24,44.09,30.2
25-11-2021,VIDIGUEIRA,2,0,37,"[0,120]",Baixo a Moderado,,,,2,Alentejo,BEJA,0214,31661.09,5510,300,248,215,233,275,508,723,971,1271,17.4,4.01,3.07,2.28
25-11-2021,VIEIRA DO MINHO,18,1,153,"[120,240]",Moderado,,,,18,Norte,BRAGA,0311,21644.35,11842,703,594,525,548,482,1030,1555,2149,2852,54.71,13.18,9.93,7.18
25-11-2021,VILA DE REI,5,0,150,"[120,240]",Moderado,,,,5,Centro,CASTELO BRANCO,0510,19154.6,3323,169,128,172,247,302,549,721,849,1018,17.35,5.31,4.43,3.76
25-11-2021,VILA DO BISPO,17,1,330,"[240,480]",Elevado,,,,17,Algarve,FARO,0815,17906.06,5154,302,302,314,232,233,465,779,1081,1383,28.78,7.72,6.04,4.35
25-11-2021,VILA DO CONDE,165,12,206,"[120,240]",Moderado,,,,165,Norte,PORTO,1316,14902.77,79899,4726,3875,2819,2070,1743,3813,6632,10507,15233,536.13,102.21,70.5,44.5
25-11-2021,VILA DO PORTO,1,0,18,"[0,120]",Baixo a Moderado,,,,1,Açores,AÇORES,4101,9688.74,5616,274,212,135,96,123,219,354,566,840,57.96,8.67,5.84,3.65
25-11-2021,VILA FLOR,10,1,166,"[120,240]",Moderado,,,,10,Norte,BRAGANÇA,0410,26581.14,6044,429,362,422,294,331,625,1047,1409,1838,22.74,6.91,5.3,3.94
25-11-2021,VILA FRANCA DE XIRA,274,20,193,"[120,240]",Moderado,,,,274,Lisboa e Vale do Tejo,LISBOA,1114,31819.39,141957,8501,6852,4869,3425,2472,5897,10766,17618,26119,446.14,82.09,55.37,33.84
25-11-2021,VILA FRANCA DO CAMPO,6,0,55,"[0,120]",Baixo a Moderado,,,,6,Açores,AÇORES,4206,7796.82,11051,450,344,248,217,154,371,619,963,1413,141.73,18.12,12.35,7.94
25-11-2021,VILA NOVA DA BARQUINHA,39,3,517,"[480,960]",Muito Elevado,,,,39,Lisboa e Vale do Tejo,SANTARÉM,1420,4952.97,7461,415,406,392,364,338,702,1094,1500,1915,150.64,38.66,30.28,22.09
25-11-2021,VILA NOVA DE CERVEIRA,11,1,124,"[120,240]",Moderado,,,,11,Norte,VIANA DO CASTELO,1610,10846.66,8910,531,444,410,384,334,718,1128,1572,2103,82.14,19.39,14.49,10.4
25-11-2021,VILA NOVA DE FAMALICÃO,179,13,136,"[120,240]",Moderado,,,,179,Norte,BRAGA,0312,20159.26,131676,7817,6164,4202,3282,2749,6031,10233,16397,24214,653.19,120.12,81.34,50.76
25-11-2021,VILA NOVA DE FOZ CÔA,1,0,16,"[0,120]",Baixo a Moderado,,,,1,Centro,GUARDA,0914,39815.18,6503,442,385,390,398,429,827,1217,1602,2044,16.33,5.13,4.02,3.06
25-11-2021,VILA NOVA DE GAIA,859,61,286,"[240,480]",Elevado,,,,859,Norte,PORTO,1317,16846.43,300472,18349,15568,10972,8224,6281,14505,25477,41045,59394,1783.64,352.57,243.65,151.23
25-11-2021,VILA NOVA DE PAIVA,37,3,789,"[480,960]",Muito Elevado,,,,37,Centro,VISEU,1822,17553.28,4687,289,272,233,217,241,458,691,963,1252,26.7,7.13,5.49,3.94
25-11-2021,VILA NOVA DE POIARES,6,0,86,"[0,120]",Baixo a Moderado,,,,6,Centro,COIMBRA,0617,8445.3,6939,380,284,262,235,182,417,679,963,1343,82.17,15.9,11.4,8.04
25-11-2021,VILA POUCA DE AGUIAR,4,0,34,"[0,120]",Baixo a Moderado,,,,4,Norte,VILA REAL,1713,43706.62,11961,860,817,733,601,627,1228,1961,2778,3638,27.37,8.32,6.36,4.49
25-11-2021,VILA REAL,111,8,223,"[120,240]",Moderado,,,,111,Norte,VILA REAL,1714,37880.28,49962,3025,2498,2065,1579,1466,3045,5110,7608,10633,131.9,28.07,20.08,13.49
25-11-2021,VILA REAL DE SANTO ANTÓNIO,59,4,317,"[240,480]",Elevado,,,,59,Algarve,FARO,0816,6125.0,18749,1172,1069,811,569,586,1155,1966,3035,4207,306.11,68.69,49.55,32.1
25-11-2021,VILA VELHA DE RÓDÃO,17,1,541,"[480,960]",Muito Elevado,,,,17,Centro,CASTELO BRANCO,0511,32991.16,3144,209,229,180,283,306,589,769,998,1207,9.53,3.66,3.03,2.33
25-11-2021,VILA VERDE,62,4,133,"[120,240]",Moderado,,,,62,Norte,BRAGA,0313,22866.52,46911,2365,2063,1667,1494,1437,2931,4598,6661,9026,205.15,39.47,29.13,20.11
25-11-2021,VILA VIÇOSA,22,2,291,"[240,480]",Elevado,,,,22,Alentejo,ÉVORA,0714,19485.89,7656,487,379,342,345,324,669,1011,1390,1877,39.29,9.63,7.13,5.19
25-11-2021,VIMIOSO,51,4,1263,"[960,Max]",Extremamente Elevado,,,,51,Norte,BRAGANÇA,0411,48158.51,4023,274,230,261,293,335,628,889,1119,1393,8.35,2.89,2.32,1.85
25-11-2021,VINHAIS,67,5,867,"[480,960]",Muito Elevado,,,,67,Norte,BRAGANÇA,0412,69475.09,7746,599,577,636,641,815,1456,2092,2669,3268,11.15,4.7,3.84,3.01
25-11-2021,VISEU,413,30,425,"[240,480]",Elevado,,,,413,Centro,VISEU,1823,50710.14,97249,5769,5038,4140,3158,2710,5868,10008,15046,20815,191.77,41.05,29.67,19.74
25-11-2021,VIZELA,20,1,84,"[0,120]",Baixo a Moderado,,,,20,Norte,BRAGA,0314,2469.83,23897,1258,928,655,509,371,880,1535,2463,3721,967.49,150.65,99.72,62.15
25-11-2021,VOUZELA,12,1,125,"[120,240]",Moderado,,,,12,Centro,VISEU,1824,19369.46,9619,626,605,554,532,507,1039,1593,2198,2824,49.66,14.58,11.35,8.22
02-12-2021,ABRANTES,156,11,443,"[240,480]",Elevado,,,,156,Lisboa e Vale do Tejo,SANTARÉM,1401,71469.08,35130,2473,2213,1730,1748,2021,3769,5499,7712,10185,49.15,14.25,10.79,7.69
02-12-2021,ÁGUEDA,319,23,693,"[480,960]",Muito Elevado,,,,319,Centro,AVEIRO,0101,33527.44,46075,3237,2713,2090,1635,1496,3131,5221,7934,11171,137.43,33.32,23.66,15.57
02-12-2021,AGUIAR DA BEIRA,5,0,108,"[0,120]",Baixo a Moderado,,,,5,Centro,GUARDA,0901,20676.57,4652,304,281,235,239,148,387,622,903,1207,22.5,5.84,4.37,3.01
02-12-2021,ALANDROAL,2,0,41,"[0,120]",Baixo a Moderado,,,,2,Alentejo,ÉVORA,0701,54267.81,4992,307,256,296,299,377,676,972,1228,1535,9.2,2.83,2.26,1.79
02-12-2021,ALBERGARIA-A-VELHA,66,5,272,"[240,480]",Elevado,,,,66,Centro,AVEIRO,0102,15882.5,24144,1550,1298,996,687,680,1367,2363,3661,5211,152.02,32.81,23.05,14.88
02-12-2021,ALBUFEIRA,190,14,458,"[240,480]",Elevado,,,,190,Algarve,FARO,0801,14066.42,41528,2067,1717,1425,985,858,1843,3268,4985,7052,295.24,50.14,35.44,23.23
02-12-2021,ALCÁCER DO SAL,31,2,268,"[240,480]",Elevado,,,,31,Alentejo,SETÚBAL,1501,149987.3,11659,884,814,623,623,602,1225,1848,2662,3546,7.77,2.36,1.77,1.23
02-12-2021,ALCANENA,40,3,311,"[240,480]",Elevado,,,,40,Lisboa e Vale do Tejo,SANTARÉM,1402,12732.86,12809,891,744,628,536,588,1124,1752,2496,3387,100.6,26.6,19.6,13.76
02-12-2021,ALCOBAÇA,258,18,482,"[480,960]",Muito Elevado,,,,258,Lisboa e Vale do Tejo,LEIRIA,1001,40814.09,53555,3420,2927,2466,2059,1676,3735,6201,9128,12548,131.22,30.74,22.36,15.19
02-12-2021,ALCOCHETE,56,4,281,"[240,480]",Elevado,,,,56,Lisboa e Vale do Tejo,SETÚBAL,1502,12836.48,19787,857,834,691,476,447,923,1614,2448,3305,154.15,25.75,19.07,12.57
02-12-2021,ALCOUTIM,7,1,337,"[240,480]",Elevado,,,,7,Algarve,FARO,0802,57536.33,2159,191,188,163,190,267,457,620,808,999,3.75,1.74,1.4,1.08
02-12-2021,ALENQUER,127,9,288,"[240,480]",Elevado,,,,127,Lisboa e Vale do Tejo,LISBOA,1101,30421.92,44052,2298,2062,1629,1330,1155,2485,4114,6176,8474,144.8,27.85,20.3,13.52
02-12-2021,ALFÂNDEGA DA FÉ,5,0,111,"[0,120]",Baixo a Moderado,,,,5,Norte,BRAGANÇA,0401,32194.64,4550,325,277,301,274,325,599,900,1177,1502,14.13,4.67,3.66,2.8
02-12-2021,ALIJÓ,34,2,323,"[240,480]",Elevado,,,,34,Norte,VILA REAL,1701,29759.89,10625,766,687,635,542,666,1208,1843,2530,3296,35.7,11.08,8.5,6.19
02-12-2021,ALJEZUR,17,1,304,"[240,480]",Elevado,,,,17,Algarve,FARO,0803,32349.95,5594,316,336,335,320,410,730,1065,1401,1717,17.29,5.31,4.33,3.29
02-12-2021,ALJUSTREL,14,1,172,"[120,240]",Moderado,,,,14,Alentejo,BEJA,0201,45847.41,8247,635,521,443,347,358,705,1148,1669,2304,17.99,5.03,3.64,2.5
02-12-2021,ALMADA,587,42,347,"[240,480]",Elevado,,,,587,Lisboa e Vale do Tejo,SETÚBAL,1503,7000.89,169039,10469,9777,7876,6144,5111,11255,19131,28908,39377,2414.5,562.45,412.91,273.26
02-12-2021,ALMEIDA,20,1,346,"[240,480]",Elevado,,,,20,Centro,GUARDA,0902,51798.46,5830,441,419,396,458,393,851,1247,1666,2107,11.26,4.07,3.22,2.41
02-12-2021,ALMEIRIM,117,8,517,"[480,960]",Muito Elevado,,,,117,Lisboa e Vale do Tejo,SANTARÉM,1403,22212.05,22546,1342,1353,1106,866,843,1709,2815,4168,5510,101.5,24.81,18.76,12.67
02-12-2021,ALMODÔVAR,2,0,30,"[0,120]",Baixo a Moderado,,,,2,Alentejo,BEJA,0202,77788.03,6725,414,443,396,373,328,701,1097,1540,1954,8.65,2.51,1.98,1.41
02-12-2021,ALPIARÇA,58,4,816,"[480,960]",Muito Elevado,,,,58,Lisboa e Vale do Tejo,SANTARÉM,1404,9536.33,7059,515,486,363,333,274,607,970,1456,1971,74.02,20.67,15.27,10.17
02-12-2021,ALTER DO CHÃO,0,0,0,"[0,120]",Baixo a Moderado,,,,0,Alentejo,PORTALEGRE,1201,36206.62,3165,201,163,136,208,187,395,531,694,895,8.74,2.47,1.92,1.47
02-12-2021,ALVAIÁZERE,21,2,319,"[240,480]",Elevado,,,,21,Centro,LEIRIA,1002,16047.76,6597,419,389,346,406,539,945,1291,1680,2099,41.11,13.08,10.47,8.04
02-12-2021,ALVITO,2,0,81,"[0,120]",Baixo a Moderado,,,,2,Alentejo,BEJA,0203,26485.32,2477,145,110,105,111,89,200,305,415,560,9.35,2.11,1.57,1.15
02-12-2021,AMADORA,429,31,233,"[120,240]",Moderado,,,,429,Lisboa e Vale do Tejo,LISBOA,1115,2378.47,184106,11186,10936,8780,6460,5890,12350,21130,32066,43252,7742.05,1818.84,1348.44,888.56
02-12-2021,AMARANTE,148,11,278,"[240,480]",Elevado,,,,148,Norte,PORTO,1301,30133.15,53193,3086,2413,1812,1643,1311,2954,4766,7179,10265,176.53,34.07,23.82,15.82
02-12-2021,AMARES,72,5,398,"[240,480]",Elevado,,,,72,Norte,BRAGA,0301,8195.41,18129,1001,829,622,489,524,1013,1635,2464,3465,221.22,42.28,30.07,19.95
02-12-2021,ANADIA,202,14,742,"[480,960]",Muito Elevado,,,,202,Centro,AVEIRO,0103,21663.48,27258,1931,1698,1376,1208,1262,2470,3846,5544,7475,125.83,34.51,25.59,17.75
02-12-2021,ANGRA DO HEROÍSMO,36,3,107,"[0,120]",Baixo a Moderado,,,,36,Açores,AÇORES,4301,23899.66,33807,2006,1473,1122,768,635,1403,2525,3998,6004,141.45,25.12,16.73,10.56
02-12-2021,ANSIÃO,60,4,497,"[480,960]",Muito Elevado,,,,60,Centro,LEIRIA,1003,17609.42,12039,727,709,646,694,530,1224,1870,2579,3306,68.37,18.77,14.65,10.62
02-12-2021,ARCOS DE VALDEVEZ,39,3,188,"[120,240]",Moderado,,,,39,Norte,VIANA DO CASTELO,1601,44759.64,20926,1329,1338,1282,1343,1515,2858,4140,5478,6807,46.75,15.21,12.24,9.25
02-12-2021,ARGANIL,22,2,200,"[120,240]",Moderado,,,,22,Centro,COIMBRA,0601,33283.93,11014,672,648,612,559,596,1155,1767,2415,3087,33.09,9.27,7.26,5.31
02-12-2021,ARMAMAR,1,0,17,"[0,120]",Baixo a Moderado,,,,1,Norte,VISEU,1801,11723.73,5769,357,305,309,285,310,595,904,1209,1566,49.21,13.36,10.31,7.71
02-12-2021,AROUCA,39,3,189,"[120,240]",Moderado,,,,39,Norte,AVEIRO,0104,32910.52,20720,1306,1047,753,683,683,1366,2119,3166,4472,62.96,13.59,9.62,6.44
02-12-2021,ARRAIOLOS,8,1,116,"[0,120]",Baixo a Moderado,,,,8,Alentejo,ÉVORA,0702,68374.55,6928,435,384,283,367,480,847,1130,1514,1949,10.13,2.85,2.21,1.65
02-12-2021,ARRONCHES,4,0,145,"[120,240]",Moderado,,,,4,Alentejo,PORTALEGRE,1202,31464.72,2820,155,142,162,187,179,366,528,670,825,8.96,2.62,2.13,1.68
02-12-2021,ARRUDA DOS VINHOS,21,2,139,"[120,240]",Moderado,,,,21,Lisboa e Vale do Tejo,LISBOA,1102,7795.93,15412,738,738,562,509,438,947,1509,2247,2985,197.69,38.29,28.82,19.36
02-12-2021,AVEIRO,361,26,459,"[240,480]",Elevado,,,,361,Centro,AVEIRO,0105,19757.57,78734,4520,4004,3050,2250,2103,4353,7403,11407,15927,398.49,80.61,57.73,37.47
02-12-2021,AVIS,2,0,48,"[0,120]",Baixo a Moderado,,,,2,Alentejo,PORTALEGRE,1203,60596.51,4247,315,225,206,251,273,524,730,955,1270,7.01,2.1,1.58,1.2
02-12-2021,AZAMBUJA,67,5,293,"[240,480]",Elevado,,,,67,Lisboa e Vale do Tejo,LISBOA,1103,26265.65,22716,1322,1171,1070,798,618,1416,2486,3657,4979,86.48,18.96,13.92,9.46
02-12-2021,BAIÃO,48,3,258,"[240,480]",Elevado,,,,48,Norte,PORTO,1302,17452.83,18748,1070,862,714,686,725,1411,2125,2987,4057,107.42,23.25,17.11,12.18
02-12-2021,BARCELOS,318,23,274,"[240,480]",Elevado,,,,318,Norte,BRAGA,0302,37890.14,116187,6721,5325,3619,2991,2562,5553,9172,14497,21218,306.64,56.0,38.26,24.21
02-12-2021,BARRANCOS,79,6,4806,"[960,Max]",Extremamente Elevado,,,,79,Alentejo,BEJA,0204,16841.73,1634,90,65,65,94,61,155,220,285,375,9.7,2.23,1.69,1.31
02-12-2021,BARREIRO,282,20,375,"[240,480]",Elevado,,,,282,Lisboa e Vale do Tejo,SETÚBAL,1504,3639.07,75147,5194,5565,4459,3105,1767,4872,9331,14896,20090,2065.05,552.07,409.34,256.42
02-12-2021,BATALHA,115,8,718,"[480,960]",Muito Elevado,,,,115,Centro,LEIRIA,1004,10341.6,15963,873,762,649,529,549,1078,1727,2489,3362,154.35,32.51,24.07,16.7
02-12-2021,BEJA,234,17,696,"[480,960]",Muito Elevado,,,,234,Alentejo,BEJA,0205,114647.55,33579,2005,1840,1386,1272,1039,2311,3697,5537,7542,29.29,6.58,4.83,3.22
02-12-2021,BELMONTE,31,2,486,"[480,960]",Muito Elevado,,,,31,Centro,CASTELO BRANCO,0501,11875.91,6398,444,321,325,310,355,665,990,1311,1755,53.87,14.78,11.04,8.34
02-12-2021,BENAVENTE,81,6,264,"[240,480]",Elevado,,,,81,Lisboa e Vale do Tejo,SANTARÉM,1405,52138.39,30602,1468,1376,1141,876,643,1519,2660,4036,5504,58.69,10.56,7.74,5.1
02-12-2021,BOMBARRAL,21,1,166,"[120,240]",Moderado,,,,21,Lisboa e Vale do Tejo,LEIRIA,1005,9128.55,12558,875,714,561,491,429,920,1481,2195,3070,137.56,33.63,24.04,16.22
02-12-2021,BORBA,39,3,585,"[480,960]",Muito Elevado,,,,39,Alentejo,ÉVORA,0703,14518.65,6736,430,375,279,436,392,828,1107,1482,1912,46.39,13.17,10.21,7.62
02-12-2021,BOTICAS,6,0,122,"[120,240]",Moderado,,,,6,Norte,VILA REAL,1702,32195.66,4998,347,306,311,305,380,685,996,1302,1649,15.52,5.12,4.04,3.09
02-12-2021,BRAGA,1131,81,619,"[480,960]",Muito Elevado,,,,1131,Norte,BRAGA,0303,18339.95,182679,10029,7963,5241,4320,3671,7991,13232,21195,31224,996.07,170.25,115.57,72.15
02-12-2021,BRAGANÇA,200,14,595,"[480,960]",Muito Elevado,,,,200,Norte,BRAGANÇA,0402,117357.27,33607,2402,1855,1652,1393,1163,2556,4208,6063,8465,28.64,7.21,5.17,3.59
02-12-2021,CABECEIRAS DE BASTO,29,2,187,"[120,240]",Moderado,,,,29,Norte,BRAGA,0304,24182.16,15628,774,594,544,575,574,1149,1693,2287,3061,64.63,12.66,9.46,7.0
02-12-2021,CADAVAL,23,2,167,"[120,240]",Moderado,,,,23,Lisboa e Vale do Tejo,LISBOA,1104,17489.3,13673,813,796,756,621,625,1246,2002,2798,3611,78.18,20.65,16.0,11.45
02-12-2021,CALDAS DA RAINHA,215,15,415,"[240,480]",Elevado,,,,215,Lisboa e Vale do Tejo,LEIRIA,1006,25569.47,51912,3035,2684,2186,1899,1705,3604,5790,8474,11509,203.03,45.01,33.14,22.64
02-12-2021,CALHETA,34,2,314,"[240,480]",Elevado,,,,34,Madeira,MADEIRA,3101,11150.43,10867,576,497,507,399,415,814,1321,1818,2394,97.46,21.47,16.3,11.85
02-12-2021,CALHETA (AÇORES),1,0,32,"[0,120]",Baixo a Moderado,,,,1,Açores,AÇORES,4501,12626.4,3184,215,159,141,139,122,261,402,561,776,25.22,6.15,4.44,3.18
02-12-2021,CÂMARA DE LOBOS,291,21,865,"[480,960]",Muito Elevado,,,,291,Madeira,MADEIRA,3102,5216.67,33675,1396,1059,834,545,381,926,1760,2819,4215,645.49,80.79,54.03,33.74
02-12-2021,CAMINHA,21,2,133,"[120,240]",Moderado,,,,21,Norte,VIANA DO CASTELO,1602,13652.14,15877,1046,944,818,646,656,1302,2120,3064,4110,116.3,30.11,22.44,15.53
02-12-2021,CAMPO MAIOR,55,4,693,"[480,960]",Muito Elevado,,,,55,Alentejo,PORTALEGRE,1204,24720.16,7874,471,364,351,279,327,606,957,1321,1792,31.85,7.25,5.34,3.87
02-12-2021,CANTANHEDE,165,12,470,"[240,480]",Elevado,,,,165,Centro,COIMBRA,0602,39088.02,35011,2346,2096,1880,1709,1451,3160,5040,7136,9482,89.57,24.26,18.26,12.89
02-12-2021,CARRAZEDA DE ANSIÃES,9,1,160,"[120,240]",Moderado,,,,9,Norte,BRAGANÇA,0403,27924.09,5666,424,389,391,312,465,777,1168,1557,1981,20.29,7.09,5.58,4.18
02-12-2021,CARREGAL DO SAL,118,8,1278,"[960,Max]",Extremamente Elevado,,,,118,Centro,VISEU,1802,11689.21,9271,587,562,486,462,376,838,1324,1886,2473,79.31,21.16,16.13,11.33
02-12-2021,CARTAXO,125,9,526,"[480,960]",Muito Elevado,,,,125,Lisboa e Vale do Tejo,SANTARÉM,1406,15817.28,23843,1415,1376,1142,861,632,1493,2635,4011,5426,150.74,34.3,25.36,16.66
02-12-2021,CASCAIS,720,51,337,"[240,480]",Elevado,,,,720,Lisboa e Vale do Tejo,LISBOA,1105,9740.17,213608,12151,11444,8680,6469,5248,11717,20397,31841,43992,2193.1,451.66,326.91,209.41
02-12-2021,CASTANHEIRA DE PÊRA,5,0,194,"[120,240]",Moderado,,,,5,Centro,LEIRIA,1007,6677.45,2614,233,195,157,190,187,377,534,729,962,39.15,14.41,10.92,8.0
02-12-2021,CASTELO BRANCO,113,8,217,"[120,240]",Moderado,,,,113,Centro,CASTELO BRANCO,0502,143819.15,51987,3528,3042,2499,2229,2225,4454,6953,9995,13523,36.15,9.4,6.95,4.83
02-12-2021,CASTELO DE PAIVA,33,2,216,"[120,240]",Moderado,,,,33,Norte,AVEIRO,0106,11500.53,15454,881,697,545,420,431,851,1396,2093,2974,134.37,25.86,18.2,12.14
02-12-2021,CASTELO DE VIDE,10,1,346,"[240,480]",Elevado,,,,10,Alentejo,PORTALEGRE,1205,26491.24,2919,204,173,179,147,170,317,496,669,873,11.02,3.3,2.53,1.87
02-12-2021,CASTRO DAIRE,69,5,499,"[480,960]",Muito Elevado,,,,69,Centro,VISEU,1803,37904.13,13823,942,857,765,732,773,1505,2270,3127,4069,36.47,10.74,8.25,5.99
02-12-2021,CASTRO MARIM,12,1,194,"[120,240]",Moderado,,,,12,Algarve,FARO,0804,30084.37,6237,370,345,334,322,344,666,1000,1345,1715,20.73,5.7,4.47,3.32
02-12-2021,CASTRO VERDE,8,1,116,"[0,120]",Baixo a Moderado,,,,8,Alentejo,BEJA,0206,56944.23,6949,437,347,303,275,227,502,805,1152,1589,12.2,2.79,2.02,1.41
02-12-2021,CELORICO DA BEIRA,21,1,303,"[240,480]",Elevado,,,,21,Centro,GUARDA,0903,24721.63,6928,430,416,363,369,535,904,1267,1683,2113,28.02,8.55,6.81,5.12
02-12-2021,CELORICO DE BASTO,35,3,185,"[120,240]",Moderado,,,,35,Norte,BRAGA,0305,18107.02,19040,1001,802,668,728,729,1457,2125,2927,3928,105.15,21.69,16.17,11.74
02-12-2021,CHAMUSCA,31,2,342,"[240,480]",Elevado,,,,31,Lisboa e Vale do Tejo,SANTARÉM,1407,74600.54,9197,629,583,553,465,579,1044,1597,2180,2809,12.33,3.77,2.92,2.14
02-12-2021,CHAVES,117,8,298,"[240,480]",Elevado,,,,117,Norte,VILA REAL,1703,59122.95,39343,2676,2429,1991,1886,1918,3804,5795,8224,10900,66.54,18.44,13.91,9.8
02-12-2021,CINFÃES,52,4,283,"[240,480]",Elevado,,,,52,Norte,VISEU,1804,23928.76,18244,1067,902,779,734,758,1492,2271,3173,4240,76.24,17.72,13.26,9.49
02-12-2021,COIMBRA,723,52,539,"[480,960]",Muito Elevado,,,,723,Centro,COIMBRA,0603,31939.94,134166,9489,8734,6353,5139,5074,10213,16566,25300,34789,420.06,108.92,79.21,51.87
02-12-2021,CONDEIXA-A-NOVA,115,8,648,"[480,960]",Muito Elevado,,,,115,Centro,COIMBRA,0604,13867.47,17733,871,809,717,583,490,1073,1790,2599,3470,127.88,25.02,18.74,12.91
02-12-2021,CONSTÂNCIA,26,2,642,"[480,960]",Muito Elevado,,,,26,Lisboa e Vale do Tejo,SANTARÉM,1408,8036.58,4030,211,183,187,148,155,303,490,673,884,50.14,11.0,8.37,6.1
02-12-2021,CORUCHE,83,6,477,"[240,480]",Elevado,,,,83,Lisboa e Vale do Tejo,SANTARÉM,1409,111572.03,17471,1294,1090,1095,1096,1019,2115,3210,4300,5594,15.66,5.01,3.85,2.88
02-12-2021,CORVO,3,0,638,"[480,960]",Muito Elevado,,,,3,Açores,AÇORES,4901,1711.45,464,22,21,11,13,19,32,43,64,86,27.12,5.03,3.74,2.51
02-12-2021,COVILHÃ,448,32,958,"[480,960]",Muito Elevado,,,,448,Centro,CASTELO BRANCO,0503,55560.06,46787,3533,2998,2365,2111,2193,4304,6669,9667,13200,84.21,23.76,17.4,12.0
02-12-2021,CRATO,3,0,98,"[0,120]",Baixo a Moderado,,,,3,Alentejo,PORTALEGRE,1206,39806.88,3129,229,258,163,182,228,410,573,831,1060,7.86,2.66,2.09,1.44
02-12-2021,CUBA,14,1,308,"[240,480]",Elevado,,,,14,Alentejo,BEJA,0207,17208.72,4595,255,233,206,190,143,333,539,772,1027,26.7,5.97,4.49,3.13
02-12-2021,ELVAS,21,2,104,"[0,120]",Baixo a Moderado,,,,21,Alentejo,PORTALEGRE,1207,63128.86,20528,1057,1145,902,852,810,1662,2564,3709,4766,32.52,7.55,5.88,4.06
02-12-2021,ENTRONCAMENTO,169,12,785,"[480,960]",Muito Elevado,,,,169,Lisboa e Vale do Tejo,SANTARÉM,1410,1372.81,21558,1066,930,868,695,592,1287,2155,3085,4151,1570.14,302.33,224.69,156.96
02-12-2021,ESPINHO,120,9,408,"[240,480]",Elevado,,,,120,Norte,AVEIRO,0107,2105.68,29516,2205,1993,1430,1177,960,2137,3567,5560,7765,1401.52,368.71,264.01,169.37
02-12-2021,ESPOSENDE,100,7,293,"[240,480]",Elevado,,,,100,Norte,BRAGA,0306,9540.98,34177,1831,1522,1095,894,723,1617,2712,4234,6065,358.21,63.57,44.38,28.42
02-12-2021,ESTARREJA,170,12,654,"[480,960]",Muito Elevado,,,,170,Centro,AVEIRO,0108,10817.33,26006,1503,1399,1106,953,728,1681,2787,4186,5689,240.42,52.59,38.7,25.76
02-12-2021,ESTREMOZ,22,2,175,"[120,240]",Moderado,,,,22,Alentejo,ÉVORA,0704,51379.95,12728,789,613,697,786,877,1663,2360,2973,3762,24.77,7.32,5.79,4.59
02-12-2021,ÉVORA,217,16,414,"[240,480]",Elevado,,,,217,Alentejo,ÉVORA,0705,130707.58,52428,3569,2852,2176,1966,1803,3769,5945,8797,12366,40.11,9.46,6.73,4.55
02-12-2021,FAFE,110,8,228,"[120,240]",Moderado,,,,110,Norte,BRAGA,0307,21908.11,48060,3044,2455,1679,1403,1208,2611,4290,6745,9789,219.37,44.68,30.79,19.58
02-12-2021,FARO,381,27,624,"[480,960]",Muito Elevado,,,,381,Algarve,FARO,0805,20256.79,61015,3847,3364,2604,2055,1601,3656,6260,9624,13471,301.2,66.5,47.51,30.9
02-12-2021,FELGUEIRAS,113,8,200,"[120,240]",Moderado,,,,113,Norte,PORTO,1303,11573.75,56422,2951,2302,1601,1316,973,2289,3890,6192,9143,487.49,79.0,53.5,33.61
02-12-2021,FERREIRA DO ALENTEJO,10,1,128,"[120,240]",Moderado,,,,10,Alentejo,BEJA,0208,64820.68,7845,515,414,372,343,345,688,1060,1474,1989,12.1,3.07,2.27,1.64
02-12-2021,FERREIRA DO ZÊZERE,28,2,352,"[240,480]",Elevado,,,,28,Lisboa e Vale do Tejo,SANTARÉM,1411,19038.03,7959,470,370,416,465,456,921,1337,1707,2177,41.81,11.44,8.97,7.02
02-12-2021,FIGUEIRA DA FOZ,382,27,650,"[480,960]",Muito Elevado,,,,382,Centro,COIMBRA,0605,37905.26,58747,4032,3597,2887,2495,2043,4538,7425,11022,15054,154.98,39.72,29.08,19.59
02-12-2021,FIGUEIRA DE CASTELO RODRIGO,5,0,89,"[0,120]",Baixo a Moderado,,,,5,Centro,GUARDA,0904,50857.46,5584,347,352,290,352,391,743,1033,1385,1732,10.98,3.41,2.72,2.03
02-12-2021,FIGUEIRÓ DOS VINHOS,35,3,629,"[480,960]",Muito Elevado,,,,35,Centro,LEIRIA,1008,17344.0,5568,402,386,322,309,351,660,982,1368,1770,32.1,10.21,7.89,5.66
02-12-2021,FORNOS DE ALGODRES,6,0,132,"[120,240]",Moderado,,,,6,Centro,GUARDA,0905,13145.05,4528,261,218,247,256,232,488,735,953,1214,34.45,9.24,7.25,5.59
02-12-2021,FREIXO DE ESPADA À CINTA,8,1,247,"[240,480]",Elevado,,,,8,Norte,BRAGANÇA,0404,24414.29,3298,211,177,231,196,189,385,616,793,1004,13.51,4.11,3.25,2.52
02-12-2021,FRONTEIRA,8,1,273,"[240,480]",Elevado,,,,8,Alentejo,PORTALEGRE,1208,24859.58,2974,213,182,149,156,168,324,473,655,868,11.96,3.49,2.63,1.9
02-12-2021,FUNCHAL,566,40,544,"[480,960]",Muito Elevado,,,,566,Madeira,MADEIRA,3103,7616.2,104024,6382,5086,3643,2821,1990,4811,8454,13540,19922,1365.86,261.58,177.78,111.0
02-12-2021,FUNDÃO,148,11,559,"[480,960]",Muito Elevado,,,,148,Centro,CASTELO BRANCO,0504,70019.79,26495,1781,1464,1432,1357,1643,3000,4432,5896,7677,37.84,10.96,8.42,6.33
02-12-2021,GAVIÃO,12,1,377,"[240,480]",Elevado,,,,12,Alentejo,PORTALEGRE,1209,29459.45,3263,189,186,222,263,293,556,778,964,1153,11.08,3.91,3.27,2.64
02-12-2021,GÓIS,9,1,239,"[120,240]",Moderado,,,,9,Centro,COIMBRA,0606,26330.19,3805,235,199,240,233,244,477,717,916,1151,14.45,4.37,3.48,2.72
02-12-2021,GOLEGÃ,38,3,718,"[480,960]",Muito Elevado,,,,38,Lisboa e Vale do Tejo,SANTARÉM,1412,8431.67,5339,356,299,281,243,255,498,779,1078,1434,63.32,17.01,12.78,9.24
02-12-2021,GONDOMAR,453,32,273,"[240,480]",Elevado,,,,453,Norte,PORTO,1304,13191.76,165985,10555,8755,6222,4450,3364,7814,14036,22791,33346,1258.22,252.77,172.76,106.4
02-12-2021,GOUVEIA,65,5,526,"[480,960]",Muito Elevado,,,,65,Centro,GUARDA,0906,30061.17,12387,871,931,780,783,810,1593,2373,3304,4175,41.21,13.89,10.99,7.89
02-12-2021,GRÂNDOLA,39,3,267,"[240,480]",Elevado,,,,39,Alentejo,SETÚBAL,1505,82593.66,14639,834,834,708,688,672,1360,2068,2902,3736,17.72,4.52,3.51,2.5
02-12-2021,GUARDA,262,19,672,"[480,960]",Muito Elevado,,,,262,Centro,GUARDA,0907,71209.58,38969,2477,2041,1686,1415,1474,2889,4575,6616,9093,54.72,12.77,9.29,6.42
02-12-2021,GUIMARÃES,291,21,191,"[120,240]",Moderado,,,,291,Norte,BRAGA,0308,24099.96,152309,9394,7074,4809,3877,2948,6825,11634,18708,28102,631.99,116.61,77.63,48.27
02-12-2021,HORTA,17,1,118,"[0,120]",Baixo a Moderado,,,,17,Açores,AÇORES,4701,17305.53,14521,818,658,468,352,302,654,1122,1780,2598,83.91,15.01,10.29,6.48
02-12-2021,IDANHA-A-NOVA,43,3,530,"[480,960]",Muito Elevado,,,,43,Centro,CASTELO BRANCO,0505,141633.51,8043,518,490,519,672,974,1646,2165,2655,3173,5.68,2.24,1.87,1.53
02-12-2021,ÍLHAVO,253,18,654,"[480,960]",Muito Elevado,,,,253,Centro,AVEIRO,0110,7347.55,38699,2227,1943,1444,1193,850,2043,3487,5430,7657,526.66,104.21,73.9,47.46
02-12-2021,LAGOA (FARO),212,15,932,"[480,960]",Muito Elevado,,,,212,Algarve,FARO,0806,8825.45,22762,1314,1168,919,749,670,1419,2338,3506,4820,257.93,54.62,39.73,26.49
02-12-2021,LAGOA,49,3,332,"[240,480]",Elevado,,,,49,Açores,AÇORES,4201,4559.32,14721,536,458,349,238,235,473,822,1280,1816,322.9,39.83,28.08,18.03
02-12-2021,LAGOS,203,14,667,"[480,960]",Muito Elevado,,,,203,Algarve,FARO,0807,21299.27,30374,1744,1434,1247,1053,1029,2082,3329,4763,6507,142.61,30.55,22.36,15.63
02-12-2021,LAJES DAS FLORES,1,0,68,"[0,120]",Baixo a Moderado,,,,1,Açores,AÇORES,4801,7004.79,1463,88,53,62,46,54,100,162,215,303,20.89,4.33,3.07,2.31
02-12-2021,LAJES DO PICO,1,0,22,"[0,120]",Baixo a Moderado,,,,1,Açores,AÇORES,4601,15531.09,4490,304,231,223,159,162,321,544,775,1079,28.91,6.95,4.99,3.5
02-12-2021,LAMEGO,46,3,186,"[120,240]",Moderado,,,,46,Norte,VISEU,1805,16542.11,24895,1639,1284,1124,898,783,1681,2805,4089,5728,150.5,34.63,24.72,16.96
02-12-2021,LEIRIA,788,56,629,"[480,960]",Muito Elevado,,,,788,Centro,LEIRIA,1009,56508.83,125267,7389,6366,5090,3902,3159,7061,12151,18517,25906,221.68,45.84,32.77,21.5
02-12-2021,LISBOA,2502,179,491,"[480,960]",Muito Elevado,,,,2502,Lisboa e Vale do Tejo,LISBOA,1106,10005.43,509515,33197,33340,27706,23037,26770,49807,77513,110853,144050,5092.6,1439.78,1107.98,774.74
02-12-2021,LOULÉ,538,38,783,"[480,960]",Muito Elevado,,,,538,Algarve,FARO,0808,76366.91,68697,3890,3350,2780,2358,2251,4609,7389,10739,14629,89.96,19.16,14.06,9.68
02-12-2021,LOURES,502,36,235,"[120,240]",Moderado,,,,502,Lisboa e Vale do Tejo,LISBOA,1107,16723.99,213687,12746,12794,9644,6669,5033,11702,21346,34140,46886,1277.73,280.35,204.14,127.64
02-12-2021,LOURINHÃ,74,5,286,"[240,480]",Elevado,,,,74,Lisboa e Vale do Tejo,LISBOA,1108,14717.2,25855,1584,1243,992,842,645,1487,2479,3722,5306,175.68,36.05,25.29,16.84
02-12-2021,LOUSÃ,93,7,544,"[480,960]",Muito Elevado,,,,93,Centro,COIMBRA,0607,13840.01,17158,946,866,658,528,450,978,1636,2502,3448,123.97,24.91,18.08,11.82
02-12-2021,LOUSADA,56,4,120,"[120,240]",Moderado,,,,56,Norte,PORTO,1305,9608.01,46755,2289,1698,1176,853,621,1474,2650,4348,6637,486.63,69.08,45.25,27.58
02-12-2021,MAÇÃO,9,1,145,"[120,240]",Moderado,,,,9,Lisboa e Vale do Tejo,SANTARÉM,1413,39997.98,6267,386,362,390,440,657,1097,1487,1849,2235,15.67,5.59,4.62,3.72
02-12-2021,MACEDO DE CAVALEIROS,69,5,472,"[240,480]",Elevado,,,,69,Norte,BRAGANÇA,0405,69914.08,14516,1082,889,878,823,938,1761,2639,3528,4610,20.76,6.59,5.05,3.77
02-12-2021,MACHICO,60,4,302,"[240,480]",Elevado,,,,60,Madeira,MADEIRA,3104,6825.1,19981,1197,860,662,455,331,786,1448,2308,3505,292.76,51.36,33.82,21.22
02-12-2021,MADALENA,2,0,34,"[0,120]",Baixo a Moderado,,,,2,Açores,AÇORES,4602,14712.33,5895,334,256,173,190,179,369,542,798,1132,40.07,7.69,5.42,3.68
02-12-2021,MAFRA,214,15,252,"[240,480]",Elevado,,,,214,Lisboa e Vale do Tejo,LISBOA,1109,29165.5,84816,3613,3334,2839,2089,1899,3988,6827,10161,13774,290.81,47.23,34.84,23.41
02-12-2021,MAIA,416,30,299,"[240,480]",Elevado,,,,416,Norte,PORTO,1306,8293.94,138971,7801,6617,4512,3339,2631,5970,10482,17099,24900,1675.56,300.22,206.16,126.38
02-12-2021,MANGUALDE,66,5,356,"[240,480]",Elevado,,,,66,Centro,VISEU,1806,21925.56,18510,1198,1128,885,852,743,1595,2480,3608,4806,84.42,21.92,16.46,11.31
02-12-2021,MANTEIGAS,21,2,703,"[480,960]",Muito Elevado,,,,21,Centro,GUARDA,0908,12197.55,3007,258,197,159,167,146,313,472,669,927,24.65,7.6,5.48,3.87
02-12-2021,MARCO DE CANAVESES,76,5,148,"[120,240]",Moderado,,,,76,Norte,PORTO,1307,20188.98,51496,2678,2060,1488,1265,1023,2288,3776,5836,8514,255.07,42.17,28.91,18.7
02-12-2021,MARINHA GRANDE,193,14,502,"[480,960]",Muito Elevado,,,,193,Centro,LEIRIA,1010,18725.19,38508,2365,2302,1638,1359,1058,2417,4055,6357,8722,205.65,46.58,33.95,21.66
02-12-2021,MARVÃO,12,1,408,"[240,480]",Elevado,,,,12,Alentejo,PORTALEGRE,1210,15489.9,3005,198,185,142,197,237,434,576,761,959,19.4,6.19,4.91,3.72
02-12-2021,MATOSINHOS,679,48,387,"[240,480]",Elevado,,,,679,Norte,PORTO,1308,6241.97,175357,11850,9977,7023,5024,3884,8908,15931,25908,37758,2809.31,604.9,415.06,255.22
02-12-2021,MEALHADA,190,14,954,"[480,960]",Muito Elevado,,,,190,Centro,AVEIRO,0111,11065.66,19914,1163,1039,810,828,831,1659,2469,3508,4671,179.96,42.21,31.7,22.31
02-12-2021,MÊDA,20,1,437,"[240,480]",Elevado,,,,20,Centro,GUARDA,0909,28604.92,4587,343,306,290,288,443,731,1021,1327,1670,16.04,5.84,4.64,3.57
02-12-2021,MELGAÇO,8,1,100,"[0,120]",Baixo a Moderado,,,,8,Norte,VIANA DO CASTELO,1603,23824.58,8093,507,567,578,614,675,1289,1867,2434,2941,33.97,12.34,10.22,7.84
02-12-2021,MÉRTOLA,13,1,215,"[120,240]",Moderado,,,,13,Alentejo,BEJA,0209,129287.34,6142,400,390,378,423,600,1023,1401,1791,2191,4.75,1.69,1.39,1.08
02-12-2021,MESÃO FRIO,6,0,152,"[120,240]",Moderado,,,,6,Norte,VILA REAL,1704,2664.87,3964,265,205,168,157,120,277,445,650,915,148.74,34.33,24.39,16.7
02-12-2021,MIRA,164,12,1389,"[960,Max]",Extremamente Elevado,,,,164,Centro,COIMBRA,0608,12403.38,11832,727,729,659,550,466,1016,1675,2404,3131,95.4,25.24,19.38,13.5
02-12-2021,MIRANDA DO CORVO,45,3,354,"[240,480]",Elevado,,,,45,Centro,COIMBRA,0609,12637.79,12708,706,659,568,498,404,902,1470,2129,2835,100.55,22.43,16.85,11.63
02-12-2021,MIRANDA DO DOURO,38,3,562,"[480,960]",Muito Elevado,,,,38,Norte,BRAGANÇA,0406,48718.31,6830,482,429,442,463,470,933,1375,1804,2286,14.02,4.69,3.7,2.82
02-12-2021,MIRANDELA,97,7,445,"[240,480]",Elevado,,,,97,Norte,BRAGANÇA,0407,65895.67,21754,1640,1315,1204,1078,947,2025,3229,4544,6184,33.01,9.38,6.9,4.9
02-12-2021,MOGADOURO,23,2,278,"[240,480]",Elevado,,,,23,Norte,BRAGANÇA,0408,76064.93,8392,589,529,576,630,655,1285,1861,2390,2979,11.03,3.92,3.14,2.45
02-12-2021,MOIMENTA DA BEIRA,41,3,422,"[240,480]",Elevado,,,,41,Norte,VISEU,1807,21996.9,9736,576,514,471,416,461,877,1348,1862,2438,44.26,11.08,8.46,6.13
02-12-2021,MOITA,242,17,376,"[240,480]",Elevado,,,,242,Lisboa e Vale do Tejo,SETÚBAL,1506,5525.98,64407,4226,3646,2623,1801,1425,3226,5849,9495,13721,1165.53,248.3,171.82,105.85
02-12-2021,MONÇÃO,7,0,39,"[0,120]",Baixo a Moderado,,,,7,Norte,VIANA DO CASTELO,1604,21130.85,17869,1161,1105,1031,1006,972,1978,3009,4114,5275,84.56,24.96,19.47,14.24
02-12-2021,MONCHIQUE,56,4,1105,"[960,Max]",Extremamente Elevado,,,,56,Algarve,FARO,0809,39530.43,5077,353,384,321,355,392,747,1068,1452,1805,12.84,4.57,3.67,2.7
02-12-2021,MONDIM DE BASTO,10,1,145,"[120,240]",Moderado,,,,10,Norte,VILA REAL,1705,17207.52,6946,395,300,314,284,283,567,881,1181,1576,40.36,9.16,6.86,5.12
02-12-2021,MONFORTE,3,0,102,"[0,120]",Baixo a Moderado,,,,3,Alentejo,PORTALEGRE,1211,42024.82,2975,139,115,117,192,168,360,477,592,731,7.08,1.74,1.41,1.14
02-12-2021,MONTALEGRE,17,1,191,"[120,240]",Moderado,,,,17,Norte,VILA REAL,1706,80545.71,8997,699,628,595,603,730,1333,1928,2556,3255,11.17,4.04,3.17,2.39
02-12-2021,MONTEMOR-O-NOVO,14,1,91,"[0,120]",Baixo a Moderado,,,,14,Alentejo,ÉVORA,0706,123296.65,15647,991,953,868,878,971,1849,2717,3670,4661,12.69,3.78,2.98,2.2
02-12-2021,MONTEMOR-O-VELHO,168,12,668,"[480,960]",Muito Elevado,,,,168,Centro,COIMBRA,0610,22896.23,25224,1496,1397,1217,1057,988,2045,3262,4659,6155,110.17,26.88,20.35,14.25
02-12-2021,MONTIJO,140,10,243,"[240,480]",Elevado,,,,140,Lisboa e Vale do Tejo,SETÚBAL,1507,34861.64,57614,2771,2441,1990,1554,1109,2663,4653,7094,9865,165.26,28.3,20.35,13.35
02-12-2021,MORA,24,2,570,"[480,960]",Muito Elevado,,,,24,Alentejo,ÉVORA,0707,44395.02,4138,336,275,252,238,257,495,747,1022,1358,9.32,3.06,2.3,1.68
02-12-2021,MORTÁGUA,22,2,250,"[240,480]",Elevado,,,,22,Centro,VISEU,1808,25117.82,8803,638,584,535,499,460,959,1494,2078,2716,35.05,10.81,8.27,5.95
02-12-2021,MOURA,94,7,684,"[480,960]",Muito Elevado,,,,94,Alentejo,BEJA,0210,95845.55,13718,817,656,665,542,461,1003,1668,2324,3141,14.31,3.28,2.42,1.74
02-12-2021,MOURÃO,5,0,206,"[120,240]",Moderado,,,,5,Alentejo,ÉVORA,0708,27862.98,2450,139,108,80,104,109,213,293,401,540,8.79,1.94,1.44,1.05
02-12-2021,MURÇA,12,1,222,"[120,240]",Moderado,,,,12,Norte,VILA REAL,1707,18937.11,5463,384,341,307,306,319,625,932,1273,1657,28.85,8.75,6.72,4.92
02-12-2021,MURTOSA,27,2,259,"[240,480]",Elevado,,,,27,Centro,AVEIRO,0112,7308.78,10279,509,473,403,353,409,762,1165,1638,2147,140.63,29.37,22.41,15.94
02-12-2021,NAZARÉ,104,7,736,"[480,960]",Muito Elevado,,,,104,Lisboa e Vale do Tejo,LEIRIA,1011,8243.43,14165,967,903,670,420,396,816,1486,2389,3356,171.84,40.71,28.98,18.03
02-12-2021,NELAS,60,4,462,"[240,480]",Elevado,,,,60,Centro,VISEU,1809,12571.48,12974,924,787,668,604,583,1187,1855,2642,3566,103.21,28.37,21.02,14.76
02-12-2021,NISA,48,3,789,"[480,960]",Muito Elevado,,,,48,Alentejo,PORTALEGRE,1212,57567.84,6061,405,389,355,483,478,961,1316,1705,2110,10.53,3.67,2.96,2.29
02-12-2021,NORDESTE,2,0,42,"[0,120]",Baixo a Moderado,,,,2,Açores,AÇORES,4202,10146.8,4862,246,180,124,161,162,323,447,627,873,47.92,8.6,6.18,4.41
02-12-2021,ÓBIDOS,44,3,374,"[240,480]",Elevado,,,,44,Lisboa e Vale do Tejo,LEIRIA,1012,14155.44,11850,743,650,574,452,436,888,1462,2112,2855,83.72,20.17,14.92,10.33
02-12-2021,ODEMIRA,111,8,451,"[240,480]",Elevado,,,,111,Alentejo,BEJA,0211,172060.15,24717,1475,1317,1225,1397,1349,2746,3971,5288,6763,14.37,3.93,3.07,2.31
02-12-2021,ODIVELAS,408,29,252,"[240,480]",Elevado,,,,408,Lisboa e Vale do Tejo,LISBOA,1116,2654.36,161774,9562,9038,6952,4641,3812,8453,15405,24443,34005,6095.48,1281.27,920.99,580.44
02-12-2021,OEIRAS,660,47,372,"[240,480]",Elevado,,,,660,Lisboa e Vale do Tejo,LISBOA,1110,4588.31,177408,11580,11575,8566,6211,5855,12066,20632,32207,43787,3866.78,954.38,701.98,449.69
02-12-2021,OLEIROS,8,1,160,"[120,240]",Moderado,,,,8,Centro,CASTELO BRANCO,0506,47109.31,5003,384,341,366,397,487,884,1250,1591,1975,10.62,4.19,3.38,2.65
02-12-2021,OLHÃO,256,18,577,"[480,960]",Muito Elevado,,,,256,Algarve,FARO,0810,13086.38,44405,2455,2309,1689,1342,1268,2610,4299,6608,9063,339.33,69.26,50.5,32.85
02-12-2021,OLIVEIRA DE AZEMÉIS,380,27,576,"[480,960]",Muito Elevado,,,,380,Norte,AVEIRO,0113,16110.41,66011,4155,3614,2794,2183,1738,3921,6715,10329,14484,409.75,89.91,64.12,41.68
02-12-2021,OLIVEIRA DE FRADES,5,0,50,"[0,120]",Baixo a Moderado,,,,5,Centro,VISEU,1810,14534.62,9936,553,475,438,359,415,774,1212,1687,2240,68.36,15.41,11.61,8.34
02-12-2021,OLIVEIRA DO BAIRRO,131,9,538,"[480,960]",Muito Elevado,,,,131,Centro,AVEIRO,0114,8731.99,24277,1327,1182,999,786,810,1596,2595,3777,5104,278.02,58.45,43.25,29.72
02-12-2021,OLIVEIRA DO HOSPITAL,16,1,83,"[0,120]",Baixo a Moderado,,,,16,Centro,COIMBRA,0611,23451.66,19253,1161,1097,962,924,960,1884,2846,3943,5104,82.1,21.76,16.81,12.14
02-12-2021,OURÉM,281,20,638,"[480,960]",Muito Elevado,,,,281,Lisboa e Vale do Tejo,SANTARÉM,1421,41668.03,44044,2463,2069,1899,1817,1603,3420,5319,7388,9851,105.7,23.64,17.73,12.77
02-12-2021,OURIQUE,11,1,242,"[240,480]",Elevado,,,,11,Alentejo,BEJA,0212,66331.36,4607,313,287,284,268,227,495,779,1066,1379,6.95,2.08,1.61,1.17
02-12-2021,OVAR,197,14,363,"[240,480]",Elevado,,,,197,Centro,AVEIRO,0115,14770.25,54260,3294,2709,1994,1636,1234,2870,4864,7573,10867,367.37,73.57,51.27,32.93
02-12-2021,PAÇOS DE FERREIRA,68,5,120,"[120,240]",Moderado,,,,68,Norte,PORTO,1309,7099.29,56728,2903,2193,1518,1135,664,1799,3317,5510,8413,799.1,118.51,77.62,46.72
02-12-2021,PALMELA,175,12,272,"[240,480]",Elevado,,,,175,Lisboa e Vale do Tejo,SETÚBAL,1508,46512.01,64269,3402,3244,2635,1846,1391,3237,5872,9116,12518,138.18,26.91,19.6,12.62
02-12-2021,PAMPILHOSA DA SERRA,9,1,223,"[120,240]",Moderado,,,,9,Centro,COIMBRA,0612,39646.24,4037,238,254,295,339,423,762,1057,1311,1549,10.18,3.91,3.31,2.67
02-12-2021,PAREDES,173,12,201,"[120,240]",Moderado,,,,173,Norte,PORTO,1310,15675.69,86067,4272,3532,2412,1717,1258,2975,5387,8919,13191,549.04,84.15,56.9,34.36
02-12-2021,PAREDES DE COURA,13,1,153,"[120,240]",Moderado,,,,13,Norte,VIANA DO CASTELO,1605,13818.59,8535,466,528,407,465,515,980,1387,1915,2381,61.76,17.23,13.86,10.04
02-12-2021,PEDRÓGÃO GRANDE,3,0,88,"[0,120]",Baixo a Moderado,,,,3,Centro,LEIRIA,1013,12874.75,3410,175,173,196,221,252,473,669,842,1017,26.49,7.9,6.54,5.2
02-12-2021,PENACOVA,55,4,403,"[240,480]",Elevado,,,,55,Centro,COIMBRA,0613,21673.23,13694,968,923,745,621,703,1324,2069,2992,3960,63.18,18.27,13.81,9.55
02-12-2021,PENAFIEL,119,8,170,"[120,240]",Moderado,,,,119,Norte,PORTO,1311,21224.27,69772,3648,2823,2032,1663,1230,2893,4925,7748,11396,328.74,53.69,36.51,23.2
02-12-2021,PENALVA DO CASTELO,25,2,350,"[240,480]",Elevado,,,,25,Centro,VISEU,1811,13433.92,7115,449,457,413,391,426,817,1230,1687,2136,52.96,15.9,12.56,9.16
02-12-2021,PENAMACOR,12,1,254,"[240,480]",Elevado,,,,12,Centro,CASTELO BRANCO,0507,56370.69,4755,262,248,273,451,633,1084,1357,1605,1867,8.44,3.31,2.85,2.41
02-12-2021,PENEDONO,7,1,272,"[240,480]",Elevado,,,,7,Norte,VISEU,1812,13370.75,2591,172,113,129,156,138,294,423,536,708,19.38,5.3,4.01,3.16
02-12-2021,PENELA,17,1,316,"[240,480]",Elevado,,,,17,Centro,COIMBRA,0614,13480.0,5397,314,324,274,359,344,703,977,1301,1615,40.04,11.98,9.65,7.25
02-12-2021,PENICHE,121,9,457,"[240,480]",Elevado,,,,121,Lisboa e Vale do Tejo,LEIRIA,1014,7754.98,26501,1746,1504,1203,926,707,1633,2836,4340,6086,341.73,78.48,55.96,36.57
02-12-2021,PESO DA RÉGUA,27,2,172,"[120,240]",Moderado,,,,27,Norte,VILA REAL,1708,9486.01,15773,1076,843,650,659,455,1114,1764,2607,3683,166.28,38.83,27.48,18.6
02-12-2021,PINHEL,15,1,178,"[120,240]",Moderado,,,,15,Centro,GUARDA,0910,48452.12,8511,577,566,551,538,689,1227,1778,2344,2921,17.57,6.03,4.84,3.67
02-12-2021,POMBAL,363,26,706,"[480,960]",Muito Elevado,,,,363,Centro,LEIRIA,1015,62600.28,51461,3187,2791,2494,2328,2027,4355,6849,9640,12827,82.21,20.49,15.4,10.94
02-12-2021,PONTA DELGADA,141,10,208,"[120,240]",Moderado,,,,141,Açores,AÇORES,4203,23298.65,67935,3108,2435,1726,1133,902,2035,3761,6196,9304,291.58,39.93,26.59,16.14
02-12-2021,PONTA DO SOL,10,1,117,"[0,120]",Baixo a Moderado,,,,10,Madeira,MADEIRA,3105,4622.03,8593,319,283,347,208,221,429,776,1059,1378,185.92,29.81,22.91,16.79
02-12-2021,PONTE DA BARCA,86,6,766,"[480,960]",Muito Elevado,,,,86,Norte,VIANA DO CASTELO,1606,18211.37,11180,635,576,517,554,490,1044,1561,2137,2772,61.39,15.22,11.73,8.57
02-12-2021,PONTE DE LIMA,166,12,402,"[240,480]",Elevado,,,,166,Norte,VIANA DO CASTELO,1607,32025.46,41315,2321,2022,1720,1596,1462,3058,4778,6800,9121,129.01,28.48,21.23,14.92
02-12-2021,PONTE DE SOR,37,3,249,"[240,480]",Elevado,,,,37,Alentejo,PORTALEGRE,1213,83971.16,14994,939,800,716,739,831,1570,2286,3086,4025,17.86,4.79,3.68,2.72
02-12-2021,PORTALEGRE,25,2,114,"[0,120]",Baixo a Moderado,,,,25,Alentejo,PORTALEGRE,1214,44713.64,22172,1577,1351,1137,993,984,1977,3114,4465,6042,49.59,13.51,9.99,6.96
02-12-2021,PORTEL,15,1,260,"[240,480]",Elevado,,,,15,Alentejo,ÉVORA,0709,60100.57,5828,336,358,283,331,305,636,919,1277,1613,9.7,2.68,2.12,1.53
02-12-2021,PORTIMÃO,589,42,1061,"[960,Max]",Extremamente Elevado,,,,589,Algarve,FARO,0811,18206.29,55483,3182,2927,2116,1582,1400,2982,5098,8025,11207,304.75,61.56,44.08,28.0
02-12-2021,PORTO,1005,72,464,"[240,480]",Elevado,,,,1005,Norte,PORTO,1312,4142.02,216606,15790,15193,11280,9409,10044,19453,30733,45926,61716,5229.5,1490.0,1108.79,741.98
02-12-2021,PORTO DE MÓS,133,9,570,"[480,960]",Muito Elevado,,,,133,Centro,LEIRIA,1016,26183.41,23275,1355,1210,1034,888,872,1760,2794,4004,5359,88.89,20.47,15.29,10.67
02-12-2021,PORTO MONIZ,8,1,346,"[240,480]",Elevado,,,,8,Madeira,MADEIRA,3106,8293.38,2342,143,130,95,98,120,218,313,443,586,28.24,7.07,5.34,3.77
02-12-2021,PORTO SANTO,15,1,289,"[240,480]",Elevado,,,,15,Madeira,MADEIRA,3201,4300.7,5202,240,157,134,110,68,178,312,469,709,120.95,16.48,10.9,7.25
02-12-2021,PÓVOA DE LANHOSO,44,3,205,"[120,240]",Moderado,,,,44,Norte,BRAGA,0309,13465.29,21499,1175,909,732,673,624,1297,2029,2938,4113,159.67,30.55,21.82,15.07
02-12-2021,PÓVOA DE VARZIM,110,8,175,"[120,240]",Moderado,,,,110,Norte,PORTO,1313,8220.59,62784,3712,3120,2134,1594,1305,2899,5033,8153,11865,763.7,144.33,99.17,61.22
02-12-2021,POVOAÇÃO,4,0,68,"[0,120]",Baixo a Moderado,,,,4,Açores,AÇORES,4204,10640.77,5927,293,212,191,144,134,278,469,681,974,55.7,9.15,6.4,4.41
02-12-2021,VILA DA PRAIA DA VITÓRIA,6,0,28,"[0,120]",Baixo a Moderado,,,,6,Açores,AÇORES,4302,16127.06,21317,1133,789,619,436,336,772,1391,2180,3313,132.18,20.54,13.52,8.63
02-12-2021,PROENÇA-A-NOVA,14,1,193,"[120,240]",Moderado,,,,14,Centro,CASTELO BRANCO,0508,39539.96,7298,508,465,389,400,560,960,1349,1814,2322,18.46,5.87,4.59,3.41
02-12-2021,REDONDO,6,0,95,"[0,120]",Baixo a Moderado,,,,6,Alentejo,ÉVORA,0710,36950.87,6353,349,325,288,288,354,642,930,1255,1604,17.19,4.34,3.4,2.52
02-12-2021,REGUENGOS DE MONSARAZ,8,1,81,"[0,120]",Baixo a Moderado,,,,8,Alentejo,ÉVORA,0711,46399.72,10015,602,511,455,462,473,935,1390,1901,2503,21.58,5.39,4.1,3.0
02-12-2021,RESENDE,5,0,50,"[0,120]",Baixo a Moderado,,,,5,Norte,VISEU,1813,12334.93,10137,560,493,448,433,422,855,1303,1796,2356,82.18,19.1,14.56,10.56
02-12-2021,RIBEIRA BRAVA,43,3,348,"[240,480]",Elevado,,,,43,Madeira,MADEIRA,3107,6544.88,12435,648,500,411,311,287,598,1009,1509,2157,189.99,32.96,23.06,15.42
02-12-2021,RIBEIRA DE PENA,2,0,33,"[0,120]",Baixo a Moderado,,,,2,Norte,VILA REAL,1709,21745.98,6016,371,301,290,310,368,678,968,1269,1640,27.66,7.54,5.84,4.45
02-12-2021,RIBEIRA GRANDE,108,8,329,"[240,480]",Elevado,,,,108,Açores,AÇORES,4205,18015.13,32811,1163,689,512,345,253,598,1110,1799,2962,182.13,16.44,9.99,6.16
02-12-2021,RIO MAIOR,62,4,306,"[240,480]",Elevado,,,,62,Lisboa e Vale do Tejo,SANTARÉM,1414,27276.45,20379,1251,1144,941,795,648,1443,2384,3528,4779,74.71,17.52,12.93,8.74
02-12-2021,SABROSA,18,1,306,"[240,480]",Elevado,,,,18,Norte,VILA REAL,1710,15692.45,5918,393,314,304,302,350,652,956,1270,1663,37.71,10.6,8.09,6.09
02-12-2021,SABUGAL,61,4,580,"[480,960]",Muito Elevado,,,,61,Centro,GUARDA,0911,82269.82,10585,724,707,694,796,1009,1805,2499,3206,3930,12.87,4.78,3.9,3.04
02-12-2021,SALVATERRA DE MAGOS,67,5,316,"[240,480]",Elevado,,,,67,Lisboa e Vale do Tejo,SANTARÉM,1415,24393.2,21295,1275,1181,1060,799,772,1571,2631,3812,5087,87.3,20.85,15.63,10.79
02-12-2021,SANTA COMBA DÃO,38,3,364,"[240,480]",Elevado,,,,38,Centro,VISEU,1814,11194.77,10452,732,684,569,538,464,1002,1571,2255,2987,93.36,26.68,20.14,14.03
02-12-2021,SANTA CRUZ,173,12,381,"[240,480]",Elevado,,,,173,Madeira,MADEIRA,3108,8150.28,45281,1817,1301,974,716,523,1239,2213,3514,5331,555.6,65.41,43.12,27.15
02-12-2021,SANTA CRUZ DA GRACIOSA,10,1,239,"[120,240]",Moderado,,,,10,Açores,AÇORES,4401,6065.78,4208,228,180,163,124,145,269,432,612,840,69.37,13.85,10.09,7.12
02-12-2021,SANTA CRUZ DAS FLORES,1,0,46,"[0,120]",Baixo a Moderado,,,,1,Açores,AÇORES,4802,7091.44,2165,125,98,74,56,51,107,181,279,404,30.53,5.7,3.93,2.55
02-12-2021,SANTA MARIA DA FEIRA,774,55,558,"[480,960]",Muito Elevado,,,,774,Norte,AVEIRO,0109,21587.65,138636,8182,6743,4771,3856,3079,6935,11706,18449,26631,642.19,123.36,85.46,54.22
02-12-2021,SANTA MARTA DE PENAGUIÃO,6,0,92,"[0,120]",Baixo a Moderado,,,,6,Norte,VILA REAL,1711,6928.13,6599,483,373,337,316,317,633,970,1343,1826,95.25,26.36,19.39,14.0
02-12-2021,SANTANA,5,0,75,"[0,120]",Baixo a Moderado,,,,5,Madeira,MADEIRA,3109,9547.3,6711,418,353,343,282,277,559,902,1255,1673,70.29,17.52,13.15,9.45
02-12-2021,SANTARÉM,181,13,315,"[240,480]",Elevado,,,,181,Lisboa e Vale do Tejo,SANTARÉM,1416,55253.58,57421,3654,3441,2760,2466,2206,4672,7432,10873,14527,103.92,26.29,19.68,13.45
02-12-2021,SANTIAGO DO CACÉM,61,4,213,"[120,240]",Moderado,,,,61,Alentejo,SETÚBAL,1509,105969.29,28791,2144,1689,1472,1295,1215,2510,3982,5671,7815,27.17,7.37,5.35,3.76
02-12-2021,SANTO TIRSO,157,11,231,"[120,240]",Moderado,,,,157,Norte,PORTO,1314,13655.52,68055,4911,3935,2761,2257,1810,4067,6828,10763,15674,498.35,114.78,78.82,50.0
02-12-2021,SÃO BRÁS DE ALPORTEL,58,4,559,"[480,960]",Muito Elevado,,,,58,Algarve,FARO,0812,15336.92,10416,596,468,467,404,401,805,1272,1740,2336,67.91,15.23,11.35,8.29
02-12-2021,SÃO JOÃO DA MADEIRA,153,11,698,"[480,960]",Muito Elevado,,,,153,Norte,AVEIRO,0116,794.3,21958,1347,1069,796,601,593,1194,1990,3059,4406,2765.49,554.91,385.26,250.63
02-12-2021,SÃO JOÃO DA PESQUEIRA,18,1,255,"[240,480]",Elevado,,,,18,Norte,VISEU,1815,26610.85,7125,417,330,294,328,328,656,950,1280,1697,26.77,6.38,4.81,3.57
02-12-2021,SÃO PEDRO DO SUL,79,6,512,"[480,960]",Muito Elevado,,,,79,Centro,VISEU,1816,34895.09,15403,990,962,861,759,909,1668,2529,3491,4481,44.14,12.84,10.0,7.25
02-12-2021,SÃO ROQUE DO PICO,2,0,61,"[0,120]",Baixo a Moderado,,,,2,Açores,AÇORES,4603,14236.1,3266,199,141,93,96,113,209,302,443,642,22.94,4.51,3.11,2.12
02-12-2021,SÃO VICENTE,19,1,372,"[240,480]",Elevado,,,,19,Madeira,MADEIRA,3110,7883.71,5143,272,264,266,225,280,505,771,1035,1307,65.23,16.58,13.13,9.78
02-12-2021,SARDOAL,9,1,242,"[240,480]",Elevado,,,,9,Lisboa e Vale do Tejo,SANTARÉM,1417,9214.72,3741,227,178,148,165,248,413,561,739,966,40.6,10.48,8.02,6.09
02-12-2021,SÁTÃO,34,2,292,"[240,480]",Elevado,,,,34,Centro,VISEU,1817,20194.11,11580,765,671,515,465,476,941,1456,2127,2892,57.34,14.32,10.53,7.21
02-12-2021,SEIA,32,2,144,"[120,240]",Moderado,,,,32,Centro,GUARDA,0912,43568.83,22234,1807,1589,1238,1122,721,1843,3081,4670,6477,51.03,14.87,10.72,7.07
02-12-2021,SEIXAL,465,33,277,"[240,480]",Elevado,,,,465,Lisboa e Vale do Tejo,SETÚBAL,1510,9545.17,167752,10586,9270,6661,4391,2930,7321,13982,23252,33838,1757.49,354.51,243.6,146.49
02-12-2021,SERNANCELHE,37,3,688,"[480,960]",Muito Elevado,,,,37,Norte,VISEU,1818,22861.22,5396,305,293,286,273,260,533,819,1112,1417,23.6,6.2,4.86,3.58
02-12-2021,SERPA,151,11,1058,"[960,Max]",Extremamente Elevado,,,,151,Alentejo,BEJA,0213,110563.34,14304,903,761,719,697,626,1323,2042,2803,3706,12.94,3.35,2.54,1.85
02-12-2021,SERTÃ,87,6,597,"[480,960]",Muito Elevado,,,,87,Centro,CASTELO BRANCO,0509,44673.17,14577,870,779,790,767,1020,1787,2577,3356,4226,32.63,9.46,7.51,5.77
02-12-2021,SESIMBRA,214,15,412,"[240,480]",Elevado,,,,214,Lisboa e Vale do Tejo,SETÚBAL,1511,19571.75,51858,2400,2321,1853,1257,1083,2340,4193,6514,8914,264.96,45.54,33.28,21.42
02-12-2021,SETÚBAL,273,19,237,"[120,240]",Moderado,,,,273,Lisboa e Vale do Tejo,SETÚBAL,1512,23032.5,115126,7425,6929,5075,3775,2655,6430,11505,18434,25859,499.83,112.27,80.03,49.95
02-12-2021,SEVER DO VOUGA,14,1,124,"[120,240]",Moderado,,,,14,Centro,AVEIRO,0117,12987.56,11331,766,637,568,540,567,1107,1675,2312,3078,87.24,23.7,17.8,12.9
02-12-2021,SILVES,228,16,629,"[480,960]",Muito Elevado,,,,228,Algarve,FARO,0813,68006.23,36226,2137,1869,1610,1423,1600,3023,4633,6502,8639,53.27,12.7,9.56,6.81
02-12-2021,SINES,12,1,88,"[0,120]",Baixo a Moderado,,,,12,Alentejo,SETÚBAL,1513,20330.17,13715,888,791,551,416,268,684,1235,2026,2914,67.46,14.33,9.97,6.07
02-12-2021,SINTRA,935,67,239,"[120,240]",Moderado,,,,935,Lisboa e Vale do Tejo,LISBOA,1111,31922.73,391402,20490,18316,13545,9137,7284,16421,29966,48282,68772,1226.08,215.43,151.25,93.87
02-12-2021,SOBRAL DE MONTE AGRAÇO,21,1,194,"[120,240]",Moderado,,,,21,Lisboa e Vale do Tejo,LISBOA,1112,5210.32,10651,564,507,352,272,212,484,836,1343,1907,204.43,36.6,25.78,16.05
02-12-2021,SOURE,175,12,1020,"[960,Max]",Extremamente Elevado,,,,175,Centro,COIMBRA,0615,26506.07,17120,1173,1142,1004,883,987,1870,2874,4016,5189,64.59,19.58,15.15,10.84
02-12-2021,SOUSEL,2,0,46,"[0,120]",Baixo a Moderado,,,,2,Alentejo,PORTALEGRE,1215,27932.18,4412,261,274,208,302,292,594,802,1076,1337,15.8,4.79,3.85,2.87
02-12-2021,TÁBUA,33,2,289,"[240,480]",Elevado,,,,33,Centro,COIMBRA,0616,19978.58,11368,729,584,524,430,464,894,1418,2002,2731,56.9,13.67,10.02,7.1
02-12-2021,TABUAÇO,2,0,33,"[0,120]",Baixo a Moderado,,,,2,Norte,VISEU,1819,13385.67,6033,372,314,217,282,363,645,862,1176,1548,45.07,11.56,8.79,6.44
02-12-2021,TAROUCA,5,0,64,"[0,120]",Baixo a Moderado,,,,5,Norte,VISEU,1820,10008.49,7804,405,335,313,277,324,601,914,1249,1654,77.98,16.53,12.48,9.13
02-12-2021,TAVIRA,179,13,729,"[480,960]",Muito Elevado,,,,179,Algarve,FARO,0814,60696.7,24530,1493,1415,1252,1066,1277,2343,3595,5010,6503,40.41,10.71,8.25,5.92
02-12-2021,TERRAS DE BOURO,67,5,1061,"[960,Max]",Extremamente Elevado,,,,67,Norte,BRAGA,0310,27746.07,6361,391,372,296,319,340,659,955,1327,1718,22.93,6.19,4.78,3.44
02-12-2021,TOMAR,143,10,389,"[240,480]",Elevado,,,,143,Lisboa e Vale do Tejo,SANTARÉM,1418,35120.44,36748,2403,2189,1868,1853,1822,3675,5543,7732,10135,104.64,28.86,22.02,15.78
02-12-2021,TONDELA,92,7,349,"[240,480]",Elevado,,,,92,Centro,VISEU,1821,37121.73,26357,1768,1722,1518,1475,1417,2892,4410,6132,7900,71.0,21.28,16.52,11.88
02-12-2021,TORRE DE MONCORVO,12,1,158,"[120,240]",Moderado,,,,12,Norte,BRAGANÇA,0409,53155.67,7695,556,478,488,551,719,1270,1758,2236,2792,14.48,5.25,4.21,3.31
02-12-2021,TORRES NOVAS,244,17,698,"[480,960]",Muito Elevado,,,,244,Lisboa e Vale do Tejo,SANTARÉM,1419,26999.68,34933,2324,1979,1738,1406,1475,2881,4619,6598,8922,129.38,33.04,24.44,17.11
02-12-2021,TORRES VEDRAS,333,24,424,"[240,480]",Elevado,,,,333,Lisboa e Vale do Tejo,LISBOA,1113,40714.89,78530,4513,3945,3447,2628,2104,4732,8179,12124,16637,192.88,40.86,29.78,20.09
02-12-2021,TRANCOSO,10,1,112,"[0,120]",Baixo a Moderado,,,,10,Centro,GUARDA,0913,36152.47,8875,581,557,542,586,496,1082,1624,2181,2762,24.55,7.64,6.03,4.49
02-12-2021,TROFA,68,5,177,"[120,240]",Moderado,,,,68,Norte,PORTO,1318,7201.76,38418,2336,1894,1231,939,684,1623,2854,4748,7084,533.44,98.36,65.93,39.63
02-12-2021,VAGOS,120,9,527,"[480,960]",Muito Elevado,,,,120,Centro,AVEIRO,0118,16491.5,22740,1320,1205,922,784,724,1508,2430,3635,4955,137.89,30.04,22.04,14.73
02-12-2021,VALE DE CAMBRA,63,5,297,"[240,480]",Elevado,,,,63,Norte,AVEIRO,0119,14733.47,21327,1491,1363,1005,831,798,1629,2634,3997,5488,144.76,37.25,27.13,17.88
02-12-2021,VALENÇA,57,4,432,"[240,480]",Elevado,,,,57,Norte,VIANA DO CASTELO,1608,11712.86,13290,867,791,582,582,503,1085,1667,2458,3325,113.46,28.39,20.99,14.23
02-12-2021,VALONGO,274,20,281,"[240,480]",Elevado,,,,274,Norte,PORTO,1315,7512.45,97444,5629,4696,3207,2462,1829,4291,7498,12194,17823,1297.18,237.26,162.33,99.81
02-12-2021,VALPAÇOS,36,3,246,"[240,480]",Elevado,,,,36,Norte,VILA REAL,1712,54873.93,14818,1217,1118,999,928,997,1925,2924,4042,5259,27.0,9.58,7.37,5.33
02-12-2021,VELAS,8,1,158,"[120,240]",Moderado,,,,8,Açores,AÇORES,4502,11738.38,5093,278,208,166,153,113,266,432,640,918,43.39,7.82,5.45,3.68
02-12-2021,VENDAS NOVAS,8,1,72,"[0,120]",Baixo a Moderado,,,,8,Alentejo,ÉVORA,0712,22238.88,11255,677,768,655,501,532,1033,1688,2456,3133,50.61,14.09,11.04,7.59
02-12-2021,VIANA DO ALENTEJO,8,1,157,"[120,240]",Moderado,,,,8,Alentejo,ÉVORA,0713,39367.29,5145,245,208,235,210,214,424,659,867,1112,13.07,2.82,2.2,1.67
02-12-2021,VIANA DO CASTELO,236,17,280,"[240,480]",Elevado,,,,236,Norte,VIANA DO CASTELO,1609,31902.01,84417,5470,4433,3591,3061,2982,6043,9634,14067,19537,264.61,61.24,44.09,30.2
02-12-2021,VIDIGUEIRA,16,1,292,"[240,480]",Elevado,,,,16,Alentejo,BEJA,0214,31661.09,5510,300,248,215,233,275,508,723,971,1271,17.4,4.01,3.07,2.28
02-12-2021,VIEIRA DO MINHO,33,2,280,"[240,480]",Elevado,,,,33,Norte,BRAGA,0311,21644.35,11842,703,594,525,548,482,1030,1555,2149,2852,54.71,13.18,9.93,7.18
02-12-2021,VILA DE REI,6,0,180,"[120,240]",Moderado,,,,6,Centro,CASTELO BRANCO,0510,19154.6,3323,169,128,172,247,302,549,721,849,1018,17.35,5.31,4.43,3.76
02-12-2021,VILA DO BISPO,27,2,525,"[480,960]",Muito Elevado,,,,27,Algarve,FARO,0815,17906.06,5154,302,302,314,232,233,465,779,1081,1383,28.78,7.72,6.04,4.35
02-12-2021,VILA DO CONDE,233,17,291,"[240,480]",Elevado,,,,233,Norte,PORTO,1316,14902.77,79899,4726,3875,2819,2070,1743,3813,6632,10507,15233,536.13,102.21,70.5,44.5
02-12-2021,VILA DO PORTO,1,0,18,"[0,120]",Baixo a Moderado,,,,1,Açores,AÇORES,4101,9688.74,5616,274,212,135,96,123,219,354,566,840,57.96,8.67,5.84,3.65
02-12-2021,VILA FLOR,4,0,67,"[0,120]",Baixo a Moderado,,,,4,Norte,BRAGANÇA,0410,26581.14,6044,429,362,422,294,331,625,1047,1409,1838,22.74,6.91,5.3,3.94
02-12-2021,VILA FRANCA DE XIRA,406,29,286,"[240,480]",Elevado,,,,406,Lisboa e Vale do Tejo,LISBOA,1114,31819.39,141957,8501,6852,4869,3425,2472,5897,10766,17618,26119,446.14,82.09,55.37,33.84
02-12-2021,VILA FRANCA DO CAMPO,9,1,82,"[0,120]",Baixo a Moderado,,,,9,Açores,AÇORES,4206,7796.82,11051,450,344,248,217,154,371,619,963,1413,141.73,18.12,12.35,7.94
02-12-2021,VILA NOVA DA BARQUINHA,36,3,477,"[240,480]",Elevado,,,,36,Lisboa e Vale do Tejo,SANTARÉM,1420,4952.97,7461,415,406,392,364,338,702,1094,1500,1915,150.64,38.66,30.28,22.09
02-12-2021,VILA NOVA DE CERVEIRA,35,3,393,"[240,480]",Elevado,,,,35,Norte,VIANA DO CASTELO,1610,10846.66,8910,531,444,410,384,334,718,1128,1572,2103,82.14,19.39,14.49,10.4
02-12-2021,VILA NOVA DE FAMALICÃO,324,23,246,"[240,480]",Elevado,,,,324,Norte,BRAGA,0312,20159.26,131676,7817,6164,4202,3282,2749,6031,10233,16397,24214,653.19,120.12,81.34,50.76
02-12-2021,VILA NOVA DE FOZ CÔA,3,0,47,"[0,120]",Baixo a Moderado,,,,3,Centro,GUARDA,0914,39815.18,6503,442,385,390,398,429,827,1217,1602,2044,16.33,5.13,4.02,3.06
02-12-2021,VILA NOVA DE GAIA,1250,89,416,"[240,480]",Elevado,,,,1250,Norte,PORTO,1317,16846.43,300472,18349,15568,10972,8224,6281,14505,25477,41045,59394,1783.64,352.57,243.65,151.23
02-12-2021,VILA NOVA DE PAIVA,55,4,1173,"[960,Max]",Extremamente Elevado,,,,55,Centro,VISEU,1822,17553.28,4687,289,272,233,217,241,458,691,963,1252,26.7,7.13,5.49,3.94
02-12-2021,VILA NOVA DE POIARES,15,1,216,"[120,240]",Moderado,,,,15,Centro,COIMBRA,0617,8445.3,6939,380,284,262,235,182,417,679,963,1343,82.17,15.9,11.4,8.04
02-12-2021,VILA POUCA DE AGUIAR,7,1,59,"[0,120]",Baixo a Moderado,,,,7,Norte,VILA REAL,1713,43706.62,11961,860,817,733,601,627,1228,1961,2778,3638,27.37,8.32,6.36,4.49
02-12-2021,VILA REAL,170,12,341,"[240,480]",Elevado,,,,170,Norte,VILA REAL,1714,37880.28,49962,3025,2498,2065,1579,1466,3045,5110,7608,10633,131.9,28.07,20.08,13.49
02-12-2021,VILA REAL DE SANTO ANTÓNIO,85,6,451,"[240,480]",Elevado,,,,85,Algarve,FARO,0816,6125.0,18749,1172,1069,811,569,586,1155,1966,3035,4207,306.11,68.69,49.55,32.1
02-12-2021,VILA VELHA DE RÓDÃO,15,1,477,"[240,480]",Elevado,,,,15,Centro,CASTELO BRANCO,0511,32991.16,3144,209,229,180,283,306,589,769,998,1207,9.53,3.66,3.03,2.33
02-12-2021,VILA VERDE,110,8,235,"[120,240]",Moderado,,,,110,Norte,BRAGA,0313,22866.52,46911,2365,2063,1667,1494,1437,2931,4598,6661,9026,205.15,39.47,29.13,20.11
02-12-2021,VILA VIÇOSA,32,2,423,"[240,480]",Elevado,,,,32,Alentejo,ÉVORA,0714,19485.89,7656,487,379,342,345,324,669,1011,1390,1877,39.29,9.63,7.13,5.19
02-12-2021,VIMIOSO,43,3,1061,"[960,Max]",Extremamente Elevado,,,,43,Norte,BRAGANÇA,0411,48158.51,4023,274,230,261,293,335,628,889,1119,1393,8.35,2.89,2.32,1.85
02-12-2021,VINHAIS,30,2,381,"[240,480]",Elevado,,,,30,Norte,BRAGANÇA,0412,69475.09,7746,599,577,636,641,815,1456,2092,2669,3268,11.15,4.7,3.84,3.01
02-12-2021,VISEU,475,34,488,"[480,960]",Muito Elevado,,,,475,Centro,VISEU,1823,50710.14,97249,5769,5038,4140,3158,2710,5868,10008,15046,20815,191.77,41.05,29.67,19.74
02-12-2021,VIZELA,24,2,100,"[0,120]",Baixo a Moderado,,,,24,Norte,BRAGA,0314,2469.83,23897,1258,928,655,509,371,880,1535,2463,3721,967.49,150.65,99.72,62.15
02-12-2021,VOUZELA,17,1,177,"[120,240]",Moderado,,,,17,Centro,VISEU,1824,19369.46,9619,626,605,554,532,507,1039,1593,2198,2824,49.66,14.58,11.35,8.22
09-12-2021,ABRANTES,183,13,521,"[480,960]",Muito Elevado,,,,183,Lisboa e Vale do Tejo,SANTARÉM,1401,71469.08,35130,2473,2213,1730,1748,2021,3769,5499,7712,10185,49.15,14.25,10.79,7.69
09-12-2021,ÁGUEDA,471,34,1023,"[960,Max]",Extremamente Elevado,,,,471,Centro,AVEIRO,0101,33527.44,46075,3237,2713,2090,1635,1496,3131,5221,7934,11171,137.43,33.32,23.66,15.57
09-12-2021,AGUIAR DA BEIRA,10,1,216,"[120,240]",Moderado,,,,10,Centro,GUARDA,0901,20676.57,4652,304,281,235,239,148,387,622,903,1207,22.5,5.84,4.37,3.01
09-12-2021,ALANDROAL,2,0,41,"[0,120]",Baixo a Moderado,,,,2,Alentejo,ÉVORA,0701,54267.81,4992,307,256,296,299,377,676,972,1228,1535,9.2,2.83,2.26,1.79
09-12-2021,ALBERGARIA-A-VELHA,108,8,449,"[240,480]",Elevado,,,,108,Centro,AVEIRO,0102,15882.5,24144,1550,1298,996,687,680,1367,2363,3661,5211,152.02,32.81,23.05,14.88
09-12-2021,ALBUFEIRA,232,17,558,"[480,960]",Muito Elevado,,,,232,Algarve,FARO,0801,14066.42,41528,2067,1717,1425,985,858,1843,3268,4985,7052,295.24,50.14,35.44,23.23
09-12-2021,ALCÁCER DO SAL,52,4,450,"[240,480]",Elevado,,,,52,Alentejo,SETÚBAL,1501,149987.3,11659,884,814,623,623,602,1225,1848,2662,3546,7.77,2.36,1.77,1.23
09-12-2021,ALCANENA,43,3,334,"[240,480]",Elevado,,,,43,Lisboa e Vale do Tejo,SANTARÉM,1402,12732.86,12809,891,744,628,536,588,1124,1752,2496,3387,100.6,26.6,19.6,13.76
09-12-2021,ALCOBAÇA,286,20,534,"[480,960]",Muito Elevado,,,,286,Lisboa e Vale do Tejo,LEIRIA,1001,40814.09,53555,3420,2927,2466,2059,1676,3735,6201,9128,12548,131.22,30.74,22.36,15.19
09-12-2021,ALCOCHETE,64,5,321,"[240,480]",Elevado,,,,64,Lisboa e Vale do Tejo,SETÚBAL,1502,12836.48,19787,857,834,691,476,447,923,1614,2448,3305,154.15,25.75,19.07,12.57
09-12-2021,ALCOUTIM,7,1,337,"[240,480]",Elevado,,,,7,Algarve,FARO,0802,57536.33,2159,191,188,163,190,267,457,620,808,999,3.75,1.74,1.4,1.08
09-12-2021,ALENQUER,200,14,454,"[240,480]",Elevado,,,,200,Lisboa e Vale do Tejo,LISBOA,1101,30421.92,44052,2298,2062,1629,1330,1155,2485,4114,6176,8474,144.8,27.85,20.3,13.52
09-12-2021,ALFÂNDEGA DA FÉ,14,1,312,"[240,480]",Elevado,,,,14,Norte,BRAGANÇA,0401,32194.64,4550,325,277,301,274,325,599,900,1177,1502,14.13,4.67,3.66,2.8
09-12-2021,ALIJÓ,34,2,323,"[240,480]",Elevado,,,,34,Norte,VILA REAL,1701,29759.89,10625,766,687,635,542,666,1208,1843,2530,3296,35.7,11.08,8.5,6.19
09-12-2021,ALJEZUR,21,1,375,"[240,480]",Elevado,,,,21,Algarve,FARO,0803,32349.95,5594,316,336,335,320,410,730,1065,1401,1717,17.29,5.31,4.33,3.29
09-12-2021,ALJUSTREL,21,2,258,"[240,480]",Elevado,,,,21,Alentejo,BEJA,0201,45847.41,8247,635,521,443,347,358,705,1148,1669,2304,17.99,5.03,3.64,2.5
09-12-2021,ALMADA,639,46,378,"[240,480]",Elevado,,,,639,Lisboa e Vale do Tejo,SETÚBAL,1503,7000.89,169039,10469,9777,7876,6144,5111,11255,19131,28908,39377,2414.5,562.45,412.91,273.26
09-12-2021,ALMEIDA,21,2,363,"[240,480]",Elevado,,,,21,Centro,GUARDA,0902,51798.46,5830,441,419,396,458,393,851,1247,1666,2107,11.26,4.07,3.22,2.41
09-12-2021,ALMEIRIM,108,8,477,"[240,480]",Elevado,,,,108,Lisboa e Vale do Tejo,SANTARÉM,1403,22212.05,22546,1342,1353,1106,866,843,1709,2815,4168,5510,101.5,24.81,18.76,12.67
09-12-2021,ALMODÔVAR,7,1,105,"[0,120]",Baixo a Moderado,,,,7,Alentejo,BEJA,0202,77788.03,6725,414,443,396,373,328,701,1097,1540,1954,8.65,2.51,1.98,1.41
09-12-2021,ALPIARÇA,35,3,501,"[480,960]",Muito Elevado,,,,35,Lisboa e Vale do Tejo,SANTARÉM,1404,9536.33,7059,515,486,363,333,274,607,970,1456,1971,74.02,20.67,15.27,10.17
09-12-2021,ALTER DO CHÃO,0,0,0,"[0,120]",Baixo a Moderado,,,,0,Alentejo,PORTALEGRE,1201,36206.62,3165,201,163,136,208,187,395,531,694,895,8.74,2.47,1.92,1.47
09-12-2021,ALVAIÁZERE,22,2,334,"[240,480]",Elevado,,,,22,Centro,LEIRIA,1002,16047.76,6597,419,389,346,406,539,945,1291,1680,2099,41.11,13.08,10.47,8.04
09-12-2021,ALVITO,1,0,41,"[0,120]",Baixo a Moderado,,,,1,Alentejo,BEJA,0203,26485.32,2477,145,110,105,111,89,200,305,415,560,9.35,2.11,1.57,1.15
09-12-2021,AMADORA,519,37,282,"[240,480]",Elevado,,,,519,Lisboa e Vale do Tejo,LISBOA,1115,2378.47,184106,11186,10936,8780,6460,5890,12350,21130,32066,43252,7742.05,1818.84,1348.44,888.56
09-12-2021,AMARANTE,199,14,374,"[240,480]",Elevado,,,,199,Norte,PORTO,1301,30133.15,53193,3086,2413,1812,1643,1311,2954,4766,7179,10265,176.53,34.07,23.82,15.82
09-12-2021,AMARES,98,7,542,"[480,960]",Muito Elevado,,,,98,Norte,BRAGA,0301,8195.41,18129,1001,829,622,489,524,1013,1635,2464,3465,221.22,42.28,30.07,19.95
09-12-2021,ANADIA,277,20,1016,"[960,Max]",Extremamente Elevado,,,,277,Centro,AVEIRO,0103,21663.48,27258,1931,1698,1376,1208,1262,2470,3846,5544,7475,125.83,34.51,25.59,17.75
09-12-2021,ANGRA DO HEROÍSMO,57,4,169,"[120,240]",Moderado,,,,57,Açores,AÇORES,4301,23899.66,33807,2006,1473,1122,768,635,1403,2525,3998,6004,141.45,25.12,16.73,10.56
09-12-2021,ANSIÃO,56,4,464,"[240,480]",Elevado,,,,56,Centro,LEIRIA,1003,17609.42,12039,727,709,646,694,530,1224,1870,2579,3306,68.37,18.77,14.65,10.62
09-12-2021,ARCOS DE VALDEVEZ,52,4,250,"[240,480]",Elevado,,,,52,Norte,VIANA DO CASTELO,1601,44759.64,20926,1329,1338,1282,1343,1515,2858,4140,5478,6807,46.75,15.21,12.24,9.25
09-12-2021,ARGANIL,24,2,218,"[120,240]",Moderado,,,,24,Centro,COIMBRA,0601,33283.93,11014,672,648,612,559,596,1155,1767,2415,3087,33.09,9.27,7.26,5.31
09-12-2021,ARMAMAR,4,0,70,"[0,120]",Baixo a Moderado,,,,4,Norte,VISEU,1801,11723.73,5769,357,305,309,285,310,595,904,1209,1566,49.21,13.36,10.31,7.71
09-12-2021,AROUCA,92,7,442,"[240,480]",Elevado,,,,92,Norte,AVEIRO,0104,32910.52,20720,1306,1047,753,683,683,1366,2119,3166,4472,62.96,13.59,9.62,6.44
09-12-2021,ARRAIOLOS,18,1,262,"[240,480]",Elevado,,,,18,Alentejo,ÉVORA,0702,68374.55,6928,435,384,283,367,480,847,1130,1514,1949,10.13,2.85,2.21,1.65
09-12-2021,ARRONCHES,3,0,109,"[0,120]",Baixo a Moderado,,,,3,Alentejo,PORTALEGRE,1202,31464.72,2820,155,142,162,187,179,366,528,670,825,8.96,2.62,2.13,1.68
09-12-2021,ARRUDA DOS VINHOS,25,2,165,"[120,240]",Moderado,,,,25,Lisboa e Vale do Tejo,LISBOA,1102,7795.93,15412,738,738,562,509,438,947,1509,2247,2985,197.69,38.29,28.82,19.36
09-12-2021,AVEIRO,475,34,603,"[480,960]",Muito Elevado,,,,475,Centro,AVEIRO,0105,19757.57,78734,4520,4004,3050,2250,2103,4353,7403,11407,15927,398.49,80.61,57.73,37.47
09-12-2021,AVIS,10,1,238,"[120,240]",Moderado,,,,10,Alentejo,PORTALEGRE,1203,60596.51,4247,315,225,206,251,273,524,730,955,1270,7.01,2.1,1.58,1.2
09-12-2021,AZAMBUJA,72,5,315,"[240,480]",Elevado,,,,72,Lisboa e Vale do Tejo,LISBOA,1103,26265.65,22716,1322,1171,1070,798,618,1416,2486,3657,4979,86.48,18.96,13.92,9.46
09-12-2021,BAIÃO,75,5,398,"[240,480]",Elevado,,,,75,Norte,PORTO,1302,17452.83,18748,1070,862,714,686,725,1411,2125,2987,4057,107.42,23.25,17.11,12.18
09-12-2021,BARCELOS,408,29,351,"[240,480]",Elevado,,,,408,Norte,BRAGA,0302,37890.14,116187,6721,5325,3619,2991,2562,5553,9172,14497,21218,306.64,56.0,38.26,24.21
09-12-2021,BARRANCOS,45,3,2773,"[960,Max]",Extremamente Elevado,,,,45,Alentejo,BEJA,0204,16841.73,1634,90,65,65,94,61,155,220,285,375,9.7,2.23,1.69,1.31
09-12-2021,BARREIRO,320,23,426,"[240,480]",Elevado,,,,320,Lisboa e Vale do Tejo,SETÚBAL,1504,3639.07,75147,5194,5565,4459,3105,1767,4872,9331,14896,20090,2065.05,552.07,409.34,256.42
09-12-2021,BATALHA,130,9,816,"[480,960]",Muito Elevado,,,,130,Centro,LEIRIA,1004,10341.6,15963,873,762,649,529,549,1078,1727,2489,3362,154.35,32.51,24.07,16.7
09-12-2021,BEJA,175,13,522,"[480,960]",Muito Elevado,,,,175,Alentejo,BEJA,0205,114647.55,33579,2005,1840,1386,1272,1039,2311,3697,5537,7542,29.29,6.58,4.83,3.22
09-12-2021,BELMONTE,28,2,439,"[240,480]",Elevado,,,,28,Centro,CASTELO BRANCO,0501,11875.91,6398,444,321,325,310,355,665,990,1311,1755,53.87,14.78,11.04,8.34
09-12-2021,BENAVENTE,79,6,257,"[240,480]",Elevado,,,,79,Lisboa e Vale do Tejo,SANTARÉM,1405,52138.39,30602,1468,1376,1141,876,643,1519,2660,4036,5504,58.69,10.56,7.74,5.1
09-12-2021,BOMBARRAL,36,3,284,"[240,480]",Elevado,,,,36,Lisboa e Vale do Tejo,LEIRIA,1005,9128.55,12558,875,714,561,491,429,920,1481,2195,3070,137.56,33.63,24.04,16.22
09-12-2021,BORBA,20,1,300,"[240,480]",Elevado,,,,20,Alentejo,ÉVORA,0703,14518.65,6736,430,375,279,436,392,828,1107,1482,1912,46.39,13.17,10.21,7.62
09-12-2021,BOTICAS,5,0,102,"[0,120]",Baixo a Moderado,,,,5,Norte,VILA REAL,1702,32195.66,4998,347,306,311,305,380,685,996,1302,1649,15.52,5.12,4.04,3.09
09-12-2021,BRAGA,1277,91,699,"[480,960]",Muito Elevado,,,,1277,Norte,BRAGA,0303,18339.95,182679,10029,7963,5241,4320,3671,7991,13232,21195,31224,996.07,170.25,115.57,72.15
09-12-2021,BRAGANÇA,222,16,661,"[480,960]",Muito Elevado,,,,222,Norte,BRAGANÇA,0402,117357.27,33607,2402,1855,1652,1393,1163,2556,4208,6063,8465,28.64,7.21,5.17,3.59
09-12-2021,CABECEIRAS DE BASTO,66,5,425,"[240,480]",Elevado,,,,66,Norte,BRAGA,0304,24182.16,15628,774,594,544,575,574,1149,1693,2287,3061,64.63,12.66,9.46,7.0
09-12-2021,CADAVAL,34,2,248,"[240,480]",Elevado,,,,34,Lisboa e Vale do Tejo,LISBOA,1104,17489.3,13673,813,796,756,621,625,1246,2002,2798,3611,78.18,20.65,16.0,11.45
09-12-2021,CALDAS DA RAINHA,210,15,404,"[240,480]",Elevado,,,,210,Lisboa e Vale do Tejo,LEIRIA,1006,25569.47,51912,3035,2684,2186,1899,1705,3604,5790,8474,11509,203.03,45.01,33.14,22.64
09-12-2021,CALHETA,21,2,194,"[120,240]",Moderado,,,,21,Madeira,MADEIRA,3101,11150.43,10867,576,497,507,399,415,814,1321,1818,2394,97.46,21.47,16.3,11.85
09-12-2021,CALHETA (AÇORES),0,0,0,"[0,120]",Baixo a Moderado,,,,0,Açores,AÇORES,4501,12626.4,3184,215,159,141,139,122,261,402,561,776,25.22,6.15,4.44,3.18
09-12-2021,CÂMARA DE LOBOS,332,24,987,"[960,Max]",Extremamente Elevado,,,,332,Madeira,MADEIRA,3102,5216.67,33675,1396,1059,834,545,381,926,1760,2819,4215,645.49,80.79,54.03,33.74
09-12-2021,CAMINHA,25,2,158,"[120,240]",Moderado,,,,25,Norte,VIANA DO CASTELO,1602,13652.14,15877,1046,944,818,646,656,1302,2120,3064,4110,116.3,30.11,22.44,15.53
09-12-2021,CAMPO MAIOR,67,5,847,"[480,960]",Muito Elevado,,,,67,Alentejo,PORTALEGRE,1204,24720.16,7874,471,364,351,279,327,606,957,1321,1792,31.85,7.25,5.34,3.87
09-12-2021,CANTANHEDE,217,16,621,"[480,960]",Muito Elevado,,,,217,Centro,COIMBRA,0602,39088.02,35011,2346,2096,1880,1709,1451,3160,5040,7136,9482,89.57,24.26,18.26,12.89
09-12-2021,CARRAZEDA DE ANSIÃES,19,1,339,"[240,480]",Elevado,,,,19,Norte,BRAGANÇA,0403,27924.09,5666,424,389,391,312,465,777,1168,1557,1981,20.29,7.09,5.58,4.18
09-12-2021,CARREGAL DO SAL,171,12,1847,"[960,Max]",Extremamente Elevado,,,,171,Centro,VISEU,1802,11689.21,9271,587,562,486,462,376,838,1324,1886,2473,79.31,21.16,16.13,11.33
09-12-2021,CARTAXO,141,10,593,"[480,960]",Muito Elevado,,,,141,Lisboa e Vale do Tejo,SANTARÉM,1406,15817.28,23843,1415,1376,1142,861,632,1493,2635,4011,5426,150.74,34.3,25.36,16.66
09-12-2021,CASCAIS,816,58,382,"[240,480]",Elevado,,,,816,Lisboa e Vale do Tejo,LISBOA,1105,9740.17,213608,12151,11444,8680,6469,5248,11717,20397,31841,43992,2193.1,451.66,326.91,209.41
09-12-2021,CASTANHEIRA DE PÊRA,4,0,155,"[120,240]",Moderado,,,,4,Centro,LEIRIA,1007,6677.45,2614,233,195,157,190,187,377,534,729,962,39.15,14.41,10.92,8.0
09-12-2021,CASTELO BRANCO,163,12,313,"[240,480]",Elevado,,,,163,Centro,CASTELO BRANCO,0502,143819.15,51987,3528,3042,2499,2229,2225,4454,6953,9995,13523,36.15,9.4,6.95,4.83
09-12-2021,CASTELO DE PAIVA,75,5,484,"[480,960]",Muito Elevado,,,,75,Norte,AVEIRO,0106,11500.53,15454,881,697,545,420,431,851,1396,2093,2974,134.37,25.86,18.2,12.14
09-12-2021,CASTELO DE VIDE,5,0,173,"[120,240]",Moderado,,,,5,Alentejo,PORTALEGRE,1205,26491.24,2919,204,173,179,147,170,317,496,669,873,11.02,3.3,2.53,1.87
09-12-2021,CASTRO DAIRE,86,6,622,"[480,960]",Muito Elevado,,,,86,Centro,VISEU,1803,37904.13,13823,942,857,765,732,773,1505,2270,3127,4069,36.47,10.74,8.25,5.99
09-12-2021,CASTRO MARIM,14,1,226,"[120,240]",Moderado,,,,14,Algarve,FARO,0804,30084.37,6237,370,345,334,322,344,666,1000,1345,1715,20.73,5.7,4.47,3.32
09-12-2021,CASTRO VERDE,7,1,102,"[0,120]",Baixo a Moderado,,,,7,Alentejo,BEJA,0206,56944.23,6949,437,347,303,275,227,502,805,1152,1589,12.2,2.79,2.02,1.41
09-12-2021,CELORICO DA BEIRA,24,2,346,"[240,480]",Elevado,,,,24,Centro,GUARDA,0903,24721.63,6928,430,416,363,369,535,904,1267,1683,2113,28.02,8.55,6.81,5.12
09-12-2021,CELORICO DE BASTO,70,5,370,"[240,480]",Elevado,,,,70,Norte,BRAGA,0305,18107.02,19040,1001,802,668,728,729,1457,2125,2927,3928,105.15,21.69,16.17,11.74
09-12-2021,CHAMUSCA,36,3,386,"[240,480]",Elevado,,,,36,Lisboa e Vale do Tejo,SANTARÉM,1407,74600.54,9197,629,583,553,465,579,1044,1597,2180,2809,12.33,3.77,2.92,2.14
09-12-2021,CHAVES,189,13,480,"[480,960]",Muito Elevado,,,,189,Norte,VILA REAL,1703,59122.95,39343,2676,2429,1991,1886,1918,3804,5795,8224,10900,66.54,18.44,13.91,9.8
09-12-2021,CINFÃES,68,5,372,"[240,480]",Elevado,,,,68,Norte,VISEU,1804,23928.76,18244,1067,902,779,734,758,1492,2271,3173,4240,76.24,17.72,13.26,9.49
09-12-2021,COIMBRA,1028,73,766,"[480,960]",Muito Elevado,,,,1028,Centro,COIMBRA,0603,31939.94,134166,9489,8734,6353,5139,5074,10213,16566,25300,34789,420.06,108.92,79.21,51.87
09-12-2021,CONDEIXA-A-NOVA,206,15,1162,"[960,Max]",Extremamente Elevado,,,,206,Centro,COIMBRA,0604,13867.47,17733,871,809,717,583,490,1073,1790,2599,3470,127.88,25.02,18.74,12.91
09-12-2021,CONSTÂNCIA,21,1,518,"[480,960]",Muito Elevado,,,,21,Lisboa e Vale do Tejo,SANTARÉM,1408,8036.58,4030,211,183,187,148,155,303,490,673,884,50.14,11.0,8.37,6.1
09-12-2021,CORUCHE,56,4,320,"[240,480]",Elevado,,,,56,Lisboa e Vale do Tejo,SANTARÉM,1409,111572.03,17471,1294,1090,1095,1096,1019,2115,3210,4300,5594,15.66,5.01,3.85,2.88
09-12-2021,CORVO,5,0,1064,"[960,Max]",Extremamente Elevado,,,,5,Açores,AÇORES,4901,1711.45,464,22,21,11,13,19,32,43,64,86,27.12,5.03,3.74,2.51
09-12-2021,COVILHÃ,497,36,1063,"[960,Max]",Extremamente Elevado,,,,497,Centro,CASTELO BRANCO,0503,55560.06,46787,3533,2998,2365,2111,2193,4304,6669,9667,13200,84.21,23.76,17.4,12.0
09-12-2021,CRATO,8,1,262,"[240,480]",Elevado,,,,8,Alentejo,PORTALEGRE,1206,39806.88,3129,229,258,163,182,228,410,573,831,1060,7.86,2.66,2.09,1.44
09-12-2021,CUBA,4,0,88,"[0,120]",Baixo a Moderado,,,,4,Alentejo,BEJA,0207,17208.72,4595,255,233,206,190,143,333,539,772,1027,26.7,5.97,4.49,3.13
09-12-2021,ELVAS,48,3,232,"[120,240]",Moderado,,,,48,Alentejo,PORTALEGRE,1207,63128.86,20528,1057,1145,902,852,810,1662,2564,3709,4766,32.52,7.55,5.88,4.06
09-12-2021,ENTRONCAMENTO,152,11,707,"[480,960]",Muito Elevado,,,,152,Lisboa e Vale do Tejo,SANTARÉM,1410,1372.81,21558,1066,930,868,695,592,1287,2155,3085,4151,1570.14,302.33,224.69,156.96
09-12-2021,ESPINHO,173,12,585,"[480,960]",Muito Elevado,,,,173,Norte,AVEIRO,0107,2105.68,29516,2205,1993,1430,1177,960,2137,3567,5560,7765,1401.52,368.71,264.01,169.37
09-12-2021,ESPOSENDE,132,9,386,"[240,480]",Elevado,,,,132,Norte,BRAGA,0306,9540.98,34177,1831,1522,1095,894,723,1617,2712,4234,6065,358.21,63.57,44.38,28.42
09-12-2021,ESTARREJA,130,9,501,"[480,960]",Muito Elevado,,,,130,Centro,AVEIRO,0108,10817.33,26006,1503,1399,1106,953,728,1681,2787,4186,5689,240.42,52.59,38.7,25.76
09-12-2021,ESTREMOZ,26,2,206,"[120,240]",Moderado,,,,26,Alentejo,ÉVORA,0704,51379.95,12728,789,613,697,786,877,1663,2360,2973,3762,24.77,7.32,5.79,4.59
09-12-2021,ÉVORA,205,15,391,"[240,480]",Elevado,,,,205,Alentejo,ÉVORA,0705,130707.58,52428,3569,2852,2176,1966,1803,3769,5945,8797,12366,40.11,9.46,6.73,4.55
09-12-2021,FAFE,195,14,406,"[240,480]",Elevado,,,,195,Norte,BRAGA,0307,21908.11,48060,3044,2455,1679,1403,1208,2611,4290,6745,9789,219.37,44.68,30.79,19.58
09-12-2021,FARO,530,38,868,"[480,960]",Muito Elevado,,,,530,Algarve,FARO,0805,20256.79,61015,3847,3364,2604,2055,1601,3656,6260,9624,13471,301.2,66.5,47.51,30.9
09-12-2021,FELGUEIRAS,174,12,308,"[240,480]",Elevado,,,,174,Norte,PORTO,1303,11573.75,56422,2951,2302,1601,1316,973,2289,3890,6192,9143,487.49,79.0,53.5,33.61
09-12-2021,FERREIRA DO ALENTEJO,13,1,167,"[120,240]",Moderado,,,,13,Alentejo,BEJA,0208,64820.68,7845,515,414,372,343,345,688,1060,1474,1989,12.1,3.07,2.27,1.64
09-12-2021,FERREIRA DO ZÊZERE,65,5,817,"[480,960]",Muito Elevado,,,,65,Lisboa e Vale do Tejo,SANTARÉM,1411,19038.03,7959,470,370,416,465,456,921,1337,1707,2177,41.81,11.44,8.97,7.02
09-12-2021,FIGUEIRA DA FOZ,538,38,915,"[480,960]",Muito Elevado,,,,538,Centro,COIMBRA,0605,37905.26,58747,4032,3597,2887,2495,2043,4538,7425,11022,15054,154.98,39.72,29.08,19.59
09-12-2021,FIGUEIRA DE CASTELO RODRIGO,9,1,161,"[120,240]",Moderado,,,,9,Centro,GUARDA,0904,50857.46,5584,347,352,290,352,391,743,1033,1385,1732,10.98,3.41,2.72,2.03
09-12-2021,FIGUEIRÓ DOS VINHOS,24,2,431,"[240,480]",Elevado,,,,24,Centro,LEIRIA,1008,17344.0,5568,402,386,322,309,351,660,982,1368,1770,32.1,10.21,7.89,5.66
09-12-2021,FORNOS DE ALGODRES,19,1,419,"[240,480]",Elevado,,,,19,Centro,GUARDA,0905,13145.05,4528,261,218,247,256,232,488,735,953,1214,34.45,9.24,7.25,5.59
09-12-2021,FREIXO DE ESPADA À CINTA,7,1,216,"[120,240]",Moderado,,,,7,Norte,BRAGANÇA,0404,24414.29,3298,211,177,231,196,189,385,616,793,1004,13.51,4.11,3.25,2.52
09-12-2021,FRONTEIRA,11,1,375,"[240,480]",Elevado,,,,11,Alentejo,PORTALEGRE,1208,24859.58,2974,213,182,149,156,168,324,473,655,868,11.96,3.49,2.63,1.9
09-12-2021,FUNCHAL,611,44,587,"[480,960]",Muito Elevado,,,,611,Madeira,MADEIRA,3103,7616.2,104024,6382,5086,3643,2821,1990,4811,8454,13540,19922,1365.86,261.58,177.78,111.0
09-12-2021,FUNDÃO,145,10,548,"[480,960]",Muito Elevado,,,,145,Centro,CASTELO BRANCO,0504,70019.79,26495,1781,1464,1432,1357,1643,3000,4432,5896,7677,37.84,10.96,8.42,6.33
09-12-2021,GAVIÃO,7,1,220,"[120,240]",Moderado,,,,7,Alentejo,PORTALEGRE,1209,29459.45,3263,189,186,222,263,293,556,778,964,1153,11.08,3.91,3.27,2.64
09-12-2021,GÓIS,11,1,292,"[240,480]",Elevado,,,,11,Centro,COIMBRA,0606,26330.19,3805,235,199,240,233,244,477,717,916,1151,14.45,4.37,3.48,2.72
09-12-2021,GOLEGÃ,35,3,662,"[480,960]",Muito Elevado,,,,35,Lisboa e Vale do Tejo,SANTARÉM,1412,8431.67,5339,356,299,281,243,255,498,779,1078,1434,63.32,17.01,12.78,9.24
09-12-2021,GONDOMAR,624,45,376,"[240,480]",Elevado,,,,624,Norte,PORTO,1304,13191.76,165985,10555,8755,6222,4450,3364,7814,14036,22791,33346,1258.22,252.77,172.76,106.4
09-12-2021,GOUVEIA,144,10,1165,"[960,Max]",Extremamente Elevado,,,,144,Centro,GUARDA,0906,30061.17,12387,871,931,780,783,810,1593,2373,3304,4175,41.21,13.89,10.99,7.89
09-12-2021,GRÂNDOLA,28,2,192,"[120,240]",Moderado,,,,28,Alentejo,SETÚBAL,1505,82593.66,14639,834,834,708,688,672,1360,2068,2902,3736,17.72,4.52,3.51,2.5
09-12-2021,GUARDA,480,34,1231,"[960,Max]",Extremamente Elevado,,,,480,Centro,GUARDA,0907,71209.58,38969,2477,2041,1686,1415,1474,2889,4575,6616,9093,54.72,12.77,9.29,6.42
09-12-2021,GUIMARÃES,416,30,273,"[240,480]",Elevado,,,,416,Norte,BRAGA,0308,24099.96,152309,9394,7074,4809,3877,2948,6825,11634,18708,28102,631.99,116.61,77.63,48.27
09-12-2021,HORTA,23,2,159,"[120,240]",Moderado,,,,23,Açores,AÇORES,4701,17305.53,14521,818,658,468,352,302,654,1122,1780,2598,83.91,15.01,10.29,6.48
09-12-2021,IDANHA-A-NOVA,45,3,555,"[480,960]",Muito Elevado,,,,45,Centro,CASTELO BRANCO,0505,141633.51,8043,518,490,519,672,974,1646,2165,2655,3173,5.68,2.24,1.87,1.53
09-12-2021,ÍLHAVO,289,21,748,"[480,960]",Muito Elevado,,,,289,Centro,AVEIRO,0110,7347.55,38699,2227,1943,1444,1193,850,2043,3487,5430,7657,526.66,104.21,73.9,47.46
09-12-2021,LAGOA (FARO),271,19,1192,"[960,Max]",Extremamente Elevado,,,,271,Algarve,FARO,0806,8825.45,22762,1314,1168,919,749,670,1419,2338,3506,4820,257.93,54.62,39.73,26.49
09-12-2021,LAGOA,59,4,400,"[240,480]",Elevado,,,,59,Açores,AÇORES,4201,4559.32,14721,536,458,349,238,235,473,822,1280,1816,322.9,39.83,28.08,18.03
09-12-2021,LAGOS,236,17,776,"[480,960]",Muito Elevado,,,,236,Algarve,FARO,0807,21299.27,30374,1744,1434,1247,1053,1029,2082,3329,4763,6507,142.61,30.55,22.36,15.63
09-12-2021,LAJES DAS FLORES,3,0,205,"[120,240]",Moderado,,,,3,Açores,AÇORES,4801,7004.79,1463,88,53,62,46,54,100,162,215,303,20.89,4.33,3.07,2.31
09-12-2021,LAJES DO PICO,2,0,45,"[0,120]",Baixo a Moderado,,,,2,Açores,AÇORES,4601,15531.09,4490,304,231,223,159,162,321,544,775,1079,28.91,6.95,4.99,3.5
09-12-2021,LAMEGO,49,4,198,"[120,240]",Moderado,,,,49,Norte,VISEU,1805,16542.11,24895,1639,1284,1124,898,783,1681,2805,4089,5728,150.5,34.63,24.72,16.96
09-12-2021,LEIRIA,917,65,732,"[480,960]",Muito Elevado,,,,917,Centro,LEIRIA,1009,56508.83,125267,7389,6366,5090,3902,3159,7061,12151,18517,25906,221.68,45.84,32.77,21.5
09-12-2021,LISBOA,2879,206,565,"[480,960]",Muito Elevado,,,,2879,Lisboa e Vale do Tejo,LISBOA,1106,10005.43,509515,33197,33340,27706,23037,26770,49807,77513,110853,144050,5092.6,1439.78,1107.98,774.74
09-12-2021,LOULÉ,587,42,855,"[480,960]",Muito Elevado,,,,587,Algarve,FARO,0808,76366.91,68697,3890,3350,2780,2358,2251,4609,7389,10739,14629,89.96,19.16,14.06,9.68
09-12-2021,LOURES,577,41,270,"[240,480]",Elevado,,,,577,Lisboa e Vale do Tejo,LISBOA,1107,16723.99,213687,12746,12794,9644,6669,5033,11702,21346,34140,46886,1277.73,280.35,204.14,127.64
09-12-2021,LOURINHÃ,122,9,470,"[240,480]",Elevado,,,,122,Lisboa e Vale do Tejo,LISBOA,1108,14717.2,25855,1584,1243,992,842,645,1487,2479,3722,5306,175.68,36.05,25.29,16.84
09-12-2021,LOUSÃ,86,6,504,"[480,960]",Muito Elevado,,,,86,Centro,COIMBRA,0607,13840.01,17158,946,866,658,528,450,978,1636,2502,3448,123.97,24.91,18.08,11.82
09-12-2021,LOUSADA,69,5,148,"[120,240]",Moderado,,,,69,Norte,PORTO,1305,9608.01,46755,2289,1698,1176,853,621,1474,2650,4348,6637,486.63,69.08,45.25,27.58
09-12-2021,MAÇÃO,19,1,307,"[240,480]",Elevado,,,,19,Lisboa e Vale do Tejo,SANTARÉM,1413,39997.98,6267,386,362,390,440,657,1097,1487,1849,2235,15.67,5.59,4.62,3.72
09-12-2021,MACEDO DE CAVALEIROS,55,4,381,"[240,480]",Elevado,,,,55,Norte,BRAGANÇA,0405,69914.08,14516,1082,889,878,823,938,1761,2639,3528,4610,20.76,6.59,5.05,3.77
09-12-2021,MACHICO,100,7,498,"[480,960]",Muito Elevado,,,,100,Madeira,MADEIRA,3104,6825.1,19981,1197,860,662,455,331,786,1448,2308,3505,292.76,51.36,33.82,21.22
09-12-2021,MADALENA,6,0,102,"[0,120]",Baixo a Moderado,,,,6,Açores,AÇORES,4602,14712.33,5895,334,256,173,190,179,369,542,798,1132,40.07,7.69,5.42,3.68
09-12-2021,MAFRA,289,21,341,"[240,480]",Elevado,,,,289,Lisboa e Vale do Tejo,LISBOA,1109,29165.5,84816,3613,3334,2839,2089,1899,3988,6827,10161,13774,290.81,47.23,34.84,23.41
09-12-2021,MAIA,639,46,460,"[240,480]",Elevado,,,,639,Norte,PORTO,1306,8293.94,138971,7801,6617,4512,3339,2631,5970,10482,17099,24900,1675.56,300.22,206.16,126.38
09-12-2021,MANGUALDE,97,7,523,"[480,960]",Muito Elevado,,,,97,Centro,VISEU,1806,21925.56,18510,1198,1128,885,852,743,1595,2480,3608,4806,84.42,21.92,16.46,11.31
09-12-2021,MANTEIGAS,20,1,670,"[480,960]",Muito Elevado,,,,20,Centro,GUARDA,0908,12197.55,3007,258,197,159,167,146,313,472,669,927,24.65,7.6,5.48,3.87
09-12-2021,MARCO DE CANAVESES,111,8,215,"[120,240]",Moderado,,,,111,Norte,PORTO,1307,20188.98,51496,2678,2060,1488,1265,1023,2288,3776,5836,8514,255.07,42.17,28.91,18.7
09-12-2021,MARINHA GRANDE,303,22,787,"[480,960]",Muito Elevado,,,,303,Centro,LEIRIA,1010,18725.19,38508,2365,2302,1638,1359,1058,2417,4055,6357,8722,205.65,46.58,33.95,21.66
09-12-2021,MARVÃO,3,0,102,"[0,120]",Baixo a Moderado,,,,3,Alentejo,PORTALEGRE,1210,15489.9,3005,198,185,142,197,237,434,576,761,959,19.4,6.19,4.91,3.72
09-12-2021,MATOSINHOS,852,61,486,"[480,960]",Muito Elevado,,,,852,Norte,PORTO,1308,6241.97,175357,11850,9977,7023,5024,3884,8908,15931,25908,37758,2809.31,604.9,415.06,255.22
09-12-2021,MEALHADA,234,17,1174,"[960,Max]",Extremamente Elevado,,,,234,Centro,AVEIRO,0111,11065.66,19914,1163,1039,810,828,831,1659,2469,3508,4671,179.96,42.21,31.7,22.31
09-12-2021,MÊDA,23,2,503,"[480,960]",Muito Elevado,,,,23,Centro,GUARDA,0909,28604.92,4587,343,306,290,288,443,731,1021,1327,1670,16.04,5.84,4.64,3.57
09-12-2021,MELGAÇO,13,1,163,"[120,240]",Moderado,,,,13,Norte,VIANA DO CASTELO,1603,23824.58,8093,507,567,578,614,675,1289,1867,2434,2941,33.97,12.34,10.22,7.84
09-12-2021,MÉRTOLA,16,1,265,"[240,480]",Elevado,,,,16,Alentejo,BEJA,0209,129287.34,6142,400,390,378,423,600,1023,1401,1791,2191,4.75,1.69,1.39,1.08
09-12-2021,MESÃO FRIO,7,1,178,"[120,240]",Moderado,,,,7,Norte,VILA REAL,1704,2664.87,3964,265,205,168,157,120,277,445,650,915,148.74,34.33,24.39,16.7
09-12-2021,MIRA,142,10,1196,"[960,Max]",Extremamente Elevado,,,,142,Centro,COIMBRA,0608,12403.38,11832,727,729,659,550,466,1016,1675,2404,3131,95.4,25.24,19.38,13.5
09-12-2021,MIRANDA DO CORVO,96,7,755,"[480,960]",Muito Elevado,,,,96,Centro,COIMBRA,0609,12637.79,12708,706,659,568,498,404,902,1470,2129,2835,100.55,22.43,16.85,11.63
09-12-2021,MIRANDA DO DOURO,25,2,370,"[240,480]",Elevado,,,,25,Norte,BRAGANÇA,0406,48718.31,6830,482,429,442,463,470,933,1375,1804,2286,14.02,4.69,3.7,2.82
09-12-2021,MIRANDELA,83,6,380,"[240,480]",Elevado,,,,83,Norte,BRAGANÇA,0407,65895.67,21754,1640,1315,1204,1078,947,2025,3229,4544,6184,33.01,9.38,6.9,4.9
09-12-2021,MOGADOURO,16,1,193,"[120,240]",Moderado,,,,16,Norte,BRAGANÇA,0408,76064.93,8392,589,529,576,630,655,1285,1861,2390,2979,11.03,3.92,3.14,2.45
09-12-2021,MOIMENTA DA BEIRA,66,5,680,"[480,960]",Muito Elevado,,,,66,Norte,VISEU,1807,21996.9,9736,576,514,471,416,461,877,1348,1862,2438,44.26,11.08,8.46,6.13
09-12-2021,MOITA,265,19,411,"[240,480]",Elevado,,,,265,Lisboa e Vale do Tejo,SETÚBAL,1506,5525.98,64407,4226,3646,2623,1801,1425,3226,5849,9495,13721,1165.53,248.3,171.82,105.85
09-12-2021,MONÇÃO,31,2,175,"[120,240]",Moderado,,,,31,Norte,VIANA DO CASTELO,1604,21130.85,17869,1161,1105,1031,1006,972,1978,3009,4114,5275,84.56,24.96,19.47,14.24
09-12-2021,MONCHIQUE,60,4,1185,"[960,Max]",Extremamente Elevado,,,,60,Algarve,FARO,0809,39530.43,5077,353,384,321,355,392,747,1068,1452,1805,12.84,4.57,3.67,2.7
09-12-2021,MONDIM DE BASTO,44,3,640,"[480,960]",Muito Elevado,,,,44,Norte,VILA REAL,1705,17207.52,6946,395,300,314,284,283,567,881,1181,1576,40.36,9.16,6.86,5.12
09-12-2021,MONFORTE,3,0,102,"[0,120]",Baixo a Moderado,,,,3,Alentejo,PORTALEGRE,1211,42024.82,2975,139,115,117,192,168,360,477,592,731,7.08,1.74,1.41,1.14
09-12-2021,MONTALEGRE,27,2,304,"[240,480]",Elevado,,,,27,Norte,VILA REAL,1706,80545.71,8997,699,628,595,603,730,1333,1928,2556,3255,11.17,4.04,3.17,2.39
09-12-2021,MONTEMOR-O-NOVO,16,1,104,"[0,120]",Baixo a Moderado,,,,16,Alentejo,ÉVORA,0706,123296.65,15647,991,953,868,878,971,1849,2717,3670,4661,12.69,3.78,2.98,2.2
09-12-2021,MONTEMOR-O-VELHO,211,15,838,"[480,960]",Muito Elevado,,,,211,Centro,COIMBRA,0610,22896.23,25224,1496,1397,1217,1057,988,2045,3262,4659,6155,110.17,26.88,20.35,14.25
09-12-2021,MONTIJO,143,10,248,"[240,480]",Elevado,,,,143,Lisboa e Vale do Tejo,SETÚBAL,1507,34861.64,57614,2771,2441,1990,1554,1109,2663,4653,7094,9865,165.26,28.3,20.35,13.35
09-12-2021,MORA,9,1,223,"[120,240]",Moderado,,,,9,Alentejo,ÉVORA,0707,44395.02,4138,336,275,252,238,257,495,747,1022,1358,9.32,3.06,2.3,1.68
09-12-2021,MORTÁGUA,19,1,216,"[120,240]",Moderado,,,,19,Centro,VISEU,1808,25117.82,8803,638,584,535,499,460,959,1494,2078,2716,35.05,10.81,8.27,5.95
09-12-2021,MOURA,44,3,323,"[240,480]",Elevado,,,,44,Alentejo,BEJA,0210,95845.55,13718,817,656,665,542,461,1003,1668,2324,3141,14.31,3.28,2.42,1.74
09-12-2021,MOURÃO,2,0,82,"[0,120]",Baixo a Moderado,,,,2,Alentejo,ÉVORA,0708,27862.98,2450,139,108,80,104,109,213,293,401,540,8.79,1.94,1.44,1.05
09-12-2021,MURÇA,15,1,278,"[240,480]",Elevado,,,,15,Norte,VILA REAL,1707,18937.11,5463,384,341,307,306,319,625,932,1273,1657,28.85,8.75,6.72,4.92
09-12-2021,MURTOSA,33,2,317,"[240,480]",Elevado,,,,33,Centro,AVEIRO,0112,7308.78,10279,509,473,403,353,409,762,1165,1638,2147,140.63,29.37,22.41,15.94
09-12-2021,NAZARÉ,88,6,624,"[480,960]",Muito Elevado,,,,88,Lisboa e Vale do Tejo,LEIRIA,1011,8243.43,14165,967,903,670,420,396,816,1486,2389,3356,171.84,40.71,28.98,18.03
09-12-2021,NELAS,74,5,570,"[480,960]",Muito Elevado,,,,74,Centro,VISEU,1809,12571.48,12974,924,787,668,604,583,1187,1855,2642,3566,103.21,28.37,21.02,14.76
09-12-2021,NISA,20,1,336,"[240,480]",Elevado,,,,20,Alentejo,PORTALEGRE,1212,57567.84,6061,405,389,355,483,478,961,1316,1705,2110,10.53,3.67,2.96,2.29
09-12-2021,NORDESTE,2,0,42,"[0,120]",Baixo a Moderado,,,,2,Açores,AÇORES,4202,10146.8,4862,246,180,124,161,162,323,447,627,873,47.92,8.6,6.18,4.41
09-12-2021,ÓBIDOS,34,2,283,"[240,480]",Elevado,,,,34,Lisboa e Vale do Tejo,LEIRIA,1012,14155.44,11850,743,650,574,452,436,888,1462,2112,2855,83.72,20.17,14.92,10.33
09-12-2021,ODEMIRA,60,4,244,"[240,480]",Elevado,,,,60,Alentejo,BEJA,0211,172060.15,24717,1475,1317,1225,1397,1349,2746,3971,5288,6763,14.37,3.93,3.07,2.31
09-12-2021,ODIVELAS,440,31,272,"[240,480]",Elevado,,,,440,Lisboa e Vale do Tejo,LISBOA,1116,2654.36,161774,9562,9038,6952,4641,3812,8453,15405,24443,34005,6095.48,1281.27,920.99,580.44
09-12-2021,OEIRAS,850,61,479,"[240,480]",Elevado,,,,850,Lisboa e Vale do Tejo,LISBOA,1110,4588.31,177408,11580,11575,8566,6211,5855,12066,20632,32207,43787,3866.78,954.38,701.98,449.69
09-12-2021,OLEIROS,4,0,80,"[0,120]",Baixo a Moderado,,,,4,Centro,CASTELO BRANCO,0506,47109.31,5003,384,341,366,397,487,884,1250,1591,1975,10.62,4.19,3.38,2.65
09-12-2021,OLHÃO,317,23,713,"[480,960]",Muito Elevado,,,,317,Algarve,FARO,0810,13086.38,44405,2455,2309,1689,1342,1268,2610,4299,6608,9063,339.33,69.26,50.5,32.85
09-12-2021,OLIVEIRA DE AZEMÉIS,430,31,652,"[480,960]",Muito Elevado,,,,430,Norte,AVEIRO,0113,16110.41,66011,4155,3614,2794,2183,1738,3921,6715,10329,14484,409.75,89.91,64.12,41.68
09-12-2021,OLIVEIRA DE FRADES,17,1,170,"[120,240]",Moderado,,,,17,Centro,VISEU,1810,14534.62,9936,553,475,438,359,415,774,1212,1687,2240,68.36,15.41,11.61,8.34
09-12-2021,OLIVEIRA DO BAIRRO,186,13,765,"[480,960]",Muito Elevado,,,,186,Centro,AVEIRO,0114,8731.99,24277,1327,1182,999,786,810,1596,2595,3777,5104,278.02,58.45,43.25,29.72
09-12-2021,OLIVEIRA DO HOSPITAL,56,4,291,"[240,480]",Elevado,,,,56,Centro,COIMBRA,0611,23451.66,19253,1161,1097,962,924,960,1884,2846,3943,5104,82.1,21.76,16.81,12.14
09-12-2021,OURÉM,415,30,942,"[480,960]",Muito Elevado,,,,415,Lisboa e Vale do Tejo,SANTARÉM,1421,41668.03,44044,2463,2069,1899,1817,1603,3420,5319,7388,9851,105.7,23.64,17.73,12.77
09-12-2021,OURIQUE,9,1,198,"[120,240]",Moderado,,,,9,Alentejo,BEJA,0212,66331.36,4607,313,287,284,268,227,495,779,1066,1379,6.95,2.08,1.61,1.17
09-12-2021,OVAR,215,15,396,"[240,480]",Elevado,,,,215,Centro,AVEIRO,0115,14770.25,54260,3294,2709,1994,1636,1234,2870,4864,7573,10867,367.37,73.57,51.27,32.93
09-12-2021,PAÇOS DE FERREIRA,61,4,108,"[0,120]",Baixo a Moderado,,,,61,Norte,PORTO,1309,7099.29,56728,2903,2193,1518,1135,664,1799,3317,5510,8413,799.1,118.51,77.62,46.72
09-12-2021,PALMELA,213,15,331,"[240,480]",Elevado,,,,213,Lisboa e Vale do Tejo,SETÚBAL,1508,46512.01,64269,3402,3244,2635,1846,1391,3237,5872,9116,12518,138.18,26.91,19.6,12.62
09-12-2021,PAMPILHOSA DA SERRA,16,1,397,"[240,480]",Elevado,,,,16,Centro,COIMBRA,0612,39646.24,4037,238,254,295,339,423,762,1057,1311,1549,10.18,3.91,3.31,2.67
09-12-2021,PAREDES,278,20,323,"[240,480]",Elevado,,,,278,Norte,PORTO,1310,15675.69,86067,4272,3532,2412,1717,1258,2975,5387,8919,13191,549.04,84.15,56.9,34.36
09-12-2021,PAREDES DE COURA,11,1,130,"[120,240]",Moderado,,,,11,Norte,VIANA DO CASTELO,1605,13818.59,8535,466,528,407,465,515,980,1387,1915,2381,61.76,17.23,13.86,10.04
09-12-2021,PEDRÓGÃO GRANDE,9,1,264,"[240,480]",Elevado,,,,9,Centro,LEIRIA,1013,12874.75,3410,175,173,196,221,252,473,669,842,1017,26.49,7.9,6.54,5.2
09-12-2021,PENACOVA,85,6,623,"[480,960]",Muito Elevado,,,,85,Centro,COIMBRA,0613,21673.23,13694,968,923,745,621,703,1324,2069,2992,3960,63.18,18.27,13.81,9.55
09-12-2021,PENAFIEL,198,14,284,"[240,480]",Elevado,,,,198,Norte,PORTO,1311,21224.27,69772,3648,2823,2032,1663,1230,2893,4925,7748,11396,328.74,53.69,36.51,23.2
09-12-2021,PENALVA DO CASTELO,41,3,574,"[480,960]",Muito Elevado,,,,41,Centro,VISEU,1811,13433.92,7115,449,457,413,391,426,817,1230,1687,2136,52.96,15.9,12.56,9.16
09-12-2021,PENAMACOR,15,1,318,"[240,480]",Elevado,,,,15,Centro,CASTELO BRANCO,0507,56370.69,4755,262,248,273,451,633,1084,1357,1605,1867,8.44,3.31,2.85,2.41
09-12-2021,PENEDONO,17,1,661,"[480,960]",Muito Elevado,,,,17,Norte,VISEU,1812,13370.75,2591,172,113,129,156,138,294,423,536,708,19.38,5.3,4.01,3.16
09-12-2021,PENELA,25,2,464,"[240,480]",Elevado,,,,25,Centro,COIMBRA,0614,13480.0,5397,314,324,274,359,344,703,977,1301,1615,40.04,11.98,9.65,7.25
09-12-2021,PENICHE,136,10,513,"[480,960]",Muito Elevado,,,,136,Lisboa e Vale do Tejo,LEIRIA,1014,7754.98,26501,1746,1504,1203,926,707,1633,2836,4340,6086,341.73,78.48,55.96,36.57
09-12-2021,PESO DA RÉGUA,32,2,204,"[120,240]",Moderado,,,,32,Norte,VILA REAL,1708,9486.01,15773,1076,843,650,659,455,1114,1764,2607,3683,166.28,38.83,27.48,18.6
09-12-2021,PINHEL,44,3,522,"[480,960]",Muito Elevado,,,,44,Centro,GUARDA,0910,48452.12,8511,577,566,551,538,689,1227,1778,2344,2921,17.57,6.03,4.84,3.67
09-12-2021,POMBAL,439,31,854,"[480,960]",Muito Elevado,,,,439,Centro,LEIRIA,1015,62600.28,51461,3187,2791,2494,2328,2027,4355,6849,9640,12827,82.21,20.49,15.4,10.94
09-12-2021,PONTA DELGADA,138,10,203,"[120,240]",Moderado,,,,138,Açores,AÇORES,4203,23298.65,67935,3108,2435,1726,1133,902,2035,3761,6196,9304,291.58,39.93,26.59,16.14
09-12-2021,PONTA DO SOL,13,1,152,"[120,240]",Moderado,,,,13,Madeira,MADEIRA,3105,4622.03,8593,319,283,347,208,221,429,776,1059,1378,185.92,29.81,22.91,16.79
09-12-2021,PONTE DA BARCA,96,7,856,"[480,960]",Muito Elevado,,,,96,Norte,VIANA DO CASTELO,1606,18211.37,11180,635,576,517,554,490,1044,1561,2137,2772,61.39,15.22,11.73,8.57
09-12-2021,PONTE DE LIMA,136,10,329,"[240,480]",Elevado,,,,136,Norte,VIANA DO CASTELO,1607,32025.46,41315,2321,2022,1720,1596,1462,3058,4778,6800,9121,129.01,28.48,21.23,14.92
09-12-2021,PONTE DE SOR,97,7,647,"[480,960]",Muito Elevado,,,,97,Alentejo,PORTALEGRE,1213,83971.16,14994,939,800,716,739,831,1570,2286,3086,4025,17.86,4.79,3.68,2.72
09-12-2021,PORTALEGRE,23,2,105,"[0,120]",Baixo a Moderado,,,,23,Alentejo,PORTALEGRE,1214,44713.64,22172,1577,1351,1137,993,984,1977,3114,4465,6042,49.59,13.51,9.99,6.96
09-12-2021,PORTEL,17,1,294,"[240,480]",Elevado,,,,17,Alentejo,ÉVORA,0709,60100.57,5828,336,358,283,331,305,636,919,1277,1613,9.7,2.68,2.12,1.53
09-12-2021,PORTIMÃO,676,48,1219,"[960,Max]",Extremamente Elevado,,,,676,Algarve,FARO,0811,18206.29,55483,3182,2927,2116,1582,1400,2982,5098,8025,11207,304.75,61.56,44.08,28.0
09-12-2021,PORTO,1129,81,521,"[480,960]",Muito Elevado,,,,1129,Norte,PORTO,1312,4142.02,216606,15790,15193,11280,9409,10044,19453,30733,45926,61716,5229.5,1490.0,1108.79,741.98
09-12-2021,PORTO DE MÓS,120,9,514,"[480,960]",Muito Elevado,,,,120,Centro,LEIRIA,1016,26183.41,23275,1355,1210,1034,888,872,1760,2794,4004,5359,88.89,20.47,15.29,10.67
09-12-2021,PORTO MONIZ,8,1,346,"[240,480]",Elevado,,,,8,Madeira,MADEIRA,3106,8293.38,2342,143,130,95,98,120,218,313,443,586,28.24,7.07,5.34,3.77
09-12-2021,PORTO SANTO,24,2,462,"[240,480]",Elevado,,,,24,Madeira,MADEIRA,3201,4300.7,5202,240,157,134,110,68,178,312,469,709,120.95,16.48,10.9,7.25
09-12-2021,PÓVOA DE LANHOSO,77,5,358,"[240,480]",Elevado,,,,77,Norte,BRAGA,0309,13465.29,21499,1175,909,732,673,624,1297,2029,2938,4113,159.67,30.55,21.82,15.07
09-12-2021,PÓVOA DE VARZIM,139,10,221,"[120,240]",Moderado,,,,139,Norte,PORTO,1313,8220.59,62784,3712,3120,2134,1594,1305,2899,5033,8153,11865,763.7,144.33,99.17,61.22
09-12-2021,POVOAÇÃO,16,1,271,"[240,480]",Elevado,,,,16,Açores,AÇORES,4204,10640.77,5927,293,212,191,144,134,278,469,681,974,55.7,9.15,6.4,4.41
09-12-2021,VILA DA PRAIA DA VITÓRIA,7,1,33,"[0,120]",Baixo a Moderado,,,,7,Açores,AÇORES,4302,16127.06,21317,1133,789,619,436,336,772,1391,2180,3313,132.18,20.54,13.52,8.63
09-12-2021,PROENÇA-A-NOVA,14,1,193,"[120,240]",Moderado,,,,14,Centro,CASTELO BRANCO,0508,39539.96,7298,508,465,389,400,560,960,1349,1814,2322,18.46,5.87,4.59,3.41
09-12-2021,REDONDO,5,0,80,"[0,120]",Baixo a Moderado,,,,5,Alentejo,ÉVORA,0710,36950.87,6353,349,325,288,288,354,642,930,1255,1604,17.19,4.34,3.4,2.52
09-12-2021,REGUENGOS DE MONSARAZ,13,1,131,"[120,240]",Moderado,,,,13,Alentejo,ÉVORA,0711,46399.72,10015,602,511,455,462,473,935,1390,1901,2503,21.58,5.39,4.1,3.0
09-12-2021,RESENDE,41,3,409,"[240,480]",Elevado,,,,41,Norte,VISEU,1813,12334.93,10137,560,493,448,433,422,855,1303,1796,2356,82.18,19.1,14.56,10.56
09-12-2021,RIBEIRA BRAVA,39,3,316,"[240,480]",Elevado,,,,39,Madeira,MADEIRA,3107,6544.88,12435,648,500,411,311,287,598,1009,1509,2157,189.99,32.96,23.06,15.42
09-12-2021,RIBEIRA DE PENA,6,0,100,"[0,120]",Baixo a Moderado,,,,6,Norte,VILA REAL,1709,21745.98,6016,371,301,290,310,368,678,968,1269,1640,27.66,7.54,5.84,4.45
09-12-2021,RIBEIRA GRANDE,35,3,107,"[0,120]",Baixo a Moderado,,,,35,Açores,AÇORES,4205,18015.13,32811,1163,689,512,345,253,598,1110,1799,2962,182.13,16.44,9.99,6.16
09-12-2021,RIO MAIOR,53,4,261,"[240,480]",Elevado,,,,53,Lisboa e Vale do Tejo,SANTARÉM,1414,27276.45,20379,1251,1144,941,795,648,1443,2384,3528,4779,74.71,17.52,12.93,8.74
09-12-2021,SABROSA,19,1,323,"[240,480]",Elevado,,,,19,Norte,VILA REAL,1710,15692.45,5918,393,314,304,302,350,652,956,1270,1663,37.71,10.6,8.09,6.09
09-12-2021,SABUGAL,76,5,722,"[480,960]",Muito Elevado,,,,76,Centro,GUARDA,0911,82269.82,10585,724,707,694,796,1009,1805,2499,3206,3930,12.87,4.78,3.9,3.04
09-12-2021,SALVATERRA DE MAGOS,70,5,330,"[240,480]",Elevado,,,,70,Lisboa e Vale do Tejo,SANTARÉM,1415,24393.2,21295,1275,1181,1060,799,772,1571,2631,3812,5087,87.3,20.85,15.63,10.79
09-12-2021,SANTA COMBA DÃO,34,2,326,"[240,480]",Elevado,,,,34,Centro,VISEU,1814,11194.77,10452,732,684,569,538,464,1002,1571,2255,2987,93.36,26.68,20.14,14.03
09-12-2021,SANTA CRUZ,199,14,440,"[240,480]",Elevado,,,,199,Madeira,MADEIRA,3108,8150.28,45281,1817,1301,974,716,523,1239,2213,3514,5331,555.6,65.41,43.12,27.15
09-12-2021,SANTA CRUZ DA GRACIOSA,1,0,24,"[0,120]",Baixo a Moderado,,,,1,Açores,AÇORES,4401,6065.78,4208,228,180,163,124,145,269,432,612,840,69.37,13.85,10.09,7.12
09-12-2021,SANTA CRUZ DAS FLORES,0,0,0,"[0,120]",Baixo a Moderado,,,,0,Açores,AÇORES,4802,7091.44,2165,125,98,74,56,51,107,181,279,404,30.53,5.7,3.93,2.55
09-12-2021,SANTA MARIA DA FEIRA,958,68,691,"[480,960]",Muito Elevado,,,,958,Norte,AVEIRO,0109,21587.65,138636,8182,6743,4771,3856,3079,6935,11706,18449,26631,642.19,123.36,85.46,54.22
09-12-2021,SANTA MARTA DE PENAGUIÃO,10,1,153,"[120,240]",Moderado,,,,10,Norte,VILA REAL,1711,6928.13,6599,483,373,337,316,317,633,970,1343,1826,95.25,26.36,19.39,14.0
09-12-2021,SANTANA,8,1,120,"[120,240]",Moderado,,,,8,Madeira,MADEIRA,3109,9547.3,6711,418,353,343,282,277,559,902,1255,1673,70.29,17.52,13.15,9.45
09-12-2021,SANTARÉM,265,19,462,"[240,480]",Elevado,,,,265,Lisboa e Vale do Tejo,SANTARÉM,1416,55253.58,57421,3654,3441,2760,2466,2206,4672,7432,10873,14527,103.92,26.29,19.68,13.45
09-12-2021,SANTIAGO DO CACÉM,66,5,230,"[120,240]",Moderado,,,,66,Alentejo,SETÚBAL,1509,105969.29,28791,2144,1689,1472,1295,1215,2510,3982,5671,7815,27.17,7.37,5.35,3.76
09-12-2021,SANTO TIRSO,214,15,315,"[240,480]",Elevado,,,,214,Norte,PORTO,1314,13655.52,68055,4911,3935,2761,2257,1810,4067,6828,10763,15674,498.35,114.78,78.82,50.0
09-12-2021,SÃO BRÁS DE ALPORTEL,87,6,839,"[480,960]",Muito Elevado,,,,87,Algarve,FARO,0812,15336.92,10416,596,468,467,404,401,805,1272,1740,2336,67.91,15.23,11.35,8.29
09-12-2021,SÃO JOÃO DA MADEIRA,183,13,834,"[480,960]",Muito Elevado,,,,183,Norte,AVEIRO,0116,794.3,21958,1347,1069,796,601,593,1194,1990,3059,4406,2765.49,554.91,385.26,250.63
09-12-2021,SÃO JOÃO DA PESQUEIRA,24,2,340,"[240,480]",Elevado,,,,24,Norte,VISEU,1815,26610.85,7125,417,330,294,328,328,656,950,1280,1697,26.77,6.38,4.81,3.57
09-12-2021,SÃO PEDRO DO SUL,61,4,396,"[240,480]",Elevado,,,,61,Centro,VISEU,1816,34895.09,15403,990,962,861,759,909,1668,2529,3491,4481,44.14,12.84,10.0,7.25
09-12-2021,SÃO ROQUE DO PICO,3,0,92,"[0,120]",Baixo a Moderado,,,,3,Açores,AÇORES,4603,14236.1,3266,199,141,93,96,113,209,302,443,642,22.94,4.51,3.11,2.12
09-12-2021,SÃO VICENTE,11,1,215,"[120,240]",Moderado,,,,11,Madeira,MADEIRA,3110,7883.71,5143,272,264,266,225,280,505,771,1035,1307,65.23,16.58,13.13,9.78
09-12-2021,SARDOAL,19,1,511,"[480,960]",Muito Elevado,,,,19,Lisboa e Vale do Tejo,SANTARÉM,1417,9214.72,3741,227,178,148,165,248,413,561,739,966,40.6,10.48,8.02,6.09
09-12-2021,SÁTÃO,47,3,404,"[240,480]",Elevado,,,,47,Centro,VISEU,1817,20194.11,11580,765,671,515,465,476,941,1456,2127,2892,57.34,14.32,10.53,7.21
09-12-2021,SEIA,66,5,298,"[240,480]",Elevado,,,,66,Centro,GUARDA,0912,43568.83,22234,1807,1589,1238,1122,721,1843,3081,4670,6477,51.03,14.87,10.72,7.07
09-12-2021,SEIXAL,451,32,269,"[240,480]",Elevado,,,,451,Lisboa e Vale do Tejo,SETÚBAL,1510,9545.17,167752,10586,9270,6661,4391,2930,7321,13982,23252,33838,1757.49,354.51,243.6,146.49
09-12-2021,SERNANCELHE,11,1,205,"[120,240]",Moderado,,,,11,Norte,VISEU,1818,22861.22,5396,305,293,286,273,260,533,819,1112,1417,23.6,6.2,4.86,3.58
09-12-2021,SERPA,117,8,818,"[480,960]",Muito Elevado,,,,117,Alentejo,BEJA,0213,110563.34,14304,903,761,719,697,626,1323,2042,2803,3706,12.94,3.35,2.54,1.85
09-12-2021,SERTÃ,60,4,412,"[240,480]",Elevado,,,,60,Centro,CASTELO BRANCO,0509,44673.17,14577,870,779,790,767,1020,1787,2577,3356,4226,32.63,9.46,7.51,5.77
09-12-2021,SESIMBRA,192,14,371,"[240,480]",Elevado,,,,192,Lisboa e Vale do Tejo,SETÚBAL,1511,19571.75,51858,2400,2321,1853,1257,1083,2340,4193,6514,8914,264.96,45.54,33.28,21.42
09-12-2021,SETÚBAL,336,24,292,"[240,480]",Elevado,,,,336,Lisboa e Vale do Tejo,SETÚBAL,1512,23032.5,115126,7425,6929,5075,3775,2655,6430,11505,18434,25859,499.83,112.27,80.03,49.95
09-12-2021,SEVER DO VOUGA,11,1,97,"[0,120]",Baixo a Moderado,,,,11,Centro,AVEIRO,0117,12987.56,11331,766,637,568,540,567,1107,1675,2312,3078,87.24,23.7,17.8,12.9
09-12-2021,SILVES,288,21,795,"[480,960]",Muito Elevado,,,,288,Algarve,FARO,0813,68006.23,36226,2137,1869,1610,1423,1600,3023,4633,6502,8639,53.27,12.7,9.56,6.81
09-12-2021,SINES,18,1,131,"[120,240]",Moderado,,,,18,Alentejo,SETÚBAL,1513,20330.17,13715,888,791,551,416,268,684,1235,2026,2914,67.46,14.33,9.97,6.07
09-12-2021,SINTRA,1119,80,286,"[240,480]",Elevado,,,,1119,Lisboa e Vale do Tejo,LISBOA,1111,31922.73,391402,20490,18316,13545,9137,7284,16421,29966,48282,68772,1226.08,215.43,151.25,93.87
09-12-2021,SOBRAL DE MONTE AGRAÇO,31,2,295,"[240,480]",Elevado,,,,31,Lisboa e Vale do Tejo,LISBOA,1112,5210.32,10651,564,507,352,272,212,484,836,1343,1907,204.43,36.6,25.78,16.05
09-12-2021,SOURE,161,11,938,"[480,960]",Muito Elevado,,,,161,Centro,COIMBRA,0615,26506.07,17120,1173,1142,1004,883,987,1870,2874,4016,5189,64.59,19.58,15.15,10.84
09-12-2021,SOUSEL,12,1,277,"[240,480]",Elevado,,,,12,Alentejo,PORTALEGRE,1215,27932.18,4412,261,274,208,302,292,594,802,1076,1337,15.8,4.79,3.85,2.87
09-12-2021,TÁBUA,38,3,333,"[240,480]",Elevado,,,,38,Centro,COIMBRA,0616,19978.58,11368,729,584,524,430,464,894,1418,2002,2731,56.9,13.67,10.02,7.1
09-12-2021,TABUAÇO,3,0,50,"[0,120]",Baixo a Moderado,,,,3,Norte,VISEU,1819,13385.67,6033,372,314,217,282,363,645,862,1176,1548,45.07,11.56,8.79,6.44
09-12-2021,TAROUCA,6,0,77,"[0,120]",Baixo a Moderado,,,,6,Norte,VISEU,1820,10008.49,7804,405,335,313,277,324,601,914,1249,1654,77.98,16.53,12.48,9.13
09-12-2021,TAVIRA,168,12,683,"[480,960]",Muito Elevado,,,,168,Algarve,FARO,0814,60696.7,24530,1493,1415,1252,1066,1277,2343,3595,5010,6503,40.41,10.71,8.25,5.92
09-12-2021,TERRAS DE BOURO,47,3,744,"[480,960]",Muito Elevado,,,,47,Norte,BRAGA,0310,27746.07,6361,391,372,296,319,340,659,955,1327,1718,22.93,6.19,4.78,3.44
09-12-2021,TOMAR,239,17,650,"[480,960]",Muito Elevado,,,,239,Lisboa e Vale do Tejo,SANTARÉM,1418,35120.44,36748,2403,2189,1868,1853,1822,3675,5543,7732,10135,104.64,28.86,22.02,15.78
09-12-2021,TONDELA,126,9,478,"[240,480]",Elevado,,,,126,Centro,VISEU,1821,37121.73,26357,1768,1722,1518,1475,1417,2892,4410,6132,7900,71.0,21.28,16.52,11.88
09-12-2021,TORRE DE MONCORVO,11,1,145,"[120,240]",Moderado,,,,11,Norte,BRAGANÇA,0409,53155.67,7695,556,478,488,551,719,1270,1758,2236,2792,14.48,5.25,4.21,3.31
09-12-2021,TORRES NOVAS,260,19,744,"[480,960]",Muito Elevado,,,,260,Lisboa e Vale do Tejo,SANTARÉM,1419,26999.68,34933,2324,1979,1738,1406,1475,2881,4619,6598,8922,129.38,33.04,24.44,17.11
09-12-2021,TORRES VEDRAS,481,34,613,"[480,960]",Muito Elevado,,,,481,Lisboa e Vale do Tejo,LISBOA,1113,40714.89,78530,4513,3945,3447,2628,2104,4732,8179,12124,16637,192.88,40.86,29.78,20.09
09-12-2021,TRANCOSO,11,1,124,"[120,240]",Moderado,,,,11,Centro,GUARDA,0913,36152.47,8875,581,557,542,586,496,1082,1624,2181,2762,24.55,7.64,6.03,4.49
09-12-2021,TROFA,97,7,252,"[240,480]",Elevado,,,,97,Norte,PORTO,1318,7201.76,38418,2336,1894,1231,939,684,1623,2854,4748,7084,533.44,98.36,65.93,39.63
09-12-2021,VAGOS,138,10,609,"[480,960]",Muito Elevado,,,,138,Centro,AVEIRO,0118,16491.5,22740,1320,1205,922,784,724,1508,2430,3635,4955,137.89,30.04,22.04,14.73
09-12-2021,VALE DE CAMBRA,66,5,311,"[240,480]",Elevado,,,,66,Norte,AVEIRO,0119,14733.47,21327,1491,1363,1005,831,798,1629,2634,3997,5488,144.76,37.25,27.13,17.88
09-12-2021,VALENÇA,53,4,402,"[240,480]",Elevado,,,,53,Norte,VIANA DO CASTELO,1608,11712.86,13290,867,791,582,582,503,1085,1667,2458,3325,113.46,28.39,20.99,14.23
09-12-2021,VALONGO,400,29,411,"[240,480]",Elevado,,,,400,Norte,PORTO,1315,7512.45,97444,5629,4696,3207,2462,1829,4291,7498,12194,17823,1297.18,237.26,162.33,99.81
09-12-2021,VALPAÇOS,33,2,225,"[120,240]",Moderado,,,,33,Norte,VILA REAL,1712,54873.93,14818,1217,1118,999,928,997,1925,2924,4042,5259,27.0,9.58,7.37,5.33
09-12-2021,VELAS,2,0,39,"[0,120]",Baixo a Moderado,,,,2,Açores,AÇORES,4502,11738.38,5093,278,208,166,153,113,266,432,640,918,43.39,7.82,5.45,3.68
09-12-2021,VENDAS NOVAS,7,1,63,"[0,120]",Baixo a Moderado,,,,7,Alentejo,ÉVORA,0712,22238.88,11255,677,768,655,501,532,1033,1688,2456,3133,50.61,14.09,11.04,7.59
09-12-2021,VIANA DO ALENTEJO,13,1,255,"[240,480]",Elevado,,,,13,Alentejo,ÉVORA,0713,39367.29,5145,245,208,235,210,214,424,659,867,1112,13.07,2.82,2.2,1.67
09-12-2021,VIANA DO CASTELO,267,19,316,"[240,480]",Elevado,,,,267,Norte,VIANA DO CASTELO,1609,31902.01,84417,5470,4433,3591,3061,2982,6043,9634,14067,19537,264.61,61.24,44.09,30.2
09-12-2021,VIDIGUEIRA,23,2,420,"[240,480]",Elevado,,,,23,Alentejo,BEJA,0214,31661.09,5510,300,248,215,233,275,508,723,971,1271,17.4,4.01,3.07,2.28
09-12-2021,VIEIRA DO MINHO,27,2,229,"[120,240]",Moderado,,,,27,Norte,BRAGA,0311,21644.35,11842,703,594,525,548,482,1030,1555,2149,2852,54.71,13.18,9.93,7.18
09-12-2021,VILA DE REI,4,0,120,"[120,240]",Moderado,,,,4,Centro,CASTELO BRANCO,0510,19154.6,3323,169,128,172,247,302,549,721,849,1018,17.35,5.31,4.43,3.76
09-12-2021,VILA DO BISPO,34,2,661,"[480,960]",Muito Elevado,,,,34,Algarve,FARO,0815,17906.06,5154,302,302,314,232,233,465,779,1081,1383,28.78,7.72,6.04,4.35
09-12-2021,VILA DO CONDE,259,18,324,"[240,480]",Elevado,,,,259,Norte,PORTO,1316,14902.77,79899,4726,3875,2819,2070,1743,3813,6632,10507,15233,536.13,102.21,70.5,44.5
09-12-2021,VILA DO PORTO,4,0,71,"[0,120]",Baixo a Moderado,,,,4,Açores,AÇORES,4101,9688.74,5616,274,212,135,96,123,219,354,566,840,57.96,8.67,5.84,3.65
09-12-2021,VILA FLOR,8,1,133,"[120,240]",Moderado,,,,8,Norte,BRAGANÇA,0410,26581.14,6044,429,362,422,294,331,625,1047,1409,1838,22.74,6.91,5.3,3.94
09-12-2021,VILA FRANCA DE XIRA,558,40,393,"[240,480]",Elevado,,,,558,Lisboa e Vale do Tejo,LISBOA,1114,31819.39,141957,8501,6852,4869,3425,2472,5897,10766,17618,26119,446.14,82.09,55.37,33.84
09-12-2021,VILA FRANCA DO CAMPO,7,1,64,"[0,120]",Baixo a Moderado,,,,7,Açores,AÇORES,4206,7796.82,11051,450,344,248,217,154,371,619,963,1413,141.73,18.12,12.35,7.94
09-12-2021,VILA NOVA DA BARQUINHA,29,2,384,"[240,480]",Elevado,,,,29,Lisboa e Vale do Tejo,SANTARÉM,1420,4952.97,7461,415,406,392,364,338,702,1094,1500,1915,150.64,38.66,30.28,22.09
09-12-2021,VILA NOVA DE CERVEIRA,44,3,494,"[480,960]",Muito Elevado,,,,44,Norte,VIANA DO CASTELO,1610,10846.66,8910,531,444,410,384,334,718,1128,1572,2103,82.14,19.39,14.49,10.4
09-12-2021,VILA NOVA DE FAMALICÃO,474,34,360,"[240,480]",Elevado,,,,474,Norte,BRAGA,0312,20159.26,131676,7817,6164,4202,3282,2749,6031,10233,16397,24214,653.19,120.12,81.34,50.76
09-12-2021,VILA NOVA DE FOZ CÔA,9,1,140,"[120,240]",Moderado,,,,9,Centro,GUARDA,0914,39815.18,6503,442,385,390,398,429,827,1217,1602,2044,16.33,5.13,4.02,3.06
09-12-2021,VILA NOVA DE GAIA,1523,109,507,"[480,960]",Muito Elevado,,,,1523,Norte,PORTO,1317,16846.43,300472,18349,15568,10972,8224,6281,14505,25477,41045,59394,1783.64,352.57,243.65,151.23
09-12-2021,VILA NOVA DE PAIVA,55,4,1173,"[960,Max]",Extremamente Elevado,,,,55,Centro,VISEU,1822,17553.28,4687,289,272,233,217,241,458,691,963,1252,26.7,7.13,5.49,3.94
09-12-2021,VILA NOVA DE POIARES,13,1,187,"[120,240]",Moderado,,,,13,Centro,COIMBRA,0617,8445.3,6939,380,284,262,235,182,417,679,963,1343,82.17,15.9,11.4,8.04
09-12-2021,VILA POUCA DE AGUIAR,15,1,126,"[120,240]",Moderado,,,,15,Norte,VILA REAL,1713,43706.62,11961,860,817,733,601,627,1228,1961,2778,3638,27.37,8.32,6.36,4.49
09-12-2021,VILA REAL,195,14,391,"[240,480]",Elevado,,,,195,Norte,VILA REAL,1714,37880.28,49962,3025,2498,2065,1579,1466,3045,5110,7608,10633,131.9,28.07,20.08,13.49
09-12-2021,VILA REAL DE SANTO ANTÓNIO,96,7,510,"[480,960]",Muito Elevado,,,,96,Algarve,FARO,0816,6125.0,18749,1172,1069,811,569,586,1155,1966,3035,4207,306.11,68.69,49.55,32.1
09-12-2021,VILA VELHA DE RÓDÃO,14,1,446,"[240,480]",Elevado,,,,14,Centro,CASTELO BRANCO,0511,32991.16,3144,209,229,180,283,306,589,769,998,1207,9.53,3.66,3.03,2.33
09-12-2021,VILA VERDE,159,11,340,"[240,480]",Elevado,,,,159,Norte,BRAGA,0313,22866.52,46911,2365,2063,1667,1494,1437,2931,4598,6661,9026,205.15,39.47,29.13,20.11
09-12-2021,VILA VIÇOSA,17,1,225,"[120,240]",Moderado,,,,17,Alentejo,ÉVORA,0714,19485.89,7656,487,379,342,345,324,669,1011,1390,1877,39.29,9.63,7.13,5.19
09-12-2021,VIMIOSO,28,2,707,"[480,960]",Muito Elevado,,,,28,Norte,BRAGANÇA,0411,48158.51,4023,274,230,261,293,335,628,889,1119,1393,8.35,2.89,2.32,1.85
09-12-2021,VINHAIS,41,3,526,"[480,960]",Muito Elevado,,,,41,Norte,BRAGANÇA,0412,69475.09,7746,599,577,636,641,815,1456,2092,2669,3268,11.15,4.7,3.84,3.01
09-12-2021,VISEU,656,47,675,"[480,960]",Muito Elevado,,,,656,Centro,VISEU,1823,50710.14,97249,5769,5038,4140,3158,2710,5868,10008,15046,20815,191.77,41.05,29.67,19.74
09-12-2021,VIZELA,40,3,167,"[120,240]",Moderado,,,,40,Norte,BRAGA,0314,2469.83,23897,1258,928,655,509,371,880,1535,2463,3721,967.49,150.65,99.72,62.15
09-12-2021,VOUZELA,16,1,166,"[120,240]",Moderado,,,,16,Centro,VISEU,1824,19369.46,9619,626,605,554,532,507,1039,1593,2198,2824,49.66,14.58,11.35,8.22
16-12-2021,ABRANTES,185,13,526,"[480,960]",Muito Elevado,,,,185,Lisboa e Vale do Tejo,SANTARÉM,1401,71469.08,35130,2473,2213,1730,1748,2021,3769,5499,7712,10185,49.15,14.25,10.79,7.69
16-12-2021,ÁGUEDA,520,37,1128,"[960,Max]",Extremamente Elevado,,,,520,Centro,AVEIRO,0101,33527.44,46075,3237,2713,2090,1635,1496,3131,5221,7934,11171,137.43,33.32,23.66,15.57
16-12-2021,AGUIAR DA BEIRA,20,1,432,"[240,480]",Elevado,,,,20,Centro,GUARDA,0901,20676.57,4652,304,281,235,239,148,387,622,903,1207,22.5,5.84,4.37,3.01
16-12-2021,ALANDROAL,5,0,102,"[0,120]",Baixo a Moderado,,,,5,Alentejo,ÉVORA,0701,54267.81,4992,307,256,296,299,377,676,972,1228,1535,9.2,2.83,2.26,1.79
16-12-2021,ALBERGARIA-A-VELHA,169,12,700,"[480,960]",Muito Elevado,,,,169,Centro,AVEIRO,0102,15882.5,24144,1550,1298,996,687,680,1367,2363,3661,5211,152.02,32.81,23.05,14.88
16-12-2021,ALBUFEIRA,308,22,742,"[480,960]",Muito Elevado,,,,308,Algarve,FARO,0801,14066.42,41528,2067,1717,1425,985,858,1843,3268,4985,7052,295.24,50.14,35.44,23.23
16-12-2021,ALCÁCER DO SAL,91,6,779,"[480,960]",Muito Elevado,,,,91,Alentejo,SETÚBAL,1501,149987.3,11659,884,814,623,623,602,1225,1848,2662,3546,7.77,2.36,1.77,1.23
16-12-2021,ALCANENA,50,4,389,"[240,480]",Elevado,,,,50,Lisboa e Vale do Tejo,SANTARÉM,1402,12732.86,12809,891,744,628,536,588,1124,1752,2496,3387,100.6,26.6,19.6,13.76
16-12-2021,ALCOBAÇA,349,25,651,"[480,960]",Muito Elevado,,,,349,Lisboa e Vale do Tejo,LEIRIA,1001,40814.09,53555,3420,2927,2466,2059,1676,3735,6201,9128,12548,131.22,30.74,22.36,15.19
16-12-2021,ALCOCHETE,70,5,356,"[240,480]",Elevado,,,,70,Lisboa e Vale do Tejo,SETÚBAL,1502,12836.48,19787,857,834,691,476,447,923,1614,2448,3305,154.15,25.75,19.07,12.57
16-12-2021,ALCOUTIM,3,0,144,"[120,240]",Moderado,,,,3,Algarve,FARO,0802,57536.33,2159,191,188,163,190,267,457,620,808,999,3.75,1.74,1.4,1.08
16-12-2021,ALENQUER,285,20,646,"[480,960]",Muito Elevado,,,,285,Lisboa e Vale do Tejo,LISBOA,1101,30421.92,44052,2298,2062,1629,1330,1155,2485,4114,6176,8474,144.8,27.85,20.3,13.52
16-12-2021,ALFÂNDEGA DA FÉ,61,4,1336,"[960,Max]",Extremamente Elevado,,,,61,Norte,BRAGANÇA,0401,32194.64,4550,325,277,301,274,325,599,900,1177,1502,14.13,4.67,3.66,2.8
16-12-2021,ALIJÓ,32,2,304,"[240,480]",Elevado,,,,32,Norte,VILA REAL,1701,29759.89,10625,766,687,635,542,666,1208,1843,2530,3296,35.7,11.08,8.5,6.19
16-12-2021,ALJEZUR,19,1,339,"[240,480]",Elevado,,,,19,Algarve,FARO,0803,32349.95,5594,316,336,335,320,410,730,1065,1401,1717,17.29,5.31,4.33,3.29
16-12-2021,ALJUSTREL,30,2,369,"[240,480]",Elevado,,,,30,Alentejo,BEJA,0201,45847.41,8247,635,521,443,347,358,705,1148,1669,2304,17.99,5.03,3.64,2.5
16-12-2021,ALMADA,808,58,478,"[240,480]",Elevado,,,,808,Lisboa e Vale do Tejo,SETÚBAL,1503,7000.89,169039,10469,9777,7876,6144,5111,11255,19131,28908,39377,2414.5,562.45,412.91,273.26
16-12-2021,ALMEIDA,29,2,501,"[480,960]",Muito Elevado,,,,29,Centro,GUARDA,0902,51798.46,5830,441,419,396,458,393,851,1247,1666,2107,11.26,4.07,3.22,2.41
16-12-2021,ALMEIRIM,147,10,651,"[480,960]",Muito Elevado,,,,147,Lisboa e Vale do Tejo,SANTARÉM,1403,22212.05,22546,1342,1353,1106,866,843,1709,2815,4168,5510,101.5,24.81,18.76,12.67
16-12-2021,ALMODÔVAR,29,2,435,"[240,480]",Elevado,,,,29,Alentejo,BEJA,0202,77788.03,6725,414,443,396,373,328,701,1097,1540,1954,8.65,2.51,1.98,1.41
16-12-2021,ALPIARÇA,34,2,487,"[480,960]",Muito Elevado,,,,34,Lisboa e Vale do Tejo,SANTARÉM,1404,9536.33,7059,515,486,363,333,274,607,970,1456,1971,74.02,20.67,15.27,10.17
16-12-2021,ALTER DO CHÃO,3,0,96,"[0,120]",Baixo a Moderado,,,,3,Alentejo,PORTALEGRE,1201,36206.62,3165,201,163,136,208,187,395,531,694,895,8.74,2.47,1.92,1.47
16-12-2021,ALVAIÁZERE,20,1,303,"[240,480]",Elevado,,,,20,Centro,LEIRIA,1002,16047.76,6597,419,389,346,406,539,945,1291,1680,2099,41.11,13.08,10.47,8.04
16-12-2021,ALVITO,1,0,41,"[0,120]",Baixo a Moderado,,,,1,Alentejo,BEJA,0203,26485.32,2477,145,110,105,111,89,200,305,415,560,9.35,2.11,1.57,1.15
16-12-2021,AMADORA,711,51,386,"[240,480]",Elevado,,,,711,Lisboa e Vale do Tejo,LISBOA,1115,2378.47,184106,11186,10936,8780,6460,5890,12350,21130,32066,43252,7742.05,1818.84,1348.44,888.56
16-12-2021,AMARANTE,247,18,465,"[240,480]",Elevado,,,,247,Norte,PORTO,1301,30133.15,53193,3086,2413,1812,1643,1311,2954,4766,7179,10265,176.53,34.07,23.82,15.82
16-12-2021,AMARES,124,9,685,"[480,960]",Muito Elevado,,,,124,Norte,BRAGA,0301,8195.41,18129,1001,829,622,489,524,1013,1635,2464,3465,221.22,42.28,30.07,19.95
16-12-2021,ANADIA,326,23,1195,"[960,Max]",Extremamente Elevado,,,,326,Centro,AVEIRO,0103,21663.48,27258,1931,1698,1376,1208,1262,2470,3846,5544,7475,125.83,34.51,25.59,17.75
16-12-2021,ANGRA DO HEROÍSMO,52,4,155,"[120,240]",Moderado,,,,52,Açores,AÇORES,4301,23899.66,33807,2006,1473,1122,768,635,1403,2525,3998,6004,141.45,25.12,16.73,10.56
16-12-2021,ANSIÃO,59,4,489,"[480,960]",Muito Elevado,,,,59,Centro,LEIRIA,1003,17609.42,12039,727,709,646,694,530,1224,1870,2579,3306,68.37,18.77,14.65,10.62
16-12-2021,ARCOS DE VALDEVEZ,96,7,457,"[240,480]",Elevado,,,,96,Norte,VIANA DO CASTELO,1601,44759.64,20926,1329,1338,1282,1343,1515,2858,4140,5478,6807,46.75,15.21,12.24,9.25
16-12-2021,ARGANIL,21,2,191,"[120,240]",Moderado,,,,21,Centro,COIMBRA,0601,33283.93,11014,672,648,612,559,596,1155,1767,2415,3087,33.09,9.27,7.26,5.31
16-12-2021,ARMAMAR,14,1,245,"[240,480]",Elevado,,,,14,Norte,VISEU,1801,11723.73,5769,357,305,309,285,310,595,904,1209,1566,49.21,13.36,10.31,7.71
16-12-2021,AROUCA,162,12,781,"[480,960]",Muito Elevado,,,,162,Norte,AVEIRO,0104,32910.52,20720,1306,1047,753,683,683,1366,2119,3166,4472,62.96,13.59,9.62,6.44
16-12-2021,ARRAIOLOS,22,2,320,"[240,480]",Elevado,,,,22,Alentejo,ÉVORA,0702,68374.55,6928,435,384,283,367,480,847,1130,1514,1949,10.13,2.85,2.21,1.65
16-12-2021,ARRONCHES,1,0,36,"[0,120]",Baixo a Moderado,,,,1,Alentejo,PORTALEGRE,1202,31464.72,2820,155,142,162,187,179,366,528,670,825,8.96,2.62,2.13,1.68
16-12-2021,ARRUDA DOS VINHOS,36,3,235,"[120,240]",Moderado,,,,36,Lisboa e Vale do Tejo,LISBOA,1102,7795.93,15412,738,738,562,509,438,947,1509,2247,2985,197.69,38.29,28.82,19.36
16-12-2021,AVEIRO,537,38,682,"[480,960]",Muito Elevado,,,,537,Centro,AVEIRO,0105,19757.57,78734,4520,4004,3050,2250,2103,4353,7403,11407,15927,398.49,80.61,57.73,37.47
16-12-2021,AVIS,12,1,286,"[240,480]",Elevado,,,,12,Alentejo,PORTALEGRE,1203,60596.51,4247,315,225,206,251,273,524,730,955,1270,7.01,2.1,1.58,1.2
16-12-2021,AZAMBUJA,83,6,364,"[240,480]",Elevado,,,,83,Lisboa e Vale do Tejo,LISBOA,1103,26265.65,22716,1322,1171,1070,798,618,1416,2486,3657,4979,86.48,18.96,13.92,9.46
16-12-2021,BAIÃO,61,4,328,"[240,480]",Elevado,,,,61,Norte,PORTO,1302,17452.83,18748,1070,862,714,686,725,1411,2125,2987,4057,107.42,23.25,17.11,12.18
16-12-2021,BARCELOS,501,36,431,"[240,480]",Elevado,,,,501,Norte,BRAGA,0302,37890.14,116187,6721,5325,3619,2991,2562,5553,9172,14497,21218,306.64,56.0,38.26,24.21
16-12-2021,BARRANCOS,19,1,1171,"[960,Max]",Extremamente Elevado,,,,19,Alentejo,BEJA,0204,16841.73,1634,90,65,65,94,61,155,220,285,375,9.7,2.23,1.69,1.31
16-12-2021,BARREIRO,368,26,490,"[480,960]",Muito Elevado,,,,368,Lisboa e Vale do Tejo,SETÚBAL,1504,3639.07,75147,5194,5565,4459,3105,1767,4872,9331,14896,20090,2065.05,552.07,409.34,256.42
16-12-2021,BATALHA,118,8,742,"[480,960]",Muito Elevado,,,,118,Centro,LEIRIA,1004,10341.6,15963,873,762,649,529,549,1078,1727,2489,3362,154.35,32.51,24.07,16.7
16-12-2021,BEJA,116,8,345,"[240,480]",Elevado,,,,116,Alentejo,BEJA,0205,114647.55,33579,2005,1840,1386,1272,1039,2311,3697,5537,7542,29.29,6.58,4.83,3.22
16-12-2021,BELMONTE,21,2,329,"[240,480]",Elevado,,,,21,Centro,CASTELO BRANCO,0501,11875.91,6398,444,321,325,310,355,665,990,1311,1755,53.87,14.78,11.04,8.34
16-12-2021,BENAVENTE,99,7,322,"[240,480]",Elevado,,,,99,Lisboa e Vale do Tejo,SANTARÉM,1405,52138.39,30602,1468,1376,1141,876,643,1519,2660,4036,5504,58.69,10.56,7.74,5.1
16-12-2021,BOMBARRAL,69,5,552,"[480,960]",Muito Elevado,,,,69,Lisboa e Vale do Tejo,LEIRIA,1005,9128.55,12558,875,714,561,491,429,920,1481,2195,3070,137.56,33.63,24.04,16.22
16-12-2021,BORBA,11,1,165,"[120,240]",Moderado,,,,11,Alentejo,ÉVORA,0703,14518.65,6736,430,375,279,436,392,828,1107,1482,1912,46.39,13.17,10.21,7.62
16-12-2021,BOTICAS,7,1,142,"[120,240]",Moderado,,,,7,Norte,VILA REAL,1702,32195.66,4998,347,306,311,305,380,685,996,1302,1649,15.52,5.12,4.04,3.09
16-12-2021,BRAGA,1328,95,727,"[480,960]",Muito Elevado,,,,1328,Norte,BRAGA,0303,18339.95,182679,10029,7963,5241,4320,3671,7991,13232,21195,31224,996.07,170.25,115.57,72.15
16-12-2021,BRAGANÇA,289,21,861,"[480,960]",Muito Elevado,,,,289,Norte,BRAGANÇA,0402,117357.27,33607,2402,1855,1652,1393,1163,2556,4208,6063,8465,28.64,7.21,5.17,3.59
16-12-2021,CABECEIRAS DE BASTO,94,7,599,"[480,960]",Muito Elevado,,,,94,Norte,BRAGA,0304,24182.16,15628,774,594,544,575,574,1149,1693,2287,3061,64.63,12.66,9.46,7.0
16-12-2021,CADAVAL,41,3,299,"[240,480]",Elevado,,,,41,Lisboa e Vale do Tejo,LISBOA,1104,17489.3,13673,813,796,756,621,625,1246,2002,2798,3611,78.18,20.65,16.0,11.45
16-12-2021,CALDAS DA RAINHA,253,18,488,"[480,960]",Muito Elevado,,,,253,Lisboa e Vale do Tejo,LEIRIA,1006,25569.47,51912,3035,2684,2186,1899,1705,3604,5790,8474,11509,203.03,45.01,33.14,22.64
16-12-2021,CALHETA,16,1,148,"[120,240]",Moderado,,,,16,Madeira,MADEIRA,3101,11150.43,10867,576,497,507,399,415,814,1321,1818,2394,97.46,21.47,16.3,11.85
16-12-2021,CALHETA (AÇORES),1,0,32,"[0,120]",Baixo a Moderado,,,,1,Açores,AÇORES,4501,12626.4,3184,215,159,141,139,122,261,402,561,776,25.22,6.15,4.44,3.18
16-12-2021,CÂMARA DE LOBOS,289,21,859,"[480,960]",Muito Elevado,,,,289,Madeira,MADEIRA,3102,5216.67,33675,1396,1059,834,545,381,926,1760,2819,4215,645.49,80.79,54.03,33.74
16-12-2021,CAMINHA,27,2,171,"[120,240]",Moderado,,,,27,Norte,VIANA DO CASTELO,1602,13652.14,15877,1046,944,818,646,656,1302,2120,3064,4110,116.3,30.11,22.44,15.53
16-12-2021,CAMPO MAIOR,58,4,732,"[480,960]",Muito Elevado,,,,58,Alentejo,PORTALEGRE,1204,24720.16,7874,471,364,351,279,327,606,957,1321,1792,31.85,7.25,5.34,3.87
16-12-2021,CANTANHEDE,245,18,700,"[480,960]",Muito Elevado,,,,245,Centro,COIMBRA,0602,39088.02,35011,2346,2096,1880,1709,1451,3160,5040,7136,9482,89.57,24.26,18.26,12.89
16-12-2021,CARRAZEDA DE ANSIÃES,23,2,410,"[240,480]",Elevado,,,,23,Norte,BRAGANÇA,0403,27924.09,5666,424,389,391,312,465,777,1168,1557,1981,20.29,7.09,5.58,4.18
16-12-2021,CARREGAL DO SAL,103,7,1106,"[960,Max]",Extremamente Elevado,,,,103,Centro,VISEU,1802,11689.21,9271,587,562,486,462,376,838,1324,1886,2473,79.31,21.16,16.13,11.33
16-12-2021,CARTAXO,157,11,660,"[480,960]",Muito Elevado,,,,157,Lisboa e Vale do Tejo,SANTARÉM,1406,15817.28,23843,1415,1376,1142,861,632,1493,2635,4011,5426,150.74,34.3,25.36,16.66
16-12-2021,CASCAIS,991,71,464,"[240,480]",Elevado,,,,991,Lisboa e Vale do Tejo,LISBOA,1105,9740.17,213608,12151,11444,8680,6469,5248,11717,20397,31841,43992,2193.1,451.66,326.91,209.41
16-12-2021,CASTANHEIRA DE PÊRA,4,0,155,"[120,240]",Moderado,,,,4,Centro,LEIRIA,1007,6677.45,2614,233,195,157,190,187,377,534,729,962,39.15,14.41,10.92,8.0
16-12-2021,CASTELO BRANCO,273,19,525,"[480,960]",Muito Elevado,,,,273,Centro,CASTELO BRANCO,0502,143819.15,51987,3528,3042,2499,2229,2225,4454,6953,9995,13523,36.15,9.4,6.95,4.83
16-12-2021,CASTELO DE PAIVA,83,6,536,"[480,960]",Muito Elevado,,,,83,Norte,AVEIRO,0106,11500.53,15454,881,697,545,420,431,851,1396,2093,2974,134.37,25.86,18.2,12.14
16-12-2021,CASTELO DE VIDE,2,0,69,"[0,120]",Baixo a Moderado,,,,2,Alentejo,PORTALEGRE,1205,26491.24,2919,204,173,179,147,170,317,496,669,873,11.02,3.3,2.53,1.87
16-12-2021,CASTRO DAIRE,91,7,659,"[480,960]",Muito Elevado,,,,91,Centro,VISEU,1803,37904.13,13823,942,857,765,732,773,1505,2270,3127,4069,36.47,10.74,8.25,5.99
16-12-2021,CASTRO MARIM,31,2,500,"[480,960]",Muito Elevado,,,,31,Algarve,FARO,0804,30084.37,6237,370,345,334,322,344,666,1000,1345,1715,20.73,5.7,4.47,3.32
16-12-2021,CASTRO VERDE,17,1,247,"[240,480]",Elevado,,,,17,Alentejo,BEJA,0206,56944.23,6949,437,347,303,275,227,502,805,1152,1589,12.2,2.79,2.02,1.41
16-12-2021,CELORICO DA BEIRA,32,2,461,"[240,480]",Elevado,,,,32,Centro,GUARDA,0903,24721.63,6928,430,416,363,369,535,904,1267,1683,2113,28.02,8.55,6.81,5.12
16-12-2021,CELORICO DE BASTO,87,6,455,"[240,480]",Elevado,,,,87,Norte,BRAGA,0305,18107.02,19040,1001,802,668,728,729,1457,2125,2927,3928,105.15,21.69,16.17,11.74
16-12-2021,CHAMUSCA,38,3,408,"[240,480]",Elevado,,,,38,Lisboa e Vale do Tejo,SANTARÉM,1407,74600.54,9197,629,583,553,465,579,1044,1597,2180,2809,12.33,3.77,2.92,2.14
16-12-2021,CHAVES,212,15,538,"[480,960]",Muito Elevado,,,,212,Norte,VILA REAL,1703,59122.95,39343,2676,2429,1991,1886,1918,3804,5795,8224,10900,66.54,18.44,13.91,9.8
16-12-2021,CINFÃES,56,4,306,"[240,480]",Elevado,,,,56,Norte,VISEU,1804,23928.76,18244,1067,902,779,734,758,1492,2271,3173,4240,76.24,17.72,13.26,9.49
16-12-2021,COIMBRA,1161,83,865,"[480,960]",Muito Elevado,,,,1161,Centro,COIMBRA,0603,31939.94,134166,9489,8734,6353,5139,5074,10213,16566,25300,34789,420.06,108.92,79.21,51.87
16-12-2021,CONDEIXA-A-NOVA,270,19,1520,"[960,Max]",Extremamente Elevado,,,,270,Centro,COIMBRA,0604,13867.47,17733,871,809,717,583,490,1073,1790,2599,3470,127.88,25.02,18.74,12.91
16-12-2021,CONSTÂNCIA,24,2,592,"[480,960]",Muito Elevado,,,,24,Lisboa e Vale do Tejo,SANTARÉM,1408,8036.58,4030,211,183,187,148,155,303,490,673,884,50.14,11.0,8.37,6.1
16-12-2021,CORUCHE,43,3,244,"[240,480]",Elevado,,,,43,Lisboa e Vale do Tejo,SANTARÉM,1409,111572.03,17471,1294,1090,1095,1096,1019,2115,3210,4300,5594,15.66,5.01,3.85,2.88
16-12-2021,CORVO,2,0,426,"[240,480]",Elevado,,,,2,Açores,AÇORES,4901,1711.45,464,22,21,11,13,19,32,43,64,86,27.12,5.03,3.74,2.51
16-12-2021,COVILHÃ,565,40,1208,"[960,Max]",Extremamente Elevado,,,,565,Centro,CASTELO BRANCO,0503,55560.06,46787,3533,2998,2365,2111,2193,4304,6669,9667,13200,84.21,23.76,17.4,12.0
16-12-2021,CRATO,6,0,196,"[120,240]",Moderado,,,,6,Alentejo,PORTALEGRE,1206,39806.88,3129,229,258,163,182,228,410,573,831,1060,7.86,2.66,2.09,1.44
16-12-2021,CUBA,7,1,154,"[120,240]",Moderado,,,,7,Alentejo,BEJA,0207,17208.72,4595,255,233,206,190,143,333,539,772,1027,26.7,5.97,4.49,3.13
16-12-2021,ELVAS,106,8,518,"[480,960]",Muito Elevado,,,,106,Alentejo,PORTALEGRE,1207,63128.86,20528,1057,1145,902,852,810,1662,2564,3709,4766,32.52,7.55,5.88,4.06
16-12-2021,ENTRONCAMENTO,150,11,698,"[480,960]",Muito Elevado,,,,150,Lisboa e Vale do Tejo,SANTARÉM,1410,1372.81,21558,1066,930,868,695,592,1287,2155,3085,4151,1570.14,302.33,224.69,156.96
16-12-2021,ESPINHO,159,11,540,"[480,960]",Muito Elevado,,,,159,Norte,AVEIRO,0107,2105.68,29516,2205,1993,1430,1177,960,2137,3567,5560,7765,1401.52,368.71,264.01,169.37
16-12-2021,ESPOSENDE,181,13,530,"[480,960]",Muito Elevado,,,,181,Norte,BRAGA,0306,9540.98,34177,1831,1522,1095,894,723,1617,2712,4234,6065,358.21,63.57,44.38,28.42
16-12-2021,ESTARREJA,123,9,474,"[240,480]",Elevado,,,,123,Centro,AVEIRO,0108,10817.33,26006,1503,1399,1106,953,728,1681,2787,4186,5689,240.42,52.59,38.7,25.76
16-12-2021,ESTREMOZ,27,2,214,"[120,240]",Moderado,,,,27,Alentejo,ÉVORA,0704,51379.95,12728,789,613,697,786,877,1663,2360,2973,3762,24.77,7.32,5.79,4.59
16-12-2021,ÉVORA,249,18,474,"[240,480]",Elevado,,,,249,Alentejo,ÉVORA,0705,130707.58,52428,3569,2852,2176,1966,1803,3769,5945,8797,12366,40.11,9.46,6.73,4.55
16-12-2021,FAFE,301,21,626,"[480,960]",Muito Elevado,,,,301,Norte,BRAGA,0307,21908.11,48060,3044,2455,1679,1403,1208,2611,4290,6745,9789,219.37,44.68,30.79,19.58
16-12-2021,FARO,711,51,1166,"[960,Max]",Extremamente Elevado,,,,711,Algarve,FARO,0805,20256.79,61015,3847,3364,2604,2055,1601,3656,6260,9624,13471,301.2,66.5,47.51,30.9
16-12-2021,FELGUEIRAS,207,15,367,"[240,480]",Elevado,,,,207,Norte,PORTO,1303,11573.75,56422,2951,2302,1601,1316,973,2289,3890,6192,9143,487.49,79.0,53.5,33.61
16-12-2021,FERREIRA DO ALENTEJO,10,1,128,"[120,240]",Moderado,,,,10,Alentejo,BEJA,0208,64820.68,7845,515,414,372,343,345,688,1060,1474,1989,12.1,3.07,2.27,1.64
16-12-2021,FERREIRA DO ZÊZERE,106,8,1333,"[960,Max]",Extremamente Elevado,,,,106,Lisboa e Vale do Tejo,SANTARÉM,1411,19038.03,7959,470,370,416,465,456,921,1337,1707,2177,41.81,11.44,8.97,7.02
16-12-2021,FIGUEIRA DA FOZ,558,40,950,"[480,960]",Muito Elevado,,,,558,Centro,COIMBRA,0605,37905.26,58747,4032,3597,2887,2495,2043,4538,7425,11022,15054,154.98,39.72,29.08,19.59
16-12-2021,FIGUEIRA DE CASTELO RODRIGO,9,1,161,"[120,240]",Moderado,,,,9,Centro,GUARDA,0904,50857.46,5584,347,352,290,352,391,743,1033,1385,1732,10.98,3.41,2.72,2.03
16-12-2021,FIGUEIRÓ DOS VINHOS,16,1,288,"[240,480]",Elevado,,,,16,Centro,LEIRIA,1008,17344.0,5568,402,386,322,309,351,660,982,1368,1770,32.1,10.21,7.89,5.66
16-12-2021,FORNOS DE ALGODRES,33,2,727,"[480,960]",Muito Elevado,,,,33,Centro,GUARDA,0905,13145.05,4528,261,218,247,256,232,488,735,953,1214,34.45,9.24,7.25,5.59
16-12-2021,FREIXO DE ESPADA À CINTA,0,0,0,"[0,120]",Baixo a Moderado,,,,0,Norte,BRAGANÇA,0404,24414.29,3298,211,177,231,196,189,385,616,793,1004,13.51,4.11,3.25,2.52
16-12-2021,FRONTEIRA,10,1,341,"[240,480]",Elevado,,,,10,Alentejo,PORTALEGRE,1208,24859.58,2974,213,182,149,156,168,324,473,655,868,11.96,3.49,2.63,1.9
16-12-2021,FUNCHAL,738,53,709,"[480,960]",Muito Elevado,,,,738,Madeira,MADEIRA,3103,7616.2,104024,6382,5086,3643,2821,1990,4811,8454,13540,19922,1365.86,261.58,177.78,111.0
16-12-2021,FUNDÃO,210,15,794,"[480,960]",Muito Elevado,,,,210,Centro,CASTELO BRANCO,0504,70019.79,26495,1781,1464,1432,1357,1643,3000,4432,5896,7677,37.84,10.96,8.42,6.33
16-12-2021,GAVIÃO,9,1,283,"[240,480]",Elevado,,,,9,Alentejo,PORTALEGRE,1209,29459.45,3263,189,186,222,263,293,556,778,964,1153,11.08,3.91,3.27,2.64
16-12-2021,GÓIS,8,1,212,"[120,240]",Moderado,,,,8,Centro,COIMBRA,0606,26330.19,3805,235,199,240,233,244,477,717,916,1151,14.45,4.37,3.48,2.72
16-12-2021,GOLEGÃ,39,3,737,"[480,960]",Muito Elevado,,,,39,Lisboa e Vale do Tejo,SANTARÉM,1412,8431.67,5339,356,299,281,243,255,498,779,1078,1434,63.32,17.01,12.78,9.24
16-12-2021,GONDOMAR,788,56,475,"[240,480]",Elevado,,,,788,Norte,PORTO,1304,13191.76,165985,10555,8755,6222,4450,3364,7814,14036,22791,33346,1258.22,252.77,172.76,106.4
16-12-2021,GOUVEIA,172,12,1392,"[960,Max]",Extremamente Elevado,,,,172,Centro,GUARDA,0906,30061.17,12387,871,931,780,783,810,1593,2373,3304,4175,41.21,13.89,10.99,7.89
16-12-2021,GRÂNDOLA,23,2,157,"[120,240]",Moderado,,,,23,Alentejo,SETÚBAL,1505,82593.66,14639,834,834,708,688,672,1360,2068,2902,3736,17.72,4.52,3.51,2.5
16-12-2021,GUARDA,553,39,1418,"[960,Max]",Extremamente Elevado,,,,553,Centro,GUARDA,0907,71209.58,38969,2477,2041,1686,1415,1474,2889,4575,6616,9093,54.72,12.77,9.29,6.42
16-12-2021,GUIMARÃES,487,35,320,"[240,480]",Elevado,,,,487,Norte,BRAGA,0308,24099.96,152309,9394,7074,4809,3877,2948,6825,11634,18708,28102,631.99,116.61,77.63,48.27
16-12-2021,HORTA,10,1,69,"[0,120]",Baixo a Moderado,,,,10,Açores,AÇORES,4701,17305.53,14521,818,658,468,352,302,654,1122,1780,2598,83.91,15.01,10.29,6.48
16-12-2021,IDANHA-A-NOVA,43,3,530,"[480,960]",Muito Elevado,,,,43,Centro,CASTELO BRANCO,0505,141633.51,8043,518,490,519,672,974,1646,2165,2655,3173,5.68,2.24,1.87,1.53
16-12-2021,ÍLHAVO,330,24,853,"[480,960]",Muito Elevado,,,,330,Centro,AVEIRO,0110,7347.55,38699,2227,1943,1444,1193,850,2043,3487,5430,7657,526.66,104.21,73.9,47.46
16-12-2021,LAGOA (FARO),284,20,1249,"[960,Max]",Extremamente Elevado,,,,284,Algarve,FARO,0806,8825.45,22762,1314,1168,919,749,670,1419,2338,3506,4820,257.93,54.62,39.73,26.49
16-12-2021,LAGOA,54,4,366,"[240,480]",Elevado,,,,54,Açores,AÇORES,4201,4559.32,14721,536,458,349,238,235,473,822,1280,1816,322.9,39.83,28.08,18.03
16-12-2021,LAGOS,274,20,902,"[480,960]",Muito Elevado,,,,274,Algarve,FARO,0807,21299.27,30374,1744,1434,1247,1053,1029,2082,3329,4763,6507,142.61,30.55,22.36,15.63
16-12-2021,LAJES DAS FLORES,2,0,137,"[120,240]",Moderado,,,,2,Açores,AÇORES,4801,7004.79,1463,88,53,62,46,54,100,162,215,303,20.89,4.33,3.07,2.31
16-12-2021,LAJES DO PICO,2,0,45,"[0,120]",Baixo a Moderado,,,,2,Açores,AÇORES,4601,15531.09,4490,304,231,223,159,162,321,544,775,1079,28.91,6.95,4.99,3.5
16-12-2021,LAMEGO,55,4,222,"[120,240]",Moderado,,,,55,Norte,VISEU,1805,16542.11,24895,1639,1284,1124,898,783,1681,2805,4089,5728,150.5,34.63,24.72,16.96
16-12-2021,LEIRIA,985,70,786,"[480,960]",Muito Elevado,,,,985,Centro,LEIRIA,1009,56508.83,125267,7389,6366,5090,3902,3159,7061,12151,18517,25906,221.68,45.84,32.77,21.5
16-12-2021,LISBOA,3271,234,642,"[480,960]",Muito Elevado,,,,3271,Lisboa e Vale do Tejo,LISBOA,1106,10005.43,509515,33197,33340,27706,23037,26770,49807,77513,110853,144050,5092.6,1439.78,1107.98,774.74
16-12-2021,LOULÉ,663,47,965,"[960,Max]",Extremamente Elevado,,,,663,Algarve,FARO,0808,76366.91,68697,3890,3350,2780,2358,2251,4609,7389,10739,14629,89.96,19.16,14.06,9.68
16-12-2021,LOURES,686,49,321,"[240,480]",Elevado,,,,686,Lisboa e Vale do Tejo,LISBOA,1107,16723.99,213687,12746,12794,9644,6669,5033,11702,21346,34140,46886,1277.73,280.35,204.14,127.64
16-12-2021,LOURINHÃ,150,11,581,"[480,960]",Muito Elevado,,,,150,Lisboa e Vale do Tejo,LISBOA,1108,14717.2,25855,1584,1243,992,842,645,1487,2479,3722,5306,175.68,36.05,25.29,16.84
16-12-2021,LOUSÃ,121,9,706,"[480,960]",Muito Elevado,,,,121,Centro,COIMBRA,0607,13840.01,17158,946,866,658,528,450,978,1636,2502,3448,123.97,24.91,18.08,11.82
16-12-2021,LOUSADA,118,8,253,"[240,480]",Elevado,,,,118,Norte,PORTO,1305,9608.01,46755,2289,1698,1176,853,621,1474,2650,4348,6637,486.63,69.08,45.25,27.58
16-12-2021,MAÇÃO,25,2,404,"[240,480]",Elevado,,,,25,Lisboa e Vale do Tejo,SANTARÉM,1413,39997.98,6267,386,362,390,440,657,1097,1487,1849,2235,15.67,5.59,4.62,3.72
16-12-2021,MACEDO DE CAVALEIROS,23,2,160,"[120,240]",Moderado,,,,23,Norte,BRAGANÇA,0405,69914.08,14516,1082,889,878,823,938,1761,2639,3528,4610,20.76,6.59,5.05,3.77
16-12-2021,MACHICO,155,11,775,"[480,960]",Muito Elevado,,,,155,Madeira,MADEIRA,3104,6825.1,19981,1197,860,662,455,331,786,1448,2308,3505,292.76,51.36,33.82,21.22
16-12-2021,MADALENA,6,0,102,"[0,120]",Baixo a Moderado,,,,6,Açores,AÇORES,4602,14712.33,5895,334,256,173,190,179,369,542,798,1132,40.07,7.69,5.42,3.68
16-12-2021,MAFRA,422,30,497,"[480,960]",Muito Elevado,,,,422,Lisboa e Vale do Tejo,LISBOA,1109,29165.5,84816,3613,3334,2839,2089,1899,3988,6827,10161,13774,290.81,47.23,34.84,23.41
16-12-2021,MAIA,770,55,554,"[480,960]",Muito Elevado,,,,770,Norte,PORTO,1306,8293.94,138971,7801,6617,4512,3339,2631,5970,10482,17099,24900,1675.56,300.22,206.16,126.38
16-12-2021,MANGUALDE,132,9,712,"[480,960]",Muito Elevado,,,,132,Centro,VISEU,1806,21925.56,18510,1198,1128,885,852,743,1595,2480,3608,4806,84.42,21.92,16.46,11.31
16-12-2021,MANTEIGAS,10,1,335,"[240,480]",Elevado,,,,10,Centro,GUARDA,0908,12197.55,3007,258,197,159,167,146,313,472,669,927,24.65,7.6,5.48,3.87
16-12-2021,MARCO DE CANAVESES,171,12,332,"[240,480]",Elevado,,,,171,Norte,PORTO,1307,20188.98,51496,2678,2060,1488,1265,1023,2288,3776,5836,8514,255.07,42.17,28.91,18.7
16-12-2021,MARINHA GRANDE,316,23,821,"[480,960]",Muito Elevado,,,,316,Centro,LEIRIA,1010,18725.19,38508,2365,2302,1638,1359,1058,2417,4055,6357,8722,205.65,46.58,33.95,21.66
16-12-2021,MARVÃO,1,0,34,"[0,120]",Baixo a Moderado,,,,1,Alentejo,PORTALEGRE,1210,15489.9,3005,198,185,142,197,237,434,576,761,959,19.4,6.19,4.91,3.72
16-12-2021,MATOSINHOS,1064,76,607,"[480,960]",Muito Elevado,,,,1064,Norte,PORTO,1308,6241.97,175357,11850,9977,7023,5024,3884,8908,15931,25908,37758,2809.31,604.9,415.06,255.22
16-12-2021,MEALHADA,190,14,954,"[480,960]",Muito Elevado,,,,190,Centro,AVEIRO,0111,11065.66,19914,1163,1039,810,828,831,1659,2469,3508,4671,179.96,42.21,31.7,22.31
16-12-2021,MÊDA,24,2,525,"[480,960]",Muito Elevado,,,,24,Centro,GUARDA,0909,28604.92,4587,343,306,290,288,443,731,1021,1327,1670,16.04,5.84,4.64,3.57
16-12-2021,MELGAÇO,13,1,163,"[120,240]",Moderado,,,,13,Norte,VIANA DO CASTELO,1603,23824.58,8093,507,567,578,614,675,1289,1867,2434,2941,33.97,12.34,10.22,7.84
16-12-2021,MÉRTOLA,10,1,165,"[120,240]",Moderado,,,,10,Alentejo,BEJA,0209,129287.34,6142,400,390,378,423,600,1023,1401,1791,2191,4.75,1.69,1.39,1.08
16-12-2021,MESÃO FRIO,4,0,102,"[0,120]",Baixo a Moderado,,,,4,Norte,VILA REAL,1704,2664.87,3964,265,205,168,157,120,277,445,650,915,148.74,34.33,24.39,16.7
16-12-2021,MIRA,116,8,977,"[960,Max]",Extremamente Elevado,,,,116,Centro,COIMBRA,0608,12403.38,11832,727,729,659,550,466,1016,1675,2404,3131,95.4,25.24,19.38,13.5
16-12-2021,MIRANDA DO CORVO,113,8,889,"[480,960]",Muito Elevado,,,,113,Centro,COIMBRA,0609,12637.79,12708,706,659,568,498,404,902,1470,2129,2835,100.55,22.43,16.85,11.63
16-12-2021,MIRANDA DO DOURO,16,1,237,"[120,240]",Moderado,,,,16,Norte,BRAGANÇA,0406,48718.31,6830,482,429,442,463,470,933,1375,1804,2286,14.02,4.69,3.7,2.82
16-12-2021,MIRANDELA,86,6,394,"[240,480]",Elevado,,,,86,Norte,BRAGANÇA,0407,65895.67,21754,1640,1315,1204,1078,947,2025,3229,4544,6184,33.01,9.38,6.9,4.9
16-12-2021,MOGADOURO,7,1,84,"[0,120]",Baixo a Moderado,,,,7,Norte,BRAGANÇA,0408,76064.93,8392,589,529,576,630,655,1285,1861,2390,2979,11.03,3.92,3.14,2.45
16-12-2021,MOIMENTA DA BEIRA,74,5,762,"[480,960]",Muito Elevado,,,,74,Norte,VISEU,1807,21996.9,9736,576,514,471,416,461,877,1348,1862,2438,44.26,11.08,8.46,6.13
16-12-2021,MOITA,299,21,464,"[240,480]",Elevado,,,,299,Lisboa e Vale do Tejo,SETÚBAL,1506,5525.98,64407,4226,3646,2623,1801,1425,3226,5849,9495,13721,1165.53,248.3,171.82,105.85
16-12-2021,MONÇÃO,98,7,547,"[480,960]",Muito Elevado,,,,98,Norte,VIANA DO CASTELO,1604,21130.85,17869,1161,1105,1031,1006,972,1978,3009,4114,5275,84.56,24.96,19.47,14.24
16-12-2021,MONCHIQUE,44,3,864,"[480,960]",Muito Elevado,,,,44,Algarve,FARO,0809,39530.43,5077,353,384,321,355,392,747,1068,1452,1805,12.84,4.57,3.67,2.7
16-12-2021,MONDIM DE BASTO,50,4,727,"[480,960]",Muito Elevado,,,,50,Norte,VILA REAL,1705,17207.52,6946,395,300,314,284,283,567,881,1181,1576,40.36,9.16,6.86,5.12
16-12-2021,MONFORTE,2,0,68,"[0,120]",Baixo a Moderado,,,,2,Alentejo,PORTALEGRE,1211,42024.82,2975,139,115,117,192,168,360,477,592,731,7.08,1.74,1.41,1.14
16-12-2021,MONTALEGRE,27,2,304,"[240,480]",Elevado,,,,27,Norte,VILA REAL,1706,80545.71,8997,699,628,595,603,730,1333,1928,2556,3255,11.17,4.04,3.17,2.39
16-12-2021,MONTEMOR-O-NOVO,16,1,104,"[0,120]",Baixo a Moderado,,,,16,Alentejo,ÉVORA,0706,123296.65,15647,991,953,868,878,971,1849,2717,3670,4661,12.69,3.78,2.98,2.2
16-12-2021,MONTEMOR-O-VELHO,189,14,751,"[480,960]",Muito Elevado,,,,189,Centro,COIMBRA,0610,22896.23,25224,1496,1397,1217,1057,988,2045,3262,4659,6155,110.17,26.88,20.35,14.25
16-12-2021,MONTIJO,199,14,346,"[240,480]",Elevado,,,,199,Lisboa e Vale do Tejo,SETÚBAL,1507,34861.64,57614,2771,2441,1990,1554,1109,2663,4653,7094,9865,165.26,28.3,20.35,13.35
16-12-2021,MORA,4,0,99,"[0,120]",Baixo a Moderado,,,,4,Alentejo,ÉVORA,0707,44395.02,4138,336,275,252,238,257,495,747,1022,1358,9.32,3.06,2.3,1.68
16-12-2021,MORTÁGUA,28,2,318,"[240,480]",Elevado,,,,28,Centro,VISEU,1808,25117.82,8803,638,584,535,499,460,959,1494,2078,2716,35.05,10.81,8.27,5.95
16-12-2021,MOURA,29,2,213,"[120,240]",Moderado,,,,29,Alentejo,BEJA,0210,95845.55,13718,817,656,665,542,461,1003,1668,2324,3141,14.31,3.28,2.42,1.74
16-12-2021,MOURÃO,3,0,123,"[120,240]",Moderado,,,,3,Alentejo,ÉVORA,0708,27862.98,2450,139,108,80,104,109,213,293,401,540,8.79,1.94,1.44,1.05
16-12-2021,MURÇA,13,1,241,"[240,480]",Elevado,,,,13,Norte,VILA REAL,1707,18937.11,5463,384,341,307,306,319,625,932,1273,1657,28.85,8.75,6.72,4.92
16-12-2021,MURTOSA,47,3,461,"[240,480]",Elevado,,,,47,Centro,AVEIRO,0112,7308.78,10279,509,473,403,353,409,762,1165,1638,2147,140.63,29.37,22.41,15.94
16-12-2021,NAZARÉ,83,6,589,"[480,960]",Muito Elevado,,,,83,Lisboa e Vale do Tejo,LEIRIA,1011,8243.43,14165,967,903,670,420,396,816,1486,2389,3356,171.84,40.71,28.98,18.03
16-12-2021,NELAS,67,5,516,"[480,960]",Muito Elevado,,,,67,Centro,VISEU,1809,12571.48,12974,924,787,668,604,583,1187,1855,2642,3566,103.21,28.37,21.02,14.76
16-12-2021,NISA,47,3,772,"[480,960]",Muito Elevado,,,,47,Alentejo,PORTALEGRE,1212,57567.84,6061,405,389,355,483,478,961,1316,1705,2110,10.53,3.67,2.96,2.29
16-12-2021,NORDESTE,2,0,42,"[0,120]",Baixo a Moderado,,,,2,Açores,AÇORES,4202,10146.8,4862,246,180,124,161,162,323,447,627,873,47.92,8.6,6.18,4.41
16-12-2021,ÓBIDOS,61,4,516,"[480,960]",Muito Elevado,,,,61,Lisboa e Vale do Tejo,LEIRIA,1012,14155.44,11850,743,650,574,452,436,888,1462,2112,2855,83.72,20.17,14.92,10.33
16-12-2021,ODEMIRA,51,4,207,"[120,240]",Moderado,,,,51,Alentejo,BEJA,0211,172060.15,24717,1475,1317,1225,1397,1349,2746,3971,5288,6763,14.37,3.93,3.07,2.31
16-12-2021,ODIVELAS,537,38,332,"[240,480]",Elevado,,,,537,Lisboa e Vale do Tejo,LISBOA,1116,2654.36,161774,9562,9038,6952,4641,3812,8453,15405,24443,34005,6095.48,1281.27,920.99,580.44
16-12-2021,OEIRAS,1063,76,599,"[480,960]",Muito Elevado,,,,1063,Lisboa e Vale do Tejo,LISBOA,1110,4588.31,177408,11580,11575,8566,6211,5855,12066,20632,32207,43787,3866.78,954.38,701.98,449.69
16-12-2021,OLEIROS,5,0,100,"[0,120]",Baixo a Moderado,,,,5,Centro,CASTELO BRANCO,0506,47109.31,5003,384,341,366,397,487,884,1250,1591,1975,10.62,4.19,3.38,2.65
16-12-2021,OLHÃO,411,29,926,"[480,960]",Muito Elevado,,,,411,Algarve,FARO,0810,13086.38,44405,2455,2309,1689,1342,1268,2610,4299,6608,9063,339.33,69.26,50.5,32.85
16-12-2021,OLIVEIRA DE AZEMÉIS,498,36,754,"[480,960]",Muito Elevado,,,,498,Norte,AVEIRO,0113,16110.41,66011,4155,3614,2794,2183,1738,3921,6715,10329,14484,409.75,89.91,64.12,41.68
16-12-2021,OLIVEIRA DE FRADES,53,4,531,"[480,960]",Muito Elevado,,,,53,Centro,VISEU,1810,14534.62,9936,553,475,438,359,415,774,1212,1687,2240,68.36,15.41,11.61,8.34
16-12-2021,OLIVEIRA DO BAIRRO,207,15,854,"[480,960]",Muito Elevado,,,,207,Centro,AVEIRO,0114,8731.99,24277,1327,1182,999,786,810,1596,2595,3777,5104,278.02,58.45,43.25,29.72
16-12-2021,OLIVEIRA DO HOSPITAL,77,6,400,"[240,480]",Elevado,,,,77,Centro,COIMBRA,0611,23451.66,19253,1161,1097,962,924,960,1884,2846,3943,5104,82.1,21.76,16.81,12.14
16-12-2021,OURÉM,465,33,1055,"[960,Max]",Extremamente Elevado,,,,465,Lisboa e Vale do Tejo,SANTARÉM,1421,41668.03,44044,2463,2069,1899,1817,1603,3420,5319,7388,9851,105.7,23.64,17.73,12.77
16-12-2021,OURIQUE,17,1,374,"[240,480]",Elevado,,,,17,Alentejo,BEJA,0212,66331.36,4607,313,287,284,268,227,495,779,1066,1379,6.95,2.08,1.61,1.17
16-12-2021,OVAR,308,22,567,"[480,960]",Muito Elevado,,,,308,Centro,AVEIRO,0115,14770.25,54260,3294,2709,1994,1636,1234,2870,4864,7573,10867,367.37,73.57,51.27,32.93
16-12-2021,PAÇOS DE FERREIRA,70,5,124,"[120,240]",Moderado,,,,70,Norte,PORTO,1309,7099.29,56728,2903,2193,1518,1135,664,1799,3317,5510,8413,799.1,118.51,77.62,46.72
16-12-2021,PALMELA,206,15,321,"[240,480]",Elevado,,,,206,Lisboa e Vale do Tejo,SETÚBAL,1508,46512.01,64269,3402,3244,2635,1846,1391,3237,5872,9116,12518,138.18,26.91,19.6,12.62
16-12-2021,PAMPILHOSA DA SERRA,21,2,521,"[480,960]",Muito Elevado,,,,21,Centro,COIMBRA,0612,39646.24,4037,238,254,295,339,423,762,1057,1311,1549,10.18,3.91,3.31,2.67
16-12-2021,PAREDES,386,28,448,"[240,480]",Elevado,,,,386,Norte,PORTO,1310,15675.69,86067,4272,3532,2412,1717,1258,2975,5387,8919,13191,549.04,84.15,56.9,34.36
16-12-2021,PAREDES DE COURA,17,1,201,"[120,240]",Moderado,,,,17,Norte,VIANA DO CASTELO,1605,13818.59,8535,466,528,407,465,515,980,1387,1915,2381,61.76,17.23,13.86,10.04
16-12-2021,PEDRÓGÃO GRANDE,12,1,351,"[240,480]",Elevado,,,,12,Centro,LEIRIA,1013,12874.75,3410,175,173,196,221,252,473,669,842,1017,26.49,7.9,6.54,5.2
16-12-2021,PENACOVA,79,6,579,"[480,960]",Muito Elevado,,,,79,Centro,COIMBRA,0613,21673.23,13694,968,923,745,621,703,1324,2069,2992,3960,63.18,18.27,13.81,9.55
16-12-2021,PENAFIEL,297,21,426,"[240,480]",Elevado,,,,297,Norte,PORTO,1311,21224.27,69772,3648,2823,2032,1663,1230,2893,4925,7748,11396,328.74,53.69,36.51,23.2
16-12-2021,PENALVA DO CASTELO,41,3,574,"[480,960]",Muito Elevado,,,,41,Centro,VISEU,1811,13433.92,7115,449,457,413,391,426,817,1230,1687,2136,52.96,15.9,12.56,9.16
16-12-2021,PENAMACOR,18,1,381,"[240,480]",Elevado,,,,18,Centro,CASTELO BRANCO,0507,56370.69,4755,262,248,273,451,633,1084,1357,1605,1867,8.44,3.31,2.85,2.41
16-12-2021,PENEDONO,18,1,700,"[480,960]",Muito Elevado,,,,18,Norte,VISEU,1812,13370.75,2591,172,113,129,156,138,294,423,536,708,19.38,5.3,4.01,3.16
16-12-2021,PENELA,32,2,594,"[480,960]",Muito Elevado,,,,32,Centro,COIMBRA,0614,13480.0,5397,314,324,274,359,344,703,977,1301,1615,40.04,11.98,9.65,7.25
16-12-2021,PENICHE,134,10,505,"[480,960]",Muito Elevado,,,,134,Lisboa e Vale do Tejo,LEIRIA,1014,7754.98,26501,1746,1504,1203,926,707,1633,2836,4340,6086,341.73,78.48,55.96,36.57
16-12-2021,PESO DA RÉGUA,36,3,229,"[120,240]",Moderado,,,,36,Norte,VILA REAL,1708,9486.01,15773,1076,843,650,659,455,1114,1764,2607,3683,166.28,38.83,27.48,18.6
16-12-2021,PINHEL,85,6,996,"[960,Max]",Extremamente Elevado,,,,85,Centro,GUARDA,0910,48452.12,8511,577,566,551,538,689,1227,1778,2344,2921,17.57,6.03,4.84,3.67
16-12-2021,POMBAL,453,32,881,"[480,960]",Muito Elevado,,,,453,Centro,LEIRIA,1015,62600.28,51461,3187,2791,2494,2328,2027,4355,6849,9640,12827,82.21,20.49,15.4,10.94
16-12-2021,PONTA DELGADA,167,12,246,"[240,480]",Elevado,,,,167,Açores,AÇORES,4203,23298.65,67935,3108,2435,1726,1133,902,2035,3761,6196,9304,291.58,39.93,26.59,16.14
16-12-2021,PONTA DO SOL,21,2,245,"[240,480]",Elevado,,,,21,Madeira,MADEIRA,3105,4622.03,8593,319,283,347,208,221,429,776,1059,1378,185.92,29.81,22.91,16.79
16-12-2021,PONTE DA BARCA,96,7,856,"[480,960]",Muito Elevado,,,,96,Norte,VIANA DO CASTELO,1606,18211.37,11180,635,576,517,554,490,1044,1561,2137,2772,61.39,15.22,11.73,8.57
16-12-2021,PONTE DE LIMA,167,12,404,"[240,480]",Elevado,,,,167,Norte,VIANA DO CASTELO,1607,32025.46,41315,2321,2022,1720,1596,1462,3058,4778,6800,9121,129.01,28.48,21.23,14.92
16-12-2021,PONTE DE SOR,88,6,586,"[480,960]",Muito Elevado,,,,88,Alentejo,PORTALEGRE,1213,83971.16,14994,939,800,716,739,831,1570,2286,3086,4025,17.86,4.79,3.68,2.72
16-12-2021,PORTALEGRE,37,3,169,"[120,240]",Moderado,,,,37,Alentejo,PORTALEGRE,1214,44713.64,22172,1577,1351,1137,993,984,1977,3114,4465,6042,49.59,13.51,9.99,6.96
16-12-2021,PORTEL,11,1,190,"[120,240]",Moderado,,,,11,Alentejo,ÉVORA,0709,60100.57,5828,336,358,283,331,305,636,919,1277,1613,9.7,2.68,2.12,1.53
16-12-2021,PORTIMÃO,702,50,1266,"[960,Max]",Extremamente Elevado,,,,702,Algarve,FARO,0811,18206.29,55483,3182,2927,2116,1582,1400,2982,5098,8025,11207,304.75,61.56,44.08,28.0
16-12-2021,PORTO,1356,97,626,"[480,960]",Muito Elevado,,,,1356,Norte,PORTO,1312,4142.02,216606,15790,15193,11280,9409,10044,19453,30733,45926,61716,5229.5,1490.0,1108.79,741.98
16-12-2021,PORTO DE MÓS,124,9,532,"[480,960]",Muito Elevado,,,,124,Centro,LEIRIA,1016,26183.41,23275,1355,1210,1034,888,872,1760,2794,4004,5359,88.89,20.47,15.29,10.67
16-12-2021,PORTO MONIZ,5,0,216,"[120,240]",Moderado,,,,5,Madeira,MADEIRA,3106,8293.38,2342,143,130,95,98,120,218,313,443,586,28.24,7.07,5.34,3.77
16-12-2021,PORTO SANTO,27,2,520,"[480,960]",Muito Elevado,,,,27,Madeira,MADEIRA,3201,4300.7,5202,240,157,134,110,68,178,312,469,709,120.95,16.48,10.9,7.25
16-12-2021,PÓVOA DE LANHOSO,114,8,531,"[480,960]",Muito Elevado,,,,114,Norte,BRAGA,0309,13465.29,21499,1175,909,732,673,624,1297,2029,2938,4113,159.67,30.55,21.82,15.07
16-12-2021,PÓVOA DE VARZIM,194,14,309,"[240,480]",Elevado,,,,194,Norte,PORTO,1313,8220.59,62784,3712,3120,2134,1594,1305,2899,5033,8153,11865,763.7,144.33,99.17,61.22
16-12-2021,POVOAÇÃO,19,1,322,"[240,480]",Elevado,,,,19,Açores,AÇORES,4204,10640.77,5927,293,212,191,144,134,278,469,681,974,55.7,9.15,6.4,4.41
16-12-2021,VILA DA PRAIA DA VITÓRIA,10,1,47,"[0,120]",Baixo a Moderado,,,,10,Açores,AÇORES,4302,16127.06,21317,1133,789,619,436,336,772,1391,2180,3313,132.18,20.54,13.52,8.63
16-12-2021,PROENÇA-A-NOVA,24,2,331,"[240,480]",Elevado,,,,24,Centro,CASTELO BRANCO,0508,39539.96,7298,508,465,389,400,560,960,1349,1814,2322,18.46,5.87,4.59,3.41
16-12-2021,REDONDO,14,1,223,"[120,240]",Moderado,,,,14,Alentejo,ÉVORA,0710,36950.87,6353,349,325,288,288,354,642,930,1255,1604,17.19,4.34,3.4,2.52
16-12-2021,REGUENGOS DE MONSARAZ,14,1,141,"[120,240]",Moderado,,,,14,Alentejo,ÉVORA,0711,46399.72,10015,602,511,455,462,473,935,1390,1901,2503,21.58,5.39,4.1,3.0
16-12-2021,RESENDE,76,5,748,"[480,960]",Muito Elevado,,,,76,Norte,VISEU,1813,12334.93,10137,560,493,448,433,422,855,1303,1796,2356,82.18,19.1,14.56,10.56
16-12-2021,RIBEIRA BRAVA,68,5,550,"[480,960]",Muito Elevado,,,,68,Madeira,MADEIRA,3107,6544.88,12435,648,500,411,311,287,598,1009,1509,2157,189.99,32.96,23.06,15.42
16-12-2021,RIBEIRA DE PENA,8,1,134,"[120,240]",Moderado,,,,8,Norte,VILA REAL,1709,21745.98,6016,371,301,290,310,368,678,968,1269,1640,27.66,7.54,5.84,4.45
16-12-2021,RIBEIRA GRANDE,42,3,128,"[120,240]",Moderado,,,,42,Açores,AÇORES,4205,18015.13,32811,1163,689,512,345,253,598,1110,1799,2962,182.13,16.44,9.99,6.16
16-12-2021,RIO MAIOR,52,4,256,"[240,480]",Elevado,,,,52,Lisboa e Vale do Tejo,SANTARÉM,1414,27276.45,20379,1251,1144,941,795,648,1443,2384,3528,4779,74.71,17.52,12.93,8.74
16-12-2021,SABROSA,11,1,187,"[120,240]",Moderado,,,,11,Norte,VILA REAL,1710,15692.45,5918,393,314,304,302,350,652,956,1270,1663,37.71,10.6,8.09,6.09
16-12-2021,SABUGAL,58,4,551,"[480,960]",Muito Elevado,,,,58,Centro,GUARDA,0911,82269.82,10585,724,707,694,796,1009,1805,2499,3206,3930,12.87,4.78,3.9,3.04
16-12-2021,SALVATERRA DE MAGOS,66,5,312,"[240,480]",Elevado,,,,66,Lisboa e Vale do Tejo,SANTARÉM,1415,24393.2,21295,1275,1181,1060,799,772,1571,2631,3812,5087,87.3,20.85,15.63,10.79
16-12-2021,SANTA COMBA DÃO,28,2,268,"[240,480]",Elevado,,,,28,Centro,VISEU,1814,11194.77,10452,732,684,569,538,464,1002,1571,2255,2987,93.36,26.68,20.14,14.03
16-12-2021,SANTA CRUZ,278,20,613,"[480,960]",Muito Elevado,,,,278,Madeira,MADEIRA,3108,8150.28,45281,1817,1301,974,716,523,1239,2213,3514,5331,555.6,65.41,43.12,27.15
16-12-2021,SANTA CRUZ DA GRACIOSA,1,0,24,"[0,120]",Baixo a Moderado,,,,1,Açores,AÇORES,4401,6065.78,4208,228,180,163,124,145,269,432,612,840,69.37,13.85,10.09,7.12
16-12-2021,SANTA CRUZ DAS FLORES,0,0,0,"[0,120]",Baixo a Moderado,,,,0,Açores,AÇORES,4802,7091.44,2165,125,98,74,56,51,107,181,279,404,30.53,5.7,3.93,2.55
16-12-2021,SANTA MARIA DA FEIRA,916,65,661,"[480,960]",Muito Elevado,,,,916,Norte,AVEIRO,0109,21587.65,138636,8182,6743,4771,3856,3079,6935,11706,18449,26631,642.19,123.36,85.46,54.22
16-12-2021,SANTA MARTA DE PENAGUIÃO,6,0,92,"[0,120]",Baixo a Moderado,,,,6,Norte,VILA REAL,1711,6928.13,6599,483,373,337,316,317,633,970,1343,1826,95.25,26.36,19.39,14.0
16-12-2021,SANTANA,17,1,256,"[240,480]",Elevado,,,,17,Madeira,MADEIRA,3109,9547.3,6711,418,353,343,282,277,559,902,1255,1673,70.29,17.52,13.15,9.45
16-12-2021,SANTARÉM,424,30,739,"[480,960]",Muito Elevado,,,,424,Lisboa e Vale do Tejo,SANTARÉM,1416,55253.58,57421,3654,3441,2760,2466,2206,4672,7432,10873,14527,103.92,26.29,19.68,13.45
16-12-2021,SANTIAGO DO CACÉM,76,5,265,"[240,480]",Elevado,,,,76,Alentejo,SETÚBAL,1509,105969.29,28791,2144,1689,1472,1295,1215,2510,3982,5671,7815,27.17,7.37,5.35,3.76
16-12-2021,SANTO TIRSO,193,14,284,"[240,480]",Elevado,,,,193,Norte,PORTO,1314,13655.52,68055,4911,3935,2761,2257,1810,4067,6828,10763,15674,498.35,114.78,78.82,50.0
16-12-2021,SÃO BRÁS DE ALPORTEL,141,10,1350,"[960,Max]",Extremamente Elevado,,,,141,Algarve,FARO,0812,15336.92,10416,596,468,467,404,401,805,1272,1740,2336,67.91,15.23,11.35,8.29
16-12-2021,SÃO JOÃO DA MADEIRA,206,15,938,"[480,960]",Muito Elevado,,,,206,Norte,AVEIRO,0116,794.3,21958,1347,1069,796,601,593,1194,1990,3059,4406,2765.49,554.91,385.26,250.63
16-12-2021,SÃO JOÃO DA PESQUEIRA,29,2,411,"[240,480]",Elevado,,,,29,Norte,VISEU,1815,26610.85,7125,417,330,294,328,328,656,950,1280,1697,26.77,6.38,4.81,3.57
16-12-2021,SÃO PEDRO DO SUL,41,3,266,"[240,480]",Elevado,,,,41,Centro,VISEU,1816,34895.09,15403,990,962,861,759,909,1668,2529,3491,4481,44.14,12.84,10.0,7.25
16-12-2021,SÃO ROQUE DO PICO,2,0,61,"[0,120]",Baixo a Moderado,,,,2,Açores,AÇORES,4603,14236.1,3266,199,141,93,96,113,209,302,443,642,22.94,4.51,3.11,2.12
16-12-2021,SÃO VICENTE,12,1,235,"[120,240]",Moderado,,,,12,Madeira,MADEIRA,3110,7883.71,5143,272,264,266,225,280,505,771,1035,1307,65.23,16.58,13.13,9.78
16-12-2021,SARDOAL,18,1,484,"[480,960]",Muito Elevado,,,,18,Lisboa e Vale do Tejo,SANTARÉM,1417,9214.72,3741,227,178,148,165,248,413,561,739,966,40.6,10.48,8.02,6.09
16-12-2021,SÁTÃO,68,5,584,"[480,960]",Muito Elevado,,,,68,Centro,VISEU,1817,20194.11,11580,765,671,515,465,476,941,1456,2127,2892,57.34,14.32,10.53,7.21
16-12-2021,SEIA,108,8,487,"[480,960]",Muito Elevado,,,,108,Centro,GUARDA,0912,43568.83,22234,1807,1589,1238,1122,721,1843,3081,4670,6477,51.03,14.87,10.72,7.07
16-12-2021,SEIXAL,631,45,376,"[240,480]",Elevado,,,,631,Lisboa e Vale do Tejo,SETÚBAL,1510,9545.17,167752,10586,9270,6661,4391,2930,7321,13982,23252,33838,1757.49,354.51,243.6,146.49
16-12-2021,SERNANCELHE,8,1,149,"[120,240]",Moderado,,,,8,Norte,VISEU,1818,22861.22,5396,305,293,286,273,260,533,819,1112,1417,23.6,6.2,4.86,3.58
16-12-2021,SERPA,59,4,409,"[240,480]",Elevado,,,,59,Alentejo,BEJA,0213,110563.34,14304,903,761,719,697,626,1323,2042,2803,3706,12.94,3.35,2.54,1.85
16-12-2021,SERTÃ,82,6,563,"[480,960]",Muito Elevado,,,,82,Centro,CASTELO BRANCO,0509,44673.17,14577,870,779,790,767,1020,1787,2577,3356,4226,32.63,9.46,7.51,5.77
16-12-2021,SESIMBRA,162,12,312,"[240,480]",Elevado,,,,162,Lisboa e Vale do Tejo,SETÚBAL,1511,19571.75,51858,2400,2321,1853,1257,1083,2340,4193,6514,8914,264.96,45.54,33.28,21.42
16-12-2021,SETÚBAL,433,31,376,"[240,480]",Elevado,,,,433,Lisboa e Vale do Tejo,SETÚBAL,1512,23032.5,115126,7425,6929,5075,3775,2655,6430,11505,18434,25859,499.83,112.27,80.03,49.95
16-12-2021,SEVER DO VOUGA,14,1,124,"[120,240]",Moderado,,,,14,Centro,AVEIRO,0117,12987.56,11331,766,637,568,540,567,1107,1675,2312,3078,87.24,23.7,17.8,12.9
16-12-2021,SILVES,329,23,908,"[480,960]",Muito Elevado,,,,329,Algarve,FARO,0813,68006.23,36226,2137,1869,1610,1423,1600,3023,4633,6502,8639,53.27,12.7,9.56,6.81
16-12-2021,SINES,32,2,233,"[120,240]",Moderado,,,,32,Alentejo,SETÚBAL,1513,20330.17,13715,888,791,551,416,268,684,1235,2026,2914,67.46,14.33,9.97,6.07
16-12-2021,SINTRA,1436,103,367,"[240,480]",Elevado,,,,1436,Lisboa e Vale do Tejo,LISBOA,1111,31922.73,391402,20490,18316,13545,9137,7284,16421,29966,48282,68772,1226.08,215.43,151.25,93.87
16-12-2021,SOBRAL DE MONTE AGRAÇO,56,4,526,"[480,960]",Muito Elevado,,,,56,Lisboa e Vale do Tejo,LISBOA,1112,5210.32,10651,564,507,352,272,212,484,836,1343,1907,204.43,36.6,25.78,16.05
16-12-2021,SOURE,163,12,950,"[480,960]",Muito Elevado,,,,163,Centro,COIMBRA,0615,26506.07,17120,1173,1142,1004,883,987,1870,2874,4016,5189,64.59,19.58,15.15,10.84
16-12-2021,SOUSEL,61,4,1386,"[960,Max]",Extremamente Elevado,,,,61,Alentejo,PORTALEGRE,1215,27932.18,4412,261,274,208,302,292,594,802,1076,1337,15.8,4.79,3.85,2.87
16-12-2021,TÁBUA,38,3,333,"[240,480]",Elevado,,,,38,Centro,COIMBRA,0616,19978.58,11368,729,584,524,430,464,894,1418,2002,2731,56.9,13.67,10.02,7.1
16-12-2021,TABUAÇO,6,0,100,"[0,120]",Baixo a Moderado,,,,6,Norte,VISEU,1819,13385.67,6033,372,314,217,282,363,645,862,1176,1548,45.07,11.56,8.79,6.44
16-12-2021,TAROUCA,21,1,269,"[240,480]",Elevado,,,,21,Norte,VISEU,1820,10008.49,7804,405,335,313,277,324,601,914,1249,1654,77.98,16.53,12.48,9.13
16-12-2021,TAVIRA,196,14,799,"[480,960]",Muito Elevado,,,,196,Algarve,FARO,0814,60696.7,24530,1493,1415,1252,1066,1277,2343,3595,5010,6503,40.41,10.71,8.25,5.92
16-12-2021,TERRAS DE BOURO,23,2,364,"[240,480]",Elevado,,,,23,Norte,BRAGA,0310,27746.07,6361,391,372,296,319,340,659,955,1327,1718,22.93,6.19,4.78,3.44
16-12-2021,TOMAR,404,29,1099,"[960,Max]",Extremamente Elevado,,,,404,Lisboa e Vale do Tejo,SANTARÉM,1418,35120.44,36748,2403,2189,1868,1853,1822,3675,5543,7732,10135,104.64,28.86,22.02,15.78
16-12-2021,TONDELA,152,11,577,"[480,960]",Muito Elevado,,,,152,Centro,VISEU,1821,37121.73,26357,1768,1722,1518,1475,1417,2892,4410,6132,7900,71.0,21.28,16.52,11.88
16-12-2021,TORRE DE MONCORVO,6,0,79,"[0,120]",Baixo a Moderado,,,,6,Norte,BRAGANÇA,0409,53155.67,7695,556,478,488,551,719,1270,1758,2236,2792,14.48,5.25,4.21,3.31
16-12-2021,TORRES NOVAS,266,19,761,"[480,960]",Muito Elevado,,,,266,Lisboa e Vale do Tejo,SANTARÉM,1419,26999.68,34933,2324,1979,1738,1406,1475,2881,4619,6598,8922,129.38,33.04,24.44,17.11
16-12-2021,TORRES VEDRAS,581,42,740,"[480,960]",Muito Elevado,,,,581,Lisboa e Vale do Tejo,LISBOA,1113,40714.89,78530,4513,3945,3447,2628,2104,4732,8179,12124,16637,192.88,40.86,29.78,20.09
16-12-2021,TRANCOSO,11,1,124,"[120,240]",Moderado,,,,11,Centro,GUARDA,0913,36152.47,8875,581,557,542,586,496,1082,1624,2181,2762,24.55,7.64,6.03,4.49
16-12-2021,TROFA,116,8,302,"[240,480]",Elevado,,,,116,Norte,PORTO,1318,7201.76,38418,2336,1894,1231,939,684,1623,2854,4748,7084,533.44,98.36,65.93,39.63
16-12-2021,VAGOS,138,10,609,"[480,960]",Muito Elevado,,,,138,Centro,AVEIRO,0118,16491.5,22740,1320,1205,922,784,724,1508,2430,3635,4955,137.89,30.04,22.04,14.73
16-12-2021,VALE DE CAMBRA,108,8,505,"[480,960]",Muito Elevado,,,,108,Norte,AVEIRO,0119,14733.47,21327,1491,1363,1005,831,798,1629,2634,3997,5488,144.76,37.25,27.13,17.88
16-12-2021,VALENÇA,52,4,394,"[240,480]",Elevado,,,,52,Norte,VIANA DO CASTELO,1608,11712.86,13290,867,791,582,582,503,1085,1667,2458,3325,113.46,28.39,20.99,14.23
16-12-2021,VALONGO,445,32,457,"[240,480]",Elevado,,,,445,Norte,PORTO,1315,7512.45,97444,5629,4696,3207,2462,1829,4291,7498,12194,17823,1297.18,237.26,162.33,99.81
16-12-2021,VALPAÇOS,34,2,232,"[120,240]",Moderado,,,,34,Norte,VILA REAL,1712,54873.93,14818,1217,1118,999,928,997,1925,2924,4042,5259,27.0,9.58,7.37,5.33
16-12-2021,VELAS,1,0,20,"[0,120]",Baixo a Moderado,,,,1,Açores,AÇORES,4502,11738.38,5093,278,208,166,153,113,266,432,640,918,43.39,7.82,5.45,3.68
16-12-2021,VENDAS NOVAS,13,1,116,"[0,120]",Baixo a Moderado,,,,13,Alentejo,ÉVORA,0712,22238.88,11255,677,768,655,501,532,1033,1688,2456,3133,50.61,14.09,11.04,7.59
16-12-2021,VIANA DO ALENTEJO,7,1,137,"[120,240]",Moderado,,,,7,Alentejo,ÉVORA,0713,39367.29,5145,245,208,235,210,214,424,659,867,1112,13.07,2.82,2.2,1.67
16-12-2021,VIANA DO CASTELO,313,22,371,"[240,480]",Elevado,,,,313,Norte,VIANA DO CASTELO,1609,31902.01,84417,5470,4433,3591,3061,2982,6043,9634,14067,19537,264.61,61.24,44.09,30.2
16-12-2021,VIDIGUEIRA,9,1,164,"[120,240]",Moderado,,,,9,Alentejo,BEJA,0214,31661.09,5510,300,248,215,233,275,508,723,971,1271,17.4,4.01,3.07,2.28
16-12-2021,VIEIRA DO MINHO,27,2,229,"[120,240]",Moderado,,,,27,Norte,BRAGA,0311,21644.35,11842,703,594,525,548,482,1030,1555,2149,2852,54.71,13.18,9.93,7.18
16-12-2021,VILA DE REI,7,0,210,"[120,240]",Moderado,,,,7,Centro,CASTELO BRANCO,0510,19154.6,3323,169,128,172,247,302,549,721,849,1018,17.35,5.31,4.43,3.76
16-12-2021,VILA DO BISPO,45,3,874,"[480,960]",Muito Elevado,,,,45,Algarve,FARO,0815,17906.06,5154,302,302,314,232,233,465,779,1081,1383,28.78,7.72,6.04,4.35
16-12-2021,VILA DO CONDE,294,21,368,"[240,480]",Elevado,,,,294,Norte,PORTO,1316,14902.77,79899,4726,3875,2819,2070,1743,3813,6632,10507,15233,536.13,102.21,70.5,44.5
16-12-2021,VILA DO PORTO,6,0,107,"[0,120]",Baixo a Moderado,,,,6,Açores,AÇORES,4101,9688.74,5616,274,212,135,96,123,219,354,566,840,57.96,8.67,5.84,3.65
16-12-2021,VILA FLOR,13,1,216,"[120,240]",Moderado,,,,13,Norte,BRAGANÇA,0410,26581.14,6044,429,362,422,294,331,625,1047,1409,1838,22.74,6.91,5.3,3.94
16-12-2021,VILA FRANCA DE XIRA,671,48,473,"[240,480]",Elevado,,,,671,Lisboa e Vale do Tejo,LISBOA,1114,31819.39,141957,8501,6852,4869,3425,2472,5897,10766,17618,26119,446.14,82.09,55.37,33.84
16-12-2021,VILA FRANCA DO CAMPO,8,1,73,"[0,120]",Baixo a Moderado,,,,8,Açores,AÇORES,4206,7796.82,11051,450,344,248,217,154,371,619,963,1413,141.73,18.12,12.35,7.94
16-12-2021,VILA NOVA DA BARQUINHA,23,2,305,"[240,480]",Elevado,,,,23,Lisboa e Vale do Tejo,SANTARÉM,1420,4952.97,7461,415,406,392,364,338,702,1094,1500,1915,150.64,38.66,30.28,22.09
16-12-2021,VILA NOVA DE CERVEIRA,21,2,236,"[120,240]",Moderado,,,,21,Norte,VIANA DO CASTELO,1610,10846.66,8910,531,444,410,384,334,718,1128,1572,2103,82.14,19.39,14.49,10.4
16-12-2021,VILA NOVA DE FAMALICÃO,557,40,423,"[240,480]",Elevado,,,,557,Norte,BRAGA,0312,20159.26,131676,7817,6164,4202,3282,2749,6031,10233,16397,24214,653.19,120.12,81.34,50.76
16-12-2021,VILA NOVA DE FOZ CÔA,8,1,125,"[120,240]",Moderado,,,,8,Centro,GUARDA,0914,39815.18,6503,442,385,390,398,429,827,1217,1602,2044,16.33,5.13,4.02,3.06
16-12-2021,VILA NOVA DE GAIA,1602,114,533,"[480,960]",Muito Elevado,,,,1602,Norte,PORTO,1317,16846.43,300472,18349,15568,10972,8224,6281,14505,25477,41045,59394,1783.64,352.57,243.65,151.23
16-12-2021,VILA NOVA DE PAIVA,74,5,1578,"[960,Max]",Extremamente Elevado,,,,74,Centro,VISEU,1822,17553.28,4687,289,272,233,217,241,458,691,963,1252,26.7,7.13,5.49,3.94
16-12-2021,VILA NOVA DE POIARES,14,1,201,"[120,240]",Moderado,,,,14,Centro,COIMBRA,0617,8445.3,6939,380,284,262,235,182,417,679,963,1343,82.17,15.9,11.4,8.04
16-12-2021,VILA POUCA DE AGUIAR,26,2,219,"[120,240]",Moderado,,,,26,Norte,VILA REAL,1713,43706.62,11961,860,817,733,601,627,1228,1961,2778,3638,27.37,8.32,6.36,4.49
16-12-2021,VILA REAL,189,14,379,"[240,480]",Elevado,,,,189,Norte,VILA REAL,1714,37880.28,49962,3025,2498,2065,1579,1466,3045,5110,7608,10633,131.9,28.07,20.08,13.49
16-12-2021,VILA REAL DE SANTO ANTÓNIO,97,7,515,"[480,960]",Muito Elevado,,,,97,Algarve,FARO,0816,6125.0,18749,1172,1069,811,569,586,1155,1966,3035,4207,306.11,68.69,49.55,32.1
16-12-2021,VILA VELHA DE RÓDÃO,10,1,318,"[240,480]",Elevado,,,,10,Centro,CASTELO BRANCO,0511,32991.16,3144,209,229,180,283,306,589,769,998,1207,9.53,3.66,3.03,2.33
16-12-2021,VILA VERDE,225,16,479,"[240,480]",Elevado,,,,225,Norte,BRAGA,0313,22866.52,46911,2365,2063,1667,1494,1437,2931,4598,6661,9026,205.15,39.47,29.13,20.11
16-12-2021,VILA VIÇOSA,8,1,106,"[0,120]",Baixo a Moderado,,,,8,Alentejo,ÉVORA,0714,19485.89,7656,487,379,342,345,324,669,1011,1390,1877,39.29,9.63,7.13,5.19
16-12-2021,VIMIOSO,29,2,733,"[480,960]",Muito Elevado,,,,29,Norte,BRAGANÇA,0411,48158.51,4023,274,230,261,293,335,628,889,1119,1393,8.35,2.89,2.32,1.85
16-12-2021,VINHAIS,46,3,591,"[480,960]",Muito Elevado,,,,46,Norte,BRAGANÇA,0412,69475.09,7746,599,577,636,641,815,1456,2092,2669,3268,11.15,4.7,3.84,3.01
16-12-2021,VISEU,856,61,880,"[480,960]",Muito Elevado,,,,856,Centro,VISEU,1823,50710.14,97249,5769,5038,4140,3158,2710,5868,10008,15046,20815,191.77,41.05,29.67,19.74
16-12-2021,VIZELA,50,4,209,"[120,240]",Moderado,,,,50,Norte,BRAGA,0314,2469.83,23897,1258,928,655,509,371,880,1535,2463,3721,967.49,150.65,99.72,62.15
16-12-2021,VOUZELA,49,3,509,"[480,960]",Muito Elevado,,,,49,Centro,VISEU,1824,19369.46,9619,626,605,554,532,507,1039,1593,2198,2824,49.66,14.58,11.35,8.22
23-12-2021,ABRANTES,192,14,546,"[480,960]",Muito Elevado,,,,192,Lisboa e Vale do Tejo,SANTARÉM,1401,71469.08,35130,2473,2213,1730,1748,2021,3769,5499,7712,10185,49.15,14.25,10.79,7.69
23-12-2021,ÁGUEDA,425,30,923,"[480,960]",Muito Elevado,,,,425,Centro,AVEIRO,0101,33527.44,46075,3237,2713,2090,1635,1496,3131,5221,7934,11171,137.43,33.32,23.66,15.57
23-12-2021,AGUIAR DA BEIRA,20,1,432,"[240,480]",Elevado,,,,20,Centro,GUARDA,0901,20676.57,4652,304,281,235,239,148,387,622,903,1207,22.5,5.84,4.37,3.01
23-12-2021,ALANDROAL,10,1,204,"[120,240]",Moderado,,,,10,Alentejo,ÉVORA,0701,54267.81,4992,307,256,296,299,377,676,972,1228,1535,9.2,2.83,2.26,1.79
23-12-2021,ALBERGARIA-A-VELHA,189,13,782,"[480,960]",Muito Elevado,,,,189,Centro,AVEIRO,0102,15882.5,24144,1550,1298,996,687,680,1367,2363,3661,5211,152.02,32.81,23.05,14.88
23-12-2021,ALBUFEIRA,333,24,802,"[480,960]",Muito Elevado,,,,333,Algarve,FARO,0801,14066.42,41528,2067,1717,1425,985,858,1843,3268,4985,7052,295.24,50.14,35.44,23.23
23-12-2021,ALCÁCER DO SAL,77,5,658,"[480,960]",Muito Elevado,,,,77,Alentejo,SETÚBAL,1501,149987.3,11659,884,814,623,623,602,1225,1848,2662,3546,7.77,2.36,1.77,1.23
23-12-2021,ALCANENA,61,4,474,"[240,480]",Elevado,,,,61,Lisboa e Vale do Tejo,SANTARÉM,1402,12732.86,12809,891,744,628,536,588,1124,1752,2496,3387,100.6,26.6,19.6,13.76
23-12-2021,ALCOBAÇA,577,41,1077,"[960,Max]",Extremamente Elevado,,,,577,Lisboa e Vale do Tejo,LEIRIA,1001,40814.09,53555,3420,2927,2466,2059,1676,3735,6201,9128,12548,131.22,30.74,22.36,15.19
23-12-2021,ALCOCHETE,113,8,572,"[480,960]",Muito Elevado,,,,113,Lisboa e Vale do Tejo,SETÚBAL,1502,12836.48,19787,857,834,691,476,447,923,1614,2448,3305,154.15,25.75,19.07,12.57
23-12-2021,ALCOUTIM,6,0,289,"[240,480]",Elevado,,,,6,Algarve,FARO,0802,57536.33,2159,191,188,163,190,267,457,620,808,999,3.75,1.74,1.4,1.08
23-12-2021,ALENQUER,374,27,848,"[480,960]",Muito Elevado,,,,374,Lisboa e Vale do Tejo,LISBOA,1101,30421.92,44052,2298,2062,1629,1330,1155,2485,4114,6176,8474,144.8,27.85,20.3,13.52
23-12-2021,ALFÂNDEGA DA FÉ,60,4,1313,"[960,Max]",Extremamente Elevado,,,,60,Norte,BRAGANÇA,0401,32194.64,4550,325,277,301,274,325,599,900,1177,1502,14.13,4.67,3.66,2.8
23-12-2021,ALIJÓ,21,2,199,"[120,240]",Moderado,,,,21,Norte,VILA REAL,1701,29759.89,10625,766,687,635,542,666,1208,1843,2530,3296,35.7,11.08,8.5,6.19
23-12-2021,ALJEZUR,28,2,500,"[480,960]",Muito Elevado,,,,28,Algarve,FARO,0803,32349.95,5594,316,336,335,320,410,730,1065,1401,1717,17.29,5.31,4.33,3.29
23-12-2021,ALJUSTREL,59,4,713,"[480,960]",Muito Elevado,,,,59,Alentejo,BEJA,0201,45847.41,8247,635,521,443,347,358,705,1148,1669,2304,17.99,5.03,3.64,2.5
23-12-2021,ALMADA,1444,103,854,"[480,960]",Muito Elevado,,,,1444,Lisboa e Vale do Tejo,SETÚBAL,1503,7000.89,169039,10469,9777,7876,6144,5111,11255,19131,28908,39377,2414.5,562.45,412.91,273.26
23-12-2021,ALMEIDA,27,2,467,"[240,480]",Elevado,,,,27,Centro,GUARDA,0902,51798.46,5830,441,419,396,458,393,851,1247,1666,2107,11.26,4.07,3.22,2.41
23-12-2021,ALMEIRIM,192,14,852,"[480,960]",Muito Elevado,,,,192,Lisboa e Vale do Tejo,SANTARÉM,1403,22212.05,22546,1342,1353,1106,866,843,1709,2815,4168,5510,101.5,24.81,18.76,12.67
23-12-2021,ALMODÔVAR,66,5,976,"[960,Max]",Extremamente Elevado,,,,66,Alentejo,BEJA,0202,77788.03,6725,414,443,396,373,328,701,1097,1540,1954,8.65,2.51,1.98,1.41
23-12-2021,ALPIARÇA,35,3,501,"[480,960]",Muito Elevado,,,,35,Lisboa e Vale do Tejo,SANTARÉM,1404,9536.33,7059,515,486,363,333,274,607,970,1456,1971,74.02,20.67,15.27,10.17
23-12-2021,ALTER DO CHÃO,5,0,159,"[120,240]",Moderado,,,,5,Alentejo,PORTALEGRE,1201,36206.62,3165,201,163,136,208,187,395,531,694,895,8.74,2.47,1.92,1.47
23-12-2021,ALVAIÁZERE,20,1,303,"[240,480]",Elevado,,,,20,Centro,LEIRIA,1002,16047.76,6597,419,389,346,406,539,945,1291,1680,2099,41.11,13.08,10.47,8.04
23-12-2021,ALVITO,6,0,243,"[240,480]",Elevado,,,,6,Alentejo,BEJA,0203,26485.32,2477,145,110,105,111,89,200,305,415,560,9.35,2.11,1.57,1.15
23-12-2021,AMADORA,1340,96,728,"[480,960]",Muito Elevado,,,,1340,Lisboa e Vale do Tejo,LISBOA,1115,2378.47,184106,11186,10936,8780,6460,5890,12350,21130,32066,43252,7742.05,1818.84,1348.44,888.56
23-12-2021,AMARANTE,249,18,469,"[240,480]",Elevado,,,,249,Norte,PORTO,1301,30133.15,53193,3086,2413,1812,1643,1311,2954,4766,7179,10265,176.53,34.07,23.82,15.82
23-12-2021,AMARES,126,9,697,"[480,960]",Muito Elevado,,,,126,Norte,BRAGA,0301,8195.41,18129,1001,829,622,489,524,1013,1635,2464,3465,221.22,42.28,30.07,19.95
23-12-2021,ANADIA,294,21,1078,"[960,Max]",Extremamente Elevado,,,,294,Centro,AVEIRO,0103,21663.48,27258,1931,1698,1376,1208,1262,2470,3846,5544,7475,125.83,34.51,25.59,17.75
23-12-2021,ANGRA DO HEROÍSMO,48,3,143,"[120,240]",Moderado,,,,48,Açores,AÇORES,4301,23899.66,33807,2006,1473,1122,768,635,1403,2525,3998,6004,141.45,25.12,16.73,10.56
23-12-2021,ANSIÃO,48,3,398,"[240,480]",Elevado,,,,48,Centro,LEIRIA,1003,17609.42,12039,727,709,646,694,530,1224,1870,2579,3306,68.37,18.77,14.65,10.62
23-12-2021,ARCOS DE VALDEVEZ,141,10,674,"[480,960]",Muito Elevado,,,,141,Norte,VIANA DO CASTELO,1601,44759.64,20926,1329,1338,1282,1343,1515,2858,4140,5478,6807,46.75,15.21,12.24,9.25
23-12-2021,ARGANIL,19,1,173,"[120,240]",Moderado,,,,19,Centro,COIMBRA,0601,33283.93,11014,672,648,612,559,596,1155,1767,2415,3087,33.09,9.27,7.26,5.31
23-12-2021,ARMAMAR,20,1,350,"[240,480]",Elevado,,,,20,Norte,VISEU,1801,11723.73,5769,357,305,309,285,310,595,904,1209,1566,49.21,13.36,10.31,7.71
23-12-2021,AROUCA,175,12,844,"[480,960]",Muito Elevado,,,,175,Norte,AVEIRO,0104,32910.52,20720,1306,1047,753,683,683,1366,2119,3166,4472,62.96,13.59,9.62,6.44
23-12-2021,ARRAIOLOS,23,2,335,"[240,480]",Elevado,,,,23,Alentejo,ÉVORA,0702,68374.55,6928,435,384,283,367,480,847,1130,1514,1949,10.13,2.85,2.21,1.65
23-12-2021,ARRONCHES,1,0,36,"[0,120]",Baixo a Moderado,,,,1,Alentejo,PORTALEGRE,1202,31464.72,2820,155,142,162,187,179,366,528,670,825,8.96,2.62,2.13,1.68
23-12-2021,ARRUDA DOS VINHOS,75,5,488,"[480,960]",Muito Elevado,,,,75,Lisboa e Vale do Tejo,LISBOA,1102,7795.93,15412,738,738,562,509,438,947,1509,2247,2985,197.69,38.29,28.82,19.36
23-12-2021,AVEIRO,578,41,734,"[480,960]",Muito Elevado,,,,578,Centro,AVEIRO,0105,19757.57,78734,4520,4004,3050,2250,2103,4353,7403,11407,15927,398.49,80.61,57.73,37.47
23-12-2021,AVIS,12,1,286,"[240,480]",Elevado,,,,12,Alentejo,PORTALEGRE,1203,60596.51,4247,315,225,206,251,273,524,730,955,1270,7.01,2.1,1.58,1.2
23-12-2021,AZAMBUJA,108,8,477,"[240,480]",Elevado,,,,108,Lisboa e Vale do Tejo,LISBOA,1103,26265.65,22716,1322,1171,1070,798,618,1416,2486,3657,4979,86.48,18.96,13.92,9.46
23-12-2021,BAIÃO,46,3,248,"[240,480]",Elevado,,,,46,Norte,PORTO,1302,17452.83,18748,1070,862,714,686,725,1411,2125,2987,4057,107.42,23.25,17.11,12.18
23-12-2021,BARCELOS,632,45,544,"[480,960]",Muito Elevado,,,,632,Norte,BRAGA,0302,37890.14,116187,6721,5325,3619,2991,2562,5553,9172,14497,21218,306.64,56.0,38.26,24.21
23-12-2021,BARRANCOS,2,0,123,"[120,240]",Moderado,,,,2,Alentejo,BEJA,0204,16841.73,1634,90,65,65,94,61,155,220,285,375,9.7,2.23,1.69,1.31
23-12-2021,BARREIRO,497,36,662,"[480,960]",Muito Elevado,,,,497,Lisboa e Vale do Tejo,SETÚBAL,1504,3639.07,75147,5194,5565,4459,3105,1767,4872,9331,14896,20090,2065.05,552.07,409.34,256.42
23-12-2021,BATALHA,142,10,891,"[480,960]",Muito Elevado,,,,142,Centro,LEIRIA,1004,10341.6,15963,873,762,649,529,549,1078,1727,2489,3362,154.35,32.51,24.07,16.7
23-12-2021,BEJA,116,8,345,"[240,480]",Elevado,,,,116,Alentejo,BEJA,0205,114647.55,33579,2005,1840,1386,1272,1039,2311,3697,5537,7542,29.29,6.58,4.83,3.22
23-12-2021,BELMONTE,26,2,407,"[240,480]",Elevado,,,,26,Centro,CASTELO BRANCO,0501,11875.91,6398,444,321,325,310,355,665,990,1311,1755,53.87,14.78,11.04,8.34
23-12-2021,BENAVENTE,175,13,573,"[480,960]",Muito Elevado,,,,175,Lisboa e Vale do Tejo,SANTARÉM,1405,52138.39,30602,1468,1376,1141,876,643,1519,2660,4036,5504,58.69,10.56,7.74,5.1
23-12-2021,BOMBARRAL,106,8,844,"[480,960]",Muito Elevado,,,,106,Lisboa e Vale do Tejo,LEIRIA,1005,9128.55,12558,875,714,561,491,429,920,1481,2195,3070,137.56,33.63,24.04,16.22
23-12-2021,BORBA,11,1,165,"[120,240]",Moderado,,,,11,Alentejo,ÉVORA,0703,14518.65,6736,430,375,279,436,392,828,1107,1482,1912,46.39,13.17,10.21,7.62
23-12-2021,BOTICAS,27,2,548,"[480,960]",Muito Elevado,,,,27,Norte,VILA REAL,1702,32195.66,4998,347,306,311,305,380,685,996,1302,1649,15.52,5.12,4.04,3.09
23-12-2021,BRAGA,1498,107,820,"[480,960]",Muito Elevado,,,,1498,Norte,BRAGA,0303,18339.95,182679,10029,7963,5241,4320,3671,7991,13232,21195,31224,996.07,170.25,115.57,72.15
23-12-2021,BRAGANÇA,254,18,757,"[480,960]",Muito Elevado,,,,254,Norte,BRAGANÇA,0402,117357.27,33607,2402,1855,1652,1393,1163,2556,4208,6063,8465,28.64,7.21,5.17,3.59
23-12-2021,CABECEIRAS DE BASTO,85,6,541,"[480,960]",Muito Elevado,,,,85,Norte,BRAGA,0304,24182.16,15628,774,594,544,575,574,1149,1693,2287,3061,64.63,12.66,9.46,7.0
23-12-2021,CADAVAL,45,3,328,"[240,480]",Elevado,,,,45,Lisboa e Vale do Tejo,LISBOA,1104,17489.3,13673,813,796,756,621,625,1246,2002,2798,3611,78.18,20.65,16.0,11.45
23-12-2021,CALDAS DA RAINHA,330,24,635,"[480,960]",Muito Elevado,,,,330,Lisboa e Vale do Tejo,LEIRIA,1006,25569.47,51912,3035,2684,2186,1899,1705,3604,5790,8474,11509,203.03,45.01,33.14,22.64
23-12-2021,CALHETA,32,2,295,"[240,480]",Elevado,,,,32,Madeira,MADEIRA,3101,11150.43,10867,576,497,507,399,415,814,1321,1818,2394,97.46,21.47,16.3,11.85
23-12-2021,CALHETA (AÇORES),3,0,95,"[0,120]",Baixo a Moderado,,,,3,Açores,AÇORES,4501,12626.4,3184,215,159,141,139,122,261,402,561,776,25.22,6.15,4.44,3.18
23-12-2021,CÂMARA DE LOBOS,349,25,1035,"[960,Max]",Extremamente Elevado,,,,349,Madeira,MADEIRA,3102,5216.67,33675,1396,1059,834,545,381,926,1760,2819,4215,645.49,80.79,54.03,33.74
23-12-2021,CAMINHA,59,4,374,"[240,480]",Elevado,,,,59,Norte,VIANA DO CASTELO,1602,13652.14,15877,1046,944,818,646,656,1302,2120,3064,4110,116.3,30.11,22.44,15.53
23-12-2021,CAMPO MAIOR,52,4,655,"[480,960]",Muito Elevado,,,,52,Alentejo,PORTALEGRE,1204,24720.16,7874,471,364,351,279,327,606,957,1321,1792,31.85,7.25,5.34,3.87
23-12-2021,CANTANHEDE,222,16,635,"[480,960]",Muito Elevado,,,,222,Centro,COIMBRA,0602,39088.02,35011,2346,2096,1880,1709,1451,3160,5040,7136,9482,89.57,24.26,18.26,12.89
23-12-2021,CARRAZEDA DE ANSIÃES,15,1,267,"[240,480]",Elevado,,,,15,Norte,BRAGANÇA,0403,27924.09,5666,424,389,391,312,465,777,1168,1557,1981,20.29,7.09,5.58,4.18
23-12-2021,CARREGAL DO SAL,46,3,494,"[480,960]",Muito Elevado,,,,46,Centro,VISEU,1802,11689.21,9271,587,562,486,462,376,838,1324,1886,2473,79.31,21.16,16.13,11.33
23-12-2021,CARTAXO,163,12,685,"[480,960]",Muito Elevado,,,,163,Lisboa e Vale do Tejo,SANTARÉM,1406,15817.28,23843,1415,1376,1142,861,632,1493,2635,4011,5426,150.74,34.3,25.36,16.66
23-12-2021,CASCAIS,1440,103,674,"[480,960]",Muito Elevado,,,,1440,Lisboa e Vale do Tejo,LISBOA,1105,9740.17,213608,12151,11444,8680,6469,5248,11717,20397,31841,43992,2193.1,451.66,326.91,209.41
23-12-2021,CASTANHEIRA DE PÊRA,5,0,194,"[120,240]",Moderado,,,,5,Centro,LEIRIA,1007,6677.45,2614,233,195,157,190,187,377,534,729,962,39.15,14.41,10.92,8.0
23-12-2021,CASTELO BRANCO,259,18,498,"[480,960]",Muito Elevado,,,,259,Centro,CASTELO BRANCO,0502,143819.15,51987,3528,3042,2499,2229,2225,4454,6953,9995,13523,36.15,9.4,6.95,4.83
23-12-2021,CASTELO DE PAIVA,102,7,660,"[480,960]",Muito Elevado,,,,102,Norte,AVEIRO,0106,11500.53,15454,881,697,545,420,431,851,1396,2093,2974,134.37,25.86,18.2,12.14
23-12-2021,CASTELO DE VIDE,2,0,69,"[0,120]",Baixo a Moderado,,,,2,Alentejo,PORTALEGRE,1205,26491.24,2919,204,173,179,147,170,317,496,669,873,11.02,3.3,2.53,1.87
23-12-2021,CASTRO DAIRE,78,6,565,"[480,960]",Muito Elevado,,,,78,Centro,VISEU,1803,37904.13,13823,942,857,765,732,773,1505,2270,3127,4069,36.47,10.74,8.25,5.99
23-12-2021,CASTRO MARIM,66,5,1065,"[960,Max]",Extremamente Elevado,,,,66,Algarve,FARO,0804,30084.37,6237,370,345,334,322,344,666,1000,1345,1715,20.73,5.7,4.47,3.32
23-12-2021,CASTRO VERDE,67,5,958,"[480,960]",Muito Elevado,,,,67,Alentejo,BEJA,0206,56944.23,6949,437,347,303,275,227,502,805,1152,1589,12.2,2.79,2.02,1.41
23-12-2021,CELORICO DA BEIRA,32,2,461,"[240,480]",Elevado,,,,32,Centro,GUARDA,0903,24721.63,6928,430,416,363,369,535,904,1267,1683,2113,28.02,8.55,6.81,5.12
23-12-2021,CELORICO DE BASTO,58,4,302,"[240,480]",Elevado,,,,58,Norte,BRAGA,0305,18107.02,19040,1001,802,668,728,729,1457,2125,2927,3928,105.15,21.69,16.17,11.74
23-12-2021,CHAMUSCA,32,2,353,"[240,480]",Elevado,,,,32,Lisboa e Vale do Tejo,SANTARÉM,1407,74600.54,9197,629,583,553,465,579,1044,1597,2180,2809,12.33,3.77,2.92,2.14
23-12-2021,CHAVES,199,14,505,"[480,960]",Muito Elevado,,,,199,Norte,VILA REAL,1703,59122.95,39343,2676,2429,1991,1886,1918,3804,5795,8224,10900,66.54,18.44,13.91,9.8
23-12-2021,CINFÃES,58,4,317,"[240,480]",Elevado,,,,58,Norte,VISEU,1804,23928.76,18244,1067,902,779,734,758,1492,2271,3173,4240,76.24,17.72,13.26,9.49
23-12-2021,COIMBRA,1323,94,986,"[960,Max]",Extremamente Elevado,,,,1323,Centro,COIMBRA,0603,31939.94,134166,9489,8734,6353,5139,5074,10213,16566,25300,34789,420.06,108.92,79.21,51.87
23-12-2021,CONDEIXA-A-NOVA,246,18,1386,"[960,Max]",Extremamente Elevado,,,,246,Centro,COIMBRA,0604,13867.47,17733,871,809,717,583,490,1073,1790,2599,3470,127.88,25.02,18.74,12.91
23-12-2021,CONSTÂNCIA,32,2,790,"[480,960]",Muito Elevado,,,,32,Lisboa e Vale do Tejo,SANTARÉM,1408,8036.58,4030,211,183,187,148,155,303,490,673,884,50.14,11.0,8.37,6.1
23-12-2021,CORUCHE,34,2,192,"[120,240]",Moderado,,,,34,Lisboa e Vale do Tejo,SANTARÉM,1409,111572.03,17471,1294,1090,1095,1096,1019,2115,3210,4300,5594,15.66,5.01,3.85,2.88
23-12-2021,CORVO,0,0,0,"[0,120]",Baixo a Moderado,,,,0,Açores,AÇORES,4901,1711.45,464,22,21,11,13,19,32,43,64,86,27.12,5.03,3.74,2.51
23-12-2021,COVILHÃ,609,44,1302,"[960,Max]",Extremamente Elevado,,,,609,Centro,CASTELO BRANCO,0503,55560.06,46787,3533,2998,2365,2111,2193,4304,6669,9667,13200,84.21,23.76,17.4,12.0
23-12-2021,CRATO,4,0,131,"[120,240]",Moderado,,,,4,Alentejo,PORTALEGRE,1206,39806.88,3129,229,258,163,182,228,410,573,831,1060,7.86,2.66,2.09,1.44
23-12-2021,CUBA,9,1,198,"[120,240]",Moderado,,,,9,Alentejo,BEJA,0207,17208.72,4595,255,233,206,190,143,333,539,772,1027,26.7,5.97,4.49,3.13
23-12-2021,ELVAS,142,10,690,"[480,960]",Muito Elevado,,,,142,Alentejo,PORTALEGRE,1207,63128.86,20528,1057,1145,902,852,810,1662,2564,3709,4766,32.52,7.55,5.88,4.06
23-12-2021,ENTRONCAMENTO,172,12,798,"[480,960]",Muito Elevado,,,,172,Lisboa e Vale do Tejo,SANTARÉM,1410,1372.81,21558,1066,930,868,695,592,1287,2155,3085,4151,1570.14,302.33,224.69,156.96
23-12-2021,ESPINHO,134,10,455,"[240,480]",Elevado,,,,134,Norte,AVEIRO,0107,2105.68,29516,2205,1993,1430,1177,960,2137,3567,5560,7765,1401.52,368.71,264.01,169.37
23-12-2021,ESPOSENDE,275,20,805,"[480,960]",Muito Elevado,,,,275,Norte,BRAGA,0306,9540.98,34177,1831,1522,1095,894,723,1617,2712,4234,6065,358.21,63.57,44.38,28.42
23-12-2021,ESTARREJA,129,9,497,"[480,960]",Muito Elevado,,,,129,Centro,AVEIRO,0108,10817.33,26006,1503,1399,1106,953,728,1681,2787,4186,5689,240.42,52.59,38.7,25.76
23-12-2021,ESTREMOZ,37,3,294,"[240,480]",Elevado,,,,37,Alentejo,ÉVORA,0704,51379.95,12728,789,613,697,786,877,1663,2360,2973,3762,24.77,7.32,5.79,4.59
23-12-2021,ÉVORA,325,23,619,"[480,960]",Muito Elevado,,,,325,Alentejo,ÉVORA,0705,130707.58,52428,3569,2852,2176,1966,1803,3769,5945,8797,12366,40.11,9.46,6.73,4.55
23-12-2021,FAFE,348,25,725,"[480,960]",Muito Elevado,,,,348,Norte,BRAGA,0307,21908.11,48060,3044,2455,1679,1403,1208,2611,4290,6745,9789,219.37,44.68,30.79,19.58
23-12-2021,FARO,681,49,1116,"[960,Max]",Extremamente Elevado,,,,681,Algarve,FARO,0805,20256.79,61015,3847,3364,2604,2055,1601,3656,6260,9624,13471,301.2,66.5,47.51,30.9
23-12-2021,FELGUEIRAS,199,14,353,"[240,480]",Elevado,,,,199,Norte,PORTO,1303,11573.75,56422,2951,2302,1601,1316,973,2289,3890,6192,9143,487.49,79.0,53.5,33.61
23-12-2021,FERREIRA DO ALENTEJO,11,1,141,"[120,240]",Moderado,,,,11,Alentejo,BEJA,0208,64820.68,7845,515,414,372,343,345,688,1060,1474,1989,12.1,3.07,2.27,1.64
23-12-2021,FERREIRA DO ZÊZERE,93,7,1169,"[960,Max]",Extremamente Elevado,,,,93,Lisboa e Vale do Tejo,SANTARÉM,1411,19038.03,7959,470,370,416,465,456,921,1337,1707,2177,41.81,11.44,8.97,7.02
23-12-2021,FIGUEIRA DA FOZ,511,36,869,"[480,960]",Muito Elevado,,,,511,Centro,COIMBRA,0605,37905.26,58747,4032,3597,2887,2495,2043,4538,7425,11022,15054,154.98,39.72,29.08,19.59
23-12-2021,FIGUEIRA DE CASTELO RODRIGO,11,1,197,"[120,240]",Moderado,,,,11,Centro,GUARDA,0904,50857.46,5584,347,352,290,352,391,743,1033,1385,1732,10.98,3.41,2.72,2.03
23-12-2021,FIGUEIRÓ DOS VINHOS,15,1,270,"[240,480]",Elevado,,,,15,Centro,LEIRIA,1008,17344.0,5568,402,386,322,309,351,660,982,1368,1770,32.1,10.21,7.89,5.66
23-12-2021,FORNOS DE ALGODRES,27,2,595,"[480,960]",Muito Elevado,,,,27,Centro,GUARDA,0905,13145.05,4528,261,218,247,256,232,488,735,953,1214,34.45,9.24,7.25,5.59
23-12-2021,FREIXO DE ESPADA À CINTA,0,0,0,"[0,120]",Baixo a Moderado,,,,0,Norte,BRAGANÇA,0404,24414.29,3298,211,177,231,196,189,385,616,793,1004,13.51,4.11,3.25,2.52
23-12-2021,FRONTEIRA,1,0,34,"[0,120]",Baixo a Moderado,,,,1,Alentejo,PORTALEGRE,1208,24859.58,2974,213,182,149,156,168,324,473,655,868,11.96,3.49,2.63,1.9
23-12-2021,FUNCHAL,1067,76,1026,"[960,Max]",Extremamente Elevado,,,,1067,Madeira,MADEIRA,3103,7616.2,104024,6382,5086,3643,2821,1990,4811,8454,13540,19922,1365.86,261.58,177.78,111.0
23-12-2021,FUNDÃO,259,19,979,"[960,Max]",Extremamente Elevado,,,,259,Centro,CASTELO BRANCO,0504,70019.79,26495,1781,1464,1432,1357,1643,3000,4432,5896,7677,37.84,10.96,8.42,6.33
23-12-2021,GAVIÃO,11,1,346,"[240,480]",Elevado,,,,11,Alentejo,PORTALEGRE,1209,29459.45,3263,189,186,222,263,293,556,778,964,1153,11.08,3.91,3.27,2.64
23-12-2021,GÓIS,9,1,239,"[120,240]",Moderado,,,,9,Centro,COIMBRA,0606,26330.19,3805,235,199,240,233,244,477,717,916,1151,14.45,4.37,3.48,2.72
23-12-2021,GOLEGÃ,52,4,983,"[960,Max]",Extremamente Elevado,,,,52,Lisboa e Vale do Tejo,SANTARÉM,1412,8431.67,5339,356,299,281,243,255,498,779,1078,1434,63.32,17.01,12.78,9.24
23-12-2021,GONDOMAR,928,66,559,"[480,960]",Muito Elevado,,,,928,Norte,PORTO,1304,13191.76,165985,10555,8755,6222,4450,3364,7814,14036,22791,33346,1258.22,252.77,172.76,106.4
23-12-2021,GOUVEIA,105,8,850,"[480,960]",Muito Elevado,,,,105,Centro,GUARDA,0906,30061.17,12387,871,931,780,783,810,1593,2373,3304,4175,41.21,13.89,10.99,7.89
23-12-2021,GRÂNDOLA,11,1,75,"[0,120]",Baixo a Moderado,,,,11,Alentejo,SETÚBAL,1505,82593.66,14639,834,834,708,688,672,1360,2068,2902,3736,17.72,4.52,3.51,2.5
23-12-2021,GUARDA,449,32,1151,"[960,Max]",Extremamente Elevado,,,,449,Centro,GUARDA,0907,71209.58,38969,2477,2041,1686,1415,1474,2889,4575,6616,9093,54.72,12.77,9.29,6.42
23-12-2021,GUIMARÃES,597,43,392,"[240,480]",Elevado,,,,597,Norte,BRAGA,0308,24099.96,152309,9394,7074,4809,3877,2948,6825,11634,18708,28102,631.99,116.61,77.63,48.27
23-12-2021,HORTA,13,1,90,"[0,120]",Baixo a Moderado,,,,13,Açores,AÇORES,4701,17305.53,14521,818,658,468,352,302,654,1122,1780,2598,83.91,15.01,10.29,6.48
23-12-2021,IDANHA-A-NOVA,36,3,442,"[240,480]",Elevado,,,,36,Centro,CASTELO BRANCO,0505,141633.51,8043,518,490,519,672,974,1646,2165,2655,3173,5.68,2.24,1.87,1.53
23-12-2021,ÍLHAVO,344,25,889,"[480,960]",Muito Elevado,,,,344,Centro,AVEIRO,0110,7347.55,38699,2227,1943,1444,1193,850,2043,3487,5430,7657,526.66,104.21,73.9,47.46
23-12-2021,LAGOA (FARO),216,15,950,"[480,960]",Muito Elevado,,,,216,Algarve,FARO,0806,8825.45,22762,1314,1168,919,749,670,1419,2338,3506,4820,257.93,54.62,39.73,26.49
23-12-2021,LAGOA,83,6,563,"[480,960]",Muito Elevado,,,,83,Açores,AÇORES,4201,4559.32,14721,536,458,349,238,235,473,822,1280,1816,322.9,39.83,28.08,18.03
23-12-2021,LAGOS,244,17,803,"[480,960]",Muito Elevado,,,,244,Algarve,FARO,0807,21299.27,30374,1744,1434,1247,1053,1029,2082,3329,4763,6507,142.61,30.55,22.36,15.63
23-12-2021,LAJES DAS FLORES,2,0,137,"[120,240]",Moderado,,,,2,Açores,AÇORES,4801,7004.79,1463,88,53,62,46,54,100,162,215,303,20.89,4.33,3.07,2.31
23-12-2021,LAJES DO PICO,3,0,67,"[0,120]",Baixo a Moderado,,,,3,Açores,AÇORES,4601,15531.09,4490,304,231,223,159,162,321,544,775,1079,28.91,6.95,4.99,3.5
23-12-2021,LAMEGO,55,4,222,"[120,240]",Moderado,,,,55,Norte,VISEU,1805,16542.11,24895,1639,1284,1124,898,783,1681,2805,4089,5728,150.5,34.63,24.72,16.96
23-12-2021,LEIRIA,1081,77,863,"[480,960]",Muito Elevado,,,,1081,Centro,LEIRIA,1009,56508.83,125267,7389,6366,5090,3902,3159,7061,12151,18517,25906,221.68,45.84,32.77,21.5
23-12-2021,LISBOA,5411,387,1062,"[960,Max]",Extremamente Elevado,,,,5411,Lisboa e Vale do Tejo,LISBOA,1106,10005.43,509515,33197,33340,27706,23037,26770,49807,77513,110853,144050,5092.6,1439.78,1107.98,774.74
23-12-2021,LOULÉ,731,52,1064,"[960,Max]",Extremamente Elevado,,,,731,Algarve,FARO,0808,76366.91,68697,3890,3350,2780,2358,2251,4609,7389,10739,14629,89.96,19.16,14.06,9.68
23-12-2021,LOURES,1224,87,573,"[480,960]",Muito Elevado,,,,1224,Lisboa e Vale do Tejo,LISBOA,1107,16723.99,213687,12746,12794,9644,6669,5033,11702,21346,34140,46886,1277.73,280.35,204.14,127.64
23-12-2021,LOURINHÃ,187,13,722,"[480,960]",Muito Elevado,,,,187,Lisboa e Vale do Tejo,LISBOA,1108,14717.2,25855,1584,1243,992,842,645,1487,2479,3722,5306,175.68,36.05,25.29,16.84
23-12-2021,LOUSÃ,128,9,747,"[480,960]",Muito Elevado,,,,128,Centro,COIMBRA,0607,13840.01,17158,946,866,658,528,450,978,1636,2502,3448,123.97,24.91,18.08,11.82
23-12-2021,LOUSADA,163,12,348,"[240,480]",Elevado,,,,163,Norte,PORTO,1305,9608.01,46755,2289,1698,1176,853,621,1474,2650,4348,6637,486.63,69.08,45.25,27.58
23-12-2021,MAÇÃO,25,2,404,"[240,480]",Elevado,,,,25,Lisboa e Vale do Tejo,SANTARÉM,1413,39997.98,6267,386,362,390,440,657,1097,1487,1849,2235,15.67,5.59,4.62,3.72
23-12-2021,MACEDO DE CAVALEIROS,17,1,118,"[0,120]",Baixo a Moderado,,,,17,Norte,BRAGANÇA,0405,69914.08,14516,1082,889,878,823,938,1761,2639,3528,4610,20.76,6.59,5.05,3.77
23-12-2021,MACHICO,203,15,1017,"[960,Max]",Extremamente Elevado,,,,203,Madeira,MADEIRA,3104,6825.1,19981,1197,860,662,455,331,786,1448,2308,3505,292.76,51.36,33.82,21.22
23-12-2021,MADALENA,5,0,85,"[0,120]",Baixo a Moderado,,,,5,Açores,AÇORES,4602,14712.33,5895,334,256,173,190,179,369,542,798,1132,40.07,7.69,5.42,3.68
23-12-2021,MAFRA,561,40,661,"[480,960]",Muito Elevado,,,,561,Lisboa e Vale do Tejo,LISBOA,1109,29165.5,84816,3613,3334,2839,2089,1899,3988,6827,10161,13774,290.81,47.23,34.84,23.41
23-12-2021,MAIA,913,65,657,"[480,960]",Muito Elevado,,,,913,Norte,PORTO,1306,8293.94,138971,7801,6617,4512,3339,2631,5970,10482,17099,24900,1675.56,300.22,206.16,126.38
23-12-2021,MANGUALDE,113,8,610,"[480,960]",Muito Elevado,,,,113,Centro,VISEU,1806,21925.56,18510,1198,1128,885,852,743,1595,2480,3608,4806,84.42,21.92,16.46,11.31
23-12-2021,MANTEIGAS,12,1,402,"[240,480]",Elevado,,,,12,Centro,GUARDA,0908,12197.55,3007,258,197,159,167,146,313,472,669,927,24.65,7.6,5.48,3.87
23-12-2021,MARCO DE CANAVESES,248,18,482,"[480,960]",Muito Elevado,,,,248,Norte,PORTO,1307,20188.98,51496,2678,2060,1488,1265,1023,2288,3776,5836,8514,255.07,42.17,28.91,18.7
23-12-2021,MARINHA GRANDE,308,22,800,"[480,960]",Muito Elevado,,,,308,Centro,LEIRIA,1010,18725.19,38508,2365,2302,1638,1359,1058,2417,4055,6357,8722,205.65,46.58,33.95,21.66
23-12-2021,MARVÃO,2,0,68,"[0,120]",Baixo a Moderado,,,,2,Alentejo,PORTALEGRE,1210,15489.9,3005,198,185,142,197,237,434,576,761,959,19.4,6.19,4.91,3.72
23-12-2021,MATOSINHOS,1320,94,753,"[480,960]",Muito Elevado,,,,1320,Norte,PORTO,1308,6241.97,175357,11850,9977,7023,5024,3884,8908,15931,25908,37758,2809.31,604.9,415.06,255.22
23-12-2021,MEALHADA,151,11,760,"[480,960]",Muito Elevado,,,,151,Centro,AVEIRO,0111,11065.66,19914,1163,1039,810,828,831,1659,2469,3508,4671,179.96,42.21,31.7,22.31
23-12-2021,MÊDA,30,2,656,"[480,960]",Muito Elevado,,,,30,Centro,GUARDA,0909,28604.92,4587,343,306,290,288,443,731,1021,1327,1670,16.04,5.84,4.64,3.57
23-12-2021,MELGAÇO,29,2,363,"[240,480]",Elevado,,,,29,Norte,VIANA DO CASTELO,1603,23824.58,8093,507,567,578,614,675,1289,1867,2434,2941,33.97,12.34,10.22,7.84
23-12-2021,MÉRTOLA,20,1,331,"[240,480]",Elevado,,,,20,Alentejo,BEJA,0209,129287.34,6142,400,390,378,423,600,1023,1401,1791,2191,4.75,1.69,1.39,1.08
23-12-2021,MESÃO FRIO,8,1,203,"[120,240]",Moderado,,,,8,Norte,VILA REAL,1704,2664.87,3964,265,205,168,157,120,277,445,650,915,148.74,34.33,24.39,16.7
23-12-2021,MIRA,96,7,808,"[480,960]",Muito Elevado,,,,96,Centro,COIMBRA,0608,12403.38,11832,727,729,659,550,466,1016,1675,2404,3131,95.4,25.24,19.38,13.5
23-12-2021,MIRANDA DO CORVO,69,5,543,"[480,960]",Muito Elevado,,,,69,Centro,COIMBRA,0609,12637.79,12708,706,659,568,498,404,902,1470,2129,2835,100.55,22.43,16.85,11.63
23-12-2021,MIRANDA DO DOURO,15,1,222,"[120,240]",Moderado,,,,15,Norte,BRAGANÇA,0406,48718.31,6830,482,429,442,463,470,933,1375,1804,2286,14.02,4.69,3.7,2.82
23-12-2021,MIRANDELA,85,6,389,"[240,480]",Elevado,,,,85,Norte,BRAGANÇA,0407,65895.67,21754,1640,1315,1204,1078,947,2025,3229,4544,6184,33.01,9.38,6.9,4.9
23-12-2021,MOGADOURO,23,2,278,"[240,480]",Elevado,,,,23,Norte,BRAGANÇA,0408,76064.93,8392,589,529,576,630,655,1285,1861,2390,2979,11.03,3.92,3.14,2.45
23-12-2021,MOIMENTA DA BEIRA,48,3,494,"[480,960]",Muito Elevado,,,,48,Norte,VISEU,1807,21996.9,9736,576,514,471,416,461,877,1348,1862,2438,44.26,11.08,8.46,6.13
23-12-2021,MOITA,442,32,687,"[480,960]",Muito Elevado,,,,442,Lisboa e Vale do Tejo,SETÚBAL,1506,5525.98,64407,4226,3646,2623,1801,1425,3226,5849,9495,13721,1165.53,248.3,171.82,105.85
23-12-2021,MONÇÃO,190,14,1061,"[960,Max]",Extremamente Elevado,,,,190,Norte,VIANA DO CASTELO,1604,21130.85,17869,1161,1105,1031,1006,972,1978,3009,4114,5275,84.56,24.96,19.47,14.24
23-12-2021,MONCHIQUE,32,2,623,"[480,960]",Muito Elevado,,,,32,Algarve,FARO,0809,39530.43,5077,353,384,321,355,392,747,1068,1452,1805,12.84,4.57,3.67,2.7
23-12-2021,MONDIM DE BASTO,37,3,538,"[480,960]",Muito Elevado,,,,37,Norte,VILA REAL,1705,17207.52,6946,395,300,314,284,283,567,881,1181,1576,40.36,9.16,6.86,5.12
23-12-2021,MONFORTE,3,0,102,"[0,120]",Baixo a Moderado,,,,3,Alentejo,PORTALEGRE,1211,42024.82,2975,139,115,117,192,168,360,477,592,731,7.08,1.74,1.41,1.14
23-12-2021,MONTALEGRE,27,2,304,"[240,480]",Elevado,,,,27,Norte,VILA REAL,1706,80545.71,8997,699,628,595,603,730,1333,1928,2556,3255,11.17,4.04,3.17,2.39
23-12-2021,MONTEMOR-O-NOVO,56,4,356,"[240,480]",Elevado,,,,56,Alentejo,ÉVORA,0706,123296.65,15647,991,953,868,878,971,1849,2717,3670,4661,12.69,3.78,2.98,2.2
23-12-2021,MONTEMOR-O-VELHO,183,13,724,"[480,960]",Muito Elevado,,,,183,Centro,COIMBRA,0610,22896.23,25224,1496,1397,1217,1057,988,2045,3262,4659,6155,110.17,26.88,20.35,14.25
23-12-2021,MONTIJO,312,22,542,"[480,960]",Muito Elevado,,,,312,Lisboa e Vale do Tejo,SETÚBAL,1507,34861.64,57614,2771,2441,1990,1554,1109,2663,4653,7094,9865,165.26,28.3,20.35,13.35
23-12-2021,MORA,9,1,223,"[120,240]",Moderado,,,,9,Alentejo,ÉVORA,0707,44395.02,4138,336,275,252,238,257,495,747,1022,1358,9.32,3.06,2.3,1.68
23-12-2021,MORTÁGUA,48,3,544,"[480,960]",Muito Elevado,,,,48,Centro,VISEU,1808,25117.82,8803,638,584,535,499,460,959,1494,2078,2716,35.05,10.81,8.27,5.95
23-12-2021,MOURA,44,3,323,"[240,480]",Elevado,,,,44,Alentejo,BEJA,0210,95845.55,13718,817,656,665,542,461,1003,1668,2324,3141,14.31,3.28,2.42,1.74
23-12-2021,MOURÃO,1,0,41,"[0,120]",Baixo a Moderado,,,,1,Alentejo,ÉVORA,0708,27862.98,2450,139,108,80,104,109,213,293,401,540,8.79,1.94,1.44,1.05
23-12-2021,MURÇA,9,1,167,"[120,240]",Moderado,,,,9,Norte,VILA REAL,1707,18937.11,5463,384,341,307,306,319,625,932,1273,1657,28.85,8.75,6.72,4.92
23-12-2021,MURTOSA,47,3,461,"[240,480]",Elevado,,,,47,Centro,AVEIRO,0112,7308.78,10279,509,473,403,353,409,762,1165,1638,2147,140.63,29.37,22.41,15.94
23-12-2021,NAZARÉ,124,9,877,"[480,960]",Muito Elevado,,,,124,Lisboa e Vale do Tejo,LEIRIA,1011,8243.43,14165,967,903,670,420,396,816,1486,2389,3356,171.84,40.71,28.98,18.03
23-12-2021,NELAS,46,3,354,"[240,480]",Elevado,,,,46,Centro,VISEU,1809,12571.48,12974,924,787,668,604,583,1187,1855,2642,3566,103.21,28.37,21.02,14.76
23-12-2021,NISA,60,4,990,"[960,Max]",Extremamente Elevado,,,,60,Alentejo,PORTALEGRE,1212,57567.84,6061,405,389,355,483,478,961,1316,1705,2110,10.53,3.67,2.96,2.29
23-12-2021,NORDESTE,2,0,42,"[0,120]",Baixo a Moderado,,,,2,Açores,AÇORES,4202,10146.8,4862,246,180,124,161,162,323,447,627,873,47.92,8.6,6.18,4.41
23-12-2021,ÓBIDOS,89,6,749,"[480,960]",Muito Elevado,,,,89,Lisboa e Vale do Tejo,LEIRIA,1012,14155.44,11850,743,650,574,452,436,888,1462,2112,2855,83.72,20.17,14.92,10.33
23-12-2021,ODEMIRA,54,4,219,"[120,240]",Moderado,,,,54,Alentejo,BEJA,0211,172060.15,24717,1475,1317,1225,1397,1349,2746,3971,5288,6763,14.37,3.93,3.07,2.31
23-12-2021,ODIVELAS,1021,73,631,"[480,960]",Muito Elevado,,,,1021,Lisboa e Vale do Tejo,LISBOA,1116,2654.36,161774,9562,9038,6952,4641,3812,8453,15405,24443,34005,6095.48,1281.27,920.99,580.44
23-12-2021,OEIRAS,1719,123,969,"[960,Max]",Extremamente Elevado,,,,1719,Lisboa e Vale do Tejo,LISBOA,1110,4588.31,177408,11580,11575,8566,6211,5855,12066,20632,32207,43787,3866.78,954.38,701.98,449.69
23-12-2021,OLEIROS,9,1,180,"[120,240]",Moderado,,,,9,Centro,CASTELO BRANCO,0506,47109.31,5003,384,341,366,397,487,884,1250,1591,1975,10.62,4.19,3.38,2.65
23-12-2021,OLHÃO,404,29,910,"[480,960]",Muito Elevado,,,,404,Algarve,FARO,0810,13086.38,44405,2455,2309,1689,1342,1268,2610,4299,6608,9063,339.33,69.26,50.5,32.85
23-12-2021,OLIVEIRA DE AZEMÉIS,539,39,817,"[480,960]",Muito Elevado,,,,539,Norte,AVEIRO,0113,16110.41,66011,4155,3614,2794,2183,1738,3921,6715,10329,14484,409.75,89.91,64.12,41.68
23-12-2021,OLIVEIRA DE FRADES,92,7,921,"[480,960]",Muito Elevado,,,,92,Centro,VISEU,1810,14534.62,9936,553,475,438,359,415,774,1212,1687,2240,68.36,15.41,11.61,8.34
23-12-2021,OLIVEIRA DO BAIRRO,188,13,773,"[480,960]",Muito Elevado,,,,188,Centro,AVEIRO,0114,8731.99,24277,1327,1182,999,786,810,1596,2595,3777,5104,278.02,58.45,43.25,29.72
23-12-2021,OLIVEIRA DO HOSPITAL,66,5,343,"[240,480]",Elevado,,,,66,Centro,COIMBRA,0611,23451.66,19253,1161,1097,962,924,960,1884,2846,3943,5104,82.1,21.76,16.81,12.14
23-12-2021,OURÉM,507,36,1152,"[960,Max]",Extremamente Elevado,,,,507,Lisboa e Vale do Tejo,SANTARÉM,1421,41668.03,44044,2463,2069,1899,1817,1603,3420,5319,7388,9851,105.7,23.64,17.73,12.77
23-12-2021,OURIQUE,31,2,682,"[480,960]",Muito Elevado,,,,31,Alentejo,BEJA,0212,66331.36,4607,313,287,284,268,227,495,779,1066,1379,6.95,2.08,1.61,1.17
23-12-2021,OVAR,410,29,756,"[480,960]",Muito Elevado,,,,410,Centro,AVEIRO,0115,14770.25,54260,3294,2709,1994,1636,1234,2870,4864,7573,10867,367.37,73.57,51.27,32.93
23-12-2021,PAÇOS DE FERREIRA,166,12,292,"[240,480]",Elevado,,,,166,Norte,PORTO,1309,7099.29,56728,2903,2193,1518,1135,664,1799,3317,5510,8413,799.1,118.51,77.62,46.72
23-12-2021,PALMELA,328,23,510,"[480,960]",Muito Elevado,,,,328,Lisboa e Vale do Tejo,SETÚBAL,1508,46512.01,64269,3402,3244,2635,1846,1391,3237,5872,9116,12518,138.18,26.91,19.6,12.62
23-12-2021,PAMPILHOSA DA SERRA,11,1,273,"[240,480]",Elevado,,,,11,Centro,COIMBRA,0612,39646.24,4037,238,254,295,339,423,762,1057,1311,1549,10.18,3.91,3.31,2.67
23-12-2021,PAREDES,446,32,518,"[480,960]",Muito Elevado,,,,446,Norte,PORTO,1310,15675.69,86067,4272,3532,2412,1717,1258,2975,5387,8919,13191,549.04,84.15,56.9,34.36
23-12-2021,PAREDES DE COURA,21,2,248,"[240,480]",Elevado,,,,21,Norte,VIANA DO CASTELO,1605,13818.59,8535,466,528,407,465,515,980,1387,1915,2381,61.76,17.23,13.86,10.04
23-12-2021,PEDRÓGÃO GRANDE,11,1,322,"[240,480]",Elevado,,,,11,Centro,LEIRIA,1013,12874.75,3410,175,173,196,221,252,473,669,842,1017,26.49,7.9,6.54,5.2
23-12-2021,PENACOVA,67,5,491,"[480,960]",Muito Elevado,,,,67,Centro,COIMBRA,0613,21673.23,13694,968,923,745,621,703,1324,2069,2992,3960,63.18,18.27,13.81,9.55
23-12-2021,PENAFIEL,304,22,435,"[240,480]",Elevado,,,,304,Norte,PORTO,1311,21224.27,69772,3648,2823,2032,1663,1230,2893,4925,7748,11396,328.74,53.69,36.51,23.2
23-12-2021,PENALVA DO CASTELO,34,2,476,"[240,480]",Elevado,,,,34,Centro,VISEU,1811,13433.92,7115,449,457,413,391,426,817,1230,1687,2136,52.96,15.9,12.56,9.16
23-12-2021,PENAMACOR,20,1,423,"[240,480]",Elevado,,,,20,Centro,CASTELO BRANCO,0507,56370.69,4755,262,248,273,451,633,1084,1357,1605,1867,8.44,3.31,2.85,2.41
23-12-2021,PENEDONO,9,1,350,"[240,480]",Elevado,,,,9,Norte,VISEU,1812,13370.75,2591,172,113,129,156,138,294,423,536,708,19.38,5.3,4.01,3.16
23-12-2021,PENELA,27,2,501,"[480,960]",Muito Elevado,,,,27,Centro,COIMBRA,0614,13480.0,5397,314,324,274,359,344,703,977,1301,1615,40.04,11.98,9.65,7.25
23-12-2021,PENICHE,148,11,558,"[480,960]",Muito Elevado,,,,148,Lisboa e Vale do Tejo,LEIRIA,1014,7754.98,26501,1746,1504,1203,926,707,1633,2836,4340,6086,341.73,78.48,55.96,36.57
23-12-2021,PESO DA RÉGUA,43,3,274,"[240,480]",Elevado,,,,43,Norte,VILA REAL,1708,9486.01,15773,1076,843,650,659,455,1114,1764,2607,3683,166.28,38.83,27.48,18.6
23-12-2021,PINHEL,79,6,925,"[480,960]",Muito Elevado,,,,79,Centro,GUARDA,0910,48452.12,8511,577,566,551,538,689,1227,1778,2344,2921,17.57,6.03,4.84,3.67
23-12-2021,POMBAL,390,28,757,"[480,960]",Muito Elevado,,,,390,Centro,LEIRIA,1015,62600.28,51461,3187,2791,2494,2328,2027,4355,6849,9640,12827,82.21,20.49,15.4,10.94
23-12-2021,PONTA DELGADA,281,20,413,"[240,480]",Elevado,,,,281,Açores,AÇORES,4203,23298.65,67935,3108,2435,1726,1133,902,2035,3761,6196,9304,291.58,39.93,26.59,16.14
23-12-2021,PONTA DO SOL,47,3,549,"[480,960]",Muito Elevado,,,,47,Madeira,MADEIRA,3105,4622.03,8593,319,283,347,208,221,429,776,1059,1378,185.92,29.81,22.91,16.79
23-12-2021,PONTE DA BARCA,118,8,1054,"[960,Max]",Extremamente Elevado,,,,118,Norte,VIANA DO CASTELO,1606,18211.37,11180,635,576,517,554,490,1044,1561,2137,2772,61.39,15.22,11.73,8.57
23-12-2021,PONTE DE LIMA,214,15,519,"[480,960]",Muito Elevado,,,,214,Norte,VIANA DO CASTELO,1607,32025.46,41315,2321,2022,1720,1596,1462,3058,4778,6800,9121,129.01,28.48,21.23,14.92
23-12-2021,PONTE DE SOR,61,4,404,"[240,480]",Elevado,,,,61,Alentejo,PORTALEGRE,1213,83971.16,14994,939,800,716,739,831,1570,2286,3086,4025,17.86,4.79,3.68,2.72
23-12-2021,PORTALEGRE,58,4,260,"[240,480]",Elevado,,,,58,Alentejo,PORTALEGRE,1214,44713.64,22172,1577,1351,1137,993,984,1977,3114,4465,6042,49.59,13.51,9.99,6.96
23-12-2021,PORTEL,6,0,104,"[0,120]",Baixo a Moderado,,,,6,Alentejo,ÉVORA,0709,60100.57,5828,336,358,283,331,305,636,919,1277,1613,9.7,2.68,2.12,1.53
23-12-2021,PORTIMÃO,527,38,950,"[480,960]",Muito Elevado,,,,527,Algarve,FARO,0811,18206.29,55483,3182,2927,2116,1582,1400,2982,5098,8025,11207,304.75,61.56,44.08,28.0
23-12-2021,PORTO,2092,149,966,"[960,Max]",Extremamente Elevado,,,,2092,Norte,PORTO,1312,4142.02,216606,15790,15193,11280,9409,10044,19453,30733,45926,61716,5229.5,1490.0,1108.79,741.98
23-12-2021,PORTO DE MÓS,172,12,737,"[480,960]",Muito Elevado,,,,172,Centro,LEIRIA,1016,26183.41,23275,1355,1210,1034,888,872,1760,2794,4004,5359,88.89,20.47,15.29,10.67
23-12-2021,PORTO MONIZ,7,1,303,"[240,480]",Elevado,,,,7,Madeira,MADEIRA,3106,8293.38,2342,143,130,95,98,120,218,313,443,586,28.24,7.07,5.34,3.77
23-12-2021,PORTO SANTO,148,11,2848,"[960,Max]",Extremamente Elevado,,,,148,Madeira,MADEIRA,3201,4300.7,5202,240,157,134,110,68,178,312,469,709,120.95,16.48,10.9,7.25
23-12-2021,PÓVOA DE LANHOSO,116,8,540,"[480,960]",Muito Elevado,,,,116,Norte,BRAGA,0309,13465.29,21499,1175,909,732,673,624,1297,2029,2938,4113,159.67,30.55,21.82,15.07
23-12-2021,PÓVOA DE VARZIM,274,20,436,"[240,480]",Elevado,,,,274,Norte,PORTO,1313,8220.59,62784,3712,3120,2134,1594,1305,2899,5033,8153,11865,763.7,144.33,99.17,61.22
23-12-2021,POVOAÇÃO,20,1,339,"[240,480]",Elevado,,,,20,Açores,AÇORES,4204,10640.77,5927,293,212,191,144,134,278,469,681,974,55.7,9.15,6.4,4.41
23-12-2021,VILA DA PRAIA DA VITÓRIA,28,2,132,"[120,240]",Moderado,,,,28,Açores,AÇORES,4302,16127.06,21317,1133,789,619,436,336,772,1391,2180,3313,132.18,20.54,13.52,8.63
23-12-2021,PROENÇA-A-NOVA,34,2,469,"[240,480]",Elevado,,,,34,Centro,CASTELO BRANCO,0508,39539.96,7298,508,465,389,400,560,960,1349,1814,2322,18.46,5.87,4.59,3.41
23-12-2021,REDONDO,36,3,573,"[480,960]",Muito Elevado,,,,36,Alentejo,ÉVORA,0710,36950.87,6353,349,325,288,288,354,642,930,1255,1604,17.19,4.34,3.4,2.52
23-12-2021,REGUENGOS DE MONSARAZ,21,2,212,"[120,240]",Moderado,,,,21,Alentejo,ÉVORA,0711,46399.72,10015,602,511,455,462,473,935,1390,1901,2503,21.58,5.39,4.1,3.0
23-12-2021,RESENDE,59,4,579,"[480,960]",Muito Elevado,,,,59,Norte,VISEU,1813,12334.93,10137,560,493,448,433,422,855,1303,1796,2356,82.18,19.1,14.56,10.56
23-12-2021,RIBEIRA BRAVA,91,6,728,"[480,960]",Muito Elevado,,,,91,Madeira,MADEIRA,3107,6544.88,12435,648,500,411,311,287,598,1009,1509,2157,189.99,32.96,23.06,15.42
23-12-2021,RIBEIRA DE PENA,15,1,251,"[240,480]",Elevado,,,,15,Norte,VILA REAL,1709,21745.98,6016,371,301,290,310,368,678,968,1269,1640,27.66,7.54,5.84,4.45
23-12-2021,RIBEIRA GRANDE,67,5,204,"[120,240]",Moderado,,,,67,Açores,AÇORES,4205,18015.13,32811,1163,689,512,345,253,598,1110,1799,2962,182.13,16.44,9.99,6.16
23-12-2021,RIO MAIOR,74,5,365,"[240,480]",Elevado,,,,74,Lisboa e Vale do Tejo,SANTARÉM,1414,27276.45,20379,1251,1144,941,795,648,1443,2384,3528,4779,74.71,17.52,12.93,8.74
23-12-2021,SABROSA,10,1,170,"[120,240]",Moderado,,,,10,Norte,VILA REAL,1710,15692.45,5918,393,314,304,302,350,652,956,1270,1663,37.71,10.6,8.09,6.09
23-12-2021,SABUGAL,60,4,570,"[480,960]",Muito Elevado,,,,60,Centro,GUARDA,0911,82269.82,10585,724,707,694,796,1009,1805,2499,3206,3930,12.87,4.78,3.9,3.04
23-12-2021,SALVATERRA DE MAGOS,75,5,354,"[240,480]",Elevado,,,,75,Lisboa e Vale do Tejo,SANTARÉM,1415,24393.2,21295,1275,1181,1060,799,772,1571,2631,3812,5087,87.3,20.85,15.63,10.79
23-12-2021,SANTA COMBA DÃO,30,2,287,"[240,480]",Elevado,,,,30,Centro,VISEU,1814,11194.77,10452,732,684,569,538,464,1002,1571,2255,2987,93.36,26.68,20.14,14.03
23-12-2021,SANTA CRUZ,388,28,857,"[480,960]",Muito Elevado,,,,388,Madeira,MADEIRA,3108,8150.28,45281,1817,1301,974,716,523,1239,2213,3514,5331,555.6,65.41,43.12,27.15
23-12-2021,SANTA CRUZ DA GRACIOSA,20,1,479,"[240,480]",Elevado,,,,20,Açores,AÇORES,4401,6065.78,4208,228,180,163,124,145,269,432,612,840,69.37,13.85,10.09,7.12
23-12-2021,SANTA CRUZ DAS FLORES,2,0,92,"[0,120]",Baixo a Moderado,,,,2,Açores,AÇORES,4802,7091.44,2165,125,98,74,56,51,107,181,279,404,30.53,5.7,3.93,2.55
23-12-2021,SANTA MARIA DA FEIRA,936,67,675,"[480,960]",Muito Elevado,,,,936,Norte,AVEIRO,0109,21587.65,138636,8182,6743,4771,3856,3079,6935,11706,18449,26631,642.19,123.36,85.46,54.22
23-12-2021,SANTA MARTA DE PENAGUIÃO,3,0,46,"[0,120]",Baixo a Moderado,,,,3,Norte,VILA REAL,1711,6928.13,6599,483,373,337,316,317,633,970,1343,1826,95.25,26.36,19.39,14.0
23-12-2021,SANTANA,24,2,361,"[240,480]",Elevado,,,,24,Madeira,MADEIRA,3109,9547.3,6711,418,353,343,282,277,559,902,1255,1673,70.29,17.52,13.15,9.45
23-12-2021,SANTARÉM,469,33,816,"[480,960]",Muito Elevado,,,,469,Lisboa e Vale do Tejo,SANTARÉM,1416,55253.58,57421,3654,3441,2760,2466,2206,4672,7432,10873,14527,103.92,26.29,19.68,13.45
23-12-2021,SANTIAGO DO CACÉM,92,7,318,"[240,480]",Elevado,,,,92,Alentejo,SETÚBAL,1509,105969.29,28791,2144,1689,1472,1295,1215,2510,3982,5671,7815,27.17,7.37,5.35,3.76
23-12-2021,SANTO TIRSO,235,17,345,"[240,480]",Elevado,,,,235,Norte,PORTO,1314,13655.52,68055,4911,3935,2761,2257,1810,4067,6828,10763,15674,498.35,114.78,78.82,50.0
23-12-2021,SÃO BRÁS DE ALPORTEL,172,12,1649,"[960,Max]",Extremamente Elevado,,,,172,Algarve,FARO,0812,15336.92,10416,596,468,467,404,401,805,1272,1740,2336,67.91,15.23,11.35,8.29
23-12-2021,SÃO JOÃO DA MADEIRA,214,15,975,"[960,Max]",Extremamente Elevado,,,,214,Norte,AVEIRO,0116,794.3,21958,1347,1069,796,601,593,1194,1990,3059,4406,2765.49,554.91,385.26,250.63
23-12-2021,SÃO JOÃO DA PESQUEIRA,21,2,297,"[240,480]",Elevado,,,,21,Norte,VISEU,1815,26610.85,7125,417,330,294,328,328,656,950,1280,1697,26.77,6.38,4.81,3.57
23-12-2021,SÃO PEDRO DO SUL,43,3,279,"[240,480]",Elevado,,,,43,Centro,VISEU,1816,34895.09,15403,990,962,861,759,909,1668,2529,3491,4481,44.14,12.84,10.0,7.25
23-12-2021,SÃO ROQUE DO PICO,1,0,31,"[0,120]",Baixo a Moderado,,,,1,Açores,AÇORES,4603,14236.1,3266,199,141,93,96,113,209,302,443,642,22.94,4.51,3.11,2.12
23-12-2021,SÃO VICENTE,22,2,430,"[240,480]",Elevado,,,,22,Madeira,MADEIRA,3110,7883.71,5143,272,264,266,225,280,505,771,1035,1307,65.23,16.58,13.13,9.78
23-12-2021,SARDOAL,18,1,484,"[480,960]",Muito Elevado,,,,18,Lisboa e Vale do Tejo,SANTARÉM,1417,9214.72,3741,227,178,148,165,248,413,561,739,966,40.6,10.48,8.02,6.09
23-12-2021,SÁTÃO,79,6,679,"[480,960]",Muito Elevado,,,,79,Centro,VISEU,1817,20194.11,11580,765,671,515,465,476,941,1456,2127,2892,57.34,14.32,10.53,7.21
23-12-2021,SEIA,124,9,559,"[480,960]",Muito Elevado,,,,124,Centro,GUARDA,0912,43568.83,22234,1807,1589,1238,1122,721,1843,3081,4670,6477,51.03,14.87,10.72,7.07
23-12-2021,SEIXAL,1278,91,762,"[480,960]",Muito Elevado,,,,1278,Lisboa e Vale do Tejo,SETÚBAL,1510,9545.17,167752,10586,9270,6661,4391,2930,7321,13982,23252,33838,1757.49,354.51,243.6,146.49
23-12-2021,SERNANCELHE,9,1,167,"[120,240]",Moderado,,,,9,Norte,VISEU,1818,22861.22,5396,305,293,286,273,260,533,819,1112,1417,23.6,6.2,4.86,3.58
23-12-2021,SERPA,42,3,296,"[240,480]",Elevado,,,,42,Alentejo,BEJA,0213,110563.34,14304,903,761,719,697,626,1323,2042,2803,3706,12.94,3.35,2.54,1.85
23-12-2021,SERTÃ,140,10,961,"[960,Max]",Extremamente Elevado,,,,140,Centro,CASTELO BRANCO,0509,44673.17,14577,870,779,790,767,1020,1787,2577,3356,4226,32.63,9.46,7.51,5.77
23-12-2021,SESIMBRA,300,21,579,"[480,960]",Muito Elevado,,,,300,Lisboa e Vale do Tejo,SETÚBAL,1511,19571.75,51858,2400,2321,1853,1257,1083,2340,4193,6514,8914,264.96,45.54,33.28,21.42
23-12-2021,SETÚBAL,645,46,560,"[480,960]",Muito Elevado,,,,645,Lisboa e Vale do Tejo,SETÚBAL,1512,23032.5,115126,7425,6929,5075,3775,2655,6430,11505,18434,25859,499.83,112.27,80.03,49.95
23-12-2021,SEVER DO VOUGA,24,2,213,"[120,240]",Moderado,,,,24,Centro,AVEIRO,0117,12987.56,11331,766,637,568,540,567,1107,1675,2312,3078,87.24,23.7,17.8,12.9
23-12-2021,SILVES,308,22,850,"[480,960]",Muito Elevado,,,,308,Algarve,FARO,0813,68006.23,36226,2137,1869,1610,1423,1600,3023,4633,6502,8639,53.27,12.7,9.56,6.81
23-12-2021,SINES,44,3,321,"[240,480]",Elevado,,,,44,Alentejo,SETÚBAL,1513,20330.17,13715,888,791,551,416,268,684,1235,2026,2914,67.46,14.33,9.97,6.07
23-12-2021,SINTRA,2799,200,715,"[480,960]",Muito Elevado,,,,2799,Lisboa e Vale do Tejo,LISBOA,1111,31922.73,391402,20490,18316,13545,9137,7284,16421,29966,48282,68772,1226.08,215.43,151.25,93.87
23-12-2021,SOBRAL DE MONTE AGRAÇO,65,5,609,"[480,960]",Muito Elevado,,,,65,Lisboa e Vale do Tejo,LISBOA,1112,5210.32,10651,564,507,352,272,212,484,836,1343,1907,204.43,36.6,25.78,16.05
23-12-2021,SOURE,195,14,1137,"[960,Max]",Extremamente Elevado,,,,195,Centro,COIMBRA,0615,26506.07,17120,1173,1142,1004,883,987,1870,2874,4016,5189,64.59,19.58,15.15,10.84
23-12-2021,SOUSEL,83,6,1872,"[960,Max]",Extremamente Elevado,,,,83,Alentejo,PORTALEGRE,1215,27932.18,4412,261,274,208,302,292,594,802,1076,1337,15.8,4.79,3.85,2.87
23-12-2021,TÁBUA,46,3,403,"[240,480]",Elevado,,,,46,Centro,COIMBRA,0616,19978.58,11368,729,584,524,430,464,894,1418,2002,2731,56.9,13.67,10.02,7.1
23-12-2021,TABUAÇO,9,1,150,"[120,240]",Moderado,,,,9,Norte,VISEU,1819,13385.67,6033,372,314,217,282,363,645,862,1176,1548,45.07,11.56,8.79,6.44
23-12-2021,TAROUCA,44,3,563,"[480,960]",Muito Elevado,,,,44,Norte,VISEU,1820,10008.49,7804,405,335,313,277,324,601,914,1249,1654,77.98,16.53,12.48,9.13
23-12-2021,TAVIRA,228,16,930,"[480,960]",Muito Elevado,,,,228,Algarve,FARO,0814,60696.7,24530,1493,1415,1252,1066,1277,2343,3595,5010,6503,40.41,10.71,8.25,5.92
23-12-2021,TERRAS DE BOURO,18,1,285,"[240,480]",Elevado,,,,18,Norte,BRAGA,0310,27746.07,6361,391,372,296,319,340,659,955,1327,1718,22.93,6.19,4.78,3.44
23-12-2021,TOMAR,425,30,1156,"[960,Max]",Extremamente Elevado,,,,425,Lisboa e Vale do Tejo,SANTARÉM,1418,35120.44,36748,2403,2189,1868,1853,1822,3675,5543,7732,10135,104.64,28.86,22.02,15.78
23-12-2021,TONDELA,200,14,759,"[480,960]",Muito Elevado,,,,200,Centro,VISEU,1821,37121.73,26357,1768,1722,1518,1475,1417,2892,4410,6132,7900,71.0,21.28,16.52,11.88
23-12-2021,TORRE DE MONCORVO,3,0,39,"[0,120]",Baixo a Moderado,,,,3,Norte,BRAGANÇA,0409,53155.67,7695,556,478,488,551,719,1270,1758,2236,2792,14.48,5.25,4.21,3.31
23-12-2021,TORRES NOVAS,297,21,849,"[480,960]",Muito Elevado,,,,297,Lisboa e Vale do Tejo,SANTARÉM,1419,26999.68,34933,2324,1979,1738,1406,1475,2881,4619,6598,8922,129.38,33.04,24.44,17.11
23-12-2021,TORRES VEDRAS,646,46,822,"[480,960]",Muito Elevado,,,,646,Lisboa e Vale do Tejo,LISBOA,1113,40714.89,78530,4513,3945,3447,2628,2104,4732,8179,12124,16637,192.88,40.86,29.78,20.09
23-12-2021,TRANCOSO,14,1,157,"[120,240]",Moderado,,,,14,Centro,GUARDA,0913,36152.47,8875,581,557,542,586,496,1082,1624,2181,2762,24.55,7.64,6.03,4.49
23-12-2021,TROFA,198,14,515,"[480,960]",Muito Elevado,,,,198,Norte,PORTO,1318,7201.76,38418,2336,1894,1231,939,684,1623,2854,4748,7084,533.44,98.36,65.93,39.63
23-12-2021,VAGOS,148,11,653,"[480,960]",Muito Elevado,,,,148,Centro,AVEIRO,0118,16491.5,22740,1320,1205,922,784,724,1508,2430,3635,4955,137.89,30.04,22.04,14.73
23-12-2021,VALE DE CAMBRA,146,10,684,"[480,960]",Muito Elevado,,,,146,Norte,AVEIRO,0119,14733.47,21327,1491,1363,1005,831,798,1629,2634,3997,5488,144.76,37.25,27.13,17.88
23-12-2021,VALENÇA,54,4,409,"[240,480]",Elevado,,,,54,Norte,VIANA DO CASTELO,1608,11712.86,13290,867,791,582,582,503,1085,1667,2458,3325,113.46,28.39,20.99,14.23
23-12-2021,VALONGO,555,40,570,"[480,960]",Muito Elevado,,,,555,Norte,PORTO,1315,7512.45,97444,5629,4696,3207,2462,1829,4291,7498,12194,17823,1297.18,237.26,162.33,99.81
23-12-2021,VALPAÇOS,48,3,321,"[240,480]",Elevado,,,,48,Norte,VILA REAL,1712,54873.93,14818,1217,1118,999,928,997,1925,2924,4042,5259,27.0,9.58,7.37,5.33
23-12-2021,VELAS,1,0,20,"[0,120]",Baixo a Moderado,,,,1,Açores,AÇORES,4502,11738.38,5093,278,208,166,153,113,266,432,640,918,43.39,7.82,5.45,3.68
23-12-2021,VENDAS NOVAS,19,1,170,"[120,240]",Moderado,,,,19,Alentejo,ÉVORA,0712,22238.88,11255,677,768,655,501,532,1033,1688,2456,3133,50.61,14.09,11.04,7.59
23-12-2021,VIANA DO ALENTEJO,1,0,20,"[0,120]",Baixo a Moderado,,,,1,Alentejo,ÉVORA,0713,39367.29,5145,245,208,235,210,214,424,659,867,1112,13.07,2.82,2.2,1.67
23-12-2021,VIANA DO CASTELO,427,31,506,"[480,960]",Muito Elevado,,,,427,Norte,VIANA DO CASTELO,1609,31902.01,84417,5470,4433,3591,3061,2982,6043,9634,14067,19537,264.61,61.24,44.09,30.2
23-12-2021,VIDIGUEIRA,7,1,128,"[120,240]",Moderado,,,,7,Alentejo,BEJA,0214,31661.09,5510,300,248,215,233,275,508,723,971,1271,17.4,4.01,3.07,2.28
23-12-2021,VIEIRA DO MINHO,37,3,314,"[240,480]",Elevado,,,,37,Norte,BRAGA,0311,21644.35,11842,703,594,525,548,482,1030,1555,2149,2852,54.71,13.18,9.93,7.18
23-12-2021,VILA DE REI,14,1,419,"[240,480]",Elevado,,,,14,Centro,CASTELO BRANCO,0510,19154.6,3323,169,128,172,247,302,549,721,849,1018,17.35,5.31,4.43,3.76
23-12-2021,VILA DO BISPO,43,3,835,"[480,960]",Muito Elevado,,,,43,Algarve,FARO,0815,17906.06,5154,302,302,314,232,233,465,779,1081,1383,28.78,7.72,6.04,4.35
23-12-2021,VILA DO CONDE,394,28,493,"[480,960]",Muito Elevado,,,,394,Norte,PORTO,1316,14902.77,79899,4726,3875,2819,2070,1743,3813,6632,10507,15233,536.13,102.21,70.5,44.5
23-12-2021,VILA DO PORTO,31,2,552,"[480,960]",Muito Elevado,,,,31,Açores,AÇORES,4101,9688.74,5616,274,212,135,96,123,219,354,566,840,57.96,8.67,5.84,3.65
23-12-2021,VILA FLOR,13,1,216,"[120,240]",Moderado,,,,13,Norte,BRAGANÇA,0410,26581.14,6044,429,362,422,294,331,625,1047,1409,1838,22.74,6.91,5.3,3.94
23-12-2021,VILA FRANCA DE XIRA,1015,72,715,"[480,960]",Muito Elevado,,,,1015,Lisboa e Vale do Tejo,LISBOA,1114,31819.39,141957,8501,6852,4869,3425,2472,5897,10766,17618,26119,446.14,82.09,55.37,33.84
23-12-2021,VILA FRANCA DO CAMPO,19,1,173,"[120,240]",Moderado,,,,19,Açores,AÇORES,4206,7796.82,11051,450,344,248,217,154,371,619,963,1413,141.73,18.12,12.35,7.94
23-12-2021,VILA NOVA DA BARQUINHA,37,3,490,"[480,960]",Muito Elevado,,,,37,Lisboa e Vale do Tejo,SANTARÉM,1420,4952.97,7461,415,406,392,364,338,702,1094,1500,1915,150.64,38.66,30.28,22.09
23-12-2021,VILA NOVA DE CERVEIRA,15,1,169,"[120,240]",Moderado,,,,15,Norte,VIANA DO CASTELO,1610,10846.66,8910,531,444,410,384,334,718,1128,1572,2103,82.14,19.39,14.49,10.4
23-12-2021,VILA NOVA DE FAMALICÃO,581,41,441,"[240,480]",Elevado,,,,581,Norte,BRAGA,0312,20159.26,131676,7817,6164,4202,3282,2749,6031,10233,16397,24214,653.19,120.12,81.34,50.76
23-12-2021,VILA NOVA DE FOZ CÔA,6,0,93,"[0,120]",Baixo a Moderado,,,,6,Centro,GUARDA,0914,39815.18,6503,442,385,390,398,429,827,1217,1602,2044,16.33,5.13,4.02,3.06
23-12-2021,VILA NOVA DE GAIA,1869,133,622,"[480,960]",Muito Elevado,,,,1869,Norte,PORTO,1317,16846.43,300472,18349,15568,10972,8224,6281,14505,25477,41045,59394,1783.64,352.57,243.65,151.23
23-12-2021,VILA NOVA DE PAIVA,55,4,1173,"[960,Max]",Extremamente Elevado,,,,55,Centro,VISEU,1822,17553.28,4687,289,272,233,217,241,458,691,963,1252,26.7,7.13,5.49,3.94
23-12-2021,VILA NOVA DE POIARES,24,2,345,"[240,480]",Elevado,,,,24,Centro,COIMBRA,0617,8445.3,6939,380,284,262,235,182,417,679,963,1343,82.17,15.9,11.4,8.04
23-12-2021,VILA POUCA DE AGUIAR,39,3,329,"[240,480]",Elevado,,,,39,Norte,VILA REAL,1713,43706.62,11961,860,817,733,601,627,1228,1961,2778,3638,27.37,8.32,6.36,4.49
23-12-2021,VILA REAL,219,16,439,"[240,480]",Elevado,,,,219,Norte,VILA REAL,1714,37880.28,49962,3025,2498,2065,1579,1466,3045,5110,7608,10633,131.9,28.07,20.08,13.49
23-12-2021,VILA REAL DE SANTO ANTÓNIO,153,11,815,"[480,960]",Muito Elevado,,,,153,Algarve,FARO,0816,6125.0,18749,1172,1069,811,569,586,1155,1966,3035,4207,306.11,68.69,49.55,32.1
23-12-2021,VILA VELHA DE RÓDÃO,7,1,223,"[120,240]",Moderado,,,,7,Centro,CASTELO BRANCO,0511,32991.16,3144,209,229,180,283,306,589,769,998,1207,9.53,3.66,3.03,2.33
23-12-2021,VILA VERDE,300,21,639,"[480,960]",Muito Elevado,,,,300,Norte,BRAGA,0313,22866.52,46911,2365,2063,1667,1494,1437,2931,4598,6661,9026,205.15,39.47,29.13,20.11
23-12-2021,VILA VIÇOSA,8,1,106,"[0,120]",Baixo a Moderado,,,,8,Alentejo,ÉVORA,0714,19485.89,7656,487,379,342,345,324,669,1011,1390,1877,39.29,9.63,7.13,5.19
23-12-2021,VIMIOSO,25,2,632,"[480,960]",Muito Elevado,,,,25,Norte,BRAGANÇA,0411,48158.51,4023,274,230,261,293,335,628,889,1119,1393,8.35,2.89,2.32,1.85
23-12-2021,VINHAIS,20,1,263,"[240,480]",Elevado,,,,20,Norte,BRAGANÇA,0412,69475.09,7746,599,577,636,641,815,1456,2092,2669,3268,11.15,4.7,3.84,3.01
23-12-2021,VISEU,832,59,856,"[480,960]",Muito Elevado,,,,832,Centro,VISEU,1823,50710.14,97249,5769,5038,4140,3158,2710,5868,10008,15046,20815,191.77,41.05,29.67,19.74
23-12-2021,VIZELA,71,5,297,"[240,480]",Elevado,,,,71,Norte,BRAGA,0314,2469.83,23897,1258,928,655,509,371,880,1535,2463,3721,967.49,150.65,99.72,62.15
23-12-2021,VOUZELA,86,6,894,"[480,960]",Muito Elevado,,,,86,Centro,VISEU,1824,19369.46,9619,626,605,554,532,507,1039,1593,2198,2824,49.66,14.58,11.35,8.22
30-12-2021,ABRANTES,292,21,832,"[480,960]",Muito Elevado,,,,292,Lisboa e Vale do Tejo,SANTARÉM,1401,71469.08,35130,2473,2213,1730,1748,2021,3769,5499,7712,10185,49.15,14.25,10.79,7.69
30-12-2021,ÁGUEDA,404,29,876,"[480,960]",Muito Elevado,,,,404,Centro,AVEIRO,0101,33527.44,46075,3237,2713,2090,1635,1496,3131,5221,7934,11171,137.43,33.32,23.66,15.57
30-12-2021,AGUIAR DA BEIRA,12,1,259,"[240,480]",Elevado,,,,12,Centro,GUARDA,0901,20676.57,4652,304,281,235,239,148,387,622,903,1207,22.5,5.84,4.37,3.01
30-12-2021,ALANDROAL,27,2,531,"[480,960]",Muito Elevado,,,,27,Alentejo,ÉVORA,0701,54267.81,4992,307,256,296,299,377,676,972,1228,1535,9.2,2.83,2.26,1.79
30-12-2021,ALBERGARIA-A-VELHA,259,19,1074,"[960,Max]",Extremamente Elevado,,,,259,Centro,AVEIRO,0102,15882.5,24144,1550,1298,996,687,680,1367,2363,3661,5211,152.02,32.81,23.05,14.88
30-12-2021,ALBUFEIRA,430,31,1035,"[960,Max]",Extremamente Elevado,,,,430,Algarve,FARO,0801,14066.42,41528,2067,1717,1425,985,858,1843,3268,4985,7052,295.24,50.14,35.44,23.23
30-12-2021,ALCÁCER DO SAL,71,5,606,"[480,960]",Muito Elevado,,,,71,Alentejo,SETÚBAL,1501,149987.3,11659,884,814,623,623,602,1225,1848,2662,3546,7.77,2.36,1.77,1.23
30-12-2021,ALCANENA,148,11,1158,"[960,Max]",Extremamente Elevado,,,,148,Lisboa e Vale do Tejo,SANTARÉM,1402,12732.86,12809,891,744,628,536,588,1124,1752,2496,3387,100.6,26.6,19.6,13.76
30-12-2021,ALCOBAÇA,1058,76,1976,"[960,Max]",Extremamente Elevado,,,,1058,Lisboa e Vale do Tejo,LEIRIA,1001,40814.09,53555,3420,2927,2466,2059,1676,3735,6201,9128,12548,131.22,30.74,22.36,15.19
30-12-2021,ALCOCHETE,258,18,1304,"[960,Max]",Extremamente Elevado,,,,258,Lisboa e Vale do Tejo,SETÚBAL,1502,12836.48,19787,857,834,691,476,447,923,1614,2448,3305,154.15,25.75,19.07,12.57
30-12-2021,ALCOUTIM,20,1,915,"[480,960]",Muito Elevado,,,,20,Algarve,FARO,0802,57536.33,2159,191,188,163,190,267,457,620,808,999,3.75,1.74,1.4,1.08
30-12-2021,ALENQUER,626,45,1422,"[960,Max]",Extremamente Elevado,,,,626,Lisboa e Vale do Tejo,LISBOA,1101,30421.92,44052,2298,2062,1629,1330,1155,2485,4114,6176,8474,144.8,27.85,20.3,13.52
30-12-2021,ALFÂNDEGA DA FÉ,17,1,378,"[240,480]",Elevado,,,,17,Norte,BRAGANÇA,0401,32194.64,4550,325,277,301,274,325,599,900,1177,1502,14.13,4.67,3.66,2.8
30-12-2021,ALIJÓ,69,5,646,"[480,960]",Muito Elevado,,,,69,Norte,VILA REAL,1701,29759.89,10625,766,687,635,542,666,1208,1843,2530,3296,35.7,11.08,8.5,6.19
30-12-2021,ALJEZUR,30,2,536,"[480,960]",Muito Elevado,,,,30,Algarve,FARO,0803,32349.95,5594,316,336,335,320,410,730,1065,1401,1717,17.29,5.31,4.33,3.29
30-12-2021,ALJUSTREL,111,8,1351,"[960,Max]",Extremamente Elevado,,,,111,Alentejo,BEJA,0201,45847.41,8247,635,521,443,347,358,705,1148,1669,2304,17.99,5.03,3.64,2.5
30-12-2021,ALMADA,3389,242,2005,"[960,Max]",Extremamente Elevado,,,,3389,Lisboa e Vale do Tejo,SETÚBAL,1503,7000.89,169039,10469,9777,7876,6144,5111,11255,19131,28908,39377,2414.5,562.45,412.91,273.26
30-12-2021,ALMEIDA,30,2,518,"[480,960]",Muito Elevado,,,,30,Centro,GUARDA,0902,51798.46,5830,441,419,396,458,393,851,1247,1666,2107,11.26,4.07,3.22,2.41
30-12-2021,ALMEIRIM,257,18,1142,"[960,Max]",Extremamente Elevado,,,,257,Lisboa e Vale do Tejo,SANTARÉM,1403,22212.05,22546,1342,1353,1106,866,843,1709,2815,4168,5510,101.5,24.81,18.76,12.67
30-12-2021,ALMODÔVAR,61,4,901,"[480,960]",Muito Elevado,,,,61,Alentejo,BEJA,0202,77788.03,6725,414,443,396,373,328,701,1097,1540,1954,8.65,2.51,1.98,1.41
30-12-2021,ALPIARÇA,45,3,644,"[480,960]",Muito Elevado,,,,45,Lisboa e Vale do Tejo,SANTARÉM,1404,9536.33,7059,515,486,363,333,274,607,970,1456,1971,74.02,20.67,15.27,10.17
30-12-2021,ALTER DO CHÃO,25,2,797,"[480,960]",Muito Elevado,,,,25,Alentejo,PORTALEGRE,1201,36206.62,3165,201,163,136,208,187,395,531,694,895,8.74,2.47,1.92,1.47
30-12-2021,ALVAIÁZERE,60,4,910,"[480,960]",Muito Elevado,,,,60,Centro,LEIRIA,1002,16047.76,6597,419,389,346,406,539,945,1291,1680,2099,41.11,13.08,10.47,8.04
30-12-2021,ALVITO,13,1,527,"[480,960]",Muito Elevado,,,,13,Alentejo,BEJA,0203,26485.32,2477,145,110,105,111,89,200,305,415,560,9.35,2.11,1.57,1.15
30-12-2021,AMADORA,3684,263,2001,"[960,Max]",Extremamente Elevado,,,,3684,Lisboa e Vale do Tejo,LISBOA,1115,2378.47,184106,11186,10936,8780,6460,5890,12350,21130,32066,43252,7742.05,1818.84,1348.44,888.56
30-12-2021,AMARANTE,536,38,1008,"[960,Max]",Extremamente Elevado,,,,536,Norte,PORTO,1301,30133.15,53193,3086,2413,1812,1643,1311,2954,4766,7179,10265,176.53,34.07,23.82,15.82
30-12-2021,AMARES,232,17,1277,"[960,Max]",Extremamente Elevado,,,,232,Norte,BRAGA,0301,8195.41,18129,1001,829,622,489,524,1013,1635,2464,3465,221.22,42.28,30.07,19.95
30-12-2021,ANADIA,267,19,979,"[960,Max]",Extremamente Elevado,,,,267,Centro,AVEIRO,0103,21663.48,27258,1931,1698,1376,1208,1262,2470,3846,5544,7475,125.83,34.51,25.59,17.75
30-12-2021,ANGRA DO HEROÍSMO,134,10,395,"[240,480]",Elevado,,,,134,Açores,AÇORES,4301,23899.66,33807,2006,1473,1122,768,635,1403,2525,3998,6004,141.45,25.12,16.73,10.56
30-12-2021,ANSIÃO,113,8,937,"[480,960]",Muito Elevado,,,,113,Centro,LEIRIA,1003,17609.42,12039,727,709,646,694,530,1224,1870,2579,3306,68.37,18.77,14.65,10.62
30-12-2021,ARCOS DE VALDEVEZ,310,22,1482,"[960,Max]",Extremamente Elevado,,,,310,Norte,VIANA DO CASTELO,1601,44759.64,20926,1329,1338,1282,1343,1515,2858,4140,5478,6807,46.75,15.21,12.24,9.25
30-12-2021,ARGANIL,71,5,646,"[480,960]",Muito Elevado,,,,71,Centro,COIMBRA,0601,33283.93,11014,672,648,612,559,596,1155,1767,2415,3087,33.09,9.27,7.26,5.31
30-12-2021,ARMAMAR,33,2,577,"[480,960]",Muito Elevado,,,,33,Norte,VISEU,1801,11723.73,5769,357,305,309,285,310,595,904,1209,1566,49.21,13.36,10.31,7.71
30-12-2021,AROUCA,195,14,941,"[480,960]",Muito Elevado,,,,195,Norte,AVEIRO,0104,32910.52,20720,1306,1047,753,683,683,1366,2119,3166,4472,62.96,13.59,9.62,6.44
30-12-2021,ARRAIOLOS,47,3,684,"[480,960]",Muito Elevado,,,,47,Alentejo,ÉVORA,0702,68374.55,6928,435,384,283,367,480,847,1130,1514,1949,10.13,2.85,2.21,1.65
30-12-2021,ARRONCHES,17,1,615,"[480,960]",Muito Elevado,,,,17,Alentejo,PORTALEGRE,1202,31464.72,2820,155,142,162,187,179,366,528,670,825,8.96,2.62,2.13,1.68
30-12-2021,ARRUDA DOS VINHOS,199,14,1293,"[960,Max]",Extremamente Elevado,,,,199,Lisboa e Vale do Tejo,LISBOA,1102,7795.93,15412,738,738,562,509,438,947,1509,2247,2985,197.69,38.29,28.82,19.36
30-12-2021,AVEIRO,915,65,1162,"[960,Max]",Extremamente Elevado,,,,915,Centro,AVEIRO,0105,19757.57,78734,4520,4004,3050,2250,2103,4353,7403,11407,15927,398.49,80.61,57.73,37.47
30-12-2021,AVIS,72,5,1693,"[960,Max]",Extremamente Elevado,,,,72,Alentejo,PORTALEGRE,1203,60596.51,4247,315,225,206,251,273,524,730,955,1270,7.01,2.1,1.58,1.2
30-12-2021,AZAMBUJA,264,19,1161,"[960,Max]",Extremamente Elevado,,,,264,Lisboa e Vale do Tejo,LISBOA,1103,26265.65,22716,1322,1171,1070,798,618,1416,2486,3657,4979,86.48,18.96,13.92,9.46
30-12-2021,BAIÃO,111,8,592,"[480,960]",Muito Elevado,,,,111,Norte,PORTO,1302,17452.83,18748,1070,862,714,686,725,1411,2125,2987,4057,107.42,23.25,17.11,12.18
30-12-2021,BARCELOS,1607,115,1383,"[960,Max]",Extremamente Elevado,,,,1607,Norte,BRAGA,0302,37890.14,116187,6721,5325,3619,2991,2562,5553,9172,14497,21218,306.64,56.0,38.26,24.21
30-12-2021,BARRANCOS,4,0,246,"[240,480]",Elevado,,,,4,Alentejo,BEJA,0204,16841.73,1634,90,65,65,94,61,155,220,285,375,9.7,2.23,1.69,1.31
30-12-2021,BARREIRO,1344,96,1788,"[960,Max]",Extremamente Elevado,,,,1344,Lisboa e Vale do Tejo,SETÚBAL,1504,3639.07,75147,5194,5565,4459,3105,1767,4872,9331,14896,20090,2065.05,552.07,409.34,256.42
30-12-2021,BATALHA,264,19,1652,"[960,Max]",Extremamente Elevado,,,,264,Centro,LEIRIA,1004,10341.6,15963,873,762,649,529,549,1078,1727,2489,3362,154.35,32.51,24.07,16.7
30-12-2021,BEJA,207,15,615,"[480,960]",Muito Elevado,,,,207,Alentejo,BEJA,0205,114647.55,33579,2005,1840,1386,1272,1039,2311,3697,5537,7542,29.29,6.58,4.83,3.22
30-12-2021,BELMONTE,44,3,689,"[480,960]",Muito Elevado,,,,44,Centro,CASTELO BRANCO,0501,11875.91,6398,444,321,325,310,355,665,990,1311,1755,53.87,14.78,11.04,8.34
30-12-2021,BENAVENTE,415,30,1357,"[960,Max]",Extremamente Elevado,,,,415,Lisboa e Vale do Tejo,SANTARÉM,1405,52138.39,30602,1468,1376,1141,876,643,1519,2660,4036,5504,58.69,10.56,7.74,5.1
30-12-2021,BOMBARRAL,187,13,1490,"[960,Max]",Extremamente Elevado,,,,187,Lisboa e Vale do Tejo,LEIRIA,1005,9128.55,12558,875,714,561,491,429,920,1481,2195,3070,137.56,33.63,24.04,16.22
30-12-2021,BORBA,15,1,225,"[120,240]",Moderado,,,,15,Alentejo,ÉVORA,0703,14518.65,6736,430,375,279,436,392,828,1107,1482,1912,46.39,13.17,10.21,7.62
30-12-2021,BOTICAS,74,5,1482,"[960,Max]",Extremamente Elevado,,,,74,Norte,VILA REAL,1702,32195.66,4998,347,306,311,305,380,685,996,1302,1649,15.52,5.12,4.04,3.09
30-12-2021,BRAGA,3476,248,1903,"[960,Max]",Extremamente Elevado,,,,3476,Norte,BRAGA,0303,18339.95,182679,10029,7963,5241,4320,3671,7991,13232,21195,31224,996.07,170.25,115.57,72.15
30-12-2021,BRAGANÇA,433,31,1289,"[960,Max]",Extremamente Elevado,,,,433,Norte,BRAGANÇA,0402,117357.27,33607,2402,1855,1652,1393,1163,2556,4208,6063,8465,28.64,7.21,5.17,3.59
30-12-2021,CABECEIRAS DE BASTO,140,10,895,"[480,960]",Muito Elevado,,,,140,Norte,BRAGA,0304,24182.16,15628,774,594,544,575,574,1149,1693,2287,3061,64.63,12.66,9.46,7.0
30-12-2021,CADAVAL,135,10,990,"[960,Max]",Extremamente Elevado,,,,135,Lisboa e Vale do Tejo,LISBOA,1104,17489.3,13673,813,796,756,621,625,1246,2002,2798,3611,78.18,20.65,16.0,11.45
30-12-2021,CALDAS DA RAINHA,733,52,1412,"[960,Max]",Extremamente Elevado,,,,733,Lisboa e Vale do Tejo,LEIRIA,1006,25569.47,51912,3035,2684,2186,1899,1705,3604,5790,8474,11509,203.03,45.01,33.14,22.64
30-12-2021,CALHETA,79,6,729,"[480,960]",Muito Elevado,,,,79,Madeira,MADEIRA,3101,11150.43,10867,576,497,507,399,415,814,1321,1818,2394,97.46,21.47,16.3,11.85
30-12-2021,CALHETA (AÇORES),5,0,158,"[120,240]",Moderado,,,,5,Açores,AÇORES,4501,12626.4,3184,215,159,141,139,122,261,402,561,776,25.22,6.15,4.44,3.18
30-12-2021,CÂMARA DE LOBOS,713,51,2117,"[960,Max]",Extremamente Elevado,,,,713,Madeira,MADEIRA,3102,5216.67,33675,1396,1059,834,545,381,926,1760,2819,4215,645.49,80.79,54.03,33.74
30-12-2021,CAMINHA,176,13,1109,"[960,Max]",Extremamente Elevado,,,,176,Norte,VIANA DO CASTELO,1602,13652.14,15877,1046,944,818,646,656,1302,2120,3064,4110,116.3,30.11,22.44,15.53
30-12-2021,CAMPO MAIOR,163,12,2066,"[960,Max]",Extremamente Elevado,,,,163,Alentejo,PORTALEGRE,1204,24720.16,7874,471,364,351,279,327,606,957,1321,1792,31.85,7.25,5.34,3.87
30-12-2021,CANTANHEDE,304,22,868,"[480,960]",Muito Elevado,,,,304,Centro,COIMBRA,0602,39088.02,35011,2346,2096,1880,1709,1451,3160,5040,7136,9482,89.57,24.26,18.26,12.89
30-12-2021,CARRAZEDA DE ANSIÃES,52,4,909,"[480,960]",Muito Elevado,,,,52,Norte,BRAGANÇA,0403,27924.09,5666,424,389,391,312,465,777,1168,1557,1981,20.29,7.09,5.58,4.18
30-12-2021,CARREGAL DO SAL,39,3,419,"[240,480]",Elevado,,,,39,Centro,VISEU,1802,11689.21,9271,587,562,486,462,376,838,1324,1886,2473,79.31,21.16,16.13,11.33
30-12-2021,CARTAXO,308,22,1291,"[960,Max]",Extremamente Elevado,,,,308,Lisboa e Vale do Tejo,SANTARÉM,1406,15817.28,23843,1415,1376,1142,861,632,1493,2635,4011,5426,150.74,34.3,25.36,16.66
30-12-2021,CASCAIS,3619,258,1694,"[960,Max]",Extremamente Elevado,,,,3619,Lisboa e Vale do Tejo,LISBOA,1105,9740.17,213608,12151,11444,8680,6469,5248,11717,20397,31841,43992,2193.1,451.66,326.91,209.41
30-12-2021,CASTANHEIRA DE PÊRA,10,1,388,"[240,480]",Elevado,,,,10,Centro,LEIRIA,1007,6677.45,2614,233,195,157,190,187,377,534,729,962,39.15,14.41,10.92,8.0
30-12-2021,CASTELO BRANCO,538,38,1035,"[960,Max]",Extremamente Elevado,,,,538,Centro,CASTELO BRANCO,0502,143819.15,51987,3528,3042,2499,2229,2225,4454,6953,9995,13523,36.15,9.4,6.95,4.83
30-12-2021,CASTELO DE PAIVA,207,15,1340,"[960,Max]",Extremamente Elevado,,,,207,Norte,AVEIRO,0106,11500.53,15454,881,697,545,420,431,851,1396,2093,2974,134.37,25.86,18.2,12.14
30-12-2021,CASTELO DE VIDE,12,1,415,"[240,480]",Elevado,,,,12,Alentejo,PORTALEGRE,1205,26491.24,2919,204,173,179,147,170,317,496,669,873,11.02,3.3,2.53,1.87
30-12-2021,CASTRO DAIRE,109,8,789,"[480,960]",Muito Elevado,,,,109,Centro,VISEU,1803,37904.13,13823,942,857,765,732,773,1505,2270,3127,4069,36.47,10.74,8.25,5.99
30-12-2021,CASTRO MARIM,102,7,1630,"[960,Max]",Extremamente Elevado,,,,102,Algarve,FARO,0804,30084.37,6237,370,345,334,322,344,666,1000,1345,1715,20.73,5.7,4.47,3.32
30-12-2021,CASTRO VERDE,121,9,1742,"[960,Max]",Extremamente Elevado,,,,121,Alentejo,BEJA,0206,56944.23,6949,437,347,303,275,227,502,805,1152,1589,12.2,2.79,2.02,1.41
30-12-2021,CELORICO DA BEIRA,43,3,620,"[480,960]",Muito Elevado,,,,43,Centro,GUARDA,0903,24721.63,6928,430,416,363,369,535,904,1267,1683,2113,28.02,8.55,6.81,5.12
30-12-2021,CELORICO DE BASTO,133,9,698,"[480,960]",Muito Elevado,,,,133,Norte,BRAGA,0305,18107.02,19040,1001,802,668,728,729,1457,2125,2927,3928,105.15,21.69,16.17,11.74
30-12-2021,CHAMUSCA,55,4,596,"[480,960]",Muito Elevado,,,,55,Lisboa e Vale do Tejo,SANTARÉM,1407,74600.54,9197,629,583,553,465,579,1044,1597,2180,2809,12.33,3.77,2.92,2.14
30-12-2021,CHAVES,288,21,732,"[480,960]",Muito Elevado,,,,288,Norte,VILA REAL,1703,59122.95,39343,2676,2429,1991,1886,1918,3804,5795,8224,10900,66.54,18.44,13.91,9.8
30-12-2021,CINFÃES,149,11,817,"[480,960]",Muito Elevado,,,,149,Norte,VISEU,1804,23928.76,18244,1067,902,779,734,758,1492,2271,3173,4240,76.24,17.72,13.26,9.49
30-12-2021,COIMBRA,2184,156,1628,"[960,Max]",Extremamente Elevado,,,,2184,Centro,COIMBRA,0603,31939.94,134166,9489,8734,6353,5139,5074,10213,16566,25300,34789,420.06,108.92,79.21,51.87
30-12-2021,CONDEIXA-A-NOVA,236,17,1330,"[960,Max]",Extremamente Elevado,,,,236,Centro,COIMBRA,0604,13867.47,17733,871,809,717,583,490,1073,1790,2599,3470,127.88,25.02,18.74,12.91
30-12-2021,CONSTÂNCIA,30,2,741,"[480,960]",Muito Elevado,,,,30,Lisboa e Vale do Tejo,SANTARÉM,1408,8036.58,4030,211,183,187,148,155,303,490,673,884,50.14,11.0,8.37,6.1
30-12-2021,CORUCHE,92,7,529,"[480,960]",Muito Elevado,,,,92,Lisboa e Vale do Tejo,SANTARÉM,1409,111572.03,17471,1294,1090,1095,1096,1019,2115,3210,4300,5594,15.66,5.01,3.85,2.88
30-12-2021,CORVO,1,0,213,"[120,240]",Moderado,,,,1,Açores,AÇORES,4901,1711.45,464,22,21,11,13,19,32,43,64,86,27.12,5.03,3.74,2.51
30-12-2021,COVILHÃ,578,41,1236,"[960,Max]",Extremamente Elevado,,,,578,Centro,CASTELO BRANCO,0503,55560.06,46787,3533,2998,2365,2111,2193,4304,6669,9667,13200,84.21,23.76,17.4,12.0
30-12-2021,CRATO,28,2,883,"[480,960]",Muito Elevado,,,,28,Alentejo,PORTALEGRE,1206,39806.88,3129,229,258,163,182,228,410,573,831,1060,7.86,2.66,2.09,1.44
30-12-2021,CUBA,22,2,484,"[480,960]",Muito Elevado,,,,22,Alentejo,BEJA,0207,17208.72,4595,255,233,206,190,143,333,539,772,1027,26.7,5.97,4.49,3.13
30-12-2021,ELVAS,231,16,1124,"[960,Max]",Extremamente Elevado,,,,231,Alentejo,PORTALEGRE,1207,63128.86,20528,1057,1145,902,852,810,1662,2564,3709,4766,32.52,7.55,5.88,4.06
30-12-2021,ENTRONCAMENTO,301,21,1396,"[960,Max]",Extremamente Elevado,,,,301,Lisboa e Vale do Tejo,SANTARÉM,1410,1372.81,21558,1066,930,868,695,592,1287,2155,3085,4151,1570.14,302.33,224.69,156.96
30-12-2021,ESPINHO,284,20,962,"[960,Max]",Extremamente Elevado,,,,284,Norte,AVEIRO,0107,2105.68,29516,2205,1993,1430,1177,960,2137,3567,5560,7765,1401.52,368.71,264.01,169.37
30-12-2021,ESPOSENDE,572,41,1674,"[960,Max]",Extremamente Elevado,,,,572,Norte,BRAGA,0306,9540.98,34177,1831,1522,1095,894,723,1617,2712,4234,6065,358.21,63.57,44.38,28.42
30-12-2021,ESTARREJA,215,15,826,"[480,960]",Muito Elevado,,,,215,Centro,AVEIRO,0108,10817.33,26006,1503,1399,1106,953,728,1681,2787,4186,5689,240.42,52.59,38.7,25.76
30-12-2021,ESTREMOZ,92,7,722,"[480,960]",Muito Elevado,,,,92,Alentejo,ÉVORA,0704,51379.95,12728,789,613,697,786,877,1663,2360,2973,3762,24.77,7.32,5.79,4.59
30-12-2021,ÉVORA,539,38,1028,"[960,Max]",Extremamente Elevado,,,,539,Alentejo,ÉVORA,0705,130707.58,52428,3569,2852,2176,1966,1803,3769,5945,8797,12366,40.11,9.46,6.73,4.55
30-12-2021,FAFE,575,41,1196,"[960,Max]",Extremamente Elevado,,,,575,Norte,BRAGA,0307,21908.11,48060,3044,2455,1679,1403,1208,2611,4290,6745,9789,219.37,44.68,30.79,19.58
30-12-2021,FARO,761,54,1247,"[960,Max]",Extremamente Elevado,,,,761,Algarve,FARO,0805,20256.79,61015,3847,3364,2604,2055,1601,3656,6260,9624,13471,301.2,66.5,47.51,30.9
30-12-2021,FELGUEIRAS,390,28,691,"[480,960]",Muito Elevado,,,,390,Norte,PORTO,1303,11573.75,56422,2951,2302,1601,1316,973,2289,3890,6192,9143,487.49,79.0,53.5,33.61
30-12-2021,FERREIRA DO ALENTEJO,23,2,295,"[240,480]",Elevado,,,,23,Alentejo,BEJA,0208,64820.68,7845,515,414,372,343,345,688,1060,1474,1989,12.1,3.07,2.27,1.64
30-12-2021,FERREIRA DO ZÊZERE,183,13,2301,"[960,Max]",Extremamente Elevado,,,,183,Lisboa e Vale do Tejo,SANTARÉM,1411,19038.03,7959,470,370,416,465,456,921,1337,1707,2177,41.81,11.44,8.97,7.02
30-12-2021,FIGUEIRA DA FOZ,638,46,1086,"[960,Max]",Extremamente Elevado,,,,638,Centro,COIMBRA,0605,37905.26,58747,4032,3597,2887,2495,2043,4538,7425,11022,15054,154.98,39.72,29.08,19.59
30-12-2021,FIGUEIRA DE CASTELO RODRIGO,26,2,465,"[240,480]",Elevado,,,,26,Centro,GUARDA,0904,50857.46,5584,347,352,290,352,391,743,1033,1385,1732,10.98,3.41,2.72,2.03
30-12-2021,FIGUEIRÓ DOS VINHOS,26,2,467,"[240,480]",Elevado,,,,26,Centro,LEIRIA,1008,17344.0,5568,402,386,322,309,351,660,982,1368,1770,32.1,10.21,7.89,5.66
30-12-2021,FORNOS DE ALGODRES,25,2,551,"[480,960]",Muito Elevado,,,,25,Centro,GUARDA,0905,13145.05,4528,261,218,247,256,232,488,735,953,1214,34.45,9.24,7.25,5.59
30-12-2021,FREIXO DE ESPADA À CINTA,41,3,1235,"[960,Max]",Extremamente Elevado,,,,41,Norte,BRAGANÇA,0404,24414.29,3298,211,177,231,196,189,385,616,793,1004,13.51,4.11,3.25,2.52
30-12-2021,FRONTEIRA,14,1,477,"[240,480]",Elevado,,,,14,Alentejo,PORTALEGRE,1208,24859.58,2974,213,182,149,156,168,324,473,655,868,11.96,3.49,2.63,1.9
30-12-2021,FUNCHAL,1875,134,1802,"[960,Max]",Extremamente Elevado,,,,1875,Madeira,MADEIRA,3103,7616.2,104024,6382,5086,3643,2821,1990,4811,8454,13540,19922,1365.86,261.58,177.78,111.0
30-12-2021,FUNDÃO,333,24,1255,"[960,Max]",Extremamente Elevado,,,,333,Centro,CASTELO BRANCO,0504,70019.79,26495,1781,1464,1432,1357,1643,3000,4432,5896,7677,37.84,10.96,8.42,6.33
30-12-2021,GAVIÃO,30,2,911,"[480,960]",Muito Elevado,,,,30,Alentejo,PORTALEGRE,1209,29459.45,3263,189,186,222,263,293,556,778,964,1153,11.08,3.91,3.27,2.64
30-12-2021,GÓIS,24,2,636,"[480,960]",Muito Elevado,,,,24,Centro,COIMBRA,0606,26330.19,3805,235,199,240,233,244,477,717,916,1151,14.45,4.37,3.48,2.72
30-12-2021,GOLEGÃ,78,6,1456,"[960,Max]",Extremamente Elevado,,,,78,Lisboa e Vale do Tejo,SANTARÉM,1412,8431.67,5339,356,299,281,243,255,498,779,1078,1434,63.32,17.01,12.78,9.24
30-12-2021,GONDOMAR,1937,138,1167,"[960,Max]",Extremamente Elevado,,,,1937,Norte,PORTO,1304,13191.76,165985,10555,8755,6222,4450,3364,7814,14036,22791,33346,1258.22,252.77,172.76,106.4
30-12-2021,GOUVEIA,72,5,583,"[480,960]",Muito Elevado,,,,72,Centro,GUARDA,0906,30061.17,12387,871,931,780,783,810,1593,2373,3304,4175,41.21,13.89,10.99,7.89
30-12-2021,GRÂNDOLA,73,5,500,"[480,960]",Muito Elevado,,,,73,Alentejo,SETÚBAL,1505,82593.66,14639,834,834,708,688,672,1360,2068,2902,3736,17.72,4.52,3.51,2.5
30-12-2021,GUARDA,420,30,1079,"[960,Max]",Extremamente Elevado,,,,420,Centro,GUARDA,0907,71209.58,38969,2477,2041,1686,1415,1474,2889,4575,6616,9093,54.72,12.77,9.29,6.42
30-12-2021,GUIMARÃES,1773,127,1164,"[960,Max]",Extremamente Elevado,,,,1773,Norte,BRAGA,0308,24099.96,152309,9394,7074,4809,3877,2948,6825,11634,18708,28102,631.99,116.61,77.63,48.27
30-12-2021,HORTA,64,5,443,"[240,480]",Elevado,,,,64,Açores,AÇORES,4701,17305.53,14521,818,658,468,352,302,654,1122,1780,2598,83.91,15.01,10.29,6.48
30-12-2021,IDANHA-A-NOVA,83,6,1035,"[960,Max]",Extremamente Elevado,,,,83,Centro,CASTELO BRANCO,0505,141633.51,8043,518,490,519,672,974,1646,2165,2655,3173,5.68,2.24,1.87,1.53
30-12-2021,ÍLHAVO,488,35,1261,"[960,Max]",Extremamente Elevado,,,,488,Centro,AVEIRO,0110,7347.55,38699,2227,1943,1444,1193,850,2043,3487,5430,7657,526.66,104.21,73.9,47.46
30-12-2021,LAGOA (FARO),212,15,932,"[480,960]",Muito Elevado,,,,212,Algarve,FARO,0806,8825.45,22762,1314,1168,919,749,670,1419,2338,3506,4820,257.93,54.62,39.73,26.49
30-12-2021,LAGOA,119,8,807,"[480,960]",Muito Elevado,,,,119,Açores,AÇORES,4201,4559.32,14721,536,458,349,238,235,473,822,1280,1816,322.9,39.83,28.08,18.03
30-12-2021,LAGOS,229,16,753,"[480,960]",Muito Elevado,,,,229,Algarve,FARO,0807,21299.27,30374,1744,1434,1247,1053,1029,2082,3329,4763,6507,142.61,30.55,22.36,15.63
30-12-2021,LAJES DAS FLORES,2,0,137,"[120,240]",Moderado,,,,2,Açores,AÇORES,4801,7004.79,1463,88,53,62,46,54,100,162,215,303,20.89,4.33,3.07,2.31
30-12-2021,LAJES DO PICO,17,1,380,"[240,480]",Elevado,,,,17,Açores,AÇORES,4601,15531.09,4490,304,231,223,159,162,321,544,775,1079,28.91,6.95,4.99,3.5
30-12-2021,LAMEGO,198,14,796,"[480,960]",Muito Elevado,,,,198,Norte,VISEU,1805,16542.11,24895,1639,1284,1124,898,783,1681,2805,4089,5728,150.5,34.63,24.72,16.96
30-12-2021,LEIRIA,1885,135,1505,"[960,Max]",Extremamente Elevado,,,,1885,Centro,LEIRIA,1009,56508.83,125267,7389,6366,5090,3902,3159,7061,12151,18517,25906,221.68,45.84,32.77,21.5
30-12-2021,LISBOA,12789,913,2510,"[960,Max]",Extremamente Elevado,,,,12789,Lisboa e Vale do Tejo,LISBOA,1106,10005.43,509515,33197,33340,27706,23037,26770,49807,77513,110853,144050,5092.6,1439.78,1107.98,774.74
30-12-2021,LOULÉ,807,58,1175,"[960,Max]",Extremamente Elevado,,,,807,Algarve,FARO,0808,76366.91,68697,3890,3350,2780,2358,2251,4609,7389,10739,14629,89.96,19.16,14.06,9.68
30-12-2021,LOURES,3799,271,1778,"[960,Max]",Extremamente Elevado,,,,3799,Lisboa e Vale do Tejo,LISBOA,1107,16723.99,213687,12746,12794,9644,6669,5033,11702,21346,34140,46886,1277.73,280.35,204.14,127.64
30-12-2021,LOURINHÃ,325,23,1257,"[960,Max]",Extremamente Elevado,,,,325,Lisboa e Vale do Tejo,LISBOA,1108,14717.2,25855,1584,1243,992,842,645,1487,2479,3722,5306,175.68,36.05,25.29,16.84
30-12-2021,LOUSÃ,218,16,1273,"[960,Max]",Extremamente Elevado,,,,218,Centro,COIMBRA,0607,13840.01,17158,946,866,658,528,450,978,1636,2502,3448,123.97,24.91,18.08,11.82
30-12-2021,LOUSADA,291,21,623,"[480,960]",Muito Elevado,,,,291,Norte,PORTO,1305,9608.01,46755,2289,1698,1176,853,621,1474,2650,4348,6637,486.63,69.08,45.25,27.58
30-12-2021,MAÇÃO,84,6,1340,"[960,Max]",Extremamente Elevado,,,,84,Lisboa e Vale do Tejo,SANTARÉM,1413,39997.98,6267,386,362,390,440,657,1097,1487,1849,2235,15.67,5.59,4.62,3.72
30-12-2021,MACEDO DE CAVALEIROS,75,5,520,"[480,960]",Muito Elevado,,,,75,Norte,BRAGANÇA,0405,69914.08,14516,1082,889,878,823,938,1761,2639,3528,4610,20.76,6.59,5.05,3.77
30-12-2021,MACHICO,301,21,1505,"[960,Max]",Extremamente Elevado,,,,301,Madeira,MADEIRA,3104,6825.1,19981,1197,860,662,455,331,786,1448,2308,3505,292.76,51.36,33.82,21.22
30-12-2021,MADALENA,16,1,272,"[240,480]",Elevado,,,,16,Açores,AÇORES,4602,14712.33,5895,334,256,173,190,179,369,542,798,1132,40.07,7.69,5.42,3.68
30-12-2021,MAFRA,1276,91,1504,"[960,Max]",Extremamente Elevado,,,,1276,Lisboa e Vale do Tejo,LISBOA,1109,29165.5,84816,3613,3334,2839,2089,1899,3988,6827,10161,13774,290.81,47.23,34.84,23.41
30-12-2021,MAIA,1922,137,1383,"[960,Max]",Extremamente Elevado,,,,1922,Norte,PORTO,1306,8293.94,138971,7801,6617,4512,3339,2631,5970,10482,17099,24900,1675.56,300.22,206.16,126.38
30-12-2021,MANGUALDE,132,9,712,"[480,960]",Muito Elevado,,,,132,Centro,VISEU,1806,21925.56,18510,1198,1128,885,852,743,1595,2480,3608,4806,84.42,21.92,16.46,11.31
30-12-2021,MANTEIGAS,19,1,636,"[480,960]",Muito Elevado,,,,19,Centro,GUARDA,0908,12197.55,3007,258,197,159,167,146,313,472,669,927,24.65,7.6,5.48,3.87
30-12-2021,MARCO DE CANAVESES,517,37,1003,"[960,Max]",Extremamente Elevado,,,,517,Norte,PORTO,1307,20188.98,51496,2678,2060,1488,1265,1023,2288,3776,5836,8514,255.07,42.17,28.91,18.7
30-12-2021,MARINHA GRANDE,411,29,1068,"[960,Max]",Extremamente Elevado,,,,411,Centro,LEIRIA,1010,18725.19,38508,2365,2302,1638,1359,1058,2417,4055,6357,8722,205.65,46.58,33.95,21.66
30-12-2021,MARVÃO,9,1,306,"[240,480]",Elevado,,,,9,Alentejo,PORTALEGRE,1210,15489.9,3005,198,185,142,197,237,434,576,761,959,19.4,6.19,4.91,3.72
30-12-2021,MATOSINHOS,2606,186,1486,"[960,Max]",Extremamente Elevado,,,,2606,Norte,PORTO,1308,6241.97,175357,11850,9977,7023,5024,3884,8908,15931,25908,37758,2809.31,604.9,415.06,255.22
30-12-2021,MEALHADA,189,13,949,"[480,960]",Muito Elevado,,,,189,Centro,AVEIRO,0111,11065.66,19914,1163,1039,810,828,831,1659,2469,3508,4671,179.96,42.21,31.7,22.31
30-12-2021,MÊDA,78,6,1705,"[960,Max]",Extremamente Elevado,,,,78,Centro,GUARDA,0909,28604.92,4587,343,306,290,288,443,731,1021,1327,1670,16.04,5.84,4.64,3.57
30-12-2021,MELGAÇO,69,5,851,"[480,960]",Muito Elevado,,,,69,Norte,VIANA DO CASTELO,1603,23824.58,8093,507,567,578,614,675,1289,1867,2434,2941,33.97,12.34,10.22,7.84
30-12-2021,MÉRTOLA,68,5,1108,"[960,Max]",Extremamente Elevado,,,,68,Alentejo,BEJA,0209,129287.34,6142,400,390,378,423,600,1023,1401,1791,2191,4.75,1.69,1.39,1.08
30-12-2021,MESÃO FRIO,19,1,482,"[480,960]",Muito Elevado,,,,19,Norte,VILA REAL,1704,2664.87,3964,265,205,168,157,120,277,445,650,915,148.74,34.33,24.39,16.7
30-12-2021,MIRA,128,9,1078,"[960,Max]",Extremamente Elevado,,,,128,Centro,COIMBRA,0608,12403.38,11832,727,729,659,550,466,1016,1675,2404,3131,95.4,25.24,19.38,13.5
30-12-2021,MIRANDA DO CORVO,89,6,700,"[480,960]",Muito Elevado,,,,89,Centro,COIMBRA,0609,12637.79,12708,706,659,568,498,404,902,1470,2129,2835,100.55,22.43,16.85,11.63
30-12-2021,MIRANDA DO DOURO,22,2,325,"[240,480]",Elevado,,,,22,Norte,BRAGANÇA,0406,48718.31,6830,482,429,442,463,470,933,1375,1804,2286,14.02,4.69,3.7,2.82
30-12-2021,MIRANDELA,156,11,718,"[480,960]",Muito Elevado,,,,156,Norte,BRAGANÇA,0407,65895.67,21754,1640,1315,1204,1078,947,2025,3229,4544,6184,33.01,9.38,6.9,4.9
30-12-2021,MOGADOURO,96,7,1147,"[960,Max]",Extremamente Elevado,,,,96,Norte,BRAGANÇA,0408,76064.93,8392,589,529,576,630,655,1285,1861,2390,2979,11.03,3.92,3.14,2.45
30-12-2021,MOIMENTA DA BEIRA,37,3,381,"[240,480]",Elevado,,,,37,Norte,VISEU,1807,21996.9,9736,576,514,471,416,461,877,1348,1862,2438,44.26,11.08,8.46,6.13
30-12-2021,MOITA,1105,79,1716,"[960,Max]",Extremamente Elevado,,,,1105,Lisboa e Vale do Tejo,SETÚBAL,1506,5525.98,64407,4226,3646,2623,1801,1425,3226,5849,9495,13721,1165.53,248.3,171.82,105.85
30-12-2021,MONÇÃO,316,23,1771,"[960,Max]",Extremamente Elevado,,,,316,Norte,VIANA DO CASTELO,1604,21130.85,17869,1161,1105,1031,1006,972,1978,3009,4114,5275,84.56,24.96,19.47,14.24
30-12-2021,MONCHIQUE,30,2,582,"[480,960]",Muito Elevado,,,,30,Algarve,FARO,0809,39530.43,5077,353,384,321,355,392,747,1068,1452,1805,12.84,4.57,3.67,2.7
30-12-2021,MONDIM DE BASTO,86,6,1235,"[960,Max]",Extremamente Elevado,,,,86,Norte,VILA REAL,1705,17207.52,6946,395,300,314,284,283,567,881,1181,1576,40.36,9.16,6.86,5.12
30-12-2021,MONFORTE,14,1,475,"[240,480]",Elevado,,,,14,Alentejo,PORTALEGRE,1211,42024.82,2975,139,115,117,192,168,360,477,592,731,7.08,1.74,1.41,1.14
30-12-2021,MONTALEGRE,43,3,473,"[240,480]",Elevado,,,,43,Norte,VILA REAL,1706,80545.71,8997,699,628,595,603,730,1333,1928,2556,3255,11.17,4.04,3.17,2.39
30-12-2021,MONTEMOR-O-NOVO,177,13,1133,"[960,Max]",Extremamente Elevado,,,,177,Alentejo,ÉVORA,0706,123296.65,15647,991,953,868,878,971,1849,2717,3670,4661,12.69,3.78,2.98,2.2
30-12-2021,MONTEMOR-O-VELHO,295,21,1170,"[960,Max]",Extremamente Elevado,,,,295,Centro,COIMBRA,0610,22896.23,25224,1496,1397,1217,1057,988,2045,3262,4659,6155,110.17,26.88,20.35,14.25
30-12-2021,MONTIJO,667,48,1157,"[960,Max]",Extremamente Elevado,,,,667,Lisboa e Vale do Tejo,SETÚBAL,1507,34861.64,57614,2771,2441,1990,1554,1109,2663,4653,7094,9865,165.26,28.3,20.35,13.35
30-12-2021,MORA,31,2,743,"[480,960]",Muito Elevado,,,,31,Alentejo,ÉVORA,0707,44395.02,4138,336,275,252,238,257,495,747,1022,1358,9.32,3.06,2.3,1.68
30-12-2021,MORTÁGUA,126,9,1429,"[960,Max]",Extremamente Elevado,,,,126,Centro,VISEU,1808,25117.82,8803,638,584,535,499,460,959,1494,2078,2716,35.05,10.81,8.27,5.95
30-12-2021,MOURA,152,11,1110,"[960,Max]",Extremamente Elevado,,,,152,Alentejo,BEJA,0210,95845.55,13718,817,656,665,542,461,1003,1668,2324,3141,14.31,3.28,2.42,1.74
30-12-2021,MOURÃO,5,0,206,"[120,240]",Moderado,,,,5,Alentejo,ÉVORA,0708,27862.98,2450,139,108,80,104,109,213,293,401,540,8.79,1.94,1.44,1.05
30-12-2021,MURÇA,51,4,926,"[480,960]",Muito Elevado,,,,51,Norte,VILA REAL,1707,18937.11,5463,384,341,307,306,319,625,932,1273,1657,28.85,8.75,6.72,4.92
30-12-2021,MURTOSA,80,6,778,"[480,960]",Muito Elevado,,,,80,Centro,AVEIRO,0112,7308.78,10279,509,473,403,353,409,762,1165,1638,2147,140.63,29.37,22.41,15.94
30-12-2021,NAZARÉ,279,20,1970,"[960,Max]",Extremamente Elevado,,,,279,Lisboa e Vale do Tejo,LEIRIA,1011,8243.43,14165,967,903,670,420,396,816,1486,2389,3356,171.84,40.71,28.98,18.03
30-12-2021,NELAS,73,5,562,"[480,960]",Muito Elevado,,,,73,Centro,VISEU,1809,12571.48,12974,924,787,668,604,583,1187,1855,2642,3566,103.21,28.37,21.02,14.76
30-12-2021,NISA,63,5,1040,"[960,Max]",Extremamente Elevado,,,,63,Alentejo,PORTALEGRE,1212,57567.84,6061,405,389,355,483,478,961,1316,1705,2110,10.53,3.67,2.96,2.29
30-12-2021,NORDESTE,26,2,540,"[480,960]",Muito Elevado,,,,26,Açores,AÇORES,4202,10146.8,4862,246,180,124,161,162,323,447,627,873,47.92,8.6,6.18,4.41
30-12-2021,ÓBIDOS,131,9,1106,"[960,Max]",Extremamente Elevado,,,,131,Lisboa e Vale do Tejo,LEIRIA,1012,14155.44,11850,743,650,574,452,436,888,1462,2112,2855,83.72,20.17,14.92,10.33
30-12-2021,ODEMIRA,100,7,406,"[240,480]",Elevado,,,,100,Alentejo,BEJA,0211,172060.15,24717,1475,1317,1225,1397,1349,2746,3971,5288,6763,14.37,3.93,3.07,2.31
30-12-2021,ODIVELAS,2873,205,1776,"[960,Max]",Extremamente Elevado,,,,2873,Lisboa e Vale do Tejo,LISBOA,1116,2654.36,161774,9562,9038,6952,4641,3812,8453,15405,24443,34005,6095.48,1281.27,920.99,580.44
30-12-2021,OEIRAS,3935,281,2218,"[960,Max]",Extremamente Elevado,,,,3935,Lisboa e Vale do Tejo,LISBOA,1110,4588.31,177408,11580,11575,8566,6211,5855,12066,20632,32207,43787,3866.78,954.38,701.98,449.69
30-12-2021,OLEIROS,16,1,319,"[240,480]",Elevado,,,,16,Centro,CASTELO BRANCO,0506,47109.31,5003,384,341,366,397,487,884,1250,1591,1975,10.62,4.19,3.38,2.65
30-12-2021,OLHÃO,375,27,844,"[480,960]",Muito Elevado,,,,375,Algarve,FARO,0810,13086.38,44405,2455,2309,1689,1342,1268,2610,4299,6608,9063,339.33,69.26,50.5,32.85
30-12-2021,OLIVEIRA DE AZEMÉIS,784,56,1188,"[960,Max]",Extremamente Elevado,,,,784,Norte,AVEIRO,0113,16110.41,66011,4155,3614,2794,2183,1738,3921,6715,10329,14484,409.75,89.91,64.12,41.68
30-12-2021,OLIVEIRA DE FRADES,129,9,1302,"[960,Max]",Extremamente Elevado,,,,129,Centro,VISEU,1810,14534.62,9936,553,475,438,359,415,774,1212,1687,2240,68.36,15.41,11.61,8.34
30-12-2021,OLIVEIRA DO BAIRRO,214,15,882,"[480,960]",Muito Elevado,,,,214,Centro,AVEIRO,0114,8731.99,24277,1327,1182,999,786,810,1596,2595,3777,5104,278.02,58.45,43.25,29.72
30-12-2021,OLIVEIRA DO HOSPITAL,117,8,608,"[480,960]",Muito Elevado,,,,117,Centro,COIMBRA,0611,23451.66,19253,1161,1097,962,924,960,1884,2846,3943,5104,82.1,21.76,16.81,12.14
30-12-2021,OURÉM,758,54,1720,"[960,Max]",Extremamente Elevado,,,,758,Lisboa e Vale do Tejo,SANTARÉM,1421,41668.03,44044,2463,2069,1899,1817,1603,3420,5319,7388,9851,105.7,23.64,17.73,12.77
30-12-2021,OURIQUE,34,2,748,"[480,960]",Muito Elevado,,,,34,Alentejo,BEJA,0212,66331.36,4607,313,287,284,268,227,495,779,1066,1379,6.95,2.08,1.61,1.17
30-12-2021,OVAR,651,47,1200,"[960,Max]",Extremamente Elevado,,,,651,Centro,AVEIRO,0115,14770.25,54260,3294,2709,1994,1636,1234,2870,4864,7573,10867,367.37,73.57,51.27,32.93
30-12-2021,PAÇOS DE FERREIRA,578,41,1019,"[960,Max]",Extremamente Elevado,,,,578,Norte,PORTO,1309,7099.29,56728,2903,2193,1518,1135,664,1799,3317,5510,8413,799.1,118.51,77.62,46.72
30-12-2021,PALMELA,818,58,1273,"[960,Max]",Extremamente Elevado,,,,818,Lisboa e Vale do Tejo,SETÚBAL,1508,46512.01,64269,3402,3244,2635,1846,1391,3237,5872,9116,12518,138.18,26.91,19.6,12.62
30-12-2021,PAMPILHOSA DA SERRA,20,1,496,"[480,960]",Muito Elevado,,,,20,Centro,COIMBRA,0612,39646.24,4037,238,254,295,339,423,762,1057,1311,1549,10.18,3.91,3.31,2.67
30-12-2021,PAREDES,919,66,1068,"[960,Max]",Extremamente Elevado,,,,919,Norte,PORTO,1310,15675.69,86067,4272,3532,2412,1717,1258,2975,5387,8919,13191,549.04,84.15,56.9,34.36
30-12-2021,PAREDES DE COURA,109,8,1275,"[960,Max]",Extremamente Elevado,,,,109,Norte,VIANA DO CASTELO,1605,13818.59,8535,466,528,407,465,515,980,1387,1915,2381,61.76,17.23,13.86,10.04
30-12-2021,PEDRÓGÃO GRANDE,24,2,703,"[480,960]",Muito Elevado,,,,24,Centro,LEIRIA,1013,12874.75,3410,175,173,196,221,252,473,669,842,1017,26.49,7.9,6.54,5.2
30-12-2021,PENACOVA,113,8,828,"[480,960]",Muito Elevado,,,,113,Centro,COIMBRA,0613,21673.23,13694,968,923,745,621,703,1324,2069,2992,3960,63.18,18.27,13.81,9.55
30-12-2021,PENAFIEL,641,46,919,"[480,960]",Muito Elevado,,,,641,Norte,PORTO,1311,21224.27,69772,3648,2823,2032,1663,1230,2893,4925,7748,11396,328.74,53.69,36.51,23.2
30-12-2021,PENALVA DO CASTELO,56,4,784,"[480,960]",Muito Elevado,,,,56,Centro,VISEU,1811,13433.92,7115,449,457,413,391,426,817,1230,1687,2136,52.96,15.9,12.56,9.16
30-12-2021,PENAMACOR,52,4,1101,"[960,Max]",Extremamente Elevado,,,,52,Centro,CASTELO BRANCO,0507,56370.69,4755,262,248,273,451,633,1084,1357,1605,1867,8.44,3.31,2.85,2.41
30-12-2021,PENEDONO,13,1,505,"[480,960]",Muito Elevado,,,,13,Norte,VISEU,1812,13370.75,2591,172,113,129,156,138,294,423,536,708,19.38,5.3,4.01,3.16
30-12-2021,PENELA,41,3,761,"[480,960]",Muito Elevado,,,,41,Centro,COIMBRA,0614,13480.0,5397,314,324,274,359,344,703,977,1301,1615,40.04,11.98,9.65,7.25
30-12-2021,PENICHE,285,20,1075,"[960,Max]",Extremamente Elevado,,,,285,Lisboa e Vale do Tejo,LEIRIA,1014,7754.98,26501,1746,1504,1203,926,707,1633,2836,4340,6086,341.73,78.48,55.96,36.57
30-12-2021,PESO DA RÉGUA,121,9,765,"[480,960]",Muito Elevado,,,,121,Norte,VILA REAL,1708,9486.01,15773,1076,843,650,659,455,1114,1764,2607,3683,166.28,38.83,27.48,18.6
30-12-2021,PINHEL,53,4,617,"[480,960]",Muito Elevado,,,,53,Centro,GUARDA,0910,48452.12,8511,577,566,551,538,689,1227,1778,2344,2921,17.57,6.03,4.84,3.67
30-12-2021,POMBAL,531,38,1032,"[960,Max]",Extremamente Elevado,,,,531,Centro,LEIRIA,1015,62600.28,51461,3187,2791,2494,2328,2027,4355,6849,9640,12827,82.21,20.49,15.4,10.94
30-12-2021,PONTA DELGADA,556,40,818,"[480,960]",Muito Elevado,,,,556,Açores,AÇORES,4203,23298.65,67935,3108,2435,1726,1133,902,2035,3761,6196,9304,291.58,39.93,26.59,16.14
30-12-2021,PONTA DO SOL,121,9,1403,"[960,Max]",Extremamente Elevado,,,,121,Madeira,MADEIRA,3105,4622.03,8593,319,283,347,208,221,429,776,1059,1378,185.92,29.81,22.91,16.79
30-12-2021,PONTE DA BARCA,185,13,1658,"[960,Max]",Extremamente Elevado,,,,185,Norte,VIANA DO CASTELO,1606,18211.37,11180,635,576,517,554,490,1044,1561,2137,2772,61.39,15.22,11.73,8.57
30-12-2021,PONTE DE LIMA,499,36,1208,"[960,Max]",Extremamente Elevado,,,,499,Norte,VIANA DO CASTELO,1607,32025.46,41315,2321,2022,1720,1596,1462,3058,4778,6800,9121,129.01,28.48,21.23,14.92
30-12-2021,PONTE DE SOR,118,8,788,"[480,960]",Muito Elevado,,,,118,Alentejo,PORTALEGRE,1213,83971.16,14994,939,800,716,739,831,1570,2286,3086,4025,17.86,4.79,3.68,2.72
30-12-2021,PORTALEGRE,229,16,1031,"[960,Max]",Extremamente Elevado,,,,229,Alentejo,PORTALEGRE,1214,44713.64,22172,1577,1351,1137,993,984,1977,3114,4465,6042,49.59,13.51,9.99,6.96
30-12-2021,PORTEL,24,2,416,"[240,480]",Elevado,,,,24,Alentejo,ÉVORA,0709,60100.57,5828,336,358,283,331,305,636,919,1277,1613,9.7,2.68,2.12,1.53
30-12-2021,PORTIMÃO,578,41,1041,"[960,Max]",Extremamente Elevado,,,,578,Algarve,FARO,0811,18206.29,55483,3182,2927,2116,1582,1400,2982,5098,8025,11207,304.75,61.56,44.08,28.0
30-12-2021,PORTO,4612,329,2129,"[960,Max]",Extremamente Elevado,,,,4612,Norte,PORTO,1312,4142.02,216606,15790,15193,11280,9409,10044,19453,30733,45926,61716,5229.5,1490.0,1108.79,741.98
30-12-2021,PORTO DE MÓS,390,28,1676,"[960,Max]",Extremamente Elevado,,,,390,Centro,LEIRIA,1016,26183.41,23275,1355,1210,1034,888,872,1760,2794,4004,5359,88.89,20.47,15.29,10.67
30-12-2021,PORTO MONIZ,19,1,822,"[480,960]",Muito Elevado,,,,19,Madeira,MADEIRA,3106,8293.38,2342,143,130,95,98,120,218,313,443,586,28.24,7.07,5.34,3.77
30-12-2021,PORTO SANTO,247,18,4753,"[960,Max]",Extremamente Elevado,,,,247,Madeira,MADEIRA,3201,4300.7,5202,240,157,134,110,68,178,312,469,709,120.95,16.48,10.9,7.25
30-12-2021,PÓVOA DE LANHOSO,225,16,1047,"[960,Max]",Extremamente Elevado,,,,225,Norte,BRAGA,0309,13465.29,21499,1175,909,732,673,624,1297,2029,2938,4113,159.67,30.55,21.82,15.07
30-12-2021,PÓVOA DE VARZIM,718,51,1144,"[960,Max]",Extremamente Elevado,,,,718,Norte,PORTO,1313,8220.59,62784,3712,3120,2134,1594,1305,2899,5033,8153,11865,763.7,144.33,99.17,61.22
30-12-2021,POVOAÇÃO,70,5,1187,"[960,Max]",Extremamente Elevado,,,,70,Açores,AÇORES,4204,10640.77,5927,293,212,191,144,134,278,469,681,974,55.7,9.15,6.4,4.41
30-12-2021,VILA DA PRAIA DA VITÓRIA,103,7,485,"[480,960]",Muito Elevado,,,,103,Açores,AÇORES,4302,16127.06,21317,1133,789,619,436,336,772,1391,2180,3313,132.18,20.54,13.52,8.63
30-12-2021,PROENÇA-A-NOVA,76,5,1035,"[960,Max]",Extremamente Elevado,,,,76,Centro,CASTELO BRANCO,0508,39539.96,7298,508,465,389,400,560,960,1349,1814,2322,18.46,5.87,4.59,3.41
30-12-2021,REDONDO,68,5,1066,"[960,Max]",Extremamente Elevado,,,,68,Alentejo,ÉVORA,0710,36950.87,6353,349,325,288,288,354,642,930,1255,1604,17.19,4.34,3.4,2.52
30-12-2021,REGUENGOS DE MONSARAZ,45,3,453,"[240,480]",Elevado,,,,45,Alentejo,ÉVORA,0711,46399.72,10015,602,511,455,462,473,935,1390,1901,2503,21.58,5.39,4.1,3.0
30-12-2021,RESENDE,42,3,419,"[240,480]",Elevado,,,,42,Norte,VISEU,1813,12334.93,10137,560,493,448,433,422,855,1303,1796,2356,82.18,19.1,14.56,10.56
30-12-2021,RIBEIRA BRAVA,163,12,1311,"[960,Max]",Extremamente Elevado,,,,163,Madeira,MADEIRA,3107,6544.88,12435,648,500,411,311,287,598,1009,1509,2157,189.99,32.96,23.06,15.42
30-12-2021,RIBEIRA DE PENA,43,3,718,"[480,960]",Muito Elevado,,,,43,Norte,VILA REAL,1709,21745.98,6016,371,301,290,310,368,678,968,1269,1640,27.66,7.54,5.84,4.45
30-12-2021,RIBEIRA GRANDE,168,12,512,"[480,960]",Muito Elevado,,,,168,Açores,AÇORES,4205,18015.13,32811,1163,689,512,345,253,598,1110,1799,2962,182.13,16.44,9.99,6.16
30-12-2021,RIO MAIOR,137,10,670,"[480,960]",Muito Elevado,,,,137,Lisboa e Vale do Tejo,SANTARÉM,1414,27276.45,20379,1251,1144,941,795,648,1443,2384,3528,4779,74.71,17.52,12.93,8.74
30-12-2021,SABROSA,48,3,816,"[480,960]",Muito Elevado,,,,48,Norte,VILA REAL,1710,15692.45,5918,393,314,304,302,350,652,956,1270,1663,37.71,10.6,8.09,6.09
30-12-2021,SABUGAL,73,5,694,"[480,960]",Muito Elevado,,,,73,Centro,GUARDA,0911,82269.82,10585,724,707,694,796,1009,1805,2499,3206,3930,12.87,4.78,3.9,3.04
30-12-2021,SALVATERRA DE MAGOS,220,16,1034,"[960,Max]",Extremamente Elevado,,,,220,Lisboa e Vale do Tejo,SANTARÉM,1415,24393.2,21295,1275,1181,1060,799,772,1571,2631,3812,5087,87.3,20.85,15.63,10.79
30-12-2021,SANTA COMBA DÃO,48,3,460,"[240,480]",Elevado,,,,48,Centro,VISEU,1814,11194.77,10452,732,684,569,538,464,1002,1571,2255,2987,93.36,26.68,20.14,14.03
30-12-2021,SANTA CRUZ,715,51,1580,"[960,Max]",Extremamente Elevado,,,,715,Madeira,MADEIRA,3108,8150.28,45281,1817,1301,974,716,523,1239,2213,3514,5331,555.6,65.41,43.12,27.15
30-12-2021,SANTA CRUZ DA GRACIOSA,23,2,550,"[480,960]",Muito Elevado,,,,23,Açores,AÇORES,4401,6065.78,4208,228,180,163,124,145,269,432,612,840,69.37,13.85,10.09,7.12
30-12-2021,SANTA CRUZ DAS FLORES,5,0,231,"[120,240]",Moderado,,,,5,Açores,AÇORES,4802,7091.44,2165,125,98,74,56,51,107,181,279,404,30.53,5.7,3.93,2.55
30-12-2021,SANTA MARIA DA FEIRA,1619,116,1168,"[960,Max]",Extremamente Elevado,,,,1619,Norte,AVEIRO,0109,21587.65,138636,8182,6743,4771,3856,3079,6935,11706,18449,26631,642.19,123.36,85.46,54.22
30-12-2021,SANTA MARTA DE PENAGUIÃO,34,2,519,"[480,960]",Muito Elevado,,,,34,Norte,VILA REAL,1711,6928.13,6599,483,373,337,316,317,633,970,1343,1826,95.25,26.36,19.39,14.0
30-12-2021,SANTANA,46,3,692,"[480,960]",Muito Elevado,,,,46,Madeira,MADEIRA,3109,9547.3,6711,418,353,343,282,277,559,902,1255,1673,70.29,17.52,13.15,9.45
30-12-2021,SANTARÉM,780,56,1358,"[960,Max]",Extremamente Elevado,,,,780,Lisboa e Vale do Tejo,SANTARÉM,1416,55253.58,57421,3654,3441,2760,2466,2206,4672,7432,10873,14527,103.92,26.29,19.68,13.45
30-12-2021,SANTIAGO DO CACÉM,236,17,821,"[480,960]",Muito Elevado,,,,236,Alentejo,SETÚBAL,1509,105969.29,28791,2144,1689,1472,1295,1215,2510,3982,5671,7815,27.17,7.37,5.35,3.76
30-12-2021,SANTO TIRSO,606,43,891,"[480,960]",Muito Elevado,,,,606,Norte,PORTO,1314,13655.52,68055,4911,3935,2761,2257,1810,4067,6828,10763,15674,498.35,114.78,78.82,50.0
30-12-2021,SÃO BRÁS DE ALPORTEL,171,12,1639,"[960,Max]",Extremamente Elevado,,,,171,Algarve,FARO,0812,15336.92,10416,596,468,467,404,401,805,1272,1740,2336,67.91,15.23,11.35,8.29
30-12-2021,SÃO JOÃO DA MADEIRA,279,20,1269,"[960,Max]",Extremamente Elevado,,,,279,Norte,AVEIRO,0116,794.3,21958,1347,1069,796,601,593,1194,1990,3059,4406,2765.49,554.91,385.26,250.63
30-12-2021,SÃO JOÃO DA PESQUEIRA,36,3,510,"[480,960]",Muito Elevado,,,,36,Norte,VISEU,1815,26610.85,7125,417,330,294,328,328,656,950,1280,1697,26.77,6.38,4.81,3.57
30-12-2021,SÃO PEDRO DO SUL,89,6,577,"[480,960]",Muito Elevado,,,,89,Centro,VISEU,1816,34895.09,15403,990,962,861,759,909,1668,2529,3491,4481,44.14,12.84,10.0,7.25
30-12-2021,SÃO ROQUE DO PICO,9,1,275,"[240,480]",Elevado,,,,9,Açores,AÇORES,4603,14236.1,3266,199,141,93,96,113,209,302,443,642,22.94,4.51,3.11,2.12
30-12-2021,SÃO VICENTE,67,5,1310,"[960,Max]",Extremamente Elevado,,,,67,Madeira,MADEIRA,3110,7883.71,5143,272,264,266,225,280,505,771,1035,1307,65.23,16.58,13.13,9.78
30-12-2021,SARDOAL,41,3,1103,"[960,Max]",Extremamente Elevado,,,,41,Lisboa e Vale do Tejo,SANTARÉM,1417,9214.72,3741,227,178,148,165,248,413,561,739,966,40.6,10.48,8.02,6.09
30-12-2021,SÁTÃO,115,8,997,"[960,Max]",Extremamente Elevado,,,,115,Centro,VISEU,1817,20194.11,11580,765,671,515,465,476,941,1456,2127,2892,57.34,14.32,10.53,7.21
30-12-2021,SEIA,201,14,902,"[480,960]",Muito Elevado,,,,201,Centro,GUARDA,0912,43568.83,22234,1807,1589,1238,1122,721,1843,3081,4670,6477,51.03,14.87,10.72,7.07
30-12-2021,SEIXAL,3209,229,1913,"[960,Max]",Extremamente Elevado,,,,3209,Lisboa e Vale do Tejo,SETÚBAL,1510,9545.17,167752,10586,9270,6661,4391,2930,7321,13982,23252,33838,1757.49,354.51,243.6,146.49
30-12-2021,SERNANCELHE,24,2,447,"[240,480]",Elevado,,,,24,Norte,VISEU,1818,22861.22,5396,305,293,286,273,260,533,819,1112,1417,23.6,6.2,4.86,3.58
30-12-2021,SERPA,107,8,748,"[480,960]",Muito Elevado,,,,107,Alentejo,BEJA,0213,110563.34,14304,903,761,719,697,626,1323,2042,2803,3706,12.94,3.35,2.54,1.85
30-12-2021,SERTÃ,160,11,1099,"[960,Max]",Extremamente Elevado,,,,160,Centro,CASTELO BRANCO,0509,44673.17,14577,870,779,790,767,1020,1787,2577,3356,4226,32.63,9.46,7.51,5.77
30-12-2021,SESIMBRA,775,55,1495,"[960,Max]",Extremamente Elevado,,,,775,Lisboa e Vale do Tejo,SETÚBAL,1511,19571.75,51858,2400,2321,1853,1257,1083,2340,4193,6514,8914,264.96,45.54,33.28,21.42
30-12-2021,SETÚBAL,1578,113,1371,"[960,Max]",Extremamente Elevado,,,,1578,Lisboa e Vale do Tejo,SETÚBAL,1512,23032.5,115126,7425,6929,5075,3775,2655,6430,11505,18434,25859,499.83,112.27,80.03,49.95
30-12-2021,SEVER DO VOUGA,57,4,505,"[480,960]",Muito Elevado,,,,57,Centro,AVEIRO,0117,12987.56,11331,766,637,568,540,567,1107,1675,2312,3078,87.24,23.7,17.8,12.9
30-12-2021,SILVES,345,25,952,"[480,960]",Muito Elevado,,,,345,Algarve,FARO,0813,68006.23,36226,2137,1869,1610,1423,1600,3023,4633,6502,8639,53.27,12.7,9.56,6.81
30-12-2021,SINES,140,10,1021,"[960,Max]",Extremamente Elevado,,,,140,Alentejo,SETÚBAL,1513,20330.17,13715,888,791,551,416,268,684,1235,2026,2914,67.46,14.33,9.97,6.07
30-12-2021,SINTRA,7773,555,1986,"[960,Max]",Extremamente Elevado,,,,7773,Lisboa e Vale do Tejo,LISBOA,1111,31922.73,391402,20490,18316,13545,9137,7284,16421,29966,48282,68772,1226.08,215.43,151.25,93.87
30-12-2021,SOBRAL DE MONTE AGRAÇO,109,8,1025,"[960,Max]",Extremamente Elevado,,,,109,Lisboa e Vale do Tejo,LISBOA,1112,5210.32,10651,564,507,352,272,212,484,836,1343,1907,204.43,36.6,25.78,16.05
30-12-2021,SOURE,273,20,1595,"[960,Max]",Extremamente Elevado,,,,273,Centro,COIMBRA,0615,26506.07,17120,1173,1142,1004,883,987,1870,2874,4016,5189,64.59,19.58,15.15,10.84
30-12-2021,SOUSEL,78,6,1779,"[960,Max]",Extremamente Elevado,,,,78,Alentejo,PORTALEGRE,1215,27932.18,4412,261,274,208,302,292,594,802,1076,1337,15.8,4.79,3.85,2.87
30-12-2021,TÁBUA,69,5,604,"[480,960]",Muito Elevado,,,,69,Centro,COIMBRA,0616,19978.58,11368,729,584,524,430,464,894,1418,2002,2731,56.9,13.67,10.02,7.1
30-12-2021,TABUAÇO,36,3,598,"[480,960]",Muito Elevado,,,,36,Norte,VISEU,1819,13385.67,6033,372,314,217,282,363,645,862,1176,1548,45.07,11.56,8.79,6.44
30-12-2021,TAROUCA,65,5,831,"[480,960]",Muito Elevado,,,,65,Norte,VISEU,1820,10008.49,7804,405,335,313,277,324,601,914,1249,1654,77.98,16.53,12.48,9.13
30-12-2021,TAVIRA,289,21,1177,"[960,Max]",Extremamente Elevado,,,,289,Algarve,FARO,0814,60696.7,24530,1493,1415,1252,1066,1277,2343,3595,5010,6503,40.41,10.71,8.25,5.92
30-12-2021,TERRAS DE BOURO,44,3,697,"[480,960]",Muito Elevado,,,,44,Norte,BRAGA,0310,27746.07,6361,391,372,296,319,340,659,955,1327,1718,22.93,6.19,4.78,3.44
30-12-2021,TOMAR,532,38,1447,"[960,Max]",Extremamente Elevado,,,,532,Lisboa e Vale do Tejo,SANTARÉM,1418,35120.44,36748,2403,2189,1868,1853,1822,3675,5543,7732,10135,104.64,28.86,22.02,15.78
30-12-2021,TONDELA,242,17,918,"[480,960]",Muito Elevado,,,,242,Centro,VISEU,1821,37121.73,26357,1768,1722,1518,1475,1417,2892,4410,6132,7900,71.0,21.28,16.52,11.88
30-12-2021,TORRE DE MONCORVO,22,2,289,"[240,480]",Elevado,,,,22,Norte,BRAGANÇA,0409,53155.67,7695,556,478,488,551,719,1270,1758,2236,2792,14.48,5.25,4.21,3.31
30-12-2021,TORRES NOVAS,490,35,1402,"[960,Max]",Extremamente Elevado,,,,490,Lisboa e Vale do Tejo,SANTARÉM,1419,26999.68,34933,2324,1979,1738,1406,1475,2881,4619,6598,8922,129.38,33.04,24.44,17.11
30-12-2021,TORRES VEDRAS,1142,82,1454,"[960,Max]",Extremamente Elevado,,,,1142,Lisboa e Vale do Tejo,LISBOA,1113,40714.89,78530,4513,3945,3447,2628,2104,4732,8179,12124,16637,192.88,40.86,29.78,20.09
30-12-2021,TRANCOSO,35,2,393,"[240,480]",Elevado,,,,35,Centro,GUARDA,0913,36152.47,8875,581,557,542,586,496,1082,1624,2181,2762,24.55,7.64,6.03,4.49
30-12-2021,TROFA,533,38,1388,"[960,Max]",Extremamente Elevado,,,,533,Norte,PORTO,1318,7201.76,38418,2336,1894,1231,939,684,1623,2854,4748,7084,533.44,98.36,65.93,39.63
30-12-2021,VAGOS,228,16,1001,"[960,Max]",Extremamente Elevado,,,,228,Centro,AVEIRO,0118,16491.5,22740,1320,1205,922,784,724,1508,2430,3635,4955,137.89,30.04,22.04,14.73
30-12-2021,VALE DE CAMBRA,238,17,1118,"[960,Max]",Extremamente Elevado,,,,238,Norte,AVEIRO,0119,14733.47,21327,1491,1363,1005,831,798,1629,2634,3997,5488,144.76,37.25,27.13,17.88
30-12-2021,VALENÇA,140,10,1054,"[960,Max]",Extremamente Elevado,,,,140,Norte,VIANA DO CASTELO,1608,11712.86,13290,867,791,582,582,503,1085,1667,2458,3325,113.46,28.39,20.99,14.23
30-12-2021,VALONGO,1288,92,1322,"[960,Max]",Extremamente Elevado,,,,1288,Norte,PORTO,1315,7512.45,97444,5629,4696,3207,2462,1829,4291,7498,12194,17823,1297.18,237.26,162.33,99.81
30-12-2021,VALPAÇOS,127,9,860,"[480,960]",Muito Elevado,,,,127,Norte,VILA REAL,1712,54873.93,14818,1217,1118,999,928,997,1925,2924,4042,5259,27.0,9.58,7.37,5.33
30-12-2021,VELAS,6,0,118,"[0,120]",Baixo a Moderado,,,,6,Açores,AÇORES,4502,11738.38,5093,278,208,166,153,113,266,432,640,918,43.39,7.82,5.45,3.68
30-12-2021,VENDAS NOVAS,45,3,402,"[240,480]",Elevado,,,,45,Alentejo,ÉVORA,0712,22238.88,11255,677,768,655,501,532,1033,1688,2456,3133,50.61,14.09,11.04,7.59
30-12-2021,VIANA DO ALENTEJO,13,1,255,"[240,480]",Elevado,,,,13,Alentejo,ÉVORA,0713,39367.29,5145,245,208,235,210,214,424,659,867,1112,13.07,2.82,2.2,1.67
30-12-2021,VIANA DO CASTELO,837,60,992,"[960,Max]",Extremamente Elevado,,,,837,Norte,VIANA DO CASTELO,1609,31902.01,84417,5470,4433,3591,3061,2982,6043,9634,14067,19537,264.61,61.24,44.09,30.2
30-12-2021,VIDIGUEIRA,13,1,237,"[120,240]",Moderado,,,,13,Alentejo,BEJA,0214,31661.09,5510,300,248,215,233,275,508,723,971,1271,17.4,4.01,3.07,2.28
30-12-2021,VIEIRA DO MINHO,69,5,585,"[480,960]",Muito Elevado,,,,69,Norte,BRAGA,0311,21644.35,11842,703,594,525,548,482,1030,1555,2149,2852,54.71,13.18,9.93,7.18
30-12-2021,VILA DE REI,14,1,419,"[240,480]",Elevado,,,,14,Centro,CASTELO BRANCO,0510,19154.6,3323,169,128,172,247,302,549,721,849,1018,17.35,5.31,4.43,3.76
30-12-2021,VILA DO BISPO,35,3,680,"[480,960]",Muito Elevado,,,,35,Algarve,FARO,0815,17906.06,5154,302,302,314,232,233,465,779,1081,1383,28.78,7.72,6.04,4.35
30-12-2021,VILA DO CONDE,775,55,970,"[960,Max]",Extremamente Elevado,,,,775,Norte,PORTO,1316,14902.77,79899,4726,3875,2819,2070,1743,3813,6632,10507,15233,536.13,102.21,70.5,44.5
30-12-2021,VILA DO PORTO,51,4,909,"[480,960]",Muito Elevado,,,,51,Açores,AÇORES,4101,9688.74,5616,274,212,135,96,123,219,354,566,840,57.96,8.67,5.84,3.65
30-12-2021,VILA FLOR,30,2,499,"[480,960]",Muito Elevado,,,,30,Norte,BRAGANÇA,0410,26581.14,6044,429,362,422,294,331,625,1047,1409,1838,22.74,6.91,5.3,3.94
30-12-2021,VILA FRANCA DE XIRA,2622,187,1847,"[960,Max]",Extremamente Elevado,,,,2622,Lisboa e Vale do Tejo,LISBOA,1114,31819.39,141957,8501,6852,4869,3425,2472,5897,10766,17618,26119,446.14,82.09,55.37,33.84
30-12-2021,VILA FRANCA DO CAMPO,70,5,637,"[480,960]",Muito Elevado,,,,70,Açores,AÇORES,4206,7796.82,11051,450,344,248,217,154,371,619,963,1413,141.73,18.12,12.35,7.94
30-12-2021,VILA NOVA DA BARQUINHA,92,7,1232,"[960,Max]",Extremamente Elevado,,,,92,Lisboa e Vale do Tejo,SANTARÉM,1420,4952.97,7461,415,406,392,364,338,702,1094,1500,1915,150.64,38.66,30.28,22.09
30-12-2021,VILA NOVA DE CERVEIRA,59,4,663,"[480,960]",Muito Elevado,,,,59,Norte,VIANA DO CASTELO,1610,10846.66,8910,531,444,410,384,334,718,1128,1572,2103,82.14,19.39,14.49,10.4
30-12-2021,VILA NOVA DE FAMALICÃO,1268,91,963,"[960,Max]",Extremamente Elevado,,,,1268,Norte,BRAGA,0312,20159.26,131676,7817,6164,4202,3282,2749,6031,10233,16397,24214,653.19,120.12,81.34,50.76
30-12-2021,VILA NOVA DE FOZ CÔA,25,2,389,"[240,480]",Elevado,,,,25,Centro,GUARDA,0914,39815.18,6503,442,385,390,398,429,827,1217,1602,2044,16.33,5.13,4.02,3.06
30-12-2021,VILA NOVA DE GAIA,4053,290,1349,"[960,Max]",Extremamente Elevado,,,,4053,Norte,PORTO,1317,16846.43,300472,18349,15568,10972,8224,6281,14505,25477,41045,59394,1783.64,352.57,243.65,151.23
30-12-2021,VILA NOVA DE PAIVA,28,2,597,"[480,960]",Muito Elevado,,,,28,Centro,VISEU,1822,17553.28,4687,289,272,233,217,241,458,691,963,1252,26.7,7.13,5.49,3.94
30-12-2021,VILA NOVA DE POIARES,35,2,503,"[480,960]",Muito Elevado,,,,35,Centro,COIMBRA,0617,8445.3,6939,380,284,262,235,182,417,679,963,1343,82.17,15.9,11.4,8.04
30-12-2021,VILA POUCA DE AGUIAR,71,5,590,"[480,960]",Muito Elevado,,,,71,Norte,VILA REAL,1713,43706.62,11961,860,817,733,601,627,1228,1961,2778,3638,27.37,8.32,6.36,4.49
30-12-2021,VILA REAL,682,49,1365,"[960,Max]",Extremamente Elevado,,,,682,Norte,VILA REAL,1714,37880.28,49962,3025,2498,2065,1579,1466,3045,5110,7608,10633,131.9,28.07,20.08,13.49
30-12-2021,VILA REAL DE SANTO ANTÓNIO,182,13,971,"[960,Max]",Extremamente Elevado,,,,182,Algarve,FARO,0816,6125.0,18749,1172,1069,811,569,586,1155,1966,3035,4207,306.11,68.69,49.55,32.1
30-12-2021,VILA VELHA DE RÓDÃO,25,2,796,"[480,960]",Muito Elevado,,,,25,Centro,CASTELO BRANCO,0511,32991.16,3144,209,229,180,283,306,589,769,998,1207,9.53,3.66,3.03,2.33
30-12-2021,VILA VERDE,732,52,1561,"[960,Max]",Extremamente Elevado,,,,732,Norte,BRAGA,0313,22866.52,46911,2365,2063,1667,1494,1437,2931,4598,6661,9026,205.15,39.47,29.13,20.11
30-12-2021,VILA VIÇOSA,30,2,397,"[240,480]",Elevado,,,,30,Alentejo,ÉVORA,0714,19485.89,7656,487,379,342,345,324,669,1011,1390,1877,39.29,9.63,7.13,5.19
30-12-2021,VIMIOSO,21,2,531,"[480,960]",Muito Elevado,,,,21,Norte,BRAGANÇA,0411,48158.51,4023,274,230,261,293,335,628,889,1119,1393,8.35,2.89,2.32,1.85
30-12-2021,VINHAIS,12,1,158,"[120,240]",Moderado,,,,12,Norte,BRAGANÇA,0412,69475.09,7746,599,577,636,641,815,1456,2092,2669,3268,11.15,4.7,3.84,3.01
30-12-2021,VISEU,1044,75,1074,"[960,Max]",Extremamente Elevado,,,,1044,Centro,VISEU,1823,50710.14,97249,5769,5038,4140,3158,2710,5868,10008,15046,20815,191.77,41.05,29.67,19.74
30-12-2021,VIZELA,223,16,933,"[480,960]",Muito Elevado,,,,223,Norte,BRAGA,0314,2469.83,23897,1258,928,655,509,371,880,1535,2463,3721,967.49,150.65,99.72,62.15
30-12-2021,VOUZELA,100,7,1039,"[960,Max]",Extremamente Elevado,,,,100,Centro,VISEU,1824,19369.46,9619,626,605,554,532,507,1039,1593,2198,2824,49.66,14.58,11.35,8.22
06-01-2022,ABRANTES,664,47,1891,"[960,Max]",Extremamente Elevado,,,,664,Lisboa e Vale do Tejo,SANTARÉM,1401,71469.08,35130,2473,2213,1730,1748,2021,3769,5499,7712,10185,49.15,14.25,10.79,7.69
06-01-2022,ÁGUEDA,699,50,1517,"[960,Max]",Extremamente Elevado,,,,699,Centro,AVEIRO,0101,33527.44,46075,3237,2713,2090,1635,1496,3131,5221,7934,11171,137.43,33.32,23.66,15.57
06-01-2022,AGUIAR DA BEIRA,42,3,906,"[480,960]",Muito Elevado,,,,42,Centro,GUARDA,0901,20676.57,4652,304,281,235,239,148,387,622,903,1207,22.5,5.84,4.37,3.01
06-01-2022,ALANDROAL,49,3,981,"[960,Max]",Extremamente Elevado,,,,49,Alentejo,ÉVORA,0701,54267.81,4992,307,256,296,299,377,676,972,1228,1535,9.2,2.83,2.26,1.79
06-01-2022,ALBERGARIA-A-VELHA,455,33,1885,"[960,Max]",Extremamente Elevado,,,,455,Centro,AVEIRO,0102,15882.5,24144,1550,1298,996,687,680,1367,2363,3661,5211,152.02,32.81,23.05,14.88
06-01-2022,ALBUFEIRA,881,63,2121,"[960,Max]",Extremamente Elevado,,,,881,Algarve,FARO,0801,14066.42,41528,2067,1717,1425,985,858,1843,3268,4985,7052,295.24,50.14,35.44,23.23
06-01-2022,ALCÁCER DO SAL,140,10,1204,"[960,Max]",Extremamente Elevado,,,,140,Alentejo,SETÚBAL,1501,149987.3,11659,884,814,623,623,602,1225,1848,2662,3546,7.77,2.36,1.77,1.23
06-01-2022,ALCANENA,342,24,2673,"[960,Max]",Extremamente Elevado,,,,342,Lisboa e Vale do Tejo,SANTARÉM,1402,12732.86,12809,891,744,628,536,588,1124,1752,2496,3387,100.6,26.6,19.6,13.76
06-01-2022,ALCOBAÇA,1786,128,3334,"[960,Max]",Extremamente Elevado,,,,1786,Lisboa e Vale do Tejo,LEIRIA,1001,40814.09,53555,3420,2927,2466,2059,1676,3735,6201,9128,12548,131.22,30.74,22.36,15.19
06-01-2022,ALCOCHETE,496,35,2508,"[960,Max]",Extremamente Elevado,,,,496,Lisboa e Vale do Tejo,SETÚBAL,1502,12836.48,19787,857,834,691,476,447,923,1614,2448,3305,154.15,25.75,19.07,12.57
06-01-2022,ALCOUTIM,31,2,1444,"[960,Max]",Extremamente Elevado,,,,31,Algarve,FARO,0802,57536.33,2159,191,188,163,190,267,457,620,808,999,3.75,1.74,1.4,1.08
06-01-2022,ALENQUER,1358,97,3082,"[960,Max]",Extremamente Elevado,,,,1358,Lisboa e Vale do Tejo,LISBOA,1101,30421.92,44052,2298,2062,1629,1330,1155,2485,4114,6176,8474,144.8,27.85,20.3,13.52
06-01-2022,ALFÂNDEGA DA FÉ,51,4,1113,"[960,Max]",Extremamente Elevado,,,,51,Norte,BRAGANÇA,0401,32194.64,4550,325,277,301,274,325,599,900,1177,1502,14.13,4.67,3.66,2.8
06-01-2022,ALIJÓ,178,13,1672,"[960,Max]",Extremamente Elevado,,,,178,Norte,VILA REAL,1701,29759.89,10625,766,687,635,542,666,1208,1843,2530,3296,35.7,11.08,8.5,6.19
06-01-2022,ALJEZUR,48,3,857,"[480,960]",Muito Elevado,,,,48,Algarve,FARO,0803,32349.95,5594,316,336,335,320,410,730,1065,1401,1717,17.29,5.31,4.33,3.29
06-01-2022,ALJUSTREL,183,13,2224,"[960,Max]",Extremamente Elevado,,,,183,Alentejo,BEJA,0201,45847.41,8247,635,521,443,347,358,705,1148,1669,2304,17.99,5.03,3.64,2.5
06-01-2022,ALMADA,5901,422,3491,"[960,Max]",Extremamente Elevado,,,,5901,Lisboa e Vale do Tejo,SETÚBAL,1503,7000.89,169039,10469,9777,7876,6144,5111,11255,19131,28908,39377,2414.5,562.45,412.91,273.26
06-01-2022,ALMEIDA,100,7,1711,"[960,Max]",Extremamente Elevado,,,,100,Centro,GUARDA,0902,51798.46,5830,441,419,396,458,393,851,1247,1666,2107,11.26,4.07,3.22,2.41
06-01-2022,ALMEIRIM,462,33,2047,"[960,Max]",Extremamente Elevado,,,,462,Lisboa e Vale do Tejo,SANTARÉM,1403,22212.05,22546,1342,1353,1106,866,843,1709,2815,4168,5510,101.5,24.81,18.76,12.67
06-01-2022,ALMODÔVAR,65,5,961,"[960,Max]",Extremamente Elevado,,,,65,Alentejo,BEJA,0202,77788.03,6725,414,443,396,373,328,701,1097,1540,1954,8.65,2.51,1.98,1.41
06-01-2022,ALPIARÇA,121,9,1718,"[960,Max]",Extremamente Elevado,,,,121,Lisboa e Vale do Tejo,SANTARÉM,1404,9536.33,7059,515,486,363,333,274,607,970,1456,1971,74.02,20.67,15.27,10.17
06-01-2022,ALTER DO CHÃO,60,4,1881,"[960,Max]",Extremamente Elevado,,,,60,Alentejo,PORTALEGRE,1201,36206.62,3165,201,163,136,208,187,395,531,694,895,8.74,2.47,1.92,1.47
06-01-2022,ALVAIÁZERE,112,8,1700,"[960,Max]",Extremamente Elevado,,,,112,Centro,LEIRIA,1002,16047.76,6597,419,389,346,406,539,945,1291,1680,2099,41.11,13.08,10.47,8.04
06-01-2022,ALVITO,20,1,810,"[480,960]",Muito Elevado,,,,20,Alentejo,BEJA,0203,26485.32,2477,145,110,105,111,89,200,305,415,560,9.35,2.11,1.57,1.15
06-01-2022,AMADORA,7173,512,3896,"[960,Max]",Extremamente Elevado,,,,7173,Lisboa e Vale do Tejo,LISBOA,1115,2378.47,184106,11186,10936,8780,6460,5890,12350,21130,32066,43252,7742.05,1818.84,1348.44,888.56
06-01-2022,AMARANTE,1020,73,1918,"[960,Max]",Extremamente Elevado,,,,1020,Norte,PORTO,1301,30133.15,53193,3086,2413,1812,1643,1311,2954,4766,7179,10265,176.53,34.07,23.82,15.82
06-01-2022,AMARES,548,39,3024,"[960,Max]",Extremamente Elevado,,,,548,Norte,BRAGA,0301,8195.41,18129,1001,829,622,489,524,1013,1635,2464,3465,221.22,42.28,30.07,19.95
06-01-2022,ANADIA,418,30,1535,"[960,Max]",Extremamente Elevado,,,,418,Centro,AVEIRO,0103,21663.48,27258,1931,1698,1376,1208,1262,2470,3846,5544,7475,125.83,34.51,25.59,17.75
06-01-2022,ANGRA DO HEROÍSMO,361,26,1067,"[960,Max]",Extremamente Elevado,,,,361,Açores,AÇORES,4301,23899.66,33807,2006,1473,1122,768,635,1403,2525,3998,6004,141.45,25.12,16.73,10.56
06-01-2022,ANSIÃO,251,18,2081,"[960,Max]",Extremamente Elevado,,,,251,Centro,LEIRIA,1003,17609.42,12039,727,709,646,694,530,1224,1870,2579,3306,68.37,18.77,14.65,10.62
06-01-2022,ARCOS DE VALDEVEZ,674,48,3219,"[960,Max]",Extremamente Elevado,,,,674,Norte,VIANA DO CASTELO,1601,44759.64,20926,1329,1338,1282,1343,1515,2858,4140,5478,6807,46.75,15.21,12.24,9.25
06-01-2022,ARGANIL,191,14,1738,"[960,Max]",Extremamente Elevado,,,,191,Centro,COIMBRA,0601,33283.93,11014,672,648,612,559,596,1155,1767,2415,3087,33.09,9.27,7.26,5.31
06-01-2022,ARMAMAR,87,6,1505,"[960,Max]",Extremamente Elevado,,,,87,Norte,VISEU,1801,11723.73,5769,357,305,309,285,310,595,904,1209,1566,49.21,13.36,10.31,7.71
06-01-2022,AROUCA,389,28,1878,"[960,Max]",Extremamente Elevado,,,,389,Norte,AVEIRO,0104,32910.52,20720,1306,1047,753,683,683,1366,2119,3166,4472,62.96,13.59,9.62,6.44
06-01-2022,ARRAIOLOS,84,6,1208,"[960,Max]",Extremamente Elevado,,,,84,Alentejo,ÉVORA,0702,68374.55,6928,435,384,283,367,480,847,1130,1514,1949,10.13,2.85,2.21,1.65
06-01-2022,ARRONCHES,64,5,2281,"[960,Max]",Extremamente Elevado,,,,64,Alentejo,PORTALEGRE,1202,31464.72,2820,155,142,162,187,179,366,528,670,825,8.96,2.62,2.13,1.68
06-01-2022,ARRUDA DOS VINHOS,426,30,2764,"[960,Max]",Extremamente Elevado,,,,426,Lisboa e Vale do Tejo,LISBOA,1102,7795.93,15412,738,738,562,509,438,947,1509,2247,2985,197.69,38.29,28.82,19.36
06-01-2022,AVEIRO,1703,122,2163,"[960,Max]",Extremamente Elevado,,,,1703,Centro,AVEIRO,0105,19757.57,78734,4520,4004,3050,2250,2103,4353,7403,11407,15927,398.49,80.61,57.73,37.47
06-01-2022,AVIS,92,7,2170,"[960,Max]",Extremamente Elevado,,,,92,Alentejo,PORTALEGRE,1203,60596.51,4247,315,225,206,251,273,524,730,955,1270,7.01,2.1,1.58,1.2
06-01-2022,AZAMBUJA,547,39,2409,"[960,Max]",Extremamente Elevado,,,,547,Lisboa e Vale do Tejo,LISBOA,1103,26265.65,22716,1322,1171,1070,798,618,1416,2486,3657,4979,86.48,18.96,13.92,9.46
06-01-2022,BAIÃO,361,26,1927,"[960,Max]",Extremamente Elevado,,,,361,Norte,PORTO,1302,17452.83,18748,1070,862,714,686,725,1411,2125,2987,4057,107.42,23.25,17.11,12.18
06-01-2022,BARCELOS,3726,266,3207,"[960,Max]",Extremamente Elevado,,,,3726,Norte,BRAGA,0302,37890.14,116187,6721,5325,3619,2991,2562,5553,9172,14497,21218,306.64,56.0,38.26,24.21
06-01-2022,BARRANCOS,13,1,801,"[480,960]",Muito Elevado,,,,13,Alentejo,BEJA,0204,16841.73,1634,90,65,65,94,61,155,220,285,375,9.7,2.23,1.69,1.31
06-01-2022,BARREIRO,2506,179,3335,"[960,Max]",Extremamente Elevado,,,,2506,Lisboa e Vale do Tejo,SETÚBAL,1504,3639.07,75147,5194,5565,4459,3105,1767,4872,9331,14896,20090,2065.05,552.07,409.34,256.42
06-01-2022,BATALHA,424,30,2654,"[960,Max]",Extremamente Elevado,,,,424,Centro,LEIRIA,1004,10341.6,15963,873,762,649,529,549,1078,1727,2489,3362,154.35,32.51,24.07,16.7
06-01-2022,BEJA,532,38,1584,"[960,Max]",Extremamente Elevado,,,,532,Alentejo,BEJA,0205,114647.55,33579,2005,1840,1386,1272,1039,2311,3697,5537,7542,29.29,6.58,4.83,3.22
06-01-2022,BELMONTE,82,6,1285,"[960,Max]",Extremamente Elevado,,,,82,Centro,CASTELO BRANCO,0501,11875.91,6398,444,321,325,310,355,665,990,1311,1755,53.87,14.78,11.04,8.34
06-01-2022,BENAVENTE,801,57,2616,"[960,Max]",Extremamente Elevado,,,,801,Lisboa e Vale do Tejo,SANTARÉM,1405,52138.39,30602,1468,1376,1141,876,643,1519,2660,4036,5504,58.69,10.56,7.74,5.1
06-01-2022,BOMBARRAL,294,21,2342,"[960,Max]",Extremamente Elevado,,,,294,Lisboa e Vale do Tejo,LEIRIA,1005,9128.55,12558,875,714,561,491,429,920,1481,2195,3070,137.56,33.63,24.04,16.22
06-01-2022,BORBA,100,7,1485,"[960,Max]",Extremamente Elevado,,,,100,Alentejo,ÉVORA,0703,14518.65,6736,430,375,279,436,392,828,1107,1482,1912,46.39,13.17,10.21,7.62
06-01-2022,BOTICAS,88,6,1766,"[960,Max]",Extremamente Elevado,,,,88,Norte,VILA REAL,1702,32195.66,4998,347,306,311,305,380,685,996,1302,1649,15.52,5.12,4.04,3.09
06-01-2022,BRAGA,6827,488,3737,"[960,Max]",Extremamente Elevado,,,,6827,Norte,BRAGA,0303,18339.95,182679,10029,7963,5241,4320,3671,7991,13232,21195,31224,996.07,170.25,115.57,72.15
06-01-2022,BRAGANÇA,927,66,2757,"[960,Max]",Extremamente Elevado,,,,927,Norte,BRAGANÇA,0402,117357.27,33607,2402,1855,1652,1393,1163,2556,4208,6063,8465,28.64,7.21,5.17,3.59
06-01-2022,CABECEIRAS DE BASTO,450,32,2879,"[960,Max]",Extremamente Elevado,,,,450,Norte,BRAGA,0304,24182.16,15628,774,594,544,575,574,1149,1693,2287,3061,64.63,12.66,9.46,7.0
06-01-2022,CADAVAL,304,22,2221,"[960,Max]",Extremamente Elevado,,,,304,Lisboa e Vale do Tejo,LISBOA,1104,17489.3,13673,813,796,756,621,625,1246,2002,2798,3611,78.18,20.65,16.0,11.45
06-01-2022,CALDAS DA RAINHA,1321,94,2544,"[960,Max]",Extremamente Elevado,,,,1321,Lisboa e Vale do Tejo,LEIRIA,1006,25569.47,51912,3035,2684,2186,1899,1705,3604,5790,8474,11509,203.03,45.01,33.14,22.64
06-01-2022,CALHETA,281,20,2585,"[960,Max]",Extremamente Elevado,,,,281,Madeira,MADEIRA,3101,11150.43,10867,576,497,507,399,415,814,1321,1818,2394,97.46,21.47,16.3,11.85
06-01-2022,CALHETA (AÇORES),12,1,380,"[240,480]",Elevado,,,,12,Açores,AÇORES,4501,12626.4,3184,215,159,141,139,122,261,402,561,776,25.22,6.15,4.44,3.18
06-01-2022,CÂMARA DE LOBOS,1491,107,4429,"[960,Max]",Extremamente Elevado,,,,1491,Madeira,MADEIRA,3102,5216.67,33675,1396,1059,834,545,381,926,1760,2819,4215,645.49,80.79,54.03,33.74
06-01-2022,CAMINHA,342,24,2154,"[960,Max]",Extremamente Elevado,,,,342,Norte,VIANA DO CASTELO,1602,13652.14,15877,1046,944,818,646,656,1302,2120,3064,4110,116.3,30.11,22.44,15.53
06-01-2022,CAMPO MAIOR,274,20,3478,"[960,Max]",Extremamente Elevado,,,,274,Alentejo,PORTALEGRE,1204,24720.16,7874,471,364,351,279,327,606,957,1321,1792,31.85,7.25,5.34,3.87
06-01-2022,CANTANHEDE,503,36,1438,"[960,Max]",Extremamente Elevado,,,,503,Centro,COIMBRA,0602,39088.02,35011,2346,2096,1880,1709,1451,3160,5040,7136,9482,89.57,24.26,18.26,12.89
06-01-2022,CARRAZEDA DE ANSIÃES,90,6,1586,"[960,Max]",Extremamente Elevado,,,,90,Norte,BRAGANÇA,0403,27924.09,5666,424,389,391,312,465,777,1168,1557,1981,20.29,7.09,5.58,4.18
06-01-2022,CARREGAL DO SAL,107,8,1149,"[960,Max]",Extremamente Elevado,,,,107,Centro,VISEU,1802,11689.21,9271,587,562,486,462,376,838,1324,1886,2473,79.31,21.16,16.13,11.33
06-01-2022,CARTAXO,587,42,2464,"[960,Max]",Extremamente Elevado,,,,587,Lisboa e Vale do Tejo,SANTARÉM,1406,15817.28,23843,1415,1376,1142,861,632,1493,2635,4011,5426,150.74,34.3,25.36,16.66
06-01-2022,CASCAIS,6955,497,3256,"[960,Max]",Extremamente Elevado,,,,6955,Lisboa e Vale do Tejo,LISBOA,1105,9740.17,213608,12151,11444,8680,6469,5248,11717,20397,31841,43992,2193.1,451.66,326.91,209.41
06-01-2022,CASTANHEIRA DE PÊRA,27,2,1048,"[960,Max]",Extremamente Elevado,,,,27,Centro,LEIRIA,1007,6677.45,2614,233,195,157,190,187,377,534,729,962,39.15,14.41,10.92,8.0
06-01-2022,CASTELO BRANCO,1279,91,2461,"[960,Max]",Extremamente Elevado,,,,1279,Centro,CASTELO BRANCO,0502,143819.15,51987,3528,3042,2499,2229,2225,4454,6953,9995,13523,36.15,9.4,6.95,4.83
06-01-2022,CASTELO DE PAIVA,353,25,2287,"[960,Max]",Extremamente Elevado,,,,353,Norte,AVEIRO,0106,11500.53,15454,881,697,545,420,431,851,1396,2093,2974,134.37,25.86,18.2,12.14
06-01-2022,CASTELO DE VIDE,46,3,1592,"[960,Max]",Extremamente Elevado,,,,46,Alentejo,PORTALEGRE,1205,26491.24,2919,204,173,179,147,170,317,496,669,873,11.02,3.3,2.53,1.87
06-01-2022,CASTRO DAIRE,199,14,1440,"[960,Max]",Extremamente Elevado,,,,199,Centro,VISEU,1803,37904.13,13823,942,857,765,732,773,1505,2270,3127,4069,36.47,10.74,8.25,5.99
06-01-2022,CASTRO MARIM,132,9,2114,"[960,Max]",Extremamente Elevado,,,,132,Algarve,FARO,0804,30084.37,6237,370,345,334,322,344,666,1000,1345,1715,20.73,5.7,4.47,3.32
06-01-2022,CASTRO VERDE,161,12,2322,"[960,Max]",Extremamente Elevado,,,,161,Alentejo,BEJA,0206,56944.23,6949,437,347,303,275,227,502,805,1152,1589,12.2,2.79,2.02,1.41
06-01-2022,CELORICO DA BEIRA,73,5,1053,"[960,Max]",Extremamente Elevado,,,,73,Centro,GUARDA,0903,24721.63,6928,430,416,363,369,535,904,1267,1683,2113,28.02,8.55,6.81,5.12
06-01-2022,CELORICO DE BASTO,457,33,2402,"[960,Max]",Extremamente Elevado,,,,457,Norte,BRAGA,0305,18107.02,19040,1001,802,668,728,729,1457,2125,2927,3928,105.15,21.69,16.17,11.74
06-01-2022,CHAMUSCA,174,12,1897,"[960,Max]",Extremamente Elevado,,,,174,Lisboa e Vale do Tejo,SANTARÉM,1407,74600.54,9197,629,583,553,465,579,1044,1597,2180,2809,12.33,3.77,2.92,2.14
06-01-2022,CHAVES,685,49,1742,"[960,Max]",Extremamente Elevado,,,,685,Norte,VILA REAL,1703,59122.95,39343,2676,2429,1991,1886,1918,3804,5795,8224,10900,66.54,18.44,13.91,9.8
06-01-2022,CINFÃES,319,23,1750,"[960,Max]",Extremamente Elevado,,,,319,Norte,VISEU,1804,23928.76,18244,1067,902,779,734,758,1492,2271,3173,4240,76.24,17.72,13.26,9.49
06-01-2022,COIMBRA,3062,219,2282,"[960,Max]",Extremamente Elevado,,,,3062,Centro,COIMBRA,0603,31939.94,134166,9489,8734,6353,5139,5074,10213,16566,25300,34789,420.06,108.92,79.21,51.87
06-01-2022,CONDEIXA-A-NOVA,263,19,1481,"[960,Max]",Extremamente Elevado,,,,263,Centro,COIMBRA,0604,13867.47,17733,871,809,717,583,490,1073,1790,2599,3470,127.88,25.02,18.74,12.91
06-01-2022,CONSTÂNCIA,45,3,1111,"[960,Max]",Extremamente Elevado,,,,45,Lisboa e Vale do Tejo,SANTARÉM,1408,8036.58,4030,211,183,187,148,155,303,490,673,884,50.14,11.0,8.37,6.1
06-01-2022,CORUCHE,256,18,1466,"[960,Max]",Extremamente Elevado,,,,256,Lisboa e Vale do Tejo,SANTARÉM,1409,111572.03,17471,1294,1090,1095,1096,1019,2115,3210,4300,5594,15.66,5.01,3.85,2.88
06-01-2022,CORVO,3,0,638,"[480,960]",Muito Elevado,,,,3,Açores,AÇORES,4901,1711.45,464,22,21,11,13,19,32,43,64,86,27.12,5.03,3.74,2.51
06-01-2022,COVILHÃ,790,56,1689,"[960,Max]",Extremamente Elevado,,,,790,Centro,CASTELO BRANCO,0503,55560.06,46787,3533,2998,2365,2111,2193,4304,6669,9667,13200,84.21,23.76,17.4,12.0
06-01-2022,CRATO,72,5,2289,"[960,Max]",Extremamente Elevado,,,,72,Alentejo,PORTALEGRE,1206,39806.88,3129,229,258,163,182,228,410,573,831,1060,7.86,2.66,2.09,1.44
06-01-2022,CUBA,50,4,1078,"[960,Max]",Extremamente Elevado,,,,50,Alentejo,BEJA,0207,17208.72,4595,255,233,206,190,143,333,539,772,1027,26.7,5.97,4.49,3.13
06-01-2022,ELVAS,558,40,2716,"[960,Max]",Extremamente Elevado,,,,558,Alentejo,PORTALEGRE,1207,63128.86,20528,1057,1145,902,852,810,1662,2564,3709,4766,32.52,7.55,5.88,4.06
06-01-2022,ENTRONCAMENTO,529,38,2454,"[960,Max]",Extremamente Elevado,,,,529,Lisboa e Vale do Tejo,SANTARÉM,1410,1372.81,21558,1066,930,868,695,592,1287,2155,3085,4151,1570.14,302.33,224.69,156.96
06-01-2022,ESPINHO,625,45,2117,"[960,Max]",Extremamente Elevado,,,,625,Norte,AVEIRO,0107,2105.68,29516,2205,1993,1430,1177,960,2137,3567,5560,7765,1401.52,368.71,264.01,169.37
06-01-2022,ESPOSENDE,1082,77,3167,"[960,Max]",Extremamente Elevado,,,,1082,Norte,BRAGA,0306,9540.98,34177,1831,1522,1095,894,723,1617,2712,4234,6065,358.21,63.57,44.38,28.42
06-01-2022,ESTARREJA,476,34,1832,"[960,Max]",Extremamente Elevado,,,,476,Centro,AVEIRO,0108,10817.33,26006,1503,1399,1106,953,728,1681,2787,4186,5689,240.42,52.59,38.7,25.76
06-01-2022,ESTREMOZ,182,13,1428,"[960,Max]",Extremamente Elevado,,,,182,Alentejo,ÉVORA,0704,51379.95,12728,789,613,697,786,877,1663,2360,2973,3762,24.77,7.32,5.79,4.59
06-01-2022,ÉVORA,922,66,1758,"[960,Max]",Extremamente Elevado,,,,922,Alentejo,ÉVORA,0705,130707.58,52428,3569,2852,2176,1966,1803,3769,5945,8797,12366,40.11,9.46,6.73,4.55
06-01-2022,FAFE,1382,99,2876,"[960,Max]",Extremamente Elevado,,,,1382,Norte,BRAGA,0307,21908.11,48060,3044,2455,1679,1403,1208,2611,4290,6745,9789,219.37,44.68,30.79,19.58
06-01-2022,FARO,1242,89,2036,"[960,Max]",Extremamente Elevado,,,,1242,Algarve,FARO,0805,20256.79,61015,3847,3364,2604,2055,1601,3656,6260,9624,13471,301.2,66.5,47.51,30.9
06-01-2022,FELGUEIRAS,1102,79,1953,"[960,Max]",Extremamente Elevado,,,,1102,Norte,PORTO,1303,11573.75,56422,2951,2302,1601,1316,973,2289,3890,6192,9143,487.49,79.0,53.5,33.61
06-01-2022,FERREIRA DO ALENTEJO,39,3,500,"[480,960]",Muito Elevado,,,,39,Alentejo,BEJA,0208,64820.68,7845,515,414,372,343,345,688,1060,1474,1989,12.1,3.07,2.27,1.64
06-01-2022,FERREIRA DO ZÊZERE,371,27,4665,"[960,Max]",Extremamente Elevado,,,,371,Lisboa e Vale do Tejo,SANTARÉM,1411,19038.03,7959,470,370,416,465,456,921,1337,1707,2177,41.81,11.44,8.97,7.02
06-01-2022,FIGUEIRA DA FOZ,954,68,1624,"[960,Max]",Extremamente Elevado,,,,954,Centro,COIMBRA,0605,37905.26,58747,4032,3597,2887,2495,2043,4538,7425,11022,15054,154.98,39.72,29.08,19.59
06-01-2022,FIGUEIRA DE CASTELO RODRIGO,71,5,1271,"[960,Max]",Extremamente Elevado,,,,71,Centro,GUARDA,0904,50857.46,5584,347,352,290,352,391,743,1033,1385,1732,10.98,3.41,2.72,2.03
06-01-2022,FIGUEIRÓ DOS VINHOS,49,4,881,"[480,960]",Muito Elevado,,,,49,Centro,LEIRIA,1008,17344.0,5568,402,386,322,309,351,660,982,1368,1770,32.1,10.21,7.89,5.66
06-01-2022,FORNOS DE ALGODRES,60,4,1322,"[960,Max]",Extremamente Elevado,,,,60,Centro,GUARDA,0905,13145.05,4528,261,218,247,256,232,488,735,953,1214,34.45,9.24,7.25,5.59
06-01-2022,FREIXO DE ESPADA À CINTA,86,6,2593,"[960,Max]",Extremamente Elevado,,,,86,Norte,BRAGANÇA,0404,24414.29,3298,211,177,231,196,189,385,616,793,1004,13.51,4.11,3.25,2.52
06-01-2022,FRONTEIRA,56,4,1875,"[960,Max]",Extremamente Elevado,,,,56,Alentejo,PORTALEGRE,1208,24859.58,2974,213,182,149,156,168,324,473,655,868,11.96,3.49,2.63,1.9
06-01-2022,FUNCHAL,4043,289,3887,"[960,Max]",Extremamente Elevado,,,,4043,Madeira,MADEIRA,3103,7616.2,104024,6382,5086,3643,2821,1990,4811,8454,13540,19922,1365.86,261.58,177.78,111.0
06-01-2022,FUNDÃO,520,37,1961,"[960,Max]",Extremamente Elevado,,,,520,Centro,CASTELO BRANCO,0504,70019.79,26495,1781,1464,1432,1357,1643,3000,4432,5896,7677,37.84,10.96,8.42,6.33
06-01-2022,GAVIÃO,35,2,1068,"[960,Max]",Extremamente Elevado,,,,35,Alentejo,PORTALEGRE,1209,29459.45,3263,189,186,222,263,293,556,778,964,1153,11.08,3.91,3.27,2.64
06-01-2022,GÓIS,33,2,875,"[480,960]",Muito Elevado,,,,33,Centro,COIMBRA,0606,26330.19,3805,235,199,240,233,244,477,717,916,1151,14.45,4.37,3.48,2.72
06-01-2022,GOLEGÃ,148,11,2779,"[960,Max]",Extremamente Elevado,,,,148,Lisboa e Vale do Tejo,SANTARÉM,1412,8431.67,5339,356,299,281,243,255,498,779,1078,1434,63.32,17.01,12.78,9.24
06-01-2022,GONDOMAR,3965,283,2389,"[960,Max]",Extremamente Elevado,,,,3965,Norte,PORTO,1304,13191.76,165985,10555,8755,6222,4450,3364,7814,14036,22791,33346,1258.22,252.77,172.76,106.4
06-01-2022,GOUVEIA,123,9,995,"[960,Max]",Extremamente Elevado,,,,123,Centro,GUARDA,0906,30061.17,12387,871,931,780,783,810,1593,2373,3304,4175,41.21,13.89,10.99,7.89
06-01-2022,GRÂNDOLA,178,13,1219,"[960,Max]",Extremamente Elevado,,,,178,Alentejo,SETÚBAL,1505,82593.66,14639,834,834,708,688,672,1360,2068,2902,3736,17.72,4.52,3.51,2.5
06-01-2022,GUARDA,625,45,1603,"[960,Max]",Extremamente Elevado,,,,625,Centro,GUARDA,0907,71209.58,38969,2477,2041,1686,1415,1474,2889,4575,6616,9093,54.72,12.77,9.29,6.42
06-01-2022,GUIMARÃES,4428,316,2907,"[960,Max]",Extremamente Elevado,,,,4428,Norte,BRAGA,0308,24099.96,152309,9394,7074,4809,3877,2948,6825,11634,18708,28102,631.99,116.61,77.63,48.27
06-01-2022,HORTA,200,14,1378,"[960,Max]",Extremamente Elevado,,,,200,Açores,AÇORES,4701,17305.53,14521,818,658,468,352,302,654,1122,1780,2598,83.91,15.01,10.29,6.48
06-01-2022,IDANHA-A-NOVA,169,12,2107,"[960,Max]",Extremamente Elevado,,,,169,Centro,CASTELO BRANCO,0505,141633.51,8043,518,490,519,672,974,1646,2165,2655,3173,5.68,2.24,1.87,1.53
06-01-2022,ÍLHAVO,893,64,2308,"[960,Max]",Extremamente Elevado,,,,893,Centro,AVEIRO,0110,7347.55,38699,2227,1943,1444,1193,850,2043,3487,5430,7657,526.66,104.21,73.9,47.46
06-01-2022,LAGOA (FARO),298,21,1310,"[960,Max]",Extremamente Elevado,,,,298,Algarve,FARO,0806,8825.45,22762,1314,1168,919,749,670,1419,2338,3506,4820,257.93,54.62,39.73,26.49
06-01-2022,LAGOA,250,18,1695,"[960,Max]",Extremamente Elevado,,,,250,Açores,AÇORES,4201,4559.32,14721,536,458,349,238,235,473,822,1280,1816,322.9,39.83,28.08,18.03
06-01-2022,LAGOS,512,37,1685,"[960,Max]",Extremamente Elevado,,,,512,Algarve,FARO,0807,21299.27,30374,1744,1434,1247,1053,1029,2082,3329,4763,6507,142.61,30.55,22.36,15.63
06-01-2022,LAJES DAS FLORES,12,1,821,"[480,960]",Muito Elevado,,,,12,Açores,AÇORES,4801,7004.79,1463,88,53,62,46,54,100,162,215,303,20.89,4.33,3.07,2.31
06-01-2022,LAJES DO PICO,32,2,715,"[480,960]",Muito Elevado,,,,32,Açores,AÇORES,4601,15531.09,4490,304,231,223,159,162,321,544,775,1079,28.91,6.95,4.99,3.5
06-01-2022,LAMEGO,564,40,2266,"[960,Max]",Extremamente Elevado,,,,564,Norte,VISEU,1805,16542.11,24895,1639,1284,1124,898,783,1681,2805,4089,5728,150.5,34.63,24.72,16.96
06-01-2022,LEIRIA,3414,244,2725,"[960,Max]",Extremamente Elevado,,,,3414,Centro,LEIRIA,1009,56508.83,125267,7389,6366,5090,3902,3159,7061,12151,18517,25906,221.68,45.84,32.77,21.5
06-01-2022,LISBOA,21909,1565,4300,"[960,Max]",Extremamente Elevado,,,,21909,Lisboa e Vale do Tejo,LISBOA,1106,10005.43,509515,33197,33340,27706,23037,26770,49807,77513,110853,144050,5092.6,1439.78,1107.98,774.74
06-01-2022,LOULÉ,1288,92,1875,"[960,Max]",Extremamente Elevado,,,,1288,Algarve,FARO,0808,76366.91,68697,3890,3350,2780,2358,2251,4609,7389,10739,14629,89.96,19.16,14.06,9.68
06-01-2022,LOURES,7716,551,3611,"[960,Max]",Extremamente Elevado,,,,7716,Lisboa e Vale do Tejo,LISBOA,1107,16723.99,213687,12746,12794,9644,6669,5033,11702,21346,34140,46886,1277.73,280.35,204.14,127.64
06-01-2022,LOURINHÃ,561,40,2169,"[960,Max]",Extremamente Elevado,,,,561,Lisboa e Vale do Tejo,LISBOA,1108,14717.2,25855,1584,1243,992,842,645,1487,2479,3722,5306,175.68,36.05,25.29,16.84
06-01-2022,LOUSÃ,403,29,2350,"[960,Max]",Extremamente Elevado,,,,403,Centro,COIMBRA,0607,13840.01,17158,946,866,658,528,450,978,1636,2502,3448,123.97,24.91,18.08,11.82
06-01-2022,LOUSADA,873,62,1868,"[960,Max]",Extremamente Elevado,,,,873,Norte,PORTO,1305,9608.01,46755,2289,1698,1176,853,621,1474,2650,4348,6637,486.63,69.08,45.25,27.58
06-01-2022,MAÇÃO,196,14,3133,"[960,Max]",Extremamente Elevado,,,,196,Lisboa e Vale do Tejo,SANTARÉM,1413,39997.98,6267,386,362,390,440,657,1097,1487,1849,2235,15.67,5.59,4.62,3.72
06-01-2022,MACEDO DE CAVALEIROS,236,17,1623,"[960,Max]",Extremamente Elevado,,,,236,Norte,BRAGANÇA,0405,69914.08,14516,1082,889,878,823,938,1761,2639,3528,4610,20.76,6.59,5.05,3.77
06-01-2022,MACHICO,712,51,3563,"[960,Max]",Extremamente Elevado,,,,712,Madeira,MADEIRA,3104,6825.1,19981,1197,860,662,455,331,786,1448,2308,3505,292.76,51.36,33.82,21.22
06-01-2022,MADALENA,42,3,714,"[480,960]",Muito Elevado,,,,42,Açores,AÇORES,4602,14712.33,5895,334,256,173,190,179,369,542,798,1132,40.07,7.69,5.42,3.68
06-01-2022,MAFRA,2492,178,2938,"[960,Max]",Extremamente Elevado,,,,2492,Lisboa e Vale do Tejo,LISBOA,1109,29165.5,84816,3613,3334,2839,2089,1899,3988,6827,10161,13774,290.81,47.23,34.84,23.41
06-01-2022,MAIA,3585,256,2580,"[960,Max]",Extremamente Elevado,,,,3585,Norte,PORTO,1306,8293.94,138971,7801,6617,4512,3339,2631,5970,10482,17099,24900,1675.56,300.22,206.16,126.38
06-01-2022,MANGUALDE,218,16,1176,"[960,Max]",Extremamente Elevado,,,,218,Centro,VISEU,1806,21925.56,18510,1198,1128,885,852,743,1595,2480,3608,4806,84.42,21.92,16.46,11.31
06-01-2022,MANTEIGAS,59,4,1976,"[960,Max]",Extremamente Elevado,,,,59,Centro,GUARDA,0908,12197.55,3007,258,197,159,167,146,313,472,669,927,24.65,7.6,5.48,3.87
06-01-2022,MARCO DE CANAVESES,1368,98,2657,"[960,Max]",Extremamente Elevado,,,,1368,Norte,PORTO,1307,20188.98,51496,2678,2060,1488,1265,1023,2288,3776,5836,8514,255.07,42.17,28.91,18.7
06-01-2022,MARINHA GRANDE,753,54,1955,"[960,Max]",Extremamente Elevado,,,,753,Centro,LEIRIA,1010,18725.19,38508,2365,2302,1638,1359,1058,2417,4055,6357,8722,205.65,46.58,33.95,21.66
06-01-2022,MARVÃO,31,2,1021,"[960,Max]",Extremamente Elevado,,,,31,Alentejo,PORTALEGRE,1210,15489.9,3005,198,185,142,197,237,434,576,761,959,19.4,6.19,4.91,3.72
06-01-2022,MATOSINHOS,4586,328,2615,"[960,Max]",Extremamente Elevado,,,,4586,Norte,PORTO,1308,6241.97,175357,11850,9977,7023,5024,3884,8908,15931,25908,37758,2809.31,604.9,415.06,255.22
06-01-2022,MEALHADA,318,23,1599,"[960,Max]",Extremamente Elevado,,,,318,Centro,AVEIRO,0111,11065.66,19914,1163,1039,810,828,831,1659,2469,3508,4671,179.96,42.21,31.7,22.31
06-01-2022,MÊDA,104,7,2273,"[960,Max]",Extremamente Elevado,,,,104,Centro,GUARDA,0909,28604.92,4587,343,306,290,288,443,731,1021,1327,1670,16.04,5.84,4.64,3.57
06-01-2022,MELGAÇO,126,9,1552,"[960,Max]",Extremamente Elevado,,,,126,Norte,VIANA DO CASTELO,1603,23824.58,8093,507,567,578,614,675,1289,1867,2434,2941,33.97,12.34,10.22,7.84
06-01-2022,MÉRTOLA,148,11,2414,"[960,Max]",Extremamente Elevado,,,,148,Alentejo,BEJA,0209,129287.34,6142,400,390,378,423,600,1023,1401,1791,2191,4.75,1.69,1.39,1.08
06-01-2022,MESÃO FRIO,52,4,1320,"[960,Max]",Extremamente Elevado,,,,52,Norte,VILA REAL,1704,2664.87,3964,265,205,168,157,120,277,445,650,915,148.74,34.33,24.39,16.7
06-01-2022,MIRA,206,15,1743,"[960,Max]",Extremamente Elevado,,,,206,Centro,COIMBRA,0608,12403.38,11832,727,729,659,550,466,1016,1675,2404,3131,95.4,25.24,19.38,13.5
06-01-2022,MIRANDA DO CORVO,160,11,1259,"[960,Max]",Extremamente Elevado,,,,160,Centro,COIMBRA,0609,12637.79,12708,706,659,568,498,404,902,1470,2129,2835,100.55,22.43,16.85,11.63
06-01-2022,MIRANDA DO DOURO,99,7,1449,"[960,Max]",Extremamente Elevado,,,,99,Norte,BRAGANÇA,0406,48718.31,6830,482,429,442,463,470,933,1375,1804,2286,14.02,4.69,3.7,2.82
06-01-2022,MIRANDELA,317,23,1459,"[960,Max]",Extremamente Elevado,,,,317,Norte,BRAGANÇA,0407,65895.67,21754,1640,1315,1204,1078,947,2025,3229,4544,6184,33.01,9.38,6.9,4.9
06-01-2022,MOGADOURO,205,15,2438,"[960,Max]",Extremamente Elevado,,,,205,Norte,BRAGANÇA,0408,76064.93,8392,589,529,576,630,655,1285,1861,2390,2979,11.03,3.92,3.14,2.45
06-01-2022,MOIMENTA DA BEIRA,125,9,1287,"[960,Max]",Extremamente Elevado,,,,125,Norte,VISEU,1807,21996.9,9736,576,514,471,416,461,877,1348,1862,2438,44.26,11.08,8.46,6.13
06-01-2022,MOITA,2225,159,3454,"[960,Max]",Extremamente Elevado,,,,2225,Lisboa e Vale do Tejo,SETÚBAL,1506,5525.98,64407,4226,3646,2623,1801,1425,3226,5849,9495,13721,1165.53,248.3,171.82,105.85
06-01-2022,MONÇÃO,455,32,2544,"[960,Max]",Extremamente Elevado,,,,455,Norte,VIANA DO CASTELO,1604,21130.85,17869,1161,1105,1031,1006,972,1978,3009,4114,5275,84.56,24.96,19.47,14.24
06-01-2022,MONCHIQUE,44,3,864,"[480,960]",Muito Elevado,,,,44,Algarve,FARO,0809,39530.43,5077,353,384,321,355,392,747,1068,1452,1805,12.84,4.57,3.67,2.7
06-01-2022,MONDIM DE BASTO,197,14,2834,"[960,Max]",Extremamente Elevado,,,,197,Norte,VILA REAL,1705,17207.52,6946,395,300,314,284,283,567,881,1181,1576,40.36,9.16,6.86,5.12
06-01-2022,MONFORTE,38,3,1289,"[960,Max]",Extremamente Elevado,,,,38,Alentejo,PORTALEGRE,1211,42024.82,2975,139,115,117,192,168,360,477,592,731,7.08,1.74,1.41,1.14
06-01-2022,MONTALEGRE,118,8,1317,"[960,Max]",Extremamente Elevado,,,,118,Norte,VILA REAL,1706,80545.71,8997,699,628,595,603,730,1333,1928,2556,3255,11.17,4.04,3.17,2.39
06-01-2022,MONTEMOR-O-NOVO,301,21,1923,"[960,Max]",Extremamente Elevado,,,,301,Alentejo,ÉVORA,0706,123296.65,15647,991,953,868,878,971,1849,2717,3670,4661,12.69,3.78,2.98,2.2
06-01-2022,MONTEMOR-O-VELHO,464,33,1839,"[960,Max]",Extremamente Elevado,,,,464,Centro,COIMBRA,0610,22896.23,25224,1496,1397,1217,1057,988,2045,3262,4659,6155,110.17,26.88,20.35,14.25
06-01-2022,MONTIJO,1196,85,2076,"[960,Max]",Extremamente Elevado,,,,1196,Lisboa e Vale do Tejo,SETÚBAL,1507,34861.64,57614,2771,2441,1990,1554,1109,2663,4653,7094,9865,165.26,28.3,20.35,13.35
06-01-2022,MORA,51,4,1239,"[960,Max]",Extremamente Elevado,,,,51,Alentejo,ÉVORA,0707,44395.02,4138,336,275,252,238,257,495,747,1022,1358,9.32,3.06,2.3,1.68
06-01-2022,MORTÁGUA,196,14,2223,"[960,Max]",Extremamente Elevado,,,,196,Centro,VISEU,1808,25117.82,8803,638,584,535,499,460,959,1494,2078,2716,35.05,10.81,8.27,5.95
06-01-2022,MOURA,345,25,2514,"[960,Max]",Extremamente Elevado,,,,345,Alentejo,BEJA,0210,95845.55,13718,817,656,665,542,461,1003,1668,2324,3141,14.31,3.28,2.42,1.74
06-01-2022,MOURÃO,22,2,904,"[480,960]",Muito Elevado,,,,22,Alentejo,ÉVORA,0708,27862.98,2450,139,108,80,104,109,213,293,401,540,8.79,1.94,1.44,1.05
06-01-2022,MURÇA,158,11,2889,"[960,Max]",Extremamente Elevado,,,,158,Norte,VILA REAL,1707,18937.11,5463,384,341,307,306,319,625,932,1273,1657,28.85,8.75,6.72,4.92
06-01-2022,MURTOSA,151,11,1470,"[960,Max]",Extremamente Elevado,,,,151,Centro,AVEIRO,0112,7308.78,10279,509,473,403,353,409,762,1165,1638,2147,140.63,29.37,22.41,15.94
06-01-2022,NAZARÉ,480,34,3387,"[960,Max]",Extremamente Elevado,,,,480,Lisboa e Vale do Tejo,LEIRIA,1011,8243.43,14165,967,903,670,420,396,816,1486,2389,3356,171.84,40.71,28.98,18.03
06-01-2022,NELAS,169,12,1302,"[960,Max]",Extremamente Elevado,,,,169,Centro,VISEU,1809,12571.48,12974,924,787,668,604,583,1187,1855,2642,3566,103.21,28.37,21.02,14.76
06-01-2022,NISA,95,7,1561,"[960,Max]",Extremamente Elevado,,,,95,Alentejo,PORTALEGRE,1212,57567.84,6061,405,389,355,483,478,961,1316,1705,2110,10.53,3.67,2.96,2.29
06-01-2022,NORDESTE,55,4,1141,"[960,Max]",Extremamente Elevado,,,,55,Açores,AÇORES,4202,10146.8,4862,246,180,124,161,162,323,447,627,873,47.92,8.6,6.18,4.41
06-01-2022,ÓBIDOS,244,17,2055,"[960,Max]",Extremamente Elevado,,,,244,Lisboa e Vale do Tejo,LEIRIA,1012,14155.44,11850,743,650,574,452,436,888,1462,2112,2855,83.72,20.17,14.92,10.33
06-01-2022,ODEMIRA,237,17,958,"[480,960]",Muito Elevado,,,,237,Alentejo,BEJA,0211,172060.15,24717,1475,1317,1225,1397,1349,2746,3971,5288,6763,14.37,3.93,3.07,2.31
06-01-2022,ODIVELAS,5690,406,3517,"[960,Max]",Extremamente Elevado,,,,5690,Lisboa e Vale do Tejo,LISBOA,1116,2654.36,161774,9562,9038,6952,4641,3812,8453,15405,24443,34005,6095.48,1281.27,920.99,580.44
06-01-2022,OEIRAS,6859,490,3866,"[960,Max]",Extremamente Elevado,,,,6859,Lisboa e Vale do Tejo,LISBOA,1110,4588.31,177408,11580,11575,8566,6211,5855,12066,20632,32207,43787,3866.78,954.38,701.98,449.69
06-01-2022,OLEIROS,37,3,739,"[480,960]",Muito Elevado,,,,37,Centro,CASTELO BRANCO,0506,47109.31,5003,384,341,366,397,487,884,1250,1591,1975,10.62,4.19,3.38,2.65
06-01-2022,OLHÃO,630,45,1419,"[960,Max]",Extremamente Elevado,,,,630,Algarve,FARO,0810,13086.38,44405,2455,2309,1689,1342,1268,2610,4299,6608,9063,339.33,69.26,50.5,32.85
06-01-2022,OLIVEIRA DE AZEMÉIS,1463,104,2216,"[960,Max]",Extremamente Elevado,,,,1463,Norte,AVEIRO,0113,16110.41,66011,4155,3614,2794,2183,1738,3921,6715,10329,14484,409.75,89.91,64.12,41.68
06-01-2022,OLIVEIRA DE FRADES,237,17,2384,"[960,Max]",Extremamente Elevado,,,,237,Centro,VISEU,1810,14534.62,9936,553,475,438,359,415,774,1212,1687,2240,68.36,15.41,11.61,8.34
06-01-2022,OLIVEIRA DO BAIRRO,356,25,1465,"[960,Max]",Extremamente Elevado,,,,356,Centro,AVEIRO,0114,8731.99,24277,1327,1182,999,786,810,1596,2595,3777,5104,278.02,58.45,43.25,29.72
06-01-2022,OLIVEIRA DO HOSPITAL,301,22,1564,"[960,Max]",Extremamente Elevado,,,,301,Centro,COIMBRA,0611,23451.66,19253,1161,1097,962,924,960,1884,2846,3943,5104,82.1,21.76,16.81,12.14
06-01-2022,OURÉM,1250,89,2838,"[960,Max]",Extremamente Elevado,,,,1250,Lisboa e Vale do Tejo,SANTARÉM,1421,41668.03,44044,2463,2069,1899,1817,1603,3420,5319,7388,9851,105.7,23.64,17.73,12.77
06-01-2022,OURIQUE,45,3,968,"[960,Max]",Extremamente Elevado,,,,45,Alentejo,BEJA,0212,66331.36,4607,313,287,284,268,227,495,779,1066,1379,6.95,2.08,1.61,1.17
06-01-2022,OVAR,1053,75,1940,"[960,Max]",Extremamente Elevado,,,,1053,Centro,AVEIRO,0115,14770.25,54260,3294,2709,1994,1636,1234,2870,4864,7573,10867,367.37,73.57,51.27,32.93
06-01-2022,PAÇOS DE FERREIRA,1475,105,2601,"[960,Max]",Extremamente Elevado,,,,1475,Norte,PORTO,1309,7099.29,56728,2903,2193,1518,1135,664,1799,3317,5510,8413,799.1,118.51,77.62,46.72
06-01-2022,PALMELA,1519,109,2364,"[960,Max]",Extremamente Elevado,,,,1519,Lisboa e Vale do Tejo,SETÚBAL,1508,46512.01,64269,3402,3244,2635,1846,1391,3237,5872,9116,12518,138.18,26.91,19.6,12.62
06-01-2022,PAMPILHOSA DA SERRA,45,3,1116,"[960,Max]",Extremamente Elevado,,,,45,Centro,COIMBRA,0612,39646.24,4037,238,254,295,339,423,762,1057,1311,1549,10.18,3.91,3.31,2.67
06-01-2022,PAREDES,2029,145,2358,"[960,Max]",Extremamente Elevado,,,,2029,Norte,PORTO,1310,15675.69,86067,4272,3532,2412,1717,1258,2975,5387,8919,13191,549.04,84.15,56.9,34.36
06-01-2022,PAREDES DE COURA,285,20,3340,"[960,Max]",Extremamente Elevado,,,,285,Norte,VIANA DO CASTELO,1605,13818.59,8535,466,528,407,465,515,980,1387,1915,2381,61.76,17.23,13.86,10.04
06-01-2022,PEDRÓGÃO GRANDE,44,3,1288,"[960,Max]",Extremamente Elevado,,,,44,Centro,LEIRIA,1013,12874.75,3410,175,173,196,221,252,473,669,842,1017,26.49,7.9,6.54,5.2
06-01-2022,PENACOVA,221,16,1612,"[960,Max]",Extremamente Elevado,,,,221,Centro,COIMBRA,0613,21673.23,13694,968,923,745,621,703,1324,2069,2992,3960,63.18,18.27,13.81,9.55
06-01-2022,PENAFIEL,1451,104,2080,"[960,Max]",Extremamente Elevado,,,,1451,Norte,PORTO,1311,21224.27,69772,3648,2823,2032,1663,1230,2893,4925,7748,11396,328.74,53.69,36.51,23.2
06-01-2022,PENALVA DO CASTELO,119,8,1666,"[960,Max]",Extremamente Elevado,,,,119,Centro,VISEU,1811,13433.92,7115,449,457,413,391,426,817,1230,1687,2136,52.96,15.9,12.56,9.16
06-01-2022,PENAMACOR,97,7,2032,"[960,Max]",Extremamente Elevado,,,,97,Centro,CASTELO BRANCO,0507,56370.69,4755,262,248,273,451,633,1084,1357,1605,1867,8.44,3.31,2.85,2.41
06-01-2022,PENEDONO,49,4,1905,"[960,Max]",Extremamente Elevado,,,,49,Norte,VISEU,1812,13370.75,2591,172,113,129,156,138,294,423,536,708,19.38,5.3,4.01,3.16
06-01-2022,PENELA,82,6,1522,"[960,Max]",Extremamente Elevado,,,,82,Centro,COIMBRA,0614,13480.0,5397,314,324,274,359,344,703,977,1301,1615,40.04,11.98,9.65,7.25
06-01-2022,PENICHE,568,41,2142,"[960,Max]",Extremamente Elevado,,,,568,Lisboa e Vale do Tejo,LEIRIA,1014,7754.98,26501,1746,1504,1203,926,707,1633,2836,4340,6086,341.73,78.48,55.96,36.57
06-01-2022,PESO DA RÉGUA,314,22,1989,"[960,Max]",Extremamente Elevado,,,,314,Norte,VILA REAL,1708,9486.01,15773,1076,843,650,659,455,1114,1764,2607,3683,166.28,38.83,27.48,18.6
06-01-2022,PINHEL,66,5,771,"[480,960]",Muito Elevado,,,,66,Centro,GUARDA,0910,48452.12,8511,577,566,551,538,689,1227,1778,2344,2921,17.57,6.03,4.84,3.67
06-01-2022,POMBAL,996,71,1936,"[960,Max]",Extremamente Elevado,,,,996,Centro,LEIRIA,1015,62600.28,51461,3187,2791,2494,2328,2027,4355,6849,9640,12827,82.21,20.49,15.4,10.94
06-01-2022,PONTA DELGADA,986,70,1451,"[960,Max]",Extremamente Elevado,,,,986,Açores,AÇORES,4203,23298.65,67935,3108,2435,1726,1133,902,2035,3761,6196,9304,291.58,39.93,26.59,16.14
06-01-2022,PONTA DO SOL,256,18,2981,"[960,Max]",Extremamente Elevado,,,,256,Madeira,MADEIRA,3105,4622.03,8593,319,283,347,208,221,429,776,1059,1378,185.92,29.81,22.91,16.79
06-01-2022,PONTE DA BARCA,322,23,2883,"[960,Max]",Extremamente Elevado,,,,322,Norte,VIANA DO CASTELO,1606,18211.37,11180,635,576,517,554,490,1044,1561,2137,2772,61.39,15.22,11.73,8.57
06-01-2022,PONTE DE LIMA,1081,77,2616,"[960,Max]",Extremamente Elevado,,,,1081,Norte,VIANA DO CASTELO,1607,32025.46,41315,2321,2022,1720,1596,1462,3058,4778,6800,9121,129.01,28.48,21.23,14.92
06-01-2022,PONTE DE SOR,214,15,1428,"[960,Max]",Extremamente Elevado,,,,214,Alentejo,PORTALEGRE,1213,83971.16,14994,939,800,716,739,831,1570,2286,3086,4025,17.86,4.79,3.68,2.72
06-01-2022,PORTALEGRE,474,34,2140,"[960,Max]",Extremamente Elevado,,,,474,Alentejo,PORTALEGRE,1214,44713.64,22172,1577,1351,1137,993,984,1977,3114,4465,6042,49.59,13.51,9.99,6.96
06-01-2022,PORTEL,75,5,1281,"[960,Max]",Extremamente Elevado,,,,75,Alentejo,ÉVORA,0709,60100.57,5828,336,358,283,331,305,636,919,1277,1613,9.7,2.68,2.12,1.53
06-01-2022,PORTIMÃO,933,67,1682,"[960,Max]",Extremamente Elevado,,,,933,Algarve,FARO,0811,18206.29,55483,3182,2927,2116,1582,1400,2982,5098,8025,11207,304.75,61.56,44.08,28.0
06-01-2022,PORTO,7579,541,3499,"[960,Max]",Extremamente Elevado,,,,7579,Norte,PORTO,1312,4142.02,216606,15790,15193,11280,9409,10044,19453,30733,45926,61716,5229.5,1490.0,1108.79,741.98
06-01-2022,PORTO DE MÓS,684,49,2937,"[960,Max]",Extremamente Elevado,,,,684,Centro,LEIRIA,1016,26183.41,23275,1355,1210,1034,888,872,1760,2794,4004,5359,88.89,20.47,15.29,10.67
06-01-2022,PORTO MONIZ,75,5,3201,"[960,Max]",Extremamente Elevado,,,,75,Madeira,MADEIRA,3106,8293.38,2342,143,130,95,98,120,218,313,443,586,28.24,7.07,5.34,3.77
06-01-2022,PORTO SANTO,224,16,4310,"[960,Max]",Extremamente Elevado,,,,224,Madeira,MADEIRA,3201,4300.7,5202,240,157,134,110,68,178,312,469,709,120.95,16.48,10.9,7.25
06-01-2022,PÓVOA DE LANHOSO,672,48,3124,"[960,Max]",Extremamente Elevado,,,,672,Norte,BRAGA,0309,13465.29,21499,1175,909,732,673,624,1297,2029,2938,4113,159.67,30.55,21.82,15.07
06-01-2022,PÓVOA DE VARZIM,1549,111,2467,"[960,Max]",Extremamente Elevado,,,,1549,Norte,PORTO,1313,8220.59,62784,3712,3120,2134,1594,1305,2899,5033,8153,11865,763.7,144.33,99.17,61.22
06-01-2022,POVOAÇÃO,117,8,1967,"[960,Max]",Extremamente Elevado,,,,117,Açores,AÇORES,4204,10640.77,5927,293,212,191,144,134,278,469,681,974,55.7,9.15,6.4,4.41
06-01-2022,VILA DA PRAIA DA VITÓRIA,290,21,1361,"[960,Max]",Extremamente Elevado,,,,290,Açores,AÇORES,4302,16127.06,21317,1133,789,619,436,336,772,1391,2180,3313,132.18,20.54,13.52,8.63
06-01-2022,PROENÇA-A-NOVA,175,13,2402,"[960,Max]",Extremamente Elevado,,,,175,Centro,CASTELO BRANCO,0508,39539.96,7298,508,465,389,400,560,960,1349,1814,2322,18.46,5.87,4.59,3.41
06-01-2022,REDONDO,85,6,1337,"[960,Max]",Extremamente Elevado,,,,85,Alentejo,ÉVORA,0710,36950.87,6353,349,325,288,288,354,642,930,1255,1604,17.19,4.34,3.4,2.52
06-01-2022,REGUENGOS DE MONSARAZ,151,11,1511,"[960,Max]",Extremamente Elevado,,,,151,Alentejo,ÉVORA,0711,46399.72,10015,602,511,455,462,473,935,1390,1901,2503,21.58,5.39,4.1,3.0
06-01-2022,RESENDE,122,9,1207,"[960,Max]",Extremamente Elevado,,,,122,Norte,VISEU,1813,12334.93,10137,560,493,448,433,422,855,1303,1796,2356,82.18,19.1,14.56,10.56
06-01-2022,RIBEIRA BRAVA,401,29,3221,"[960,Max]",Extremamente Elevado,,,,401,Madeira,MADEIRA,3107,6544.88,12435,648,500,411,311,287,598,1009,1509,2157,189.99,32.96,23.06,15.42
06-01-2022,RIBEIRA DE PENA,159,11,2639,"[960,Max]",Extremamente Elevado,,,,159,Norte,VILA REAL,1709,21745.98,6016,371,301,290,310,368,678,968,1269,1640,27.66,7.54,5.84,4.45
06-01-2022,RIBEIRA GRANDE,428,31,1304,"[960,Max]",Extremamente Elevado,,,,428,Açores,AÇORES,4205,18015.13,32811,1163,689,512,345,253,598,1110,1799,2962,182.13,16.44,9.99,6.16
06-01-2022,RIO MAIOR,265,19,1301,"[960,Max]",Extremamente Elevado,,,,265,Lisboa e Vale do Tejo,SANTARÉM,1414,27276.45,20379,1251,1144,941,795,648,1443,2384,3528,4779,74.71,17.52,12.93,8.74
06-01-2022,SABROSA,111,8,1870,"[960,Max]",Extremamente Elevado,,,,111,Norte,VILA REAL,1710,15692.45,5918,393,314,304,302,350,652,956,1270,1663,37.71,10.6,8.09,6.09
06-01-2022,SABUGAL,159,11,1501,"[960,Max]",Extremamente Elevado,,,,159,Centro,GUARDA,0911,82269.82,10585,724,707,694,796,1009,1805,2499,3206,3930,12.87,4.78,3.9,3.04
06-01-2022,SALVATERRA DE MAGOS,424,30,1992,"[960,Max]",Extremamente Elevado,,,,424,Lisboa e Vale do Tejo,SANTARÉM,1415,24393.2,21295,1275,1181,1060,799,772,1571,2631,3812,5087,87.3,20.85,15.63,10.79
06-01-2022,SANTA COMBA DÃO,114,8,1091,"[960,Max]",Extremamente Elevado,,,,114,Centro,VISEU,1814,11194.77,10452,732,684,569,538,464,1002,1571,2255,2987,93.36,26.68,20.14,14.03
06-01-2022,SANTA CRUZ,1590,114,3512,"[960,Max]",Extremamente Elevado,,,,1590,Madeira,MADEIRA,3108,8150.28,45281,1817,1301,974,716,523,1239,2213,3514,5331,555.6,65.41,43.12,27.15
06-01-2022,SANTA CRUZ DA GRACIOSA,17,1,407,"[240,480]",Elevado,,,,17,Açores,AÇORES,4401,6065.78,4208,228,180,163,124,145,269,432,612,840,69.37,13.85,10.09,7.12
06-01-2022,SANTA CRUZ DAS FLORES,5,0,231,"[120,240]",Moderado,,,,5,Açores,AÇORES,4802,7091.44,2165,125,98,74,56,51,107,181,279,404,30.53,5.7,3.93,2.55
06-01-2022,SANTA MARIA DA FEIRA,3381,242,2439,"[960,Max]",Extremamente Elevado,,,,3381,Norte,AVEIRO,0109,21587.65,138636,8182,6743,4771,3856,3079,6935,11706,18449,26631,642.19,123.36,85.46,54.22
06-01-2022,SANTA MARTA DE PENAGUIÃO,101,7,1525,"[960,Max]",Extremamente Elevado,,,,101,Norte,VILA REAL,1711,6928.13,6599,483,373,337,316,317,633,970,1343,1826,95.25,26.36,19.39,14.0
06-01-2022,SANTANA,143,10,2136,"[960,Max]",Extremamente Elevado,,,,143,Madeira,MADEIRA,3109,9547.3,6711,418,353,343,282,277,559,902,1255,1673,70.29,17.52,13.15,9.45
06-01-2022,SANTARÉM,1433,102,2496,"[960,Max]",Extremamente Elevado,,,,1433,Lisboa e Vale do Tejo,SANTARÉM,1416,55253.58,57421,3654,3441,2760,2466,2206,4672,7432,10873,14527,103.92,26.29,19.68,13.45
06-01-2022,SANTIAGO DO CACÉM,445,32,1547,"[960,Max]",Extremamente Elevado,,,,445,Alentejo,SETÚBAL,1509,105969.29,28791,2144,1689,1472,1295,1215,2510,3982,5671,7815,27.17,7.37,5.35,3.76
06-01-2022,SANTO TIRSO,1401,100,2059,"[960,Max]",Extremamente Elevado,,,,1401,Norte,PORTO,1314,13655.52,68055,4911,3935,2761,2257,1810,4067,6828,10763,15674,498.35,114.78,78.82,50.0
06-01-2022,SÃO BRÁS DE ALPORTEL,225,16,2160,"[960,Max]",Extremamente Elevado,,,,225,Algarve,FARO,0812,15336.92,10416,596,468,467,404,401,805,1272,1740,2336,67.91,15.23,11.35,8.29
06-01-2022,SÃO JOÃO DA MADEIRA,567,41,2584,"[960,Max]",Extremamente Elevado,,,,567,Norte,AVEIRO,0116,794.3,21958,1347,1069,796,601,593,1194,1990,3059,4406,2765.49,554.91,385.26,250.63
06-01-2022,SÃO JOÃO DA PESQUEIRA,96,7,1346,"[960,Max]",Extremamente Elevado,,,,96,Norte,VISEU,1815,26610.85,7125,417,330,294,328,328,656,950,1280,1697,26.77,6.38,4.81,3.57
06-01-2022,SÃO PEDRO DO SUL,237,17,1537,"[960,Max]",Extremamente Elevado,,,,237,Centro,VISEU,1816,34895.09,15403,990,962,861,759,909,1668,2529,3491,4481,44.14,12.84,10.0,7.25
06-01-2022,SÃO ROQUE DO PICO,30,2,915,"[480,960]",Muito Elevado,,,,30,Açores,AÇORES,4603,14236.1,3266,199,141,93,96,113,209,302,443,642,22.94,4.51,3.11,2.12
06-01-2022,SÃO VICENTE,124,9,2406,"[960,Max]",Extremamente Elevado,,,,124,Madeira,MADEIRA,3110,7883.71,5143,272,264,266,225,280,505,771,1035,1307,65.23,16.58,13.13,9.78
06-01-2022,SARDOAL,82,6,2179,"[960,Max]",Extremamente Elevado,,,,82,Lisboa e Vale do Tejo,SANTARÉM,1417,9214.72,3741,227,178,148,165,248,413,561,739,966,40.6,10.48,8.02,6.09
06-01-2022,SÁTÃO,277,20,2389,"[960,Max]",Extremamente Elevado,,,,277,Centro,VISEU,1817,20194.11,11580,765,671,515,465,476,941,1456,2127,2892,57.34,14.32,10.53,7.21
06-01-2022,SEIA,317,23,1426,"[960,Max]",Extremamente Elevado,,,,317,Centro,GUARDA,0912,43568.83,22234,1807,1589,1238,1122,721,1843,3081,4670,6477,51.03,14.87,10.72,7.07
06-01-2022,SEIXAL,5870,419,3499,"[960,Max]",Extremamente Elevado,,,,5870,Lisboa e Vale do Tejo,SETÚBAL,1510,9545.17,167752,10586,9270,6661,4391,2930,7321,13982,23252,33838,1757.49,354.51,243.6,146.49
06-01-2022,SERNANCELHE,56,4,1042,"[960,Max]",Extremamente Elevado,,,,56,Norte,VISEU,1818,22861.22,5396,305,293,286,273,260,533,819,1112,1417,23.6,6.2,4.86,3.58
06-01-2022,SERPA,368,26,2575,"[960,Max]",Extremamente Elevado,,,,368,Alentejo,BEJA,0213,110563.34,14304,903,761,719,697,626,1323,2042,2803,3706,12.94,3.35,2.54,1.85
06-01-2022,SERTÃ,256,18,1758,"[960,Max]",Extremamente Elevado,,,,256,Centro,CASTELO BRANCO,0509,44673.17,14577,870,779,790,767,1020,1787,2577,3356,4226,32.63,9.46,7.51,5.77
06-01-2022,SESIMBRA,1527,109,2945,"[960,Max]",Extremamente Elevado,,,,1527,Lisboa e Vale do Tejo,SETÚBAL,1511,19571.75,51858,2400,2321,1853,1257,1083,2340,4193,6514,8914,264.96,45.54,33.28,21.42
06-01-2022,SETÚBAL,2909,208,2527,"[960,Max]",Extremamente Elevado,,,,2909,Lisboa e Vale do Tejo,SETÚBAL,1512,23032.5,115126,7425,6929,5075,3775,2655,6430,11505,18434,25859,499.83,112.27,80.03,49.95
06-01-2022,SEVER DO VOUGA,178,13,1567,"[960,Max]",Extremamente Elevado,,,,178,Centro,AVEIRO,0117,12987.56,11331,766,637,568,540,567,1107,1675,2312,3078,87.24,23.7,17.8,12.9
06-01-2022,SILVES,531,38,1466,"[960,Max]",Extremamente Elevado,,,,531,Algarve,FARO,0813,68006.23,36226,2137,1869,1610,1423,1600,3023,4633,6502,8639,53.27,12.7,9.56,6.81
06-01-2022,SINES,320,23,2335,"[960,Max]",Extremamente Elevado,,,,320,Alentejo,SETÚBAL,1513,20330.17,13715,888,791,551,416,268,684,1235,2026,2914,67.46,14.33,9.97,6.07
06-01-2022,SINTRA,15484,1106,3956,"[960,Max]",Extremamente Elevado,,,,15484,Lisboa e Vale do Tejo,LISBOA,1111,31922.73,391402,20490,18316,13545,9137,7284,16421,29966,48282,68772,1226.08,215.43,151.25,93.87
06-01-2022,SOBRAL DE MONTE AGRAÇO,253,18,2372,"[960,Max]",Extremamente Elevado,,,,253,Lisboa e Vale do Tejo,LISBOA,1112,5210.32,10651,564,507,352,272,212,484,836,1343,1907,204.43,36.6,25.78,16.05
06-01-2022,SOURE,332,24,1941,"[960,Max]",Extremamente Elevado,,,,332,Centro,COIMBRA,0615,26506.07,17120,1173,1142,1004,883,987,1870,2874,4016,5189,64.59,19.58,15.15,10.84
06-01-2022,SOUSEL,102,7,2311,"[960,Max]",Extremamente Elevado,,,,102,Alentejo,PORTALEGRE,1215,27932.18,4412,261,274,208,302,292,594,802,1076,1337,15.8,4.79,3.85,2.87
06-01-2022,TÁBUA,129,9,1138,"[960,Max]",Extremamente Elevado,,,,129,Centro,COIMBRA,0616,19978.58,11368,729,584,524,430,464,894,1418,2002,2731,56.9,13.67,10.02,7.1
06-01-2022,TABUAÇO,71,5,1179,"[960,Max]",Extremamente Elevado,,,,71,Norte,VISEU,1819,13385.67,6033,372,314,217,282,363,645,862,1176,1548,45.07,11.56,8.79,6.44
06-01-2022,TAROUCA,123,9,1573,"[960,Max]",Extremamente Elevado,,,,123,Norte,VISEU,1820,10008.49,7804,405,335,313,277,324,601,914,1249,1654,77.98,16.53,12.48,9.13
06-01-2022,TAVIRA,453,32,1848,"[960,Max]",Extremamente Elevado,,,,453,Algarve,FARO,0814,60696.7,24530,1493,1415,1252,1066,1277,2343,3595,5010,6503,40.41,10.71,8.25,5.92
06-01-2022,TERRAS DE BOURO,117,8,1837,"[960,Max]",Extremamente Elevado,,,,117,Norte,BRAGA,0310,27746.07,6361,391,372,296,319,340,659,955,1327,1718,22.93,6.19,4.78,3.44
06-01-2022,TOMAR,810,58,2205,"[960,Max]",Extremamente Elevado,,,,810,Lisboa e Vale do Tejo,SANTARÉM,1418,35120.44,36748,2403,2189,1868,1853,1822,3675,5543,7732,10135,104.64,28.86,22.02,15.78
06-01-2022,TONDELA,431,31,1635,"[960,Max]",Extremamente Elevado,,,,431,Centro,VISEU,1821,37121.73,26357,1768,1722,1518,1475,1417,2892,4410,6132,7900,71.0,21.28,16.52,11.88
06-01-2022,TORRE DE MONCORVO,94,7,1223,"[960,Max]",Extremamente Elevado,,,,94,Norte,BRAGANÇA,0409,53155.67,7695,556,478,488,551,719,1270,1758,2236,2792,14.48,5.25,4.21,3.31
06-01-2022,TORRES NOVAS,822,59,2353,"[960,Max]",Extremamente Elevado,,,,822,Lisboa e Vale do Tejo,SANTARÉM,1419,26999.68,34933,2324,1979,1738,1406,1475,2881,4619,6598,8922,129.38,33.04,24.44,17.11
06-01-2022,TORRES VEDRAS,2095,150,2668,"[960,Max]",Extremamente Elevado,,,,2095,Lisboa e Vale do Tejo,LISBOA,1113,40714.89,78530,4513,3945,3447,2628,2104,4732,8179,12124,16637,192.88,40.86,29.78,20.09
06-01-2022,TRANCOSO,72,5,809,"[480,960]",Muito Elevado,,,,72,Centro,GUARDA,0913,36152.47,8875,581,557,542,586,496,1082,1624,2181,2762,24.55,7.64,6.03,4.49
06-01-2022,TROFA,1011,72,2631,"[960,Max]",Extremamente Elevado,,,,1011,Norte,PORTO,1318,7201.76,38418,2336,1894,1231,939,684,1623,2854,4748,7084,533.44,98.36,65.93,39.63
06-01-2022,VAGOS,423,30,1858,"[960,Max]",Extremamente Elevado,,,,423,Centro,AVEIRO,0118,16491.5,22740,1320,1205,922,784,724,1508,2430,3635,4955,137.89,30.04,22.04,14.73
06-01-2022,VALE DE CAMBRA,647,46,3032,"[960,Max]",Extremamente Elevado,,,,647,Norte,AVEIRO,0119,14733.47,21327,1491,1363,1005,831,798,1629,2634,3997,5488,144.76,37.25,27.13,17.88
06-01-2022,VALENÇA,358,26,2691,"[960,Max]",Extremamente Elevado,,,,358,Norte,VIANA DO CASTELO,1608,11712.86,13290,867,791,582,582,503,1085,1667,2458,3325,113.46,28.39,20.99,14.23
06-01-2022,VALONGO,2392,171,2455,"[960,Max]",Extremamente Elevado,,,,2392,Norte,PORTO,1315,7512.45,97444,5629,4696,3207,2462,1829,4291,7498,12194,17823,1297.18,237.26,162.33,99.81
06-01-2022,VALPAÇOS,323,23,2178,"[960,Max]",Extremamente Elevado,,,,323,Norte,VILA REAL,1712,54873.93,14818,1217,1118,999,928,997,1925,2924,4042,5259,27.0,9.58,7.37,5.33
06-01-2022,VELAS,6,0,118,"[0,120]",Baixo a Moderado,,,,6,Açores,AÇORES,4502,11738.38,5093,278,208,166,153,113,266,432,640,918,43.39,7.82,5.45,3.68
06-01-2022,VENDAS NOVAS,144,10,1278,"[960,Max]",Extremamente Elevado,,,,144,Alentejo,ÉVORA,0712,22238.88,11255,677,768,655,501,532,1033,1688,2456,3133,50.61,14.09,11.04,7.59
06-01-2022,VIANA DO ALENTEJO,42,3,822,"[480,960]",Muito Elevado,,,,42,Alentejo,ÉVORA,0713,39367.29,5145,245,208,235,210,214,424,659,867,1112,13.07,2.82,2.2,1.67
06-01-2022,VIANA DO CASTELO,1711,122,2027,"[960,Max]",Extremamente Elevado,,,,1711,Norte,VIANA DO CASTELO,1609,31902.01,84417,5470,4433,3591,3061,2982,6043,9634,14067,19537,264.61,61.24,44.09,30.2
06-01-2022,VIDIGUEIRA,29,2,530,"[480,960]",Muito Elevado,,,,29,Alentejo,BEJA,0214,31661.09,5510,300,248,215,233,275,508,723,971,1271,17.4,4.01,3.07,2.28
06-01-2022,VIEIRA DO MINHO,224,16,1892,"[960,Max]",Extremamente Elevado,,,,224,Norte,BRAGA,0311,21644.35,11842,703,594,525,548,482,1030,1555,2149,2852,54.71,13.18,9.93,7.18
06-01-2022,VILA DE REI,40,3,1198,"[960,Max]",Extremamente Elevado,,,,40,Centro,CASTELO BRANCO,0510,19154.6,3323,169,128,172,247,302,549,721,849,1018,17.35,5.31,4.43,3.76
06-01-2022,VILA DO BISPO,70,5,1360,"[960,Max]",Extremamente Elevado,,,,70,Algarve,FARO,0815,17906.06,5154,302,302,314,232,233,465,779,1081,1383,28.78,7.72,6.04,4.35
06-01-2022,VILA DO CONDE,1738,124,2175,"[960,Max]",Extremamente Elevado,,,,1738,Norte,PORTO,1316,14902.77,79899,4726,3875,2819,2070,1743,3813,6632,10507,15233,536.13,102.21,70.5,44.5
06-01-2022,VILA DO PORTO,44,3,784,"[480,960]",Muito Elevado,,,,44,Açores,AÇORES,4101,9688.74,5616,274,212,135,96,123,219,354,566,840,57.96,8.67,5.84,3.65
06-01-2022,VILA FLOR,50,4,832,"[480,960]",Muito Elevado,,,,50,Norte,BRAGANÇA,0410,26581.14,6044,429,362,422,294,331,625,1047,1409,1838,22.74,6.91,5.3,3.94
06-01-2022,VILA FRANCA DE XIRA,5242,374,3693,"[960,Max]",Extremamente Elevado,,,,5242,Lisboa e Vale do Tejo,LISBOA,1114,31819.39,141957,8501,6852,4869,3425,2472,5897,10766,17618,26119,446.14,82.09,55.37,33.84
06-01-2022,VILA FRANCA DO CAMPO,160,11,1448,"[960,Max]",Extremamente Elevado,,,,160,Açores,AÇORES,4206,7796.82,11051,450,344,248,217,154,371,619,963,1413,141.73,18.12,12.35,7.94
06-01-2022,VILA NOVA DA BARQUINHA,149,11,2000,"[960,Max]",Extremamente Elevado,,,,149,Lisboa e Vale do Tejo,SANTARÉM,1420,4952.97,7461,415,406,392,364,338,702,1094,1500,1915,150.64,38.66,30.28,22.09
06-01-2022,VILA NOVA DE CERVEIRA,176,13,1978,"[960,Max]",Extremamente Elevado,,,,176,Norte,VIANA DO CASTELO,1610,10846.66,8910,531,444,410,384,334,718,1128,1572,2103,82.14,19.39,14.49,10.4
06-01-2022,VILA NOVA DE FAMALICÃO,2996,214,2275,"[960,Max]",Extremamente Elevado,,,,2996,Norte,BRAGA,0312,20159.26,131676,7817,6164,4202,3282,2749,6031,10233,16397,24214,653.19,120.12,81.34,50.76
06-01-2022,VILA NOVA DE FOZ CÔA,75,5,1152,"[960,Max]",Extremamente Elevado,,,,75,Centro,GUARDA,0914,39815.18,6503,442,385,390,398,429,827,1217,1602,2044,16.33,5.13,4.02,3.06
06-01-2022,VILA NOVA DE GAIA,8095,578,2694,"[960,Max]",Extremamente Elevado,,,,8095,Norte,PORTO,1317,16846.43,300472,18349,15568,10972,8224,6281,14505,25477,41045,59394,1783.64,352.57,243.65,151.23
06-01-2022,VILA NOVA DE PAIVA,77,5,1642,"[960,Max]",Extremamente Elevado,,,,77,Centro,VISEU,1822,17553.28,4687,289,272,233,217,241,458,691,963,1252,26.7,7.13,5.49,3.94
06-01-2022,VILA NOVA DE POIARES,71,5,1020,"[960,Max]",Extremamente Elevado,,,,71,Centro,COIMBRA,0617,8445.3,6939,380,284,262,235,182,417,679,963,1343,82.17,15.9,11.4,8.04
06-01-2022,VILA POUCA DE AGUIAR,159,11,1332,"[960,Max]",Extremamente Elevado,,,,159,Norte,VILA REAL,1713,43706.62,11961,860,817,733,601,627,1228,1961,2778,3638,27.37,8.32,6.36,4.49
06-01-2022,VILA REAL,1349,96,2701,"[960,Max]",Extremamente Elevado,,,,1349,Norte,VILA REAL,1714,37880.28,49962,3025,2498,2065,1579,1466,3045,5110,7608,10633,131.9,28.07,20.08,13.49
06-01-2022,VILA REAL DE SANTO ANTÓNIO,245,18,1309,"[960,Max]",Extremamente Elevado,,,,245,Algarve,FARO,0816,6125.0,18749,1172,1069,811,569,586,1155,1966,3035,4207,306.11,68.69,49.55,32.1
06-01-2022,VILA VELHA DE RÓDÃO,49,4,1560,"[960,Max]",Extremamente Elevado,,,,49,Centro,CASTELO BRANCO,0511,32991.16,3144,209,229,180,283,306,589,769,998,1207,9.53,3.66,3.03,2.33
06-01-2022,VILA VERDE,1609,115,3429,"[960,Max]",Extremamente Elevado,,,,1609,Norte,BRAGA,0313,22866.52,46911,2365,2063,1667,1494,1437,2931,4598,6661,9026,205.15,39.47,29.13,20.11
06-01-2022,VILA VIÇOSA,137,10,1785,"[960,Max]",Extremamente Elevado,,,,137,Alentejo,ÉVORA,0714,19485.89,7656,487,379,342,345,324,669,1011,1390,1877,39.29,9.63,7.13,5.19
06-01-2022,VIMIOSO,89,6,2223,"[960,Max]",Extremamente Elevado,,,,89,Norte,BRAGANÇA,0411,48158.51,4023,274,230,261,293,335,628,889,1119,1393,8.35,2.89,2.32,1.85
06-01-2022,VINHAIS,113,8,1459,"[960,Max]",Extremamente Elevado,,,,113,Norte,BRAGANÇA,0412,69475.09,7746,599,577,636,641,815,1456,2092,2669,3268,11.15,4.7,3.84,3.01
06-01-2022,VISEU,1891,135,1945,"[960,Max]",Extremamente Elevado,,,,1891,Centro,VISEU,1823,50710.14,97249,5769,5038,4140,3158,2710,5868,10008,15046,20815,191.77,41.05,29.67,19.74
06-01-2022,VIZELA,661,47,2766,"[960,Max]",Extremamente Elevado,,,,661,Norte,BRAGA,0314,2469.83,23897,1258,928,655,509,371,880,1535,2463,3721,967.49,150.65,99.72,62.15
06-01-2022,VOUZELA,134,10,1392,"[960,Max]",Extremamente Elevado,,,,134,Centro,VISEU,1824,19369.46,9619,626,605,554,532,507,1039,1593,2198,2824,49.66,14.58,11.35,8.22
13-01-2022,ABRANTES,1148,82,3267,"[960,Max]",Extremamente Elevado,,,,1148,Lisboa e Vale do Tejo,SANTARÉM,1401,71469.08,35130,2473,2213,1730,1748,2021,3769,5499,7712,10185,49.15,14.25,10.79,7.69
13-01-2022,ÁGUEDA,1178,84,2557,"[960,Max]",Extremamente Elevado,,,,1178,Centro,AVEIRO,0101,33527.44,46075,3237,2713,2090,1635,1496,3131,5221,7934,11171,137.43,33.32,23.66,15.57
13-01-2022,AGUIAR DA BEIRA,100,7,2158,"[960,Max]",Extremamente Elevado,,,,100,Centro,GUARDA,0901,20676.57,4652,304,281,235,239,148,387,622,903,1207,22.5,5.84,4.37,3.01
13-01-2022,ALANDROAL,93,7,1859,"[960,Max]",Extremamente Elevado,,,,93,Alentejo,ÉVORA,0701,54267.81,4992,307,256,296,299,377,676,972,1228,1535,9.2,2.83,2.26,1.79
13-01-2022,ALBERGARIA-A-VELHA,874,62,3622,"[960,Max]",Extremamente Elevado,,,,874,Centro,AVEIRO,0102,15882.5,24144,1550,1298,996,687,680,1367,2363,3661,5211,152.02,32.81,23.05,14.88
13-01-2022,ALBUFEIRA,1422,102,3423,"[960,Max]",Extremamente Elevado,,,,1422,Algarve,FARO,0801,14066.42,41528,2067,1717,1425,985,858,1843,3268,4985,7052,295.24,50.14,35.44,23.23
13-01-2022,ALCÁCER DO SAL,227,16,1949,"[960,Max]",Extremamente Elevado,,,,227,Alentejo,SETÚBAL,1501,149987.3,11659,884,814,623,623,602,1225,1848,2662,3546,7.77,2.36,1.77,1.23
13-01-2022,ALCANENA,469,33,3660,"[960,Max]",Extremamente Elevado,,,,469,Lisboa e Vale do Tejo,SANTARÉM,1402,12732.86,12809,891,744,628,536,588,1124,1752,2496,3387,100.6,26.6,19.6,13.76
13-01-2022,ALCOBAÇA,2411,172,4501,"[960,Max]",Extremamente Elevado,,,,2411,Lisboa e Vale do Tejo,LEIRIA,1001,40814.09,53555,3420,2927,2466,2059,1676,3735,6201,9128,12548,131.22,30.74,22.36,15.19
13-01-2022,ALCOCHETE,716,51,3617,"[960,Max]",Extremamente Elevado,,,,716,Lisboa e Vale do Tejo,SETÚBAL,1502,12836.48,19787,857,834,691,476,447,923,1614,2448,3305,154.15,25.75,19.07,12.57
13-01-2022,ALCOUTIM,44,3,2022,"[960,Max]",Extremamente Elevado,,,,44,Algarve,FARO,0802,57536.33,2159,191,188,163,190,267,457,620,808,999,3.75,1.74,1.4,1.08
13-01-2022,ALENQUER,2041,146,4634,"[960,Max]",Extremamente Elevado,,,,2041,Lisboa e Vale do Tejo,LISBOA,1101,30421.92,44052,2298,2062,1629,1330,1155,2485,4114,6176,8474,144.8,27.85,20.3,13.52
13-01-2022,ALFÂNDEGA DA FÉ,80,6,1759,"[960,Max]",Extremamente Elevado,,,,80,Norte,BRAGANÇA,0401,32194.64,4550,325,277,301,274,325,599,900,1177,1502,14.13,4.67,3.66,2.8
13-01-2022,ALIJÓ,339,24,3192,"[960,Max]",Extremamente Elevado,,,,339,Norte,VILA REAL,1701,29759.89,10625,766,687,635,542,666,1208,1843,2530,3296,35.7,11.08,8.5,6.19
13-01-2022,ALJEZUR,79,6,1411,"[960,Max]",Extremamente Elevado,,,,79,Algarve,FARO,0803,32349.95,5594,316,336,335,320,410,730,1065,1401,1717,17.29,5.31,4.33,3.29
13-01-2022,ALJUSTREL,227,16,2752,"[960,Max]",Extremamente Elevado,,,,227,Alentejo,BEJA,0201,45847.41,8247,635,521,443,347,358,705,1148,1669,2304,17.99,5.03,3.64,2.5
13-01-2022,ALMADA,8220,587,4863,"[960,Max]",Extremamente Elevado,,,,8220,Lisboa e Vale do Tejo,SETÚBAL,1503,7000.89,169039,10469,9777,7876,6144,5111,11255,19131,28908,39377,2414.5,562.45,412.91,273.26
13-01-2022,ALMEIDA,212,15,3629,"[960,Max]",Extremamente Elevado,,,,212,Centro,GUARDA,0902,51798.46,5830,441,419,396,458,393,851,1247,1666,2107,11.26,4.07,3.22,2.41
13-01-2022,ALMEIRIM,627,45,2783,"[960,Max]",Extremamente Elevado,,,,627,Lisboa e Vale do Tejo,SANTARÉM,1403,22212.05,22546,1342,1353,1106,866,843,1709,2815,4168,5510,101.5,24.81,18.76,12.67
13-01-2022,ALMODÔVAR,148,11,2207,"[960,Max]",Extremamente Elevado,,,,148,Alentejo,BEJA,0202,77788.03,6725,414,443,396,373,328,701,1097,1540,1954,8.65,2.51,1.98,1.41
13-01-2022,ALPIARÇA,189,13,2677,"[960,Max]",Extremamente Elevado,,,,189,Lisboa e Vale do Tejo,SANTARÉM,1404,9536.33,7059,515,486,363,333,274,607,970,1456,1971,74.02,20.67,15.27,10.17
13-01-2022,ALTER DO CHÃO,85,6,2679,"[960,Max]",Extremamente Elevado,,,,85,Alentejo,PORTALEGRE,1201,36206.62,3165,201,163,136,208,187,395,531,694,895,8.74,2.47,1.92,1.47
13-01-2022,ALVAIÁZERE,130,9,1973,"[960,Max]",Extremamente Elevado,,,,130,Centro,LEIRIA,1002,16047.76,6597,419,389,346,406,539,945,1291,1680,2099,41.11,13.08,10.47,8.04
13-01-2022,ALVITO,23,2,932,"[480,960]",Muito Elevado,,,,23,Alentejo,BEJA,0203,26485.32,2477,145,110,105,111,89,200,305,415,560,9.35,2.11,1.57,1.15
13-01-2022,AMADORA,9196,657,4995,"[960,Max]",Extremamente Elevado,,,,9196,Lisboa e Vale do Tejo,LISBOA,1115,2378.47,184106,11186,10936,8780,6460,5890,12350,21130,32066,43252,7742.05,1818.84,1348.44,888.56
13-01-2022,AMARANTE,1522,109,2861,"[960,Max]",Extremamente Elevado,,,,1522,Norte,PORTO,1301,30133.15,53193,3086,2413,1812,1643,1311,2954,4766,7179,10265,176.53,34.07,23.82,15.82
13-01-2022,AMARES,936,67,5163,"[960,Max]",Extremamente Elevado,,,,936,Norte,BRAGA,0301,8195.41,18129,1001,829,622,489,524,1013,1635,2464,3465,221.22,42.28,30.07,19.95
13-01-2022,ANADIA,624,45,2291,"[960,Max]",Extremamente Elevado,,,,624,Centro,AVEIRO,0103,21663.48,27258,1931,1698,1376,1208,1262,2470,3846,5544,7475,125.83,34.51,25.59,17.75
13-01-2022,ANGRA DO HEROÍSMO,603,43,1783,"[960,Max]",Extremamente Elevado,,,,603,Açores,AÇORES,4301,23899.66,33807,2006,1473,1122,768,635,1403,2525,3998,6004,141.45,25.12,16.73,10.56
13-01-2022,ANSIÃO,385,28,3200,"[960,Max]",Extremamente Elevado,,,,385,Centro,LEIRIA,1003,17609.42,12039,727,709,646,694,530,1224,1870,2579,3306,68.37,18.77,14.65,10.62
13-01-2022,ARCOS DE VALDEVEZ,878,63,4195,"[960,Max]",Extremamente Elevado,,,,878,Norte,VIANA DO CASTELO,1601,44759.64,20926,1329,1338,1282,1343,1515,2858,4140,5478,6807,46.75,15.21,12.24,9.25
13-01-2022,ARGANIL,274,20,2484,"[960,Max]",Extremamente Elevado,,,,274,Centro,COIMBRA,0601,33283.93,11014,672,648,612,559,596,1155,1767,2415,3087,33.09,9.27,7.26,5.31
13-01-2022,ARMAMAR,176,13,3044,"[960,Max]",Extremamente Elevado,,,,176,Norte,VISEU,1801,11723.73,5769,357,305,309,285,310,595,904,1209,1566,49.21,13.36,10.31,7.71
13-01-2022,AROUCA,804,57,3882,"[960,Max]",Extremamente Elevado,,,,804,Norte,AVEIRO,0104,32910.52,20720,1306,1047,753,683,683,1366,2119,3166,4472,62.96,13.59,9.62,6.44
13-01-2022,ARRAIOLOS,154,11,2227,"[960,Max]",Extremamente Elevado,,,,154,Alentejo,ÉVORA,0702,68374.55,6928,435,384,283,367,480,847,1130,1514,1949,10.13,2.85,2.21,1.65
13-01-2022,ARRONCHES,86,6,3041,"[960,Max]",Extremamente Elevado,,,,86,Alentejo,PORTALEGRE,1202,31464.72,2820,155,142,162,187,179,366,528,670,825,8.96,2.62,2.13,1.68
13-01-2022,ARRUDA DOS VINHOS,615,44,3988,"[960,Max]",Extremamente Elevado,,,,615,Lisboa e Vale do Tejo,LISBOA,1102,7795.93,15412,738,738,562,509,438,947,1509,2247,2985,197.69,38.29,28.82,19.36
13-01-2022,AVEIRO,2638,188,3351,"[960,Max]",Extremamente Elevado,,,,2638,Centro,AVEIRO,0105,19757.57,78734,4520,4004,3050,2250,2103,4353,7403,11407,15927,398.49,80.61,57.73,37.47
13-01-2022,AVIS,38,3,906,"[480,960]",Muito Elevado,,,,38,Alentejo,PORTALEGRE,1203,60596.51,4247,315,225,206,251,273,524,730,955,1270,7.01,2.1,1.58,1.2
13-01-2022,AZAMBUJA,783,56,3447,"[960,Max]",Extremamente Elevado,,,,783,Lisboa e Vale do Tejo,LISBOA,1103,26265.65,22716,1322,1171,1070,798,618,1416,2486,3657,4979,86.48,18.96,13.92,9.46
13-01-2022,BAIÃO,591,42,3155,"[960,Max]",Extremamente Elevado,,,,591,Norte,PORTO,1302,17452.83,18748,1070,862,714,686,725,1411,2125,2987,4057,107.42,23.25,17.11,12.18
13-01-2022,BARCELOS,5815,415,5005,"[960,Max]",Extremamente Elevado,,,,5815,Norte,BRAGA,0302,37890.14,116187,6721,5325,3619,2991,2562,5553,9172,14497,21218,306.64,56.0,38.26,24.21
13-01-2022,BARRANCOS,20,1,1232,"[960,Max]",Extremamente Elevado,,,,20,Alentejo,BEJA,0204,16841.73,1634,90,65,65,94,61,155,220,285,375,9.7,2.23,1.69,1.31
13-01-2022,BARREIRO,3507,251,4667,"[960,Max]",Extremamente Elevado,,,,3507,Lisboa e Vale do Tejo,SETÚBAL,1504,3639.07,75147,5194,5565,4459,3105,1767,4872,9331,14896,20090,2065.05,552.07,409.34,256.42
13-01-2022,BATALHA,585,42,3662,"[960,Max]",Extremamente Elevado,,,,585,Centro,LEIRIA,1004,10341.6,15963,873,762,649,529,549,1078,1727,2489,3362,154.35,32.51,24.07,16.7
13-01-2022,BEJA,809,58,2409,"[960,Max]",Extremamente Elevado,,,,809,Alentejo,BEJA,0205,114647.55,33579,2005,1840,1386,1272,1039,2311,3697,5537,7542,29.29,6.58,4.83,3.22
13-01-2022,BELMONTE,113,8,1770,"[960,Max]",Extremamente Elevado,,,,113,Centro,CASTELO BRANCO,0501,11875.91,6398,444,321,325,310,355,665,990,1311,1755,53.87,14.78,11.04,8.34
13-01-2022,BENAVENTE,1185,85,3873,"[960,Max]",Extremamente Elevado,,,,1185,Lisboa e Vale do Tejo,SANTARÉM,1405,52138.39,30602,1468,1376,1141,876,643,1519,2660,4036,5504,58.69,10.56,7.74,5.1
13-01-2022,BOMBARRAL,413,29,3288,"[960,Max]",Extremamente Elevado,,,,413,Lisboa e Vale do Tejo,LEIRIA,1005,9128.55,12558,875,714,561,491,429,920,1481,2195,3070,137.56,33.63,24.04,16.22
13-01-2022,BORBA,196,14,2909,"[960,Max]",Extremamente Elevado,,,,196,Alentejo,ÉVORA,0703,14518.65,6736,430,375,279,436,392,828,1107,1482,1912,46.39,13.17,10.21,7.62
13-01-2022,BOTICAS,114,8,2274,"[960,Max]",Extremamente Elevado,,,,114,Norte,VILA REAL,1702,32195.66,4998,347,306,311,305,380,685,996,1302,1649,15.52,5.12,4.04,3.09
13-01-2022,BRAGA,9771,698,5349,"[960,Max]",Extremamente Elevado,,,,9771,Norte,BRAGA,0303,18339.95,182679,10029,7963,5241,4320,3671,7991,13232,21195,31224,996.07,170.25,115.57,72.15
13-01-2022,BRAGANÇA,1258,90,3744,"[960,Max]",Extremamente Elevado,,,,1258,Norte,BRAGANÇA,0402,117357.27,33607,2402,1855,1652,1393,1163,2556,4208,6063,8465,28.64,7.21,5.17,3.59
13-01-2022,CABECEIRAS DE BASTO,968,69,6196,"[960,Max]",Extremamente Elevado,,,,968,Norte,BRAGA,0304,24182.16,15628,774,594,544,575,574,1149,1693,2287,3061,64.63,12.66,9.46,7.0
13-01-2022,CADAVAL,363,26,2658,"[960,Max]",Extremamente Elevado,,,,363,Lisboa e Vale do Tejo,LISBOA,1104,17489.3,13673,813,796,756,621,625,1246,2002,2798,3611,78.18,20.65,16.0,11.45
13-01-2022,CALDAS DA RAINHA,1694,121,3264,"[960,Max]",Extremamente Elevado,,,,1694,Lisboa e Vale do Tejo,LEIRIA,1006,25569.47,51912,3035,2684,2186,1899,1705,3604,5790,8474,11509,203.03,45.01,33.14,22.64
13-01-2022,CALHETA,605,43,5566,"[960,Max]",Extremamente Elevado,,,,605,Madeira,MADEIRA,3101,11150.43,10867,576,497,507,399,415,814,1321,1818,2394,97.46,21.47,16.3,11.85
13-01-2022,CALHETA (AÇORES),14,1,443,"[240,480]",Elevado,,,,14,Açores,AÇORES,4501,12626.4,3184,215,159,141,139,122,261,402,561,776,25.22,6.15,4.44,3.18
13-01-2022,CÂMARA DE LOBOS,2869,205,8520,"[960,Max]",Extremamente Elevado,,,,2869,Madeira,MADEIRA,3102,5216.67,33675,1396,1059,834,545,381,926,1760,2819,4215,645.49,80.79,54.03,33.74
13-01-2022,CAMINHA,491,35,3091,"[960,Max]",Extremamente Elevado,,,,491,Norte,VIANA DO CASTELO,1602,13652.14,15877,1046,944,818,646,656,1302,2120,3064,4110,116.3,30.11,22.44,15.53
13-01-2022,CAMPO MAIOR,229,16,2913,"[960,Max]",Extremamente Elevado,,,,229,Alentejo,PORTALEGRE,1204,24720.16,7874,471,364,351,279,327,606,957,1321,1792,31.85,7.25,5.34,3.87
13-01-2022,CANTANHEDE,625,45,1785,"[960,Max]",Extremamente Elevado,,,,625,Centro,COIMBRA,0602,39088.02,35011,2346,2096,1880,1709,1451,3160,5040,7136,9482,89.57,24.26,18.26,12.89
13-01-2022,CARRAZEDA DE ANSIÃES,90,6,1586,"[960,Max]",Extremamente Elevado,,,,90,Norte,BRAGANÇA,0403,27924.09,5666,424,389,391,312,465,777,1168,1557,1981,20.29,7.09,5.58,4.18
13-01-2022,CARREGAL DO SAL,214,15,2309,"[960,Max]",Extremamente Elevado,,,,214,Centro,VISEU,1802,11689.21,9271,587,562,486,462,376,838,1324,1886,2473,79.31,21.16,16.13,11.33
13-01-2022,CARTAXO,789,56,3310,"[960,Max]",Extremamente Elevado,,,,789,Lisboa e Vale do Tejo,SANTARÉM,1406,15817.28,23843,1415,1376,1142,861,632,1493,2635,4011,5426,150.74,34.3,25.36,16.66
13-01-2022,CASCAIS,9484,677,4440,"[960,Max]",Extremamente Elevado,,,,9484,Lisboa e Vale do Tejo,LISBOA,1105,9740.17,213608,12151,11444,8680,6469,5248,11717,20397,31841,43992,2193.1,451.66,326.91,209.41
13-01-2022,CASTANHEIRA DE PÊRA,51,4,1940,"[960,Max]",Extremamente Elevado,,,,51,Centro,LEIRIA,1007,6677.45,2614,233,195,157,190,187,377,534,729,962,39.15,14.41,10.92,8.0
13-01-2022,CASTELO BRANCO,1885,135,3625,"[960,Max]",Extremamente Elevado,,,,1885,Centro,CASTELO BRANCO,0502,143819.15,51987,3528,3042,2499,2229,2225,4454,6953,9995,13523,36.15,9.4,6.95,4.83
13-01-2022,CASTELO DE PAIVA,589,42,3810,"[960,Max]",Extremamente Elevado,,,,589,Norte,AVEIRO,0106,11500.53,15454,881,697,545,420,431,851,1396,2093,2974,134.37,25.86,18.2,12.14
13-01-2022,CASTELO DE VIDE,136,10,4673,"[960,Max]",Extremamente Elevado,,,,136,Alentejo,PORTALEGRE,1205,26491.24,2919,204,173,179,147,170,317,496,669,873,11.02,3.3,2.53,1.87
13-01-2022,CASTRO DAIRE,453,32,3279,"[960,Max]",Extremamente Elevado,,,,453,Centro,VISEU,1803,37904.13,13823,942,857,765,732,773,1505,2270,3127,4069,36.47,10.74,8.25,5.99
13-01-2022,CASTRO MARIM,143,10,2291,"[960,Max]",Extremamente Elevado,,,,143,Algarve,FARO,0804,30084.37,6237,370,345,334,322,344,666,1000,1345,1715,20.73,5.7,4.47,3.32
13-01-2022,CASTRO VERDE,150,11,2163,"[960,Max]",Extremamente Elevado,,,,150,Alentejo,BEJA,0206,56944.23,6949,437,347,303,275,227,502,805,1152,1589,12.2,2.79,2.02,1.41
13-01-2022,CELORICO DA BEIRA,184,13,2654,"[960,Max]",Extremamente Elevado,,,,184,Centro,GUARDA,0903,24721.63,6928,430,416,363,369,535,904,1267,1683,2113,28.02,8.55,6.81,5.12
13-01-2022,CELORICO DE BASTO,762,54,4004,"[960,Max]",Extremamente Elevado,,,,762,Norte,BRAGA,0305,18107.02,19040,1001,802,668,728,729,1457,2125,2927,3928,105.15,21.69,16.17,11.74
13-01-2022,CHAMUSCA,305,22,3320,"[960,Max]",Extremamente Elevado,,,,305,Lisboa e Vale do Tejo,SANTARÉM,1407,74600.54,9197,629,583,553,465,579,1044,1597,2180,2809,12.33,3.77,2.92,2.14
13-01-2022,CHAVES,1149,82,2921,"[960,Max]",Extremamente Elevado,,,,1149,Norte,VILA REAL,1703,59122.95,39343,2676,2429,1991,1886,1918,3804,5795,8224,10900,66.54,18.44,13.91,9.8
13-01-2022,CINFÃES,511,36,2800,"[960,Max]",Extremamente Elevado,,,,511,Norte,VISEU,1804,23928.76,18244,1067,902,779,734,758,1492,2271,3173,4240,76.24,17.72,13.26,9.49
13-01-2022,COIMBRA,3309,236,2466,"[960,Max]",Extremamente Elevado,,,,3309,Centro,COIMBRA,0603,31939.94,134166,9489,8734,6353,5139,5074,10213,16566,25300,34789,420.06,108.92,79.21,51.87
13-01-2022,CONDEIXA-A-NOVA,331,24,1866,"[960,Max]",Extremamente Elevado,,,,331,Centro,COIMBRA,0604,13867.47,17733,871,809,717,583,490,1073,1790,2599,3470,127.88,25.02,18.74,12.91
13-01-2022,CONSTÂNCIA,132,9,3283,"[960,Max]",Extremamente Elevado,,,,132,Lisboa e Vale do Tejo,SANTARÉM,1408,8036.58,4030,211,183,187,148,155,303,490,673,884,50.14,11.0,8.37,6.1
13-01-2022,CORUCHE,425,30,2432,"[960,Max]",Extremamente Elevado,,,,425,Lisboa e Vale do Tejo,SANTARÉM,1409,111572.03,17471,1294,1090,1095,1096,1019,2115,3210,4300,5594,15.66,5.01,3.85,2.88
13-01-2022,CORVO,3,0,638,"[480,960]",Muito Elevado,,,,3,Açores,AÇORES,4901,1711.45,464,22,21,11,13,19,32,43,64,86,27.12,5.03,3.74,2.51
13-01-2022,COVILHÃ,1209,86,2585,"[960,Max]",Extremamente Elevado,,,,1209,Centro,CASTELO BRANCO,0503,55560.06,46787,3533,2998,2365,2111,2193,4304,6669,9667,13200,84.21,23.76,17.4,12.0
13-01-2022,CRATO,84,6,2681,"[960,Max]",Extremamente Elevado,,,,84,Alentejo,PORTALEGRE,1206,39806.88,3129,229,258,163,182,228,410,573,831,1060,7.86,2.66,2.09,1.44
13-01-2022,CUBA,61,4,1320,"[960,Max]",Extremamente Elevado,,,,61,Alentejo,BEJA,0207,17208.72,4595,255,233,206,190,143,333,539,772,1027,26.7,5.97,4.49,3.13
13-01-2022,ELVAS,922,66,4490,"[960,Max]",Extremamente Elevado,,,,922,Alentejo,PORTALEGRE,1207,63128.86,20528,1057,1145,902,852,810,1662,2564,3709,4766,32.52,7.55,5.88,4.06
13-01-2022,ENTRONCAMENTO,773,55,3585,"[960,Max]",Extremamente Elevado,,,,773,Lisboa e Vale do Tejo,SANTARÉM,1410,1372.81,21558,1066,930,868,695,592,1287,2155,3085,4151,1570.14,302.33,224.69,156.96
13-01-2022,ESPINHO,1123,80,3806,"[960,Max]",Extremamente Elevado,,,,1123,Norte,AVEIRO,0107,2105.68,29516,2205,1993,1430,1177,960,2137,3567,5560,7765,1401.52,368.71,264.01,169.37
13-01-2022,ESPOSENDE,1587,113,4644,"[960,Max]",Extremamente Elevado,,,,1587,Norte,BRAGA,0306,9540.98,34177,1831,1522,1095,894,723,1617,2712,4234,6065,358.21,63.57,44.38,28.42
13-01-2022,ESTARREJA,775,55,2979,"[960,Max]",Extremamente Elevado,,,,775,Centro,AVEIRO,0108,10817.33,26006,1503,1399,1106,953,728,1681,2787,4186,5689,240.42,52.59,38.7,25.76
13-01-2022,ESTREMOZ,253,18,1984,"[960,Max]",Extremamente Elevado,,,,253,Alentejo,ÉVORA,0704,51379.95,12728,789,613,697,786,877,1663,2360,2973,3762,24.77,7.32,5.79,4.59
13-01-2022,ÉVORA,1456,104,2778,"[960,Max]",Extremamente Elevado,,,,1456,Alentejo,ÉVORA,0705,130707.58,52428,3569,2852,2176,1966,1803,3769,5945,8797,12366,40.11,9.46,6.73,4.55
13-01-2022,FAFE,2502,179,5207,"[960,Max]",Extremamente Elevado,,,,2502,Norte,BRAGA,0307,21908.11,48060,3044,2455,1679,1403,1208,2611,4290,6745,9789,219.37,44.68,30.79,19.58
13-01-2022,FARO,1740,124,2852,"[960,Max]",Extremamente Elevado,,,,1740,Algarve,FARO,0805,20256.79,61015,3847,3364,2604,2055,1601,3656,6260,9624,13471,301.2,66.5,47.51,30.9
13-01-2022,FELGUEIRAS,2290,164,4059,"[960,Max]",Extremamente Elevado,,,,2290,Norte,PORTO,1303,11573.75,56422,2951,2302,1601,1316,973,2289,3890,6192,9143,487.49,79.0,53.5,33.61
13-01-2022,FERREIRA DO ALENTEJO,96,7,1230,"[960,Max]",Extremamente Elevado,,,,96,Alentejo,BEJA,0208,64820.68,7845,515,414,372,343,345,688,1060,1474,1989,12.1,3.07,2.27,1.64
13-01-2022,FERREIRA DO ZÊZERE,377,27,4740,"[960,Max]",Extremamente Elevado,,,,377,Lisboa e Vale do Tejo,SANTARÉM,1411,19038.03,7959,470,370,416,465,456,921,1337,1707,2177,41.81,11.44,8.97,7.02
13-01-2022,FIGUEIRA DA FOZ,1173,84,1996,"[960,Max]",Extremamente Elevado,,,,1173,Centro,COIMBRA,0605,37905.26,58747,4032,3597,2887,2495,2043,4538,7425,11022,15054,154.98,39.72,29.08,19.59
13-01-2022,FIGUEIRA DE CASTELO RODRIGO,98,7,1754,"[960,Max]",Extremamente Elevado,,,,98,Centro,GUARDA,0904,50857.46,5584,347,352,290,352,391,743,1033,1385,1732,10.98,3.41,2.72,2.03
13-01-2022,FIGUEIRÓ DOS VINHOS,120,9,2156,"[960,Max]",Extremamente Elevado,,,,120,Centro,LEIRIA,1008,17344.0,5568,402,386,322,309,351,660,982,1368,1770,32.1,10.21,7.89,5.66
13-01-2022,FORNOS DE ALGODRES,78,6,1718,"[960,Max]",Extremamente Elevado,,,,78,Centro,GUARDA,0905,13145.05,4528,261,218,247,256,232,488,735,953,1214,34.45,9.24,7.25,5.59
13-01-2022,FREIXO DE ESPADA À CINTA,100,7,3026,"[960,Max]",Extremamente Elevado,,,,100,Norte,BRAGANÇA,0404,24414.29,3298,211,177,231,196,189,385,616,793,1004,13.51,4.11,3.25,2.52
13-01-2022,FRONTEIRA,86,6,2898,"[960,Max]",Extremamente Elevado,,,,86,Alentejo,PORTALEGRE,1208,24859.58,2974,213,182,149,156,168,324,473,655,868,11.96,3.49,2.63,1.9
13-01-2022,FUNCHAL,8070,576,7758,"[960,Max]",Extremamente Elevado,,,,8070,Madeira,MADEIRA,3103,7616.2,104024,6382,5086,3643,2821,1990,4811,8454,13540,19922,1365.86,261.58,177.78,111.0
13-01-2022,FUNDÃO,757,54,2857,"[960,Max]",Extremamente Elevado,,,,757,Centro,CASTELO BRANCO,0504,70019.79,26495,1781,1464,1432,1357,1643,3000,4432,5896,7677,37.84,10.96,8.42,6.33
13-01-2022,GAVIÃO,28,2,848,"[480,960]",Muito Elevado,,,,28,Alentejo,PORTALEGRE,1209,29459.45,3263,189,186,222,263,293,556,778,964,1153,11.08,3.91,3.27,2.64
13-01-2022,GÓIS,35,3,928,"[480,960]",Muito Elevado,,,,35,Centro,COIMBRA,0606,26330.19,3805,235,199,240,233,244,477,717,916,1151,14.45,4.37,3.48,2.72
13-01-2022,GOLEGÃ,211,15,3952,"[960,Max]",Extremamente Elevado,,,,211,Lisboa e Vale do Tejo,SANTARÉM,1412,8431.67,5339,356,299,281,243,255,498,779,1078,1434,63.32,17.01,12.78,9.24
13-01-2022,GONDOMAR,6356,454,3829,"[960,Max]",Extremamente Elevado,,,,6356,Norte,PORTO,1304,13191.76,165985,10555,8755,6222,4450,3364,7814,14036,22791,33346,1258.22,252.77,172.76,106.4
13-01-2022,GOUVEIA,181,13,1464,"[960,Max]",Extremamente Elevado,,,,181,Centro,GUARDA,0906,30061.17,12387,871,931,780,783,810,1593,2373,3304,4175,41.21,13.89,10.99,7.89
13-01-2022,GRÂNDOLA,270,19,1842,"[960,Max]",Extremamente Elevado,,,,270,Alentejo,SETÚBAL,1505,82593.66,14639,834,834,708,688,672,1360,2068,2902,3736,17.72,4.52,3.51,2.5
13-01-2022,GUARDA,849,61,2179,"[960,Max]",Extremamente Elevado,,,,849,Centro,GUARDA,0907,71209.58,38969,2477,2041,1686,1415,1474,2889,4575,6616,9093,54.72,12.77,9.29,6.42
13-01-2022,GUIMARÃES,7641,546,5017,"[960,Max]",Extremamente Elevado,,,,7641,Norte,BRAGA,0308,24099.96,152309,9394,7074,4809,3877,2948,6825,11634,18708,28102,631.99,116.61,77.63,48.27
13-01-2022,HORTA,249,18,1717,"[960,Max]",Extremamente Elevado,,,,249,Açores,AÇORES,4701,17305.53,14521,818,658,468,352,302,654,1122,1780,2598,83.91,15.01,10.29,6.48
13-01-2022,IDANHA-A-NOVA,253,18,3142,"[960,Max]",Extremamente Elevado,,,,253,Centro,CASTELO BRANCO,0505,141633.51,8043,518,490,519,672,974,1646,2165,2655,3173,5.68,2.24,1.87,1.53
13-01-2022,ÍLHAVO,1268,91,3276,"[960,Max]",Extremamente Elevado,,,,1268,Centro,AVEIRO,0110,7347.55,38699,2227,1943,1444,1193,850,2043,3487,5430,7657,526.66,104.21,73.9,47.46
13-01-2022,LAGOA (FARO),517,37,2273,"[960,Max]",Extremamente Elevado,,,,517,Algarve,FARO,0806,8825.45,22762,1314,1168,919,749,670,1419,2338,3506,4820,257.93,54.62,39.73,26.49
13-01-2022,LAGOA,326,23,2217,"[960,Max]",Extremamente Elevado,,,,326,Açores,AÇORES,4201,4559.32,14721,536,458,349,238,235,473,822,1280,1816,322.9,39.83,28.08,18.03
13-01-2022,LAGOS,936,67,3082,"[960,Max]",Extremamente Elevado,,,,936,Algarve,FARO,0807,21299.27,30374,1744,1434,1247,1053,1029,2082,3329,4763,6507,142.61,30.55,22.36,15.63
13-01-2022,LAJES DAS FLORES,20,1,1368,"[960,Max]",Extremamente Elevado,,,,20,Açores,AÇORES,4801,7004.79,1463,88,53,62,46,54,100,162,215,303,20.89,4.33,3.07,2.31
13-01-2022,LAJES DO PICO,56,4,1252,"[960,Max]",Extremamente Elevado,,,,56,Açores,AÇORES,4601,15531.09,4490,304,231,223,159,162,321,544,775,1079,28.91,6.95,4.99,3.5
13-01-2022,LAMEGO,882,63,3543,"[960,Max]",Extremamente Elevado,,,,882,Norte,VISEU,1805,16542.11,24895,1639,1284,1124,898,783,1681,2805,4089,5728,150.5,34.63,24.72,16.96
13-01-2022,LEIRIA,4210,301,3361,"[960,Max]",Extremamente Elevado,,,,4210,Centro,LEIRIA,1009,56508.83,125267,7389,6366,5090,3902,3159,7061,12151,18517,25906,221.68,45.84,32.77,21.5
13-01-2022,LISBOA,27544,1967,5406,"[960,Max]",Extremamente Elevado,,,,27544,Lisboa e Vale do Tejo,LISBOA,1106,10005.43,509515,33197,33340,27706,23037,26770,49807,77513,110853,144050,5092.6,1439.78,1107.98,774.74
13-01-2022,LOULÉ,1900,136,2766,"[960,Max]",Extremamente Elevado,,,,1900,Algarve,FARO,0808,76366.91,68697,3890,3350,2780,2358,2251,4609,7389,10739,14629,89.96,19.16,14.06,9.68
13-01-2022,LOURES,10208,729,4777,"[960,Max]",Extremamente Elevado,,,,10208,Lisboa e Vale do Tejo,LISBOA,1107,16723.99,213687,12746,12794,9644,6669,5033,11702,21346,34140,46886,1277.73,280.35,204.14,127.64
13-01-2022,LOURINHÃ,846,60,3273,"[960,Max]",Extremamente Elevado,,,,846,Lisboa e Vale do Tejo,LISBOA,1108,14717.2,25855,1584,1243,992,842,645,1487,2479,3722,5306,175.68,36.05,25.29,16.84
13-01-2022,LOUSÃ,443,32,2582,"[960,Max]",Extremamente Elevado,,,,443,Centro,COIMBRA,0607,13840.01,17158,946,866,658,528,450,978,1636,2502,3448,123.97,24.91,18.08,11.82
13-01-2022,LOUSADA,2143,153,4584,"[960,Max]",Extremamente Elevado,,,,2143,Norte,PORTO,1305,9608.01,46755,2289,1698,1176,853,621,1474,2650,4348,6637,486.63,69.08,45.25,27.58
13-01-2022,MAÇÃO,218,16,3472,"[960,Max]",Extremamente Elevado,,,,218,Lisboa e Vale do Tejo,SANTARÉM,1413,39997.98,6267,386,362,390,440,657,1097,1487,1849,2235,15.67,5.59,4.62,3.72
13-01-2022,MACEDO DE CAVALEIROS,423,30,2913,"[960,Max]",Extremamente Elevado,,,,423,Norte,BRAGANÇA,0405,69914.08,14516,1082,889,878,823,938,1761,2639,3528,4610,20.76,6.59,5.05,3.77
13-01-2022,MACHICO,1236,88,6185,"[960,Max]",Extremamente Elevado,,,,1236,Madeira,MADEIRA,3104,6825.1,19981,1197,860,662,455,331,786,1448,2308,3505,292.76,51.36,33.82,21.22
13-01-2022,MADALENA,58,4,986,"[960,Max]",Extremamente Elevado,,,,58,Açores,AÇORES,4602,14712.33,5895,334,256,173,190,179,369,542,798,1132,40.07,7.69,5.42,3.68
13-01-2022,MAFRA,3276,234,3862,"[960,Max]",Extremamente Elevado,,,,3276,Lisboa e Vale do Tejo,LISBOA,1109,29165.5,84816,3613,3334,2839,2089,1899,3988,6827,10161,13774,290.81,47.23,34.84,23.41
13-01-2022,MAIA,5064,362,3644,"[960,Max]",Extremamente Elevado,,,,5064,Norte,PORTO,1306,8293.94,138971,7801,6617,4512,3339,2631,5970,10482,17099,24900,1675.56,300.22,206.16,126.38
13-01-2022,MANGUALDE,398,28,2152,"[960,Max]",Extremamente Elevado,,,,398,Centro,VISEU,1806,21925.56,18510,1198,1128,885,852,743,1595,2480,3608,4806,84.42,21.92,16.46,11.31
13-01-2022,MANTEIGAS,100,7,3315,"[960,Max]",Extremamente Elevado,,,,100,Centro,GUARDA,0908,12197.55,3007,258,197,159,167,146,313,472,669,927,24.65,7.6,5.48,3.87
13-01-2022,MARCO DE CANAVESES,2442,174,4743,"[960,Max]",Extremamente Elevado,,,,2442,Norte,PORTO,1307,20188.98,51496,2678,2060,1488,1265,1023,2288,3776,5836,8514,255.07,42.17,28.91,18.7
13-01-2022,MARINHA GRANDE,1149,82,2984,"[960,Max]",Extremamente Elevado,,,,1149,Centro,LEIRIA,1010,18725.19,38508,2365,2302,1638,1359,1058,2417,4055,6357,8722,205.65,46.58,33.95,21.66
13-01-2022,MARVÃO,57,4,1906,"[960,Max]",Extremamente Elevado,,,,57,Alentejo,PORTALEGRE,1210,15489.9,3005,198,185,142,197,237,434,576,761,959,19.4,6.19,4.91,3.72
13-01-2022,MATOSINHOS,6544,467,3732,"[960,Max]",Extremamente Elevado,,,,6544,Norte,PORTO,1308,6241.97,175357,11850,9977,7023,5024,3884,8908,15931,25908,37758,2809.31,604.9,415.06,255.22
13-01-2022,MEALHADA,413,30,2074,"[960,Max]",Extremamente Elevado,,,,413,Centro,AVEIRO,0111,11065.66,19914,1163,1039,810,828,831,1659,2469,3508,4671,179.96,42.21,31.7,22.31
13-01-2022,MÊDA,83,6,1814,"[960,Max]",Extremamente Elevado,,,,83,Centro,GUARDA,0909,28604.92,4587,343,306,290,288,443,731,1021,1327,1670,16.04,5.84,4.64,3.57
13-01-2022,MELGAÇO,142,10,1752,"[960,Max]",Extremamente Elevado,,,,142,Norte,VIANA DO CASTELO,1603,23824.58,8093,507,567,578,614,675,1289,1867,2434,2941,33.97,12.34,10.22,7.84
13-01-2022,MÉRTOLA,187,13,3042,"[960,Max]",Extremamente Elevado,,,,187,Alentejo,BEJA,0209,129287.34,6142,400,390,378,423,600,1023,1401,1791,2191,4.75,1.69,1.39,1.08
13-01-2022,MESÃO FRIO,80,6,2006,"[960,Max]",Extremamente Elevado,,,,80,Norte,VILA REAL,1704,2664.87,3964,265,205,168,157,120,277,445,650,915,148.74,34.33,24.39,16.7
13-01-2022,MIRA,279,20,2357,"[960,Max]",Extremamente Elevado,,,,279,Centro,COIMBRA,0608,12403.38,11832,727,729,659,550,466,1016,1675,2404,3131,95.4,25.24,19.38,13.5
13-01-2022,MIRANDA DO CORVO,266,19,2092,"[960,Max]",Extremamente Elevado,,,,266,Centro,COIMBRA,0609,12637.79,12708,706,659,568,498,404,902,1470,2129,2835,100.55,22.43,16.85,11.63
13-01-2022,MIRANDA DO DOURO,179,13,2617,"[960,Max]",Extremamente Elevado,,,,179,Norte,BRAGANÇA,0406,48718.31,6830,482,429,442,463,470,933,1375,1804,2286,14.02,4.69,3.7,2.82
13-01-2022,MIRANDELA,564,40,2594,"[960,Max]",Extremamente Elevado,,,,564,Norte,BRAGANÇA,0407,65895.67,21754,1640,1315,1204,1078,947,2025,3229,4544,6184,33.01,9.38,6.9,4.9
13-01-2022,MOGADOURO,273,20,3259,"[960,Max]",Extremamente Elevado,,,,273,Norte,BRAGANÇA,0408,76064.93,8392,589,529,576,630,655,1285,1861,2390,2979,11.03,3.92,3.14,2.45
13-01-2022,MOIMENTA DA BEIRA,262,19,2687,"[960,Max]",Extremamente Elevado,,,,262,Norte,VISEU,1807,21996.9,9736,576,514,471,416,461,877,1348,1862,2438,44.26,11.08,8.46,6.13
13-01-2022,MOITA,3136,224,4869,"[960,Max]",Extremamente Elevado,,,,3136,Lisboa e Vale do Tejo,SETÚBAL,1506,5525.98,64407,4226,3646,2623,1801,1425,3226,5849,9495,13721,1165.53,248.3,171.82,105.85
13-01-2022,MONÇÃO,588,42,3289,"[960,Max]",Extremamente Elevado,,,,588,Norte,VIANA DO CASTELO,1604,21130.85,17869,1161,1105,1031,1006,972,1978,3009,4114,5275,84.56,24.96,19.47,14.24
13-01-2022,MONCHIQUE,57,4,1125,"[960,Max]",Extremamente Elevado,,,,57,Algarve,FARO,0809,39530.43,5077,353,384,321,355,392,747,1068,1452,1805,12.84,4.57,3.67,2.7
13-01-2022,MONDIM DE BASTO,312,22,4491,"[960,Max]",Extremamente Elevado,,,,312,Norte,VILA REAL,1705,17207.52,6946,395,300,314,284,283,567,881,1181,1576,40.36,9.16,6.86,5.12
13-01-2022,MONFORTE,126,9,4240,"[960,Max]",Extremamente Elevado,,,,126,Alentejo,PORTALEGRE,1211,42024.82,2975,139,115,117,192,168,360,477,592,731,7.08,1.74,1.41,1.14
13-01-2022,MONTALEGRE,249,18,2770,"[960,Max]",Extremamente Elevado,,,,249,Norte,VILA REAL,1706,80545.71,8997,699,628,595,603,730,1333,1928,2556,3255,11.17,4.04,3.17,2.39
13-01-2022,MONTEMOR-O-NOVO,434,31,2772,"[960,Max]",Extremamente Elevado,,,,434,Alentejo,ÉVORA,0706,123296.65,15647,991,953,868,878,971,1849,2717,3670,4661,12.69,3.78,2.98,2.2
13-01-2022,MONTEMOR-O-VELHO,627,45,2487,"[960,Max]",Extremamente Elevado,,,,627,Centro,COIMBRA,0610,22896.23,25224,1496,1397,1217,1057,988,2045,3262,4659,6155,110.17,26.88,20.35,14.25
13-01-2022,MONTIJO,1897,136,3293,"[960,Max]",Extremamente Elevado,,,,1897,Lisboa e Vale do Tejo,SETÚBAL,1507,34861.64,57614,2771,2441,1990,1554,1109,2663,4653,7094,9865,165.26,28.3,20.35,13.35
13-01-2022,MORA,58,4,1412,"[960,Max]",Extremamente Elevado,,,,58,Alentejo,ÉVORA,0707,44395.02,4138,336,275,252,238,257,495,747,1022,1358,9.32,3.06,2.3,1.68
13-01-2022,MORTÁGUA,192,14,2178,"[960,Max]",Extremamente Elevado,,,,192,Centro,VISEU,1808,25117.82,8803,638,584,535,499,460,959,1494,2078,2716,35.05,10.81,8.27,5.95
13-01-2022,MOURA,444,32,3234,"[960,Max]",Extremamente Elevado,,,,444,Alentejo,BEJA,0210,95845.55,13718,817,656,665,542,461,1003,1668,2324,3141,14.31,3.28,2.42,1.74
13-01-2022,MOURÃO,24,2,986,"[960,Max]",Extremamente Elevado,,,,24,Alentejo,ÉVORA,0708,27862.98,2450,139,108,80,104,109,213,293,401,540,8.79,1.94,1.44,1.05
13-01-2022,MURÇA,201,14,3686,"[960,Max]",Extremamente Elevado,,,,201,Norte,VILA REAL,1707,18937.11,5463,384,341,307,306,319,625,932,1273,1657,28.85,8.75,6.72,4.92
13-01-2022,MURTOSA,234,17,2278,"[960,Max]",Extremamente Elevado,,,,234,Centro,AVEIRO,0112,7308.78,10279,509,473,403,353,409,762,1165,1638,2147,140.63,29.37,22.41,15.94
13-01-2022,NAZARÉ,667,48,4712,"[960,Max]",Extremamente Elevado,,,,667,Lisboa e Vale do Tejo,LEIRIA,1011,8243.43,14165,967,903,670,420,396,816,1486,2389,3356,171.84,40.71,28.98,18.03
13-01-2022,NELAS,256,18,1972,"[960,Max]",Extremamente Elevado,,,,256,Centro,VISEU,1809,12571.48,12974,924,787,668,604,583,1187,1855,2642,3566,103.21,28.37,21.02,14.76
13-01-2022,NISA,175,12,2886,"[960,Max]",Extremamente Elevado,,,,175,Alentejo,PORTALEGRE,1212,57567.84,6061,405,389,355,483,478,961,1316,1705,2110,10.53,3.67,2.96,2.29
13-01-2022,NORDESTE,77,5,1577,"[960,Max]",Extremamente Elevado,,,,77,Açores,AÇORES,4202,10146.8,4862,246,180,124,161,162,323,447,627,873,47.92,8.6,6.18,4.41
13-01-2022,ÓBIDOS,404,29,3410,"[960,Max]",Extremamente Elevado,,,,404,Lisboa e Vale do Tejo,LEIRIA,1012,14155.44,11850,743,650,574,452,436,888,1462,2112,2855,83.72,20.17,14.92,10.33
13-01-2022,ODEMIRA,378,27,1531,"[960,Max]",Extremamente Elevado,,,,378,Alentejo,BEJA,0211,172060.15,24717,1475,1317,1225,1397,1349,2746,3971,5288,6763,14.37,3.93,3.07,2.31
13-01-2022,ODIVELAS,7610,544,4704,"[960,Max]",Extremamente Elevado,,,,7610,Lisboa e Vale do Tejo,LISBOA,1116,2654.36,161774,9562,9038,6952,4641,3812,8453,15405,24443,34005,6095.48,1281.27,920.99,580.44
13-01-2022,OEIRAS,8267,591,4660,"[960,Max]",Extremamente Elevado,,,,8267,Lisboa e Vale do Tejo,LISBOA,1110,4588.31,177408,11580,11575,8566,6211,5855,12066,20632,32207,43787,3866.78,954.38,701.98,449.69
13-01-2022,OLEIROS,71,5,1417,"[960,Max]",Extremamente Elevado,,,,71,Centro,CASTELO BRANCO,0506,47109.31,5003,384,341,366,397,487,884,1250,1591,1975,10.62,4.19,3.38,2.65
13-01-2022,OLHÃO,997,71,2245,"[960,Max]",Extremamente Elevado,,,,997,Algarve,FARO,0810,13086.38,44405,2455,2309,1689,1342,1268,2610,4299,6608,9063,339.33,69.26,50.5,32.85
13-01-2022,OLIVEIRA DE AZEMÉIS,2318,166,3512,"[960,Max]",Extremamente Elevado,,,,2318,Norte,AVEIRO,0113,16110.41,66011,4155,3614,2794,2183,1738,3921,6715,10329,14484,409.75,89.91,64.12,41.68
13-01-2022,OLIVEIRA DE FRADES,302,22,3035,"[960,Max]",Extremamente Elevado,,,,302,Centro,VISEU,1810,14534.62,9936,553,475,438,359,415,774,1212,1687,2240,68.36,15.41,11.61,8.34
13-01-2022,OLIVEIRA DO BAIRRO,564,40,2322,"[960,Max]",Extremamente Elevado,,,,564,Centro,AVEIRO,0114,8731.99,24277,1327,1182,999,786,810,1596,2595,3777,5104,278.02,58.45,43.25,29.72
13-01-2022,OLIVEIRA DO HOSPITAL,419,30,2177,"[960,Max]",Extremamente Elevado,,,,419,Centro,COIMBRA,0611,23451.66,19253,1161,1097,962,924,960,1884,2846,3943,5104,82.1,21.76,16.81,12.14
13-01-2022,OURÉM,1630,116,3701,"[960,Max]",Extremamente Elevado,,,,1630,Lisboa e Vale do Tejo,SANTARÉM,1421,41668.03,44044,2463,2069,1899,1817,1603,3420,5319,7388,9851,105.7,23.64,17.73,12.77
13-01-2022,OURIQUE,70,5,1518,"[960,Max]",Extremamente Elevado,,,,70,Alentejo,BEJA,0212,66331.36,4607,313,287,284,268,227,495,779,1066,1379,6.95,2.08,1.61,1.17
13-01-2022,OVAR,1596,114,2942,"[960,Max]",Extremamente Elevado,,,,1596,Centro,AVEIRO,0115,14770.25,54260,3294,2709,1994,1636,1234,2870,4864,7573,10867,367.37,73.57,51.27,32.93
13-01-2022,PAÇOS DE FERREIRA,2596,185,4577,"[960,Max]",Extremamente Elevado,,,,2596,Norte,PORTO,1309,7099.29,56728,2903,2193,1518,1135,664,1799,3317,5510,8413,799.1,118.51,77.62,46.72
13-01-2022,PALMELA,2183,156,3397,"[960,Max]",Extremamente Elevado,,,,2183,Lisboa e Vale do Tejo,SETÚBAL,1508,46512.01,64269,3402,3244,2635,1846,1391,3237,5872,9116,12518,138.18,26.91,19.6,12.62
13-01-2022,PAMPILHOSA DA SERRA,55,4,1364,"[960,Max]",Extremamente Elevado,,,,55,Centro,COIMBRA,0612,39646.24,4037,238,254,295,339,423,762,1057,1311,1549,10.18,3.91,3.31,2.67
13-01-2022,PAREDES,3792,271,4406,"[960,Max]",Extremamente Elevado,,,,3792,Norte,PORTO,1310,15675.69,86067,4272,3532,2412,1717,1258,2975,5387,8919,13191,549.04,84.15,56.9,34.36
13-01-2022,PAREDES DE COURA,402,29,4710,"[960,Max]",Extremamente Elevado,,,,402,Norte,VIANA DO CASTELO,1605,13818.59,8535,466,528,407,465,515,980,1387,1915,2381,61.76,17.23,13.86,10.04
13-01-2022,PEDRÓGÃO GRANDE,98,7,2870,"[960,Max]",Extremamente Elevado,,,,98,Centro,LEIRIA,1013,12874.75,3410,175,173,196,221,252,473,669,842,1017,26.49,7.9,6.54,5.2
13-01-2022,PENACOVA,277,20,2023,"[960,Max]",Extremamente Elevado,,,,277,Centro,COIMBRA,0613,21673.23,13694,968,923,745,621,703,1324,2069,2992,3960,63.18,18.27,13.81,9.55
13-01-2022,PENAFIEL,2811,201,4029,"[960,Max]",Extremamente Elevado,,,,2811,Norte,PORTO,1311,21224.27,69772,3648,2823,2032,1663,1230,2893,4925,7748,11396,328.74,53.69,36.51,23.2
13-01-2022,PENALVA DO CASTELO,195,14,2743,"[960,Max]",Extremamente Elevado,,,,195,Centro,VISEU,1811,13433.92,7115,449,457,413,391,426,817,1230,1687,2136,52.96,15.9,12.56,9.16
13-01-2022,PENAMACOR,84,6,1757,"[960,Max]",Extremamente Elevado,,,,84,Centro,CASTELO BRANCO,0507,56370.69,4755,262,248,273,451,633,1084,1357,1605,1867,8.44,3.31,2.85,2.41
13-01-2022,PENEDONO,86,6,3305,"[960,Max]",Extremamente Elevado,,,,86,Norte,VISEU,1812,13370.75,2591,172,113,129,156,138,294,423,536,708,19.38,5.3,4.01,3.16
13-01-2022,PENELA,140,10,2599,"[960,Max]",Extremamente Elevado,,,,140,Centro,COIMBRA,0614,13480.0,5397,314,324,274,359,344,703,977,1301,1615,40.04,11.98,9.65,7.25
13-01-2022,PENICHE,1000,71,3774,"[960,Max]",Extremamente Elevado,,,,1000,Lisboa e Vale do Tejo,LEIRIA,1014,7754.98,26501,1746,1504,1203,926,707,1633,2836,4340,6086,341.73,78.48,55.96,36.57
13-01-2022,PESO DA RÉGUA,580,41,3678,"[960,Max]",Extremamente Elevado,,,,580,Norte,VILA REAL,1708,9486.01,15773,1076,843,650,659,455,1114,1764,2607,3683,166.28,38.83,27.48,18.6
13-01-2022,PINHEL,117,8,1376,"[960,Max]",Extremamente Elevado,,,,117,Centro,GUARDA,0910,48452.12,8511,577,566,551,538,689,1227,1778,2344,2921,17.57,6.03,4.84,3.67
13-01-2022,POMBAL,1392,99,2704,"[960,Max]",Extremamente Elevado,,,,1392,Centro,LEIRIA,1015,62600.28,51461,3187,2791,2494,2328,2027,4355,6849,9640,12827,82.21,20.49,15.4,10.94
13-01-2022,PONTA DELGADA,1237,88,1821,"[960,Max]",Extremamente Elevado,,,,1237,Açores,AÇORES,4203,23298.65,67935,3108,2435,1726,1133,902,2035,3761,6196,9304,291.58,39.93,26.59,16.14
13-01-2022,PONTA DO SOL,462,33,5378,"[960,Max]",Extremamente Elevado,,,,462,Madeira,MADEIRA,3105,4622.03,8593,319,283,347,208,221,429,776,1059,1378,185.92,29.81,22.91,16.79
13-01-2022,PONTE DA BARCA,445,32,3983,"[960,Max]",Extremamente Elevado,,,,445,Norte,VIANA DO CASTELO,1606,18211.37,11180,635,576,517,554,490,1044,1561,2137,2772,61.39,15.22,11.73,8.57
13-01-2022,PONTE DE LIMA,1698,121,4111,"[960,Max]",Extremamente Elevado,,,,1698,Norte,VIANA DO CASTELO,1607,32025.46,41315,2321,2022,1720,1596,1462,3058,4778,6800,9121,129.01,28.48,21.23,14.92
13-01-2022,PONTE DE SOR,394,28,2627,"[960,Max]",Extremamente Elevado,,,,394,Alentejo,PORTALEGRE,1213,83971.16,14994,939,800,716,739,831,1570,2286,3086,4025,17.86,4.79,3.68,2.72
13-01-2022,PORTALEGRE,632,45,2852,"[960,Max]",Extremamente Elevado,,,,632,Alentejo,PORTALEGRE,1214,44713.64,22172,1577,1351,1137,993,984,1977,3114,4465,6042,49.59,13.51,9.99,6.96
13-01-2022,PORTEL,116,8,1991,"[960,Max]",Extremamente Elevado,,,,116,Alentejo,ÉVORA,0709,60100.57,5828,336,358,283,331,305,636,919,1277,1613,9.7,2.68,2.12,1.53
13-01-2022,PORTIMÃO,1424,102,2567,"[960,Max]",Extremamente Elevado,,,,1424,Algarve,FARO,0811,18206.29,55483,3182,2927,2116,1582,1400,2982,5098,8025,11207,304.75,61.56,44.08,28.0
13-01-2022,PORTO,9429,673,4353,"[960,Max]",Extremamente Elevado,,,,9429,Norte,PORTO,1312,4142.02,216606,15790,15193,11280,9409,10044,19453,30733,45926,61716,5229.5,1490.0,1108.79,741.98
13-01-2022,PORTO DE MÓS,766,55,3293,"[960,Max]",Extremamente Elevado,,,,766,Centro,LEIRIA,1016,26183.41,23275,1355,1210,1034,888,872,1760,2794,4004,5359,88.89,20.47,15.29,10.67
13-01-2022,PORTO MONIZ,151,11,6445,"[960,Max]",Extremamente Elevado,,,,151,Madeira,MADEIRA,3106,8293.38,2342,143,130,95,98,120,218,313,443,586,28.24,7.07,5.34,3.77
13-01-2022,PORTO SANTO,242,17,4657,"[960,Max]",Extremamente Elevado,,,,242,Madeira,MADEIRA,3201,4300.7,5202,240,157,134,110,68,178,312,469,709,120.95,16.48,10.9,7.25
13-01-2022,PÓVOA DE LANHOSO,1220,87,5675,"[960,Max]",Extremamente Elevado,,,,1220,Norte,BRAGA,0309,13465.29,21499,1175,909,732,673,624,1297,2029,2938,4113,159.67,30.55,21.82,15.07
13-01-2022,PÓVOA DE VARZIM,2605,186,4149,"[960,Max]",Extremamente Elevado,,,,2605,Norte,PORTO,1313,8220.59,62784,3712,3120,2134,1594,1305,2899,5033,8153,11865,763.7,144.33,99.17,61.22
13-01-2022,POVOAÇÃO,112,8,1883,"[960,Max]",Extremamente Elevado,,,,112,Açores,AÇORES,4204,10640.77,5927,293,212,191,144,134,278,469,681,974,55.7,9.15,6.4,4.41
13-01-2022,VILA DA PRAIA DA VITÓRIA,405,29,1898,"[960,Max]",Extremamente Elevado,,,,405,Açores,AÇORES,4302,16127.06,21317,1133,789,619,436,336,772,1391,2180,3313,132.18,20.54,13.52,8.63
13-01-2022,PROENÇA-A-NOVA,267,19,3659,"[960,Max]",Extremamente Elevado,,,,267,Centro,CASTELO BRANCO,0508,39539.96,7298,508,465,389,400,560,960,1349,1814,2322,18.46,5.87,4.59,3.41
13-01-2022,REDONDO,98,7,1544,"[960,Max]",Extremamente Elevado,,,,98,Alentejo,ÉVORA,0710,36950.87,6353,349,325,288,288,354,642,930,1255,1604,17.19,4.34,3.4,2.52
13-01-2022,REGUENGOS DE MONSARAZ,273,20,2730,"[960,Max]",Extremamente Elevado,,,,273,Alentejo,ÉVORA,0711,46399.72,10015,602,511,455,462,473,935,1390,1901,2503,21.58,5.39,4.1,3.0
13-01-2022,RESENDE,265,19,2614,"[960,Max]",Extremamente Elevado,,,,265,Norte,VISEU,1813,12334.93,10137,560,493,448,433,422,855,1303,1796,2356,82.18,19.1,14.56,10.56
13-01-2022,RIBEIRA BRAVA,724,52,5819,"[960,Max]",Extremamente Elevado,,,,724,Madeira,MADEIRA,3107,6544.88,12435,648,500,411,311,287,598,1009,1509,2157,189.99,32.96,23.06,15.42
13-01-2022,RIBEIRA DE PENA,269,19,4476,"[960,Max]",Extremamente Elevado,,,,269,Norte,VILA REAL,1709,21745.98,6016,371,301,290,310,368,678,968,1269,1640,27.66,7.54,5.84,4.45
13-01-2022,RIBEIRA GRANDE,792,57,2413,"[960,Max]",Extremamente Elevado,,,,792,Açores,AÇORES,4205,18015.13,32811,1163,689,512,345,253,598,1110,1799,2962,182.13,16.44,9.99,6.16
13-01-2022,RIO MAIOR,542,39,2662,"[960,Max]",Extremamente Elevado,,,,542,Lisboa e Vale do Tejo,SANTARÉM,1414,27276.45,20379,1251,1144,941,795,648,1443,2384,3528,4779,74.71,17.52,12.93,8.74
13-01-2022,SABROSA,159,11,2686,"[960,Max]",Extremamente Elevado,,,,159,Norte,VILA REAL,1710,15692.45,5918,393,314,304,302,350,652,956,1270,1663,37.71,10.6,8.09,6.09
13-01-2022,SABUGAL,231,17,2185,"[960,Max]",Extremamente Elevado,,,,231,Centro,GUARDA,0911,82269.82,10585,724,707,694,796,1009,1805,2499,3206,3930,12.87,4.78,3.9,3.04
13-01-2022,SALVATERRA DE MAGOS,551,39,2587,"[960,Max]",Extremamente Elevado,,,,551,Lisboa e Vale do Tejo,SANTARÉM,1415,24393.2,21295,1275,1181,1060,799,772,1571,2631,3812,5087,87.3,20.85,15.63,10.79
13-01-2022,SANTA COMBA DÃO,185,13,1771,"[960,Max]",Extremamente Elevado,,,,185,Centro,VISEU,1814,11194.77,10452,732,684,569,538,464,1002,1571,2255,2987,93.36,26.68,20.14,14.03
13-01-2022,SANTA CRUZ,2898,207,6401,"[960,Max]",Extremamente Elevado,,,,2898,Madeira,MADEIRA,3108,8150.28,45281,1817,1301,974,716,523,1239,2213,3514,5331,555.6,65.41,43.12,27.15
13-01-2022,SANTA CRUZ DA GRACIOSA,16,1,383,"[240,480]",Elevado,,,,16,Açores,AÇORES,4401,6065.78,4208,228,180,163,124,145,269,432,612,840,69.37,13.85,10.09,7.12
13-01-2022,SANTA CRUZ DAS FLORES,22,2,1016,"[960,Max]",Extremamente Elevado,,,,22,Açores,AÇORES,4802,7091.44,2165,125,98,74,56,51,107,181,279,404,30.53,5.7,3.93,2.55
13-01-2022,SANTA MARIA DA FEIRA,5717,408,4124,"[960,Max]",Extremamente Elevado,,,,5717,Norte,AVEIRO,0109,21587.65,138636,8182,6743,4771,3856,3079,6935,11706,18449,26631,642.19,123.36,85.46,54.22
13-01-2022,SANTA MARTA DE PENAGUIÃO,175,13,2654,"[960,Max]",Extremamente Elevado,,,,175,Norte,VILA REAL,1711,6928.13,6599,483,373,337,316,317,633,970,1343,1826,95.25,26.36,19.39,14.0
13-01-2022,SANTANA,274,20,4076,"[960,Max]",Extremamente Elevado,,,,274,Madeira,MADEIRA,3109,9547.3,6711,418,353,343,282,277,559,902,1255,1673,70.29,17.52,13.15,9.45
13-01-2022,SANTARÉM,1972,141,3435,"[960,Max]",Extremamente Elevado,,,,1972,Lisboa e Vale do Tejo,SANTARÉM,1416,55253.58,57421,3654,3441,2760,2466,2206,4672,7432,10873,14527,103.92,26.29,19.68,13.45
13-01-2022,SANTIAGO DO CACÉM,522,37,1812,"[960,Max]",Extremamente Elevado,,,,522,Alentejo,SETÚBAL,1509,105969.29,28791,2144,1689,1472,1295,1215,2510,3982,5671,7815,27.17,7.37,5.35,3.76
13-01-2022,SANTO TIRSO,2430,174,3571,"[960,Max]",Extremamente Elevado,,,,2430,Norte,PORTO,1314,13655.52,68055,4911,3935,2761,2257,1810,4067,6828,10763,15674,498.35,114.78,78.82,50.0
13-01-2022,SÃO BRÁS DE ALPORTEL,258,18,2478,"[960,Max]",Extremamente Elevado,,,,258,Algarve,FARO,0812,15336.92,10416,596,468,467,404,401,805,1272,1740,2336,67.91,15.23,11.35,8.29
13-01-2022,SÃO JOÃO DA MADEIRA,872,62,3971,"[960,Max]",Extremamente Elevado,,,,872,Norte,AVEIRO,0116,794.3,21958,1347,1069,796,601,593,1194,1990,3059,4406,2765.49,554.91,385.26,250.63
13-01-2022,SÃO JOÃO DA PESQUEIRA,228,16,3201,"[960,Max]",Extremamente Elevado,,,,228,Norte,VISEU,1815,26610.85,7125,417,330,294,328,328,656,950,1280,1697,26.77,6.38,4.81,3.57
13-01-2022,SÃO PEDRO DO SUL,429,31,2782,"[960,Max]",Extremamente Elevado,,,,429,Centro,VISEU,1816,34895.09,15403,990,962,861,759,909,1668,2529,3491,4481,44.14,12.84,10.0,7.25
13-01-2022,SÃO ROQUE DO PICO,32,2,977,"[960,Max]",Extremamente Elevado,,,,32,Açores,AÇORES,4603,14236.1,3266,199,141,93,96,113,209,302,443,642,22.94,4.51,3.11,2.12
13-01-2022,SÃO VICENTE,242,17,4713,"[960,Max]",Extremamente Elevado,,,,242,Madeira,MADEIRA,3110,7883.71,5143,272,264,266,225,280,505,771,1035,1307,65.23,16.58,13.13,9.78
13-01-2022,SARDOAL,164,12,4385,"[960,Max]",Extremamente Elevado,,,,164,Lisboa e Vale do Tejo,SANTARÉM,1417,9214.72,3741,227,178,148,165,248,413,561,739,966,40.6,10.48,8.02,6.09
13-01-2022,SÁTÃO,408,29,3524,"[960,Max]",Extremamente Elevado,,,,408,Centro,VISEU,1817,20194.11,11580,765,671,515,465,476,941,1456,2127,2892,57.34,14.32,10.53,7.21
13-01-2022,SEIA,479,34,2156,"[960,Max]",Extremamente Elevado,,,,479,Centro,GUARDA,0912,43568.83,22234,1807,1589,1238,1122,721,1843,3081,4670,6477,51.03,14.87,10.72,7.07
13-01-2022,SEIXAL,8185,585,4879,"[960,Max]",Extremamente Elevado,,,,8185,Lisboa e Vale do Tejo,SETÚBAL,1510,9545.17,167752,10586,9270,6661,4391,2930,7321,13982,23252,33838,1757.49,354.51,243.6,146.49
13-01-2022,SERNANCELHE,90,6,1674,"[960,Max]",Extremamente Elevado,,,,90,Norte,VISEU,1818,22861.22,5396,305,293,286,273,260,533,819,1112,1417,23.6,6.2,4.86,3.58
13-01-2022,SERPA,611,44,4275,"[960,Max]",Extremamente Elevado,,,,611,Alentejo,BEJA,0213,110563.34,14304,903,761,719,697,626,1323,2042,2803,3706,12.94,3.35,2.54,1.85
13-01-2022,SERTÃ,450,32,3090,"[960,Max]",Extremamente Elevado,,,,450,Centro,CASTELO BRANCO,0509,44673.17,14577,870,779,790,767,1020,1787,2577,3356,4226,32.63,9.46,7.51,5.77
13-01-2022,SESIMBRA,2126,152,4099,"[960,Max]",Extremamente Elevado,,,,2126,Lisboa e Vale do Tejo,SETÚBAL,1511,19571.75,51858,2400,2321,1853,1257,1083,2340,4193,6514,8914,264.96,45.54,33.28,21.42
13-01-2022,SETÚBAL,4332,309,3763,"[960,Max]",Extremamente Elevado,,,,4332,Lisboa e Vale do Tejo,SETÚBAL,1512,23032.5,115126,7425,6929,5075,3775,2655,6430,11505,18434,25859,499.83,112.27,80.03,49.95
13-01-2022,SEVER DO VOUGA,354,25,3126,"[960,Max]",Extremamente Elevado,,,,354,Centro,AVEIRO,0117,12987.56,11331,766,637,568,540,567,1107,1675,2312,3078,87.24,23.7,17.8,12.9
13-01-2022,SILVES,809,58,2233,"[960,Max]",Extremamente Elevado,,,,809,Algarve,FARO,0813,68006.23,36226,2137,1869,1610,1423,1600,3023,4633,6502,8639,53.27,12.7,9.56,6.81
13-01-2022,SINES,428,31,3122,"[960,Max]",Extremamente Elevado,,,,428,Alentejo,SETÚBAL,1513,20330.17,13715,888,791,551,416,268,684,1235,2026,2914,67.46,14.33,9.97,6.07
13-01-2022,SINTRA,20506,1465,5239,"[960,Max]",Extremamente Elevado,,,,20506,Lisboa e Vale do Tejo,LISBOA,1111,31922.73,391402,20490,18316,13545,9137,7284,16421,29966,48282,68772,1226.08,215.43,151.25,93.87
13-01-2022,SOBRAL DE MONTE AGRAÇO,401,29,3766,"[960,Max]",Extremamente Elevado,,,,401,Lisboa e Vale do Tejo,LISBOA,1112,5210.32,10651,564,507,352,272,212,484,836,1343,1907,204.43,36.6,25.78,16.05
13-01-2022,SOURE,338,24,1976,"[960,Max]",Extremamente Elevado,,,,338,Centro,COIMBRA,0615,26506.07,17120,1173,1142,1004,883,987,1870,2874,4016,5189,64.59,19.58,15.15,10.84
13-01-2022,SOUSEL,88,6,1987,"[960,Max]",Extremamente Elevado,,,,88,Alentejo,PORTALEGRE,1215,27932.18,4412,261,274,208,302,292,594,802,1076,1337,15.8,4.79,3.85,2.87
13-01-2022,TÁBUA,241,17,2119,"[960,Max]",Extremamente Elevado,,,,241,Centro,COIMBRA,0616,19978.58,11368,729,584,524,430,464,894,1418,2002,2731,56.9,13.67,10.02,7.1
13-01-2022,TABUAÇO,91,7,1512,"[960,Max]",Extremamente Elevado,,,,91,Norte,VISEU,1819,13385.67,6033,372,314,217,282,363,645,862,1176,1548,45.07,11.56,8.79,6.44
13-01-2022,TAROUCA,182,13,2327,"[960,Max]",Extremamente Elevado,,,,182,Norte,VISEU,1820,10008.49,7804,405,335,313,277,324,601,914,1249,1654,77.98,16.53,12.48,9.13
13-01-2022,TAVIRA,565,40,2305,"[960,Max]",Extremamente Elevado,,,,565,Algarve,FARO,0814,60696.7,24530,1493,1415,1252,1066,1277,2343,3595,5010,6503,40.41,10.71,8.25,5.92
13-01-2022,TERRAS DE BOURO,254,18,3990,"[960,Max]",Extremamente Elevado,,,,254,Norte,BRAGA,0310,27746.07,6361,391,372,296,319,340,659,955,1327,1718,22.93,6.19,4.78,3.44
13-01-2022,TOMAR,1203,86,3274,"[960,Max]",Extremamente Elevado,,,,1203,Lisboa e Vale do Tejo,SANTARÉM,1418,35120.44,36748,2403,2189,1868,1853,1822,3675,5543,7732,10135,104.64,28.86,22.02,15.78
13-01-2022,TONDELA,629,45,2386,"[960,Max]",Extremamente Elevado,,,,629,Centro,VISEU,1821,37121.73,26357,1768,1722,1518,1475,1417,2892,4410,6132,7900,71.0,21.28,16.52,11.88
13-01-2022,TORRE DE MONCORVO,136,10,1762,"[960,Max]",Extremamente Elevado,,,,136,Norte,BRAGANÇA,0409,53155.67,7695,556,478,488,551,719,1270,1758,2236,2792,14.48,5.25,4.21,3.31
13-01-2022,TORRES NOVAS,1136,81,3251,"[960,Max]",Extremamente Elevado,,,,1136,Lisboa e Vale do Tejo,SANTARÉM,1419,26999.68,34933,2324,1979,1738,1406,1475,2881,4619,6598,8922,129.38,33.04,24.44,17.11
13-01-2022,TORRES VEDRAS,2892,207,3683,"[960,Max]",Extremamente Elevado,,,,2892,Lisboa e Vale do Tejo,LISBOA,1113,40714.89,78530,4513,3945,3447,2628,2104,4732,8179,12124,16637,192.88,40.86,29.78,20.09
13-01-2022,TRANCOSO,128,9,1439,"[960,Max]",Extremamente Elevado,,,,128,Centro,GUARDA,0913,36152.47,8875,581,557,542,586,496,1082,1624,2181,2762,24.55,7.64,6.03,4.49
13-01-2022,TROFA,1437,103,3741,"[960,Max]",Extremamente Elevado,,,,1437,Norte,PORTO,1318,7201.76,38418,2336,1894,1231,939,684,1623,2854,4748,7084,533.44,98.36,65.93,39.63
13-01-2022,VAGOS,651,47,2863,"[960,Max]",Extremamente Elevado,,,,651,Centro,AVEIRO,0118,16491.5,22740,1320,1205,922,784,724,1508,2430,3635,4955,137.89,30.04,22.04,14.73
13-01-2022,VALE DE CAMBRA,1161,83,5442,"[960,Max]",Extremamente Elevado,,,,1161,Norte,AVEIRO,0119,14733.47,21327,1491,1363,1005,831,798,1629,2634,3997,5488,144.76,37.25,27.13,17.88
13-01-2022,VALENÇA,595,43,4480,"[960,Max]",Extremamente Elevado,,,,595,Norte,VIANA DO CASTELO,1608,11712.86,13290,867,791,582,582,503,1085,1667,2458,3325,113.46,28.39,20.99,14.23
13-01-2022,VALONGO,3496,250,3588,"[960,Max]",Extremamente Elevado,,,,3496,Norte,PORTO,1315,7512.45,97444,5629,4696,3207,2462,1829,4291,7498,12194,17823,1297.18,237.26,162.33,99.81
13-01-2022,VALPAÇOS,467,33,3154,"[960,Max]",Extremamente Elevado,,,,467,Norte,VILA REAL,1712,54873.93,14818,1217,1118,999,928,997,1925,2924,4042,5259,27.0,9.58,7.37,5.33
13-01-2022,VELAS,14,1,276,"[240,480]",Elevado,,,,14,Açores,AÇORES,4502,11738.38,5093,278,208,166,153,113,266,432,640,918,43.39,7.82,5.45,3.68
13-01-2022,VENDAS NOVAS,311,22,2762,"[960,Max]",Extremamente Elevado,,,,311,Alentejo,ÉVORA,0712,22238.88,11255,677,768,655,501,532,1033,1688,2456,3133,50.61,14.09,11.04,7.59
13-01-2022,VIANA DO ALENTEJO,72,5,1390,"[960,Max]",Extremamente Elevado,,,,72,Alentejo,ÉVORA,0713,39367.29,5145,245,208,235,210,214,424,659,867,1112,13.07,2.82,2.2,1.67
13-01-2022,VIANA DO CASTELO,2747,196,3254,"[960,Max]",Extremamente Elevado,,,,2747,Norte,VIANA DO CASTELO,1609,31902.01,84417,5470,4433,3591,3061,2982,6043,9634,14067,19537,264.61,61.24,44.09,30.2
13-01-2022,VIDIGUEIRA,74,5,1334,"[960,Max]",Extremamente Elevado,,,,74,Alentejo,BEJA,0214,31661.09,5510,300,248,215,233,275,508,723,971,1271,17.4,4.01,3.07,2.28
13-01-2022,VIEIRA DO MINHO,515,37,4353,"[960,Max]",Extremamente Elevado,,,,515,Norte,BRAGA,0311,21644.35,11842,703,594,525,548,482,1030,1555,2149,2852,54.71,13.18,9.93,7.18
13-01-2022,VILA DE REI,77,5,2307,"[960,Max]",Extremamente Elevado,,,,77,Centro,CASTELO BRANCO,0510,19154.6,3323,169,128,172,247,302,549,721,849,1018,17.35,5.31,4.43,3.76
13-01-2022,VILA DO BISPO,102,7,1982,"[960,Max]",Extremamente Elevado,,,,102,Algarve,FARO,0815,17906.06,5154,302,302,314,232,233,465,779,1081,1383,28.78,7.72,6.04,4.35
13-01-2022,VILA DO CONDE,3175,227,3974,"[960,Max]",Extremamente Elevado,,,,3175,Norte,PORTO,1316,14902.77,79899,4726,3875,2819,2070,1743,3813,6632,10507,15233,536.13,102.21,70.5,44.5
13-01-2022,VILA DO PORTO,87,6,1550,"[960,Max]",Extremamente Elevado,,,,87,Açores,AÇORES,4101,9688.74,5616,274,212,135,96,123,219,354,566,840,57.96,8.67,5.84,3.65
13-01-2022,VILA FLOR,83,6,1381,"[960,Max]",Extremamente Elevado,,,,83,Norte,BRAGANÇA,0410,26581.14,6044,429,362,422,294,331,625,1047,1409,1838,22.74,6.91,5.3,3.94
13-01-2022,VILA FRANCA DE XIRA,7082,506,4989,"[960,Max]",Extremamente Elevado,,,,7082,Lisboa e Vale do Tejo,LISBOA,1114,31819.39,141957,8501,6852,4869,3425,2472,5897,10766,17618,26119,446.14,82.09,55.37,33.84
13-01-2022,VILA FRANCA DO CAMPO,211,15,1912,"[960,Max]",Extremamente Elevado,,,,211,Açores,AÇORES,4206,7796.82,11051,450,344,248,217,154,371,619,963,1413,141.73,18.12,12.35,7.94
13-01-2022,VILA NOVA DA BARQUINHA,223,16,2994,"[960,Max]",Extremamente Elevado,,,,223,Lisboa e Vale do Tejo,SANTARÉM,1420,4952.97,7461,415,406,392,364,338,702,1094,1500,1915,150.64,38.66,30.28,22.09
13-01-2022,VILA NOVA DE CERVEIRA,319,23,3584,"[960,Max]",Extremamente Elevado,,,,319,Norte,VIANA DO CASTELO,1610,10846.66,8910,531,444,410,384,334,718,1128,1572,2103,82.14,19.39,14.49,10.4
13-01-2022,VILA NOVA DE FAMALICÃO,5083,363,3860,"[960,Max]",Extremamente Elevado,,,,5083,Norte,BRAGA,0312,20159.26,131676,7817,6164,4202,3282,2749,6031,10233,16397,24214,653.19,120.12,81.34,50.76
13-01-2022,VILA NOVA DE FOZ CÔA,91,7,1401,"[960,Max]",Extremamente Elevado,,,,91,Centro,GUARDA,0914,39815.18,6503,442,385,390,398,429,827,1217,1602,2044,16.33,5.13,4.02,3.06
13-01-2022,VILA NOVA DE GAIA,12635,902,4205,"[960,Max]",Extremamente Elevado,,,,12635,Norte,PORTO,1317,16846.43,300472,18349,15568,10972,8224,6281,14505,25477,41045,59394,1783.64,352.57,243.65,151.23
13-01-2022,VILA NOVA DE PAIVA,224,16,4778,"[960,Max]",Extremamente Elevado,,,,224,Centro,VISEU,1822,17553.28,4687,289,272,233,217,241,458,691,963,1252,26.7,7.13,5.49,3.94
13-01-2022,VILA NOVA DE POIARES,123,9,1767,"[960,Max]",Extremamente Elevado,,,,123,Centro,COIMBRA,0617,8445.3,6939,380,284,262,235,182,417,679,963,1343,82.17,15.9,11.4,8.04
13-01-2022,VILA POUCA DE AGUIAR,312,22,2606,"[960,Max]",Extremamente Elevado,,,,312,Norte,VILA REAL,1713,43706.62,11961,860,817,733,601,627,1228,1961,2778,3638,27.37,8.32,6.36,4.49
13-01-2022,VILA REAL,1764,126,3531,"[960,Max]",Extremamente Elevado,,,,1764,Norte,VILA REAL,1714,37880.28,49962,3025,2498,2065,1579,1466,3045,5110,7608,10633,131.9,28.07,20.08,13.49
13-01-2022,VILA REAL DE SANTO ANTÓNIO,349,25,1862,"[960,Max]",Extremamente Elevado,,,,349,Algarve,FARO,0816,6125.0,18749,1172,1069,811,569,586,1155,1966,3035,4207,306.11,68.69,49.55,32.1
13-01-2022,VILA VELHA DE RÓDÃO,55,4,1750,"[960,Max]",Extremamente Elevado,,,,55,Centro,CASTELO BRANCO,0511,32991.16,3144,209,229,180,283,306,589,769,998,1207,9.53,3.66,3.03,2.33
13-01-2022,VILA VERDE,2381,170,5076,"[960,Max]",Extremamente Elevado,,,,2381,Norte,BRAGA,0313,22866.52,46911,2365,2063,1667,1494,1437,2931,4598,6661,9026,205.15,39.47,29.13,20.11
13-01-2022,VILA VIÇOSA,265,19,3463,"[960,Max]",Extremamente Elevado,,,,265,Alentejo,ÉVORA,0714,19485.89,7656,487,379,342,345,324,669,1011,1390,1877,39.29,9.63,7.13,5.19
13-01-2022,VIMIOSO,196,14,4876,"[960,Max]",Extremamente Elevado,,,,196,Norte,BRAGANÇA,0411,48158.51,4023,274,230,261,293,335,628,889,1119,1393,8.35,2.89,2.32,1.85
13-01-2022,VINHAIS,248,18,3207,"[960,Max]",Extremamente Elevado,,,,248,Norte,BRAGANÇA,0412,69475.09,7746,599,577,636,641,815,1456,2092,2669,3268,11.15,4.7,3.84,3.01
13-01-2022,VISEU,2958,211,3042,"[960,Max]",Extremamente Elevado,,,,2958,Centro,VISEU,1823,50710.14,97249,5769,5038,4140,3158,2710,5868,10008,15046,20815,191.77,41.05,29.67,19.74
13-01-2022,VIZELA,1567,112,6557,"[960,Max]",Extremamente Elevado,,,,1567,Norte,BRAGA,0314,2469.83,23897,1258,928,655,509,371,880,1535,2463,3721,967.49,150.65,99.72,62.15
13-01-2022,VOUZELA,194,14,2016,"[960,Max]",Extremamente Elevado,,,,194,Centro,VISEU,1824,19369.46,9619,626,605,554,532,507,1039,1593,2198,2824,49.66,14.58,11.35,8.22
20-01-2022,ABRANTES,1406,100,4002,"[960,Max]",Extremamente Elevado,,,,1406,Lisboa e Vale do Tejo,SANTARÉM,1401,71469.08,35130,2473,2213,1730,1748,2021,3769,5499,7712,10185,49.15,14.25,10.79,7.69
20-01-2022,ÁGUEDA,2233,159,4846,"[960,Max]",Extremamente Elevado,,,,2233,Centro,AVEIRO,0101,33527.44,46075,3237,2713,2090,1635,1496,3131,5221,7934,11171,137.43,33.32,23.66,15.57
20-01-2022,AGUIAR DA BEIRA,192,14,4122,"[960,Max]",Extremamente Elevado,,,,192,Centro,GUARDA,0901,20676.57,4652,304,281,235,239,148,387,622,903,1207,22.5,5.84,4.37,3.01
20-01-2022,ALANDROAL,169,12,3392,"[960,Max]",Extremamente Elevado,,,,169,Alentejo,ÉVORA,0701,54267.81,4992,307,256,296,299,377,676,972,1228,1535,9.2,2.83,2.26,1.79
20-01-2022,ALBERGARIA-A-VELHA,1628,116,6742,"[960,Max]",Extremamente Elevado,,,,1628,Centro,AVEIRO,0102,15882.5,24144,1550,1298,996,687,680,1367,2363,3661,5211,152.02,32.81,23.05,14.88
20-01-2022,ALBUFEIRA,1985,142,4780,"[960,Max]",Extremamente Elevado,,,,1985,Algarve,FARO,0801,14066.42,41528,2067,1717,1425,985,858,1843,3268,4985,7052,295.24,50.14,35.44,23.23
20-01-2022,ALCÁCER DO SAL,400,29,3430,"[960,Max]",Extremamente Elevado,,,,400,Alentejo,SETÚBAL,1501,149987.3,11659,884,814,623,623,602,1225,1848,2662,3546,7.77,2.36,1.77,1.23
20-01-2022,ALCANENA,510,36,3978,"[960,Max]",Extremamente Elevado,,,,510,Lisboa e Vale do Tejo,SANTARÉM,1402,12732.86,12809,891,744,628,536,588,1124,1752,2496,3387,100.6,26.6,19.6,13.76
20-01-2022,ALCOBAÇA,2521,180,4708,"[960,Max]",Extremamente Elevado,,,,2521,Lisboa e Vale do Tejo,LEIRIA,1001,40814.09,53555,3420,2927,2466,2059,1676,3735,6201,9128,12548,131.22,30.74,22.36,15.19
20-01-2022,ALCOCHETE,904,65,4570,"[960,Max]",Extremamente Elevado,,,,904,Lisboa e Vale do Tejo,SETÚBAL,1502,12836.48,19787,857,834,691,476,447,923,1614,2448,3305,154.15,25.75,19.07,12.57
20-01-2022,ALCOUTIM,112,8,5200,"[960,Max]",Extremamente Elevado,,,,112,Algarve,FARO,0802,57536.33,2159,191,188,163,190,267,457,620,808,999,3.75,1.74,1.4,1.08
20-01-2022,ALENQUER,2154,154,4889,"[960,Max]",Extremamente Elevado,,,,2154,Lisboa e Vale do Tejo,LISBOA,1101,30421.92,44052,2298,2062,1629,1330,1155,2485,4114,6176,8474,144.8,27.85,20.3,13.52
20-01-2022,ALFÂNDEGA DA FÉ,134,10,2939,"[960,Max]",Extremamente Elevado,,,,134,Norte,BRAGANÇA,0401,32194.64,4550,325,277,301,274,325,599,900,1177,1502,14.13,4.67,3.66,2.8
20-01-2022,ALIJÓ,398,28,3743,"[960,Max]",Extremamente Elevado,,,,398,Norte,VILA REAL,1701,29759.89,10625,766,687,635,542,666,1208,1843,2530,3296,35.7,11.08,8.5,6.19
20-01-2022,ALJEZUR,145,10,2590,"[960,Max]",Extremamente Elevado,,,,145,Algarve,FARO,0803,32349.95,5594,316,336,335,320,410,730,1065,1401,1717,17.29,5.31,4.33,3.29
20-01-2022,ALJUSTREL,243,17,2948,"[960,Max]",Extremamente Elevado,,,,243,Alentejo,BEJA,0201,45847.41,8247,635,521,443,347,358,705,1148,1669,2304,17.99,5.03,3.64,2.5
20-01-2022,ALMADA,9421,673,5573,"[960,Max]",Extremamente Elevado,,,,9421,Lisboa e Vale do Tejo,SETÚBAL,1503,7000.89,169039,10469,9777,7876,6144,5111,11255,19131,28908,39377,2414.5,562.45,412.91,273.26
20-01-2022,ALMEIDA,200,14,3439,"[960,Max]",Extremamente Elevado,,,,200,Centro,GUARDA,0902,51798.46,5830,441,419,396,458,393,851,1247,1666,2107,11.26,4.07,3.22,2.41
20-01-2022,ALMEIRIM,863,62,3826,"[960,Max]",Extremamente Elevado,,,,863,Lisboa e Vale do Tejo,SANTARÉM,1403,22212.05,22546,1342,1353,1106,866,843,1709,2815,4168,5510,101.5,24.81,18.76,12.67
20-01-2022,ALMODÔVAR,276,20,4099,"[960,Max]",Extremamente Elevado,,,,276,Alentejo,BEJA,0202,77788.03,6725,414,443,396,373,328,701,1097,1540,1954,8.65,2.51,1.98,1.41
20-01-2022,ALPIARÇA,298,21,4223,"[960,Max]",Extremamente Elevado,,,,298,Lisboa e Vale do Tejo,SANTARÉM,1404,9536.33,7059,515,486,363,333,274,607,970,1456,1971,74.02,20.67,15.27,10.17
20-01-2022,ALTER DO CHÃO,67,5,2105,"[960,Max]",Extremamente Elevado,,,,67,Alentejo,PORTALEGRE,1201,36206.62,3165,201,163,136,208,187,395,531,694,895,8.74,2.47,1.92,1.47
20-01-2022,ALVAIÁZERE,143,10,2170,"[960,Max]",Extremamente Elevado,,,,143,Centro,LEIRIA,1002,16047.76,6597,419,389,346,406,539,945,1291,1680,2099,41.11,13.08,10.47,8.04
20-01-2022,ALVITO,31,2,1256,"[960,Max]",Extremamente Elevado,,,,31,Alentejo,BEJA,0203,26485.32,2477,145,110,105,111,89,200,305,415,560,9.35,2.11,1.57,1.15
20-01-2022,AMADORA,8544,610,4641,"[960,Max]",Extremamente Elevado,,,,8544,Lisboa e Vale do Tejo,LISBOA,1115,2378.47,184106,11186,10936,8780,6460,5890,12350,21130,32066,43252,7742.05,1818.84,1348.44,888.56
20-01-2022,AMARANTE,2363,169,4442,"[960,Max]",Extremamente Elevado,,,,2363,Norte,PORTO,1301,30133.15,53193,3086,2413,1812,1643,1311,2954,4766,7179,10265,176.53,34.07,23.82,15.82
20-01-2022,AMARES,1142,82,6302,"[960,Max]",Extremamente Elevado,,,,1142,Norte,BRAGA,0301,8195.41,18129,1001,829,622,489,524,1013,1635,2464,3465,221.22,42.28,30.07,19.95
20-01-2022,ANADIA,1137,81,4173,"[960,Max]",Extremamente Elevado,,,,1137,Centro,AVEIRO,0103,21663.48,27258,1931,1698,1376,1208,1262,2470,3846,5544,7475,125.83,34.51,25.59,17.75
20-01-2022,ANGRA DO HEROÍSMO,973,69,2877,"[960,Max]",Extremamente Elevado,,,,973,Açores,AÇORES,4301,23899.66,33807,2006,1473,1122,768,635,1403,2525,3998,6004,141.45,25.12,16.73,10.56
20-01-2022,ANSIÃO,546,39,4535,"[960,Max]",Extremamente Elevado,,,,546,Centro,LEIRIA,1003,17609.42,12039,727,709,646,694,530,1224,1870,2579,3306,68.37,18.77,14.65,10.62
20-01-2022,ARCOS DE VALDEVEZ,893,64,4268,"[960,Max]",Extremamente Elevado,,,,893,Norte,VIANA DO CASTELO,1601,44759.64,20926,1329,1338,1282,1343,1515,2858,4140,5478,6807,46.75,15.21,12.24,9.25
20-01-2022,ARGANIL,340,24,3084,"[960,Max]",Extremamente Elevado,,,,340,Centro,COIMBRA,0601,33283.93,11014,672,648,612,559,596,1155,1767,2415,3087,33.09,9.27,7.26,5.31
20-01-2022,ARMAMAR,236,17,4094,"[960,Max]",Extremamente Elevado,,,,236,Norte,VISEU,1801,11723.73,5769,357,305,309,285,310,595,904,1209,1566,49.21,13.36,10.31,7.71
20-01-2022,AROUCA,1297,93,6259,"[960,Max]",Extremamente Elevado,,,,1297,Norte,AVEIRO,0104,32910.52,20720,1306,1047,753,683,683,1366,2119,3166,4472,62.96,13.59,9.62,6.44
20-01-2022,ARRAIOLOS,265,19,3829,"[960,Max]",Extremamente Elevado,,,,265,Alentejo,ÉVORA,0702,68374.55,6928,435,384,283,367,480,847,1130,1514,1949,10.13,2.85,2.21,1.65
20-01-2022,ARRONCHES,113,8,4019,"[960,Max]",Extremamente Elevado,,,,113,Alentejo,PORTALEGRE,1202,31464.72,2820,155,142,162,187,179,366,528,670,825,8.96,2.62,2.13,1.68
20-01-2022,ARRUDA DOS VINHOS,633,45,4108,"[960,Max]",Extremamente Elevado,,,,633,Lisboa e Vale do Tejo,LISBOA,1102,7795.93,15412,738,738,562,509,438,947,1509,2247,2985,197.69,38.29,28.82,19.36
20-01-2022,AVEIRO,3686,263,4682,"[960,Max]",Extremamente Elevado,,,,3686,Centro,AVEIRO,0105,19757.57,78734,4520,4004,3050,2250,2103,4353,7403,11407,15927,398.49,80.61,57.73,37.47
20-01-2022,AVIS,47,3,1097,"[960,Max]",Extremamente Elevado,,,,47,Alentejo,PORTALEGRE,1203,60596.51,4247,315,225,206,251,273,524,730,955,1270,7.01,2.1,1.58,1.2
20-01-2022,AZAMBUJA,946,68,4165,"[960,Max]",Extremamente Elevado,,,,946,Lisboa e Vale do Tejo,LISBOA,1103,26265.65,22716,1322,1171,1070,798,618,1416,2486,3657,4979,86.48,18.96,13.92,9.46
20-01-2022,BAIÃO,737,53,3930,"[960,Max]",Extremamente Elevado,,,,737,Norte,PORTO,1302,17452.83,18748,1070,862,714,686,725,1411,2125,2987,4057,107.42,23.25,17.11,12.18
20-01-2022,BARCELOS,7956,568,6848,"[960,Max]",Extremamente Elevado,,,,7956,Norte,BRAGA,0302,37890.14,116187,6721,5325,3619,2991,2562,5553,9172,14497,21218,306.64,56.0,38.26,24.21
20-01-2022,BARRANCOS,29,2,1787,"[960,Max]",Extremamente Elevado,,,,29,Alentejo,BEJA,0204,16841.73,1634,90,65,65,94,61,155,220,285,375,9.7,2.23,1.69,1.31
20-01-2022,BARREIRO,4306,308,5730,"[960,Max]",Extremamente Elevado,,,,4306,Lisboa e Vale do Tejo,SETÚBAL,1504,3639.07,75147,5194,5565,4459,3105,1767,4872,9331,14896,20090,2065.05,552.07,409.34,256.42
20-01-2022,BATALHA,720,51,4509,"[960,Max]",Extremamente Elevado,,,,720,Centro,LEIRIA,1004,10341.6,15963,873,762,649,529,549,1078,1727,2489,3362,154.35,32.51,24.07,16.7
20-01-2022,BEJA,1009,72,3005,"[960,Max]",Extremamente Elevado,,,,1009,Alentejo,BEJA,0205,114647.55,33579,2005,1840,1386,1272,1039,2311,3697,5537,7542,29.29,6.58,4.83,3.22
20-01-2022,BELMONTE,161,12,2522,"[960,Max]",Extremamente Elevado,,,,161,Centro,CASTELO BRANCO,0501,11875.91,6398,444,321,325,310,355,665,990,1311,1755,53.87,14.78,11.04,8.34
20-01-2022,BENAVENTE,1542,110,5038,"[960,Max]",Extremamente Elevado,,,,1542,Lisboa e Vale do Tejo,SANTARÉM,1405,52138.39,30602,1468,1376,1141,876,643,1519,2660,4036,5504,58.69,10.56,7.74,5.1
20-01-2022,BOMBARRAL,465,33,3705,"[960,Max]",Extremamente Elevado,,,,465,Lisboa e Vale do Tejo,LEIRIA,1005,9128.55,12558,875,714,561,491,429,920,1481,2195,3070,137.56,33.63,24.04,16.22
20-01-2022,BORBA,241,17,3584,"[960,Max]",Extremamente Elevado,,,,241,Alentejo,ÉVORA,0703,14518.65,6736,430,375,279,436,392,828,1107,1482,1912,46.39,13.17,10.21,7.62
20-01-2022,BOTICAS,177,13,3532,"[960,Max]",Extremamente Elevado,,,,177,Norte,VILA REAL,1702,32195.66,4998,347,306,311,305,380,685,996,1302,1649,15.52,5.12,4.04,3.09
20-01-2022,BRAGA,12952,925,7090,"[960,Max]",Extremamente Elevado,,,,12952,Norte,BRAGA,0303,18339.95,182679,10029,7963,5241,4320,3671,7991,13232,21195,31224,996.07,170.25,115.57,72.15
20-01-2022,BRAGANÇA,1482,106,4411,"[960,Max]",Extremamente Elevado,,,,1482,Norte,BRAGANÇA,0402,117357.27,33607,2402,1855,1652,1393,1163,2556,4208,6063,8465,28.64,7.21,5.17,3.59
20-01-2022,CABECEIRAS DE BASTO,1506,108,9635,"[960,Max]",Extremamente Elevado,,,,1506,Norte,BRAGA,0304,24182.16,15628,774,594,544,575,574,1149,1693,2287,3061,64.63,12.66,9.46,7.0
20-01-2022,CADAVAL,437,31,3196,"[960,Max]",Extremamente Elevado,,,,437,Lisboa e Vale do Tejo,LISBOA,1104,17489.3,13673,813,796,756,621,625,1246,2002,2798,3611,78.18,20.65,16.0,11.45
20-01-2022,CALDAS DA RAINHA,1868,133,3598,"[960,Max]",Extremamente Elevado,,,,1868,Lisboa e Vale do Tejo,LEIRIA,1006,25569.47,51912,3035,2684,2186,1899,1705,3604,5790,8474,11509,203.03,45.01,33.14,22.64
20-01-2022,CALHETA,774,55,7126,"[960,Max]",Extremamente Elevado,,,,774,Madeira,MADEIRA,3101,11150.43,10867,576,497,507,399,415,814,1321,1818,2394,97.46,21.47,16.3,11.85
20-01-2022,CALHETA (AÇORES),17,1,538,"[480,960]",Muito Elevado,,,,17,Açores,AÇORES,4501,12626.4,3184,215,159,141,139,122,261,402,561,776,25.22,6.15,4.44,3.18
20-01-2022,CÂMARA DE LOBOS,4013,287,11918,,Extremamente Elevado,,,,4013,Madeira,MADEIRA,3102,5216.67,33675,1396,1059,834,545,381,926,1760,2819,4215,645.49,80.79,54.03,33.74
20-01-2022,CAMINHA,519,37,3269,"[960,Max]",Extremamente Elevado,,,,519,Norte,VIANA DO CASTELO,1602,13652.14,15877,1046,944,818,646,656,1302,2120,3064,4110,116.3,30.11,22.44,15.53
20-01-2022,CAMPO MAIOR,223,16,2836,"[960,Max]",Extremamente Elevado,,,,223,Alentejo,PORTALEGRE,1204,24720.16,7874,471,364,351,279,327,606,957,1321,1792,31.85,7.25,5.34,3.87
20-01-2022,CANTANHEDE,872,62,2491,"[960,Max]",Extremamente Elevado,,,,872,Centro,COIMBRA,0602,39088.02,35011,2346,2096,1880,1709,1451,3160,5040,7136,9482,89.57,24.26,18.26,12.89
20-01-2022,CARRAZEDA DE ANSIÃES,86,6,1515,"[960,Max]",Extremamente Elevado,,,,86,Norte,BRAGANÇA,0403,27924.09,5666,424,389,391,312,465,777,1168,1557,1981,20.29,7.09,5.58,4.18
20-01-2022,CARREGAL DO SAL,365,26,3941,"[960,Max]",Extremamente Elevado,,,,365,Centro,VISEU,1802,11689.21,9271,587,562,486,462,376,838,1324,1886,2473,79.31,21.16,16.13,11.33
20-01-2022,CARTAXO,1045,75,4382,"[960,Max]",Extremamente Elevado,,,,1045,Lisboa e Vale do Tejo,SANTARÉM,1406,15817.28,23843,1415,1376,1142,861,632,1493,2635,4011,5426,150.74,34.3,25.36,16.66
20-01-2022,CASCAIS,11001,786,5150,"[960,Max]",Extremamente Elevado,,,,11001,Lisboa e Vale do Tejo,LISBOA,1105,9740.17,213608,12151,11444,8680,6469,5248,11717,20397,31841,43992,2193.1,451.66,326.91,209.41
20-01-2022,CASTANHEIRA DE PÊRA,65,5,2484,"[960,Max]",Extremamente Elevado,,,,65,Centro,LEIRIA,1007,6677.45,2614,233,195,157,190,187,377,534,729,962,39.15,14.41,10.92,8.0
20-01-2022,CASTELO BRANCO,2489,178,4788,"[960,Max]",Extremamente Elevado,,,,2489,Centro,CASTELO BRANCO,0502,143819.15,51987,3528,3042,2499,2229,2225,4454,6953,9995,13523,36.15,9.4,6.95,4.83
20-01-2022,CASTELO DE PAIVA,879,63,5685,"[960,Max]",Extremamente Elevado,,,,879,Norte,AVEIRO,0106,11500.53,15454,881,697,545,420,431,851,1396,2093,2974,134.37,25.86,18.2,12.14
20-01-2022,CASTELO DE VIDE,160,11,5469,"[960,Max]",Extremamente Elevado,,,,160,Alentejo,PORTALEGRE,1205,26491.24,2919,204,173,179,147,170,317,496,669,873,11.02,3.3,2.53,1.87
20-01-2022,CASTRO DAIRE,768,55,5559,"[960,Max]",Extremamente Elevado,,,,768,Centro,VISEU,1803,37904.13,13823,942,857,765,732,773,1505,2270,3127,4069,36.47,10.74,8.25,5.99
20-01-2022,CASTRO MARIM,162,12,2598,"[960,Max]",Extremamente Elevado,,,,162,Algarve,FARO,0804,30084.37,6237,370,345,334,322,344,666,1000,1345,1715,20.73,5.7,4.47,3.32
20-01-2022,CASTRO VERDE,190,14,2729,"[960,Max]",Extremamente Elevado,,,,190,Alentejo,BEJA,0206,56944.23,6949,437,347,303,275,227,502,805,1152,1589,12.2,2.79,2.02,1.41
20-01-2022,CELORICO DA BEIRA,310,22,4471,"[960,Max]",Extremamente Elevado,,,,310,Centro,GUARDA,0903,24721.63,6928,430,416,363,369,535,904,1267,1683,2113,28.02,8.55,6.81,5.12
20-01-2022,CELORICO DE BASTO,907,65,4766,"[960,Max]",Extremamente Elevado,,,,907,Norte,BRAGA,0305,18107.02,19040,1001,802,668,728,729,1457,2125,2927,3928,105.15,21.69,16.17,11.74
20-01-2022,CHAMUSCA,387,28,4213,"[960,Max]",Extremamente Elevado,,,,387,Lisboa e Vale do Tejo,SANTARÉM,1407,74600.54,9197,629,583,553,465,579,1044,1597,2180,2809,12.33,3.77,2.92,2.14
20-01-2022,CHAVES,1616,115,4107,"[960,Max]",Extremamente Elevado,,,,1616,Norte,VILA REAL,1703,59122.95,39343,2676,2429,1991,1886,1918,3804,5795,8224,10900,66.54,18.44,13.91,9.8
20-01-2022,CINFÃES,921,66,5050,"[960,Max]",Extremamente Elevado,,,,921,Norte,VISEU,1804,23928.76,18244,1067,902,779,734,758,1492,2271,3173,4240,76.24,17.72,13.26,9.49
20-01-2022,COIMBRA,3914,280,2917,"[960,Max]",Extremamente Elevado,,,,3914,Centro,COIMBRA,0603,31939.94,134166,9489,8734,6353,5139,5074,10213,16566,25300,34789,420.06,108.92,79.21,51.87
20-01-2022,CONDEIXA-A-NOVA,494,35,2783,"[960,Max]",Extremamente Elevado,,,,494,Centro,COIMBRA,0604,13867.47,17733,871,809,717,583,490,1073,1790,2599,3470,127.88,25.02,18.74,12.91
20-01-2022,CONSTÂNCIA,174,12,4320,"[960,Max]",Extremamente Elevado,,,,174,Lisboa e Vale do Tejo,SANTARÉM,1408,8036.58,4030,211,183,187,148,155,303,490,673,884,50.14,11.0,8.37,6.1
20-01-2022,CORUCHE,528,38,3020,"[960,Max]",Extremamente Elevado,,,,528,Lisboa e Vale do Tejo,SANTARÉM,1409,111572.03,17471,1294,1090,1095,1096,1019,2115,3210,4300,5594,15.66,5.01,3.85,2.88
20-01-2022,CORVO,2,0,426,"[240,480]",Elevado,,,,2,Açores,AÇORES,4901,1711.45,464,22,21,11,13,19,32,43,64,86,27.12,5.03,3.74,2.51
20-01-2022,COVILHÃ,1633,117,3491,"[960,Max]",Extremamente Elevado,,,,1633,Centro,CASTELO BRANCO,0503,55560.06,46787,3533,2998,2365,2111,2193,4304,6669,9667,13200,84.21,23.76,17.4,12.0
20-01-2022,CRATO,88,6,2812,"[960,Max]",Extremamente Elevado,,,,88,Alentejo,PORTALEGRE,1206,39806.88,3129,229,258,163,182,228,410,573,831,1060,7.86,2.66,2.09,1.44
20-01-2022,CUBA,75,5,1627,"[960,Max]",Extremamente Elevado,,,,75,Alentejo,BEJA,0207,17208.72,4595,255,233,206,190,143,333,539,772,1027,26.7,5.97,4.49,3.13
20-01-2022,ELVAS,1068,76,5205,"[960,Max]",Extremamente Elevado,,,,1068,Alentejo,PORTALEGRE,1207,63128.86,20528,1057,1145,902,852,810,1662,2564,3709,4766,32.52,7.55,5.88,4.06
20-01-2022,ENTRONCAMENTO,865,62,4014,"[960,Max]",Extremamente Elevado,,,,865,Lisboa e Vale do Tejo,SANTARÉM,1410,1372.81,21558,1066,930,868,695,592,1287,2155,3085,4151,1570.14,302.33,224.69,156.96
20-01-2022,ESPINHO,1626,116,5509,"[960,Max]",Extremamente Elevado,,,,1626,Norte,AVEIRO,0107,2105.68,29516,2205,1993,1430,1177,960,2137,3567,5560,7765,1401.52,368.71,264.01,169.37
20-01-2022,ESPOSENDE,2185,156,6394,"[960,Max]",Extremamente Elevado,,,,2185,Norte,BRAGA,0306,9540.98,34177,1831,1522,1095,894,723,1617,2712,4234,6065,358.21,63.57,44.38,28.42
20-01-2022,ESTARREJA,1107,79,4257,"[960,Max]",Extremamente Elevado,,,,1107,Centro,AVEIRO,0108,10817.33,26006,1503,1399,1106,953,728,1681,2787,4186,5689,240.42,52.59,38.7,25.76
20-01-2022,ESTREMOZ,313,22,2460,"[960,Max]",Extremamente Elevado,,,,313,Alentejo,ÉVORA,0704,51379.95,12728,789,613,697,786,877,1663,2360,2973,3762,24.77,7.32,5.79,4.59
20-01-2022,ÉVORA,2088,149,3982,"[960,Max]",Extremamente Elevado,,,,2088,Alentejo,ÉVORA,0705,130707.58,52428,3569,2852,2176,1966,1803,3769,5945,8797,12366,40.11,9.46,6.73,4.55
20-01-2022,FAFE,3571,255,7430,"[960,Max]",Extremamente Elevado,,,,3571,Norte,BRAGA,0307,21908.11,48060,3044,2455,1679,1403,1208,2611,4290,6745,9789,219.37,44.68,30.79,19.58
20-01-2022,FARO,2415,172,3958,"[960,Max]",Extremamente Elevado,,,,2415,Algarve,FARO,0805,20256.79,61015,3847,3364,2604,2055,1601,3656,6260,9624,13471,301.2,66.5,47.51,30.9
20-01-2022,FELGUEIRAS,3681,263,6524,"[960,Max]",Extremamente Elevado,,,,3681,Norte,PORTO,1303,11573.75,56422,2951,2302,1601,1316,973,2289,3890,6192,9143,487.49,79.0,53.5,33.61
20-01-2022,FERREIRA DO ALENTEJO,172,12,2190,"[960,Max]",Extremamente Elevado,,,,172,Alentejo,BEJA,0208,64820.68,7845,515,414,372,343,345,688,1060,1474,1989,12.1,3.07,2.27,1.64
20-01-2022,FERREIRA DO ZÊZERE,357,26,4489,"[960,Max]",Extremamente Elevado,,,,357,Lisboa e Vale do Tejo,SANTARÉM,1411,19038.03,7959,470,370,416,465,456,921,1337,1707,2177,41.81,11.44,8.97,7.02
20-01-2022,FIGUEIRA DA FOZ,1474,105,2509,"[960,Max]",Extremamente Elevado,,,,1474,Centro,COIMBRA,0605,37905.26,58747,4032,3597,2887,2495,2043,4538,7425,11022,15054,154.98,39.72,29.08,19.59
20-01-2022,FIGUEIRA DE CASTELO RODRIGO,111,8,1987,"[960,Max]",Extremamente Elevado,,,,111,Centro,GUARDA,0904,50857.46,5584,347,352,290,352,391,743,1033,1385,1732,10.98,3.41,2.72,2.03
20-01-2022,FIGUEIRÓ DOS VINHOS,271,19,4870,"[960,Max]",Extremamente Elevado,,,,271,Centro,LEIRIA,1008,17344.0,5568,402,386,322,309,351,660,982,1368,1770,32.1,10.21,7.89,5.66
20-01-2022,FORNOS DE ALGODRES,68,5,1498,"[960,Max]",Extremamente Elevado,,,,68,Centro,GUARDA,0905,13145.05,4528,261,218,247,256,232,488,735,953,1214,34.45,9.24,7.25,5.59
20-01-2022,FREIXO DE ESPADA À CINTA,125,9,3797,"[960,Max]",Extremamente Elevado,,,,125,Norte,BRAGANÇA,0404,24414.29,3298,211,177,231,196,189,385,616,793,1004,13.51,4.11,3.25,2.52
20-01-2022,FRONTEIRA,83,6,2796,"[960,Max]",Extremamente Elevado,,,,83,Alentejo,PORTALEGRE,1208,24859.58,2974,213,182,149,156,168,324,473,655,868,11.96,3.49,2.63,1.9
20-01-2022,FUNCHAL,10616,758,10205,,Extremamente Elevado,,,,10616,Madeira,MADEIRA,3103,7616.2,104024,6382,5086,3643,2821,1990,4811,8454,13540,19922,1365.86,261.58,177.78,111.0
20-01-2022,FUNDÃO,1069,76,4036,"[960,Max]",Extremamente Elevado,,,,1069,Centro,CASTELO BRANCO,0504,70019.79,26495,1781,1464,1432,1357,1643,3000,4432,5896,7677,37.84,10.96,8.42,6.33
20-01-2022,GAVIÃO,59,4,1822,"[960,Max]",Extremamente Elevado,,,,59,Alentejo,PORTALEGRE,1209,29459.45,3263,189,186,222,263,293,556,778,964,1153,11.08,3.91,3.27,2.64
20-01-2022,GÓIS,80,6,2094,"[960,Max]",Extremamente Elevado,,,,80,Centro,COIMBRA,0606,26330.19,3805,235,199,240,233,244,477,717,916,1151,14.45,4.37,3.48,2.72
20-01-2022,GOLEGÃ,219,16,4103,"[960,Max]",Extremamente Elevado,,,,219,Lisboa e Vale do Tejo,SANTARÉM,1412,8431.67,5339,356,299,281,243,255,498,779,1078,1434,63.32,17.01,12.78,9.24
20-01-2022,GONDOMAR,9259,661,5578,"[960,Max]",Extremamente Elevado,,,,9259,Norte,PORTO,1304,13191.76,165985,10555,8755,6222,4450,3364,7814,14036,22791,33346,1258.22,252.77,172.76,106.4
20-01-2022,GOUVEIA,224,16,1812,"[960,Max]",Extremamente Elevado,,,,224,Centro,GUARDA,0906,30061.17,12387,871,931,780,783,810,1593,2373,3304,4175,41.21,13.89,10.99,7.89
20-01-2022,GRÂNDOLA,447,32,3054,"[960,Max]",Extremamente Elevado,,,,447,Alentejo,SETÚBAL,1505,82593.66,14639,834,834,708,688,672,1360,2068,2902,3736,17.72,4.52,3.51,2.5
20-01-2022,GUARDA,1462,104,3751,"[960,Max]",Extremamente Elevado,,,,1462,Centro,GUARDA,0907,71209.58,38969,2477,2041,1686,1415,1474,2889,4575,6616,9093,54.72,12.77,9.29,6.42
20-01-2022,GUIMARÃES,11345,810,7449,"[960,Max]",Extremamente Elevado,,,,11345,Norte,BRAGA,0308,24099.96,152309,9394,7074,4809,3877,2948,6825,11634,18708,28102,631.99,116.61,77.63,48.27
20-01-2022,HORTA,253,18,1745,"[960,Max]",Extremamente Elevado,,,,253,Açores,AÇORES,4701,17305.53,14521,818,658,468,352,302,654,1122,1780,2598,83.91,15.01,10.29,6.48
20-01-2022,IDANHA-A-NOVA,290,21,3608,"[960,Max]",Extremamente Elevado,,,,290,Centro,CASTELO BRANCO,0505,141633.51,8043,518,490,519,672,974,1646,2165,2655,3173,5.68,2.24,1.87,1.53
20-01-2022,ÍLHAVO,1637,117,4231,"[960,Max]",Extremamente Elevado,,,,1637,Centro,AVEIRO,0110,7347.55,38699,2227,1943,1444,1193,850,2043,3487,5430,7657,526.66,104.21,73.9,47.46
20-01-2022,LAGOA (FARO),784,56,3443,"[960,Max]",Extremamente Elevado,,,,784,Algarve,FARO,0806,8825.45,22762,1314,1168,919,749,670,1419,2338,3506,4820,257.93,54.62,39.73,26.49
20-01-2022,LAGOA,374,27,2542,"[960,Max]",Extremamente Elevado,,,,374,Açores,AÇORES,4201,4559.32,14721,536,458,349,238,235,473,822,1280,1816,322.9,39.83,28.08,18.03
20-01-2022,LAGOS,1366,98,4496,"[960,Max]",Extremamente Elevado,,,,1366,Algarve,FARO,0807,21299.27,30374,1744,1434,1247,1053,1029,2082,3329,4763,6507,142.61,30.55,22.36,15.63
20-01-2022,LAJES DAS FLORES,16,1,1094,"[960,Max]",Extremamente Elevado,,,,16,Açores,AÇORES,4801,7004.79,1463,88,53,62,46,54,100,162,215,303,20.89,4.33,3.07,2.31
20-01-2022,LAJES DO PICO,236,17,5254,"[960,Max]",Extremamente Elevado,,,,236,Açores,AÇORES,4601,15531.09,4490,304,231,223,159,162,321,544,775,1079,28.91,6.95,4.99,3.5
20-01-2022,LAMEGO,1169,83,4694,"[960,Max]",Extremamente Elevado,,,,1169,Norte,VISEU,1805,16542.11,24895,1639,1284,1124,898,783,1681,2805,4089,5728,150.5,34.63,24.72,16.96
20-01-2022,LEIRIA,4779,341,3815,"[960,Max]",Extremamente Elevado,,,,4779,Centro,LEIRIA,1009,56508.83,125267,7389,6366,5090,3902,3159,7061,12151,18517,25906,221.68,45.84,32.77,21.5
20-01-2022,LISBOA,29664,2119,5822,"[960,Max]",Extremamente Elevado,,,,29664,Lisboa e Vale do Tejo,LISBOA,1106,10005.43,509515,33197,33340,27706,23037,26770,49807,77513,110853,144050,5092.6,1439.78,1107.98,774.74
20-01-2022,LOULÉ,2426,173,3531,"[960,Max]",Extremamente Elevado,,,,2426,Algarve,FARO,0808,76366.91,68697,3890,3350,2780,2358,2251,4609,7389,10739,14629,89.96,19.16,14.06,9.68
20-01-2022,LOURES,10543,753,4934,"[960,Max]",Extremamente Elevado,,,,10543,Lisboa e Vale do Tejo,LISBOA,1107,16723.99,213687,12746,12794,9644,6669,5033,11702,21346,34140,46886,1277.73,280.35,204.14,127.64
20-01-2022,LOURINHÃ,1022,73,3953,"[960,Max]",Extremamente Elevado,,,,1022,Lisboa e Vale do Tejo,LISBOA,1108,14717.2,25855,1584,1243,992,842,645,1487,2479,3722,5306,175.68,36.05,25.29,16.84
20-01-2022,LOUSÃ,603,43,3514,"[960,Max]",Extremamente Elevado,,,,603,Centro,COIMBRA,0607,13840.01,17158,946,866,658,528,450,978,1636,2502,3448,123.97,24.91,18.08,11.82
20-01-2022,LOUSADA,3458,247,7396,"[960,Max]",Extremamente Elevado,,,,3458,Norte,PORTO,1305,9608.01,46755,2289,1698,1176,853,621,1474,2650,4348,6637,486.63,69.08,45.25,27.58
20-01-2022,MAÇÃO,183,13,2923,"[960,Max]",Extremamente Elevado,,,,183,Lisboa e Vale do Tejo,SANTARÉM,1413,39997.98,6267,386,362,390,440,657,1097,1487,1849,2235,15.67,5.59,4.62,3.72
20-01-2022,MACEDO DE CAVALEIROS,521,37,3586,"[960,Max]",Extremamente Elevado,,,,521,Norte,BRAGANÇA,0405,69914.08,14516,1082,889,878,823,938,1761,2639,3528,4610,20.76,6.59,5.05,3.77
20-01-2022,MACHICO,1479,106,7403,"[960,Max]",Extremamente Elevado,,,,1479,Madeira,MADEIRA,3104,6825.1,19981,1197,860,662,455,331,786,1448,2308,3505,292.76,51.36,33.82,21.22
20-01-2022,MADALENA,172,12,2923,"[960,Max]",Extremamente Elevado,,,,172,Açores,AÇORES,4602,14712.33,5895,334,256,173,190,179,369,542,798,1132,40.07,7.69,5.42,3.68
20-01-2022,MAFRA,3914,280,4615,"[960,Max]",Extremamente Elevado,,,,3914,Lisboa e Vale do Tejo,LISBOA,1109,29165.5,84816,3613,3334,2839,2089,1899,3988,6827,10161,13774,290.81,47.23,34.84,23.41
20-01-2022,MAIA,7367,526,5301,"[960,Max]",Extremamente Elevado,,,,7367,Norte,PORTO,1306,8293.94,138971,7801,6617,4512,3339,2631,5970,10482,17099,24900,1675.56,300.22,206.16,126.38
20-01-2022,MANGUALDE,686,49,3706,"[960,Max]",Extremamente Elevado,,,,686,Centro,VISEU,1806,21925.56,18510,1198,1128,885,852,743,1595,2480,3608,4806,84.42,21.92,16.46,11.31
20-01-2022,MANTEIGAS,78,6,2579,"[960,Max]",Extremamente Elevado,,,,78,Centro,GUARDA,0908,12197.55,3007,258,197,159,167,146,313,472,669,927,24.65,7.6,5.48,3.87
20-01-2022,MARCO DE CANAVESES,3180,227,6175,"[960,Max]",Extremamente Elevado,,,,3180,Norte,PORTO,1307,20188.98,51496,2678,2060,1488,1265,1023,2288,3776,5836,8514,255.07,42.17,28.91,18.7
20-01-2022,MARINHA GRANDE,1330,95,3455,"[960,Max]",Extremamente Elevado,,,,1330,Centro,LEIRIA,1010,18725.19,38508,2365,2302,1638,1359,1058,2417,4055,6357,8722,205.65,46.58,33.95,21.66
20-01-2022,MARVÃO,80,6,2655,"[960,Max]",Extremamente Elevado,,,,80,Alentejo,PORTALEGRE,1210,15489.9,3005,198,185,142,197,237,434,576,761,959,19.4,6.19,4.91,3.72
20-01-2022,MATOSINHOS,8952,639,5105,"[960,Max]",Extremamente Elevado,,,,8952,Norte,PORTO,1308,6241.97,175357,11850,9977,7023,5024,3884,8908,15931,25908,37758,2809.31,604.9,415.06,255.22
20-01-2022,MEALHADA,575,41,2888,"[960,Max]",Extremamente Elevado,,,,575,Centro,AVEIRO,0111,11065.66,19914,1163,1039,810,828,831,1659,2469,3508,4671,179.96,42.21,31.7,22.31
20-01-2022,MÊDA,161,12,3519,"[960,Max]",Extremamente Elevado,,,,161,Centro,GUARDA,0909,28604.92,4587,343,306,290,288,443,731,1021,1327,1670,16.04,5.84,4.64,3.57
20-01-2022,MELGAÇO,156,11,1927,"[960,Max]",Extremamente Elevado,,,,156,Norte,VIANA DO CASTELO,1603,23824.58,8093,507,567,578,614,675,1289,1867,2434,2941,33.97,12.34,10.22,7.84
20-01-2022,MÉRTOLA,207,15,3372,"[960,Max]",Extremamente Elevado,,,,207,Alentejo,BEJA,0209,129287.34,6142,400,390,378,423,600,1023,1401,1791,2191,4.75,1.69,1.39,1.08
20-01-2022,MESÃO FRIO,149,11,3757,"[960,Max]",Extremamente Elevado,,,,149,Norte,VILA REAL,1704,2664.87,3964,265,205,168,157,120,277,445,650,915,148.74,34.33,24.39,16.7
20-01-2022,MIRA,384,27,3242,"[960,Max]",Extremamente Elevado,,,,384,Centro,COIMBRA,0608,12403.38,11832,727,729,659,550,466,1016,1675,2404,3131,95.4,25.24,19.38,13.5
20-01-2022,MIRANDA DO CORVO,347,25,2729,"[960,Max]",Extremamente Elevado,,,,347,Centro,COIMBRA,0609,12637.79,12708,706,659,568,498,404,902,1470,2129,2835,100.55,22.43,16.85,11.63
20-01-2022,MIRANDA DO DOURO,201,14,2942,"[960,Max]",Extremamente Elevado,,,,201,Norte,BRAGANÇA,0406,48718.31,6830,482,429,442,463,470,933,1375,1804,2286,14.02,4.69,3.7,2.82
20-01-2022,MIRANDELA,811,58,3729,"[960,Max]",Extremamente Elevado,,,,811,Norte,BRAGANÇA,0407,65895.67,21754,1640,1315,1204,1078,947,2025,3229,4544,6184,33.01,9.38,6.9,4.9
20-01-2022,MOGADOURO,252,18,3005,"[960,Max]",Extremamente Elevado,,,,252,Norte,BRAGANÇA,0408,76064.93,8392,589,529,576,630,655,1285,1861,2390,2979,11.03,3.92,3.14,2.45
20-01-2022,MOIMENTA DA BEIRA,315,22,3233,"[960,Max]",Extremamente Elevado,,,,315,Norte,VISEU,1807,21996.9,9736,576,514,471,416,461,877,1348,1862,2438,44.26,11.08,8.46,6.13
20-01-2022,MOITA,3559,254,5526,"[960,Max]",Extremamente Elevado,,,,3559,Lisboa e Vale do Tejo,SETÚBAL,1506,5525.98,64407,4226,3646,2623,1801,1425,3226,5849,9495,13721,1165.53,248.3,171.82,105.85
20-01-2022,MONÇÃO,770,55,4310,"[960,Max]",Extremamente Elevado,,,,770,Norte,VIANA DO CASTELO,1604,21130.85,17869,1161,1105,1031,1006,972,1978,3009,4114,5275,84.56,24.96,19.47,14.24
20-01-2022,MONCHIQUE,76,5,1506,"[960,Max]",Extremamente Elevado,,,,76,Algarve,FARO,0809,39530.43,5077,353,384,321,355,392,747,1068,1452,1805,12.84,4.57,3.67,2.7
20-01-2022,MONDIM DE BASTO,338,24,4869,"[960,Max]",Extremamente Elevado,,,,338,Norte,VILA REAL,1705,17207.52,6946,395,300,314,284,283,567,881,1181,1576,40.36,9.16,6.86,5.12
20-01-2022,MONFORTE,126,9,4240,"[960,Max]",Extremamente Elevado,,,,126,Alentejo,PORTALEGRE,1211,42024.82,2975,139,115,117,192,168,360,477,592,731,7.08,1.74,1.41,1.14
20-01-2022,MONTALEGRE,385,27,4278,"[960,Max]",Extremamente Elevado,,,,385,Norte,VILA REAL,1706,80545.71,8997,699,628,595,603,730,1333,1928,2556,3255,11.17,4.04,3.17,2.39
20-01-2022,MONTEMOR-O-NOVO,503,36,3212,"[960,Max]",Extremamente Elevado,,,,503,Alentejo,ÉVORA,0706,123296.65,15647,991,953,868,878,971,1849,2717,3670,4661,12.69,3.78,2.98,2.2
20-01-2022,MONTEMOR-O-VELHO,782,56,3100,"[960,Max]",Extremamente Elevado,,,,782,Centro,COIMBRA,0610,22896.23,25224,1496,1397,1217,1057,988,2045,3262,4659,6155,110.17,26.88,20.35,14.25
20-01-2022,MONTIJO,2364,169,4104,"[960,Max]",Extremamente Elevado,,,,2364,Lisboa e Vale do Tejo,SETÚBAL,1507,34861.64,57614,2771,2441,1990,1554,1109,2663,4653,7094,9865,165.26,28.3,20.35,13.35
20-01-2022,MORA,52,4,1264,"[960,Max]",Extremamente Elevado,,,,52,Alentejo,ÉVORA,0707,44395.02,4138,336,275,252,238,257,495,747,1022,1358,9.32,3.06,2.3,1.68
20-01-2022,MORTÁGUA,215,15,2439,"[960,Max]",Extremamente Elevado,,,,215,Centro,VISEU,1808,25117.82,8803,638,584,535,499,460,959,1494,2078,2716,35.05,10.81,8.27,5.95
20-01-2022,MOURA,529,38,3859,"[960,Max]",Extremamente Elevado,,,,529,Alentejo,BEJA,0210,95845.55,13718,817,656,665,542,461,1003,1668,2324,3141,14.31,3.28,2.42,1.74
20-01-2022,MOURÃO,19,1,781,"[480,960]",Muito Elevado,,,,19,Alentejo,ÉVORA,0708,27862.98,2450,139,108,80,104,109,213,293,401,540,8.79,1.94,1.44,1.05
20-01-2022,MURÇA,199,14,3649,"[960,Max]",Extremamente Elevado,,,,199,Norte,VILA REAL,1707,18937.11,5463,384,341,307,306,319,625,932,1273,1657,28.85,8.75,6.72,4.92
20-01-2022,MURTOSA,383,27,3729,"[960,Max]",Extremamente Elevado,,,,383,Centro,AVEIRO,0112,7308.78,10279,509,473,403,353,409,762,1165,1638,2147,140.63,29.37,22.41,15.94
20-01-2022,NAZARÉ,729,52,5147,"[960,Max]",Extremamente Elevado,,,,729,Lisboa e Vale do Tejo,LEIRIA,1011,8243.43,14165,967,903,670,420,396,816,1486,2389,3356,171.84,40.71,28.98,18.03
20-01-2022,NELAS,339,24,2611,"[960,Max]",Extremamente Elevado,,,,339,Centro,VISEU,1809,12571.48,12974,924,787,668,604,583,1187,1855,2642,3566,103.21,28.37,21.02,14.76
20-01-2022,NISA,379,27,6259,"[960,Max]",Extremamente Elevado,,,,379,Alentejo,PORTALEGRE,1212,57567.84,6061,405,389,355,483,478,961,1316,1705,2110,10.53,3.67,2.96,2.29
20-01-2022,NORDESTE,169,12,3486,"[960,Max]",Extremamente Elevado,,,,169,Açores,AÇORES,4202,10146.8,4862,246,180,124,161,162,323,447,627,873,47.92,8.6,6.18,4.41
20-01-2022,ÓBIDOS,468,33,3951,"[960,Max]",Extremamente Elevado,,,,468,Lisboa e Vale do Tejo,LEIRIA,1012,14155.44,11850,743,650,574,452,436,888,1462,2112,2855,83.72,20.17,14.92,10.33
20-01-2022,ODEMIRA,518,37,2095,"[960,Max]",Extremamente Elevado,,,,518,Alentejo,BEJA,0211,172060.15,24717,1475,1317,1225,1397,1349,2746,3971,5288,6763,14.37,3.93,3.07,2.31
20-01-2022,ODIVELAS,7877,563,4869,"[960,Max]",Extremamente Elevado,,,,7877,Lisboa e Vale do Tejo,LISBOA,1116,2654.36,161774,9562,9038,6952,4641,3812,8453,15405,24443,34005,6095.48,1281.27,920.99,580.44
20-01-2022,OEIRAS,8766,626,4941,"[960,Max]",Extremamente Elevado,,,,8766,Lisboa e Vale do Tejo,LISBOA,1110,4588.31,177408,11580,11575,8566,6211,5855,12066,20632,32207,43787,3866.78,954.38,701.98,449.69
20-01-2022,OLEIROS,99,7,1976,"[960,Max]",Extremamente Elevado,,,,99,Centro,CASTELO BRANCO,0506,47109.31,5003,384,341,366,397,487,884,1250,1591,1975,10.62,4.19,3.38,2.65
20-01-2022,OLHÃO,1467,105,3303,"[960,Max]",Extremamente Elevado,,,,1467,Algarve,FARO,0810,13086.38,44405,2455,2309,1689,1342,1268,2610,4299,6608,9063,339.33,69.26,50.5,32.85
20-01-2022,OLIVEIRA DE AZEMÉIS,3668,262,5557,"[960,Max]",Extremamente Elevado,,,,3668,Norte,AVEIRO,0113,16110.41,66011,4155,3614,2794,2183,1738,3921,6715,10329,14484,409.75,89.91,64.12,41.68
20-01-2022,OLIVEIRA DE FRADES,408,29,4106,"[960,Max]",Extremamente Elevado,,,,408,Centro,VISEU,1810,14534.62,9936,553,475,438,359,415,774,1212,1687,2240,68.36,15.41,11.61,8.34
20-01-2022,OLIVEIRA DO BAIRRO,1047,75,4313,"[960,Max]",Extremamente Elevado,,,,1047,Centro,AVEIRO,0114,8731.99,24277,1327,1182,999,786,810,1596,2595,3777,5104,278.02,58.45,43.25,29.72
20-01-2022,OLIVEIRA DO HOSPITAL,432,31,2244,"[960,Max]",Extremamente Elevado,,,,432,Centro,COIMBRA,0611,23451.66,19253,1161,1097,962,924,960,1884,2846,3943,5104,82.1,21.76,16.81,12.14
20-01-2022,OURÉM,1976,141,4487,"[960,Max]",Extremamente Elevado,,,,1976,Lisboa e Vale do Tejo,SANTARÉM,1421,41668.03,44044,2463,2069,1899,1817,1603,3420,5319,7388,9851,105.7,23.64,17.73,12.77
20-01-2022,OURIQUE,89,6,1936,"[960,Max]",Extremamente Elevado,,,,89,Alentejo,BEJA,0212,66331.36,4607,313,287,284,268,227,495,779,1066,1379,6.95,2.08,1.61,1.17
20-01-2022,OVAR,2610,186,4810,"[960,Max]",Extremamente Elevado,,,,2610,Centro,AVEIRO,0115,14770.25,54260,3294,2709,1994,1636,1234,2870,4864,7573,10867,367.37,73.57,51.27,32.93
20-01-2022,PAÇOS DE FERREIRA,3476,248,6128,"[960,Max]",Extremamente Elevado,,,,3476,Norte,PORTO,1309,7099.29,56728,2903,2193,1518,1135,664,1799,3317,5510,8413,799.1,118.51,77.62,46.72
20-01-2022,PALMELA,2811,201,4374,"[960,Max]",Extremamente Elevado,,,,2811,Lisboa e Vale do Tejo,SETÚBAL,1508,46512.01,64269,3402,3244,2635,1846,1391,3237,5872,9116,12518,138.18,26.91,19.6,12.62
20-01-2022,PAMPILHOSA DA SERRA,51,4,1265,"[960,Max]",Extremamente Elevado,,,,51,Centro,COIMBRA,0612,39646.24,4037,238,254,295,339,423,762,1057,1311,1549,10.18,3.91,3.31,2.67
20-01-2022,PAREDES,5714,408,6639,"[960,Max]",Extremamente Elevado,,,,5714,Norte,PORTO,1310,15675.69,86067,4272,3532,2412,1717,1258,2975,5387,8919,13191,549.04,84.15,56.9,34.36
20-01-2022,PAREDES DE COURA,501,36,5866,"[960,Max]",Extremamente Elevado,,,,501,Norte,VIANA DO CASTELO,1605,13818.59,8535,466,528,407,465,515,980,1387,1915,2381,61.76,17.23,13.86,10.04
20-01-2022,PEDRÓGÃO GRANDE,149,11,4363,"[960,Max]",Extremamente Elevado,,,,149,Centro,LEIRIA,1013,12874.75,3410,175,173,196,221,252,473,669,842,1017,26.49,7.9,6.54,5.2
20-01-2022,PENACOVA,268,19,1957,"[960,Max]",Extremamente Elevado,,,,268,Centro,COIMBRA,0613,21673.23,13694,968,923,745,621,703,1324,2069,2992,3960,63.18,18.27,13.81,9.55
20-01-2022,PENAFIEL,4262,304,6108,"[960,Max]",Extremamente Elevado,,,,4262,Norte,PORTO,1311,21224.27,69772,3648,2823,2032,1663,1230,2893,4925,7748,11396,328.74,53.69,36.51,23.2
20-01-2022,PENALVA DO CASTELO,232,17,3261,"[960,Max]",Extremamente Elevado,,,,232,Centro,VISEU,1811,13433.92,7115,449,457,413,391,426,817,1230,1687,2136,52.96,15.9,12.56,9.16
20-01-2022,PENAMACOR,46,3,974,"[960,Max]",Extremamente Elevado,,,,46,Centro,CASTELO BRANCO,0507,56370.69,4755,262,248,273,451,633,1084,1357,1605,1867,8.44,3.31,2.85,2.41
20-01-2022,PENEDONO,114,8,4393,"[960,Max]",Extremamente Elevado,,,,114,Norte,VISEU,1812,13370.75,2591,172,113,129,156,138,294,423,536,708,19.38,5.3,4.01,3.16
20-01-2022,PENELA,188,13,3490,"[960,Max]",Extremamente Elevado,,,,188,Centro,COIMBRA,0614,13480.0,5397,314,324,274,359,344,703,977,1301,1615,40.04,11.98,9.65,7.25
20-01-2022,PENICHE,1151,82,4343,"[960,Max]",Extremamente Elevado,,,,1151,Lisboa e Vale do Tejo,LEIRIA,1014,7754.98,26501,1746,1504,1203,926,707,1633,2836,4340,6086,341.73,78.48,55.96,36.57
20-01-2022,PESO DA RÉGUA,781,56,4953,"[960,Max]",Extremamente Elevado,,,,781,Norte,VILA REAL,1708,9486.01,15773,1076,843,650,659,455,1114,1764,2607,3683,166.28,38.83,27.48,18.6
20-01-2022,PINHEL,213,15,2503,"[960,Max]",Extremamente Elevado,,,,213,Centro,GUARDA,0910,48452.12,8511,577,566,551,538,689,1227,1778,2344,2921,17.57,6.03,4.84,3.67
20-01-2022,POMBAL,1795,128,3488,"[960,Max]",Extremamente Elevado,,,,1795,Centro,LEIRIA,1015,62600.28,51461,3187,2791,2494,2328,2027,4355,6849,9640,12827,82.21,20.49,15.4,10.94
20-01-2022,PONTA DELGADA,1637,117,2409,"[960,Max]",Extremamente Elevado,,,,1637,Açores,AÇORES,4203,23298.65,67935,3108,2435,1726,1133,902,2035,3761,6196,9304,291.58,39.93,26.59,16.14
20-01-2022,PONTA DO SOL,619,44,7201,"[960,Max]",Extremamente Elevado,,,,619,Madeira,MADEIRA,3105,4622.03,8593,319,283,347,208,221,429,776,1059,1378,185.92,29.81,22.91,16.79
20-01-2022,PONTE DA BARCA,432,31,3866,"[960,Max]",Extremamente Elevado,,,,432,Norte,VIANA DO CASTELO,1606,18211.37,11180,635,576,517,554,490,1044,1561,2137,2772,61.39,15.22,11.73,8.57
20-01-2022,PONTE DE LIMA,2111,151,5110,"[960,Max]",Extremamente Elevado,,,,2111,Norte,VIANA DO CASTELO,1607,32025.46,41315,2321,2022,1720,1596,1462,3058,4778,6800,9121,129.01,28.48,21.23,14.92
20-01-2022,PONTE DE SOR,557,40,3712,"[960,Max]",Extremamente Elevado,,,,557,Alentejo,PORTALEGRE,1213,83971.16,14994,939,800,716,739,831,1570,2286,3086,4025,17.86,4.79,3.68,2.72
20-01-2022,PORTALEGRE,958,68,4321,"[960,Max]",Extremamente Elevado,,,,958,Alentejo,PORTALEGRE,1214,44713.64,22172,1577,1351,1137,993,984,1977,3114,4465,6042,49.59,13.51,9.99,6.96
20-01-2022,PORTEL,134,10,2303,"[960,Max]",Extremamente Elevado,,,,134,Alentejo,ÉVORA,0709,60100.57,5828,336,358,283,331,305,636,919,1277,1613,9.7,2.68,2.12,1.53
20-01-2022,PORTIMÃO,2204,157,3973,"[960,Max]",Extremamente Elevado,,,,2204,Algarve,FARO,0811,18206.29,55483,3182,2927,2116,1582,1400,2982,5098,8025,11207,304.75,61.56,44.08,28.0
20-01-2022,PORTO,12006,858,5543,"[960,Max]",Extremamente Elevado,,,,12006,Norte,PORTO,1312,4142.02,216606,15790,15193,11280,9409,10044,19453,30733,45926,61716,5229.5,1490.0,1108.79,741.98
20-01-2022,PORTO DE MÓS,812,58,3490,"[960,Max]",Extremamente Elevado,,,,812,Centro,LEIRIA,1016,26183.41,23275,1355,1210,1034,888,872,1760,2794,4004,5359,88.89,20.47,15.29,10.67
20-01-2022,PORTO MONIZ,178,13,7612,"[960,Max]",Extremamente Elevado,,,,178,Madeira,MADEIRA,3106,8293.38,2342,143,130,95,98,120,218,313,443,586,28.24,7.07,5.34,3.77
20-01-2022,PORTO SANTO,211,15,4060,"[960,Max]",Extremamente Elevado,,,,211,Madeira,MADEIRA,3201,4300.7,5202,240,157,134,110,68,178,312,469,709,120.95,16.48,10.9,7.25
20-01-2022,PÓVOA DE LANHOSO,1437,103,6685,"[960,Max]",Extremamente Elevado,,,,1437,Norte,BRAGA,0309,13465.29,21499,1175,909,732,673,624,1297,2029,2938,4113,159.67,30.55,21.82,15.07
20-01-2022,PÓVOA DE VARZIM,3705,265,5901,"[960,Max]",Extremamente Elevado,,,,3705,Norte,PORTO,1313,8220.59,62784,3712,3120,2134,1594,1305,2899,5033,8153,11865,763.7,144.33,99.17,61.22
20-01-2022,POVOAÇÃO,136,10,2290,"[960,Max]",Extremamente Elevado,,,,136,Açores,AÇORES,4204,10640.77,5927,293,212,191,144,134,278,469,681,974,55.7,9.15,6.4,4.41
20-01-2022,VILA DA PRAIA DA VITÓRIA,582,42,2732,"[960,Max]",Extremamente Elevado,,,,582,Açores,AÇORES,4302,16127.06,21317,1133,789,619,436,336,772,1391,2180,3313,132.18,20.54,13.52,8.63
20-01-2022,PROENÇA-A-NOVA,324,23,4446,"[960,Max]",Extremamente Elevado,,,,324,Centro,CASTELO BRANCO,0508,39539.96,7298,508,465,389,400,560,960,1349,1814,2322,18.46,5.87,4.59,3.41
20-01-2022,REDONDO,129,9,2037,"[960,Max]",Extremamente Elevado,,,,129,Alentejo,ÉVORA,0710,36950.87,6353,349,325,288,288,354,642,930,1255,1604,17.19,4.34,3.4,2.52
20-01-2022,REGUENGOS DE MONSARAZ,256,18,2558,"[960,Max]",Extremamente Elevado,,,,256,Alentejo,ÉVORA,0711,46399.72,10015,602,511,455,462,473,935,1390,1901,2503,21.58,5.39,4.1,3.0
20-01-2022,RESENDE,414,30,4081,"[960,Max]",Extremamente Elevado,,,,414,Norte,VISEU,1813,12334.93,10137,560,493,448,433,422,855,1303,1796,2356,82.18,19.1,14.56,10.56
20-01-2022,RIBEIRA BRAVA,1089,78,8757,"[960,Max]",Extremamente Elevado,,,,1089,Madeira,MADEIRA,3107,6544.88,12435,648,500,411,311,287,598,1009,1509,2157,189.99,32.96,23.06,15.42
20-01-2022,RIBEIRA DE PENA,284,20,4727,"[960,Max]",Extremamente Elevado,,,,284,Norte,VILA REAL,1709,21745.98,6016,371,301,290,310,368,678,968,1269,1640,27.66,7.54,5.84,4.45
20-01-2022,RIBEIRA GRANDE,1522,109,4640,"[960,Max]",Extremamente Elevado,,,,1522,Açores,AÇORES,4205,18015.13,32811,1163,689,512,345,253,598,1110,1799,2962,182.13,16.44,9.99,6.16
20-01-2022,RIO MAIOR,818,58,4012,"[960,Max]",Extremamente Elevado,,,,818,Lisboa e Vale do Tejo,SANTARÉM,1414,27276.45,20379,1251,1144,941,795,648,1443,2384,3528,4779,74.71,17.52,12.93,8.74
20-01-2022,SABROSA,201,14,3400,"[960,Max]",Extremamente Elevado,,,,201,Norte,VILA REAL,1710,15692.45,5918,393,314,304,302,350,652,956,1270,1663,37.71,10.6,8.09,6.09
20-01-2022,SABUGAL,223,16,2109,"[960,Max]",Extremamente Elevado,,,,223,Centro,GUARDA,0911,82269.82,10585,724,707,694,796,1009,1805,2499,3206,3930,12.87,4.78,3.9,3.04
20-01-2022,SALVATERRA DE MAGOS,645,46,3031,"[960,Max]",Extremamente Elevado,,,,645,Lisboa e Vale do Tejo,SANTARÉM,1415,24393.2,21295,1275,1181,1060,799,772,1571,2631,3812,5087,87.3,20.85,15.63,10.79
20-01-2022,SANTA COMBA DÃO,345,25,3303,"[960,Max]",Extremamente Elevado,,,,345,Centro,VISEU,1814,11194.77,10452,732,684,569,538,464,1002,1571,2255,2987,93.36,26.68,20.14,14.03
20-01-2022,SANTA CRUZ,3721,266,8217,"[960,Max]",Extremamente Elevado,,,,3721,Madeira,MADEIRA,3108,8150.28,45281,1817,1301,974,716,523,1239,2213,3514,5331,555.6,65.41,43.12,27.15
20-01-2022,SANTA CRUZ DA GRACIOSA,12,1,287,"[240,480]",Elevado,,,,12,Açores,AÇORES,4401,6065.78,4208,228,180,163,124,145,269,432,612,840,69.37,13.85,10.09,7.12
20-01-2022,SANTA CRUZ DAS FLORES,32,2,1478,"[960,Max]",Extremamente Elevado,,,,32,Açores,AÇORES,4802,7091.44,2165,125,98,74,56,51,107,181,279,404,30.53,5.7,3.93,2.55
20-01-2022,SANTA MARIA DA FEIRA,8374,598,6040,"[960,Max]",Extremamente Elevado,,,,8374,Norte,AVEIRO,0109,21587.65,138636,8182,6743,4771,3856,3079,6935,11706,18449,26631,642.19,123.36,85.46,54.22
20-01-2022,SANTA MARTA DE PENAGUIÃO,200,14,3035,"[960,Max]",Extremamente Elevado,,,,200,Norte,VILA REAL,1711,6928.13,6599,483,373,337,316,317,633,970,1343,1826,95.25,26.36,19.39,14.0
20-01-2022,SANTANA,377,27,5611,"[960,Max]",Extremamente Elevado,,,,377,Madeira,MADEIRA,3109,9547.3,6711,418,353,343,282,277,559,902,1255,1673,70.29,17.52,13.15,9.45
20-01-2022,SANTARÉM,2493,178,4341,"[960,Max]",Extremamente Elevado,,,,2493,Lisboa e Vale do Tejo,SANTARÉM,1416,55253.58,57421,3654,3441,2760,2466,2206,4672,7432,10873,14527,103.92,26.29,19.68,13.45
20-01-2022,SANTIAGO DO CACÉM,645,46,2242,"[960,Max]",Extremamente Elevado,,,,645,Alentejo,SETÚBAL,1509,105969.29,28791,2144,1689,1472,1295,1215,2510,3982,5671,7815,27.17,7.37,5.35,3.76
20-01-2022,SANTO TIRSO,3481,249,5115,"[960,Max]",Extremamente Elevado,,,,3481,Norte,PORTO,1314,13655.52,68055,4911,3935,2761,2257,1810,4067,6828,10763,15674,498.35,114.78,78.82,50.0
20-01-2022,SÃO BRÁS DE ALPORTEL,298,21,2863,"[960,Max]",Extremamente Elevado,,,,298,Algarve,FARO,0812,15336.92,10416,596,468,467,404,401,805,1272,1740,2336,67.91,15.23,11.35,8.29
20-01-2022,SÃO JOÃO DA MADEIRA,1371,98,6246,"[960,Max]",Extremamente Elevado,,,,1371,Norte,AVEIRO,0116,794.3,21958,1347,1069,796,601,593,1194,1990,3059,4406,2765.49,554.91,385.26,250.63
20-01-2022,SÃO JOÃO DA PESQUEIRA,352,25,4943,"[960,Max]",Extremamente Elevado,,,,352,Norte,VISEU,1815,26610.85,7125,417,330,294,328,328,656,950,1280,1697,26.77,6.38,4.81,3.57
20-01-2022,SÃO PEDRO DO SUL,654,47,4247,"[960,Max]",Extremamente Elevado,,,,654,Centro,VISEU,1816,34895.09,15403,990,962,861,759,909,1668,2529,3491,4481,44.14,12.84,10.0,7.25
20-01-2022,SÃO ROQUE DO PICO,94,7,2868,"[960,Max]",Extremamente Elevado,,,,94,Açores,AÇORES,4603,14236.1,3266,199,141,93,96,113,209,302,443,642,22.94,4.51,3.11,2.12
20-01-2022,SÃO VICENTE,376,27,7315,"[960,Max]",Extremamente Elevado,,,,376,Madeira,MADEIRA,3110,7883.71,5143,272,264,266,225,280,505,771,1035,1307,65.23,16.58,13.13,9.78
20-01-2022,SARDOAL,174,12,4654,"[960,Max]",Extremamente Elevado,,,,174,Lisboa e Vale do Tejo,SANTARÉM,1417,9214.72,3741,227,178,148,165,248,413,561,739,966,40.6,10.48,8.02,6.09
20-01-2022,SÁTÃO,504,36,4349,"[960,Max]",Extremamente Elevado,,,,504,Centro,VISEU,1817,20194.11,11580,765,671,515,465,476,941,1456,2127,2892,57.34,14.32,10.53,7.21
20-01-2022,SEIA,737,53,3316,"[960,Max]",Extremamente Elevado,,,,737,Centro,GUARDA,0912,43568.83,22234,1807,1589,1238,1122,721,1843,3081,4670,6477,51.03,14.87,10.72,7.07
20-01-2022,SEIXAL,9037,645,5387,"[960,Max]",Extremamente Elevado,,,,9037,Lisboa e Vale do Tejo,SETÚBAL,1510,9545.17,167752,10586,9270,6661,4391,2930,7321,13982,23252,33838,1757.49,354.51,243.6,146.49
20-01-2022,SERNANCELHE,164,12,3033,"[960,Max]",Extremamente Elevado,,,,164,Norte,VISEU,1818,22861.22,5396,305,293,286,273,260,533,819,1112,1417,23.6,6.2,4.86,3.58
20-01-2022,SERPA,600,43,4197,"[960,Max]",Extremamente Elevado,,,,600,Alentejo,BEJA,0213,110563.34,14304,903,761,719,697,626,1323,2042,2803,3706,12.94,3.35,2.54,1.85
20-01-2022,SERTÃ,572,41,3927,"[960,Max]",Extremamente Elevado,,,,572,Centro,CASTELO BRANCO,0509,44673.17,14577,870,779,790,767,1020,1787,2577,3356,4226,32.63,9.46,7.51,5.77
20-01-2022,SESIMBRA,2334,167,4500,"[960,Max]",Extremamente Elevado,,,,2334,Lisboa e Vale do Tejo,SETÚBAL,1511,19571.75,51858,2400,2321,1853,1257,1083,2340,4193,6514,8914,264.96,45.54,33.28,21.42
20-01-2022,SETÚBAL,5541,396,4813,"[960,Max]",Extremamente Elevado,,,,5541,Lisboa e Vale do Tejo,SETÚBAL,1512,23032.5,115126,7425,6929,5075,3775,2655,6430,11505,18434,25859,499.83,112.27,80.03,49.95
20-01-2022,SEVER DO VOUGA,555,40,4897,"[960,Max]",Extremamente Elevado,,,,555,Centro,AVEIRO,0117,12987.56,11331,766,637,568,540,567,1107,1675,2312,3078,87.24,23.7,17.8,12.9
20-01-2022,SILVES,1114,80,3075,"[960,Max]",Extremamente Elevado,,,,1114,Algarve,FARO,0813,68006.23,36226,2137,1869,1610,1423,1600,3023,4633,6502,8639,53.27,12.7,9.56,6.81
20-01-2022,SINES,519,37,3786,"[960,Max]",Extremamente Elevado,,,,519,Alentejo,SETÚBAL,1513,20330.17,13715,888,791,551,416,268,684,1235,2026,2914,67.46,14.33,9.97,6.07
20-01-2022,SINTRA,20361,1454,5202,"[960,Max]",Extremamente Elevado,,,,20361,Lisboa e Vale do Tejo,LISBOA,1111,31922.73,391402,20490,18316,13545,9137,7284,16421,29966,48282,68772,1226.08,215.43,151.25,93.87
20-01-2022,SOBRAL DE MONTE AGRAÇO,567,41,5326,"[960,Max]",Extremamente Elevado,,,,567,Lisboa e Vale do Tejo,LISBOA,1112,5210.32,10651,564,507,352,272,212,484,836,1343,1907,204.43,36.6,25.78,16.05
20-01-2022,SOURE,545,39,3184,"[960,Max]",Extremamente Elevado,,,,545,Centro,COIMBRA,0615,26506.07,17120,1173,1142,1004,883,987,1870,2874,4016,5189,64.59,19.58,15.15,10.84
20-01-2022,SOUSEL,76,5,1733,"[960,Max]",Extremamente Elevado,,,,76,Alentejo,PORTALEGRE,1215,27932.18,4412,261,274,208,302,292,594,802,1076,1337,15.8,4.79,3.85,2.87
20-01-2022,TÁBUA,411,29,3617,"[960,Max]",Extremamente Elevado,,,,411,Centro,COIMBRA,0616,19978.58,11368,729,584,524,430,464,894,1418,2002,2731,56.9,13.67,10.02,7.1
20-01-2022,TABUAÇO,150,11,2492,"[960,Max]",Extremamente Elevado,,,,150,Norte,VISEU,1819,13385.67,6033,372,314,217,282,363,645,862,1176,1548,45.07,11.56,8.79,6.44
20-01-2022,TAROUCA,249,18,3197,"[960,Max]",Extremamente Elevado,,,,249,Norte,VISEU,1820,10008.49,7804,405,335,313,277,324,601,914,1249,1654,77.98,16.53,12.48,9.13
20-01-2022,TAVIRA,664,47,2708,"[960,Max]",Extremamente Elevado,,,,664,Algarve,FARO,0814,60696.7,24530,1493,1415,1252,1066,1277,2343,3595,5010,6503,40.41,10.71,8.25,5.92
20-01-2022,TERRAS DE BOURO,359,26,5637,"[960,Max]",Extremamente Elevado,,,,359,Norte,BRAGA,0310,27746.07,6361,391,372,296,319,340,659,955,1327,1718,22.93,6.19,4.78,3.44
20-01-2022,TOMAR,1594,114,4337,"[960,Max]",Extremamente Elevado,,,,1594,Lisboa e Vale do Tejo,SANTARÉM,1418,35120.44,36748,2403,2189,1868,1853,1822,3675,5543,7732,10135,104.64,28.86,22.02,15.78
20-01-2022,TONDELA,893,64,3388,"[960,Max]",Extremamente Elevado,,,,893,Centro,VISEU,1821,37121.73,26357,1768,1722,1518,1475,1417,2892,4410,6132,7900,71.0,21.28,16.52,11.88
20-01-2022,TORRE DE MONCORVO,158,11,2051,"[960,Max]",Extremamente Elevado,,,,158,Norte,BRAGANÇA,0409,53155.67,7695,556,478,488,551,719,1270,1758,2236,2792,14.48,5.25,4.21,3.31
20-01-2022,TORRES NOVAS,1395,100,3992,"[960,Max]",Extremamente Elevado,,,,1395,Lisboa e Vale do Tejo,SANTARÉM,1419,26999.68,34933,2324,1979,1738,1406,1475,2881,4619,6598,8922,129.38,33.04,24.44,17.11
20-01-2022,TORRES VEDRAS,3608,258,4594,"[960,Max]",Extremamente Elevado,,,,3608,Lisboa e Vale do Tejo,LISBOA,1113,40714.89,78530,4513,3945,3447,2628,2104,4732,8179,12124,16637,192.88,40.86,29.78,20.09
20-01-2022,TRANCOSO,256,18,2888,"[960,Max]",Extremamente Elevado,,,,256,Centro,GUARDA,0913,36152.47,8875,581,557,542,586,496,1082,1624,2181,2762,24.55,7.64,6.03,4.49
20-01-2022,TROFA,1985,142,5166,"[960,Max]",Extremamente Elevado,,,,1985,Norte,PORTO,1318,7201.76,38418,2336,1894,1231,939,684,1623,2854,4748,7084,533.44,98.36,65.93,39.63
20-01-2022,VAGOS,951,68,4182,"[960,Max]",Extremamente Elevado,,,,951,Centro,AVEIRO,0118,16491.5,22740,1320,1205,922,784,724,1508,2430,3635,4955,137.89,30.04,22.04,14.73
20-01-2022,VALE DE CAMBRA,1473,105,6908,"[960,Max]",Extremamente Elevado,,,,1473,Norte,AVEIRO,0119,14733.47,21327,1491,1363,1005,831,798,1629,2634,3997,5488,144.76,37.25,27.13,17.88
20-01-2022,VALENÇA,639,46,4806,"[960,Max]",Extremamente Elevado,,,,639,Norte,VIANA DO CASTELO,1608,11712.86,13290,867,791,582,582,503,1085,1667,2458,3325,113.46,28.39,20.99,14.23
20-01-2022,VALONGO,4878,348,5006,"[960,Max]",Extremamente Elevado,,,,4878,Norte,PORTO,1315,7512.45,97444,5629,4696,3207,2462,1829,4291,7498,12194,17823,1297.18,237.26,162.33,99.81
20-01-2022,VALPAÇOS,539,39,3639,"[960,Max]",Extremamente Elevado,,,,539,Norte,VILA REAL,1712,54873.93,14818,1217,1118,999,928,997,1925,2924,4042,5259,27.0,9.58,7.37,5.33
20-01-2022,VELAS,28,2,552,"[480,960]",Muito Elevado,,,,28,Açores,AÇORES,4502,11738.38,5093,278,208,166,153,113,266,432,640,918,43.39,7.82,5.45,3.68
20-01-2022,VENDAS NOVAS,432,31,3835,"[960,Max]",Extremamente Elevado,,,,432,Alentejo,ÉVORA,0712,22238.88,11255,677,768,655,501,532,1033,1688,2456,3133,50.61,14.09,11.04,7.59
20-01-2022,VIANA DO ALENTEJO,121,9,2350,"[960,Max]",Extremamente Elevado,,,,121,Alentejo,ÉVORA,0713,39367.29,5145,245,208,235,210,214,424,659,867,1112,13.07,2.82,2.2,1.67
20-01-2022,VIANA DO CASTELO,3641,260,4313,"[960,Max]",Extremamente Elevado,,,,3641,Norte,VIANA DO CASTELO,1609,31902.01,84417,5470,4433,3591,3061,2982,6043,9634,14067,19537,264.61,61.24,44.09,30.2
20-01-2022,VIDIGUEIRA,181,13,3288,"[960,Max]",Extremamente Elevado,,,,181,Alentejo,BEJA,0214,31661.09,5510,300,248,215,233,275,508,723,971,1271,17.4,4.01,3.07,2.28
20-01-2022,VIEIRA DO MINHO,693,50,5854,"[960,Max]",Extremamente Elevado,,,,693,Norte,BRAGA,0311,21644.35,11842,703,594,525,548,482,1030,1555,2149,2852,54.71,13.18,9.93,7.18
20-01-2022,VILA DE REI,80,6,2397,"[960,Max]",Extremamente Elevado,,,,80,Centro,CASTELO BRANCO,0510,19154.6,3323,169,128,172,247,302,549,721,849,1018,17.35,5.31,4.43,3.76
20-01-2022,VILA DO BISPO,113,8,2195,"[960,Max]",Extremamente Elevado,,,,113,Algarve,FARO,0815,17906.06,5154,302,302,314,232,233,465,779,1081,1383,28.78,7.72,6.04,4.35
20-01-2022,VILA DO CONDE,4613,329,5773,"[960,Max]",Extremamente Elevado,,,,4613,Norte,PORTO,1316,14902.77,79899,4726,3875,2819,2070,1743,3813,6632,10507,15233,536.13,102.21,70.5,44.5
20-01-2022,VILA DO PORTO,148,11,2637,"[960,Max]",Extremamente Elevado,,,,148,Açores,AÇORES,4101,9688.74,5616,274,212,135,96,123,219,354,566,840,57.96,8.67,5.84,3.65
20-01-2022,VILA FLOR,158,11,2612,"[960,Max]",Extremamente Elevado,,,,158,Norte,BRAGANÇA,0410,26581.14,6044,429,362,422,294,331,625,1047,1409,1838,22.74,6.91,5.3,3.94
20-01-2022,VILA FRANCA DE XIRA,7562,540,5327,"[960,Max]",Extremamente Elevado,,,,7562,Lisboa e Vale do Tejo,LISBOA,1114,31819.39,141957,8501,6852,4869,3425,2472,5897,10766,17618,26119,446.14,82.09,55.37,33.84
20-01-2022,VILA FRANCA DO CAMPO,372,27,3369,"[960,Max]",Extremamente Elevado,,,,372,Açores,AÇORES,4206,7796.82,11051,450,344,248,217,154,371,619,963,1413,141.73,18.12,12.35,7.94
20-01-2022,VILA NOVA DA BARQUINHA,279,20,3736,"[960,Max]",Extremamente Elevado,,,,279,Lisboa e Vale do Tejo,SANTARÉM,1420,4952.97,7461,415,406,392,364,338,702,1094,1500,1915,150.64,38.66,30.28,22.09
20-01-2022,VILA NOVA DE CERVEIRA,430,31,4831,"[960,Max]",Extremamente Elevado,,,,430,Norte,VIANA DO CASTELO,1610,10846.66,8910,531,444,410,384,334,718,1128,1572,2103,82.14,19.39,14.49,10.4
20-01-2022,VILA NOVA DE FAMALICÃO,7931,566,6023,"[960,Max]",Extremamente Elevado,,,,7931,Norte,BRAGA,0312,20159.26,131676,7817,6164,4202,3282,2749,6031,10233,16397,24214,653.19,120.12,81.34,50.76
20-01-2022,VILA NOVA DE FOZ CÔA,88,6,1355,"[960,Max]",Extremamente Elevado,,,,88,Centro,GUARDA,0914,39815.18,6503,442,385,390,398,429,827,1217,1602,2044,16.33,5.13,4.02,3.06
20-01-2022,VILA NOVA DE GAIA,17893,1278,5955,"[960,Max]",Extremamente Elevado,,,,17893,Norte,PORTO,1317,16846.43,300472,18349,15568,10972,8224,6281,14505,25477,41045,59394,1783.64,352.57,243.65,151.23
20-01-2022,VILA NOVA DE PAIVA,291,21,6207,"[960,Max]",Extremamente Elevado,,,,291,Centro,VISEU,1822,17553.28,4687,289,272,233,217,241,458,691,963,1252,26.7,7.13,5.49,3.94
20-01-2022,VILA NOVA DE POIARES,202,14,2917,"[960,Max]",Extremamente Elevado,,,,202,Centro,COIMBRA,0617,8445.3,6939,380,284,262,235,182,417,679,963,1343,82.17,15.9,11.4,8.04
20-01-2022,VILA POUCA DE AGUIAR,478,34,3997,"[960,Max]",Extremamente Elevado,,,,478,Norte,VILA REAL,1713,43706.62,11961,860,817,733,601,627,1228,1961,2778,3638,27.37,8.32,6.36,4.49
20-01-2022,VILA REAL,2092,149,4188,"[960,Max]",Extremamente Elevado,,,,2092,Norte,VILA REAL,1714,37880.28,49962,3025,2498,2065,1579,1466,3045,5110,7608,10633,131.9,28.07,20.08,13.49
20-01-2022,VILA REAL DE SANTO ANTÓNIO,612,44,3262,"[960,Max]",Extremamente Elevado,,,,612,Algarve,FARO,0816,6125.0,18749,1172,1069,811,569,586,1155,1966,3035,4207,306.11,68.69,49.55,32.1
20-01-2022,VILA VELHA DE RÓDÃO,106,8,3374,"[960,Max]",Extremamente Elevado,,,,106,Centro,CASTELO BRANCO,0511,32991.16,3144,209,229,180,283,306,589,769,998,1207,9.53,3.66,3.03,2.33
20-01-2022,VILA VERDE,2938,210,6262,"[960,Max]",Extremamente Elevado,,,,2938,Norte,BRAGA,0313,22866.52,46911,2365,2063,1667,1494,1437,2931,4598,6661,9026,205.15,39.47,29.13,20.11
20-01-2022,VILA VIÇOSA,292,21,3820,"[960,Max]",Extremamente Elevado,,,,292,Alentejo,ÉVORA,0714,19485.89,7656,487,379,342,345,324,669,1011,1390,1877,39.29,9.63,7.13,5.19
20-01-2022,VIMIOSO,204,15,5078,"[960,Max]",Extremamente Elevado,,,,204,Norte,BRAGANÇA,0411,48158.51,4023,274,230,261,293,335,628,889,1119,1393,8.35,2.89,2.32,1.85
20-01-2022,VINHAIS,242,17,3128,"[960,Max]",Extremamente Elevado,,,,242,Norte,BRAGANÇA,0412,69475.09,7746,599,577,636,641,815,1456,2092,2669,3268,11.15,4.7,3.84,3.01
20-01-2022,VISEU,4600,329,4730,"[960,Max]",Extremamente Elevado,,,,4600,Centro,VISEU,1823,50710.14,97249,5769,5038,4140,3158,2710,5868,10008,15046,20815,191.77,41.05,29.67,19.74
20-01-2022,VIZELA,2141,153,8959,"[960,Max]",Extremamente Elevado,,,,2141,Norte,BRAGA,0314,2469.83,23897,1258,928,655,509,371,880,1535,2463,3721,967.49,150.65,99.72,62.15
20-01-2022,VOUZELA,359,26,3731,"[960,Max]",Extremamente Elevado,,,,359,Centro,VISEU,1824,19369.46,9619,626,605,554,532,507,1039,1593,2198,2824,49.66,14.58,11.35,8.22
27-01-2022,ABRANTES,1682,120,4788,"[960,Max]",Extremamente Elevado,,,,1682,Lisboa e Vale do Tejo,SANTARÉM,1401,71469.08,35130,2473,2213,1730,1748,2021,3769,5499,7712,10185,49.15,14.25,10.79,7.69
27-01-2022,ÁGUEDA,3943,282,8557,"[960,Max]",Extremamente Elevado,,,,3943,Centro,AVEIRO,0101,33527.44,46075,3237,2713,2090,1635,1496,3131,5221,7934,11171,137.43,33.32,23.66,15.57
27-01-2022,AGUIAR DA BEIRA,342,24,7359,"[960,Max]",Extremamente Elevado,,,,342,Centro,GUARDA,0901,20676.57,4652,304,281,235,239,148,387,622,903,1207,22.5,5.84,4.37,3.01
27-01-2022,ALANDROAL,234,17,4679,"[960,Max]",Extremamente Elevado,,,,234,Alentejo,ÉVORA,0701,54267.81,4992,307,256,296,299,377,676,972,1228,1535,9.2,2.83,2.26,1.79
27-01-2022,ALBERGARIA-A-VELHA,2305,165,9545,"[960,Max]",Extremamente Elevado,,,,2305,Centro,AVEIRO,0102,15882.5,24144,1550,1298,996,687,680,1367,2363,3661,5211,152.02,32.81,23.05,14.88
27-01-2022,ALBUFEIRA,2577,184,6205,"[960,Max]",Extremamente Elevado,,,,2577,Algarve,FARO,0801,14066.42,41528,2067,1717,1425,985,858,1843,3268,4985,7052,295.24,50.14,35.44,23.23
27-01-2022,ALCÁCER DO SAL,561,40,4816,"[960,Max]",Extremamente Elevado,,,,561,Alentejo,SETÚBAL,1501,149987.3,11659,884,814,623,623,602,1225,1848,2662,3546,7.77,2.36,1.77,1.23
27-01-2022,ALCANENA,551,39,4305,"[960,Max]",Extremamente Elevado,,,,551,Lisboa e Vale do Tejo,SANTARÉM,1402,12732.86,12809,891,744,628,536,588,1124,1752,2496,3387,100.6,26.6,19.6,13.76
27-01-2022,ALCOBAÇA,3253,232,6075,"[960,Max]",Extremamente Elevado,,,,3253,Lisboa e Vale do Tejo,LEIRIA,1001,40814.09,53555,3420,2927,2466,2059,1676,3735,6201,9128,12548,131.22,30.74,22.36,15.19
27-01-2022,ALCOCHETE,1096,78,5539,"[960,Max]",Extremamente Elevado,,,,1096,Lisboa e Vale do Tejo,SETÚBAL,1502,12836.48,19787,857,834,691,476,447,923,1614,2448,3305,154.15,25.75,19.07,12.57
27-01-2022,ALCOUTIM,143,10,6644,"[960,Max]",Extremamente Elevado,,,,143,Algarve,FARO,0802,57536.33,2159,191,188,163,190,267,457,620,808,999,3.75,1.74,1.4,1.08
27-01-2022,ALENQUER,2714,194,6161,"[960,Max]",Extremamente Elevado,,,,2714,Lisboa e Vale do Tejo,LISBOA,1101,30421.92,44052,2298,2062,1629,1330,1155,2485,4114,6176,8474,144.8,27.85,20.3,13.52
27-01-2022,ALFÂNDEGA DA FÉ,230,16,5053,"[960,Max]",Extremamente Elevado,,,,230,Norte,BRAGANÇA,0401,32194.64,4550,325,277,301,274,325,599,900,1177,1502,14.13,4.67,3.66,2.8
27-01-2022,ALIJÓ,475,34,4474,"[960,Max]",Extremamente Elevado,,,,475,Norte,VILA REAL,1701,29759.89,10625,766,687,635,542,666,1208,1843,2530,3296,35.7,11.08,8.5,6.19
27-01-2022,ALJEZUR,252,18,4502,"[960,Max]",Extremamente Elevado,,,,252,Algarve,FARO,0803,32349.95,5594,316,336,335,320,410,730,1065,1401,1717,17.29,5.31,4.33,3.29
27-01-2022,ALJUSTREL,359,26,4349,"[960,Max]",Extremamente Elevado,,,,359,Alentejo,BEJA,0201,45847.41,8247,635,521,443,347,358,705,1148,1669,2304,17.99,5.03,3.64,2.5
27-01-2022,ALMADA,9571,684,5662,"[960,Max]",Extremamente Elevado,,,,9571,Lisboa e Vale do Tejo,SETÚBAL,1503,7000.89,169039,10469,9777,7876,6144,5111,11255,19131,28908,39377,2414.5,562.45,412.91,273.26
27-01-2022,ALMEIDA,165,12,2834,"[960,Max]",Extremamente Elevado,,,,165,Centro,GUARDA,0902,51798.46,5830,441,419,396,458,393,851,1247,1666,2107,11.26,4.07,3.22,2.41
27-01-2022,ALMEIRIM,1344,96,5962,"[960,Max]",Extremamente Elevado,,,,1344,Lisboa e Vale do Tejo,SANTARÉM,1403,22212.05,22546,1342,1353,1106,866,843,1709,2815,4168,5510,101.5,24.81,18.76,12.67
27-01-2022,ALMODÔVAR,407,29,6051,"[960,Max]",Extremamente Elevado,,,,407,Alentejo,BEJA,0202,77788.03,6725,414,443,396,373,328,701,1097,1540,1954,8.65,2.51,1.98,1.41
27-01-2022,ALPIARÇA,458,33,6485,"[960,Max]",Extremamente Elevado,,,,458,Lisboa e Vale do Tejo,SANTARÉM,1404,9536.33,7059,515,486,363,333,274,607,970,1456,1971,74.02,20.67,15.27,10.17
27-01-2022,ALTER DO CHÃO,39,3,1244,"[960,Max]",Extremamente Elevado,,,,39,Alentejo,PORTALEGRE,1201,36206.62,3165,201,163,136,208,187,395,531,694,895,8.74,2.47,1.92,1.47
27-01-2022,ALVAIÁZERE,269,19,4082,"[960,Max]",Extremamente Elevado,,,,269,Centro,LEIRIA,1002,16047.76,6597,419,389,346,406,539,945,1291,1680,2099,41.11,13.08,10.47,8.04
27-01-2022,ALVITO,48,3,1945,"[960,Max]",Extremamente Elevado,,,,48,Alentejo,BEJA,0203,26485.32,2477,145,110,105,111,89,200,305,415,560,9.35,2.11,1.57,1.15
27-01-2022,AMADORA,7747,553,4208,"[960,Max]",Extremamente Elevado,,,,7747,Lisboa e Vale do Tejo,LISBOA,1115,2378.47,184106,11186,10936,8780,6460,5890,12350,21130,32066,43252,7742.05,1818.84,1348.44,888.56
27-01-2022,AMARANTE,3767,269,7082,"[960,Max]",Extremamente Elevado,,,,3767,Norte,PORTO,1301,30133.15,53193,3086,2413,1812,1643,1311,2954,4766,7179,10265,176.53,34.07,23.82,15.82
27-01-2022,AMARES,1368,98,7546,"[960,Max]",Extremamente Elevado,,,,1368,Norte,BRAGA,0301,8195.41,18129,1001,829,622,489,524,1013,1635,2464,3465,221.22,42.28,30.07,19.95
27-01-2022,ANADIA,1870,134,6859,"[960,Max]",Extremamente Elevado,,,,1870,Centro,AVEIRO,0103,21663.48,27258,1931,1698,1376,1208,1262,2470,3846,5544,7475,125.83,34.51,25.59,17.75
27-01-2022,ANGRA DO HEROÍSMO,1639,117,4848,"[960,Max]",Extremamente Elevado,,,,1639,Açores,AÇORES,4301,23899.66,33807,2006,1473,1122,768,635,1403,2525,3998,6004,141.45,25.12,16.73,10.56
27-01-2022,ANSIÃO,673,48,5588,"[960,Max]",Extremamente Elevado,,,,673,Centro,LEIRIA,1003,17609.42,12039,727,709,646,694,530,1224,1870,2579,3306,68.37,18.77,14.65,10.62
27-01-2022,ARCOS DE VALDEVEZ,1021,73,4879,"[960,Max]",Extremamente Elevado,,,,1021,Norte,VIANA DO CASTELO,1601,44759.64,20926,1329,1338,1282,1343,1515,2858,4140,5478,6807,46.75,15.21,12.24,9.25
27-01-2022,ARGANIL,520,37,4722,"[960,Max]",Extremamente Elevado,,,,520,Centro,COIMBRA,0601,33283.93,11014,672,648,612,559,596,1155,1767,2415,3087,33.09,9.27,7.26,5.31
27-01-2022,ARMAMAR,291,21,5038,"[960,Max]",Extremamente Elevado,,,,291,Norte,VISEU,1801,11723.73,5769,357,305,309,285,310,595,904,1209,1566,49.21,13.36,10.31,7.71
27-01-2022,AROUCA,1914,137,9239,"[960,Max]",Extremamente Elevado,,,,1914,Norte,AVEIRO,0104,32910.52,20720,1306,1047,753,683,683,1366,2119,3166,4472,62.96,13.59,9.62,6.44
27-01-2022,ARRAIOLOS,342,24,4935,"[960,Max]",Extremamente Elevado,,,,342,Alentejo,ÉVORA,0702,68374.55,6928,435,384,283,367,480,847,1130,1514,1949,10.13,2.85,2.21,1.65
27-01-2022,ARRONCHES,179,13,6336,"[960,Max]",Extremamente Elevado,,,,179,Alentejo,PORTALEGRE,1202,31464.72,2820,155,142,162,187,179,366,528,670,825,8.96,2.62,2.13,1.68
27-01-2022,ARRUDA DOS VINHOS,729,52,4729,"[960,Max]",Extremamente Elevado,,,,729,Lisboa e Vale do Tejo,LISBOA,1102,7795.93,15412,738,738,562,509,438,947,1509,2247,2985,197.69,38.29,28.82,19.36
27-01-2022,AVEIRO,6216,444,7895,"[960,Max]",Extremamente Elevado,,,,6216,Centro,AVEIRO,0105,19757.57,78734,4520,4004,3050,2250,2103,4353,7403,11407,15927,398.49,80.61,57.73,37.47
27-01-2022,AVIS,67,5,1574,"[960,Max]",Extremamente Elevado,,,,67,Alentejo,PORTALEGRE,1203,60596.51,4247,315,225,206,251,273,524,730,955,1270,7.01,2.1,1.58,1.2
27-01-2022,AZAMBUJA,1233,88,5427,"[960,Max]",Extremamente Elevado,,,,1233,Lisboa e Vale do Tejo,LISBOA,1103,26265.65,22716,1322,1171,1070,798,618,1416,2486,3657,4979,86.48,18.96,13.92,9.46
27-01-2022,BAIÃO,1195,85,6374,"[960,Max]",Extremamente Elevado,,,,1195,Norte,PORTO,1302,17452.83,18748,1070,862,714,686,725,1411,2125,2987,4057,107.42,23.25,17.11,12.18
27-01-2022,BARCELOS,10427,745,8974,"[960,Max]",Extremamente Elevado,,,,10427,Norte,BRAGA,0302,37890.14,116187,6721,5325,3619,2991,2562,5553,9172,14497,21218,306.64,56.0,38.26,24.21
27-01-2022,BARRANCOS,56,4,3450,"[960,Max]",Extremamente Elevado,,,,56,Alentejo,BEJA,0204,16841.73,1634,90,65,65,94,61,155,220,285,375,9.7,2.23,1.69,1.31
27-01-2022,BARREIRO,4457,318,5931,"[960,Max]",Extremamente Elevado,,,,4457,Lisboa e Vale do Tejo,SETÚBAL,1504,3639.07,75147,5194,5565,4459,3105,1767,4872,9331,14896,20090,2065.05,552.07,409.34,256.42
27-01-2022,BATALHA,1024,73,6414,"[960,Max]",Extremamente Elevado,,,,1024,Centro,LEIRIA,1004,10341.6,15963,873,762,649,529,549,1078,1727,2489,3362,154.35,32.51,24.07,16.7
27-01-2022,BEJA,1841,132,5483,"[960,Max]",Extremamente Elevado,,,,1841,Alentejo,BEJA,0205,114647.55,33579,2005,1840,1386,1272,1039,2311,3697,5537,7542,29.29,6.58,4.83,3.22
27-01-2022,BELMONTE,292,21,4559,"[960,Max]",Extremamente Elevado,,,,292,Centro,CASTELO BRANCO,0501,11875.91,6398,444,321,325,310,355,665,990,1311,1755,53.87,14.78,11.04,8.34
27-01-2022,BENAVENTE,1884,135,6157,"[960,Max]",Extremamente Elevado,,,,1884,Lisboa e Vale do Tejo,SANTARÉM,1405,52138.39,30602,1468,1376,1141,876,643,1519,2660,4036,5504,58.69,10.56,7.74,5.1
27-01-2022,BOMBARRAL,607,43,4833,"[960,Max]",Extremamente Elevado,,,,607,Lisboa e Vale do Tejo,LEIRIA,1005,9128.55,12558,875,714,561,491,429,920,1481,2195,3070,137.56,33.63,24.04,16.22
27-01-2022,BORBA,425,30,6314,"[960,Max]",Extremamente Elevado,,,,425,Alentejo,ÉVORA,0703,14518.65,6736,430,375,279,436,392,828,1107,1482,1912,46.39,13.17,10.21,7.62
27-01-2022,BOTICAS,222,16,4446,"[960,Max]",Extremamente Elevado,,,,222,Norte,VILA REAL,1702,32195.66,4998,347,306,311,305,380,685,996,1302,1649,15.52,5.12,4.04,3.09
27-01-2022,BRAGA,18094,1292,9905,"[960,Max]",Extremamente Elevado,,,,18094,Norte,BRAGA,0303,18339.95,182679,10029,7963,5241,4320,3671,7991,13232,21195,31224,996.07,170.25,115.57,72.15
27-01-2022,BRAGANÇA,1797,128,5347,"[960,Max]",Extremamente Elevado,,,,1797,Norte,BRAGANÇA,0402,117357.27,33607,2402,1855,1652,1393,1163,2556,4208,6063,8465,28.64,7.21,5.17,3.59
27-01-2022,CABECEIRAS DE BASTO,1752,125,11213,"[960,Max]",Extremamente Elevado,,,,1752,Norte,BRAGA,0304,24182.16,15628,774,594,544,575,574,1149,1693,2287,3061,64.63,12.66,9.46,7.0
27-01-2022,CADAVAL,610,44,4463,"[960,Max]",Extremamente Elevado,,,,610,Lisboa e Vale do Tejo,LISBOA,1104,17489.3,13673,813,796,756,621,625,1246,2002,2798,3611,78.18,20.65,16.0,11.45
27-01-2022,CALDAS DA RAINHA,2338,167,4503,"[960,Max]",Extremamente Elevado,,,,2338,Lisboa e Vale do Tejo,LEIRIA,1006,25569.47,51912,3035,2684,2186,1899,1705,3604,5790,8474,11509,203.03,45.01,33.14,22.64
27-01-2022,CALHETA,690,49,6351,"[960,Max]",Extremamente Elevado,,,,690,Madeira,MADEIRA,3101,11150.43,10867,576,497,507,399,415,814,1321,1818,2394,97.46,21.47,16.3,11.85
27-01-2022,CALHETA (AÇORES),27,2,855,"[480,960]",Muito Elevado,,,,27,Açores,AÇORES,4501,12626.4,3184,215,159,141,139,122,261,402,561,776,25.22,6.15,4.44,3.18
27-01-2022,CÂMARA DE LOBOS,3691,264,10960,"[960,Max]",Extremamente Elevado,,,,3691,Madeira,MADEIRA,3102,5216.67,33675,1396,1059,834,545,381,926,1760,2819,4215,645.49,80.79,54.03,33.74
27-01-2022,CAMINHA,724,52,4561,"[960,Max]",Extremamente Elevado,,,,724,Norte,VIANA DO CASTELO,1602,13652.14,15877,1046,944,818,646,656,1302,2120,3064,4110,116.3,30.11,22.44,15.53
27-01-2022,CAMPO MAIOR,312,22,3966,"[960,Max]",Extremamente Elevado,,,,312,Alentejo,PORTALEGRE,1204,24720.16,7874,471,364,351,279,327,606,957,1321,1792,31.85,7.25,5.34,3.87
27-01-2022,CANTANHEDE,1559,111,4453,"[960,Max]",Extremamente Elevado,,,,1559,Centro,COIMBRA,0602,39088.02,35011,2346,2096,1880,1709,1451,3160,5040,7136,9482,89.57,24.26,18.26,12.89
27-01-2022,CARRAZEDA DE ANSIÃES,139,10,2460,"[960,Max]",Extremamente Elevado,,,,139,Norte,BRAGANÇA,0403,27924.09,5666,424,389,391,312,465,777,1168,1557,1981,20.29,7.09,5.58,4.18
27-01-2022,CARREGAL DO SAL,572,41,6174,"[960,Max]",Extremamente Elevado,,,,572,Centro,VISEU,1802,11689.21,9271,587,562,486,462,376,838,1324,1886,2473,79.31,21.16,16.13,11.33
27-01-2022,CARTAXO,1466,105,6148,"[960,Max]",Extremamente Elevado,,,,1466,Lisboa e Vale do Tejo,SANTARÉM,1406,15817.28,23843,1415,1376,1142,861,632,1493,2635,4011,5426,150.74,34.3,25.36,16.66
27-01-2022,CASCAIS,12428,888,5818,"[960,Max]",Extremamente Elevado,,,,12428,Lisboa e Vale do Tejo,LISBOA,1105,9740.17,213608,12151,11444,8680,6469,5248,11717,20397,31841,43992,2193.1,451.66,326.91,209.41
27-01-2022,CASTANHEIRA DE PÊRA,76,5,2910,"[960,Max]",Extremamente Elevado,,,,76,Centro,LEIRIA,1007,6677.45,2614,233,195,157,190,187,377,534,729,962,39.15,14.41,10.92,8.0
27-01-2022,CASTELO BRANCO,3650,261,7021,"[960,Max]",Extremamente Elevado,,,,3650,Centro,CASTELO BRANCO,0502,143819.15,51987,3528,3042,2499,2229,2225,4454,6953,9995,13523,36.15,9.4,6.95,4.83
27-01-2022,CASTELO DE PAIVA,1187,85,7678,"[960,Max]",Extremamente Elevado,,,,1187,Norte,AVEIRO,0106,11500.53,15454,881,697,545,420,431,851,1396,2093,2974,134.37,25.86,18.2,12.14
27-01-2022,CASTELO DE VIDE,141,10,4846,"[960,Max]",Extremamente Elevado,,,,141,Alentejo,PORTALEGRE,1205,26491.24,2919,204,173,179,147,170,317,496,669,873,11.02,3.3,2.53,1.87
27-01-2022,CASTRO DAIRE,1098,78,7940,"[960,Max]",Extremamente Elevado,,,,1098,Centro,VISEU,1803,37904.13,13823,942,857,765,732,773,1505,2270,3127,4069,36.47,10.74,8.25,5.99
27-01-2022,CASTRO MARIM,265,19,4243,"[960,Max]",Extremamente Elevado,,,,265,Algarve,FARO,0804,30084.37,6237,370,345,334,322,344,666,1000,1345,1715,20.73,5.7,4.47,3.32
27-01-2022,CASTRO VERDE,441,31,6343,"[960,Max]",Extremamente Elevado,,,,441,Alentejo,BEJA,0206,56944.23,6949,437,347,303,275,227,502,805,1152,1589,12.2,2.79,2.02,1.41
27-01-2022,CELORICO DA BEIRA,425,30,6129,"[960,Max]",Extremamente Elevado,,,,425,Centro,GUARDA,0903,24721.63,6928,430,416,363,369,535,904,1267,1683,2113,28.02,8.55,6.81,5.12
27-01-2022,CELORICO DE BASTO,1195,85,6274,"[960,Max]",Extremamente Elevado,,,,1195,Norte,BRAGA,0305,18107.02,19040,1001,802,668,728,729,1457,2125,2927,3928,105.15,21.69,16.17,11.74
27-01-2022,CHAMUSCA,452,32,4919,"[960,Max]",Extremamente Elevado,,,,452,Lisboa e Vale do Tejo,SANTARÉM,1407,74600.54,9197,629,583,553,465,579,1044,1597,2180,2809,12.33,3.77,2.92,2.14
27-01-2022,CHAVES,2353,168,5980,"[960,Max]",Extremamente Elevado,,,,2353,Norte,VILA REAL,1703,59122.95,39343,2676,2429,1991,1886,1918,3804,5795,8224,10900,66.54,18.44,13.91,9.8
27-01-2022,CINFÃES,1472,105,8066,"[960,Max]",Extremamente Elevado,,,,1472,Norte,VISEU,1804,23928.76,18244,1067,902,779,734,758,1492,2271,3173,4240,76.24,17.72,13.26,9.49
27-01-2022,COIMBRA,6075,434,4528,"[960,Max]",Extremamente Elevado,,,,6075,Centro,COIMBRA,0603,31939.94,134166,9489,8734,6353,5139,5074,10213,16566,25300,34789,420.06,108.92,79.21,51.87
27-01-2022,CONDEIXA-A-NOVA,855,61,4823,"[960,Max]",Extremamente Elevado,,,,855,Centro,COIMBRA,0604,13867.47,17733,871,809,717,583,490,1073,1790,2599,3470,127.88,25.02,18.74,12.91
27-01-2022,CONSTÂNCIA,163,12,4048,"[960,Max]",Extremamente Elevado,,,,163,Lisboa e Vale do Tejo,SANTARÉM,1408,8036.58,4030,211,183,187,148,155,303,490,673,884,50.14,11.0,8.37,6.1
27-01-2022,CORUCHE,582,42,3334,"[960,Max]",Extremamente Elevado,,,,582,Lisboa e Vale do Tejo,SANTARÉM,1409,111572.03,17471,1294,1090,1095,1096,1019,2115,3210,4300,5594,15.66,5.01,3.85,2.88
27-01-2022,CORVO,2,0,426,"[240,480]",Elevado,,,,2,Açores,AÇORES,4901,1711.45,464,22,21,11,13,19,32,43,64,86,27.12,5.03,3.74,2.51
27-01-2022,COVILHÃ,2798,200,5980,"[960,Max]",Extremamente Elevado,,,,2798,Centro,CASTELO BRANCO,0503,55560.06,46787,3533,2998,2365,2111,2193,4304,6669,9667,13200,84.21,23.76,17.4,12.0
27-01-2022,CRATO,102,7,3270,"[960,Max]",Extremamente Elevado,,,,102,Alentejo,PORTALEGRE,1206,39806.88,3129,229,258,163,182,228,410,573,831,1060,7.86,2.66,2.09,1.44
27-01-2022,CUBA,150,11,3255,"[960,Max]",Extremamente Elevado,,,,150,Alentejo,BEJA,0207,17208.72,4595,255,233,206,190,143,333,539,772,1027,26.7,5.97,4.49,3.13
27-01-2022,ELVAS,1205,86,5870,"[960,Max]",Extremamente Elevado,,,,1205,Alentejo,PORTALEGRE,1207,63128.86,20528,1057,1145,902,852,810,1662,2564,3709,4766,32.52,7.55,5.88,4.06
27-01-2022,ENTRONCAMENTO,995,71,4616,"[960,Max]",Extremamente Elevado,,,,995,Lisboa e Vale do Tejo,SANTARÉM,1410,1372.81,21558,1066,930,868,695,592,1287,2155,3085,4151,1570.14,302.33,224.69,156.96
27-01-2022,ESPINHO,2315,165,7844,"[960,Max]",Extremamente Elevado,,,,2315,Norte,AVEIRO,0107,2105.68,29516,2205,1993,1430,1177,960,2137,3567,5560,7765,1401.52,368.71,264.01,169.37
27-01-2022,ESPOSENDE,2941,210,8604,"[960,Max]",Extremamente Elevado,,,,2941,Norte,BRAGA,0306,9540.98,34177,1831,1522,1095,894,723,1617,2712,4234,6065,358.21,63.57,44.38,28.42
27-01-2022,ESTARREJA,1868,133,7182,"[960,Max]",Extremamente Elevado,,,,1868,Centro,AVEIRO,0108,10817.33,26006,1503,1399,1106,953,728,1681,2787,4186,5689,240.42,52.59,38.7,25.76
27-01-2022,ESTREMOZ,410,29,3222,"[960,Max]",Extremamente Elevado,,,,410,Alentejo,ÉVORA,0704,51379.95,12728,789,613,697,786,877,1663,2360,2973,3762,24.77,7.32,5.79,4.59
27-01-2022,ÉVORA,3087,221,5889,"[960,Max]",Extremamente Elevado,,,,3087,Alentejo,ÉVORA,0705,130707.58,52428,3569,2852,2176,1966,1803,3769,5945,8797,12366,40.11,9.46,6.73,4.55
27-01-2022,FAFE,4436,317,9231,"[960,Max]",Extremamente Elevado,,,,4436,Norte,BRAGA,0307,21908.11,48060,3044,2455,1679,1403,1208,2611,4290,6745,9789,219.37,44.68,30.79,19.58
27-01-2022,FARO,3607,258,5911,"[960,Max]",Extremamente Elevado,,,,3607,Algarve,FARO,0805,20256.79,61015,3847,3364,2604,2055,1601,3656,6260,9624,13471,301.2,66.5,47.51,30.9
27-01-2022,FELGUEIRAS,4772,341,8457,"[960,Max]",Extremamente Elevado,,,,4772,Norte,PORTO,1303,11573.75,56422,2951,2302,1601,1316,973,2289,3890,6192,9143,487.49,79.0,53.5,33.61
27-01-2022,FERREIRA DO ALENTEJO,326,23,4150,"[960,Max]",Extremamente Elevado,,,,326,Alentejo,BEJA,0208,64820.68,7845,515,414,372,343,345,688,1060,1474,1989,12.1,3.07,2.27,1.64
27-01-2022,FERREIRA DO ZÊZERE,389,28,4891,"[960,Max]",Extremamente Elevado,,,,389,Lisboa e Vale do Tejo,SANTARÉM,1411,19038.03,7959,470,370,416,465,456,921,1337,1707,2177,41.81,11.44,8.97,7.02
27-01-2022,FIGUEIRA DA FOZ,2288,163,3895,"[960,Max]",Extremamente Elevado,,,,2288,Centro,COIMBRA,0605,37905.26,58747,4032,3597,2887,2495,2043,4538,7425,11022,15054,154.98,39.72,29.08,19.59
27-01-2022,FIGUEIRA DE CASTELO RODRIGO,176,13,3150,"[960,Max]",Extremamente Elevado,,,,176,Centro,GUARDA,0904,50857.46,5584,347,352,290,352,391,743,1033,1385,1732,10.98,3.41,2.72,2.03
27-01-2022,FIGUEIRÓ DOS VINHOS,324,23,5822,"[960,Max]",Extremamente Elevado,,,,324,Centro,LEIRIA,1008,17344.0,5568,402,386,322,309,351,660,982,1368,1770,32.1,10.21,7.89,5.66
27-01-2022,FORNOS DE ALGODRES,126,9,2776,"[960,Max]",Extremamente Elevado,,,,126,Centro,GUARDA,0905,13145.05,4528,261,218,247,256,232,488,735,953,1214,34.45,9.24,7.25,5.59
27-01-2022,FREIXO DE ESPADA À CINTA,159,11,4816,"[960,Max]",Extremamente Elevado,,,,159,Norte,BRAGANÇA,0404,24414.29,3298,211,177,231,196,189,385,616,793,1004,13.51,4.11,3.25,2.52
27-01-2022,FRONTEIRA,75,5,2523,"[960,Max]",Extremamente Elevado,,,,75,Alentejo,PORTALEGRE,1208,24859.58,2974,213,182,149,156,168,324,473,655,868,11.96,3.49,2.63,1.9
27-01-2022,FUNCHAL,9129,652,8776,"[960,Max]",Extremamente Elevado,,,,9129,Madeira,MADEIRA,3103,7616.2,104024,6382,5086,3643,2821,1990,4811,8454,13540,19922,1365.86,261.58,177.78,111.0
27-01-2022,FUNDÃO,1586,113,5985,"[960,Max]",Extremamente Elevado,,,,1586,Centro,CASTELO BRANCO,0504,70019.79,26495,1781,1464,1432,1357,1643,3000,4432,5896,7677,37.84,10.96,8.42,6.33
27-01-2022,GAVIÃO,128,9,3927,"[960,Max]",Extremamente Elevado,,,,128,Alentejo,PORTALEGRE,1209,29459.45,3263,189,186,222,263,293,556,778,964,1153,11.08,3.91,3.27,2.64
27-01-2022,GÓIS,143,10,3764,"[960,Max]",Extremamente Elevado,,,,143,Centro,COIMBRA,0606,26330.19,3805,235,199,240,233,244,477,717,916,1151,14.45,4.37,3.48,2.72
27-01-2022,GOLEGÃ,238,17,4462,"[960,Max]",Extremamente Elevado,,,,238,Lisboa e Vale do Tejo,SANTARÉM,1412,8431.67,5339,356,299,281,243,255,498,779,1078,1434,63.32,17.01,12.78,9.24
27-01-2022,GONDOMAR,13463,962,8111,"[960,Max]",Extremamente Elevado,,,,13463,Norte,PORTO,1304,13191.76,165985,10555,8755,6222,4450,3364,7814,14036,22791,33346,1258.22,252.77,172.76,106.4
27-01-2022,GOUVEIA,439,31,3544,"[960,Max]",Extremamente Elevado,,,,439,Centro,GUARDA,0906,30061.17,12387,871,931,780,783,810,1593,2373,3304,4175,41.21,13.89,10.99,7.89
27-01-2022,GRÂNDOLA,756,54,5162,"[960,Max]",Extremamente Elevado,,,,756,Alentejo,SETÚBAL,1505,82593.66,14639,834,834,708,688,672,1360,2068,2902,3736,17.72,4.52,3.51,2.5
27-01-2022,GUARDA,2388,171,6128,"[960,Max]",Extremamente Elevado,,,,2388,Centro,GUARDA,0907,71209.58,38969,2477,2041,1686,1415,1474,2889,4575,6616,9093,54.72,12.77,9.29,6.42
27-01-2022,GUIMARÃES,15133,1081,9936,"[960,Max]",Extremamente Elevado,,,,15133,Norte,BRAGA,0308,24099.96,152309,9394,7074,4809,3877,2948,6825,11634,18708,28102,631.99,116.61,77.63,48.27
27-01-2022,HORTA,324,23,2229,"[960,Max]",Extremamente Elevado,,,,324,Açores,AÇORES,4701,17305.53,14521,818,658,468,352,302,654,1122,1780,2598,83.91,15.01,10.29,6.48
27-01-2022,IDANHA-A-NOVA,291,21,3621,"[960,Max]",Extremamente Elevado,,,,291,Centro,CASTELO BRANCO,0505,141633.51,8043,518,490,519,672,974,1646,2165,2655,3173,5.68,2.24,1.87,1.53
27-01-2022,ÍLHAVO,2653,190,6856,"[960,Max]",Extremamente Elevado,,,,2653,Centro,AVEIRO,0110,7347.55,38699,2227,1943,1444,1193,850,2043,3487,5430,7657,526.66,104.21,73.9,47.46
27-01-2022,LAGOA (FARO),1159,83,5092,"[960,Max]",Extremamente Elevado,,,,1159,Algarve,FARO,0806,8825.45,22762,1314,1168,919,749,670,1419,2338,3506,4820,257.93,54.62,39.73,26.49
27-01-2022,LAGOA,582,42,3953,"[960,Max]",Extremamente Elevado,,,,582,Açores,AÇORES,4201,4559.32,14721,536,458,349,238,235,473,822,1280,1816,322.9,39.83,28.08,18.03
27-01-2022,LAGOS,1889,135,6218,"[960,Max]",Extremamente Elevado,,,,1889,Algarve,FARO,0807,21299.27,30374,1744,1434,1247,1053,1029,2082,3329,4763,6507,142.61,30.55,22.36,15.63
27-01-2022,LAJES DAS FLORES,57,4,3899,"[960,Max]",Extremamente Elevado,,,,57,Açores,AÇORES,4801,7004.79,1463,88,53,62,46,54,100,162,215,303,20.89,4.33,3.07,2.31
27-01-2022,LAJES DO PICO,255,18,5679,"[960,Max]",Extremamente Elevado,,,,255,Açores,AÇORES,4601,15531.09,4490,304,231,223,159,162,321,544,775,1079,28.91,6.95,4.99,3.5
27-01-2022,LAMEGO,1635,117,6568,"[960,Max]",Extremamente Elevado,,,,1635,Norte,VISEU,1805,16542.11,24895,1639,1284,1124,898,783,1681,2805,4089,5728,150.5,34.63,24.72,16.96
27-01-2022,LEIRIA,7133,509,5694,"[960,Max]",Extremamente Elevado,,,,7133,Centro,LEIRIA,1009,56508.83,125267,7389,6366,5090,3902,3159,7061,12151,18517,25906,221.68,45.84,32.77,21.5
27-01-2022,LISBOA,31850,2275,6251,"[960,Max]",Extremamente Elevado,,,,31850,Lisboa e Vale do Tejo,LISBOA,1106,10005.43,509515,33197,33340,27706,23037,26770,49807,77513,110853,144050,5092.6,1439.78,1107.98,774.74
27-01-2022,LOULÉ,3328,238,4844,"[960,Max]",Extremamente Elevado,,,,3328,Algarve,FARO,0808,76366.91,68697,3890,3350,2780,2358,2251,4609,7389,10739,14629,89.96,19.16,14.06,9.68
27-01-2022,LOURES,11221,801,5251,"[960,Max]",Extremamente Elevado,,,,11221,Lisboa e Vale do Tejo,LISBOA,1107,16723.99,213687,12746,12794,9644,6669,5033,11702,21346,34140,46886,1277.73,280.35,204.14,127.64
27-01-2022,LOURINHÃ,1309,94,5064,"[960,Max]",Extremamente Elevado,,,,1309,Lisboa e Vale do Tejo,LISBOA,1108,14717.2,25855,1584,1243,992,842,645,1487,2479,3722,5306,175.68,36.05,25.29,16.84
27-01-2022,LOUSÃ,988,71,5759,"[960,Max]",Extremamente Elevado,,,,988,Centro,COIMBRA,0607,13840.01,17158,946,866,658,528,450,978,1636,2502,3448,123.97,24.91,18.08,11.82
27-01-2022,LOUSADA,4072,291,8710,"[960,Max]",Extremamente Elevado,,,,4072,Norte,PORTO,1305,9608.01,46755,2289,1698,1176,853,621,1474,2650,4348,6637,486.63,69.08,45.25,27.58
27-01-2022,MAÇÃO,237,17,3778,"[960,Max]",Extremamente Elevado,,,,237,Lisboa e Vale do Tejo,SANTARÉM,1413,39997.98,6267,386,362,390,440,657,1097,1487,1849,2235,15.67,5.59,4.62,3.72
27-01-2022,MACEDO DE CAVALEIROS,648,46,4466,"[960,Max]",Extremamente Elevado,,,,648,Norte,BRAGANÇA,0405,69914.08,14516,1082,889,878,823,938,1761,2639,3528,4610,20.76,6.59,5.05,3.77
27-01-2022,MACHICO,1399,100,7001,"[960,Max]",Extremamente Elevado,,,,1399,Madeira,MADEIRA,3104,6825.1,19981,1197,860,662,455,331,786,1448,2308,3505,292.76,51.36,33.82,21.22
27-01-2022,MADALENA,331,24,5607,"[960,Max]",Extremamente Elevado,,,,331,Açores,AÇORES,4602,14712.33,5895,334,256,173,190,179,369,542,798,1132,40.07,7.69,5.42,3.68
27-01-2022,MAFRA,5128,366,6046,"[960,Max]",Extremamente Elevado,,,,5128,Lisboa e Vale do Tejo,LISBOA,1109,29165.5,84816,3613,3334,2839,2089,1899,3988,6827,10161,13774,290.81,47.23,34.84,23.41
27-01-2022,MAIA,11726,838,8438,"[960,Max]",Extremamente Elevado,,,,11726,Norte,PORTO,1306,8293.94,138971,7801,6617,4512,3339,2631,5970,10482,17099,24900,1675.56,300.22,206.16,126.38
27-01-2022,MANGUALDE,1047,75,5659,"[960,Max]",Extremamente Elevado,,,,1047,Centro,VISEU,1806,21925.56,18510,1198,1128,885,852,743,1595,2480,3608,4806,84.42,21.92,16.46,11.31
27-01-2022,MANTEIGAS,47,3,1574,"[960,Max]",Extremamente Elevado,,,,47,Centro,GUARDA,0908,12197.55,3007,258,197,159,167,146,313,472,669,927,24.65,7.6,5.48,3.87
27-01-2022,MARCO DE CANAVESES,4266,305,8284,"[960,Max]",Extremamente Elevado,,,,4266,Norte,PORTO,1307,20188.98,51496,2678,2060,1488,1265,1023,2288,3776,5836,8514,255.07,42.17,28.91,18.7
27-01-2022,MARINHA GRANDE,2258,161,5863,"[960,Max]",Extremamente Elevado,,,,2258,Centro,LEIRIA,1010,18725.19,38508,2365,2302,1638,1359,1058,2417,4055,6357,8722,205.65,46.58,33.95,21.66
27-01-2022,MARVÃO,98,7,3268,"[960,Max]",Extremamente Elevado,,,,98,Alentejo,PORTALEGRE,1210,15489.9,3005,198,185,142,197,237,434,576,761,959,19.4,6.19,4.91,3.72
27-01-2022,MATOSINHOS,13390,956,7636,"[960,Max]",Extremamente Elevado,,,,13390,Norte,PORTO,1308,6241.97,175357,11850,9977,7023,5024,3884,8908,15931,25908,37758,2809.31,604.9,415.06,255.22
27-01-2022,MEALHADA,941,67,4727,"[960,Max]",Extremamente Elevado,,,,941,Centro,AVEIRO,0111,11065.66,19914,1163,1039,810,828,831,1659,2469,3508,4671,179.96,42.21,31.7,22.31
27-01-2022,MÊDA,285,20,6208,"[960,Max]",Extremamente Elevado,,,,285,Centro,GUARDA,0909,28604.92,4587,343,306,290,288,443,731,1021,1327,1670,16.04,5.84,4.64,3.57
27-01-2022,MELGAÇO,265,19,3279,"[960,Max]",Extremamente Elevado,,,,265,Norte,VIANA DO CASTELO,1603,23824.58,8093,507,567,578,614,675,1289,1867,2434,2941,33.97,12.34,10.22,7.84
27-01-2022,MÉRTOLA,188,13,3058,"[960,Max]",Extremamente Elevado,,,,188,Alentejo,BEJA,0209,129287.34,6142,400,390,378,423,600,1023,1401,1791,2191,4.75,1.69,1.39,1.08
27-01-2022,MESÃO FRIO,252,18,6347,"[960,Max]",Extremamente Elevado,,,,252,Norte,VILA REAL,1704,2664.87,3964,265,205,168,157,120,277,445,650,915,148.74,34.33,24.39,16.7
27-01-2022,MIRA,584,42,4934,"[960,Max]",Extremamente Elevado,,,,584,Centro,COIMBRA,0608,12403.38,11832,727,729,659,550,466,1016,1675,2404,3131,95.4,25.24,19.38,13.5
27-01-2022,MIRANDA DO CORVO,586,42,4609,"[960,Max]",Extremamente Elevado,,,,586,Centro,COIMBRA,0609,12637.79,12708,706,659,568,498,404,902,1470,2129,2835,100.55,22.43,16.85,11.63
27-01-2022,MIRANDA DO DOURO,210,15,3076,"[960,Max]",Extremamente Elevado,,,,210,Norte,BRAGANÇA,0406,48718.31,6830,482,429,442,463,470,933,1375,1804,2286,14.02,4.69,3.7,2.82
27-01-2022,MIRANDELA,1149,82,5281,"[960,Max]",Extremamente Elevado,,,,1149,Norte,BRAGANÇA,0407,65895.67,21754,1640,1315,1204,1078,947,2025,3229,4544,6184,33.01,9.38,6.9,4.9
27-01-2022,MOGADOURO,259,19,3090,"[960,Max]",Extremamente Elevado,,,,259,Norte,BRAGANÇA,0408,76064.93,8392,589,529,576,630,655,1285,1861,2390,2979,11.03,3.92,3.14,2.45
27-01-2022,MOIMENTA DA BEIRA,406,29,4170,"[960,Max]",Extremamente Elevado,,,,406,Norte,VISEU,1807,21996.9,9736,576,514,471,416,461,877,1348,1862,2438,44.26,11.08,8.46,6.13
27-01-2022,MOITA,3752,268,5825,"[960,Max]",Extremamente Elevado,,,,3752,Lisboa e Vale do Tejo,SETÚBAL,1506,5525.98,64407,4226,3646,2623,1801,1425,3226,5849,9495,13721,1165.53,248.3,171.82,105.85
27-01-2022,MONÇÃO,1088,78,6087,"[960,Max]",Extremamente Elevado,,,,1088,Norte,VIANA DO CASTELO,1604,21130.85,17869,1161,1105,1031,1006,972,1978,3009,4114,5275,84.56,24.96,19.47,14.24
27-01-2022,MONCHIQUE,116,8,2290,"[960,Max]",Extremamente Elevado,,,,116,Algarve,FARO,0809,39530.43,5077,353,384,321,355,392,747,1068,1452,1805,12.84,4.57,3.67,2.7
27-01-2022,MONDIM DE BASTO,382,27,5494,"[960,Max]",Extremamente Elevado,,,,382,Norte,VILA REAL,1705,17207.52,6946,395,300,314,284,283,567,881,1181,1576,40.36,9.16,6.86,5.12
27-01-2022,MONFORTE,83,6,2782,"[960,Max]",Extremamente Elevado,,,,83,Alentejo,PORTALEGRE,1211,42024.82,2975,139,115,117,192,168,360,477,592,731,7.08,1.74,1.41,1.14
27-01-2022,MONTALEGRE,414,30,4605,"[960,Max]",Extremamente Elevado,,,,414,Norte,VILA REAL,1706,80545.71,8997,699,628,595,603,730,1333,1928,2556,3255,11.17,4.04,3.17,2.39
27-01-2022,MONTEMOR-O-NOVO,589,42,3763,"[960,Max]",Extremamente Elevado,,,,589,Alentejo,ÉVORA,0706,123296.65,15647,991,953,868,878,971,1849,2717,3670,4661,12.69,3.78,2.98,2.2
27-01-2022,MONTEMOR-O-VELHO,1181,84,4681,"[960,Max]",Extremamente Elevado,,,,1181,Centro,COIMBRA,0610,22896.23,25224,1496,1397,1217,1057,988,2045,3262,4659,6155,110.17,26.88,20.35,14.25
27-01-2022,MONTIJO,2900,207,5033,"[960,Max]",Extremamente Elevado,,,,2900,Lisboa e Vale do Tejo,SETÚBAL,1507,34861.64,57614,2771,2441,1990,1554,1109,2663,4653,7094,9865,165.26,28.3,20.35,13.35
27-01-2022,MORA,64,5,1536,"[960,Max]",Extremamente Elevado,,,,64,Alentejo,ÉVORA,0707,44395.02,4138,336,275,252,238,257,495,747,1022,1358,9.32,3.06,2.3,1.68
27-01-2022,MORTÁGUA,314,22,3562,"[960,Max]",Extremamente Elevado,,,,314,Centro,VISEU,1808,25117.82,8803,638,584,535,499,460,959,1494,2078,2716,35.05,10.81,8.27,5.95
27-01-2022,MOURA,623,45,4542,"[960,Max]",Extremamente Elevado,,,,623,Alentejo,BEJA,0210,95845.55,13718,817,656,665,542,461,1003,1668,2324,3141,14.31,3.28,2.42,1.74
27-01-2022,MOURÃO,49,4,2014,"[960,Max]",Extremamente Elevado,,,,49,Alentejo,ÉVORA,0708,27862.98,2450,139,108,80,104,109,213,293,401,540,8.79,1.94,1.44,1.05
27-01-2022,MURÇA,200,14,3667,"[960,Max]",Extremamente Elevado,,,,200,Norte,VILA REAL,1707,18937.11,5463,384,341,307,306,319,625,932,1273,1657,28.85,8.75,6.72,4.92
27-01-2022,MURTOSA,702,50,6833,"[960,Max]",Extremamente Elevado,,,,702,Centro,AVEIRO,0112,7308.78,10279,509,473,403,353,409,762,1165,1638,2147,140.63,29.37,22.41,15.94
27-01-2022,NAZARÉ,915,65,6458,"[960,Max]",Extremamente Elevado,,,,915,Lisboa e Vale do Tejo,LEIRIA,1011,8243.43,14165,967,903,670,420,396,816,1486,2389,3356,171.84,40.71,28.98,18.03
27-01-2022,NELAS,673,48,5191,"[960,Max]",Extremamente Elevado,,,,673,Centro,VISEU,1809,12571.48,12974,924,787,668,604,583,1187,1855,2642,3566,103.21,28.37,21.02,14.76
27-01-2022,NISA,454,32,7484,"[960,Max]",Extremamente Elevado,,,,454,Alentejo,PORTALEGRE,1212,57567.84,6061,405,389,355,483,478,961,1316,1705,2110,10.53,3.67,2.96,2.29
27-01-2022,NORDESTE,400,29,8217,"[960,Max]",Extremamente Elevado,,,,400,Açores,AÇORES,4202,10146.8,4862,246,180,124,161,162,323,447,627,873,47.92,8.6,6.18,4.41
27-01-2022,ÓBIDOS,497,35,4192,"[960,Max]",Extremamente Elevado,,,,497,Lisboa e Vale do Tejo,LEIRIA,1012,14155.44,11850,743,650,574,452,436,888,1462,2112,2855,83.72,20.17,14.92,10.33
27-01-2022,ODEMIRA,850,61,3440,"[960,Max]",Extremamente Elevado,,,,850,Alentejo,BEJA,0211,172060.15,24717,1475,1317,1225,1397,1349,2746,3971,5288,6763,14.37,3.93,3.07,2.31
27-01-2022,ODIVELAS,8244,589,5096,"[960,Max]",Extremamente Elevado,,,,8244,Lisboa e Vale do Tejo,LISBOA,1116,2654.36,161774,9562,9038,6952,4641,3812,8453,15405,24443,34005,6095.48,1281.27,920.99,580.44
27-01-2022,OEIRAS,10549,753,5946,"[960,Max]",Extremamente Elevado,,,,10549,Lisboa e Vale do Tejo,LISBOA,1110,4588.31,177408,11580,11575,8566,6211,5855,12066,20632,32207,43787,3866.78,954.38,701.98,449.69
27-01-2022,OLEIROS,165,12,3294,"[960,Max]",Extremamente Elevado,,,,165,Centro,CASTELO BRANCO,0506,47109.31,5003,384,341,366,397,487,884,1250,1591,1975,10.62,4.19,3.38,2.65
27-01-2022,OLHÃO,2658,190,5985,"[960,Max]",Extremamente Elevado,,,,2658,Algarve,FARO,0810,13086.38,44405,2455,2309,1689,1342,1268,2610,4299,6608,9063,339.33,69.26,50.5,32.85
27-01-2022,OLIVEIRA DE AZEMÉIS,5901,422,8940,"[960,Max]",Extremamente Elevado,,,,5901,Norte,AVEIRO,0113,16110.41,66011,4155,3614,2794,2183,1738,3921,6715,10329,14484,409.75,89.91,64.12,41.68
27-01-2022,OLIVEIRA DE FRADES,738,53,7431,"[960,Max]",Extremamente Elevado,,,,738,Centro,VISEU,1810,14534.62,9936,553,475,438,359,415,774,1212,1687,2240,68.36,15.41,11.61,8.34
27-01-2022,OLIVEIRA DO BAIRRO,1830,131,7537,"[960,Max]",Extremamente Elevado,,,,1830,Centro,AVEIRO,0114,8731.99,24277,1327,1182,999,786,810,1596,2595,3777,5104,278.02,58.45,43.25,29.72
27-01-2022,OLIVEIRA DO HOSPITAL,652,47,3387,"[960,Max]",Extremamente Elevado,,,,652,Centro,COIMBRA,0611,23451.66,19253,1161,1097,962,924,960,1884,2846,3943,5104,82.1,21.76,16.81,12.14
27-01-2022,OURÉM,2745,196,6232,"[960,Max]",Extremamente Elevado,,,,2745,Lisboa e Vale do Tejo,SANTARÉM,1421,41668.03,44044,2463,2069,1899,1817,1603,3420,5319,7388,9851,105.7,23.64,17.73,12.77
27-01-2022,OURIQUE,206,15,4466,"[960,Max]",Extremamente Elevado,,,,206,Alentejo,BEJA,0212,66331.36,4607,313,287,284,268,227,495,779,1066,1379,6.95,2.08,1.61,1.17
27-01-2022,OVAR,4469,319,8237,"[960,Max]",Extremamente Elevado,,,,4469,Centro,AVEIRO,0115,14770.25,54260,3294,2709,1994,1636,1234,2870,4864,7573,10867,367.37,73.57,51.27,32.93
27-01-2022,PAÇOS DE FERREIRA,4530,324,7986,"[960,Max]",Extremamente Elevado,,,,4530,Norte,PORTO,1309,7099.29,56728,2903,2193,1518,1135,664,1799,3317,5510,8413,799.1,118.51,77.62,46.72
27-01-2022,PALMELA,3751,268,5836,"[960,Max]",Extremamente Elevado,,,,3751,Lisboa e Vale do Tejo,SETÚBAL,1508,46512.01,64269,3402,3244,2635,1846,1391,3237,5872,9116,12518,138.18,26.91,19.6,12.62
27-01-2022,PAMPILHOSA DA SERRA,75,5,1860,"[960,Max]",Extremamente Elevado,,,,75,Centro,COIMBRA,0612,39646.24,4037,238,254,295,339,423,762,1057,1311,1549,10.18,3.91,3.31,2.67
27-01-2022,PAREDES,7563,540,8787,"[960,Max]",Extremamente Elevado,,,,7563,Norte,PORTO,1310,15675.69,86067,4272,3532,2412,1717,1258,2975,5387,8919,13191,549.04,84.15,56.9,34.36
27-01-2022,PAREDES DE COURA,619,44,7247,"[960,Max]",Extremamente Elevado,,,,619,Norte,VIANA DO CASTELO,1605,13818.59,8535,466,528,407,465,515,980,1387,1915,2381,61.76,17.23,13.86,10.04
27-01-2022,PEDRÓGÃO GRANDE,152,11,4451,"[960,Max]",Extremamente Elevado,,,,152,Centro,LEIRIA,1013,12874.75,3410,175,173,196,221,252,473,669,842,1017,26.49,7.9,6.54,5.2
27-01-2022,PENACOVA,408,29,2983,"[960,Max]",Extremamente Elevado,,,,408,Centro,COIMBRA,0613,21673.23,13694,968,923,745,621,703,1324,2069,2992,3960,63.18,18.27,13.81,9.55
27-01-2022,PENAFIEL,5670,405,8127,"[960,Max]",Extremamente Elevado,,,,5670,Norte,PORTO,1311,21224.27,69772,3648,2823,2032,1663,1230,2893,4925,7748,11396,328.74,53.69,36.51,23.2
27-01-2022,PENALVA DO CASTELO,262,19,3681,"[960,Max]",Extremamente Elevado,,,,262,Centro,VISEU,1811,13433.92,7115,449,457,413,391,426,817,1230,1687,2136,52.96,15.9,12.56,9.16
27-01-2022,PENAMACOR,64,5,1355,"[960,Max]",Extremamente Elevado,,,,64,Centro,CASTELO BRANCO,0507,56370.69,4755,262,248,273,451,633,1084,1357,1605,1867,8.44,3.31,2.85,2.41
27-01-2022,PENEDONO,122,9,4705,"[960,Max]",Extremamente Elevado,,,,122,Norte,VISEU,1812,13370.75,2591,172,113,129,156,138,294,423,536,708,19.38,5.3,4.01,3.16
27-01-2022,PENELA,224,16,4158,"[960,Max]",Extremamente Elevado,,,,224,Centro,COIMBRA,0614,13480.0,5397,314,324,274,359,344,703,977,1301,1615,40.04,11.98,9.65,7.25
27-01-2022,PENICHE,1154,82,4355,"[960,Max]",Extremamente Elevado,,,,1154,Lisboa e Vale do Tejo,LEIRIA,1014,7754.98,26501,1746,1504,1203,926,707,1633,2836,4340,6086,341.73,78.48,55.96,36.57
27-01-2022,PESO DA RÉGUA,1019,73,6458,"[960,Max]",Extremamente Elevado,,,,1019,Norte,VILA REAL,1708,9486.01,15773,1076,843,650,659,455,1114,1764,2607,3683,166.28,38.83,27.48,18.6
27-01-2022,PINHEL,311,22,3653,"[960,Max]",Extremamente Elevado,,,,311,Centro,GUARDA,0910,48452.12,8511,577,566,551,538,689,1227,1778,2344,2921,17.57,6.03,4.84,3.67
27-01-2022,POMBAL,2641,189,5133,"[960,Max]",Extremamente Elevado,,,,2641,Centro,LEIRIA,1015,62600.28,51461,3187,2791,2494,2328,2027,4355,6849,9640,12827,82.21,20.49,15.4,10.94
27-01-2022,PONTA DELGADA,2947,211,4338,"[960,Max]",Extremamente Elevado,,,,2947,Açores,AÇORES,4203,23298.65,67935,3108,2435,1726,1133,902,2035,3761,6196,9304,291.58,39.93,26.59,16.14
27-01-2022,PONTA DO SOL,615,44,7155,"[960,Max]",Extremamente Elevado,,,,615,Madeira,MADEIRA,3105,4622.03,8593,319,283,347,208,221,429,776,1059,1378,185.92,29.81,22.91,16.79
27-01-2022,PONTE DA BARCA,491,35,4388,"[960,Max]",Extremamente Elevado,,,,491,Norte,VIANA DO CASTELO,1606,18211.37,11180,635,576,517,554,490,1044,1561,2137,2772,61.39,15.22,11.73,8.57
27-01-2022,PONTE DE LIMA,2550,182,6172,"[960,Max]",Extremamente Elevado,,,,2550,Norte,VIANA DO CASTELO,1607,32025.46,41315,2321,2022,1720,1596,1462,3058,4778,6800,9121,129.01,28.48,21.23,14.92
27-01-2022,PONTE DE SOR,620,44,4136,"[960,Max]",Extremamente Elevado,,,,620,Alentejo,PORTALEGRE,1213,83971.16,14994,939,800,716,739,831,1570,2286,3086,4025,17.86,4.79,3.68,2.72
27-01-2022,PORTALEGRE,1221,87,5507,"[960,Max]",Extremamente Elevado,,,,1221,Alentejo,PORTALEGRE,1214,44713.64,22172,1577,1351,1137,993,984,1977,3114,4465,6042,49.59,13.51,9.99,6.96
27-01-2022,PORTEL,227,16,3896,"[960,Max]",Extremamente Elevado,,,,227,Alentejo,ÉVORA,0709,60100.57,5828,336,358,283,331,305,636,919,1277,1613,9.7,2.68,2.12,1.53
27-01-2022,PORTIMÃO,3054,218,5504,"[960,Max]",Extremamente Elevado,,,,3054,Algarve,FARO,0811,18206.29,55483,3182,2927,2116,1582,1400,2982,5098,8025,11207,304.75,61.56,44.08,28.0
27-01-2022,PORTO,17539,1253,8097,"[960,Max]",Extremamente Elevado,,,,17539,Norte,PORTO,1312,4142.02,216606,15790,15193,11280,9409,10044,19453,30733,45926,61716,5229.5,1490.0,1108.79,741.98
27-01-2022,PORTO DE MÓS,1157,83,4969,"[960,Max]",Extremamente Elevado,,,,1157,Centro,LEIRIA,1016,26183.41,23275,1355,1210,1034,888,872,1760,2794,4004,5359,88.89,20.47,15.29,10.67
27-01-2022,PORTO MONIZ,126,9,5363,"[960,Max]",Extremamente Elevado,,,,126,Madeira,MADEIRA,3106,8293.38,2342,143,130,95,98,120,218,313,443,586,28.24,7.07,5.34,3.77
27-01-2022,PORTO SANTO,145,10,2790,"[960,Max]",Extremamente Elevado,,,,145,Madeira,MADEIRA,3201,4300.7,5202,240,157,134,110,68,178,312,469,709,120.95,16.48,10.9,7.25
27-01-2022,PÓVOA DE LANHOSO,1785,127,8301,"[960,Max]",Extremamente Elevado,,,,1785,Norte,BRAGA,0309,13465.29,21499,1175,909,732,673,624,1297,2029,2938,4113,159.67,30.55,21.82,15.07
27-01-2022,PÓVOA DE VARZIM,5159,368,8217,"[960,Max]",Extremamente Elevado,,,,5159,Norte,PORTO,1313,8220.59,62784,3712,3120,2134,1594,1305,2899,5033,8153,11865,763.7,144.33,99.17,61.22
27-01-2022,POVOAÇÃO,310,22,5224,"[960,Max]",Extremamente Elevado,,,,310,Açores,AÇORES,4204,10640.77,5927,293,212,191,144,134,278,469,681,974,55.7,9.15,6.4,4.41
27-01-2022,VILA DA PRAIA DA VITÓRIA,1057,76,4960,"[960,Max]",Extremamente Elevado,,,,1057,Açores,AÇORES,4302,16127.06,21317,1133,789,619,436,336,772,1391,2180,3313,132.18,20.54,13.52,8.63
27-01-2022,PROENÇA-A-NOVA,389,28,5329,"[960,Max]",Extremamente Elevado,,,,389,Centro,CASTELO BRANCO,0508,39539.96,7298,508,465,389,400,560,960,1349,1814,2322,18.46,5.87,4.59,3.41
27-01-2022,REDONDO,211,15,3326,"[960,Max]",Extremamente Elevado,,,,211,Alentejo,ÉVORA,0710,36950.87,6353,349,325,288,288,354,642,930,1255,1604,17.19,4.34,3.4,2.52
27-01-2022,REGUENGOS DE MONSARAZ,292,21,2911,"[960,Max]",Extremamente Elevado,,,,292,Alentejo,ÉVORA,0711,46399.72,10015,602,511,455,462,473,935,1390,1901,2503,21.58,5.39,4.1,3.0
27-01-2022,RESENDE,609,43,6007,"[960,Max]",Extremamente Elevado,,,,609,Norte,VISEU,1813,12334.93,10137,560,493,448,433,422,855,1303,1796,2356,82.18,19.1,14.56,10.56
27-01-2022,RIBEIRA BRAVA,1211,86,9736,"[960,Max]",Extremamente Elevado,,,,1211,Madeira,MADEIRA,3107,6544.88,12435,648,500,411,311,287,598,1009,1509,2157,189.99,32.96,23.06,15.42
27-01-2022,RIBEIRA DE PENA,297,21,4944,"[960,Max]",Extremamente Elevado,,,,297,Norte,VILA REAL,1709,21745.98,6016,371,301,290,310,368,678,968,1269,1640,27.66,7.54,5.84,4.45
27-01-2022,RIBEIRA GRANDE,2656,190,8095,"[960,Max]",Extremamente Elevado,,,,2656,Açores,AÇORES,4205,18015.13,32811,1163,689,512,345,253,598,1110,1799,2962,182.13,16.44,9.99,6.16
27-01-2022,RIO MAIOR,1041,74,5106,"[960,Max]",Extremamente Elevado,,,,1041,Lisboa e Vale do Tejo,SANTARÉM,1414,27276.45,20379,1251,1144,941,795,648,1443,2384,3528,4779,74.71,17.52,12.93,8.74
27-01-2022,SABROSA,265,19,4471,"[960,Max]",Extremamente Elevado,,,,265,Norte,VILA REAL,1710,15692.45,5918,393,314,304,302,350,652,956,1270,1663,37.71,10.6,8.09,6.09
27-01-2022,SABUGAL,291,21,2746,"[960,Max]",Extremamente Elevado,,,,291,Centro,GUARDA,0911,82269.82,10585,724,707,694,796,1009,1805,2499,3206,3930,12.87,4.78,3.9,3.04
27-01-2022,SALVATERRA DE MAGOS,848,61,3980,"[960,Max]",Extremamente Elevado,,,,848,Lisboa e Vale do Tejo,SANTARÉM,1415,24393.2,21295,1275,1181,1060,799,772,1571,2631,3812,5087,87.3,20.85,15.63,10.79
27-01-2022,SANTA COMBA DÃO,667,48,6386,"[960,Max]",Extremamente Elevado,,,,667,Centro,VISEU,1814,11194.77,10452,732,684,569,538,464,1002,1571,2255,2987,93.36,26.68,20.14,14.03
27-01-2022,SANTA CRUZ,3406,243,7521,"[960,Max]",Extremamente Elevado,,,,3406,Madeira,MADEIRA,3108,8150.28,45281,1817,1301,974,716,523,1239,2213,3514,5331,555.6,65.41,43.12,27.15
27-01-2022,SANTA CRUZ DA GRACIOSA,62,4,1484,"[960,Max]",Extremamente Elevado,,,,62,Açores,AÇORES,4401,6065.78,4208,228,180,163,124,145,269,432,612,840,69.37,13.85,10.09,7.12
27-01-2022,SANTA CRUZ DAS FLORES,75,5,3464,"[960,Max]",Extremamente Elevado,,,,75,Açores,AÇORES,4802,7091.44,2165,125,98,74,56,51,107,181,279,404,30.53,5.7,3.93,2.55
27-01-2022,SANTA MARIA DA FEIRA,11772,841,8491,"[960,Max]",Extremamente Elevado,,,,11772,Norte,AVEIRO,0109,21587.65,138636,8182,6743,4771,3856,3079,6935,11706,18449,26631,642.19,123.36,85.46,54.22
27-01-2022,SANTA MARTA DE PENAGUIÃO,258,18,3905,"[960,Max]",Extremamente Elevado,,,,258,Norte,VILA REAL,1711,6928.13,6599,483,373,337,316,317,633,970,1343,1826,95.25,26.36,19.39,14.0
27-01-2022,SANTANA,404,29,6017,"[960,Max]",Extremamente Elevado,,,,404,Madeira,MADEIRA,3109,9547.3,6711,418,353,343,282,277,559,902,1255,1673,70.29,17.52,13.15,9.45
27-01-2022,SANTARÉM,3064,219,5336,"[960,Max]",Extremamente Elevado,,,,3064,Lisboa e Vale do Tejo,SANTARÉM,1416,55253.58,57421,3654,3441,2760,2466,2206,4672,7432,10873,14527,103.92,26.29,19.68,13.45
27-01-2022,SANTIAGO DO CACÉM,1102,79,3827,"[960,Max]",Extremamente Elevado,,,,1102,Alentejo,SETÚBAL,1509,105969.29,28791,2144,1689,1472,1295,1215,2510,3982,5671,7815,27.17,7.37,5.35,3.76
27-01-2022,SANTO TIRSO,4846,346,7120,"[960,Max]",Extremamente Elevado,,,,4846,Norte,PORTO,1314,13655.52,68055,4911,3935,2761,2257,1810,4067,6828,10763,15674,498.35,114.78,78.82,50.0
27-01-2022,SÃO BRÁS DE ALPORTEL,445,32,4271,"[960,Max]",Extremamente Elevado,,,,445,Algarve,FARO,0812,15336.92,10416,596,468,467,404,401,805,1272,1740,2336,67.91,15.23,11.35,8.29
27-01-2022,SÃO JOÃO DA MADEIRA,2245,160,10222,"[960,Max]",Extremamente Elevado,,,,2245,Norte,AVEIRO,0116,794.3,21958,1347,1069,796,601,593,1194,1990,3059,4406,2765.49,554.91,385.26,250.63
27-01-2022,SÃO JOÃO DA PESQUEIRA,510,36,7153,"[960,Max]",Extremamente Elevado,,,,510,Norte,VISEU,1815,26610.85,7125,417,330,294,328,328,656,950,1280,1697,26.77,6.38,4.81,3.57
27-01-2022,SÃO PEDRO DO SUL,1080,77,7010,"[960,Max]",Extremamente Elevado,,,,1080,Centro,VISEU,1816,34895.09,15403,990,962,861,759,909,1668,2529,3491,4481,44.14,12.84,10.0,7.25
27-01-2022,SÃO ROQUE DO PICO,173,12,5310,"[960,Max]",Extremamente Elevado,,,,173,Açores,AÇORES,4603,14236.1,3266,199,141,93,96,113,209,302,443,642,22.94,4.51,3.11,2.12
27-01-2022,SÃO VICENTE,363,26,7060,"[960,Max]",Extremamente Elevado,,,,363,Madeira,MADEIRA,3110,7883.71,5143,272,264,266,225,280,505,771,1035,1307,65.23,16.58,13.13,9.78
27-01-2022,SARDOAL,153,11,4089,"[960,Max]",Extremamente Elevado,,,,153,Lisboa e Vale do Tejo,SANTARÉM,1417,9214.72,3741,227,178,148,165,248,413,561,739,966,40.6,10.48,8.02,6.09
27-01-2022,SÁTÃO,696,50,6008,"[960,Max]",Extremamente Elevado,,,,696,Centro,VISEU,1817,20194.11,11580,765,671,515,465,476,941,1456,2127,2892,57.34,14.32,10.53,7.21
27-01-2022,SEIA,1117,80,5025,"[960,Max]",Extremamente Elevado,,,,1117,Centro,GUARDA,0912,43568.83,22234,1807,1589,1238,1122,721,1843,3081,4670,6477,51.03,14.87,10.72,7.07
27-01-2022,SEIXAL,8978,641,5352,"[960,Max]",Extremamente Elevado,,,,8978,Lisboa e Vale do Tejo,SETÚBAL,1510,9545.17,167752,10586,9270,6661,4391,2930,7321,13982,23252,33838,1757.49,354.51,243.6,146.49
27-01-2022,SERNANCELHE,224,16,4149,"[960,Max]",Extremamente Elevado,,,,224,Norte,VISEU,1818,22861.22,5396,305,293,286,273,260,533,819,1112,1417,23.6,6.2,4.86,3.58
27-01-2022,SERPA,608,43,4253,"[960,Max]",Extremamente Elevado,,,,608,Alentejo,BEJA,0213,110563.34,14304,903,761,719,697,626,1323,2042,2803,3706,12.94,3.35,2.54,1.85
27-01-2022,SERTÃ,834,60,5720,"[960,Max]",Extremamente Elevado,,,,834,Centro,CASTELO BRANCO,0509,44673.17,14577,870,779,790,767,1020,1787,2577,3356,4226,32.63,9.46,7.51,5.77
27-01-2022,SESIMBRA,2353,168,4538,"[960,Max]",Extremamente Elevado,,,,2353,Lisboa e Vale do Tejo,SETÚBAL,1511,19571.75,51858,2400,2321,1853,1257,1083,2340,4193,6514,8914,264.96,45.54,33.28,21.42
27-01-2022,SETÚBAL,6954,497,6040,"[960,Max]",Extremamente Elevado,,,,6954,Lisboa e Vale do Tejo,SETÚBAL,1512,23032.5,115126,7425,6929,5075,3775,2655,6430,11505,18434,25859,499.83,112.27,80.03,49.95
27-01-2022,SEVER DO VOUGA,795,57,7013,"[960,Max]",Extremamente Elevado,,,,795,Centro,AVEIRO,0117,12987.56,11331,766,637,568,540,567,1107,1675,2312,3078,87.24,23.7,17.8,12.9
27-01-2022,SILVES,1699,121,4689,"[960,Max]",Extremamente Elevado,,,,1699,Algarve,FARO,0813,68006.23,36226,2137,1869,1610,1423,1600,3023,4633,6502,8639,53.27,12.7,9.56,6.81
27-01-2022,SINES,776,55,5661,"[960,Max]",Extremamente Elevado,,,,776,Alentejo,SETÚBAL,1513,20330.17,13715,888,791,551,416,268,684,1235,2026,2914,67.46,14.33,9.97,6.07
27-01-2022,SINTRA,19159,1369,4895,"[960,Max]",Extremamente Elevado,,,,19159,Lisboa e Vale do Tejo,LISBOA,1111,31922.73,391402,20490,18316,13545,9137,7284,16421,29966,48282,68772,1226.08,215.43,151.25,93.87
27-01-2022,SOBRAL DE MONTE AGRAÇO,688,49,6461,"[960,Max]",Extremamente Elevado,,,,688,Lisboa e Vale do Tejo,LISBOA,1112,5210.32,10651,564,507,352,272,212,484,836,1343,1907,204.43,36.6,25.78,16.05
27-01-2022,SOURE,985,70,5752,"[960,Max]",Extremamente Elevado,,,,985,Centro,COIMBRA,0615,26506.07,17120,1173,1142,1004,883,987,1870,2874,4016,5189,64.59,19.58,15.15,10.84
27-01-2022,SOUSEL,143,10,3235,"[960,Max]",Extremamente Elevado,,,,143,Alentejo,PORTALEGRE,1215,27932.18,4412,261,274,208,302,292,594,802,1076,1337,15.8,4.79,3.85,2.87
27-01-2022,TÁBUA,574,41,5053,"[960,Max]",Extremamente Elevado,,,,574,Centro,COIMBRA,0616,19978.58,11368,729,584,524,430,464,894,1418,2002,2731,56.9,13.67,10.02,7.1
27-01-2022,TABUAÇO,250,18,4136,"[960,Max]",Extremamente Elevado,,,,250,Norte,VISEU,1819,13385.67,6033,372,314,217,282,363,645,862,1176,1548,45.07,11.56,8.79,6.44
27-01-2022,TAROUCA,370,26,4744,"[960,Max]",Extremamente Elevado,,,,370,Norte,VISEU,1820,10008.49,7804,405,335,313,277,324,601,914,1249,1654,77.98,16.53,12.48,9.13
27-01-2022,TAVIRA,1118,80,4557,"[960,Max]",Extremamente Elevado,,,,1118,Algarve,FARO,0814,60696.7,24530,1493,1415,1252,1066,1277,2343,3595,5010,6503,40.41,10.71,8.25,5.92
27-01-2022,TERRAS DE BOURO,460,33,7237,"[960,Max]",Extremamente Elevado,,,,460,Norte,BRAGA,0310,27746.07,6361,391,372,296,319,340,659,955,1327,1718,22.93,6.19,4.78,3.44
27-01-2022,TOMAR,1981,142,5392,"[960,Max]",Extremamente Elevado,,,,1981,Lisboa e Vale do Tejo,SANTARÉM,1418,35120.44,36748,2403,2189,1868,1853,1822,3675,5543,7732,10135,104.64,28.86,22.02,15.78
27-01-2022,TONDELA,1472,105,5585,"[960,Max]",Extremamente Elevado,,,,1472,Centro,VISEU,1821,37121.73,26357,1768,1722,1518,1475,1417,2892,4410,6132,7900,71.0,21.28,16.52,11.88
27-01-2022,TORRE DE MONCORVO,260,19,3378,"[960,Max]",Extremamente Elevado,,,,260,Norte,BRAGANÇA,0409,53155.67,7695,556,478,488,551,719,1270,1758,2236,2792,14.48,5.25,4.21,3.31
27-01-2022,TORRES NOVAS,1779,127,5094,"[960,Max]",Extremamente Elevado,,,,1779,Lisboa e Vale do Tejo,SANTARÉM,1419,26999.68,34933,2324,1979,1738,1406,1475,2881,4619,6598,8922,129.38,33.04,24.44,17.11
27-01-2022,TORRES VEDRAS,4454,318,5672,"[960,Max]",Extremamente Elevado,,,,4454,Lisboa e Vale do Tejo,LISBOA,1113,40714.89,78530,4513,3945,3447,2628,2104,4732,8179,12124,16637,192.88,40.86,29.78,20.09
27-01-2022,TRANCOSO,434,31,4889,"[960,Max]",Extremamente Elevado,,,,434,Centro,GUARDA,0913,36152.47,8875,581,557,542,586,496,1082,1624,2181,2762,24.55,7.64,6.03,4.49
27-01-2022,TROFA,3055,218,7953,"[960,Max]",Extremamente Elevado,,,,3055,Norte,PORTO,1318,7201.76,38418,2336,1894,1231,939,684,1623,2854,4748,7084,533.44,98.36,65.93,39.63
27-01-2022,VAGOS,1472,105,6475,"[960,Max]",Extremamente Elevado,,,,1472,Centro,AVEIRO,0118,16491.5,22740,1320,1205,922,784,724,1508,2430,3635,4955,137.89,30.04,22.04,14.73
27-01-2022,VALE DE CAMBRA,1801,129,8445,"[960,Max]",Extremamente Elevado,,,,1801,Norte,AVEIRO,0119,14733.47,21327,1491,1363,1005,831,798,1629,2634,3997,5488,144.76,37.25,27.13,17.88
27-01-2022,VALENÇA,781,56,5874,"[960,Max]",Extremamente Elevado,,,,781,Norte,VIANA DO CASTELO,1608,11712.86,13290,867,791,582,582,503,1085,1667,2458,3325,113.46,28.39,20.99,14.23
27-01-2022,VALONGO,7642,546,7842,"[960,Max]",Extremamente Elevado,,,,7642,Norte,PORTO,1315,7512.45,97444,5629,4696,3207,2462,1829,4291,7498,12194,17823,1297.18,237.26,162.33,99.81
27-01-2022,VALPAÇOS,687,49,4636,"[960,Max]",Extremamente Elevado,,,,687,Norte,VILA REAL,1712,54873.93,14818,1217,1118,999,928,997,1925,2924,4042,5259,27.0,9.58,7.37,5.33
27-01-2022,VELAS,159,11,3117,"[960,Max]",Extremamente Elevado,,,,159,Açores,AÇORES,4502,11738.38,5093,278,208,166,153,113,266,432,640,918,43.39,7.82,5.45,3.68
27-01-2022,VENDAS NOVAS,554,40,4926,"[960,Max]",Extremamente Elevado,,,,554,Alentejo,ÉVORA,0712,22238.88,11255,677,768,655,501,532,1033,1688,2456,3133,50.61,14.09,11.04,7.59
27-01-2022,VIANA DO ALENTEJO,203,14,3936,"[960,Max]",Extremamente Elevado,,,,203,Alentejo,ÉVORA,0713,39367.29,5145,245,208,235,210,214,424,659,867,1112,13.07,2.82,2.2,1.67
27-01-2022,VIANA DO CASTELO,5194,371,6153,"[960,Max]",Extremamente Elevado,,,,5194,Norte,VIANA DO CASTELO,1609,31902.01,84417,5470,4433,3591,3061,2982,6043,9634,14067,19537,264.61,61.24,44.09,30.2
27-01-2022,VIDIGUEIRA,291,21,5280,"[960,Max]",Extremamente Elevado,,,,291,Alentejo,BEJA,0214,31661.09,5510,300,248,215,233,275,508,723,971,1271,17.4,4.01,3.07,2.28
27-01-2022,VIEIRA DO MINHO,759,54,6406,"[960,Max]",Extremamente Elevado,,,,759,Norte,BRAGA,0311,21644.35,11842,703,594,525,548,482,1030,1555,2149,2852,54.71,13.18,9.93,7.18
27-01-2022,VILA DE REI,122,9,3685,"[960,Max]",Extremamente Elevado,,,,122,Centro,CASTELO BRANCO,0510,19154.6,3323,169,128,172,247,302,549,721,849,1018,17.35,5.31,4.43,3.76
27-01-2022,VILA DO BISPO,170,12,3303,"[960,Max]",Extremamente Elevado,,,,170,Algarve,FARO,0815,17906.06,5154,302,302,314,232,233,465,779,1081,1383,28.78,7.72,6.04,4.35
27-01-2022,VILA DO CONDE,6478,463,8108,"[960,Max]",Extremamente Elevado,,,,6478,Norte,PORTO,1316,14902.77,79899,4726,3875,2819,2070,1743,3813,6632,10507,15233,536.13,102.21,70.5,44.5
27-01-2022,VILA DO PORTO,171,12,3047,"[960,Max]",Extremamente Elevado,,,,171,Açores,AÇORES,4101,9688.74,5616,274,212,135,96,123,219,354,566,840,57.96,8.67,5.84,3.65
27-01-2022,VILA FLOR,284,20,4691,"[960,Max]",Extremamente Elevado,,,,284,Norte,BRAGANÇA,0410,26581.14,6044,429,362,422,294,331,625,1047,1409,1838,22.74,6.91,5.3,3.94
27-01-2022,VILA FRANCA DE XIRA,8632,617,6081,"[960,Max]",Extremamente Elevado,,,,8632,Lisboa e Vale do Tejo,LISBOA,1114,31819.39,141957,8501,6852,4869,3425,2472,5897,10766,17618,26119,446.14,82.09,55.37,33.84
27-01-2022,VILA FRANCA DO CAMPO,670,48,6063,"[960,Max]",Extremamente Elevado,,,,670,Açores,AÇORES,4206,7796.82,11051,450,344,248,217,154,371,619,963,1413,141.73,18.12,12.35,7.94
27-01-2022,VILA NOVA DA BARQUINHA,308,22,4133,"[960,Max]",Extremamente Elevado,,,,308,Lisboa e Vale do Tejo,SANTARÉM,1420,4952.97,7461,415,406,392,364,338,702,1094,1500,1915,150.64,38.66,30.28,22.09
27-01-2022,VILA NOVA DE CERVEIRA,533,38,5978,"[960,Max]",Extremamente Elevado,,,,533,Norte,VIANA DO CASTELO,1610,10846.66,8910,531,444,410,384,334,718,1128,1572,2103,82.14,19.39,14.49,10.4
27-01-2022,VILA NOVA DE FAMALICÃO,11742,839,8917,"[960,Max]",Extremamente Elevado,,,,11742,Norte,BRAGA,0312,20159.26,131676,7817,6164,4202,3282,2749,6031,10233,16397,24214,653.19,120.12,81.34,50.76
27-01-2022,VILA NOVA DE FOZ CÔA,146,10,2242,"[960,Max]",Extremamente Elevado,,,,146,Centro,GUARDA,0914,39815.18,6503,442,385,390,398,429,827,1217,1602,2044,16.33,5.13,4.02,3.06
27-01-2022,VILA NOVA DE GAIA,26051,1861,8670,"[960,Max]",Extremamente Elevado,,,,26051,Norte,PORTO,1317,16846.43,300472,18349,15568,10972,8224,6281,14505,25477,41045,59394,1783.64,352.57,243.65,151.23
27-01-2022,VILA NOVA DE PAIVA,290,21,6186,"[960,Max]",Extremamente Elevado,,,,290,Centro,VISEU,1822,17553.28,4687,289,272,233,217,241,458,691,963,1252,26.7,7.13,5.49,3.94
27-01-2022,VILA NOVA DE POIARES,315,23,4541,"[960,Max]",Extremamente Elevado,,,,315,Centro,COIMBRA,0617,8445.3,6939,380,284,262,235,182,417,679,963,1343,82.17,15.9,11.4,8.04
27-01-2022,VILA POUCA DE AGUIAR,613,44,5127,"[960,Max]",Extremamente Elevado,,,,613,Norte,VILA REAL,1713,43706.62,11961,860,817,733,601,627,1228,1961,2778,3638,27.37,8.32,6.36,4.49
27-01-2022,VILA REAL,2785,199,5574,"[960,Max]",Extremamente Elevado,,,,2785,Norte,VILA REAL,1714,37880.28,49962,3025,2498,2065,1579,1466,3045,5110,7608,10633,131.9,28.07,20.08,13.49
27-01-2022,VILA REAL DE SANTO ANTÓNIO,1124,80,5993,"[960,Max]",Extremamente Elevado,,,,1124,Algarve,FARO,0816,6125.0,18749,1172,1069,811,569,586,1155,1966,3035,4207,306.11,68.69,49.55,32.1
27-01-2022,VILA VELHA DE RÓDÃO,140,10,4456,"[960,Max]",Extremamente Elevado,,,,140,Centro,CASTELO BRANCO,0511,32991.16,3144,209,229,180,283,306,589,769,998,1207,9.53,3.66,3.03,2.33
27-01-2022,VILA VERDE,3844,275,8195,"[960,Max]",Extremamente Elevado,,,,3844,Norte,BRAGA,0313,22866.52,46911,2365,2063,1667,1494,1437,2931,4598,6661,9026,205.15,39.47,29.13,20.11
27-01-2022,VILA VIÇOSA,350,25,4574,"[960,Max]",Extremamente Elevado,,,,350,Alentejo,ÉVORA,0714,19485.89,7656,487,379,342,345,324,669,1011,1390,1877,39.29,9.63,7.13,5.19
27-01-2022,VIMIOSO,198,14,4927,"[960,Max]",Extremamente Elevado,,,,198,Norte,BRAGANÇA,0411,48158.51,4023,274,230,261,293,335,628,889,1119,1393,8.35,2.89,2.32,1.85
27-01-2022,VINHAIS,230,16,2970,"[960,Max]",Extremamente Elevado,,,,230,Norte,BRAGANÇA,0412,69475.09,7746,599,577,636,641,815,1456,2092,2669,3268,11.15,4.7,3.84,3.01
27-01-2022,VISEU,7088,506,7289,"[960,Max]",Extremamente Elevado,,,,7088,Centro,VISEU,1823,50710.14,97249,5769,5038,4140,3158,2710,5868,10008,15046,20815,191.77,41.05,29.67,19.74
27-01-2022,VIZELA,2397,171,10030,"[960,Max]",Extremamente Elevado,,,,2397,Norte,BRAGA,0314,2469.83,23897,1258,928,655,509,371,880,1535,2463,3721,967.49,150.65,99.72,62.15
27-01-2022,VOUZELA,603,43,6266,"[960,Max]",Extremamente Elevado,,,,603,Centro,VISEU,1824,19369.46,9619,626,605,554,532,507,1039,1593,2198,2824,49.66,14.58,11.35,8.22
03-02-2022,ABRANTES,1860,133,5295,"[960,Max]",Extremamente Elevado,,,,1860,Lisboa e Vale do Tejo,SANTARÉM,1401,71469.08,35130,2473,2213,1730,1748,2021,3769,5499,7712,10185,49.15,14.25,10.79,7.69
03-02-2022,ÁGUEDA,4630,331,10048,"[960,Max]",Extremamente Elevado,,,,4630,Centro,AVEIRO,0101,33527.44,46075,3237,2713,2090,1635,1496,3131,5221,7934,11171,137.43,33.32,23.66,15.57
03-02-2022,AGUIAR DA BEIRA,383,27,8243,"[960,Max]",Extremamente Elevado,,,,383,Centro,GUARDA,0901,20676.57,4652,304,281,235,239,148,387,622,903,1207,22.5,5.84,4.37,3.01
03-02-2022,ALANDROAL,188,13,3760,"[960,Max]",Extremamente Elevado,,,,188,Alentejo,ÉVORA,0701,54267.81,4992,307,256,296,299,377,676,972,1228,1535,9.2,2.83,2.26,1.79
03-02-2022,ALBERGARIA-A-VELHA,2463,176,10200,"[960,Max]",Extremamente Elevado,,,,2463,Centro,AVEIRO,0102,15882.5,24144,1550,1298,996,687,680,1367,2363,3661,5211,152.02,32.81,23.05,14.88
03-02-2022,ALBUFEIRA,2585,185,6224,"[960,Max]",Extremamente Elevado,,,,2585,Algarve,FARO,0801,14066.42,41528,2067,1717,1425,985,858,1843,3268,4985,7052,295.24,50.14,35.44,23.23
03-02-2022,ALCÁCER DO SAL,545,39,4677,"[960,Max]",Extremamente Elevado,,,,545,Alentejo,SETÚBAL,1501,149987.3,11659,884,814,623,623,602,1225,1848,2662,3546,7.77,2.36,1.77,1.23
03-02-2022,ALCANENA,605,43,4724,"[960,Max]",Extremamente Elevado,,,,605,Lisboa e Vale do Tejo,SANTARÉM,1402,12732.86,12809,891,744,628,536,588,1124,1752,2496,3387,100.6,26.6,19.6,13.76
03-02-2022,ALCOBAÇA,3723,266,6952,"[960,Max]",Extremamente Elevado,,,,3723,Lisboa e Vale do Tejo,LEIRIA,1001,40814.09,53555,3420,2927,2466,2059,1676,3735,6201,9128,12548,131.22,30.74,22.36,15.19
03-02-2022,ALCOCHETE,1081,77,5463,"[960,Max]",Extremamente Elevado,,,,1081,Lisboa e Vale do Tejo,SETÚBAL,1502,12836.48,19787,857,834,691,476,447,923,1614,2448,3305,154.15,25.75,19.07,12.57
03-02-2022,ALCOUTIM,91,7,4237,"[960,Max]",Extremamente Elevado,,,,91,Algarve,FARO,0802,57536.33,2159,191,188,163,190,267,457,620,808,999,3.75,1.74,1.4,1.08
03-02-2022,ALENQUER,3077,220,6986,"[960,Max]",Extremamente Elevado,,,,3077,Lisboa e Vale do Tejo,LISBOA,1101,30421.92,44052,2298,2062,1629,1330,1155,2485,4114,6176,8474,144.8,27.85,20.3,13.52
03-02-2022,ALFÂNDEGA DA FÉ,240,17,5276,"[960,Max]",Extremamente Elevado,,,,240,Norte,BRAGANÇA,0401,32194.64,4550,325,277,301,274,325,599,900,1177,1502,14.13,4.67,3.66,2.8
03-02-2022,ALIJÓ,541,39,5092,"[960,Max]",Extremamente Elevado,,,,541,Norte,VILA REAL,1701,29759.89,10625,766,687,635,542,666,1208,1843,2530,3296,35.7,11.08,8.5,6.19
03-02-2022,ALJEZUR,300,21,5359,"[960,Max]",Extremamente Elevado,,,,300,Algarve,FARO,0803,32349.95,5594,316,336,335,320,410,730,1065,1401,1717,17.29,5.31,4.33,3.29
03-02-2022,ALJUSTREL,446,32,5405,"[960,Max]",Extremamente Elevado,,,,446,Alentejo,BEJA,0201,45847.41,8247,635,521,443,347,358,705,1148,1669,2304,17.99,5.03,3.64,2.5
03-02-2022,ALMADA,8822,630,5219,"[960,Max]",Extremamente Elevado,,,,8822,Lisboa e Vale do Tejo,SETÚBAL,1503,7000.89,169039,10469,9777,7876,6144,5111,11255,19131,28908,39377,2414.5,562.45,412.91,273.26
03-02-2022,ALMEIDA,221,16,3785,"[960,Max]",Extremamente Elevado,,,,221,Centro,GUARDA,0902,51798.46,5830,441,419,396,458,393,851,1247,1666,2107,11.26,4.07,3.22,2.41
03-02-2022,ALMEIRIM,1350,96,5989,"[960,Max]",Extremamente Elevado,,,,1350,Lisboa e Vale do Tejo,SANTARÉM,1403,22212.05,22546,1342,1353,1106,866,843,1709,2815,4168,5510,101.5,24.81,18.76,12.67
03-02-2022,ALMODÔVAR,413,29,6141,"[960,Max]",Extremamente Elevado,,,,413,Alentejo,BEJA,0202,77788.03,6725,414,443,396,373,328,701,1097,1540,1954,8.65,2.51,1.98,1.41
03-02-2022,ALPIARÇA,411,29,5827,"[960,Max]",Extremamente Elevado,,,,411,Lisboa e Vale do Tejo,SANTARÉM,1404,9536.33,7059,515,486,363,333,274,607,970,1456,1971,74.02,20.67,15.27,10.17
03-02-2022,ALTER DO CHÃO,72,5,2264,"[960,Max]",Extremamente Elevado,,,,72,Alentejo,PORTALEGRE,1201,36206.62,3165,201,163,136,208,187,395,531,694,895,8.74,2.47,1.92,1.47
03-02-2022,ALVAIÁZERE,372,27,5645,"[960,Max]",Extremamente Elevado,,,,372,Centro,LEIRIA,1002,16047.76,6597,419,389,346,406,539,945,1291,1680,2099,41.11,13.08,10.47,8.04
03-02-2022,ALVITO,70,5,2836,"[960,Max]",Extremamente Elevado,,,,70,Alentejo,BEJA,0203,26485.32,2477,145,110,105,111,89,200,305,415,560,9.35,2.11,1.57,1.15
03-02-2022,AMADORA,7038,503,3823,"[960,Max]",Extremamente Elevado,,,,7038,Lisboa e Vale do Tejo,LISBOA,1115,2378.47,184106,11186,10936,8780,6460,5890,12350,21130,32066,43252,7742.05,1818.84,1348.44,888.56
03-02-2022,AMARANTE,4377,313,8229,"[960,Max]",Extremamente Elevado,,,,4377,Norte,PORTO,1301,30133.15,53193,3086,2413,1812,1643,1311,2954,4766,7179,10265,176.53,34.07,23.82,15.82
03-02-2022,AMARES,1627,116,8972,"[960,Max]",Extremamente Elevado,,,,1627,Norte,BRAGA,0301,8195.41,18129,1001,829,622,489,524,1013,1635,2464,3465,221.22,42.28,30.07,19.95
03-02-2022,ANADIA,2229,159,8178,"[960,Max]",Extremamente Elevado,,,,2229,Centro,AVEIRO,0103,21663.48,27258,1931,1698,1376,1208,1262,2470,3846,5544,7475,125.83,34.51,25.59,17.75
03-02-2022,ANGRA DO HEROÍSMO,2305,165,6818,"[960,Max]",Extremamente Elevado,,,,2305,Açores,AÇORES,4301,23899.66,33807,2006,1473,1122,768,635,1403,2525,3998,6004,141.45,25.12,16.73,10.56
03-02-2022,ANSIÃO,753,54,6252,"[960,Max]",Extremamente Elevado,,,,753,Centro,LEIRIA,1003,17609.42,12039,727,709,646,694,530,1224,1870,2579,3306,68.37,18.77,14.65,10.62
03-02-2022,ARCOS DE VALDEVEZ,1118,80,5345,"[960,Max]",Extremamente Elevado,,,,1118,Norte,VIANA DO CASTELO,1601,44759.64,20926,1329,1338,1282,1343,1515,2858,4140,5478,6807,46.75,15.21,12.24,9.25
03-02-2022,ARGANIL,714,51,6487,"[960,Max]",Extremamente Elevado,,,,714,Centro,COIMBRA,0601,33283.93,11014,672,648,612,559,596,1155,1767,2415,3087,33.09,9.27,7.26,5.31
03-02-2022,ARMAMAR,304,22,5266,"[960,Max]",Extremamente Elevado,,,,304,Norte,VISEU,1801,11723.73,5769,357,305,309,285,310,595,904,1209,1566,49.21,13.36,10.31,7.71
03-02-2022,AROUCA,2047,146,9879,"[960,Max]",Extremamente Elevado,,,,2047,Norte,AVEIRO,0104,32910.52,20720,1306,1047,753,683,683,1366,2119,3166,4472,62.96,13.59,9.62,6.44
03-02-2022,ARRAIOLOS,355,25,5124,"[960,Max]",Extremamente Elevado,,,,355,Alentejo,ÉVORA,0702,68374.55,6928,435,384,283,367,480,847,1130,1514,1949,10.13,2.85,2.21,1.65
03-02-2022,ARRONCHES,182,13,6445,"[960,Max]",Extremamente Elevado,,,,182,Alentejo,PORTALEGRE,1202,31464.72,2820,155,142,162,187,179,366,528,670,825,8.96,2.62,2.13,1.68
03-02-2022,ARRUDA DOS VINHOS,913,65,5921,"[960,Max]",Extremamente Elevado,,,,913,Lisboa e Vale do Tejo,LISBOA,1102,7795.93,15412,738,738,562,509,438,947,1509,2247,2985,197.69,38.29,28.82,19.36
03-02-2022,AVEIRO,7977,570,10132,"[960,Max]",Extremamente Elevado,,,,7977,Centro,AVEIRO,0105,19757.57,78734,4520,4004,3050,2250,2103,4353,7403,11407,15927,398.49,80.61,57.73,37.47
03-02-2022,AVIS,101,7,2384,"[960,Max]",Extremamente Elevado,,,,101,Alentejo,PORTALEGRE,1203,60596.51,4247,315,225,206,251,273,524,730,955,1270,7.01,2.1,1.58,1.2
03-02-2022,AZAMBUJA,1415,101,6228,"[960,Max]",Extremamente Elevado,,,,1415,Lisboa e Vale do Tejo,LISBOA,1103,26265.65,22716,1322,1171,1070,798,618,1416,2486,3657,4979,86.48,18.96,13.92,9.46
03-02-2022,BAIÃO,1471,105,7844,"[960,Max]",Extremamente Elevado,,,,1471,Norte,PORTO,1302,17452.83,18748,1070,862,714,686,725,1411,2125,2987,4057,107.42,23.25,17.11,12.18
03-02-2022,BARCELOS,10341,739,8900,"[960,Max]",Extremamente Elevado,,,,10341,Norte,BRAGA,0302,37890.14,116187,6721,5325,3619,2991,2562,5553,9172,14497,21218,306.64,56.0,38.26,24.21
03-02-2022,BARRANCOS,48,3,2957,"[960,Max]",Extremamente Elevado,,,,48,Alentejo,BEJA,0204,16841.73,1634,90,65,65,94,61,155,220,285,375,9.7,2.23,1.69,1.31
03-02-2022,BARREIRO,3950,282,5256,"[960,Max]",Extremamente Elevado,,,,3950,Lisboa e Vale do Tejo,SETÚBAL,1504,3639.07,75147,5194,5565,4459,3105,1767,4872,9331,14896,20090,2065.05,552.07,409.34,256.42
03-02-2022,BATALHA,1255,90,7862,"[960,Max]",Extremamente Elevado,,,,1255,Centro,LEIRIA,1004,10341.6,15963,873,762,649,529,549,1078,1727,2489,3362,154.35,32.51,24.07,16.7
03-02-2022,BEJA,2612,187,7780,"[960,Max]",Extremamente Elevado,,,,2612,Alentejo,BEJA,0205,114647.55,33579,2005,1840,1386,1272,1039,2311,3697,5537,7542,29.29,6.58,4.83,3.22
03-02-2022,BELMONTE,341,24,5327,"[960,Max]",Extremamente Elevado,,,,341,Centro,CASTELO BRANCO,0501,11875.91,6398,444,321,325,310,355,665,990,1311,1755,53.87,14.78,11.04,8.34
03-02-2022,BENAVENTE,1843,132,6024,"[960,Max]",Extremamente Elevado,,,,1843,Lisboa e Vale do Tejo,SANTARÉM,1405,52138.39,30602,1468,1376,1141,876,643,1519,2660,4036,5504,58.69,10.56,7.74,5.1
03-02-2022,BOMBARRAL,711,51,5661,"[960,Max]",Extremamente Elevado,,,,711,Lisboa e Vale do Tejo,LEIRIA,1005,9128.55,12558,875,714,561,491,429,920,1481,2195,3070,137.56,33.63,24.04,16.22
03-02-2022,BORBA,467,33,6929,"[960,Max]",Extremamente Elevado,,,,467,Alentejo,ÉVORA,0703,14518.65,6736,430,375,279,436,392,828,1107,1482,1912,46.39,13.17,10.21,7.62
03-02-2022,BOTICAS,300,21,6009,"[960,Max]",Extremamente Elevado,,,,300,Norte,VILA REAL,1702,32195.66,4998,347,306,311,305,380,685,996,1302,1649,15.52,5.12,4.04,3.09
03-02-2022,BRAGA,20392,1457,11163,"[960,Max]",Extremamente Elevado,,,,20392,Norte,BRAGA,0303,18339.95,182679,10029,7963,5241,4320,3671,7991,13232,21195,31224,996.07,170.25,115.57,72.15
03-02-2022,BRAGANÇA,1779,127,5293,"[960,Max]",Extremamente Elevado,,,,1779,Norte,BRAGANÇA,0402,117357.27,33607,2402,1855,1652,1393,1163,2556,4208,6063,8465,28.64,7.21,5.17,3.59
03-02-2022,CABECEIRAS DE BASTO,1344,96,8598,"[960,Max]",Extremamente Elevado,,,,1344,Norte,BRAGA,0304,24182.16,15628,774,594,544,575,574,1149,1693,2287,3061,64.63,12.66,9.46,7.0
03-02-2022,CADAVAL,596,43,4361,"[960,Max]",Extremamente Elevado,,,,596,Lisboa e Vale do Tejo,LISBOA,1104,17489.3,13673,813,796,756,621,625,1246,2002,2798,3611,78.18,20.65,16.0,11.45
03-02-2022,CALDAS DA RAINHA,2775,198,5345,"[960,Max]",Extremamente Elevado,,,,2775,Lisboa e Vale do Tejo,LEIRIA,1006,25569.47,51912,3035,2684,2186,1899,1705,3604,5790,8474,11509,203.03,45.01,33.14,22.64
03-02-2022,CALHETA,525,37,4828,"[960,Max]",Extremamente Elevado,,,,525,Madeira,MADEIRA,3101,11150.43,10867,576,497,507,399,415,814,1321,1818,2394,97.46,21.47,16.3,11.85
03-02-2022,CALHETA (AÇORES),36,3,1140,"[960,Max]",Extremamente Elevado,,,,36,Açores,AÇORES,4501,12626.4,3184,215,159,141,139,122,261,402,561,776,25.22,6.15,4.44,3.18
03-02-2022,CÂMARA DE LOBOS,2400,171,7126,"[960,Max]",Extremamente Elevado,,,,2400,Madeira,MADEIRA,3102,5216.67,33675,1396,1059,834,545,381,926,1760,2819,4215,645.49,80.79,54.03,33.74
03-02-2022,CAMINHA,928,66,5847,"[960,Max]",Extremamente Elevado,,,,928,Norte,VIANA DO CASTELO,1602,13652.14,15877,1046,944,818,646,656,1302,2120,3064,4110,116.3,30.11,22.44,15.53
03-02-2022,CAMPO MAIOR,422,30,5364,"[960,Max]",Extremamente Elevado,,,,422,Alentejo,PORTALEGRE,1204,24720.16,7874,471,364,351,279,327,606,957,1321,1792,31.85,7.25,5.34,3.87
03-02-2022,CANTANHEDE,2211,158,6315,"[960,Max]",Extremamente Elevado,,,,2211,Centro,COIMBRA,0602,39088.02,35011,2346,2096,1880,1709,1451,3160,5040,7136,9482,89.57,24.26,18.26,12.89
03-02-2022,CARRAZEDA DE ANSIÃES,265,19,4670,"[960,Max]",Extremamente Elevado,,,,265,Norte,BRAGANÇA,0403,27924.09,5666,424,389,391,312,465,777,1168,1557,1981,20.29,7.09,5.58,4.18
03-02-2022,CARREGAL DO SAL,591,42,6378,"[960,Max]",Extremamente Elevado,,,,591,Centro,VISEU,1802,11689.21,9271,587,562,486,462,376,838,1324,1886,2473,79.31,21.16,16.13,11.33
03-02-2022,CARTAXO,1508,108,6325,"[960,Max]",Extremamente Elevado,,,,1508,Lisboa e Vale do Tejo,SANTARÉM,1406,15817.28,23843,1415,1376,1142,861,632,1493,2635,4011,5426,150.74,34.3,25.36,16.66
03-02-2022,CASCAIS,13045,932,6107,"[960,Max]",Extremamente Elevado,,,,13045,Lisboa e Vale do Tejo,LISBOA,1105,9740.17,213608,12151,11444,8680,6469,5248,11717,20397,31841,43992,2193.1,451.66,326.91,209.41
03-02-2022,CASTANHEIRA DE PÊRA,83,6,3182,"[960,Max]",Extremamente Elevado,,,,83,Centro,LEIRIA,1007,6677.45,2614,233,195,157,190,187,377,534,729,962,39.15,14.41,10.92,8.0
03-02-2022,CASTELO BRANCO,3790,271,7290,"[960,Max]",Extremamente Elevado,,,,3790,Centro,CASTELO BRANCO,0502,143819.15,51987,3528,3042,2499,2229,2225,4454,6953,9995,13523,36.15,9.4,6.95,4.83
03-02-2022,CASTELO DE PAIVA,1284,92,8306,"[960,Max]",Extremamente Elevado,,,,1284,Norte,AVEIRO,0106,11500.53,15454,881,697,545,420,431,851,1396,2093,2974,134.37,25.86,18.2,12.14
03-02-2022,CASTELO DE VIDE,154,11,5261,"[960,Max]",Extremamente Elevado,,,,154,Alentejo,PORTALEGRE,1205,26491.24,2919,204,173,179,147,170,317,496,669,873,11.02,3.3,2.53,1.87
03-02-2022,CASTRO DAIRE,1210,86,8751,"[960,Max]",Extremamente Elevado,,,,1210,Centro,VISEU,1803,37904.13,13823,942,857,765,732,773,1505,2270,3127,4069,36.47,10.74,8.25,5.99
03-02-2022,CASTRO MARIM,292,21,4679,"[960,Max]",Extremamente Elevado,,,,292,Algarve,FARO,0804,30084.37,6237,370,345,334,322,344,666,1000,1345,1715,20.73,5.7,4.47,3.32
03-02-2022,CASTRO VERDE,519,37,7475,"[960,Max]",Extremamente Elevado,,,,519,Alentejo,BEJA,0206,56944.23,6949,437,347,303,275,227,502,805,1152,1589,12.2,2.79,2.02,1.41
03-02-2022,CELORICO DA BEIRA,422,30,6086,"[960,Max]",Extremamente Elevado,,,,422,Centro,GUARDA,0903,24721.63,6928,430,416,363,369,535,904,1267,1683,2113,28.02,8.55,6.81,5.12
03-02-2022,CELORICO DE BASTO,1335,95,7014,"[960,Max]",Extremamente Elevado,,,,1335,Norte,BRAGA,0305,18107.02,19040,1001,802,668,728,729,1457,2125,2927,3928,105.15,21.69,16.17,11.74
03-02-2022,CHAMUSCA,415,30,4511,"[960,Max]",Extremamente Elevado,,,,415,Lisboa e Vale do Tejo,SANTARÉM,1407,74600.54,9197,629,583,553,465,579,1044,1597,2180,2809,12.33,3.77,2.92,2.14
03-02-2022,CHAVES,2491,178,6332,"[960,Max]",Extremamente Elevado,,,,2491,Norte,VILA REAL,1703,59122.95,39343,2676,2429,1991,1886,1918,3804,5795,8224,10900,66.54,18.44,13.91,9.8
03-02-2022,CINFÃES,1403,100,7688,"[960,Max]",Extremamente Elevado,,,,1403,Norte,VISEU,1804,23928.76,18244,1067,902,779,734,758,1492,2271,3173,4240,76.24,17.72,13.26,9.49
03-02-2022,COIMBRA,8738,624,6513,"[960,Max]",Extremamente Elevado,,,,8738,Centro,COIMBRA,0603,31939.94,134166,9489,8734,6353,5139,5074,10213,16566,25300,34789,420.06,108.92,79.21,51.87
03-02-2022,CONDEIXA-A-NOVA,1158,83,6533,"[960,Max]",Extremamente Elevado,,,,1158,Centro,COIMBRA,0604,13867.47,17733,871,809,717,583,490,1073,1790,2599,3470,127.88,25.02,18.74,12.91
03-02-2022,CONSTÂNCIA,253,18,6270,"[960,Max]",Extremamente Elevado,,,,253,Lisboa e Vale do Tejo,SANTARÉM,1408,8036.58,4030,211,183,187,148,155,303,490,673,884,50.14,11.0,8.37,6.1
03-02-2022,CORUCHE,565,40,3235,"[960,Max]",Extremamente Elevado,,,,565,Lisboa e Vale do Tejo,SANTARÉM,1409,111572.03,17471,1294,1090,1095,1096,1019,2115,3210,4300,5594,15.66,5.01,3.85,2.88
03-02-2022,CORVO,3,0,638,"[480,960]",Muito Elevado,,,,3,Açores,AÇORES,4901,1711.45,464,22,21,11,13,19,32,43,64,86,27.12,5.03,3.74,2.51
03-02-2022,COVILHÃ,4067,291,8693,"[960,Max]",Extremamente Elevado,,,,4067,Centro,CASTELO BRANCO,0503,55560.06,46787,3533,2998,2365,2111,2193,4304,6669,9667,13200,84.21,23.76,17.4,12.0
03-02-2022,CRATO,100,7,3205,"[960,Max]",Extremamente Elevado,,,,100,Alentejo,PORTALEGRE,1206,39806.88,3129,229,258,163,182,228,410,573,831,1060,7.86,2.66,2.09,1.44
03-02-2022,CUBA,242,17,5256,"[960,Max]",Extremamente Elevado,,,,242,Alentejo,BEJA,0207,17208.72,4595,255,233,206,190,143,333,539,772,1027,26.7,5.97,4.49,3.13
03-02-2022,ELVAS,1293,92,6299,"[960,Max]",Extremamente Elevado,,,,1293,Alentejo,PORTALEGRE,1207,63128.86,20528,1057,1145,902,852,810,1662,2564,3709,4766,32.52,7.55,5.88,4.06
03-02-2022,ENTRONCAMENTO,1159,83,5378,"[960,Max]",Extremamente Elevado,,,,1159,Lisboa e Vale do Tejo,SANTARÉM,1410,1372.81,21558,1066,930,868,695,592,1287,2155,3085,4151,1570.14,302.33,224.69,156.96
03-02-2022,ESPINHO,2681,192,9084,"[960,Max]",Extremamente Elevado,,,,2681,Norte,AVEIRO,0107,2105.68,29516,2205,1993,1430,1177,960,2137,3567,5560,7765,1401.52,368.71,264.01,169.37
03-02-2022,ESPOSENDE,3008,215,8800,"[960,Max]",Extremamente Elevado,,,,3008,Norte,BRAGA,0306,9540.98,34177,1831,1522,1095,894,723,1617,2712,4234,6065,358.21,63.57,44.38,28.42
03-02-2022,ESTARREJA,2532,181,9737,"[960,Max]",Extremamente Elevado,,,,2532,Centro,AVEIRO,0108,10817.33,26006,1503,1399,1106,953,728,1681,2787,4186,5689,240.42,52.59,38.7,25.76
03-02-2022,ESTREMOZ,468,33,3674,"[960,Max]",Extremamente Elevado,,,,468,Alentejo,ÉVORA,0704,51379.95,12728,789,613,697,786,877,1663,2360,2973,3762,24.77,7.32,5.79,4.59
03-02-2022,ÉVORA,3731,266,7116,"[960,Max]",Extremamente Elevado,,,,3731,Alentejo,ÉVORA,0705,130707.58,52428,3569,2852,2176,1966,1803,3769,5945,8797,12366,40.11,9.46,6.73,4.55
03-02-2022,FAFE,4124,295,8580,"[960,Max]",Extremamente Elevado,,,,4124,Norte,BRAGA,0307,21908.11,48060,3044,2455,1679,1403,1208,2611,4290,6745,9789,219.37,44.68,30.79,19.58
03-02-2022,FARO,4502,322,7379,"[960,Max]",Extremamente Elevado,,,,4502,Algarve,FARO,0805,20256.79,61015,3847,3364,2604,2055,1601,3656,6260,9624,13471,301.2,66.5,47.51,30.9
03-02-2022,FELGUEIRAS,4563,326,8087,"[960,Max]",Extremamente Elevado,,,,4563,Norte,PORTO,1303,11573.75,56422,2951,2302,1601,1316,973,2289,3890,6192,9143,487.49,79.0,53.5,33.61
03-02-2022,FERREIRA DO ALENTEJO,418,30,5329,"[960,Max]",Extremamente Elevado,,,,418,Alentejo,BEJA,0208,64820.68,7845,515,414,372,343,345,688,1060,1474,1989,12.1,3.07,2.27,1.64
03-02-2022,FERREIRA DO ZÊZERE,349,25,4388,"[960,Max]",Extremamente Elevado,,,,349,Lisboa e Vale do Tejo,SANTARÉM,1411,19038.03,7959,470,370,416,465,456,921,1337,1707,2177,41.81,11.44,8.97,7.02
03-02-2022,FIGUEIRA DA FOZ,3302,236,5621,"[960,Max]",Extremamente Elevado,,,,3302,Centro,COIMBRA,0605,37905.26,58747,4032,3597,2887,2495,2043,4538,7425,11022,15054,154.98,39.72,29.08,19.59
03-02-2022,FIGUEIRA DE CASTELO RODRIGO,195,14,3490,"[960,Max]",Extremamente Elevado,,,,195,Centro,GUARDA,0904,50857.46,5584,347,352,290,352,391,743,1033,1385,1732,10.98,3.41,2.72,2.03
03-02-2022,FIGUEIRÓ DOS VINHOS,276,20,4960,"[960,Max]",Extremamente Elevado,,,,276,Centro,LEIRIA,1008,17344.0,5568,402,386,322,309,351,660,982,1368,1770,32.1,10.21,7.89,5.66
03-02-2022,FORNOS DE ALGODRES,203,15,4494,"[960,Max]",Extremamente Elevado,,,,203,Centro,GUARDA,0905,13145.05,4528,261,218,247,256,232,488,735,953,1214,34.45,9.24,7.25,5.59
03-02-2022,FREIXO DE ESPADA À CINTA,131,9,3983,"[960,Max]",Extremamente Elevado,,,,131,Norte,BRAGANÇA,0404,24414.29,3298,211,177,231,196,189,385,616,793,1004,13.51,4.11,3.25,2.52
03-02-2022,FRONTEIRA,112,8,3750,"[960,Max]",Extremamente Elevado,,,,112,Alentejo,PORTALEGRE,1208,24859.58,2974,213,182,149,156,168,324,473,655,868,11.96,3.49,2.63,1.9
03-02-2022,FUNCHAL,5989,428,5757,"[960,Max]",Extremamente Elevado,,,,5989,Madeira,MADEIRA,3103,7616.2,104024,6382,5086,3643,2821,1990,4811,8454,13540,19922,1365.86,261.58,177.78,111.0
03-02-2022,FUNDÃO,1783,127,6730,"[960,Max]",Extremamente Elevado,,,,1783,Centro,CASTELO BRANCO,0504,70019.79,26495,1781,1464,1432,1357,1643,3000,4432,5896,7677,37.84,10.96,8.42,6.33
03-02-2022,GAVIÃO,150,11,4587,"[960,Max]",Extremamente Elevado,,,,150,Alentejo,PORTALEGRE,1209,29459.45,3263,189,186,222,263,293,556,778,964,1153,11.08,3.91,3.27,2.64
03-02-2022,GÓIS,216,15,5672,"[960,Max]",Extremamente Elevado,,,,216,Centro,COIMBRA,0606,26330.19,3805,235,199,240,233,244,477,717,916,1151,14.45,4.37,3.48,2.72
03-02-2022,GOLEGÃ,297,21,5559,"[960,Max]",Extremamente Elevado,,,,297,Lisboa e Vale do Tejo,SANTARÉM,1412,8431.67,5339,356,299,281,243,255,498,779,1078,1434,63.32,17.01,12.78,9.24
03-02-2022,GONDOMAR,16024,1145,9654,"[960,Max]",Extremamente Elevado,,,,16024,Norte,PORTO,1304,13191.76,165985,10555,8755,6222,4450,3364,7814,14036,22791,33346,1258.22,252.77,172.76,106.4
03-02-2022,GOUVEIA,570,41,4604,"[960,Max]",Extremamente Elevado,,,,570,Centro,GUARDA,0906,30061.17,12387,871,931,780,783,810,1593,2373,3304,4175,41.21,13.89,10.99,7.89
03-02-2022,GRÂNDOLA,882,63,6025,"[960,Max]",Extremamente Elevado,,,,882,Alentejo,SETÚBAL,1505,82593.66,14639,834,834,708,688,672,1360,2068,2902,3736,17.72,4.52,3.51,2.5
03-02-2022,GUARDA,2753,197,7064,"[960,Max]",Extremamente Elevado,,,,2753,Centro,GUARDA,0907,71209.58,38969,2477,2041,1686,1415,1474,2889,4575,6616,9093,54.72,12.77,9.29,6.42
03-02-2022,GUIMARÃES,14285,1020,9379,"[960,Max]",Extremamente Elevado,,,,14285,Norte,BRAGA,0308,24099.96,152309,9394,7074,4809,3877,2948,6825,11634,18708,28102,631.99,116.61,77.63,48.27
03-02-2022,HORTA,355,25,2444,"[960,Max]",Extremamente Elevado,,,,355,Açores,AÇORES,4701,17305.53,14521,818,658,468,352,302,654,1122,1780,2598,83.91,15.01,10.29,6.48
03-02-2022,IDANHA-A-NOVA,249,18,3091,"[960,Max]",Extremamente Elevado,,,,249,Centro,CASTELO BRANCO,0505,141633.51,8043,518,490,519,672,974,1646,2165,2655,3173,5.68,2.24,1.87,1.53
03-02-2022,ÍLHAVO,3441,246,8891,"[960,Max]",Extremamente Elevado,,,,3441,Centro,AVEIRO,0110,7347.55,38699,2227,1943,1444,1193,850,2043,3487,5430,7657,526.66,104.21,73.9,47.46
03-02-2022,LAGOA (FARO),1453,104,6384,"[960,Max]",Extremamente Elevado,,,,1453,Algarve,FARO,0806,8825.45,22762,1314,1168,919,749,670,1419,2338,3506,4820,257.93,54.62,39.73,26.49
03-02-2022,LAGOA,950,68,6454,"[960,Max]",Extremamente Elevado,,,,950,Açores,AÇORES,4201,4559.32,14721,536,458,349,238,235,473,822,1280,1816,322.9,39.83,28.08,18.03
03-02-2022,LAGOS,2121,152,6984,"[960,Max]",Extremamente Elevado,,,,2121,Algarve,FARO,0807,21299.27,30374,1744,1434,1247,1053,1029,2082,3329,4763,6507,142.61,30.55,22.36,15.63
03-02-2022,LAJES DAS FLORES,75,5,5130,"[960,Max]",Extremamente Elevado,,,,75,Açores,AÇORES,4801,7004.79,1463,88,53,62,46,54,100,162,215,303,20.89,4.33,3.07,2.31
03-02-2022,LAJES DO PICO,124,9,2772,"[960,Max]",Extremamente Elevado,,,,124,Açores,AÇORES,4601,15531.09,4490,304,231,223,159,162,321,544,775,1079,28.91,6.95,4.99,3.5
03-02-2022,LAMEGO,1894,135,7606,"[960,Max]",Extremamente Elevado,,,,1894,Norte,VISEU,1805,16542.11,24895,1639,1284,1124,898,783,1681,2805,4089,5728,150.5,34.63,24.72,16.96
03-02-2022,LEIRIA,9847,703,7861,"[960,Max]",Extremamente Elevado,,,,9847,Centro,LEIRIA,1009,56508.83,125267,7389,6366,5090,3902,3159,7061,12151,18517,25906,221.68,45.84,32.77,21.5
03-02-2022,LISBOA,31834,2274,6248,"[960,Max]",Extremamente Elevado,,,,31834,Lisboa e Vale do Tejo,LISBOA,1106,10005.43,509515,33197,33340,27706,23037,26770,49807,77513,110853,144050,5092.6,1439.78,1107.98,774.74
03-02-2022,LOULÉ,4080,291,5939,"[960,Max]",Extremamente Elevado,,,,4080,Algarve,FARO,0808,76366.91,68697,3890,3350,2780,2358,2251,4609,7389,10739,14629,89.96,19.16,14.06,9.68
03-02-2022,LOURES,11075,791,5183,"[960,Max]",Extremamente Elevado,,,,11075,Lisboa e Vale do Tejo,LISBOA,1107,16723.99,213687,12746,12794,9644,6669,5033,11702,21346,34140,46886,1277.73,280.35,204.14,127.64
03-02-2022,LOURINHÃ,1487,106,5752,"[960,Max]",Extremamente Elevado,,,,1487,Lisboa e Vale do Tejo,LISBOA,1108,14717.2,25855,1584,1243,992,842,645,1487,2479,3722,5306,175.68,36.05,25.29,16.84
03-02-2022,LOUSÃ,1251,89,7293,"[960,Max]",Extremamente Elevado,,,,1251,Centro,COIMBRA,0607,13840.01,17158,946,866,658,528,450,978,1636,2502,3448,123.97,24.91,18.08,11.82
03-02-2022,LOUSADA,3627,259,7757,"[960,Max]",Extremamente Elevado,,,,3627,Norte,PORTO,1305,9608.01,46755,2289,1698,1176,853,621,1474,2650,4348,6637,486.63,69.08,45.25,27.58
03-02-2022,MAÇÃO,289,21,4618,"[960,Max]",Extremamente Elevado,,,,289,Lisboa e Vale do Tejo,SANTARÉM,1413,39997.98,6267,386,362,390,440,657,1097,1487,1849,2235,15.67,5.59,4.62,3.72
03-02-2022,MACEDO DE CAVALEIROS,702,50,4834,"[960,Max]",Extremamente Elevado,,,,702,Norte,BRAGANÇA,0405,69914.08,14516,1082,889,878,823,938,1761,2639,3528,4610,20.76,6.59,5.05,3.77
03-02-2022,MACHICO,1055,75,5279,"[960,Max]",Extremamente Elevado,,,,1055,Madeira,MADEIRA,3104,6825.1,19981,1197,860,662,455,331,786,1448,2308,3505,292.76,51.36,33.82,21.22
03-02-2022,MADALENA,366,26,6202,"[960,Max]",Extremamente Elevado,,,,366,Açores,AÇORES,4602,14712.33,5895,334,256,173,190,179,369,542,798,1132,40.07,7.69,5.42,3.68
03-02-2022,MAFRA,5870,419,6921,"[960,Max]",Extremamente Elevado,,,,5870,Lisboa e Vale do Tejo,LISBOA,1109,29165.5,84816,3613,3334,2839,2089,1899,3988,6827,10161,13774,290.81,47.23,34.84,23.41
03-02-2022,MAIA,14318,1023,10303,"[960,Max]",Extremamente Elevado,,,,14318,Norte,PORTO,1306,8293.94,138971,7801,6617,4512,3339,2631,5970,10482,17099,24900,1675.56,300.22,206.16,126.38
03-02-2022,MANGUALDE,1258,90,6797,"[960,Max]",Extremamente Elevado,,,,1258,Centro,VISEU,1806,21925.56,18510,1198,1128,885,852,743,1595,2480,3608,4806,84.42,21.92,16.46,11.31
03-02-2022,MANTEIGAS,130,9,4320,"[960,Max]",Extremamente Elevado,,,,130,Centro,GUARDA,0908,12197.55,3007,258,197,159,167,146,313,472,669,927,24.65,7.6,5.48,3.87
03-02-2022,MARCO DE CANAVESES,4610,329,8952,"[960,Max]",Extremamente Elevado,,,,4610,Norte,PORTO,1307,20188.98,51496,2678,2060,1488,1265,1023,2288,3776,5836,8514,255.07,42.17,28.91,18.7
03-02-2022,MARINHA GRANDE,3106,222,8066,"[960,Max]",Extremamente Elevado,,,,3106,Centro,LEIRIA,1010,18725.19,38508,2365,2302,1638,1359,1058,2417,4055,6357,8722,205.65,46.58,33.95,21.66
03-02-2022,MARVÃO,135,10,4493,"[960,Max]",Extremamente Elevado,,,,135,Alentejo,PORTALEGRE,1210,15489.9,3005,198,185,142,197,237,434,576,761,959,19.4,6.19,4.91,3.72
03-02-2022,MATOSINHOS,16247,1160,9265,"[960,Max]",Extremamente Elevado,,,,16247,Norte,PORTO,1308,6241.97,175357,11850,9977,7023,5024,3884,8908,15931,25908,37758,2809.31,604.9,415.06,255.22
03-02-2022,MEALHADA,1306,93,6556,"[960,Max]",Extremamente Elevado,,,,1306,Centro,AVEIRO,0111,11065.66,19914,1163,1039,810,828,831,1659,2469,3508,4671,179.96,42.21,31.7,22.31
03-02-2022,MÊDA,285,20,6208,"[960,Max]",Extremamente Elevado,,,,285,Centro,GUARDA,0909,28604.92,4587,343,306,290,288,443,731,1021,1327,1670,16.04,5.84,4.64,3.57
03-02-2022,MELGAÇO,298,21,3679,"[960,Max]",Extremamente Elevado,,,,298,Norte,VIANA DO CASTELO,1603,23824.58,8093,507,567,578,614,675,1289,1867,2434,2941,33.97,12.34,10.22,7.84
03-02-2022,MÉRTOLA,114,8,1852,"[960,Max]",Extremamente Elevado,,,,114,Alentejo,BEJA,0209,129287.34,6142,400,390,378,423,600,1023,1401,1791,2191,4.75,1.69,1.39,1.08
03-02-2022,MESÃO FRIO,239,17,6017,"[960,Max]",Extremamente Elevado,,,,239,Norte,VILA REAL,1704,2664.87,3964,265,205,168,157,120,277,445,650,915,148.74,34.33,24.39,16.7
03-02-2022,MIRA,830,59,7014,"[960,Max]",Extremamente Elevado,,,,830,Centro,COIMBRA,0608,12403.38,11832,727,729,659,550,466,1016,1675,2404,3131,95.4,25.24,19.38,13.5
03-02-2022,MIRANDA DO CORVO,851,61,6694,"[960,Max]",Extremamente Elevado,,,,851,Centro,COIMBRA,0609,12637.79,12708,706,659,568,498,404,902,1470,2129,2835,100.55,22.43,16.85,11.63
03-02-2022,MIRANDA DO DOURO,219,16,3209,"[960,Max]",Extremamente Elevado,,,,219,Norte,BRAGANÇA,0406,48718.31,6830,482,429,442,463,470,933,1375,1804,2286,14.02,4.69,3.7,2.82
03-02-2022,MIRANDELA,1140,81,5239,"[960,Max]",Extremamente Elevado,,,,1140,Norte,BRAGANÇA,0407,65895.67,21754,1640,1315,1204,1078,947,2025,3229,4544,6184,33.01,9.38,6.9,4.9
03-02-2022,MOGADOURO,271,19,3234,"[960,Max]",Extremamente Elevado,,,,271,Norte,BRAGANÇA,0408,76064.93,8392,589,529,576,630,655,1285,1861,2390,2979,11.03,3.92,3.14,2.45
03-02-2022,MOIMENTA DA BEIRA,453,32,4654,"[960,Max]",Extremamente Elevado,,,,453,Norte,VISEU,1807,21996.9,9736,576,514,471,416,461,877,1348,1862,2438,44.26,11.08,8.46,6.13
03-02-2022,MOITA,3588,256,5571,"[960,Max]",Extremamente Elevado,,,,3588,Lisboa e Vale do Tejo,SETÚBAL,1506,5525.98,64407,4226,3646,2623,1801,1425,3226,5849,9495,13721,1165.53,248.3,171.82,105.85
03-02-2022,MONÇÃO,1177,84,6589,"[960,Max]",Extremamente Elevado,,,,1177,Norte,VIANA DO CASTELO,1604,21130.85,17869,1161,1105,1031,1006,972,1978,3009,4114,5275,84.56,24.96,19.47,14.24
03-02-2022,MONCHIQUE,228,16,4499,"[960,Max]",Extremamente Elevado,,,,228,Algarve,FARO,0809,39530.43,5077,353,384,321,355,392,747,1068,1452,1805,12.84,4.57,3.67,2.7
03-02-2022,MONDIM DE BASTO,410,29,5901,"[960,Max]",Extremamente Elevado,,,,410,Norte,VILA REAL,1705,17207.52,6946,395,300,314,284,283,567,881,1181,1576,40.36,9.16,6.86,5.12
03-02-2022,MONFORTE,114,8,3833,"[960,Max]",Extremamente Elevado,,,,114,Alentejo,PORTALEGRE,1211,42024.82,2975,139,115,117,192,168,360,477,592,731,7.08,1.74,1.41,1.14
03-02-2022,MONTALEGRE,357,25,3963,"[960,Max]",Extremamente Elevado,,,,357,Norte,VILA REAL,1706,80545.71,8997,699,628,595,603,730,1333,1928,2556,3255,11.17,4.04,3.17,2.39
03-02-2022,MONTEMOR-O-NOVO,762,54,4870,"[960,Max]",Extremamente Elevado,,,,762,Alentejo,ÉVORA,0706,123296.65,15647,991,953,868,878,971,1849,2717,3670,4661,12.69,3.78,2.98,2.2
03-02-2022,MONTEMOR-O-VELHO,1659,119,6579,"[960,Max]",Extremamente Elevado,,,,1659,Centro,COIMBRA,0610,22896.23,25224,1496,1397,1217,1057,988,2045,3262,4659,6155,110.17,26.88,20.35,14.25
03-02-2022,MONTIJO,3273,234,5681,"[960,Max]",Extremamente Elevado,,,,3273,Lisboa e Vale do Tejo,SETÚBAL,1507,34861.64,57614,2771,2441,1990,1554,1109,2663,4653,7094,9865,165.26,28.3,20.35,13.35
03-02-2022,MORA,86,6,2081,"[960,Max]",Extremamente Elevado,,,,86,Alentejo,ÉVORA,0707,44395.02,4138,336,275,252,238,257,495,747,1022,1358,9.32,3.06,2.3,1.68
03-02-2022,MORTÁGUA,533,38,6057,"[960,Max]",Extremamente Elevado,,,,533,Centro,VISEU,1808,25117.82,8803,638,584,535,499,460,959,1494,2078,2716,35.05,10.81,8.27,5.95
03-02-2022,MOURA,659,47,4807,"[960,Max]",Extremamente Elevado,,,,659,Alentejo,BEJA,0210,95845.55,13718,817,656,665,542,461,1003,1668,2324,3141,14.31,3.28,2.42,1.74
03-02-2022,MOURÃO,78,6,3165,"[960,Max]",Extremamente Elevado,,,,78,Alentejo,ÉVORA,0708,27862.98,2450,139,108,80,104,109,213,293,401,540,8.79,1.94,1.44,1.05
03-02-2022,MURÇA,187,13,3427,"[960,Max]",Extremamente Elevado,,,,187,Norte,VILA REAL,1707,18937.11,5463,384,341,307,306,319,625,932,1273,1657,28.85,8.75,6.72,4.92
03-02-2022,MURTOSA,935,67,9092,"[960,Max]",Extremamente Elevado,,,,935,Centro,AVEIRO,0112,7308.78,10279,509,473,403,353,409,762,1165,1638,2147,140.63,29.37,22.41,15.94
03-02-2022,NAZARÉ,1087,78,7671,"[960,Max]",Extremamente Elevado,,,,1087,Lisboa e Vale do Tejo,LEIRIA,1011,8243.43,14165,967,903,670,420,396,816,1486,2389,3356,171.84,40.71,28.98,18.03
03-02-2022,NELAS,863,62,6654,"[960,Max]",Extremamente Elevado,,,,863,Centro,VISEU,1809,12571.48,12974,924,787,668,604,583,1187,1855,2642,3566,103.21,28.37,21.02,14.76
03-02-2022,NISA,354,25,5840,"[960,Max]",Extremamente Elevado,,,,354,Alentejo,PORTALEGRE,1212,57567.84,6061,405,389,355,483,478,961,1316,1705,2110,10.53,3.67,2.96,2.29
03-02-2022,NORDESTE,531,38,10915,"[960,Max]",Extremamente Elevado,,,,531,Açores,AÇORES,4202,10146.8,4862,246,180,124,161,162,323,447,627,873,47.92,8.6,6.18,4.41
03-02-2022,ÓBIDOS,600,43,5066,"[960,Max]",Extremamente Elevado,,,,600,Lisboa e Vale do Tejo,LEIRIA,1012,14155.44,11850,743,650,574,452,436,888,1462,2112,2855,83.72,20.17,14.92,10.33
03-02-2022,ODEMIRA,1086,78,4394,"[960,Max]",Extremamente Elevado,,,,1086,Alentejo,BEJA,0211,172060.15,24717,1475,1317,1225,1397,1349,2746,3971,5288,6763,14.37,3.93,3.07,2.31
03-02-2022,ODIVELAS,8388,599,5185,"[960,Max]",Extremamente Elevado,,,,8388,Lisboa e Vale do Tejo,LISBOA,1116,2654.36,161774,9562,9038,6952,4641,3812,8453,15405,24443,34005,6095.48,1281.27,920.99,580.44
03-02-2022,OEIRAS,11230,802,6330,"[960,Max]",Extremamente Elevado,,,,11230,Lisboa e Vale do Tejo,LISBOA,1110,4588.31,177408,11580,11575,8566,6211,5855,12066,20632,32207,43787,3866.78,954.38,701.98,449.69
03-02-2022,OLEIROS,219,16,4372,"[960,Max]",Extremamente Elevado,,,,219,Centro,CASTELO BRANCO,0506,47109.31,5003,384,341,366,397,487,884,1250,1591,1975,10.62,4.19,3.38,2.65
03-02-2022,OLHÃO,3352,239,7549,"[960,Max]",Extremamente Elevado,,,,3352,Algarve,FARO,0810,13086.38,44405,2455,2309,1689,1342,1268,2610,4299,6608,9063,339.33,69.26,50.5,32.85
03-02-2022,OLIVEIRA DE AZEMÉIS,6861,490,10394,"[960,Max]",Extremamente Elevado,,,,6861,Norte,AVEIRO,0113,16110.41,66011,4155,3614,2794,2183,1738,3921,6715,10329,14484,409.75,89.91,64.12,41.68
03-02-2022,OLIVEIRA DE FRADES,813,58,8182,"[960,Max]",Extremamente Elevado,,,,813,Centro,VISEU,1810,14534.62,9936,553,475,438,359,415,774,1212,1687,2240,68.36,15.41,11.61,8.34
03-02-2022,OLIVEIRA DO BAIRRO,2127,152,8763,"[960,Max]",Extremamente Elevado,,,,2127,Centro,AVEIRO,0114,8731.99,24277,1327,1182,999,786,810,1596,2595,3777,5104,278.02,58.45,43.25,29.72
03-02-2022,OLIVEIRA DO HOSPITAL,986,70,5122,"[960,Max]",Extremamente Elevado,,,,986,Centro,COIMBRA,0611,23451.66,19253,1161,1097,962,924,960,1884,2846,3943,5104,82.1,21.76,16.81,12.14
03-02-2022,OURÉM,3431,245,7789,"[960,Max]",Extremamente Elevado,,,,3431,Lisboa e Vale do Tejo,SANTARÉM,1421,41668.03,44044,2463,2069,1899,1817,1603,3420,5319,7388,9851,105.7,23.64,17.73,12.77
03-02-2022,OURIQUE,325,23,7063,"[960,Max]",Extremamente Elevado,,,,325,Alentejo,BEJA,0212,66331.36,4607,313,287,284,268,227,495,779,1066,1379,6.95,2.08,1.61,1.17
03-02-2022,OVAR,5635,403,10386,"[960,Max]",Extremamente Elevado,,,,5635,Centro,AVEIRO,0115,14770.25,54260,3294,2709,1994,1636,1234,2870,4864,7573,10867,367.37,73.57,51.27,32.93
03-02-2022,PAÇOS DE FERREIRA,4382,313,7725,"[960,Max]",Extremamente Elevado,,,,4382,Norte,PORTO,1309,7099.29,56728,2903,2193,1518,1135,664,1799,3317,5510,8413,799.1,118.51,77.62,46.72
03-02-2022,PALMELA,4373,312,6804,"[960,Max]",Extremamente Elevado,,,,4373,Lisboa e Vale do Tejo,SETÚBAL,1508,46512.01,64269,3402,3244,2635,1846,1391,3237,5872,9116,12518,138.18,26.91,19.6,12.62
03-02-2022,PAMPILHOSA DA SERRA,92,7,2282,"[960,Max]",Extremamente Elevado,,,,92,Centro,COIMBRA,0612,39646.24,4037,238,254,295,339,423,762,1057,1311,1549,10.18,3.91,3.31,2.67
03-02-2022,PAREDES,7475,534,8685,"[960,Max]",Extremamente Elevado,,,,7475,Norte,PORTO,1310,15675.69,86067,4272,3532,2412,1717,1258,2975,5387,8919,13191,549.04,84.15,56.9,34.36
03-02-2022,PAREDES DE COURA,530,38,6209,"[960,Max]",Extremamente Elevado,,,,530,Norte,VIANA DO CASTELO,1605,13818.59,8535,466,528,407,465,515,980,1387,1915,2381,61.76,17.23,13.86,10.04
03-02-2022,PEDRÓGÃO GRANDE,145,10,4246,"[960,Max]",Extremamente Elevado,,,,145,Centro,LEIRIA,1013,12874.75,3410,175,173,196,221,252,473,669,842,1017,26.49,7.9,6.54,5.2
03-02-2022,PENACOVA,658,47,4808,"[960,Max]",Extremamente Elevado,,,,658,Centro,COIMBRA,0613,21673.23,13694,968,923,745,621,703,1324,2069,2992,3960,63.18,18.27,13.81,9.55
03-02-2022,PENAFIEL,6002,429,8603,"[960,Max]",Extremamente Elevado,,,,6002,Norte,PORTO,1311,21224.27,69772,3648,2823,2032,1663,1230,2893,4925,7748,11396,328.74,53.69,36.51,23.2
03-02-2022,PENALVA DO CASTELO,337,24,4731,"[960,Max]",Extremamente Elevado,,,,337,Centro,VISEU,1811,13433.92,7115,449,457,413,391,426,817,1230,1687,2136,52.96,15.9,12.56,9.16
03-02-2022,PENAMACOR,74,5,1566,"[960,Max]",Extremamente Elevado,,,,74,Centro,CASTELO BRANCO,0507,56370.69,4755,262,248,273,451,633,1084,1357,1605,1867,8.44,3.31,2.85,2.41
03-02-2022,PENEDONO,84,6,3227,"[960,Max]",Extremamente Elevado,,,,84,Norte,VISEU,1812,13370.75,2591,172,113,129,156,138,294,423,536,708,19.38,5.3,4.01,3.16
03-02-2022,PENELA,261,19,4845,"[960,Max]",Extremamente Elevado,,,,261,Centro,COIMBRA,0614,13480.0,5397,314,324,274,359,344,703,977,1301,1615,40.04,11.98,9.65,7.25
03-02-2022,PENICHE,1290,92,4868,"[960,Max]",Extremamente Elevado,,,,1290,Lisboa e Vale do Tejo,LEIRIA,1014,7754.98,26501,1746,1504,1203,926,707,1633,2836,4340,6086,341.73,78.48,55.96,36.57
03-02-2022,PESO DA RÉGUA,1075,77,6815,"[960,Max]",Extremamente Elevado,,,,1075,Norte,VILA REAL,1708,9486.01,15773,1076,843,650,659,455,1114,1764,2607,3683,166.28,38.83,27.48,18.6
03-02-2022,PINHEL,355,25,4175,"[960,Max]",Extremamente Elevado,,,,355,Centro,GUARDA,0910,48452.12,8511,577,566,551,538,689,1227,1778,2344,2921,17.57,6.03,4.84,3.67
03-02-2022,POMBAL,3447,246,6699,"[960,Max]",Extremamente Elevado,,,,3447,Centro,LEIRIA,1015,62600.28,51461,3187,2791,2494,2328,2027,4355,6849,9640,12827,82.21,20.49,15.4,10.94
03-02-2022,PONTA DELGADA,4897,350,7209,"[960,Max]",Extremamente Elevado,,,,4897,Açores,AÇORES,4203,23298.65,67935,3108,2435,1726,1133,902,2035,3761,6196,9304,291.58,39.93,26.59,16.14
03-02-2022,PONTA DO SOL,471,34,5483,"[960,Max]",Extremamente Elevado,,,,471,Madeira,MADEIRA,3105,4622.03,8593,319,283,347,208,221,429,776,1059,1378,185.92,29.81,22.91,16.79
03-02-2022,PONTE DA BARCA,581,42,5199,"[960,Max]",Extremamente Elevado,,,,581,Norte,VIANA DO CASTELO,1606,18211.37,11180,635,576,517,554,490,1044,1561,2137,2772,61.39,15.22,11.73,8.57
03-02-2022,PONTE DE LIMA,2652,189,6418,"[960,Max]",Extremamente Elevado,,,,2652,Norte,VIANA DO CASTELO,1607,32025.46,41315,2321,2022,1720,1596,1462,3058,4778,6800,9121,129.01,28.48,21.23,14.92
03-02-2022,PONTE DE SOR,618,44,4123,"[960,Max]",Extremamente Elevado,,,,618,Alentejo,PORTALEGRE,1213,83971.16,14994,939,800,716,739,831,1570,2286,3086,4025,17.86,4.79,3.68,2.72
03-02-2022,PORTALEGRE,1314,94,5927,"[960,Max]",Extremamente Elevado,,,,1314,Alentejo,PORTALEGRE,1214,44713.64,22172,1577,1351,1137,993,984,1977,3114,4465,6042,49.59,13.51,9.99,6.96
03-02-2022,PORTEL,335,24,5749,"[960,Max]",Extremamente Elevado,,,,335,Alentejo,ÉVORA,0709,60100.57,5828,336,358,283,331,305,636,919,1277,1613,9.7,2.68,2.12,1.53
03-02-2022,PORTIMÃO,3566,255,6428,"[960,Max]",Extremamente Elevado,,,,3566,Algarve,FARO,0811,18206.29,55483,3182,2927,2116,1582,1400,2982,5098,8025,11207,304.75,61.56,44.08,28.0
03-02-2022,PORTO,21212,1515,9793,"[960,Max]",Extremamente Elevado,,,,21212,Norte,PORTO,1312,4142.02,216606,15790,15193,11280,9409,10044,19453,30733,45926,61716,5229.5,1490.0,1108.79,741.98
03-02-2022,PORTO DE MÓS,1521,109,6534,"[960,Max]",Extremamente Elevado,,,,1521,Centro,LEIRIA,1016,26183.41,23275,1355,1210,1034,888,872,1760,2794,4004,5359,88.89,20.47,15.29,10.67
03-02-2022,PORTO MONIZ,78,6,3330,"[960,Max]",Extremamente Elevado,,,,78,Madeira,MADEIRA,3106,8293.38,2342,143,130,95,98,120,218,313,443,586,28.24,7.07,5.34,3.77
03-02-2022,PORTO SANTO,133,10,2559,"[960,Max]",Extremamente Elevado,,,,133,Madeira,MADEIRA,3201,4300.7,5202,240,157,134,110,68,178,312,469,709,120.95,16.48,10.9,7.25
03-02-2022,PÓVOA DE LANHOSO,1883,134,8757,"[960,Max]",Extremamente Elevado,,,,1883,Norte,BRAGA,0309,13465.29,21499,1175,909,732,673,624,1297,2029,2938,4113,159.67,30.55,21.82,15.07
03-02-2022,PÓVOA DE VARZIM,5711,408,9096,"[960,Max]",Extremamente Elevado,,,,5711,Norte,PORTO,1313,8220.59,62784,3712,3120,2134,1594,1305,2899,5033,8153,11865,763.7,144.33,99.17,61.22
03-02-2022,POVOAÇÃO,457,33,7717,"[960,Max]",Extremamente Elevado,,,,457,Açores,AÇORES,4204,10640.77,5927,293,212,191,144,134,278,469,681,974,55.7,9.15,6.4,4.41
03-02-2022,VILA DA PRAIA DA VITÓRIA,1366,98,6406,"[960,Max]",Extremamente Elevado,,,,1366,Açores,AÇORES,4302,16127.06,21317,1133,789,619,436,336,772,1391,2180,3313,132.18,20.54,13.52,8.63
03-02-2022,PROENÇA-A-NOVA,402,29,5509,"[960,Max]",Extremamente Elevado,,,,402,Centro,CASTELO BRANCO,0508,39539.96,7298,508,465,389,400,560,960,1349,1814,2322,18.46,5.87,4.59,3.41
03-02-2022,REDONDO,256,18,4026,"[960,Max]",Extremamente Elevado,,,,256,Alentejo,ÉVORA,0710,36950.87,6353,349,325,288,288,354,642,930,1255,1604,17.19,4.34,3.4,2.52
03-02-2022,REGUENGOS DE MONSARAZ,355,25,3546,"[960,Max]",Extremamente Elevado,,,,355,Alentejo,ÉVORA,0711,46399.72,10015,602,511,455,462,473,935,1390,1901,2503,21.58,5.39,4.1,3.0
03-02-2022,RESENDE,679,48,6695,"[960,Max]",Extremamente Elevado,,,,679,Norte,VISEU,1813,12334.93,10137,560,493,448,433,422,855,1303,1796,2356,82.18,19.1,14.56,10.56
03-02-2022,RIBEIRA BRAVA,904,65,7268,"[960,Max]",Extremamente Elevado,,,,904,Madeira,MADEIRA,3107,6544.88,12435,648,500,411,311,287,598,1009,1509,2157,189.99,32.96,23.06,15.42
03-02-2022,RIBEIRA DE PENA,273,20,4543,"[960,Max]",Extremamente Elevado,,,,273,Norte,VILA REAL,1709,21745.98,6016,371,301,290,310,368,678,968,1269,1640,27.66,7.54,5.84,4.45
03-02-2022,RIBEIRA GRANDE,3510,251,10697,"[960,Max]",Extremamente Elevado,,,,3510,Açores,AÇORES,4205,18015.13,32811,1163,689,512,345,253,598,1110,1799,2962,182.13,16.44,9.99,6.16
03-02-2022,RIO MAIOR,1225,88,6013,"[960,Max]",Extremamente Elevado,,,,1225,Lisboa e Vale do Tejo,SANTARÉM,1414,27276.45,20379,1251,1144,941,795,648,1443,2384,3528,4779,74.71,17.52,12.93,8.74
03-02-2022,SABROSA,306,22,5168,"[960,Max]",Extremamente Elevado,,,,306,Norte,VILA REAL,1710,15692.45,5918,393,314,304,302,350,652,956,1270,1663,37.71,10.6,8.09,6.09
03-02-2022,SABUGAL,335,24,3164,"[960,Max]",Extremamente Elevado,,,,335,Centro,GUARDA,0911,82269.82,10585,724,707,694,796,1009,1805,2499,3206,3930,12.87,4.78,3.9,3.04
03-02-2022,SALVATERRA DE MAGOS,1063,76,4990,"[960,Max]",Extremamente Elevado,,,,1063,Lisboa e Vale do Tejo,SANTARÉM,1415,24393.2,21295,1275,1181,1060,799,772,1571,2631,3812,5087,87.3,20.85,15.63,10.79
03-02-2022,SANTA COMBA DÃO,753,54,7200,"[960,Max]",Extremamente Elevado,,,,753,Centro,VISEU,1814,11194.77,10452,732,684,569,538,464,1002,1571,2255,2987,93.36,26.68,20.14,14.03
03-02-2022,SANTA CRUZ,2392,171,5282,"[960,Max]",Extremamente Elevado,,,,2392,Madeira,MADEIRA,3108,8150.28,45281,1817,1301,974,716,523,1239,2213,3514,5331,555.6,65.41,43.12,27.15
03-02-2022,SANTA CRUZ DA GRACIOSA,203,15,4834,"[960,Max]",Extremamente Elevado,,,,203,Açores,AÇORES,4401,6065.78,4208,228,180,163,124,145,269,432,612,840,69.37,13.85,10.09,7.12
03-02-2022,SANTA CRUZ DAS FLORES,114,8,5266,"[960,Max]",Extremamente Elevado,,,,114,Açores,AÇORES,4802,7091.44,2165,125,98,74,56,51,107,181,279,404,30.53,5.7,3.93,2.55
03-02-2022,SANTA MARIA DA FEIRA,12810,915,9240,"[960,Max]",Extremamente Elevado,,,,12810,Norte,AVEIRO,0109,21587.65,138636,8182,6743,4771,3856,3079,6935,11706,18449,26631,642.19,123.36,85.46,54.22
03-02-2022,SANTA MARTA DE PENAGUIÃO,342,24,5186,"[960,Max]",Extremamente Elevado,,,,342,Norte,VILA REAL,1711,6928.13,6599,483,373,337,316,317,633,970,1343,1826,95.25,26.36,19.39,14.0
03-02-2022,SANTANA,326,23,4859,"[960,Max]",Extremamente Elevado,,,,326,Madeira,MADEIRA,3109,9547.3,6711,418,353,343,282,277,559,902,1255,1673,70.29,17.52,13.15,9.45
03-02-2022,SANTARÉM,3312,237,5768,"[960,Max]",Extremamente Elevado,,,,3312,Lisboa e Vale do Tejo,SANTARÉM,1416,55253.58,57421,3654,3441,2760,2466,2206,4672,7432,10873,14527,103.92,26.29,19.68,13.45
03-02-2022,SANTIAGO DO CACÉM,1425,102,4951,"[960,Max]",Extremamente Elevado,,,,1425,Alentejo,SETÚBAL,1509,105969.29,28791,2144,1689,1472,1295,1215,2510,3982,5671,7815,27.17,7.37,5.35,3.76
03-02-2022,SANTO TIRSO,5446,389,8003,"[960,Max]",Extremamente Elevado,,,,5446,Norte,PORTO,1314,13655.52,68055,4911,3935,2761,2257,1810,4067,6828,10763,15674,498.35,114.78,78.82,50.0
03-02-2022,SÃO BRÁS DE ALPORTEL,560,40,5380,"[960,Max]",Extremamente Elevado,,,,560,Algarve,FARO,0812,15336.92,10416,596,468,467,404,401,805,1272,1740,2336,67.91,15.23,11.35,8.29
03-02-2022,SÃO JOÃO DA MADEIRA,2359,168,10743,"[960,Max]",Extremamente Elevado,,,,2359,Norte,AVEIRO,0116,794.3,21958,1347,1069,796,601,593,1194,1990,3059,4406,2765.49,554.91,385.26,250.63
03-02-2022,SÃO JOÃO DA PESQUEIRA,511,36,7167,"[960,Max]",Extremamente Elevado,,,,511,Norte,VISEU,1815,26610.85,7125,417,330,294,328,328,656,950,1280,1697,26.77,6.38,4.81,3.57
03-02-2022,SÃO PEDRO DO SUL,1247,89,8099,"[960,Max]",Extremamente Elevado,,,,1247,Centro,VISEU,1816,34895.09,15403,990,962,861,759,909,1668,2529,3491,4481,44.14,12.84,10.0,7.25
03-02-2022,SÃO ROQUE DO PICO,130,9,3967,"[960,Max]",Extremamente Elevado,,,,130,Açores,AÇORES,4603,14236.1,3266,199,141,93,96,113,209,302,443,642,22.94,4.51,3.11,2.12
03-02-2022,SÃO VICENTE,268,19,5202,"[960,Max]",Extremamente Elevado,,,,268,Madeira,MADEIRA,3110,7883.71,5143,272,264,266,225,280,505,771,1035,1307,65.23,16.58,13.13,9.78
03-02-2022,SARDOAL,157,11,4197,"[960,Max]",Extremamente Elevado,,,,157,Lisboa e Vale do Tejo,SANTARÉM,1417,9214.72,3741,227,178,148,165,248,413,561,739,966,40.6,10.48,8.02,6.09
03-02-2022,SÁTÃO,744,53,6429,"[960,Max]",Extremamente Elevado,,,,744,Centro,VISEU,1817,20194.11,11580,765,671,515,465,476,941,1456,2127,2892,57.34,14.32,10.53,7.21
03-02-2022,SEIA,1291,92,5806,"[960,Max]",Extremamente Elevado,,,,1291,Centro,GUARDA,0912,43568.83,22234,1807,1589,1238,1122,721,1843,3081,4670,6477,51.03,14.87,10.72,7.07
03-02-2022,SEIXAL,8748,625,5215,"[960,Max]",Extremamente Elevado,,,,8748,Lisboa e Vale do Tejo,SETÚBAL,1510,9545.17,167752,10586,9270,6661,4391,2930,7321,13982,23252,33838,1757.49,354.51,243.6,146.49
03-02-2022,SERNANCELHE,181,13,3349,"[960,Max]",Extremamente Elevado,,,,181,Norte,VISEU,1818,22861.22,5396,305,293,286,273,260,533,819,1112,1417,23.6,6.2,4.86,3.58
03-02-2022,SERPA,619,44,4324,"[960,Max]",Extremamente Elevado,,,,619,Alentejo,BEJA,0213,110563.34,14304,903,761,719,697,626,1323,2042,2803,3706,12.94,3.35,2.54,1.85
03-02-2022,SERTÃ,1021,73,7004,"[960,Max]",Extremamente Elevado,,,,1021,Centro,CASTELO BRANCO,0509,44673.17,14577,870,779,790,767,1020,1787,2577,3356,4226,32.63,9.46,7.51,5.77
03-02-2022,SESIMBRA,2413,172,4654,"[960,Max]",Extremamente Elevado,,,,2413,Lisboa e Vale do Tejo,SETÚBAL,1511,19571.75,51858,2400,2321,1853,1257,1083,2340,4193,6514,8914,264.96,45.54,33.28,21.42
03-02-2022,SETÚBAL,7523,537,6535,"[960,Max]",Extremamente Elevado,,,,7523,Lisboa e Vale do Tejo,SETÚBAL,1512,23032.5,115126,7425,6929,5075,3775,2655,6430,11505,18434,25859,499.83,112.27,80.03,49.95
03-02-2022,SEVER DO VOUGA,826,59,7288,"[960,Max]",Extremamente Elevado,,,,826,Centro,AVEIRO,0117,12987.56,11331,766,637,568,540,567,1107,1675,2312,3078,87.24,23.7,17.8,12.9
03-02-2022,SILVES,2059,147,5683,"[960,Max]",Extremamente Elevado,,,,2059,Algarve,FARO,0813,68006.23,36226,2137,1869,1610,1423,1600,3023,4633,6502,8639,53.27,12.7,9.56,6.81
03-02-2022,SINES,884,63,6442,"[960,Max]",Extremamente Elevado,,,,884,Alentejo,SETÚBAL,1513,20330.17,13715,888,791,551,416,268,684,1235,2026,2914,67.46,14.33,9.97,6.07
03-02-2022,SINTRA,18134,1295,4633,"[960,Max]",Extremamente Elevado,,,,18134,Lisboa e Vale do Tejo,LISBOA,1111,31922.73,391402,20490,18316,13545,9137,7284,16421,29966,48282,68772,1226.08,215.43,151.25,93.87
03-02-2022,SOBRAL DE MONTE AGRAÇO,634,45,5953,"[960,Max]",Extremamente Elevado,,,,634,Lisboa e Vale do Tejo,LISBOA,1112,5210.32,10651,564,507,352,272,212,484,836,1343,1907,204.43,36.6,25.78,16.05
03-02-2022,SOURE,1220,87,7129,"[960,Max]",Extremamente Elevado,,,,1220,Centro,COIMBRA,0615,26506.07,17120,1173,1142,1004,883,987,1870,2874,4016,5189,64.59,19.58,15.15,10.84
03-02-2022,SOUSEL,186,13,4205,"[960,Max]",Extremamente Elevado,,,,186,Alentejo,PORTALEGRE,1215,27932.18,4412,261,274,208,302,292,594,802,1076,1337,15.8,4.79,3.85,2.87
03-02-2022,TÁBUA,627,45,5517,"[960,Max]",Extremamente Elevado,,,,627,Centro,COIMBRA,0616,19978.58,11368,729,584,524,430,464,894,1418,2002,2731,56.9,13.67,10.02,7.1
03-02-2022,TABUAÇO,331,24,5482,"[960,Max]",Extremamente Elevado,,,,331,Norte,VISEU,1819,13385.67,6033,372,314,217,282,363,645,862,1176,1548,45.07,11.56,8.79,6.44
03-02-2022,TAROUCA,451,32,5779,"[960,Max]",Extremamente Elevado,,,,451,Norte,VISEU,1820,10008.49,7804,405,335,313,277,324,601,914,1249,1654,77.98,16.53,12.48,9.13
03-02-2022,TAVIRA,1506,108,6141,"[960,Max]",Extremamente Elevado,,,,1506,Algarve,FARO,0814,60696.7,24530,1493,1415,1252,1066,1277,2343,3595,5010,6503,40.41,10.71,8.25,5.92
03-02-2022,TERRAS DE BOURO,429,31,6746,"[960,Max]",Extremamente Elevado,,,,429,Norte,BRAGA,0310,27746.07,6361,391,372,296,319,340,659,955,1327,1718,22.93,6.19,4.78,3.44
03-02-2022,TOMAR,2134,152,5808,"[960,Max]",Extremamente Elevado,,,,2134,Lisboa e Vale do Tejo,SANTARÉM,1418,35120.44,36748,2403,2189,1868,1853,1822,3675,5543,7732,10135,104.64,28.86,22.02,15.78
03-02-2022,TONDELA,1778,127,6746,"[960,Max]",Extremamente Elevado,,,,1778,Centro,VISEU,1821,37121.73,26357,1768,1722,1518,1475,1417,2892,4410,6132,7900,71.0,21.28,16.52,11.88
03-02-2022,TORRE DE MONCORVO,308,22,4009,"[960,Max]",Extremamente Elevado,,,,308,Norte,BRAGANÇA,0409,53155.67,7695,556,478,488,551,719,1270,1758,2236,2792,14.48,5.25,4.21,3.31
03-02-2022,TORRES NOVAS,2016,144,5772,"[960,Max]",Extremamente Elevado,,,,2016,Lisboa e Vale do Tejo,SANTARÉM,1419,26999.68,34933,2324,1979,1738,1406,1475,2881,4619,6598,8922,129.38,33.04,24.44,17.11
03-02-2022,TORRES VEDRAS,4710,336,5998,"[960,Max]",Extremamente Elevado,,,,4710,Lisboa e Vale do Tejo,LISBOA,1113,40714.89,78530,4513,3945,3447,2628,2104,4732,8179,12124,16637,192.88,40.86,29.78,20.09
03-02-2022,TRANCOSO,444,32,5001,"[960,Max]",Extremamente Elevado,,,,444,Centro,GUARDA,0913,36152.47,8875,581,557,542,586,496,1082,1624,2181,2762,24.55,7.64,6.03,4.49
03-02-2022,TROFA,3749,268,9758,"[960,Max]",Extremamente Elevado,,,,3749,Norte,PORTO,1318,7201.76,38418,2336,1894,1231,939,684,1623,2854,4748,7084,533.44,98.36,65.93,39.63
03-02-2022,VAGOS,1779,127,7824,"[960,Max]",Extremamente Elevado,,,,1779,Centro,AVEIRO,0118,16491.5,22740,1320,1205,922,784,724,1508,2430,3635,4955,137.89,30.04,22.04,14.73
03-02-2022,VALE DE CAMBRA,1768,126,8290,"[960,Max]",Extremamente Elevado,,,,1768,Norte,AVEIRO,0119,14733.47,21327,1491,1363,1005,831,798,1629,2634,3997,5488,144.76,37.25,27.13,17.88
03-02-2022,VALENÇA,875,63,6587,"[960,Max]",Extremamente Elevado,,,,875,Norte,VIANA DO CASTELO,1608,11712.86,13290,867,791,582,582,503,1085,1667,2458,3325,113.46,28.39,20.99,14.23
03-02-2022,VALONGO,9827,702,10085,"[960,Max]",Extremamente Elevado,,,,9827,Norte,PORTO,1315,7512.45,97444,5629,4696,3207,2462,1829,4291,7498,12194,17823,1297.18,237.26,162.33,99.81
03-02-2022,VALPAÇOS,732,52,4943,"[960,Max]",Extremamente Elevado,,,,732,Norte,VILA REAL,1712,54873.93,14818,1217,1118,999,928,997,1925,2924,4042,5259,27.0,9.58,7.37,5.33
03-02-2022,VELAS,302,22,5938,"[960,Max]",Extremamente Elevado,,,,302,Açores,AÇORES,4502,11738.38,5093,278,208,166,153,113,266,432,640,918,43.39,7.82,5.45,3.68
03-02-2022,VENDAS NOVAS,722,52,6419,"[960,Max]",Extremamente Elevado,,,,722,Alentejo,ÉVORA,0712,22238.88,11255,677,768,655,501,532,1033,1688,2456,3133,50.61,14.09,11.04,7.59
03-02-2022,VIANA DO ALENTEJO,232,17,4504,"[960,Max]",Extremamente Elevado,,,,232,Alentejo,ÉVORA,0713,39367.29,5145,245,208,235,210,214,424,659,867,1112,13.07,2.82,2.2,1.67
03-02-2022,VIANA DO CASTELO,6179,441,7320,"[960,Max]",Extremamente Elevado,,,,6179,Norte,VIANA DO CASTELO,1609,31902.01,84417,5470,4433,3591,3061,2982,6043,9634,14067,19537,264.61,61.24,44.09,30.2
03-02-2022,VIDIGUEIRA,256,18,4640,"[960,Max]",Extremamente Elevado,,,,256,Alentejo,BEJA,0214,31661.09,5510,300,248,215,233,275,508,723,971,1271,17.4,4.01,3.07,2.28
03-02-2022,VIEIRA DO MINHO,701,50,5922,"[960,Max]",Extremamente Elevado,,,,701,Norte,BRAGA,0311,21644.35,11842,703,594,525,548,482,1030,1555,2149,2852,54.71,13.18,9.93,7.18
03-02-2022,VILA DE REI,213,15,6411,"[960,Max]",Extremamente Elevado,,,,213,Centro,CASTELO BRANCO,0510,19154.6,3323,169,128,172,247,302,549,721,849,1018,17.35,5.31,4.43,3.76
03-02-2022,VILA DO BISPO,244,17,4741,"[960,Max]",Extremamente Elevado,,,,244,Algarve,FARO,0815,17906.06,5154,302,302,314,232,233,465,779,1081,1383,28.78,7.72,6.04,4.35
03-02-2022,VILA DO CONDE,7304,522,9142,"[960,Max]",Extremamente Elevado,,,,7304,Norte,PORTO,1316,14902.77,79899,4726,3875,2819,2070,1743,3813,6632,10507,15233,536.13,102.21,70.5,44.5
03-02-2022,VILA DO PORTO,174,12,3100,"[960,Max]",Extremamente Elevado,,,,174,Açores,AÇORES,4101,9688.74,5616,274,212,135,96,123,219,354,566,840,57.96,8.67,5.84,3.65
03-02-2022,VILA FLOR,309,22,5107,"[960,Max]",Extremamente Elevado,,,,309,Norte,BRAGANÇA,0410,26581.14,6044,429,362,422,294,331,625,1047,1409,1838,22.74,6.91,5.3,3.94
03-02-2022,VILA FRANCA DE XIRA,9308,665,6557,"[960,Max]",Extremamente Elevado,,,,9308,Lisboa e Vale do Tejo,LISBOA,1114,31819.39,141957,8501,6852,4869,3425,2472,5897,10766,17618,26119,446.14,82.09,55.37,33.84
03-02-2022,VILA FRANCA DO CAMPO,947,68,8567,"[960,Max]",Extremamente Elevado,,,,947,Açores,AÇORES,4206,7796.82,11051,450,344,248,217,154,371,619,963,1413,141.73,18.12,12.35,7.94
03-02-2022,VILA NOVA DA BARQUINHA,364,26,4875,"[960,Max]",Extremamente Elevado,,,,364,Lisboa e Vale do Tejo,SANTARÉM,1420,4952.97,7461,415,406,392,364,338,702,1094,1500,1915,150.64,38.66,30.28,22.09
03-02-2022,VILA NOVA DE CERVEIRA,596,43,6685,"[960,Max]",Extremamente Elevado,,,,596,Norte,VIANA DO CASTELO,1610,10846.66,8910,531,444,410,384,334,718,1128,1572,2103,82.14,19.39,14.49,10.4
03-02-2022,VILA NOVA DE FAMALICÃO,13261,947,10071,"[960,Max]",Extremamente Elevado,,,,13261,Norte,BRAGA,0312,20159.26,131676,7817,6164,4202,3282,2749,6031,10233,16397,24214,653.19,120.12,81.34,50.76
03-02-2022,VILA NOVA DE FOZ CÔA,238,17,3659,"[960,Max]",Extremamente Elevado,,,,238,Centro,GUARDA,0914,39815.18,6503,442,385,390,398,429,827,1217,1602,2044,16.33,5.13,4.02,3.06
03-02-2022,VILA NOVA DE GAIA,30324,2166,10092,"[960,Max]",Extremamente Elevado,,,,30324,Norte,PORTO,1317,16846.43,300472,18349,15568,10972,8224,6281,14505,25477,41045,59394,1783.64,352.57,243.65,151.23
03-02-2022,VILA NOVA DE PAIVA,287,20,6122,"[960,Max]",Extremamente Elevado,,,,287,Centro,VISEU,1822,17553.28,4687,289,272,233,217,241,458,691,963,1252,26.7,7.13,5.49,3.94
03-02-2022,VILA NOVA DE POIARES,372,27,5360,"[960,Max]",Extremamente Elevado,,,,372,Centro,COIMBRA,0617,8445.3,6939,380,284,262,235,182,417,679,963,1343,82.17,15.9,11.4,8.04
03-02-2022,VILA POUCA DE AGUIAR,672,48,5616,"[960,Max]",Extremamente Elevado,,,,672,Norte,VILA REAL,1713,43706.62,11961,860,817,733,601,627,1228,1961,2778,3638,27.37,8.32,6.36,4.49
03-02-2022,VILA REAL,3409,243,6823,"[960,Max]",Extremamente Elevado,,,,3409,Norte,VILA REAL,1714,37880.28,49962,3025,2498,2065,1579,1466,3045,5110,7608,10633,131.9,28.07,20.08,13.49
03-02-2022,VILA REAL DE SANTO ANTÓNIO,1264,90,6744,"[960,Max]",Extremamente Elevado,,,,1264,Algarve,FARO,0816,6125.0,18749,1172,1069,811,569,586,1155,1966,3035,4207,306.11,68.69,49.55,32.1
03-02-2022,VILA VELHA DE RÓDÃO,114,8,3628,"[960,Max]",Extremamente Elevado,,,,114,Centro,CASTELO BRANCO,0511,32991.16,3144,209,229,180,283,306,589,769,998,1207,9.53,3.66,3.03,2.33
03-02-2022,VILA VERDE,4177,298,8905,"[960,Max]",Extremamente Elevado,,,,4177,Norte,BRAGA,0313,22866.52,46911,2365,2063,1667,1494,1437,2931,4598,6661,9026,205.15,39.47,29.13,20.11
03-02-2022,VILA VIÇOSA,366,26,4785,"[960,Max]",Extremamente Elevado,,,,366,Alentejo,ÉVORA,0714,19485.89,7656,487,379,342,345,324,669,1011,1390,1877,39.29,9.63,7.13,5.19
03-02-2022,VIMIOSO,188,13,4674,"[960,Max]",Extremamente Elevado,,,,188,Norte,BRAGANÇA,0411,48158.51,4023,274,230,261,293,335,628,889,1119,1393,8.35,2.89,2.32,1.85
03-02-2022,VINHAIS,295,21,3811,"[960,Max]",Extremamente Elevado,,,,295,Norte,BRAGANÇA,0412,69475.09,7746,599,577,636,641,815,1456,2092,2669,3268,11.15,4.7,3.84,3.01
03-02-2022,VISEU,8229,588,8462,"[960,Max]",Extremamente Elevado,,,,8229,Centro,VISEU,1823,50710.14,97249,5769,5038,4140,3158,2710,5868,10008,15046,20815,191.77,41.05,29.67,19.74
03-02-2022,VIZELA,2274,162,9515,"[960,Max]",Extremamente Elevado,,,,2274,Norte,BRAGA,0314,2469.83,23897,1258,928,655,509,371,880,1535,2463,3721,967.49,150.65,99.72,62.15
03-02-2022,VOUZELA,737,53,7659,"[960,Max]",Extremamente Elevado,,,,737,Centro,VISEU,1824,19369.46,9619,626,605,554,532,507,1039,1593,2198,2824,49.66,14.58,11.35,8.22
10-02-2022,ABRANTES,1476,105,4202,"[960,Max]",Extremamente Elevado,,,,1476,Lisboa e Vale do Tejo,SANTARÉM,1401,71469.08,35130,2473,2213,1730,1748,2021,3769,5499,7712,10185,49.15,14.25,10.79,7.69
10-02-2022,ÁGUEDA,3671,262,7968,"[960,Max]",Extremamente Elevado,,,,3671,Centro,AVEIRO,0101,33527.44,46075,3237,2713,2090,1635,1496,3131,5221,7934,11171,137.43,33.32,23.66,15.57
10-02-2022,AGUIAR DA BEIRA,265,19,5697,"[960,Max]",Extremamente Elevado,,,,265,Centro,GUARDA,0901,20676.57,4652,304,281,235,239,148,387,622,903,1207,22.5,5.84,4.37,3.01
10-02-2022,ALANDROAL,119,9,2391,"[960,Max]",Extremamente Elevado,,,,119,Alentejo,ÉVORA,0701,54267.81,4992,307,256,296,299,377,676,972,1228,1535,9.2,2.83,2.26,1.79
10-02-2022,ALBERGARIA-A-VELHA,1908,136,7903,"[960,Max]",Extremamente Elevado,,,,1908,Centro,AVEIRO,0102,15882.5,24144,1550,1298,996,687,680,1367,2363,3661,5211,152.02,32.81,23.05,14.88
10-02-2022,ALBUFEIRA,1956,140,4711,"[960,Max]",Extremamente Elevado,,,,1956,Algarve,FARO,0801,14066.42,41528,2067,1717,1425,985,858,1843,3268,4985,7052,295.24,50.14,35.44,23.23
10-02-2022,ALCÁCER DO SAL,456,33,3915,"[960,Max]",Extremamente Elevado,,,,456,Alentejo,SETÚBAL,1501,149987.3,11659,884,814,623,623,602,1225,1848,2662,3546,7.77,2.36,1.77,1.23
10-02-2022,ALCANENA,569,41,4444,"[960,Max]",Extremamente Elevado,,,,569,Lisboa e Vale do Tejo,SANTARÉM,1402,12732.86,12809,891,744,628,536,588,1124,1752,2496,3387,100.6,26.6,19.6,13.76
10-02-2022,ALCOBAÇA,2899,207,5413,"[960,Max]",Extremamente Elevado,,,,2899,Lisboa e Vale do Tejo,LEIRIA,1001,40814.09,53555,3420,2927,2466,2059,1676,3735,6201,9128,12548,131.22,30.74,22.36,15.19
10-02-2022,ALCOCHETE,882,63,4455,"[960,Max]",Extremamente Elevado,,,,882,Lisboa e Vale do Tejo,SETÚBAL,1502,12836.48,19787,857,834,691,476,447,923,1614,2448,3305,154.15,25.75,19.07,12.57
10-02-2022,ALCOUTIM,84,6,3900,"[960,Max]",Extremamente Elevado,,,,84,Algarve,FARO,0802,57536.33,2159,191,188,163,190,267,457,620,808,999,3.75,1.74,1.4,1.08
10-02-2022,ALENQUER,2352,168,5340,"[960,Max]",Extremamente Elevado,,,,2352,Lisboa e Vale do Tejo,LISBOA,1101,30421.92,44052,2298,2062,1629,1330,1155,2485,4114,6176,8474,144.8,27.85,20.3,13.52
10-02-2022,ALFÂNDEGA DA FÉ,182,13,4007,"[960,Max]",Extremamente Elevado,,,,182,Norte,BRAGANÇA,0401,32194.64,4550,325,277,301,274,325,599,900,1177,1502,14.13,4.67,3.66,2.8
10-02-2022,ALIJÓ,438,31,4123,"[960,Max]",Extremamente Elevado,,,,438,Norte,VILA REAL,1701,29759.89,10625,766,687,635,542,666,1208,1843,2530,3296,35.7,11.08,8.5,6.19
10-02-2022,ALJEZUR,278,20,4966,"[960,Max]",Extremamente Elevado,,,,278,Algarve,FARO,0803,32349.95,5594,316,336,335,320,410,730,1065,1401,1717,17.29,5.31,4.33,3.29
10-02-2022,ALJUSTREL,379,27,4595,"[960,Max]",Extremamente Elevado,,,,379,Alentejo,BEJA,0201,45847.41,8247,635,521,443,347,358,705,1148,1669,2304,17.99,5.03,3.64,2.5
10-02-2022,ALMADA,6618,473,3915,"[960,Max]",Extremamente Elevado,,,,6618,Lisboa e Vale do Tejo,SETÚBAL,1503,7000.89,169039,10469,9777,7876,6144,5111,11255,19131,28908,39377,2414.5,562.45,412.91,273.26
10-02-2022,ALMEIDA,244,17,4183,"[960,Max]",Extremamente Elevado,,,,244,Centro,GUARDA,0902,51798.46,5830,441,419,396,458,393,851,1247,1666,2107,11.26,4.07,3.22,2.41
10-02-2022,ALMEIRIM,927,66,4111,"[960,Max]",Extremamente Elevado,,,,927,Lisboa e Vale do Tejo,SANTARÉM,1403,22212.05,22546,1342,1353,1106,866,843,1709,2815,4168,5510,101.5,24.81,18.76,12.67
10-02-2022,ALMODÔVAR,333,24,4955,"[960,Max]",Extremamente Elevado,,,,333,Alentejo,BEJA,0202,77788.03,6725,414,443,396,373,328,701,1097,1540,1954,8.65,2.51,1.98,1.41
10-02-2022,ALPIARÇA,249,18,3522,"[960,Max]",Extremamente Elevado,,,,249,Lisboa e Vale do Tejo,SANTARÉM,1404,9536.33,7059,515,486,363,333,274,607,970,1456,1971,74.02,20.67,15.27,10.17
10-02-2022,ALTER DO CHÃO,113,8,3571,"[960,Max]",Extremamente Elevado,,,,113,Alentejo,PORTALEGRE,1201,36206.62,3165,201,163,136,208,187,395,531,694,895,8.74,2.47,1.92,1.47
10-02-2022,ALVAIÁZERE,297,21,4507,"[960,Max]",Extremamente Elevado,,,,297,Centro,LEIRIA,1002,16047.76,6597,419,389,346,406,539,945,1291,1680,2099,41.11,13.08,10.47,8.04
10-02-2022,ALVITO,78,6,3160,"[960,Max]",Extremamente Elevado,,,,78,Alentejo,BEJA,0203,26485.32,2477,145,110,105,111,89,200,305,415,560,9.35,2.11,1.57,1.15
10-02-2022,AMADORA,5138,367,2791,"[960,Max]",Extremamente Elevado,,,,5138,Lisboa e Vale do Tejo,LISBOA,1115,2378.47,184106,11186,10936,8780,6460,5890,12350,21130,32066,43252,7742.05,1818.84,1348.44,888.56
10-02-2022,AMARANTE,3218,230,6050,"[960,Max]",Extremamente Elevado,,,,3218,Norte,PORTO,1301,30133.15,53193,3086,2413,1812,1643,1311,2954,4766,7179,10265,176.53,34.07,23.82,15.82
10-02-2022,AMARES,1332,95,7347,"[960,Max]",Extremamente Elevado,,,,1332,Norte,BRAGA,0301,8195.41,18129,1001,829,622,489,524,1013,1635,2464,3465,221.22,42.28,30.07,19.95
10-02-2022,ANADIA,1866,133,6844,"[960,Max]",Extremamente Elevado,,,,1866,Centro,AVEIRO,0103,21663.48,27258,1931,1698,1376,1208,1262,2470,3846,5544,7475,125.83,34.51,25.59,17.75
10-02-2022,ANGRA DO HEROÍSMO,2339,167,6919,"[960,Max]",Extremamente Elevado,,,,2339,Açores,AÇORES,4301,23899.66,33807,2006,1473,1122,768,635,1403,2525,3998,6004,141.45,25.12,16.73,10.56
10-02-2022,ANSIÃO,665,47,5522,"[960,Max]",Extremamente Elevado,,,,665,Centro,LEIRIA,1003,17609.42,12039,727,709,646,694,530,1224,1870,2579,3306,68.37,18.77,14.65,10.62
10-02-2022,ARCOS DE VALDEVEZ,882,63,4215,"[960,Max]",Extremamente Elevado,,,,882,Norte,VIANA DO CASTELO,1601,44759.64,20926,1329,1338,1282,1343,1515,2858,4140,5478,6807,46.75,15.21,12.24,9.25
10-02-2022,ARGANIL,663,47,6023,"[960,Max]",Extremamente Elevado,,,,663,Centro,COIMBRA,0601,33283.93,11014,672,648,612,559,596,1155,1767,2415,3087,33.09,9.27,7.26,5.31
10-02-2022,ARMAMAR,225,16,3901,"[960,Max]",Extremamente Elevado,,,,225,Norte,VISEU,1801,11723.73,5769,357,305,309,285,310,595,904,1209,1566,49.21,13.36,10.31,7.71
10-02-2022,AROUCA,1314,94,6342,"[960,Max]",Extremamente Elevado,,,,1314,Norte,AVEIRO,0104,32910.52,20720,1306,1047,753,683,683,1366,2119,3166,4472,62.96,13.59,9.62,6.44
10-02-2022,ARRAIOLOS,295,21,4251,"[960,Max]",Extremamente Elevado,,,,295,Alentejo,ÉVORA,0702,68374.55,6928,435,384,283,367,480,847,1130,1514,1949,10.13,2.85,2.21,1.65
10-02-2022,ARRONCHES,141,10,4996,"[960,Max]",Extremamente Elevado,,,,141,Alentejo,PORTALEGRE,1202,31464.72,2820,155,142,162,187,179,366,528,670,825,8.96,2.62,2.13,1.68
10-02-2022,ARRUDA DOS VINHOS,836,60,5427,"[960,Max]",Extremamente Elevado,,,,836,Lisboa e Vale do Tejo,LISBOA,1102,7795.93,15412,738,738,562,509,438,947,1509,2247,2985,197.69,38.29,28.82,19.36
10-02-2022,AVEIRO,6651,475,8447,"[960,Max]",Extremamente Elevado,,,,6651,Centro,AVEIRO,0105,19757.57,78734,4520,4004,3050,2250,2103,4353,7403,11407,15927,398.49,80.61,57.73,37.47
10-02-2022,AVIS,188,13,4435,"[960,Max]",Extremamente Elevado,,,,188,Alentejo,PORTALEGRE,1203,60596.51,4247,315,225,206,251,273,524,730,955,1270,7.01,2.1,1.58,1.2
10-02-2022,AZAMBUJA,1160,83,5107,"[960,Max]",Extremamente Elevado,,,,1160,Lisboa e Vale do Tejo,LISBOA,1103,26265.65,22716,1322,1171,1070,798,618,1416,2486,3657,4979,86.48,18.96,13.92,9.46
10-02-2022,BAIÃO,1047,75,5583,"[960,Max]",Extremamente Elevado,,,,1047,Norte,PORTO,1302,17452.83,18748,1070,862,714,686,725,1411,2125,2987,4057,107.42,23.25,17.11,12.18
10-02-2022,BARCELOS,6883,492,5924,"[960,Max]",Extremamente Elevado,,,,6883,Norte,BRAGA,0302,37890.14,116187,6721,5325,3619,2991,2562,5553,9172,14497,21218,306.64,56.0,38.26,24.21
10-02-2022,BARRANCOS,22,2,1356,"[960,Max]",Extremamente Elevado,,,,22,Alentejo,BEJA,0204,16841.73,1634,90,65,65,94,61,155,220,285,375,9.7,2.23,1.69,1.31
10-02-2022,BARREIRO,2926,209,3894,"[960,Max]",Extremamente Elevado,,,,2926,Lisboa e Vale do Tejo,SETÚBAL,1504,3639.07,75147,5194,5565,4459,3105,1767,4872,9331,14896,20090,2065.05,552.07,409.34,256.42
10-02-2022,BATALHA,1036,74,6489,"[960,Max]",Extremamente Elevado,,,,1036,Centro,LEIRIA,1004,10341.6,15963,873,762,649,529,549,1078,1727,2489,3362,154.35,32.51,24.07,16.7
10-02-2022,BEJA,2262,162,6737,"[960,Max]",Extremamente Elevado,,,,2262,Alentejo,BEJA,0205,114647.55,33579,2005,1840,1386,1272,1039,2311,3697,5537,7542,29.29,6.58,4.83,3.22
10-02-2022,BELMONTE,285,20,4449,"[960,Max]",Extremamente Elevado,,,,285,Centro,CASTELO BRANCO,0501,11875.91,6398,444,321,325,310,355,665,990,1311,1755,53.87,14.78,11.04,8.34
10-02-2022,BENAVENTE,1437,103,4696,"[960,Max]",Extremamente Elevado,,,,1437,Lisboa e Vale do Tejo,SANTARÉM,1405,52138.39,30602,1468,1376,1141,876,643,1519,2660,4036,5504,58.69,10.56,7.74,5.1
10-02-2022,BOMBARRAL,562,40,4478,"[960,Max]",Extremamente Elevado,,,,562,Lisboa e Vale do Tejo,LEIRIA,1005,9128.55,12558,875,714,561,491,429,920,1481,2195,3070,137.56,33.63,24.04,16.22
10-02-2022,BORBA,333,24,4949,"[960,Max]",Extremamente Elevado,,,,333,Alentejo,ÉVORA,0703,14518.65,6736,430,375,279,436,392,828,1107,1482,1912,46.39,13.17,10.21,7.62
10-02-2022,BOTICAS,254,18,5075,"[960,Max]",Extremamente Elevado,,,,254,Norte,VILA REAL,1702,32195.66,4998,347,306,311,305,380,685,996,1302,1649,15.52,5.12,4.04,3.09
10-02-2022,BRAGA,14812,1058,8108,"[960,Max]",Extremamente Elevado,,,,14812,Norte,BRAGA,0303,18339.95,182679,10029,7963,5241,4320,3671,7991,13232,21195,31224,996.07,170.25,115.57,72.15
10-02-2022,BRAGANÇA,1251,89,3723,"[960,Max]",Extremamente Elevado,,,,1251,Norte,BRAGANÇA,0402,117357.27,33607,2402,1855,1652,1393,1163,2556,4208,6063,8465,28.64,7.21,5.17,3.59
10-02-2022,CABECEIRAS DE BASTO,748,53,4786,"[960,Max]",Extremamente Elevado,,,,748,Norte,BRAGA,0304,24182.16,15628,774,594,544,575,574,1149,1693,2287,3061,64.63,12.66,9.46,7.0
10-02-2022,CADAVAL,548,39,4005,"[960,Max]",Extremamente Elevado,,,,548,Lisboa e Vale do Tejo,LISBOA,1104,17489.3,13673,813,796,756,621,625,1246,2002,2798,3611,78.18,20.65,16.0,11.45
10-02-2022,CALDAS DA RAINHA,2378,170,4581,"[960,Max]",Extremamente Elevado,,,,2378,Lisboa e Vale do Tejo,LEIRIA,1006,25569.47,51912,3035,2684,2186,1899,1705,3604,5790,8474,11509,203.03,45.01,33.14,22.64
10-02-2022,CALHETA,411,29,3785,"[960,Max]",Extremamente Elevado,,,,411,Madeira,MADEIRA,3101,11150.43,10867,576,497,507,399,415,814,1321,1818,2394,97.46,21.47,16.3,11.85
10-02-2022,CALHETA (AÇORES),46,3,1456,"[960,Max]",Extremamente Elevado,,,,46,Açores,AÇORES,4501,12626.4,3184,215,159,141,139,122,261,402,561,776,25.22,6.15,4.44,3.18
10-02-2022,CÂMARA DE LOBOS,1315,94,3906,"[960,Max]",Extremamente Elevado,,,,1315,Madeira,MADEIRA,3102,5216.67,33675,1396,1059,834,545,381,926,1760,2819,4215,645.49,80.79,54.03,33.74
10-02-2022,CAMINHA,743,53,4681,"[960,Max]",Extremamente Elevado,,,,743,Norte,VIANA DO CASTELO,1602,13652.14,15877,1046,944,818,646,656,1302,2120,3064,4110,116.3,30.11,22.44,15.53
10-02-2022,CAMPO MAIOR,454,32,5762,"[960,Max]",Extremamente Elevado,,,,454,Alentejo,PORTALEGRE,1204,24720.16,7874,471,364,351,279,327,606,957,1321,1792,31.85,7.25,5.34,3.87
10-02-2022,CANTANHEDE,2051,147,5859,"[960,Max]",Extremamente Elevado,,,,2051,Centro,COIMBRA,0602,39088.02,35011,2346,2096,1880,1709,1451,3160,5040,7136,9482,89.57,24.26,18.26,12.89
10-02-2022,CARRAZEDA DE ANSIÃES,317,23,5597,"[960,Max]",Extremamente Elevado,,,,317,Norte,BRAGANÇA,0403,27924.09,5666,424,389,391,312,465,777,1168,1557,1981,20.29,7.09,5.58,4.18
10-02-2022,CARREGAL DO SAL,413,30,4456,"[960,Max]",Extremamente Elevado,,,,413,Centro,VISEU,1802,11689.21,9271,587,562,486,462,376,838,1324,1886,2473,79.31,21.16,16.13,11.33
10-02-2022,CARTAXO,1034,74,4336,"[960,Max]",Extremamente Elevado,,,,1034,Lisboa e Vale do Tejo,SANTARÉM,1406,15817.28,23843,1415,1376,1142,861,632,1493,2635,4011,5426,150.74,34.3,25.36,16.66
10-02-2022,CASCAIS,10627,759,4975,"[960,Max]",Extremamente Elevado,,,,10627,Lisboa e Vale do Tejo,LISBOA,1105,9740.17,213608,12151,11444,8680,6469,5248,11717,20397,31841,43992,2193.1,451.66,326.91,209.41
10-02-2022,CASTANHEIRA DE PÊRA,73,5,2794,"[960,Max]",Extremamente Elevado,,,,73,Centro,LEIRIA,1007,6677.45,2614,233,195,157,190,187,377,534,729,962,39.15,14.41,10.92,8.0
10-02-2022,CASTELO BRANCO,2879,206,5538,"[960,Max]",Extremamente Elevado,,,,2879,Centro,CASTELO BRANCO,0502,143819.15,51987,3528,3042,2499,2229,2225,4454,6953,9995,13523,36.15,9.4,6.95,4.83
10-02-2022,CASTELO DE PAIVA,962,69,6228,"[960,Max]",Extremamente Elevado,,,,962,Norte,AVEIRO,0106,11500.53,15454,881,697,545,420,431,851,1396,2093,2974,134.37,25.86,18.2,12.14
10-02-2022,CASTELO DE VIDE,101,7,3461,"[960,Max]",Extremamente Elevado,,,,101,Alentejo,PORTALEGRE,1205,26491.24,2919,204,173,179,147,170,317,496,669,873,11.02,3.3,2.53,1.87
10-02-2022,CASTRO DAIRE,797,57,5769,"[960,Max]",Extremamente Elevado,,,,797,Centro,VISEU,1803,37904.13,13823,942,857,765,732,773,1505,2270,3127,4069,36.47,10.74,8.25,5.99
10-02-2022,CASTRO MARIM,225,16,3614,"[960,Max]",Extremamente Elevado,,,,225,Algarve,FARO,0804,30084.37,6237,370,345,334,322,344,666,1000,1345,1715,20.73,5.7,4.47,3.32
10-02-2022,CASTRO VERDE,400,29,5762,"[960,Max]",Extremamente Elevado,,,,400,Alentejo,BEJA,0206,56944.23,6949,437,347,303,275,227,502,805,1152,1589,12.2,2.79,2.02,1.41
10-02-2022,CELORICO DA BEIRA,265,19,3822,"[960,Max]",Extremamente Elevado,,,,265,Centro,GUARDA,0903,24721.63,6928,430,416,363,369,535,904,1267,1683,2113,28.02,8.55,6.81,5.12
10-02-2022,CELORICO DE BASTO,964,69,5062,"[960,Max]",Extremamente Elevado,,,,964,Norte,BRAGA,0305,18107.02,19040,1001,802,668,728,729,1457,2125,2927,3928,105.15,21.69,16.17,11.74
10-02-2022,CHAMUSCA,276,20,3000,"[960,Max]",Extremamente Elevado,,,,276,Lisboa e Vale do Tejo,SANTARÉM,1407,74600.54,9197,629,583,553,465,579,1044,1597,2180,2809,12.33,3.77,2.92,2.14
10-02-2022,CHAVES,1697,121,4314,"[960,Max]",Extremamente Elevado,,,,1697,Norte,VILA REAL,1703,59122.95,39343,2676,2429,1991,1886,1918,3804,5795,8224,10900,66.54,18.44,13.91,9.8
10-02-2022,CINFÃES,827,59,4533,"[960,Max]",Extremamente Elevado,,,,827,Norte,VISEU,1804,23928.76,18244,1067,902,779,734,758,1492,2271,3173,4240,76.24,17.72,13.26,9.49
10-02-2022,COIMBRA,8871,634,6612,"[960,Max]",Extremamente Elevado,,,,8871,Centro,COIMBRA,0603,31939.94,134166,9489,8734,6353,5139,5074,10213,16566,25300,34789,420.06,108.92,79.21,51.87
10-02-2022,CONDEIXA-A-NOVA,1046,75,5896,"[960,Max]",Extremamente Elevado,,,,1046,Centro,COIMBRA,0604,13867.47,17733,871,809,717,583,490,1073,1790,2599,3470,127.88,25.02,18.74,12.91
10-02-2022,CONSTÂNCIA,278,20,6887,"[960,Max]",Extremamente Elevado,,,,278,Lisboa e Vale do Tejo,SANTARÉM,1408,8036.58,4030,211,183,187,148,155,303,490,673,884,50.14,11.0,8.37,6.1
10-02-2022,CORUCHE,588,42,3363,"[960,Max]",Extremamente Elevado,,,,588,Lisboa e Vale do Tejo,SANTARÉM,1409,111572.03,17471,1294,1090,1095,1096,1019,2115,3210,4300,5594,15.66,5.01,3.85,2.88
10-02-2022,CORVO,3,0,638,"[480,960]",Muito Elevado,,,,3,Açores,AÇORES,4901,1711.45,464,22,21,11,13,19,32,43,64,86,27.12,5.03,3.74,2.51
10-02-2022,COVILHÃ,4034,288,8621,"[960,Max]",Extremamente Elevado,,,,4034,Centro,CASTELO BRANCO,0503,55560.06,46787,3533,2998,2365,2111,2193,4304,6669,9667,13200,84.21,23.76,17.4,12.0
10-02-2022,CRATO,114,8,3630,"[960,Max]",Extremamente Elevado,,,,114,Alentejo,PORTALEGRE,1206,39806.88,3129,229,258,163,182,228,410,573,831,1060,7.86,2.66,2.09,1.44
10-02-2022,CUBA,212,15,4618,"[960,Max]",Extremamente Elevado,,,,212,Alentejo,BEJA,0207,17208.72,4595,255,233,206,190,143,333,539,772,1027,26.7,5.97,4.49,3.13
10-02-2022,ELVAS,1065,76,5190,"[960,Max]",Extremamente Elevado,,,,1065,Alentejo,PORTALEGRE,1207,63128.86,20528,1057,1145,902,852,810,1662,2564,3709,4766,32.52,7.55,5.88,4.06
10-02-2022,ENTRONCAMENTO,1082,77,5018,"[960,Max]",Extremamente Elevado,,,,1082,Lisboa e Vale do Tejo,SANTARÉM,1410,1372.81,21558,1066,930,868,695,592,1287,2155,3085,4151,1570.14,302.33,224.69,156.96
10-02-2022,ESPINHO,2097,150,7103,"[960,Max]",Extremamente Elevado,,,,2097,Norte,AVEIRO,0107,2105.68,29516,2205,1993,1430,1177,960,2137,3567,5560,7765,1401.52,368.71,264.01,169.37
10-02-2022,ESPOSENDE,2202,157,6444,"[960,Max]",Extremamente Elevado,,,,2202,Norte,BRAGA,0306,9540.98,34177,1831,1522,1095,894,723,1617,2712,4234,6065,358.21,63.57,44.38,28.42
10-02-2022,ESTARREJA,1916,137,7366,"[960,Max]",Extremamente Elevado,,,,1916,Centro,AVEIRO,0108,10817.33,26006,1503,1399,1106,953,728,1681,2787,4186,5689,240.42,52.59,38.7,25.76
10-02-2022,ESTREMOZ,439,31,3452,"[960,Max]",Extremamente Elevado,,,,439,Alentejo,ÉVORA,0704,51379.95,12728,789,613,697,786,877,1663,2360,2973,3762,24.77,7.32,5.79,4.59
10-02-2022,ÉVORA,3288,235,6271,"[960,Max]",Extremamente Elevado,,,,3288,Alentejo,ÉVORA,0705,130707.58,52428,3569,2852,2176,1966,1803,3769,5945,8797,12366,40.11,9.46,6.73,4.55
10-02-2022,FAFE,2549,182,5304,"[960,Max]",Extremamente Elevado,,,,2549,Norte,BRAGA,0307,21908.11,48060,3044,2455,1679,1403,1208,2611,4290,6745,9789,219.37,44.68,30.79,19.58
10-02-2022,FARO,4275,305,7007,"[960,Max]",Extremamente Elevado,,,,4275,Algarve,FARO,0805,20256.79,61015,3847,3364,2604,2055,1601,3656,6260,9624,13471,301.2,66.5,47.51,30.9
10-02-2022,FELGUEIRAS,2808,201,4976,"[960,Max]",Extremamente Elevado,,,,2808,Norte,PORTO,1303,11573.75,56422,2951,2302,1601,1316,973,2289,3890,6192,9143,487.49,79.0,53.5,33.61
10-02-2022,FERREIRA DO ALENTEJO,432,31,5508,"[960,Max]",Extremamente Elevado,,,,432,Alentejo,BEJA,0208,64820.68,7845,515,414,372,343,345,688,1060,1474,1989,12.1,3.07,2.27,1.64
10-02-2022,FERREIRA DO ZÊZERE,296,21,3722,"[960,Max]",Extremamente Elevado,,,,296,Lisboa e Vale do Tejo,SANTARÉM,1411,19038.03,7959,470,370,416,465,456,921,1337,1707,2177,41.81,11.44,8.97,7.02
10-02-2022,FIGUEIRA DA FOZ,3467,248,5901,"[960,Max]",Extremamente Elevado,,,,3467,Centro,COIMBRA,0605,37905.26,58747,4032,3597,2887,2495,2043,4538,7425,11022,15054,154.98,39.72,29.08,19.59
10-02-2022,FIGUEIRA DE CASTELO RODRIGO,193,14,3454,"[960,Max]",Extremamente Elevado,,,,193,Centro,GUARDA,0904,50857.46,5584,347,352,290,352,391,743,1033,1385,1732,10.98,3.41,2.72,2.03
10-02-2022,FIGUEIRÓ DOS VINHOS,208,15,3738,"[960,Max]",Extremamente Elevado,,,,208,Centro,LEIRIA,1008,17344.0,5568,402,386,322,309,351,660,982,1368,1770,32.1,10.21,7.89,5.66
10-02-2022,FORNOS DE ALGODRES,182,13,4010,"[960,Max]",Extremamente Elevado,,,,182,Centro,GUARDA,0905,13145.05,4528,261,218,247,256,232,488,735,953,1214,34.45,9.24,7.25,5.59
10-02-2022,FREIXO DE ESPADA À CINTA,92,7,2779,"[960,Max]",Extremamente Elevado,,,,92,Norte,BRAGANÇA,0404,24414.29,3298,211,177,231,196,189,385,616,793,1004,13.51,4.11,3.25,2.52
10-02-2022,FRONTEIRA,185,13,6205,"[960,Max]",Extremamente Elevado,,,,185,Alentejo,PORTALEGRE,1208,24859.58,2974,213,182,149,156,168,324,473,655,868,11.96,3.49,2.63,1.9
10-02-2022,FUNCHAL,3782,270,3636,"[960,Max]",Extremamente Elevado,,,,3782,Madeira,MADEIRA,3103,7616.2,104024,6382,5086,3643,2821,1990,4811,8454,13540,19922,1365.86,261.58,177.78,111.0
10-02-2022,FUNDÃO,1559,111,5883,"[960,Max]",Extremamente Elevado,,,,1559,Centro,CASTELO BRANCO,0504,70019.79,26495,1781,1464,1432,1357,1643,3000,4432,5896,7677,37.84,10.96,8.42,6.33
10-02-2022,GAVIÃO,137,10,4210,"[960,Max]",Extremamente Elevado,,,,137,Alentejo,PORTALEGRE,1209,29459.45,3263,189,186,222,263,293,556,778,964,1153,11.08,3.91,3.27,2.64
10-02-2022,GÓIS,232,17,6096,"[960,Max]",Extremamente Elevado,,,,232,Centro,COIMBRA,0606,26330.19,3805,235,199,240,233,244,477,717,916,1151,14.45,4.37,3.48,2.72
10-02-2022,GOLEGÃ,234,17,4386,"[960,Max]",Extremamente Elevado,,,,234,Lisboa e Vale do Tejo,SANTARÉM,1412,8431.67,5339,356,299,281,243,255,498,779,1078,1434,63.32,17.01,12.78,9.24
10-02-2022,GONDOMAR,13287,949,8005,"[960,Max]",Extremamente Elevado,,,,13287,Norte,PORTO,1304,13191.76,165985,10555,8755,6222,4450,3364,7814,14036,22791,33346,1258.22,252.77,172.76,106.4
10-02-2022,GOUVEIA,481,34,3883,"[960,Max]",Extremamente Elevado,,,,481,Centro,GUARDA,0906,30061.17,12387,871,931,780,783,810,1593,2373,3304,4175,41.21,13.89,10.99,7.89
10-02-2022,GRÂNDOLA,645,46,4409,"[960,Max]",Extremamente Elevado,,,,645,Alentejo,SETÚBAL,1505,82593.66,14639,834,834,708,688,672,1360,2068,2902,3736,17.72,4.52,3.51,2.5
10-02-2022,GUARDA,2258,161,5795,"[960,Max]",Extremamente Elevado,,,,2258,Centro,GUARDA,0907,71209.58,38969,2477,2041,1686,1415,1474,2889,4575,6616,9093,54.72,12.77,9.29,6.42
10-02-2022,GUIMARÃES,8668,619,5691,"[960,Max]",Extremamente Elevado,,,,8668,Norte,BRAGA,0308,24099.96,152309,9394,7074,4809,3877,2948,6825,11634,18708,28102,631.99,116.61,77.63,48.27
10-02-2022,HORTA,335,24,2306,"[960,Max]",Extremamente Elevado,,,,335,Açores,AÇORES,4701,17305.53,14521,818,658,468,352,302,654,1122,1780,2598,83.91,15.01,10.29,6.48
10-02-2022,IDANHA-A-NOVA,192,14,2385,"[960,Max]",Extremamente Elevado,,,,192,Centro,CASTELO BRANCO,0505,141633.51,8043,518,490,519,672,974,1646,2165,2655,3173,5.68,2.24,1.87,1.53
10-02-2022,ÍLHAVO,2806,200,7252,"[960,Max]",Extremamente Elevado,,,,2806,Centro,AVEIRO,0110,7347.55,38699,2227,1943,1444,1193,850,2043,3487,5430,7657,526.66,104.21,73.9,47.46
10-02-2022,LAGOA (FARO),1306,93,5738,"[960,Max]",Extremamente Elevado,,,,1306,Algarve,FARO,0806,8825.45,22762,1314,1168,919,749,670,1419,2338,3506,4820,257.93,54.62,39.73,26.49
10-02-2022,LAGOA,1261,90,8563,"[960,Max]",Extremamente Elevado,,,,1261,Açores,AÇORES,4201,4559.32,14721,536,458,349,238,235,473,822,1280,1816,322.9,39.83,28.08,18.03
10-02-2022,LAGOS,1781,127,5864,"[960,Max]",Extremamente Elevado,,,,1781,Algarve,FARO,0807,21299.27,30374,1744,1434,1247,1053,1029,2082,3329,4763,6507,142.61,30.55,22.36,15.63
10-02-2022,LAJES DAS FLORES,43,3,2941,"[960,Max]",Extremamente Elevado,,,,43,Açores,AÇORES,4801,7004.79,1463,88,53,62,46,54,100,162,215,303,20.89,4.33,3.07,2.31
10-02-2022,LAJES DO PICO,122,9,2727,"[960,Max]",Extremamente Elevado,,,,122,Açores,AÇORES,4601,15531.09,4490,304,231,223,159,162,321,544,775,1079,28.91,6.95,4.99,3.5
10-02-2022,LAMEGO,1476,105,5930,"[960,Max]",Extremamente Elevado,,,,1476,Norte,VISEU,1805,16542.11,24895,1639,1284,1124,898,783,1681,2805,4089,5728,150.5,34.63,24.72,16.96
10-02-2022,LEIRIA,9583,684,7650,"[960,Max]",Extremamente Elevado,,,,9583,Centro,LEIRIA,1009,56508.83,125267,7389,6366,5090,3902,3159,7061,12151,18517,25906,221.68,45.84,32.77,21.5
10-02-2022,LISBOA,24538,1753,4816,"[960,Max]",Extremamente Elevado,,,,24538,Lisboa e Vale do Tejo,LISBOA,1106,10005.43,509515,33197,33340,27706,23037,26770,49807,77513,110853,144050,5092.6,1439.78,1107.98,774.74
10-02-2022,LOULÉ,3837,274,5586,"[960,Max]",Extremamente Elevado,,,,3837,Algarve,FARO,0808,76366.91,68697,3890,3350,2780,2358,2251,4609,7389,10739,14629,89.96,19.16,14.06,9.68
10-02-2022,LOURES,8058,576,3771,"[960,Max]",Extremamente Elevado,,,,8058,Lisboa e Vale do Tejo,LISBOA,1107,16723.99,213687,12746,12794,9644,6669,5033,11702,21346,34140,46886,1277.73,280.35,204.14,127.64
10-02-2022,LOURINHÃ,1258,90,4866,"[960,Max]",Extremamente Elevado,,,,1258,Lisboa e Vale do Tejo,LISBOA,1108,14717.2,25855,1584,1243,992,842,645,1487,2479,3722,5306,175.68,36.05,25.29,16.84
10-02-2022,LOUSÃ,1187,85,6917,"[960,Max]",Extremamente Elevado,,,,1187,Centro,COIMBRA,0607,13840.01,17158,946,866,658,528,450,978,1636,2502,3448,123.97,24.91,18.08,11.82
10-02-2022,LOUSADA,2198,157,4702,"[960,Max]",Extremamente Elevado,,,,2198,Norte,PORTO,1305,9608.01,46755,2289,1698,1176,853,621,1474,2650,4348,6637,486.63,69.08,45.25,27.58
10-02-2022,MAÇÃO,228,16,3633,"[960,Max]",Extremamente Elevado,,,,228,Lisboa e Vale do Tejo,SANTARÉM,1413,39997.98,6267,386,362,390,440,657,1097,1487,1849,2235,15.67,5.59,4.62,3.72
10-02-2022,MACEDO DE CAVALEIROS,493,35,3398,"[960,Max]",Extremamente Elevado,,,,493,Norte,BRAGANÇA,0405,69914.08,14516,1082,889,878,823,938,1761,2639,3528,4610,20.76,6.59,5.05,3.77
10-02-2022,MACHICO,733,52,3669,"[960,Max]",Extremamente Elevado,,,,733,Madeira,MADEIRA,3104,6825.1,19981,1197,860,662,455,331,786,1448,2308,3505,292.76,51.36,33.82,21.22
10-02-2022,MADALENA,287,21,4877,"[960,Max]",Extremamente Elevado,,,,287,Açores,AÇORES,4602,14712.33,5895,334,256,173,190,179,369,542,798,1132,40.07,7.69,5.42,3.68
10-02-2022,MAFRA,4970,355,5860,"[960,Max]",Extremamente Elevado,,,,4970,Lisboa e Vale do Tejo,LISBOA,1109,29165.5,84816,3613,3334,2839,2089,1899,3988,6827,10161,13774,290.81,47.23,34.84,23.41
10-02-2022,MAIA,11108,793,7993,"[960,Max]",Extremamente Elevado,,,,11108,Norte,PORTO,1306,8293.94,138971,7801,6617,4512,3339,2631,5970,10482,17099,24900,1675.56,300.22,206.16,126.38
10-02-2022,MANGUALDE,1036,74,5599,"[960,Max]",Extremamente Elevado,,,,1036,Centro,VISEU,1806,21925.56,18510,1198,1128,885,852,743,1595,2480,3608,4806,84.42,21.92,16.46,11.31
10-02-2022,MANTEIGAS,193,14,6430,"[960,Max]",Extremamente Elevado,,,,193,Centro,GUARDA,0908,12197.55,3007,258,197,159,167,146,313,472,669,927,24.65,7.6,5.48,3.87
10-02-2022,MARCO DE CANAVESES,3295,235,6398,"[960,Max]",Extremamente Elevado,,,,3295,Norte,PORTO,1307,20188.98,51496,2678,2060,1488,1265,1023,2288,3776,5836,8514,255.07,42.17,28.91,18.7
10-02-2022,MARINHA GRANDE,2815,201,7309,"[960,Max]",Extremamente Elevado,,,,2815,Centro,LEIRIA,1010,18725.19,38508,2365,2302,1638,1359,1058,2417,4055,6357,8722,205.65,46.58,33.95,21.66
10-02-2022,MARVÃO,126,9,4187,"[960,Max]",Extremamente Elevado,,,,126,Alentejo,PORTALEGRE,1210,15489.9,3005,198,185,142,197,237,434,576,761,959,19.4,6.19,4.91,3.72
10-02-2022,MATOSINHOS,12894,921,7353,"[960,Max]",Extremamente Elevado,,,,12894,Norte,PORTO,1308,6241.97,175357,11850,9977,7023,5024,3884,8908,15931,25908,37758,2809.31,604.9,415.06,255.22
10-02-2022,MEALHADA,1245,89,6252,"[960,Max]",Extremamente Elevado,,,,1245,Centro,AVEIRO,0111,11065.66,19914,1163,1039,810,828,831,1659,2469,3508,4671,179.96,42.21,31.7,22.31
10-02-2022,MÊDA,189,14,4131,"[960,Max]",Extremamente Elevado,,,,189,Centro,GUARDA,0909,28604.92,4587,343,306,290,288,443,731,1021,1327,1670,16.04,5.84,4.64,3.57
10-02-2022,MELGAÇO,216,15,2665,"[960,Max]",Extremamente Elevado,,,,216,Norte,VIANA DO CASTELO,1603,23824.58,8093,507,567,578,614,675,1289,1867,2434,2941,33.97,12.34,10.22,7.84
10-02-2022,MÉRTOLA,84,6,1372,"[960,Max]",Extremamente Elevado,,,,84,Alentejo,BEJA,0209,129287.34,6142,400,390,378,423,600,1023,1401,1791,2191,4.75,1.69,1.39,1.08
10-02-2022,MESÃO FRIO,152,11,3833,"[960,Max]",Extremamente Elevado,,,,152,Norte,VILA REAL,1704,2664.87,3964,265,205,168,157,120,277,445,650,915,148.74,34.33,24.39,16.7
10-02-2022,MIRA,735,53,6214,"[960,Max]",Extremamente Elevado,,,,735,Centro,COIMBRA,0608,12403.38,11832,727,729,659,550,466,1016,1675,2404,3131,95.4,25.24,19.38,13.5
10-02-2022,MIRANDA DO CORVO,741,53,5829,"[960,Max]",Extremamente Elevado,,,,741,Centro,COIMBRA,0609,12637.79,12708,706,659,568,498,404,902,1470,2129,2835,100.55,22.43,16.85,11.63
10-02-2022,MIRANDA DO DOURO,197,14,2883,"[960,Max]",Extremamente Elevado,,,,197,Norte,BRAGANÇA,0406,48718.31,6830,482,429,442,463,470,933,1375,1804,2286,14.02,4.69,3.7,2.82
10-02-2022,MIRANDELA,787,56,3618,"[960,Max]",Extremamente Elevado,,,,787,Norte,BRAGANÇA,0407,65895.67,21754,1640,1315,1204,1078,947,2025,3229,4544,6184,33.01,9.38,6.9,4.9
10-02-2022,MOGADOURO,230,16,2740,"[960,Max]",Extremamente Elevado,,,,230,Norte,BRAGANÇA,0408,76064.93,8392,589,529,576,630,655,1285,1861,2390,2979,11.03,3.92,3.14,2.45
10-02-2022,MOIMENTA DA BEIRA,343,24,3521,"[960,Max]",Extremamente Elevado,,,,343,Norte,VISEU,1807,21996.9,9736,576,514,471,416,461,877,1348,1862,2438,44.26,11.08,8.46,6.13
10-02-2022,MOITA,2674,191,4152,"[960,Max]",Extremamente Elevado,,,,2674,Lisboa e Vale do Tejo,SETÚBAL,1506,5525.98,64407,4226,3646,2623,1801,1425,3226,5849,9495,13721,1165.53,248.3,171.82,105.85
10-02-2022,MONÇÃO,816,58,4564,"[960,Max]",Extremamente Elevado,,,,816,Norte,VIANA DO CASTELO,1604,21130.85,17869,1161,1105,1031,1006,972,1978,3009,4114,5275,84.56,24.96,19.47,14.24
10-02-2022,MONCHIQUE,308,22,6065,"[960,Max]",Extremamente Elevado,,,,308,Algarve,FARO,0809,39530.43,5077,353,384,321,355,392,747,1068,1452,1805,12.84,4.57,3.67,2.7
10-02-2022,MONDIM DE BASTO,298,21,4288,"[960,Max]",Extremamente Elevado,,,,298,Norte,VILA REAL,1705,17207.52,6946,395,300,314,284,283,567,881,1181,1576,40.36,9.16,6.86,5.12
10-02-2022,MONFORTE,177,13,5936,"[960,Max]",Extremamente Elevado,,,,177,Alentejo,PORTALEGRE,1211,42024.82,2975,139,115,117,192,168,360,477,592,731,7.08,1.74,1.41,1.14
10-02-2022,MONTALEGRE,269,19,2995,"[960,Max]",Extremamente Elevado,,,,269,Norte,VILA REAL,1706,80545.71,8997,699,628,595,603,730,1333,1928,2556,3255,11.17,4.04,3.17,2.39
10-02-2022,MONTEMOR-O-NOVO,696,50,4449,"[960,Max]",Extremamente Elevado,,,,696,Alentejo,ÉVORA,0706,123296.65,15647,991,953,868,878,971,1849,2717,3670,4661,12.69,3.78,2.98,2.2
10-02-2022,MONTEMOR-O-VELHO,1518,108,6018,"[960,Max]",Extremamente Elevado,,,,1518,Centro,COIMBRA,0610,22896.23,25224,1496,1397,1217,1057,988,2045,3262,4659,6155,110.17,26.88,20.35,14.25
10-02-2022,MONTIJO,2770,198,4808,"[960,Max]",Extremamente Elevado,,,,2770,Lisboa e Vale do Tejo,SETÚBAL,1507,34861.64,57614,2771,2441,1990,1554,1109,2663,4653,7094,9865,165.26,28.3,20.35,13.35
10-02-2022,MORA,69,5,1660,"[960,Max]",Extremamente Elevado,,,,69,Alentejo,ÉVORA,0707,44395.02,4138,336,275,252,238,257,495,747,1022,1358,9.32,3.06,2.3,1.68
10-02-2022,MORTÁGUA,528,38,6000,"[960,Max]",Extremamente Elevado,,,,528,Centro,VISEU,1808,25117.82,8803,638,584,535,499,460,959,1494,2078,2716,35.05,10.81,8.27,5.95
10-02-2022,MOURA,574,41,4182,"[960,Max]",Extremamente Elevado,,,,574,Alentejo,BEJA,0210,95845.55,13718,817,656,665,542,461,1003,1668,2324,3141,14.31,3.28,2.42,1.74
10-02-2022,MOURÃO,79,6,3206,"[960,Max]",Extremamente Elevado,,,,79,Alentejo,ÉVORA,0708,27862.98,2450,139,108,80,104,109,213,293,401,540,8.79,1.94,1.44,1.05
10-02-2022,MURÇA,137,10,2500,"[960,Max]",Extremamente Elevado,,,,137,Norte,VILA REAL,1707,18937.11,5463,384,341,307,306,319,625,932,1273,1657,28.85,8.75,6.72,4.92
10-02-2022,MURTOSA,724,52,7045,"[960,Max]",Extremamente Elevado,,,,724,Centro,AVEIRO,0112,7308.78,10279,509,473,403,353,409,762,1165,1638,2147,140.63,29.37,22.41,15.94
10-02-2022,NAZARÉ,871,62,6150,"[960,Max]",Extremamente Elevado,,,,871,Lisboa e Vale do Tejo,LEIRIA,1011,8243.43,14165,967,903,670,420,396,816,1486,2389,3356,171.84,40.71,28.98,18.03
10-02-2022,NELAS,712,51,5491,"[960,Max]",Extremamente Elevado,,,,712,Centro,VISEU,1809,12571.48,12974,924,787,668,604,583,1187,1855,2642,3566,103.21,28.37,21.02,14.76
10-02-2022,NISA,247,18,4078,"[960,Max]",Extremamente Elevado,,,,247,Alentejo,PORTALEGRE,1212,57567.84,6061,405,389,355,483,478,961,1316,1705,2110,10.53,3.67,2.96,2.29
10-02-2022,NORDESTE,355,25,7304,"[960,Max]",Extremamente Elevado,,,,355,Açores,AÇORES,4202,10146.8,4862,246,180,124,161,162,323,447,627,873,47.92,8.6,6.18,4.41
10-02-2022,ÓBIDOS,609,44,5141,"[960,Max]",Extremamente Elevado,,,,609,Lisboa e Vale do Tejo,LEIRIA,1012,14155.44,11850,743,650,574,452,436,888,1462,2112,2855,83.72,20.17,14.92,10.33
10-02-2022,ODEMIRA,1179,84,4772,"[960,Max]",Extremamente Elevado,,,,1179,Alentejo,BEJA,0211,172060.15,24717,1475,1317,1225,1397,1349,2746,3971,5288,6763,14.37,3.93,3.07,2.31
10-02-2022,ODIVELAS,6332,452,3914,"[960,Max]",Extremamente Elevado,,,,6332,Lisboa e Vale do Tejo,LISBOA,1116,2654.36,161774,9562,9038,6952,4641,3812,8453,15405,24443,34005,6095.48,1281.27,920.99,580.44
10-02-2022,OEIRAS,8324,595,4692,"[960,Max]",Extremamente Elevado,,,,8324,Lisboa e Vale do Tejo,LISBOA,1110,4588.31,177408,11580,11575,8566,6211,5855,12066,20632,32207,43787,3866.78,954.38,701.98,449.69
10-02-2022,OLEIROS,213,15,4252,"[960,Max]",Extremamente Elevado,,,,213,Centro,CASTELO BRANCO,0506,47109.31,5003,384,341,366,397,487,884,1250,1591,1975,10.62,4.19,3.38,2.65
10-02-2022,OLHÃO,2742,196,6175,"[960,Max]",Extremamente Elevado,,,,2742,Algarve,FARO,0810,13086.38,44405,2455,2309,1689,1342,1268,2610,4299,6608,9063,339.33,69.26,50.5,32.85
10-02-2022,OLIVEIRA DE AZEMÉIS,5028,359,7617,"[960,Max]",Extremamente Elevado,,,,5028,Norte,AVEIRO,0113,16110.41,66011,4155,3614,2794,2183,1738,3921,6715,10329,14484,409.75,89.91,64.12,41.68
10-02-2022,OLIVEIRA DE FRADES,576,41,5799,"[960,Max]",Extremamente Elevado,,,,576,Centro,VISEU,1810,14534.62,9936,553,475,438,359,415,774,1212,1687,2240,68.36,15.41,11.61,8.34
10-02-2022,OLIVEIRA DO BAIRRO,1737,124,7153,"[960,Max]",Extremamente Elevado,,,,1737,Centro,AVEIRO,0114,8731.99,24277,1327,1182,999,786,810,1596,2595,3777,5104,278.02,58.45,43.25,29.72
10-02-2022,OLIVEIRA DO HOSPITAL,1067,76,5543,"[960,Max]",Extremamente Elevado,,,,1067,Centro,COIMBRA,0611,23451.66,19253,1161,1097,962,924,960,1884,2846,3943,5104,82.1,21.76,16.81,12.14
10-02-2022,OURÉM,2949,211,6696,"[960,Max]",Extremamente Elevado,,,,2949,Lisboa e Vale do Tejo,SANTARÉM,1421,41668.03,44044,2463,2069,1899,1817,1603,3420,5319,7388,9851,105.7,23.64,17.73,12.77
10-02-2022,OURIQUE,297,21,6447,"[960,Max]",Extremamente Elevado,,,,297,Alentejo,BEJA,0212,66331.36,4607,313,287,284,268,227,495,779,1066,1379,6.95,2.08,1.61,1.17
10-02-2022,OVAR,4269,305,7868,"[960,Max]",Extremamente Elevado,,,,4269,Centro,AVEIRO,0115,14770.25,54260,3294,2709,1994,1636,1234,2870,4864,7573,10867,367.37,73.57,51.27,32.93
10-02-2022,PAÇOS DE FERREIRA,2640,189,4653,"[960,Max]",Extremamente Elevado,,,,2640,Norte,PORTO,1309,7099.29,56728,2903,2193,1518,1135,664,1799,3317,5510,8413,799.1,118.51,77.62,46.72
10-02-2022,PALMELA,3439,246,5351,"[960,Max]",Extremamente Elevado,,,,3439,Lisboa e Vale do Tejo,SETÚBAL,1508,46512.01,64269,3402,3244,2635,1846,1391,3237,5872,9116,12518,138.18,26.91,19.6,12.62
10-02-2022,PAMPILHOSA DA SERRA,81,6,2009,"[960,Max]",Extremamente Elevado,,,,81,Centro,COIMBRA,0612,39646.24,4037,238,254,295,339,423,762,1057,1311,1549,10.18,3.91,3.31,2.67
10-02-2022,PAREDES,4935,353,5734,"[960,Max]",Extremamente Elevado,,,,4935,Norte,PORTO,1310,15675.69,86067,4272,3532,2412,1717,1258,2975,5387,8919,13191,549.04,84.15,56.9,34.36
10-02-2022,PAREDES DE COURA,340,24,3978,"[960,Max]",Extremamente Elevado,,,,340,Norte,VIANA DO CASTELO,1605,13818.59,8535,466,528,407,465,515,980,1387,1915,2381,61.76,17.23,13.86,10.04
10-02-2022,PEDRÓGÃO GRANDE,122,9,3572,"[960,Max]",Extremamente Elevado,,,,122,Centro,LEIRIA,1013,12874.75,3410,175,173,196,221,252,473,669,842,1017,26.49,7.9,6.54,5.2
10-02-2022,PENACOVA,650,46,4749,"[960,Max]",Extremamente Elevado,,,,650,Centro,COIMBRA,0613,21673.23,13694,968,923,745,621,703,1324,2069,2992,3960,63.18,18.27,13.81,9.55
10-02-2022,PENAFIEL,4131,295,5921,"[960,Max]",Extremamente Elevado,,,,4131,Norte,PORTO,1311,21224.27,69772,3648,2823,2032,1663,1230,2893,4925,7748,11396,328.74,53.69,36.51,23.2
10-02-2022,PENALVA DO CASTELO,328,23,4605,"[960,Max]",Extremamente Elevado,,,,328,Centro,VISEU,1811,13433.92,7115,449,457,413,391,426,817,1230,1687,2136,52.96,15.9,12.56,9.16
10-02-2022,PENAMACOR,94,7,1969,"[960,Max]",Extremamente Elevado,,,,94,Centro,CASTELO BRANCO,0507,56370.69,4755,262,248,273,451,633,1084,1357,1605,1867,8.44,3.31,2.85,2.41
10-02-2022,PENEDONO,52,4,2022,"[960,Max]",Extremamente Elevado,,,,52,Norte,VISEU,1812,13370.75,2591,172,113,129,156,138,294,423,536,708,19.38,5.3,4.01,3.16
10-02-2022,PENELA,233,17,4325,"[960,Max]",Extremamente Elevado,,,,233,Centro,COIMBRA,0614,13480.0,5397,314,324,274,359,344,703,977,1301,1615,40.04,11.98,9.65,7.25
10-02-2022,PENICHE,1193,85,4501,"[960,Max]",Extremamente Elevado,,,,1193,Lisboa e Vale do Tejo,LEIRIA,1014,7754.98,26501,1746,1504,1203,926,707,1633,2836,4340,6086,341.73,78.48,55.96,36.57
10-02-2022,PESO DA RÉGUA,824,59,5227,"[960,Max]",Extremamente Elevado,,,,824,Norte,VILA REAL,1708,9486.01,15773,1076,843,650,659,455,1114,1764,2607,3683,166.28,38.83,27.48,18.6
10-02-2022,PINHEL,315,22,3701,"[960,Max]",Extremamente Elevado,,,,315,Centro,GUARDA,0910,48452.12,8511,577,566,551,538,689,1227,1778,2344,2921,17.57,6.03,4.84,3.67
10-02-2022,POMBAL,3233,231,6283,"[960,Max]",Extremamente Elevado,,,,3233,Centro,LEIRIA,1015,62600.28,51461,3187,2791,2494,2328,2027,4355,6849,9640,12827,82.21,20.49,15.4,10.94
10-02-2022,PONTA DELGADA,5952,425,8761,"[960,Max]",Extremamente Elevado,,,,5952,Açores,AÇORES,4203,23298.65,67935,3108,2435,1726,1133,902,2035,3761,6196,9304,291.58,39.93,26.59,16.14
10-02-2022,PONTA DO SOL,322,23,3753,"[960,Max]",Extremamente Elevado,,,,322,Madeira,MADEIRA,3105,4622.03,8593,319,283,347,208,221,429,776,1059,1378,185.92,29.81,22.91,16.79
10-02-2022,PONTE DA BARCA,450,32,4028,"[960,Max]",Extremamente Elevado,,,,450,Norte,VIANA DO CASTELO,1606,18211.37,11180,635,576,517,554,490,1044,1561,2137,2772,61.39,15.22,11.73,8.57
10-02-2022,PONTE DE LIMA,1993,142,4825,"[960,Max]",Extremamente Elevado,,,,1993,Norte,VIANA DO CASTELO,1607,32025.46,41315,2321,2022,1720,1596,1462,3058,4778,6800,9121,129.01,28.48,21.23,14.92
10-02-2022,PONTE DE SOR,473,34,3153,"[960,Max]",Extremamente Elevado,,,,473,Alentejo,PORTALEGRE,1213,83971.16,14994,939,800,716,739,831,1570,2286,3086,4025,17.86,4.79,3.68,2.72
10-02-2022,PORTALEGRE,1511,108,6817,"[960,Max]",Extremamente Elevado,,,,1511,Alentejo,PORTALEGRE,1214,44713.64,22172,1577,1351,1137,993,984,1977,3114,4465,6042,49.59,13.51,9.99,6.96
10-02-2022,PORTEL,349,25,5991,"[960,Max]",Extremamente Elevado,,,,349,Alentejo,ÉVORA,0709,60100.57,5828,336,358,283,331,305,636,919,1277,1613,9.7,2.68,2.12,1.53
10-02-2022,PORTIMÃO,3310,236,5966,"[960,Max]",Extremamente Elevado,,,,3310,Algarve,FARO,0811,18206.29,55483,3182,2927,2116,1582,1400,2982,5098,8025,11207,304.75,61.56,44.08,28.0
10-02-2022,PORTO,17123,1223,7905,"[960,Max]",Extremamente Elevado,,,,17123,Norte,PORTO,1312,4142.02,216606,15790,15193,11280,9409,10044,19453,30733,45926,61716,5229.5,1490.0,1108.79,741.98
10-02-2022,PORTO DE MÓS,1381,99,5934,"[960,Max]",Extremamente Elevado,,,,1381,Centro,LEIRIA,1016,26183.41,23275,1355,1210,1034,888,872,1760,2794,4004,5359,88.89,20.47,15.29,10.67
10-02-2022,PORTO MONIZ,57,4,2422,"[960,Max]",Extremamente Elevado,,,,57,Madeira,MADEIRA,3106,8293.38,2342,143,130,95,98,120,218,313,443,586,28.24,7.07,5.34,3.77
10-02-2022,PORTO SANTO,112,8,2155,"[960,Max]",Extremamente Elevado,,,,112,Madeira,MADEIRA,3201,4300.7,5202,240,157,134,110,68,178,312,469,709,120.95,16.48,10.9,7.25
10-02-2022,PÓVOA DE LANHOSO,1261,90,5866,"[960,Max]",Extremamente Elevado,,,,1261,Norte,BRAGA,0309,13465.29,21499,1175,909,732,673,624,1297,2029,2938,4113,159.67,30.55,21.82,15.07
10-02-2022,PÓVOA DE VARZIM,4355,311,6936,"[960,Max]",Extremamente Elevado,,,,4355,Norte,PORTO,1313,8220.59,62784,3712,3120,2134,1594,1305,2899,5033,8153,11865,763.7,144.33,99.17,61.22
10-02-2022,POVOAÇÃO,361,26,6089,"[960,Max]",Extremamente Elevado,,,,361,Açores,AÇORES,4204,10640.77,5927,293,212,191,144,134,278,469,681,974,55.7,9.15,6.4,4.41
10-02-2022,VILA DA PRAIA DA VITÓRIA,1228,88,5761,"[960,Max]",Extremamente Elevado,,,,1228,Açores,AÇORES,4302,16127.06,21317,1133,789,619,436,336,772,1391,2180,3313,132.18,20.54,13.52,8.63
10-02-2022,PROENÇA-A-NOVA,294,21,4031,"[960,Max]",Extremamente Elevado,,,,294,Centro,CASTELO BRANCO,0508,39539.96,7298,508,465,389,400,560,960,1349,1814,2322,18.46,5.87,4.59,3.41
10-02-2022,REDONDO,228,16,3596,"[960,Max]",Extremamente Elevado,,,,228,Alentejo,ÉVORA,0710,36950.87,6353,349,325,288,288,354,642,930,1255,1604,17.19,4.34,3.4,2.52
10-02-2022,REGUENGOS DE MONSARAZ,311,22,3102,"[960,Max]",Extremamente Elevado,,,,311,Alentejo,ÉVORA,0711,46399.72,10015,602,511,455,462,473,935,1390,1901,2503,21.58,5.39,4.1,3.0
10-02-2022,RESENDE,549,39,5418,"[960,Max]",Extremamente Elevado,,,,549,Norte,VISEU,1813,12334.93,10137,560,493,448,433,422,855,1303,1796,2356,82.18,19.1,14.56,10.56
10-02-2022,RIBEIRA BRAVA,575,41,4621,"[960,Max]",Extremamente Elevado,,,,575,Madeira,MADEIRA,3107,6544.88,12435,648,500,411,311,287,598,1009,1509,2157,189.99,32.96,23.06,15.42
10-02-2022,RIBEIRA DE PENA,216,15,3591,"[960,Max]",Extremamente Elevado,,,,216,Norte,VILA REAL,1709,21745.98,6016,371,301,290,310,368,678,968,1269,1640,27.66,7.54,5.84,4.45
10-02-2022,RIBEIRA GRANDE,2999,214,9140,"[960,Max]",Extremamente Elevado,,,,2999,Açores,AÇORES,4205,18015.13,32811,1163,689,512,345,253,598,1110,1799,2962,182.13,16.44,9.99,6.16
10-02-2022,RIO MAIOR,1127,80,5530,"[960,Max]",Extremamente Elevado,,,,1127,Lisboa e Vale do Tejo,SANTARÉM,1414,27276.45,20379,1251,1144,941,795,648,1443,2384,3528,4779,74.71,17.52,12.93,8.74
10-02-2022,SABROSA,292,21,4930,"[960,Max]",Extremamente Elevado,,,,292,Norte,VILA REAL,1710,15692.45,5918,393,314,304,302,350,652,956,1270,1663,37.71,10.6,8.09,6.09
10-02-2022,SABUGAL,310,22,2926,"[960,Max]",Extremamente Elevado,,,,310,Centro,GUARDA,0911,82269.82,10585,724,707,694,796,1009,1805,2499,3206,3930,12.87,4.78,3.9,3.04
10-02-2022,SALVATERRA DE MAGOS,1129,81,5301,"[960,Max]",Extremamente Elevado,,,,1129,Lisboa e Vale do Tejo,SANTARÉM,1415,24393.2,21295,1275,1181,1060,799,772,1571,2631,3812,5087,87.3,20.85,15.63,10.79
10-02-2022,SANTA COMBA DÃO,583,42,5582,"[960,Max]",Extremamente Elevado,,,,583,Centro,VISEU,1814,11194.77,10452,732,684,569,538,464,1002,1571,2255,2987,93.36,26.68,20.14,14.03
10-02-2022,SANTA CRUZ,1567,112,3461,"[960,Max]",Extremamente Elevado,,,,1567,Madeira,MADEIRA,3108,8150.28,45281,1817,1301,974,716,523,1239,2213,3514,5331,555.6,65.41,43.12,27.15
10-02-2022,SANTA CRUZ DA GRACIOSA,309,22,7346,"[960,Max]",Extremamente Elevado,,,,309,Açores,AÇORES,4401,6065.78,4208,228,180,163,124,145,269,432,612,840,69.37,13.85,10.09,7.12
10-02-2022,SANTA CRUZ DAS FLORES,73,5,3372,"[960,Max]",Extremamente Elevado,,,,73,Açores,AÇORES,4802,7091.44,2165,125,98,74,56,51,107,181,279,404,30.53,5.7,3.93,2.55
10-02-2022,SANTA MARIA DA FEIRA,9225,659,6654,"[960,Max]",Extremamente Elevado,,,,9225,Norte,AVEIRO,0109,21587.65,138636,8182,6743,4771,3856,3079,6935,11706,18449,26631,642.19,123.36,85.46,54.22
10-02-2022,SANTA MARTA DE PENAGUIÃO,315,23,4774,"[960,Max]",Extremamente Elevado,,,,315,Norte,VILA REAL,1711,6928.13,6599,483,373,337,316,317,633,970,1343,1826,95.25,26.36,19.39,14.0
10-02-2022,SANTANA,219,16,3264,"[960,Max]",Extremamente Elevado,,,,219,Madeira,MADEIRA,3109,9547.3,6711,418,353,343,282,277,559,902,1255,1673,70.29,17.52,13.15,9.45
10-02-2022,SANTARÉM,2905,207,5059,"[960,Max]",Extremamente Elevado,,,,2905,Lisboa e Vale do Tejo,SANTARÉM,1416,55253.58,57421,3654,3441,2760,2466,2206,4672,7432,10873,14527,103.92,26.29,19.68,13.45
10-02-2022,SANTIAGO DO CACÉM,1439,103,4997,"[960,Max]",Extremamente Elevado,,,,1439,Alentejo,SETÚBAL,1509,105969.29,28791,2144,1689,1472,1295,1215,2510,3982,5671,7815,27.17,7.37,5.35,3.76
10-02-2022,SANTO TIRSO,3984,285,5854,"[960,Max]",Extremamente Elevado,,,,3984,Norte,PORTO,1314,13655.52,68055,4911,3935,2761,2257,1810,4067,6828,10763,15674,498.35,114.78,78.82,50.0
10-02-2022,SÃO BRÁS DE ALPORTEL,563,40,5409,"[960,Max]",Extremamente Elevado,,,,563,Algarve,FARO,0812,15336.92,10416,596,468,467,404,401,805,1272,1740,2336,67.91,15.23,11.35,8.29
10-02-2022,SÃO JOÃO DA MADEIRA,1532,109,6976,"[960,Max]",Extremamente Elevado,,,,1532,Norte,AVEIRO,0116,794.3,21958,1347,1069,796,601,593,1194,1990,3059,4406,2765.49,554.91,385.26,250.63
10-02-2022,SÃO JOÃO DA PESQUEIRA,300,21,4207,"[960,Max]",Extremamente Elevado,,,,300,Norte,VISEU,1815,26610.85,7125,417,330,294,328,328,656,950,1280,1697,26.77,6.38,4.81,3.57
10-02-2022,SÃO PEDRO DO SUL,974,70,6323,"[960,Max]",Extremamente Elevado,,,,974,Centro,VISEU,1816,34895.09,15403,990,962,861,759,909,1668,2529,3491,4481,44.14,12.84,10.0,7.25
10-02-2022,SÃO ROQUE DO PICO,98,7,2991,"[960,Max]",Extremamente Elevado,,,,98,Açores,AÇORES,4603,14236.1,3266,199,141,93,96,113,209,302,443,642,22.94,4.51,3.11,2.12
10-02-2022,SÃO VICENTE,140,10,2719,"[960,Max]",Extremamente Elevado,,,,140,Madeira,MADEIRA,3110,7883.71,5143,272,264,266,225,280,505,771,1035,1307,65.23,16.58,13.13,9.78
10-02-2022,SARDOAL,128,9,3417,"[960,Max]",Extremamente Elevado,,,,128,Lisboa e Vale do Tejo,SANTARÉM,1417,9214.72,3741,227,178,148,165,248,413,561,739,966,40.6,10.48,8.02,6.09
10-02-2022,SÁTÃO,540,39,4667,"[960,Max]",Extremamente Elevado,,,,540,Centro,VISEU,1817,20194.11,11580,765,671,515,465,476,941,1456,2127,2892,57.34,14.32,10.53,7.21
10-02-2022,SEIA,1081,77,4863,"[960,Max]",Extremamente Elevado,,,,1081,Centro,GUARDA,0912,43568.83,22234,1807,1589,1238,1122,721,1843,3081,4670,6477,51.03,14.87,10.72,7.07
10-02-2022,SEIXAL,6900,493,4113,"[960,Max]",Extremamente Elevado,,,,6900,Lisboa e Vale do Tejo,SETÚBAL,1510,9545.17,167752,10586,9270,6661,4391,2930,7321,13982,23252,33838,1757.49,354.51,243.6,146.49
10-02-2022,SERNANCELHE,105,8,1953,"[960,Max]",Extremamente Elevado,,,,105,Norte,VISEU,1818,22861.22,5396,305,293,286,273,260,533,819,1112,1417,23.6,6.2,4.86,3.58
10-02-2022,SERPA,491,35,3435,"[960,Max]",Extremamente Elevado,,,,491,Alentejo,BEJA,0213,110563.34,14304,903,761,719,697,626,1323,2042,2803,3706,12.94,3.35,2.54,1.85
10-02-2022,SERTÃ,876,63,6008,"[960,Max]",Extremamente Elevado,,,,876,Centro,CASTELO BRANCO,0509,44673.17,14577,870,779,790,767,1020,1787,2577,3356,4226,32.63,9.46,7.51,5.77
10-02-2022,SESIMBRA,2182,156,4207,"[960,Max]",Extremamente Elevado,,,,2182,Lisboa e Vale do Tejo,SETÚBAL,1511,19571.75,51858,2400,2321,1853,1257,1083,2340,4193,6514,8914,264.96,45.54,33.28,21.42
10-02-2022,SETÚBAL,5937,424,5157,"[960,Max]",Extremamente Elevado,,,,5937,Lisboa e Vale do Tejo,SETÚBAL,1512,23032.5,115126,7425,6929,5075,3775,2655,6430,11505,18434,25859,499.83,112.27,80.03,49.95
10-02-2022,SEVER DO VOUGA,626,45,5526,"[960,Max]",Extremamente Elevado,,,,626,Centro,AVEIRO,0117,12987.56,11331,766,637,568,540,567,1107,1675,2312,3078,87.24,23.7,17.8,12.9
10-02-2022,SILVES,1725,123,4761,"[960,Max]",Extremamente Elevado,,,,1725,Algarve,FARO,0813,68006.23,36226,2137,1869,1610,1423,1600,3023,4633,6502,8639,53.27,12.7,9.56,6.81
10-02-2022,SINES,719,51,5245,"[960,Max]",Extremamente Elevado,,,,719,Alentejo,SETÚBAL,1513,20330.17,13715,888,791,551,416,268,684,1235,2026,2914,67.46,14.33,9.97,6.07
10-02-2022,SINTRA,14357,1025,3668,"[960,Max]",Extremamente Elevado,,,,14357,Lisboa e Vale do Tejo,LISBOA,1111,31922.73,391402,20490,18316,13545,9137,7284,16421,29966,48282,68772,1226.08,215.43,151.25,93.87
10-02-2022,SOBRAL DE MONTE AGRAÇO,477,34,4477,"[960,Max]",Extremamente Elevado,,,,477,Lisboa e Vale do Tejo,LISBOA,1112,5210.32,10651,564,507,352,272,212,484,836,1343,1907,204.43,36.6,25.78,16.05
10-02-2022,SOURE,1074,77,6273,"[960,Max]",Extremamente Elevado,,,,1074,Centro,COIMBRA,0615,26506.07,17120,1173,1142,1004,883,987,1870,2874,4016,5189,64.59,19.58,15.15,10.84
10-02-2022,SOUSEL,151,11,3420,"[960,Max]",Extremamente Elevado,,,,151,Alentejo,PORTALEGRE,1215,27932.18,4412,261,274,208,302,292,594,802,1076,1337,15.8,4.79,3.85,2.87
10-02-2022,TÁBUA,474,34,4168,"[960,Max]",Extremamente Elevado,,,,474,Centro,COIMBRA,0616,19978.58,11368,729,584,524,430,464,894,1418,2002,2731,56.9,13.67,10.02,7.1
10-02-2022,TABUAÇO,244,17,4037,"[960,Max]",Extremamente Elevado,,,,244,Norte,VISEU,1819,13385.67,6033,372,314,217,282,363,645,862,1176,1548,45.07,11.56,8.79,6.44
10-02-2022,TAROUCA,385,28,4935,"[960,Max]",Extremamente Elevado,,,,385,Norte,VISEU,1820,10008.49,7804,405,335,313,277,324,601,914,1249,1654,77.98,16.53,12.48,9.13
10-02-2022,TAVIRA,1380,99,5627,"[960,Max]",Extremamente Elevado,,,,1380,Algarve,FARO,0814,60696.7,24530,1493,1415,1252,1066,1277,2343,3595,5010,6503,40.41,10.71,8.25,5.92
10-02-2022,TERRAS DE BOURO,303,22,4766,"[960,Max]",Extremamente Elevado,,,,303,Norte,BRAGA,0310,27746.07,6361,391,372,296,319,340,659,955,1327,1718,22.93,6.19,4.78,3.44
10-02-2022,TOMAR,1667,119,4536,"[960,Max]",Extremamente Elevado,,,,1667,Lisboa e Vale do Tejo,SANTARÉM,1418,35120.44,36748,2403,2189,1868,1853,1822,3675,5543,7732,10135,104.64,28.86,22.02,15.78
10-02-2022,TONDELA,1612,115,6116,"[960,Max]",Extremamente Elevado,,,,1612,Centro,VISEU,1821,37121.73,26357,1768,1722,1518,1475,1417,2892,4410,6132,7900,71.0,21.28,16.52,11.88
10-02-2022,TORRE DE MONCORVO,261,19,3392,"[960,Max]",Extremamente Elevado,,,,261,Norte,BRAGANÇA,0409,53155.67,7695,556,478,488,551,719,1270,1758,2236,2792,14.48,5.25,4.21,3.31
10-02-2022,TORRES NOVAS,1820,130,5211,"[960,Max]",Extremamente Elevado,,,,1820,Lisboa e Vale do Tejo,SANTARÉM,1419,26999.68,34933,2324,1979,1738,1406,1475,2881,4619,6598,8922,129.38,33.04,24.44,17.11
10-02-2022,TORRES VEDRAS,4009,286,5105,"[960,Max]",Extremamente Elevado,,,,4009,Lisboa e Vale do Tejo,LISBOA,1113,40714.89,78530,4513,3945,3447,2628,2104,4732,8179,12124,16637,192.88,40.86,29.78,20.09
10-02-2022,TRANCOSO,305,22,3439,"[960,Max]",Extremamente Elevado,,,,305,Centro,GUARDA,0913,36152.47,8875,581,557,542,586,496,1082,1624,2181,2762,24.55,7.64,6.03,4.49
10-02-2022,TROFA,2883,206,7504,"[960,Max]",Extremamente Elevado,,,,2883,Norte,PORTO,1318,7201.76,38418,2336,1894,1231,939,684,1623,2854,4748,7084,533.44,98.36,65.93,39.63
10-02-2022,VAGOS,1472,105,6475,"[960,Max]",Extremamente Elevado,,,,1472,Centro,AVEIRO,0118,16491.5,22740,1320,1205,922,784,724,1508,2430,3635,4955,137.89,30.04,22.04,14.73
10-02-2022,VALE DE CAMBRA,1246,89,5842,"[960,Max]",Extremamente Elevado,,,,1246,Norte,AVEIRO,0119,14733.47,21327,1491,1363,1005,831,798,1629,2634,3997,5488,144.76,37.25,27.13,17.88
10-02-2022,VALENÇA,615,44,4624,"[960,Max]",Extremamente Elevado,,,,615,Norte,VIANA DO CASTELO,1608,11712.86,13290,867,791,582,582,503,1085,1667,2458,3325,113.46,28.39,20.99,14.23
10-02-2022,VALONGO,7722,552,7925,"[960,Max]",Extremamente Elevado,,,,7722,Norte,PORTO,1315,7512.45,97444,5629,4696,3207,2462,1829,4291,7498,12194,17823,1297.18,237.26,162.33,99.81
10-02-2022,VALPAÇOS,547,39,3694,"[960,Max]",Extremamente Elevado,,,,547,Norte,VILA REAL,1712,54873.93,14818,1217,1118,999,928,997,1925,2924,4042,5259,27.0,9.58,7.37,5.33
10-02-2022,VELAS,240,17,4715,"[960,Max]",Extremamente Elevado,,,,240,Açores,AÇORES,4502,11738.38,5093,278,208,166,153,113,266,432,640,918,43.39,7.82,5.45,3.68
10-02-2022,VENDAS NOVAS,690,49,6133,"[960,Max]",Extremamente Elevado,,,,690,Alentejo,ÉVORA,0712,22238.88,11255,677,768,655,501,532,1033,1688,2456,3133,50.61,14.09,11.04,7.59
10-02-2022,VIANA DO ALENTEJO,223,16,4327,"[960,Max]",Extremamente Elevado,,,,223,Alentejo,ÉVORA,0713,39367.29,5145,245,208,235,210,214,424,659,867,1112,13.07,2.82,2.2,1.67
10-02-2022,VIANA DO CASTELO,4913,351,5820,"[960,Max]",Extremamente Elevado,,,,4913,Norte,VIANA DO CASTELO,1609,31902.01,84417,5470,4433,3591,3061,2982,6043,9634,14067,19537,264.61,61.24,44.09,30.2
10-02-2022,VIDIGUEIRA,239,17,4330,"[960,Max]",Extremamente Elevado,,,,239,Alentejo,BEJA,0214,31661.09,5510,300,248,215,233,275,508,723,971,1271,17.4,4.01,3.07,2.28
10-02-2022,VIEIRA DO MINHO,462,33,3903,"[960,Max]",Extremamente Elevado,,,,462,Norte,BRAGA,0311,21644.35,11842,703,594,525,548,482,1030,1555,2149,2852,54.71,13.18,9.93,7.18
10-02-2022,VILA DE REI,196,14,5902,"[960,Max]",Extremamente Elevado,,,,196,Centro,CASTELO BRANCO,0510,19154.6,3323,169,128,172,247,302,549,721,849,1018,17.35,5.31,4.43,3.76
10-02-2022,VILA DO BISPO,248,18,4818,"[960,Max]",Extremamente Elevado,,,,248,Algarve,FARO,0815,17906.06,5154,302,302,314,232,233,465,779,1081,1383,28.78,7.72,6.04,4.35
10-02-2022,VILA DO CONDE,5482,392,6861,"[960,Max]",Extremamente Elevado,,,,5482,Norte,PORTO,1316,14902.77,79899,4726,3875,2819,2070,1743,3813,6632,10507,15233,536.13,102.21,70.5,44.5
10-02-2022,VILA DO PORTO,235,17,4187,"[960,Max]",Extremamente Elevado,,,,235,Açores,AÇORES,4101,9688.74,5616,274,212,135,96,123,219,354,566,840,57.96,8.67,5.84,3.65
10-02-2022,VILA FLOR,228,16,3776,"[960,Max]",Extremamente Elevado,,,,228,Norte,BRAGANÇA,0410,26581.14,6044,429,362,422,294,331,625,1047,1409,1838,22.74,6.91,5.3,3.94
10-02-2022,VILA FRANCA DE XIRA,7038,503,4958,"[960,Max]",Extremamente Elevado,,,,7038,Lisboa e Vale do Tejo,LISBOA,1114,31819.39,141957,8501,6852,4869,3425,2472,5897,10766,17618,26119,446.14,82.09,55.37,33.84
10-02-2022,VILA FRANCA DO CAMPO,977,70,8840,"[960,Max]",Extremamente Elevado,,,,977,Açores,AÇORES,4206,7796.82,11051,450,344,248,217,154,371,619,963,1413,141.73,18.12,12.35,7.94
10-02-2022,VILA NOVA DA BARQUINHA,434,31,5815,"[960,Max]",Extremamente Elevado,,,,434,Lisboa e Vale do Tejo,SANTARÉM,1420,4952.97,7461,415,406,392,364,338,702,1094,1500,1915,150.64,38.66,30.28,22.09
10-02-2022,VILA NOVA DE CERVEIRA,476,34,5337,"[960,Max]",Extremamente Elevado,,,,476,Norte,VIANA DO CASTELO,1610,10846.66,8910,531,444,410,384,334,718,1128,1572,2103,82.14,19.39,14.49,10.4
10-02-2022,VILA NOVA DE FAMALICÃO,9714,694,7377,"[960,Max]",Extremamente Elevado,,,,9714,Norte,BRAGA,0312,20159.26,131676,7817,6164,4202,3282,2749,6031,10233,16397,24214,653.19,120.12,81.34,50.76
10-02-2022,VILA NOVA DE FOZ CÔA,229,16,3519,"[960,Max]",Extremamente Elevado,,,,229,Centro,GUARDA,0914,39815.18,6503,442,385,390,398,429,827,1217,1602,2044,16.33,5.13,4.02,3.06
10-02-2022,VILA NOVA DE GAIA,23217,1658,7727,"[960,Max]",Extremamente Elevado,,,,23217,Norte,PORTO,1317,16846.43,300472,18349,15568,10972,8224,6281,14505,25477,41045,59394,1783.64,352.57,243.65,151.23
10-02-2022,VILA NOVA DE PAIVA,192,14,4096,"[960,Max]",Extremamente Elevado,,,,192,Centro,VISEU,1822,17553.28,4687,289,272,233,217,241,458,691,963,1252,26.7,7.13,5.49,3.94
10-02-2022,VILA NOVA DE POIARES,325,23,4685,"[960,Max]",Extremamente Elevado,,,,325,Centro,COIMBRA,0617,8445.3,6939,380,284,262,235,182,417,679,963,1343,82.17,15.9,11.4,8.04
10-02-2022,VILA POUCA DE AGUIAR,500,36,4183,"[960,Max]",Extremamente Elevado,,,,500,Norte,VILA REAL,1713,43706.62,11961,860,817,733,601,627,1228,1961,2778,3638,27.37,8.32,6.36,4.49
10-02-2022,VILA REAL,2891,206,5786,"[960,Max]",Extremamente Elevado,,,,2891,Norte,VILA REAL,1714,37880.28,49962,3025,2498,2065,1579,1466,3045,5110,7608,10633,131.9,28.07,20.08,13.49
10-02-2022,VILA REAL DE SANTO ANTÓNIO,951,68,5070,"[960,Max]",Extremamente Elevado,,,,951,Algarve,FARO,0816,6125.0,18749,1172,1069,811,569,586,1155,1966,3035,4207,306.11,68.69,49.55,32.1
10-02-2022,VILA VELHA DE RÓDÃO,111,8,3533,"[960,Max]",Extremamente Elevado,,,,111,Centro,CASTELO BRANCO,0511,32991.16,3144,209,229,180,283,306,589,769,998,1207,9.53,3.66,3.03,2.33
10-02-2022,VILA VERDE,3007,215,6410,"[960,Max]",Extremamente Elevado,,,,3007,Norte,BRAGA,0313,22866.52,46911,2365,2063,1667,1494,1437,2931,4598,6661,9026,205.15,39.47,29.13,20.11
10-02-2022,VILA VIÇOSA,280,20,3662,"[960,Max]",Extremamente Elevado,,,,280,Alentejo,ÉVORA,0714,19485.89,7656,487,379,342,345,324,669,1011,1390,1877,39.29,9.63,7.13,5.19
10-02-2022,VIMIOSO,107,8,2653,"[960,Max]",Extremamente Elevado,,,,107,Norte,BRAGANÇA,0411,48158.51,4023,274,230,261,293,335,628,889,1119,1393,8.35,2.89,2.32,1.85
10-02-2022,VINHAIS,242,17,3128,"[960,Max]",Extremamente Elevado,,,,242,Norte,BRAGANÇA,0412,69475.09,7746,599,577,636,641,815,1456,2092,2669,3268,11.15,4.7,3.84,3.01
10-02-2022,VISEU,6595,471,6782,"[960,Max]",Extremamente Elevado,,,,6595,Centro,VISEU,1823,50710.14,97249,5769,5038,4140,3158,2710,5868,10008,15046,20815,191.77,41.05,29.67,19.74
10-02-2022,VIZELA,1393,99,5829,"[960,Max]",Extremamente Elevado,,,,1393,Norte,BRAGA,0314,2469.83,23897,1258,928,655,509,371,880,1535,2463,3721,967.49,150.65,99.72,62.15
10-02-2022,VOUZELA,651,46,6765,"[960,Max]",Extremamente Elevado,,,,651,Centro,VISEU,1824,19369.46,9619,626,605,554,532,507,1039,1593,2198,2824,49.66,14.58,11.35,8.22
17-02-2022,ABRANTES,889,64,2531,"[960,Max]",Extremamente Elevado,,,,889,Lisboa e Vale do Tejo,SANTARÉM,1401,71469.08,35130,2473,2213,1730,1748,2021,3769,5499,7712,10185,49.15,14.25,10.79,7.69
17-02-2022,ÁGUEDA,2136,153,4637,"[960,Max]",Extremamente Elevado,,,,2136,Centro,AVEIRO,0101,33527.44,46075,3237,2713,2090,1635,1496,3131,5221,7934,11171,137.43,33.32,23.66,15.57
17-02-2022,AGUIAR DA BEIRA,132,9,2827,"[960,Max]",Extremamente Elevado,,,,132,Centro,GUARDA,0901,20676.57,4652,304,281,235,239,148,387,622,903,1207,22.5,5.84,4.37,3.01
17-02-2022,ALANDROAL,139,10,2779,"[960,Max]",Extremamente Elevado,,,,139,Alentejo,ÉVORA,0701,54267.81,4992,307,256,296,299,377,676,972,1228,1535,9.2,2.83,2.26,1.79
17-02-2022,ALBERGARIA-A-VELHA,1016,73,4207,"[960,Max]",Extremamente Elevado,,,,1016,Centro,AVEIRO,0102,15882.5,24144,1550,1298,996,687,680,1367,2363,3661,5211,152.02,32.81,23.05,14.88
17-02-2022,ALBUFEIRA,1331,95,3206,"[960,Max]",Extremamente Elevado,,,,1331,Algarve,FARO,0801,14066.42,41528,2067,1717,1425,985,858,1843,3268,4985,7052,295.24,50.14,35.44,23.23
17-02-2022,ALCÁCER DO SAL,346,25,2971,"[960,Max]",Extremamente Elevado,,,,346,Alentejo,SETÚBAL,1501,149987.3,11659,884,814,623,623,602,1225,1848,2662,3546,7.77,2.36,1.77,1.23
17-02-2022,ALCANENA,447,32,3489,"[960,Max]",Extremamente Elevado,,,,447,Lisboa e Vale do Tejo,SANTARÉM,1402,12732.86,12809,891,744,628,536,588,1124,1752,2496,3387,100.6,26.6,19.6,13.76
17-02-2022,ALCOBAÇA,1747,125,3262,"[960,Max]",Extremamente Elevado,,,,1747,Lisboa e Vale do Tejo,LEIRIA,1001,40814.09,53555,3420,2927,2466,2059,1676,3735,6201,9128,12548,131.22,30.74,22.36,15.19
17-02-2022,ALCOCHETE,714,51,3607,"[960,Max]",Extremamente Elevado,,,,714,Lisboa e Vale do Tejo,SETÚBAL,1502,12836.48,19787,857,834,691,476,447,923,1614,2448,3305,154.15,25.75,19.07,12.57
17-02-2022,ALCOUTIM,104,7,4815,"[960,Max]",Extremamente Elevado,,,,104,Algarve,FARO,0802,57536.33,2159,191,188,163,190,267,457,620,808,999,3.75,1.74,1.4,1.08
17-02-2022,ALENQUER,1411,101,3203,"[960,Max]",Extremamente Elevado,,,,1411,Lisboa e Vale do Tejo,LISBOA,1101,30421.92,44052,2298,2062,1629,1330,1155,2485,4114,6176,8474,144.8,27.85,20.3,13.52
17-02-2022,ALFÂNDEGA DA FÉ,99,7,2182,"[960,Max]",Extremamente Elevado,,,,99,Norte,BRAGANÇA,0401,32194.64,4550,325,277,301,274,325,599,900,1177,1502,14.13,4.67,3.66,2.8
17-02-2022,ALIJÓ,306,22,2878,"[960,Max]",Extremamente Elevado,,,,306,Norte,VILA REAL,1701,29759.89,10625,766,687,635,542,666,1208,1843,2530,3296,35.7,11.08,8.5,6.19
17-02-2022,ALJEZUR,269,19,4805,"[960,Max]",Extremamente Elevado,,,,269,Algarve,FARO,0803,32349.95,5594,316,336,335,320,410,730,1065,1401,1717,17.29,5.31,4.33,3.29
17-02-2022,ALJUSTREL,243,17,2948,"[960,Max]",Extremamente Elevado,,,,243,Alentejo,BEJA,0201,45847.41,8247,635,521,443,347,358,705,1148,1669,2304,17.99,5.03,3.64,2.5
17-02-2022,ALMADA,4319,308,2555,"[960,Max]",Extremamente Elevado,,,,4319,Lisboa e Vale do Tejo,SETÚBAL,1503,7000.89,169039,10469,9777,7876,6144,5111,11255,19131,28908,39377,2414.5,562.45,412.91,273.26
17-02-2022,ALMEIDA,171,12,2938,"[960,Max]",Extremamente Elevado,,,,171,Centro,GUARDA,0902,51798.46,5830,441,419,396,458,393,851,1247,1666,2107,11.26,4.07,3.22,2.41
17-02-2022,ALMEIRIM,637,46,2827,"[960,Max]",Extremamente Elevado,,,,637,Lisboa e Vale do Tejo,SANTARÉM,1403,22212.05,22546,1342,1353,1106,866,843,1709,2815,4168,5510,101.5,24.81,18.76,12.67
17-02-2022,ALMODÔVAR,248,18,3694,"[960,Max]",Extremamente Elevado,,,,248,Alentejo,BEJA,0202,77788.03,6725,414,443,396,373,328,701,1097,1540,1954,8.65,2.51,1.98,1.41
17-02-2022,ALPIARÇA,161,11,2276,"[960,Max]",Extremamente Elevado,,,,161,Lisboa e Vale do Tejo,SANTARÉM,1404,9536.33,7059,515,486,363,333,274,607,970,1456,1971,74.02,20.67,15.27,10.17
17-02-2022,ALTER DO CHÃO,114,8,3603,"[960,Max]",Extremamente Elevado,,,,114,Alentejo,PORTALEGRE,1201,36206.62,3165,201,163,136,208,187,395,531,694,895,8.74,2.47,1.92,1.47
17-02-2022,ALVAIÁZERE,187,13,2838,"[960,Max]",Extremamente Elevado,,,,187,Centro,LEIRIA,1002,16047.76,6597,419,389,346,406,539,945,1291,1680,2099,41.11,13.08,10.47,8.04
17-02-2022,ALVITO,75,5,3039,"[960,Max]",Extremamente Elevado,,,,75,Alentejo,BEJA,0203,26485.32,2477,145,110,105,111,89,200,305,415,560,9.35,2.11,1.57,1.15
17-02-2022,AMADORA,3106,222,1687,"[960,Max]",Extremamente Elevado,,,,3106,Lisboa e Vale do Tejo,LISBOA,1115,2378.47,184106,11186,10936,8780,6460,5890,12350,21130,32066,43252,7742.05,1818.84,1348.44,888.56
17-02-2022,AMARANTE,1701,122,3198,"[960,Max]",Extremamente Elevado,,,,1701,Norte,PORTO,1301,30133.15,53193,3086,2413,1812,1643,1311,2954,4766,7179,10265,176.53,34.07,23.82,15.82
17-02-2022,AMARES,685,49,3781,"[960,Max]",Extremamente Elevado,,,,685,Norte,BRAGA,0301,8195.41,18129,1001,829,622,489,524,1013,1635,2464,3465,221.22,42.28,30.07,19.95
17-02-2022,ANADIA,1031,74,3782,"[960,Max]",Extremamente Elevado,,,,1031,Centro,AVEIRO,0103,21663.48,27258,1931,1698,1376,1208,1262,2470,3846,5544,7475,125.83,34.51,25.59,17.75
17-02-2022,ANGRA DO HEROÍSMO,1754,125,5189,"[960,Max]",Extremamente Elevado,,,,1754,Açores,AÇORES,4301,23899.66,33807,2006,1473,1122,768,635,1403,2525,3998,6004,141.45,25.12,16.73,10.56
17-02-2022,ANSIÃO,413,30,3433,"[960,Max]",Extremamente Elevado,,,,413,Centro,LEIRIA,1003,17609.42,12039,727,709,646,694,530,1224,1870,2579,3306,68.37,18.77,14.65,10.62
17-02-2022,ARCOS DE VALDEVEZ,511,37,2444,"[960,Max]",Extremamente Elevado,,,,511,Norte,VIANA DO CASTELO,1601,44759.64,20926,1329,1338,1282,1343,1515,2858,4140,5478,6807,46.75,15.21,12.24,9.25
17-02-2022,ARGANIL,391,28,3548,"[960,Max]",Extremamente Elevado,,,,391,Centro,COIMBRA,0601,33283.93,11014,672,648,612,559,596,1155,1767,2415,3087,33.09,9.27,7.26,5.31
17-02-2022,ARMAMAR,168,12,2904,"[960,Max]",Extremamente Elevado,,,,168,Norte,VISEU,1801,11723.73,5769,357,305,309,285,310,595,904,1209,1566,49.21,13.36,10.31,7.71
17-02-2022,AROUCA,638,46,3081,"[960,Max]",Extremamente Elevado,,,,638,Norte,AVEIRO,0104,32910.52,20720,1306,1047,753,683,683,1366,2119,3166,4472,62.96,13.59,9.62,6.44
17-02-2022,ARRAIOLOS,179,13,2577,"[960,Max]",Extremamente Elevado,,,,179,Alentejo,ÉVORA,0702,68374.55,6928,435,384,283,367,480,847,1130,1514,1949,10.13,2.85,2.21,1.65
17-02-2022,ARRONCHES,94,7,3331,"[960,Max]",Extremamente Elevado,,,,94,Alentejo,PORTALEGRE,1202,31464.72,2820,155,142,162,187,179,366,528,670,825,8.96,2.62,2.13,1.68
17-02-2022,ARRUDA DOS VINHOS,550,39,3569,"[960,Max]",Extremamente Elevado,,,,550,Lisboa e Vale do Tejo,LISBOA,1102,7795.93,15412,738,738,562,509,438,947,1509,2247,2985,197.69,38.29,28.82,19.36
17-02-2022,AVEIRO,3886,278,4936,"[960,Max]",Extremamente Elevado,,,,3886,Centro,AVEIRO,0105,19757.57,78734,4520,4004,3050,2250,2103,4353,7403,11407,15927,398.49,80.61,57.73,37.47
17-02-2022,AVIS,209,15,4912,"[960,Max]",Extremamente Elevado,,,,209,Alentejo,PORTALEGRE,1203,60596.51,4247,315,225,206,251,273,524,730,955,1270,7.01,2.1,1.58,1.2
17-02-2022,AZAMBUJA,678,48,2983,"[960,Max]",Extremamente Elevado,,,,678,Lisboa e Vale do Tejo,LISBOA,1103,26265.65,22716,1322,1171,1070,798,618,1416,2486,3657,4979,86.48,18.96,13.92,9.46
17-02-2022,BAIÃO,498,36,2654,"[960,Max]",Extremamente Elevado,,,,498,Norte,PORTO,1302,17452.83,18748,1070,862,714,686,725,1411,2125,2987,4057,107.42,23.25,17.11,12.18
17-02-2022,BARCELOS,3344,239,2878,"[960,Max]",Extremamente Elevado,,,,3344,Norte,BRAGA,0302,37890.14,116187,6721,5325,3619,2991,2562,5553,9172,14497,21218,306.64,56.0,38.26,24.21
17-02-2022,BARRANCOS,21,2,1294,"[960,Max]",Extremamente Elevado,,,,21,Alentejo,BEJA,0204,16841.73,1634,90,65,65,94,61,155,220,285,375,9.7,2.23,1.69,1.31
17-02-2022,BARREIRO,1837,131,2445,"[960,Max]",Extremamente Elevado,,,,1837,Lisboa e Vale do Tejo,SETÚBAL,1504,3639.07,75147,5194,5565,4459,3105,1767,4872,9331,14896,20090,2065.05,552.07,409.34,256.42
17-02-2022,BATALHA,688,49,4311,"[960,Max]",Extremamente Elevado,,,,688,Centro,LEIRIA,1004,10341.6,15963,873,762,649,529,549,1078,1727,2489,3362,154.35,32.51,24.07,16.7
17-02-2022,BEJA,1315,94,3917,"[960,Max]",Extremamente Elevado,,,,1315,Alentejo,BEJA,0205,114647.55,33579,2005,1840,1386,1272,1039,2311,3697,5537,7542,29.29,6.58,4.83,3.22
17-02-2022,BELMONTE,265,19,4136,"[960,Max]",Extremamente Elevado,,,,265,Centro,CASTELO BRANCO,0501,11875.91,6398,444,321,325,310,355,665,990,1311,1755,53.87,14.78,11.04,8.34
17-02-2022,BENAVENTE,1062,76,3469,"[960,Max]",Extremamente Elevado,,,,1062,Lisboa e Vale do Tejo,SANTARÉM,1405,52138.39,30602,1468,1376,1141,876,643,1519,2660,4036,5504,58.69,10.56,7.74,5.1
17-02-2022,BOMBARRAL,376,27,2996,"[960,Max]",Extremamente Elevado,,,,376,Lisboa e Vale do Tejo,LEIRIA,1005,9128.55,12558,875,714,561,491,429,920,1481,2195,3070,137.56,33.63,24.04,16.22
17-02-2022,BORBA,245,18,3644,"[960,Max]",Extremamente Elevado,,,,245,Alentejo,ÉVORA,0703,14518.65,6736,430,375,279,436,392,828,1107,1482,1912,46.39,13.17,10.21,7.62
17-02-2022,BOTICAS,110,8,2192,"[960,Max]",Extremamente Elevado,,,,110,Norte,VILA REAL,1702,32195.66,4998,347,306,311,305,380,685,996,1302,1649,15.52,5.12,4.04,3.09
17-02-2022,BRAGA,7293,521,3992,"[960,Max]",Extremamente Elevado,,,,7293,Norte,BRAGA,0303,18339.95,182679,10029,7963,5241,4320,3671,7991,13232,21195,31224,996.07,170.25,115.57,72.15
17-02-2022,BRAGANÇA,719,51,2138,"[960,Max]",Extremamente Elevado,,,,719,Norte,BRAGANÇA,0402,117357.27,33607,2402,1855,1652,1393,1163,2556,4208,6063,8465,28.64,7.21,5.17,3.59
17-02-2022,CABECEIRAS DE BASTO,401,29,2563,"[960,Max]",Extremamente Elevado,,,,401,Norte,BRAGA,0304,24182.16,15628,774,594,544,575,574,1149,1693,2287,3061,64.63,12.66,9.46,7.0
17-02-2022,CADAVAL,519,37,3794,"[960,Max]",Extremamente Elevado,,,,519,Lisboa e Vale do Tejo,LISBOA,1104,17489.3,13673,813,796,756,621,625,1246,2002,2798,3611,78.18,20.65,16.0,11.45
17-02-2022,CALDAS DA RAINHA,1654,118,3186,"[960,Max]",Extremamente Elevado,,,,1654,Lisboa e Vale do Tejo,LEIRIA,1006,25569.47,51912,3035,2684,2186,1899,1705,3604,5790,8474,11509,203.03,45.01,33.14,22.64
17-02-2022,CALHETA,343,25,3157,"[960,Max]",Extremamente Elevado,,,,343,Madeira,MADEIRA,3101,11150.43,10867,576,497,507,399,415,814,1321,1818,2394,97.46,21.47,16.3,11.85
17-02-2022,CALHETA (AÇORES),53,4,1678,"[960,Max]",Extremamente Elevado,,,,53,Açores,AÇORES,4501,12626.4,3184,215,159,141,139,122,261,402,561,776,25.22,6.15,4.44,3.18
17-02-2022,CÂMARA DE LOBOS,854,61,2536,"[960,Max]",Extremamente Elevado,,,,854,Madeira,MADEIRA,3102,5216.67,33675,1396,1059,834,545,381,926,1760,2819,4215,645.49,80.79,54.03,33.74
17-02-2022,CAMINHA,420,30,2648,"[960,Max]",Extremamente Elevado,,,,420,Norte,VIANA DO CASTELO,1602,13652.14,15877,1046,944,818,646,656,1302,2120,3064,4110,116.3,30.11,22.44,15.53
17-02-2022,CAMPO MAIOR,344,25,4363,"[960,Max]",Extremamente Elevado,,,,344,Alentejo,PORTALEGRE,1204,24720.16,7874,471,364,351,279,327,606,957,1321,1792,31.85,7.25,5.34,3.87
17-02-2022,CANTANHEDE,1329,95,3795,"[960,Max]",Extremamente Elevado,,,,1329,Centro,COIMBRA,0602,39088.02,35011,2346,2096,1880,1709,1451,3160,5040,7136,9482,89.57,24.26,18.26,12.89
17-02-2022,CARRAZEDA DE ANSIÃES,235,17,4153,"[960,Max]",Extremamente Elevado,,,,235,Norte,BRAGANÇA,0403,27924.09,5666,424,389,391,312,465,777,1168,1557,1981,20.29,7.09,5.58,4.18
17-02-2022,CARREGAL DO SAL,264,19,2845,"[960,Max]",Extremamente Elevado,,,,264,Centro,VISEU,1802,11689.21,9271,587,562,486,462,376,838,1324,1886,2473,79.31,21.16,16.13,11.33
17-02-2022,CARTAXO,596,43,2498,"[960,Max]",Extremamente Elevado,,,,596,Lisboa e Vale do Tejo,SANTARÉM,1406,15817.28,23843,1415,1376,1142,861,632,1493,2635,4011,5426,150.74,34.3,25.36,16.66
17-02-2022,CASCAIS,6363,455,2979,"[960,Max]",Extremamente Elevado,,,,6363,Lisboa e Vale do Tejo,LISBOA,1105,9740.17,213608,12151,11444,8680,6469,5248,11717,20397,31841,43992,2193.1,451.66,326.91,209.41
17-02-2022,CASTANHEIRA DE PÊRA,45,3,1707,"[960,Max]",Extremamente Elevado,,,,45,Centro,LEIRIA,1007,6677.45,2614,233,195,157,190,187,377,534,729,962,39.15,14.41,10.92,8.0
17-02-2022,CASTELO BRANCO,2057,147,3956,"[960,Max]",Extremamente Elevado,,,,2057,Centro,CASTELO BRANCO,0502,143819.15,51987,3528,3042,2499,2229,2225,4454,6953,9995,13523,36.15,9.4,6.95,4.83
17-02-2022,CASTELO DE PAIVA,582,42,3764,"[960,Max]",Extremamente Elevado,,,,582,Norte,AVEIRO,0106,11500.53,15454,881,697,545,420,431,851,1396,2093,2974,134.37,25.86,18.2,12.14
17-02-2022,CASTELO DE VIDE,53,4,1800,"[960,Max]",Extremamente Elevado,,,,53,Alentejo,PORTALEGRE,1205,26491.24,2919,204,173,179,147,170,317,496,669,873,11.02,3.3,2.53,1.87
17-02-2022,CASTRO DAIRE,353,25,2555,"[960,Max]",Extremamente Elevado,,,,353,Centro,VISEU,1803,37904.13,13823,942,857,765,732,773,1505,2270,3127,4069,36.47,10.74,8.25,5.99
17-02-2022,CASTRO MARIM,206,15,3308,"[960,Max]",Extremamente Elevado,,,,206,Algarve,FARO,0804,30084.37,6237,370,345,334,322,344,666,1000,1345,1715,20.73,5.7,4.47,3.32
17-02-2022,CASTRO VERDE,282,20,4064,"[960,Max]",Extremamente Elevado,,,,282,Alentejo,BEJA,0206,56944.23,6949,437,347,303,275,227,502,805,1152,1589,12.2,2.79,2.02,1.41
17-02-2022,CELORICO DA BEIRA,140,10,2019,"[960,Max]",Extremamente Elevado,,,,140,Centro,GUARDA,0903,24721.63,6928,430,416,363,369,535,904,1267,1683,2113,28.02,8.55,6.81,5.12
17-02-2022,CELORICO DE BASTO,477,34,2507,"[960,Max]",Extremamente Elevado,,,,477,Norte,BRAGA,0305,18107.02,19040,1001,802,668,728,729,1457,2125,2927,3928,105.15,21.69,16.17,11.74
17-02-2022,CHAMUSCA,167,12,1820,"[960,Max]",Extremamente Elevado,,,,167,Lisboa e Vale do Tejo,SANTARÉM,1407,74600.54,9197,629,583,553,465,579,1044,1597,2180,2809,12.33,3.77,2.92,2.14
17-02-2022,CHAVES,883,63,2245,"[960,Max]",Extremamente Elevado,,,,883,Norte,VILA REAL,1703,59122.95,39343,2676,2429,1991,1886,1918,3804,5795,8224,10900,66.54,18.44,13.91,9.8
17-02-2022,CINFÃES,412,29,2261,"[960,Max]",Extremamente Elevado,,,,412,Norte,VISEU,1804,23928.76,18244,1067,902,779,734,758,1492,2271,3173,4240,76.24,17.72,13.26,9.49
17-02-2022,COIMBRA,6200,443,4621,"[960,Max]",Extremamente Elevado,,,,6200,Centro,COIMBRA,0603,31939.94,134166,9489,8734,6353,5139,5074,10213,16566,25300,34789,420.06,108.92,79.21,51.87
17-02-2022,CONDEIXA-A-NOVA,779,56,4392,"[960,Max]",Extremamente Elevado,,,,779,Centro,COIMBRA,0604,13867.47,17733,871,809,717,583,490,1073,1790,2599,3470,127.88,25.02,18.74,12.91
17-02-2022,CONSTÂNCIA,163,12,4048,"[960,Max]",Extremamente Elevado,,,,163,Lisboa e Vale do Tejo,SANTARÉM,1408,8036.58,4030,211,183,187,148,155,303,490,673,884,50.14,11.0,8.37,6.1
17-02-2022,CORUCHE,551,39,3153,"[960,Max]",Extremamente Elevado,,,,551,Lisboa e Vale do Tejo,SANTARÉM,1409,111572.03,17471,1294,1090,1095,1096,1019,2115,3210,4300,5594,15.66,5.01,3.85,2.88
17-02-2022,CORVO,1,0,213,"[120,240]",Moderado,,,,1,Açores,AÇORES,4901,1711.45,464,22,21,11,13,19,32,43,64,86,27.12,5.03,3.74,2.51
17-02-2022,COVILHÃ,2822,202,6032,"[960,Max]",Extremamente Elevado,,,,2822,Centro,CASTELO BRANCO,0503,55560.06,46787,3533,2998,2365,2111,2193,4304,6669,9667,13200,84.21,23.76,17.4,12.0
17-02-2022,CRATO,120,9,3826,"[960,Max]",Extremamente Elevado,,,,120,Alentejo,PORTALEGRE,1206,39806.88,3129,229,258,163,182,228,410,573,831,1060,7.86,2.66,2.09,1.44
17-02-2022,CUBA,121,9,2639,"[960,Max]",Extremamente Elevado,,,,121,Alentejo,BEJA,0207,17208.72,4595,255,233,206,190,143,333,539,772,1027,26.7,5.97,4.49,3.13
17-02-2022,ELVAS,645,46,3140,"[960,Max]",Extremamente Elevado,,,,645,Alentejo,PORTALEGRE,1207,63128.86,20528,1057,1145,902,852,810,1662,2564,3709,4766,32.52,7.55,5.88,4.06
17-02-2022,ENTRONCAMENTO,807,58,3745,"[960,Max]",Extremamente Elevado,,,,807,Lisboa e Vale do Tejo,SANTARÉM,1410,1372.81,21558,1066,930,868,695,592,1287,2155,3085,4151,1570.14,302.33,224.69,156.96
17-02-2022,ESPINHO,1110,79,3759,"[960,Max]",Extremamente Elevado,,,,1110,Norte,AVEIRO,0107,2105.68,29516,2205,1993,1430,1177,960,2137,3567,5560,7765,1401.52,368.71,264.01,169.37
17-02-2022,ESPOSENDE,1216,87,3559,"[960,Max]",Extremamente Elevado,,,,1216,Norte,BRAGA,0306,9540.98,34177,1831,1522,1095,894,723,1617,2712,4234,6065,358.21,63.57,44.38,28.42
17-02-2022,ESTARREJA,816,58,3136,"[960,Max]",Extremamente Elevado,,,,816,Centro,AVEIRO,0108,10817.33,26006,1503,1399,1106,953,728,1681,2787,4186,5689,240.42,52.59,38.7,25.76
17-02-2022,ESTREMOZ,366,26,2873,"[960,Max]",Extremamente Elevado,,,,366,Alentejo,ÉVORA,0704,51379.95,12728,789,613,697,786,877,1663,2360,2973,3762,24.77,7.32,5.79,4.59
17-02-2022,ÉVORA,2297,164,4381,"[960,Max]",Extremamente Elevado,,,,2297,Alentejo,ÉVORA,0705,130707.58,52428,3569,2852,2176,1966,1803,3769,5945,8797,12366,40.11,9.46,6.73,4.55
17-02-2022,FAFE,1091,78,2271,"[960,Max]",Extremamente Elevado,,,,1091,Norte,BRAGA,0307,21908.11,48060,3044,2455,1679,1403,1208,2611,4290,6745,9789,219.37,44.68,30.79,19.58
17-02-2022,FARO,3428,245,5619,"[960,Max]",Extremamente Elevado,,,,3428,Algarve,FARO,0805,20256.79,61015,3847,3364,2604,2055,1601,3656,6260,9624,13471,301.2,66.5,47.51,30.9
17-02-2022,FELGUEIRAS,1136,81,2013,"[960,Max]",Extremamente Elevado,,,,1136,Norte,PORTO,1303,11573.75,56422,2951,2302,1601,1316,973,2289,3890,6192,9143,487.49,79.0,53.5,33.61
17-02-2022,FERREIRA DO ALENTEJO,397,28,5060,"[960,Max]",Extremamente Elevado,,,,397,Alentejo,BEJA,0208,64820.68,7845,515,414,372,343,345,688,1060,1474,1989,12.1,3.07,2.27,1.64
17-02-2022,FERREIRA DO ZÊZERE,226,16,2842,"[960,Max]",Extremamente Elevado,,,,226,Lisboa e Vale do Tejo,SANTARÉM,1411,19038.03,7959,470,370,416,465,456,921,1337,1707,2177,41.81,11.44,8.97,7.02
17-02-2022,FIGUEIRA DA FOZ,2463,176,4192,"[960,Max]",Extremamente Elevado,,,,2463,Centro,COIMBRA,0605,37905.26,58747,4032,3597,2887,2495,2043,4538,7425,11022,15054,154.98,39.72,29.08,19.59
17-02-2022,FIGUEIRA DE CASTELO RODRIGO,222,16,3974,"[960,Max]",Extremamente Elevado,,,,222,Centro,GUARDA,0904,50857.46,5584,347,352,290,352,391,743,1033,1385,1732,10.98,3.41,2.72,2.03
17-02-2022,FIGUEIRÓ DOS VINHOS,130,9,2336,"[960,Max]",Extremamente Elevado,,,,130,Centro,LEIRIA,1008,17344.0,5568,402,386,322,309,351,660,982,1368,1770,32.1,10.21,7.89,5.66
17-02-2022,FORNOS DE ALGODRES,110,8,2423,"[960,Max]",Extremamente Elevado,,,,110,Centro,GUARDA,0905,13145.05,4528,261,218,247,256,232,488,735,953,1214,34.45,9.24,7.25,5.59
17-02-2022,FREIXO DE ESPADA À CINTA,57,4,1729,"[960,Max]",Extremamente Elevado,,,,57,Norte,BRAGANÇA,0404,24414.29,3298,211,177,231,196,189,385,616,793,1004,13.51,4.11,3.25,2.52
17-02-2022,FRONTEIRA,202,14,6785,"[960,Max]",Extremamente Elevado,,,,202,Alentejo,PORTALEGRE,1208,24859.58,2974,213,182,149,156,168,324,473,655,868,11.96,3.49,2.63,1.9
17-02-2022,FUNCHAL,3076,220,2957,"[960,Max]",Extremamente Elevado,,,,3076,Madeira,MADEIRA,3103,7616.2,104024,6382,5086,3643,2821,1990,4811,8454,13540,19922,1365.86,261.58,177.78,111.0
17-02-2022,FUNDÃO,1109,79,4187,"[960,Max]",Extremamente Elevado,,,,1109,Centro,CASTELO BRANCO,0504,70019.79,26495,1781,1464,1432,1357,1643,3000,4432,5896,7677,37.84,10.96,8.42,6.33
17-02-2022,GAVIÃO,112,8,3424,"[960,Max]",Extremamente Elevado,,,,112,Alentejo,PORTALEGRE,1209,29459.45,3263,189,186,222,263,293,556,778,964,1153,11.08,3.91,3.27,2.64
17-02-2022,GÓIS,169,12,4453,"[960,Max]",Extremamente Elevado,,,,169,Centro,COIMBRA,0606,26330.19,3805,235,199,240,233,244,477,717,916,1151,14.45,4.37,3.48,2.72
17-02-2022,GOLEGÃ,165,12,3082,"[960,Max]",Extremamente Elevado,,,,165,Lisboa e Vale do Tejo,SANTARÉM,1412,8431.67,5339,356,299,281,243,255,498,779,1078,1434,63.32,17.01,12.78,9.24
17-02-2022,GONDOMAR,7423,530,4472,"[960,Max]",Extremamente Elevado,,,,7423,Norte,PORTO,1304,13191.76,165985,10555,8755,6222,4450,3364,7814,14036,22791,33346,1258.22,252.77,172.76,106.4
17-02-2022,GOUVEIA,380,27,3066,"[960,Max]",Extremamente Elevado,,,,380,Centro,GUARDA,0906,30061.17,12387,871,931,780,783,810,1593,2373,3304,4175,41.21,13.89,10.99,7.89
17-02-2022,GRÂNDOLA,373,27,2547,"[960,Max]",Extremamente Elevado,,,,373,Alentejo,SETÚBAL,1505,82593.66,14639,834,834,708,688,672,1360,2068,2902,3736,17.72,4.52,3.51,2.5
17-02-2022,GUARDA,1442,103,3700,"[960,Max]",Extremamente Elevado,,,,1442,Centro,GUARDA,0907,71209.58,38969,2477,2041,1686,1415,1474,2889,4575,6616,9093,54.72,12.77,9.29,6.42
17-02-2022,GUIMARÃES,3923,280,2576,"[960,Max]",Extremamente Elevado,,,,3923,Norte,BRAGA,0308,24099.96,152309,9394,7074,4809,3877,2948,6825,11634,18708,28102,631.99,116.61,77.63,48.27
17-02-2022,HORTA,261,19,1800,"[960,Max]",Extremamente Elevado,,,,261,Açores,AÇORES,4701,17305.53,14521,818,658,468,352,302,654,1122,1780,2598,83.91,15.01,10.29,6.48
17-02-2022,IDANHA-A-NOVA,164,12,2044,"[960,Max]",Extremamente Elevado,,,,164,Centro,CASTELO BRANCO,0505,141633.51,8043,518,490,519,672,974,1646,2165,2655,3173,5.68,2.24,1.87,1.53
17-02-2022,ÍLHAVO,1553,111,4014,"[960,Max]",Extremamente Elevado,,,,1553,Centro,AVEIRO,0110,7347.55,38699,2227,1943,1444,1193,850,2043,3487,5430,7657,526.66,104.21,73.9,47.46
17-02-2022,LAGOA (FARO),976,70,4287,"[960,Max]",Extremamente Elevado,,,,976,Algarve,FARO,0806,8825.45,22762,1314,1168,919,749,670,1419,2338,3506,4820,257.93,54.62,39.73,26.49
17-02-2022,LAGOA,1054,75,7159,"[960,Max]",Extremamente Elevado,,,,1054,Açores,AÇORES,4201,4559.32,14721,536,458,349,238,235,473,822,1280,1816,322.9,39.83,28.08,18.03
17-02-2022,LAGOS,1174,84,3865,"[960,Max]",Extremamente Elevado,,,,1174,Algarve,FARO,0807,21299.27,30374,1744,1434,1247,1053,1029,2082,3329,4763,6507,142.61,30.55,22.36,15.63
17-02-2022,LAJES DAS FLORES,62,4,4241,"[960,Max]",Extremamente Elevado,,,,62,Açores,AÇORES,4801,7004.79,1463,88,53,62,46,54,100,162,215,303,20.89,4.33,3.07,2.31
17-02-2022,LAJES DO PICO,135,10,2996,"[960,Max]",Extremamente Elevado,,,,135,Açores,AÇORES,4601,15531.09,4490,304,231,223,159,162,321,544,775,1079,28.91,6.95,4.99,3.5
17-02-2022,LAMEGO,852,61,3421,"[960,Max]",Extremamente Elevado,,,,852,Norte,VISEU,1805,16542.11,24895,1639,1284,1124,898,783,1681,2805,4089,5728,150.5,34.63,24.72,16.96
17-02-2022,LEIRIA,6478,463,5171,"[960,Max]",Extremamente Elevado,,,,6478,Centro,LEIRIA,1009,56508.83,125267,7389,6366,5090,3902,3159,7061,12151,18517,25906,221.68,45.84,32.77,21.5
17-02-2022,LISBOA,15291,1092,3001,"[960,Max]",Extremamente Elevado,,,,15291,Lisboa e Vale do Tejo,LISBOA,1106,10005.43,509515,33197,33340,27706,23037,26770,49807,77513,110853,144050,5092.6,1439.78,1107.98,774.74
17-02-2022,LOULÉ,2964,212,4314,"[960,Max]",Extremamente Elevado,,,,2964,Algarve,FARO,0808,76366.91,68697,3890,3350,2780,2358,2251,4609,7389,10739,14629,89.96,19.16,14.06,9.68
17-02-2022,LOURES,4817,344,2254,"[960,Max]",Extremamente Elevado,,,,4817,Lisboa e Vale do Tejo,LISBOA,1107,16723.99,213687,12746,12794,9644,6669,5033,11702,21346,34140,46886,1277.73,280.35,204.14,127.64
17-02-2022,LOURINHÃ,940,67,3636,"[960,Max]",Extremamente Elevado,,,,940,Lisboa e Vale do Tejo,LISBOA,1108,14717.2,25855,1584,1243,992,842,645,1487,2479,3722,5306,175.68,36.05,25.29,16.84
17-02-2022,LOUSÃ,770,55,4486,"[960,Max]",Extremamente Elevado,,,,770,Centro,COIMBRA,0607,13840.01,17158,946,866,658,528,450,978,1636,2502,3448,123.97,24.91,18.08,11.82
17-02-2022,LOUSADA,887,63,1898,"[960,Max]",Extremamente Elevado,,,,887,Norte,PORTO,1305,9608.01,46755,2289,1698,1176,853,621,1474,2650,4348,6637,486.63,69.08,45.25,27.58
17-02-2022,MAÇÃO,135,10,2148,"[960,Max]",Extremamente Elevado,,,,135,Lisboa e Vale do Tejo,SANTARÉM,1413,39997.98,6267,386,362,390,440,657,1097,1487,1849,2235,15.67,5.59,4.62,3.72
17-02-2022,MACEDO DE CAVALEIROS,297,21,2046,"[960,Max]",Extremamente Elevado,,,,297,Norte,BRAGANÇA,0405,69914.08,14516,1082,889,878,823,938,1761,2639,3528,4610,20.76,6.59,5.05,3.77
17-02-2022,MACHICO,615,44,3080,"[960,Max]",Extremamente Elevado,,,,615,Madeira,MADEIRA,3104,6825.1,19981,1197,860,662,455,331,786,1448,2308,3505,292.76,51.36,33.82,21.22
17-02-2022,MADALENA,191,14,3246,"[960,Max]",Extremamente Elevado,,,,191,Açores,AÇORES,4602,14712.33,5895,334,256,173,190,179,369,542,798,1132,40.07,7.69,5.42,3.68
17-02-2022,MAFRA,3064,219,3612,"[960,Max]",Extremamente Elevado,,,,3064,Lisboa e Vale do Tejo,LISBOA,1109,29165.5,84816,3613,3334,2839,2089,1899,3988,6827,10161,13774,290.81,47.23,34.84,23.41
17-02-2022,MAIA,5874,420,4227,"[960,Max]",Extremamente Elevado,,,,5874,Norte,PORTO,1306,8293.94,138971,7801,6617,4512,3339,2631,5970,10482,17099,24900,1675.56,300.22,206.16,126.38
17-02-2022,MANGUALDE,640,46,3458,"[960,Max]",Extremamente Elevado,,,,640,Centro,VISEU,1806,21925.56,18510,1198,1128,885,852,743,1595,2480,3608,4806,84.42,21.92,16.46,11.31
17-02-2022,MANTEIGAS,156,11,5191,"[960,Max]",Extremamente Elevado,,,,156,Centro,GUARDA,0908,12197.55,3007,258,197,159,167,146,313,472,669,927,24.65,7.6,5.48,3.87
17-02-2022,MARCO DE CANAVESES,1915,137,3719,"[960,Max]",Extremamente Elevado,,,,1915,Norte,PORTO,1307,20188.98,51496,2678,2060,1488,1265,1023,2288,3776,5836,8514,255.07,42.17,28.91,18.7
17-02-2022,MARINHA GRANDE,1921,137,4989,"[960,Max]",Extremamente Elevado,,,,1921,Centro,LEIRIA,1010,18725.19,38508,2365,2302,1638,1359,1058,2417,4055,6357,8722,205.65,46.58,33.95,21.66
17-02-2022,MARVÃO,95,7,3165,"[960,Max]",Extremamente Elevado,,,,95,Alentejo,PORTALEGRE,1210,15489.9,3005,198,185,142,197,237,434,576,761,959,19.4,6.19,4.91,3.72
17-02-2022,MATOSINHOS,7151,511,4078,"[960,Max]",Extremamente Elevado,,,,7151,Norte,PORTO,1308,6241.97,175357,11850,9977,7023,5024,3884,8908,15931,25908,37758,2809.31,604.9,415.06,255.22
17-02-2022,MEALHADA,795,57,3993,"[960,Max]",Extremamente Elevado,,,,795,Centro,AVEIRO,0111,11065.66,19914,1163,1039,810,828,831,1659,2469,3508,4671,179.96,42.21,31.7,22.31
17-02-2022,MÊDA,91,7,1989,"[960,Max]",Extremamente Elevado,,,,91,Centro,GUARDA,0909,28604.92,4587,343,306,290,288,443,731,1021,1327,1670,16.04,5.84,4.64,3.57
17-02-2022,MELGAÇO,136,10,1677,"[960,Max]",Extremamente Elevado,,,,136,Norte,VIANA DO CASTELO,1603,23824.58,8093,507,567,578,614,675,1289,1867,2434,2941,33.97,12.34,10.22,7.84
17-02-2022,MÉRTOLA,84,6,1372,"[960,Max]",Extremamente Elevado,,,,84,Alentejo,BEJA,0209,129287.34,6142,400,390,378,423,600,1023,1401,1791,2191,4.75,1.69,1.39,1.08
17-02-2022,MESÃO FRIO,96,7,2412,"[960,Max]",Extremamente Elevado,,,,96,Norte,VILA REAL,1704,2664.87,3964,265,205,168,157,120,277,445,650,915,148.74,34.33,24.39,16.7
17-02-2022,MIRA,408,29,3452,"[960,Max]",Extremamente Elevado,,,,408,Centro,COIMBRA,0608,12403.38,11832,727,729,659,550,466,1016,1675,2404,3131,95.4,25.24,19.38,13.5
17-02-2022,MIRANDA DO CORVO,409,29,3217,"[960,Max]",Extremamente Elevado,,,,409,Centro,COIMBRA,0609,12637.79,12708,706,659,568,498,404,902,1470,2129,2835,100.55,22.43,16.85,11.63
17-02-2022,MIRANDA DO DOURO,105,8,1538,"[960,Max]",Extremamente Elevado,,,,105,Norte,BRAGANÇA,0406,48718.31,6830,482,429,442,463,470,933,1375,1804,2286,14.02,4.69,3.7,2.82
17-02-2022,MIRANDELA,536,38,2464,"[960,Max]",Extremamente Elevado,,,,536,Norte,BRAGANÇA,0407,65895.67,21754,1640,1315,1204,1078,947,2025,3229,4544,6184,33.01,9.38,6.9,4.9
17-02-2022,MOGADOURO,188,13,2245,"[960,Max]",Extremamente Elevado,,,,188,Norte,BRAGANÇA,0408,76064.93,8392,589,529,576,630,655,1285,1861,2390,2979,11.03,3.92,3.14,2.45
17-02-2022,MOIMENTA DA BEIRA,189,14,1946,"[960,Max]",Extremamente Elevado,,,,189,Norte,VISEU,1807,21996.9,9736,576,514,471,416,461,877,1348,1862,2438,44.26,11.08,8.46,6.13
17-02-2022,MOITA,1585,113,2461,"[960,Max]",Extremamente Elevado,,,,1585,Lisboa e Vale do Tejo,SETÚBAL,1506,5525.98,64407,4226,3646,2623,1801,1425,3226,5849,9495,13721,1165.53,248.3,171.82,105.85
17-02-2022,MONÇÃO,415,30,2324,"[960,Max]",Extremamente Elevado,,,,415,Norte,VIANA DO CASTELO,1604,21130.85,17869,1161,1105,1031,1006,972,1978,3009,4114,5275,84.56,24.96,19.47,14.24
17-02-2022,MONCHIQUE,246,18,4840,"[960,Max]",Extremamente Elevado,,,,246,Algarve,FARO,0809,39530.43,5077,353,384,321,355,392,747,1068,1452,1805,12.84,4.57,3.67,2.7
17-02-2022,MONDIM DE BASTO,181,13,2602,"[960,Max]",Extremamente Elevado,,,,181,Norte,VILA REAL,1705,17207.52,6946,395,300,314,284,283,567,881,1181,1576,40.36,9.16,6.86,5.12
17-02-2022,MONFORTE,189,13,6343,"[960,Max]",Extremamente Elevado,,,,189,Alentejo,PORTALEGRE,1211,42024.82,2975,139,115,117,192,168,360,477,592,731,7.08,1.74,1.41,1.14
17-02-2022,MONTALEGRE,154,11,1711,"[960,Max]",Extremamente Elevado,,,,154,Norte,VILA REAL,1706,80545.71,8997,699,628,595,603,730,1333,1928,2556,3255,11.17,4.04,3.17,2.39
17-02-2022,MONTEMOR-O-NOVO,496,35,3173,"[960,Max]",Extremamente Elevado,,,,496,Alentejo,ÉVORA,0706,123296.65,15647,991,953,868,878,971,1849,2717,3670,4661,12.69,3.78,2.98,2.2
17-02-2022,MONTEMOR-O-VELHO,944,67,3744,"[960,Max]",Extremamente Elevado,,,,944,Centro,COIMBRA,0610,22896.23,25224,1496,1397,1217,1057,988,2045,3262,4659,6155,110.17,26.88,20.35,14.25
17-02-2022,MONTIJO,1974,141,3426,"[960,Max]",Extremamente Elevado,,,,1974,Lisboa e Vale do Tejo,SETÚBAL,1507,34861.64,57614,2771,2441,1990,1554,1109,2663,4653,7094,9865,165.26,28.3,20.35,13.35
17-02-2022,MORA,43,3,1041,"[960,Max]",Extremamente Elevado,,,,43,Alentejo,ÉVORA,0707,44395.02,4138,336,275,252,238,257,495,747,1022,1358,9.32,3.06,2.3,1.68
17-02-2022,MORTÁGUA,286,20,3244,"[960,Max]",Extremamente Elevado,,,,286,Centro,VISEU,1808,25117.82,8803,638,584,535,499,460,959,1494,2078,2716,35.05,10.81,8.27,5.95
17-02-2022,MOURA,371,27,2705,"[960,Max]",Extremamente Elevado,,,,371,Alentejo,BEJA,0210,95845.55,13718,817,656,665,542,461,1003,1668,2324,3141,14.31,3.28,2.42,1.74
17-02-2022,MOURÃO,60,4,2466,"[960,Max]",Extremamente Elevado,,,,60,Alentejo,ÉVORA,0708,27862.98,2450,139,108,80,104,109,213,293,401,540,8.79,1.94,1.44,1.05
17-02-2022,MURÇA,66,5,1204,"[960,Max]",Extremamente Elevado,,,,66,Norte,VILA REAL,1707,18937.11,5463,384,341,307,306,319,625,932,1273,1657,28.85,8.75,6.72,4.92
17-02-2022,MURTOSA,341,24,3316,"[960,Max]",Extremamente Elevado,,,,341,Centro,AVEIRO,0112,7308.78,10279,509,473,403,353,409,762,1165,1638,2147,140.63,29.37,22.41,15.94
17-02-2022,NAZARÉ,509,36,3590,"[960,Max]",Extremamente Elevado,,,,509,Lisboa e Vale do Tejo,LEIRIA,1011,8243.43,14165,967,903,670,420,396,816,1486,2389,3356,171.84,40.71,28.98,18.03
17-02-2022,NELAS,482,34,3712,"[960,Max]",Extremamente Elevado,,,,482,Centro,VISEU,1809,12571.48,12974,924,787,668,604,583,1187,1855,2642,3566,103.21,28.37,21.02,14.76
17-02-2022,NISA,131,9,2165,"[960,Max]",Extremamente Elevado,,,,131,Alentejo,PORTALEGRE,1212,57567.84,6061,405,389,355,483,478,961,1316,1705,2110,10.53,3.67,2.96,2.29
17-02-2022,NORDESTE,197,14,4046,"[960,Max]",Extremamente Elevado,,,,197,Açores,AÇORES,4202,10146.8,4862,246,180,124,161,162,323,447,627,873,47.92,8.6,6.18,4.41
17-02-2022,ÓBIDOS,457,33,3860,"[960,Max]",Extremamente Elevado,,,,457,Lisboa e Vale do Tejo,LEIRIA,1012,14155.44,11850,743,650,574,452,436,888,1462,2112,2855,83.72,20.17,14.92,10.33
17-02-2022,ODEMIRA,1177,84,4763,"[960,Max]",Extremamente Elevado,,,,1177,Alentejo,BEJA,0211,172060.15,24717,1475,1317,1225,1397,1349,2746,3971,5288,6763,14.37,3.93,3.07,2.31
17-02-2022,ODIVELAS,3658,261,2261,"[960,Max]",Extremamente Elevado,,,,3658,Lisboa e Vale do Tejo,LISBOA,1116,2654.36,161774,9562,9038,6952,4641,3812,8453,15405,24443,34005,6095.48,1281.27,920.99,580.44
17-02-2022,OEIRAS,4925,352,2776,"[960,Max]",Extremamente Elevado,,,,4925,Lisboa e Vale do Tejo,LISBOA,1110,4588.31,177408,11580,11575,8566,6211,5855,12066,20632,32207,43787,3866.78,954.38,701.98,449.69
17-02-2022,OLEIROS,181,13,3613,"[960,Max]",Extremamente Elevado,,,,181,Centro,CASTELO BRANCO,0506,47109.31,5003,384,341,366,397,487,884,1250,1591,1975,10.62,4.19,3.38,2.65
17-02-2022,OLHÃO,1912,137,4305,"[960,Max]",Extremamente Elevado,,,,1912,Algarve,FARO,0810,13086.38,44405,2455,2309,1689,1342,1268,2610,4299,6608,9063,339.33,69.26,50.5,32.85
17-02-2022,OLIVEIRA DE AZEMÉIS,2533,181,3837,"[960,Max]",Extremamente Elevado,,,,2533,Norte,AVEIRO,0113,16110.41,66011,4155,3614,2794,2183,1738,3921,6715,10329,14484,409.75,89.91,64.12,41.68
17-02-2022,OLIVEIRA DE FRADES,338,24,3405,"[960,Max]",Extremamente Elevado,,,,338,Centro,VISEU,1810,14534.62,9936,553,475,438,359,415,774,1212,1687,2240,68.36,15.41,11.61,8.34
17-02-2022,OLIVEIRA DO BAIRRO,1038,74,4276,"[960,Max]",Extremamente Elevado,,,,1038,Centro,AVEIRO,0114,8731.99,24277,1327,1182,999,786,810,1596,2595,3777,5104,278.02,58.45,43.25,29.72
17-02-2022,OLIVEIRA DO HOSPITAL,837,60,4348,"[960,Max]",Extremamente Elevado,,,,837,Centro,COIMBRA,0611,23451.66,19253,1161,1097,962,924,960,1884,2846,3943,5104,82.1,21.76,16.81,12.14
17-02-2022,OURÉM,1750,125,3973,"[960,Max]",Extremamente Elevado,,,,1750,Lisboa e Vale do Tejo,SANTARÉM,1421,41668.03,44044,2463,2069,1899,1817,1603,3420,5319,7388,9851,105.7,23.64,17.73,12.77
17-02-2022,OURIQUE,234,17,5083,"[960,Max]",Extremamente Elevado,,,,234,Alentejo,BEJA,0212,66331.36,4607,313,287,284,268,227,495,779,1066,1379,6.95,2.08,1.61,1.17
17-02-2022,OVAR,2081,149,3836,"[960,Max]",Extremamente Elevado,,,,2081,Centro,AVEIRO,0115,14770.25,54260,3294,2709,1994,1636,1234,2870,4864,7573,10867,367.37,73.57,51.27,32.93
17-02-2022,PAÇOS DE FERREIRA,1249,89,2202,"[960,Max]",Extremamente Elevado,,,,1249,Norte,PORTO,1309,7099.29,56728,2903,2193,1518,1135,664,1799,3317,5510,8413,799.1,118.51,77.62,46.72
17-02-2022,PALMELA,2104,150,3274,"[960,Max]",Extremamente Elevado,,,,2104,Lisboa e Vale do Tejo,SETÚBAL,1508,46512.01,64269,3402,3244,2635,1846,1391,3237,5872,9116,12518,138.18,26.91,19.6,12.62
17-02-2022,PAMPILHOSA DA SERRA,76,5,1885,"[960,Max]",Extremamente Elevado,,,,76,Centro,COIMBRA,0612,39646.24,4037,238,254,295,339,423,762,1057,1311,1549,10.18,3.91,3.31,2.67
17-02-2022,PAREDES,2431,174,2825,"[960,Max]",Extremamente Elevado,,,,2431,Norte,PORTO,1310,15675.69,86067,4272,3532,2412,1717,1258,2975,5387,8919,13191,549.04,84.15,56.9,34.36
17-02-2022,PAREDES DE COURA,192,14,2254,"[960,Max]",Extremamente Elevado,,,,192,Norte,VIANA DO CASTELO,1605,13818.59,8535,466,528,407,465,515,980,1387,1915,2381,61.76,17.23,13.86,10.04
17-02-2022,PEDRÓGÃO GRANDE,83,6,2430,"[960,Max]",Extremamente Elevado,,,,83,Centro,LEIRIA,1013,12874.75,3410,175,173,196,221,252,473,669,842,1017,26.49,7.9,6.54,5.2
17-02-2022,PENACOVA,435,31,3173,"[960,Max]",Extremamente Elevado,,,,435,Centro,COIMBRA,0613,21673.23,13694,968,923,745,621,703,1324,2069,2992,3960,63.18,18.27,13.81,9.55
17-02-2022,PENAFIEL,1972,141,2826,"[960,Max]",Extremamente Elevado,,,,1972,Norte,PORTO,1311,21224.27,69772,3648,2823,2032,1663,1230,2893,4925,7748,11396,328.74,53.69,36.51,23.2
17-02-2022,PENALVA DO CASTELO,207,15,2911,"[960,Max]",Extremamente Elevado,,,,207,Centro,VISEU,1811,13433.92,7115,449,457,413,391,426,817,1230,1687,2136,52.96,15.9,12.56,9.16
17-02-2022,PENAMACOR,96,7,2011,"[960,Max]",Extremamente Elevado,,,,96,Centro,CASTELO BRANCO,0507,56370.69,4755,262,248,273,451,633,1084,1357,1605,1867,8.44,3.31,2.85,2.41
17-02-2022,PENEDONO,33,2,1283,"[960,Max]",Extremamente Elevado,,,,33,Norte,VISEU,1812,13370.75,2591,172,113,129,156,138,294,423,536,708,19.38,5.3,4.01,3.16
17-02-2022,PENELA,148,11,2747,"[960,Max]",Extremamente Elevado,,,,148,Centro,COIMBRA,0614,13480.0,5397,314,324,274,359,344,703,977,1301,1615,40.04,11.98,9.65,7.25
17-02-2022,PENICHE,949,68,3580,"[960,Max]",Extremamente Elevado,,,,949,Lisboa e Vale do Tejo,LEIRIA,1014,7754.98,26501,1746,1504,1203,926,707,1633,2836,4340,6086,341.73,78.48,55.96,36.57
17-02-2022,PESO DA RÉGUA,543,39,3442,"[960,Max]",Extremamente Elevado,,,,543,Norte,VILA REAL,1708,9486.01,15773,1076,843,650,659,455,1114,1764,2607,3683,166.28,38.83,27.48,18.6
17-02-2022,PINHEL,221,16,2598,"[960,Max]",Extremamente Elevado,,,,221,Centro,GUARDA,0910,48452.12,8511,577,566,551,538,689,1227,1778,2344,2921,17.57,6.03,4.84,3.67
17-02-2022,POMBAL,2200,157,4276,"[960,Max]",Extremamente Elevado,,,,2200,Centro,LEIRIA,1015,62600.28,51461,3187,2791,2494,2328,2027,4355,6849,9640,12827,82.21,20.49,15.4,10.94
17-02-2022,PONTA DELGADA,4748,339,6989,"[960,Max]",Extremamente Elevado,,,,4748,Açores,AÇORES,4203,23298.65,67935,3108,2435,1726,1133,902,2035,3761,6196,9304,291.58,39.93,26.59,16.14
17-02-2022,PONTA DO SOL,235,17,2736,"[960,Max]",Extremamente Elevado,,,,235,Madeira,MADEIRA,3105,4622.03,8593,319,283,347,208,221,429,776,1059,1378,185.92,29.81,22.91,16.79
17-02-2022,PONTE DA BARCA,263,19,2352,"[960,Max]",Extremamente Elevado,,,,263,Norte,VIANA DO CASTELO,1606,18211.37,11180,635,576,517,554,490,1044,1561,2137,2772,61.39,15.22,11.73,8.57
17-02-2022,PONTE DE LIMA,1150,82,2784,"[960,Max]",Extremamente Elevado,,,,1150,Norte,VIANA DO CASTELO,1607,32025.46,41315,2321,2022,1720,1596,1462,3058,4778,6800,9121,129.01,28.48,21.23,14.92
17-02-2022,PONTE DE SOR,334,24,2230,"[960,Max]",Extremamente Elevado,,,,334,Alentejo,PORTALEGRE,1213,83971.16,14994,939,800,716,739,831,1570,2286,3086,4025,17.86,4.79,3.68,2.72
17-02-2022,PORTALEGRE,1318,94,5945,"[960,Max]",Extremamente Elevado,,,,1318,Alentejo,PORTALEGRE,1214,44713.64,22172,1577,1351,1137,993,984,1977,3114,4465,6042,49.59,13.51,9.99,6.96
17-02-2022,PORTEL,227,16,3896,"[960,Max]",Extremamente Elevado,,,,227,Alentejo,ÉVORA,0709,60100.57,5828,336,358,283,331,305,636,919,1277,1613,9.7,2.68,2.12,1.53
17-02-2022,PORTIMÃO,2374,170,4279,"[960,Max]",Extremamente Elevado,,,,2374,Algarve,FARO,0811,18206.29,55483,3182,2927,2116,1582,1400,2982,5098,8025,11207,304.75,61.56,44.08,28.0
17-02-2022,PORTO,9578,684,4422,"[960,Max]",Extremamente Elevado,,,,9578,Norte,PORTO,1312,4142.02,216606,15790,15193,11280,9409,10044,19453,30733,45926,61716,5229.5,1490.0,1108.79,741.98
17-02-2022,PORTO DE MÓS,897,64,3854,"[960,Max]",Extremamente Elevado,,,,897,Centro,LEIRIA,1016,26183.41,23275,1355,1210,1034,888,872,1760,2794,4004,5359,88.89,20.47,15.29,10.67
17-02-2022,PORTO MONIZ,29,2,1254,"[960,Max]",Extremamente Elevado,,,,29,Madeira,MADEIRA,3106,8293.38,2342,143,130,95,98,120,218,313,443,586,28.24,7.07,5.34,3.77
17-02-2022,PORTO SANTO,129,9,2482,"[960,Max]",Extremamente Elevado,,,,129,Madeira,MADEIRA,3201,4300.7,5202,240,157,134,110,68,178,312,469,709,120.95,16.48,10.9,7.25
17-02-2022,PÓVOA DE LANHOSO,582,42,2709,"[960,Max]",Extremamente Elevado,,,,582,Norte,BRAGA,0309,13465.29,21499,1175,909,732,673,624,1297,2029,2938,4113,159.67,30.55,21.82,15.07
17-02-2022,PÓVOA DE VARZIM,2313,165,3684,"[960,Max]",Extremamente Elevado,,,,2313,Norte,PORTO,1313,8220.59,62784,3712,3120,2134,1594,1305,2899,5033,8153,11865,763.7,144.33,99.17,61.22
17-02-2022,POVOAÇÃO,242,17,4088,"[960,Max]",Extremamente Elevado,,,,242,Açores,AÇORES,4204,10640.77,5927,293,212,191,144,134,278,469,681,974,55.7,9.15,6.4,4.41
17-02-2022,VILA DA PRAIA DA VITÓRIA,913,65,4282,"[960,Max]",Extremamente Elevado,,,,913,Açores,AÇORES,4302,16127.06,21317,1133,789,619,436,336,772,1391,2180,3313,132.18,20.54,13.52,8.63
17-02-2022,PROENÇA-A-NOVA,194,14,2665,"[960,Max]",Extremamente Elevado,,,,194,Centro,CASTELO BRANCO,0508,39539.96,7298,508,465,389,400,560,960,1349,1814,2322,18.46,5.87,4.59,3.41
17-02-2022,REDONDO,209,15,3294,"[960,Max]",Extremamente Elevado,,,,209,Alentejo,ÉVORA,0710,36950.87,6353,349,325,288,288,354,642,930,1255,1604,17.19,4.34,3.4,2.52
17-02-2022,REGUENGOS DE MONSARAZ,245,18,2448,"[960,Max]",Extremamente Elevado,,,,245,Alentejo,ÉVORA,0711,46399.72,10015,602,511,455,462,473,935,1390,1901,2503,21.58,5.39,4.1,3.0
17-02-2022,RESENDE,329,23,3243,"[960,Max]",Extremamente Elevado,,,,329,Norte,VISEU,1813,12334.93,10137,560,493,448,433,422,855,1303,1796,2356,82.18,19.1,14.56,10.56
17-02-2022,RIBEIRA BRAVA,409,29,3286,"[960,Max]",Extremamente Elevado,,,,409,Madeira,MADEIRA,3107,6544.88,12435,648,500,411,311,287,598,1009,1509,2157,189.99,32.96,23.06,15.42
17-02-2022,RIBEIRA DE PENA,163,12,2706,"[960,Max]",Extremamente Elevado,,,,163,Norte,VILA REAL,1709,21745.98,6016,371,301,290,310,368,678,968,1269,1640,27.66,7.54,5.84,4.45
17-02-2022,RIBEIRA GRANDE,1754,125,5347,"[960,Max]",Extremamente Elevado,,,,1754,Açores,AÇORES,4205,18015.13,32811,1163,689,512,345,253,598,1110,1799,2962,182.13,16.44,9.99,6.16
17-02-2022,RIO MAIOR,824,59,4042,"[960,Max]",Extremamente Elevado,,,,824,Lisboa e Vale do Tejo,SANTARÉM,1414,27276.45,20379,1251,1144,941,795,648,1443,2384,3528,4779,74.71,17.52,12.93,8.74
17-02-2022,SABROSA,198,14,3349,"[960,Max]",Extremamente Elevado,,,,198,Norte,VILA REAL,1710,15692.45,5918,393,314,304,302,350,652,956,1270,1663,37.71,10.6,8.09,6.09
17-02-2022,SABUGAL,392,28,3705,"[960,Max]",Extremamente Elevado,,,,392,Centro,GUARDA,0911,82269.82,10585,724,707,694,796,1009,1805,2499,3206,3930,12.87,4.78,3.9,3.04
17-02-2022,SALVATERRA DE MAGOS,943,67,4428,"[960,Max]",Extremamente Elevado,,,,943,Lisboa e Vale do Tejo,SANTARÉM,1415,24393.2,21295,1275,1181,1060,799,772,1571,2631,3812,5087,87.3,20.85,15.63,10.79
17-02-2022,SANTA COMBA DÃO,410,29,3925,"[960,Max]",Extremamente Elevado,,,,410,Centro,VISEU,1814,11194.77,10452,732,684,569,538,464,1002,1571,2255,2987,93.36,26.68,20.14,14.03
17-02-2022,SANTA CRUZ,1281,92,2830,"[960,Max]",Extremamente Elevado,,,,1281,Madeira,MADEIRA,3108,8150.28,45281,1817,1301,974,716,523,1239,2213,3514,5331,555.6,65.41,43.12,27.15
17-02-2022,SANTA CRUZ DA GRACIOSA,339,24,8064,"[960,Max]",Extremamente Elevado,,,,339,Açores,AÇORES,4401,6065.78,4208,228,180,163,124,145,269,432,612,840,69.37,13.85,10.09,7.12
17-02-2022,SANTA CRUZ DAS FLORES,38,3,1755,"[960,Max]",Extremamente Elevado,,,,38,Açores,AÇORES,4802,7091.44,2165,125,98,74,56,51,107,181,279,404,30.53,5.7,3.93,2.55
17-02-2022,SANTA MARIA DA FEIRA,4664,333,3364,"[960,Max]",Extremamente Elevado,,,,4664,Norte,AVEIRO,0109,21587.65,138636,8182,6743,4771,3856,3079,6935,11706,18449,26631,642.19,123.36,85.46,54.22
17-02-2022,SANTA MARTA DE PENAGUIÃO,206,15,3127,"[960,Max]",Extremamente Elevado,,,,206,Norte,VILA REAL,1711,6928.13,6599,483,373,337,316,317,633,970,1343,1826,95.25,26.36,19.39,14.0
17-02-2022,SANTANA,179,13,2662,"[960,Max]",Extremamente Elevado,,,,179,Madeira,MADEIRA,3109,9547.3,6711,418,353,343,282,277,559,902,1255,1673,70.29,17.52,13.15,9.45
17-02-2022,SANTARÉM,2249,161,3917,"[960,Max]",Extremamente Elevado,,,,2249,Lisboa e Vale do Tejo,SANTARÉM,1416,55253.58,57421,3654,3441,2760,2466,2206,4672,7432,10873,14527,103.92,26.29,19.68,13.45
17-02-2022,SANTIAGO DO CACÉM,1265,90,4393,"[960,Max]",Extremamente Elevado,,,,1265,Alentejo,SETÚBAL,1509,105969.29,28791,2144,1689,1472,1295,1215,2510,3982,5671,7815,27.17,7.37,5.35,3.76
17-02-2022,SANTO TIRSO,2050,146,3012,"[960,Max]",Extremamente Elevado,,,,2050,Norte,PORTO,1314,13655.52,68055,4911,3935,2761,2257,1810,4067,6828,10763,15674,498.35,114.78,78.82,50.0
17-02-2022,SÃO BRÁS DE ALPORTEL,546,39,5245,"[960,Max]",Extremamente Elevado,,,,546,Algarve,FARO,0812,15336.92,10416,596,468,467,404,401,805,1272,1740,2336,67.91,15.23,11.35,8.29
17-02-2022,SÃO JOÃO DA MADEIRA,711,51,3236,"[960,Max]",Extremamente Elevado,,,,711,Norte,AVEIRO,0116,794.3,21958,1347,1069,796,601,593,1194,1990,3059,4406,2765.49,554.91,385.26,250.63
17-02-2022,SÃO JOÃO DA PESQUEIRA,172,12,2408,"[960,Max]",Extremamente Elevado,,,,172,Norte,VISEU,1815,26610.85,7125,417,330,294,328,328,656,950,1280,1697,26.77,6.38,4.81,3.57
17-02-2022,SÃO PEDRO DO SUL,629,45,4085,"[960,Max]",Extremamente Elevado,,,,629,Centro,VISEU,1816,34895.09,15403,990,962,861,759,909,1668,2529,3491,4481,44.14,12.84,10.0,7.25
17-02-2022,SÃO ROQUE DO PICO,95,7,2899,"[960,Max]",Extremamente Elevado,,,,95,Açores,AÇORES,4603,14236.1,3266,199,141,93,96,113,209,302,443,642,22.94,4.51,3.11,2.12
17-02-2022,SÃO VICENTE,69,5,1350,"[960,Max]",Extremamente Elevado,,,,69,Madeira,MADEIRA,3110,7883.71,5143,272,264,266,225,280,505,771,1035,1307,65.23,16.58,13.13,9.78
17-02-2022,SARDOAL,97,7,2583,"[960,Max]",Extremamente Elevado,,,,97,Lisboa e Vale do Tejo,SANTARÉM,1417,9214.72,3741,227,178,148,165,248,413,561,739,966,40.6,10.48,8.02,6.09
17-02-2022,SÁTÃO,307,22,2647,"[960,Max]",Extremamente Elevado,,,,307,Centro,VISEU,1817,20194.11,11580,765,671,515,465,476,941,1456,2127,2892,57.34,14.32,10.53,7.21
17-02-2022,SEIA,715,51,3216,"[960,Max]",Extremamente Elevado,,,,715,Centro,GUARDA,0912,43568.83,22234,1807,1589,1238,1122,721,1843,3081,4670,6477,51.03,14.87,10.72,7.07
17-02-2022,SEIXAL,4090,292,2438,"[960,Max]",Extremamente Elevado,,,,4090,Lisboa e Vale do Tejo,SETÚBAL,1510,9545.17,167752,10586,9270,6661,4391,2930,7321,13982,23252,33838,1757.49,354.51,243.6,146.49
17-02-2022,SERNANCELHE,75,5,1395,"[960,Max]",Extremamente Elevado,,,,75,Norte,VISEU,1818,22861.22,5396,305,293,286,273,260,533,819,1112,1417,23.6,6.2,4.86,3.58
17-02-2022,SERPA,323,23,2257,"[960,Max]",Extremamente Elevado,,,,323,Alentejo,BEJA,0213,110563.34,14304,903,761,719,697,626,1323,2042,2803,3706,12.94,3.35,2.54,1.85
17-02-2022,SERTÃ,603,43,4140,"[960,Max]",Extremamente Elevado,,,,603,Centro,CASTELO BRANCO,0509,44673.17,14577,870,779,790,767,1020,1787,2577,3356,4226,32.63,9.46,7.51,5.77
17-02-2022,SESIMBRA,1433,102,2764,"[960,Max]",Extremamente Elevado,,,,1433,Lisboa e Vale do Tejo,SETÚBAL,1511,19571.75,51858,2400,2321,1853,1257,1083,2340,4193,6514,8914,264.96,45.54,33.28,21.42
17-02-2022,SETÚBAL,3791,271,3293,"[960,Max]",Extremamente Elevado,,,,3791,Lisboa e Vale do Tejo,SETÚBAL,1512,23032.5,115126,7425,6929,5075,3775,2655,6430,11505,18434,25859,499.83,112.27,80.03,49.95
17-02-2022,SEVER DO VOUGA,385,28,3400,"[960,Max]",Extremamente Elevado,,,,385,Centro,AVEIRO,0117,12987.56,11331,766,637,568,540,567,1107,1675,2312,3078,87.24,23.7,17.8,12.9
17-02-2022,SILVES,1229,88,3392,"[960,Max]",Extremamente Elevado,,,,1229,Algarve,FARO,0813,68006.23,36226,2137,1869,1610,1423,1600,3023,4633,6502,8639,53.27,12.7,9.56,6.81
17-02-2022,SINES,506,36,3692,"[960,Max]",Extremamente Elevado,,,,506,Alentejo,SETÚBAL,1513,20330.17,13715,888,791,551,416,268,684,1235,2026,2914,67.46,14.33,9.97,6.07
17-02-2022,SINTRA,8893,635,2272,"[960,Max]",Extremamente Elevado,,,,8893,Lisboa e Vale do Tejo,LISBOA,1111,31922.73,391402,20490,18316,13545,9137,7284,16421,29966,48282,68772,1226.08,215.43,151.25,93.87
17-02-2022,SOBRAL DE MONTE AGRAÇO,286,20,2686,"[960,Max]",Extremamente Elevado,,,,286,Lisboa e Vale do Tejo,LISBOA,1112,5210.32,10651,564,507,352,272,212,484,836,1343,1907,204.43,36.6,25.78,16.05
17-02-2022,SOURE,727,52,4245,"[960,Max]",Extremamente Elevado,,,,727,Centro,COIMBRA,0615,26506.07,17120,1173,1142,1004,883,987,1870,2874,4016,5189,64.59,19.58,15.15,10.84
17-02-2022,SOUSEL,106,8,2403,"[960,Max]",Extremamente Elevado,,,,106,Alentejo,PORTALEGRE,1215,27932.18,4412,261,274,208,302,292,594,802,1076,1337,15.8,4.79,3.85,2.87
17-02-2022,TÁBUA,273,19,2400,"[960,Max]",Extremamente Elevado,,,,273,Centro,COIMBRA,0616,19978.58,11368,729,584,524,430,464,894,1418,2002,2731,56.9,13.67,10.02,7.1
17-02-2022,TABUAÇO,114,8,1894,"[960,Max]",Extremamente Elevado,,,,114,Norte,VISEU,1819,13385.67,6033,372,314,217,282,363,645,862,1176,1548,45.07,11.56,8.79,6.44
17-02-2022,TAROUCA,213,15,2723,"[960,Max]",Extremamente Elevado,,,,213,Norte,VISEU,1820,10008.49,7804,405,335,313,277,324,601,914,1249,1654,77.98,16.53,12.48,9.13
17-02-2022,TAVIRA,1061,76,4326,"[960,Max]",Extremamente Elevado,,,,1061,Algarve,FARO,0814,60696.7,24530,1493,1415,1252,1066,1277,2343,3595,5010,6503,40.41,10.71,8.25,5.92
17-02-2022,TERRAS DE BOURO,205,15,3230,"[960,Max]",Extremamente Elevado,,,,205,Norte,BRAGA,0310,27746.07,6361,391,372,296,319,340,659,955,1327,1718,22.93,6.19,4.78,3.44
17-02-2022,TOMAR,1037,74,2823,"[960,Max]",Extremamente Elevado,,,,1037,Lisboa e Vale do Tejo,SANTARÉM,1418,35120.44,36748,2403,2189,1868,1853,1822,3675,5543,7732,10135,104.64,28.86,22.02,15.78
17-02-2022,TONDELA,1224,87,4644,"[960,Max]",Extremamente Elevado,,,,1224,Centro,VISEU,1821,37121.73,26357,1768,1722,1518,1475,1417,2892,4410,6132,7900,71.0,21.28,16.52,11.88
17-02-2022,TORRE DE MONCORVO,191,14,2485,"[960,Max]",Extremamente Elevado,,,,191,Norte,BRAGANÇA,0409,53155.67,7695,556,478,488,551,719,1270,1758,2236,2792,14.48,5.25,4.21,3.31
17-02-2022,TORRES NOVAS,1319,94,3775,"[960,Max]",Extremamente Elevado,,,,1319,Lisboa e Vale do Tejo,SANTARÉM,1419,26999.68,34933,2324,1979,1738,1406,1475,2881,4619,6598,8922,129.38,33.04,24.44,17.11
17-02-2022,TORRES VEDRAS,2983,213,3799,"[960,Max]",Extremamente Elevado,,,,2983,Lisboa e Vale do Tejo,LISBOA,1113,40714.89,78530,4513,3945,3447,2628,2104,4732,8179,12124,16637,192.88,40.86,29.78,20.09
17-02-2022,TRANCOSO,189,13,2124,"[960,Max]",Extremamente Elevado,,,,189,Centro,GUARDA,0913,36152.47,8875,581,557,542,586,496,1082,1624,2181,2762,24.55,7.64,6.03,4.49
17-02-2022,TROFA,1526,109,3973,"[960,Max]",Extremamente Elevado,,,,1526,Norte,PORTO,1318,7201.76,38418,2336,1894,1231,939,684,1623,2854,4748,7084,533.44,98.36,65.93,39.63
17-02-2022,VAGOS,865,62,3803,"[960,Max]",Extremamente Elevado,,,,865,Centro,AVEIRO,0118,16491.5,22740,1320,1205,922,784,724,1508,2430,3635,4955,137.89,30.04,22.04,14.73
17-02-2022,VALE DE CAMBRA,712,51,3339,"[960,Max]",Extremamente Elevado,,,,712,Norte,AVEIRO,0119,14733.47,21327,1491,1363,1005,831,798,1629,2634,3997,5488,144.76,37.25,27.13,17.88
17-02-2022,VALENÇA,306,22,2304,"[960,Max]",Extremamente Elevado,,,,306,Norte,VIANA DO CASTELO,1608,11712.86,13290,867,791,582,582,503,1085,1667,2458,3325,113.46,28.39,20.99,14.23
17-02-2022,VALONGO,3940,281,4043,"[960,Max]",Extremamente Elevado,,,,3940,Norte,PORTO,1315,7512.45,97444,5629,4696,3207,2462,1829,4291,7498,12194,17823,1297.18,237.26,162.33,99.81
17-02-2022,VALPAÇOS,323,23,2178,"[960,Max]",Extremamente Elevado,,,,323,Norte,VILA REAL,1712,54873.93,14818,1217,1118,999,928,997,1925,2924,4042,5259,27.0,9.58,7.37,5.33
17-02-2022,VELAS,144,10,2821,"[960,Max]",Extremamente Elevado,,,,144,Açores,AÇORES,4502,11738.38,5093,278,208,166,153,113,266,432,640,918,43.39,7.82,5.45,3.68
17-02-2022,VENDAS NOVAS,424,30,3764,"[960,Max]",Extremamente Elevado,,,,424,Alentejo,ÉVORA,0712,22238.88,11255,677,768,655,501,532,1033,1688,2456,3133,50.61,14.09,11.04,7.59
17-02-2022,VIANA DO ALENTEJO,248,18,4817,"[960,Max]",Extremamente Elevado,,,,248,Alentejo,ÉVORA,0713,39367.29,5145,245,208,235,210,214,424,659,867,1112,13.07,2.82,2.2,1.67
17-02-2022,VIANA DO CASTELO,2780,199,3293,"[960,Max]",Extremamente Elevado,,,,2780,Norte,VIANA DO CASTELO,1609,31902.01,84417,5470,4433,3591,3061,2982,6043,9634,14067,19537,264.61,61.24,44.09,30.2
17-02-2022,VIDIGUEIRA,210,15,3818,"[960,Max]",Extremamente Elevado,,,,210,Alentejo,BEJA,0214,31661.09,5510,300,248,215,233,275,508,723,971,1271,17.4,4.01,3.07,2.28
17-02-2022,VIEIRA DO MINHO,234,17,1977,"[960,Max]",Extremamente Elevado,,,,234,Norte,BRAGA,0311,21644.35,11842,703,594,525,548,482,1030,1555,2149,2852,54.71,13.18,9.93,7.18
17-02-2022,VILA DE REI,105,7,3146,"[960,Max]",Extremamente Elevado,,,,105,Centro,CASTELO BRANCO,0510,19154.6,3323,169,128,172,247,302,549,721,849,1018,17.35,5.31,4.43,3.76
17-02-2022,VILA DO BISPO,191,14,3711,"[960,Max]",Extremamente Elevado,,,,191,Algarve,FARO,0815,17906.06,5154,302,302,314,232,233,465,779,1081,1383,28.78,7.72,6.04,4.35
17-02-2022,VILA DO CONDE,2860,204,3579,"[960,Max]",Extremamente Elevado,,,,2860,Norte,PORTO,1316,14902.77,79899,4726,3875,2819,2070,1743,3813,6632,10507,15233,536.13,102.21,70.5,44.5
17-02-2022,VILA DO PORTO,229,16,4081,"[960,Max]",Extremamente Elevado,,,,229,Açores,AÇORES,4101,9688.74,5616,274,212,135,96,123,219,354,566,840,57.96,8.67,5.84,3.65
17-02-2022,VILA FLOR,158,11,2612,"[960,Max]",Extremamente Elevado,,,,158,Norte,BRAGANÇA,0410,26581.14,6044,429,362,422,294,331,625,1047,1409,1838,22.74,6.91,5.3,3.94
17-02-2022,VILA FRANCA DE XIRA,4144,296,2919,"[960,Max]",Extremamente Elevado,,,,4144,Lisboa e Vale do Tejo,LISBOA,1114,31819.39,141957,8501,6852,4869,3425,2472,5897,10766,17618,26119,446.14,82.09,55.37,33.84
17-02-2022,VILA FRANCA DO CAMPO,618,44,5590,"[960,Max]",Extremamente Elevado,,,,618,Açores,AÇORES,4206,7796.82,11051,450,344,248,217,154,371,619,963,1413,141.73,18.12,12.35,7.94
17-02-2022,VILA NOVA DA BARQUINHA,401,29,5378,"[960,Max]",Extremamente Elevado,,,,401,Lisboa e Vale do Tejo,SANTARÉM,1420,4952.97,7461,415,406,392,364,338,702,1094,1500,1915,150.64,38.66,30.28,22.09
17-02-2022,VILA NOVA DE CERVEIRA,266,19,2989,"[960,Max]",Extremamente Elevado,,,,266,Norte,VIANA DO CASTELO,1610,10846.66,8910,531,444,410,384,334,718,1128,1572,2103,82.14,19.39,14.49,10.4
17-02-2022,VILA NOVA DE FAMALICÃO,4711,337,3578,"[960,Max]",Extremamente Elevado,,,,4711,Norte,BRAGA,0312,20159.26,131676,7817,6164,4202,3282,2749,6031,10233,16397,24214,653.19,120.12,81.34,50.76
17-02-2022,VILA NOVA DE FOZ CÔA,155,11,2382,"[960,Max]",Extremamente Elevado,,,,155,Centro,GUARDA,0914,39815.18,6503,442,385,390,398,429,827,1217,1602,2044,16.33,5.13,4.02,3.06
17-02-2022,VILA NOVA DE GAIA,12292,878,4091,"[960,Max]",Extremamente Elevado,,,,12292,Norte,PORTO,1317,16846.43,300472,18349,15568,10972,8224,6281,14505,25477,41045,59394,1783.64,352.57,243.65,151.23
17-02-2022,VILA NOVA DE PAIVA,97,7,2069,"[960,Max]",Extremamente Elevado,,,,97,Centro,VISEU,1822,17553.28,4687,289,272,233,217,241,458,691,963,1252,26.7,7.13,5.49,3.94
17-02-2022,VILA NOVA DE POIARES,238,17,3434,"[960,Max]",Extremamente Elevado,,,,238,Centro,COIMBRA,0617,8445.3,6939,380,284,262,235,182,417,679,963,1343,82.17,15.9,11.4,8.04
17-02-2022,VILA POUCA DE AGUIAR,259,19,2167,"[960,Max]",Extremamente Elevado,,,,259,Norte,VILA REAL,1713,43706.62,11961,860,817,733,601,627,1228,1961,2778,3638,27.37,8.32,6.36,4.49
17-02-2022,VILA REAL,1657,118,3316,"[960,Max]",Extremamente Elevado,,,,1657,Norte,VILA REAL,1714,37880.28,49962,3025,2498,2065,1579,1466,3045,5110,7608,10633,131.9,28.07,20.08,13.49
17-02-2022,VILA REAL DE SANTO ANTÓNIO,698,50,3723,"[960,Max]",Extremamente Elevado,,,,698,Algarve,FARO,0816,6125.0,18749,1172,1069,811,569,586,1155,1966,3035,4207,306.11,68.69,49.55,32.1
17-02-2022,VILA VELHA DE RÓDÃO,97,7,3087,"[960,Max]",Extremamente Elevado,,,,97,Centro,CASTELO BRANCO,0511,32991.16,3144,209,229,180,283,306,589,769,998,1207,9.53,3.66,3.03,2.33
17-02-2022,VILA VERDE,1519,109,3239,"[960,Max]",Extremamente Elevado,,,,1519,Norte,BRAGA,0313,22866.52,46911,2365,2063,1667,1494,1437,2931,4598,6661,9026,205.15,39.47,29.13,20.11
17-02-2022,VILA VIÇOSA,199,14,2604,"[960,Max]",Extremamente Elevado,,,,199,Alentejo,ÉVORA,0714,19485.89,7656,487,379,342,345,324,669,1011,1390,1877,39.29,9.63,7.13,5.19
17-02-2022,VIMIOSO,36,3,884,"[480,960]",Muito Elevado,,,,36,Norte,BRAGANÇA,0411,48158.51,4023,274,230,261,293,335,628,889,1119,1393,8.35,2.89,2.32,1.85
17-02-2022,VINHAIS,114,8,1472,"[960,Max]",Extremamente Elevado,,,,114,Norte,BRAGANÇA,0412,69475.09,7746,599,577,636,641,815,1456,2092,2669,3268,11.15,4.7,3.84,3.01
17-02-2022,VISEU,3986,285,4099,"[960,Max]",Extremamente Elevado,,,,3986,Centro,VISEU,1823,50710.14,97249,5769,5038,4140,3158,2710,5868,10008,15046,20815,191.77,41.05,29.67,19.74
17-02-2022,VIZELA,601,43,2515,"[960,Max]",Extremamente Elevado,,,,601,Norte,BRAGA,0314,2469.83,23897,1258,928,655,509,371,880,1535,2463,3721,967.49,150.65,99.72,62.15
17-02-2022,VOUZELA,387,28,4022,"[960,Max]",Extremamente Elevado,,,,387,Centro,VISEU,1824,19369.46,9619,626,605,554,532,507,1039,1593,2198,2824,49.66,14.58,11.35,8.22
03-03-2022,ABRANTES,345,25,981,"[960,Max]",Extremamente Elevado,,,,345,Lisboa e Vale do Tejo,SANTARÉM,1401,71469.08,35130,2473,2213,1730,1748,2021,3769,5499,7712,10185,49.15,14.25,10.79,7.69
03-03-2022,ÁGUEDA,487,35,1057,"[960,Max]",Extremamente Elevado,,,,487,Centro,AVEIRO,0101,33527.44,46075,3237,2713,2090,1635,1496,3131,5221,7934,11171,137.43,33.32,23.66,15.57
03-03-2022,AGUIAR DA BEIRA,45,3,971,"[960,Max]",Extremamente Elevado,,,,45,Centro,GUARDA,0901,20676.57,4652,304,281,235,239,148,387,622,903,1207,22.5,5.84,4.37,3.01
03-03-2022,ALANDROAL,102,7,2043,"[960,Max]",Extremamente Elevado,,,,102,Alentejo,ÉVORA,0701,54267.81,4992,307,256,296,299,377,676,972,1228,1535,9.2,2.83,2.26,1.79
03-03-2022,ALBERGARIA-A-VELHA,211,15,873,"[480,960]",Muito Elevado,,,,211,Centro,AVEIRO,0102,15882.5,24144,1550,1298,996,687,680,1367,2363,3661,5211,152.02,32.81,23.05,14.88
03-03-2022,ALBUFEIRA,724,52,1744,"[960,Max]",Extremamente Elevado,,,,724,Algarve,FARO,0801,14066.42,41528,2067,1717,1425,985,858,1843,3268,4985,7052,295.24,50.14,35.44,23.23
03-03-2022,ALCÁCER DO SAL,231,17,1983,"[960,Max]",Extremamente Elevado,,,,231,Alentejo,SETÚBAL,1501,149987.3,11659,884,814,623,623,602,1225,1848,2662,3546,7.77,2.36,1.77,1.23
03-03-2022,ALCANENA,220,16,1717,"[960,Max]",Extremamente Elevado,,,,220,Lisboa e Vale do Tejo,SANTARÉM,1402,12732.86,12809,891,744,628,536,588,1124,1752,2496,3387,100.6,26.6,19.6,13.76
03-03-2022,ALCOBAÇA,855,61,1597,"[960,Max]",Extremamente Elevado,,,,855,Lisboa e Vale do Tejo,LEIRIA,1001,40814.09,53555,3420,2927,2466,2059,1676,3735,6201,9128,12548,131.22,30.74,22.36,15.19
03-03-2022,ALCOCHETE,351,25,1776,"[960,Max]",Extremamente Elevado,,,,351,Lisboa e Vale do Tejo,SETÚBAL,1502,12836.48,19787,857,834,691,476,447,923,1614,2448,3305,154.15,25.75,19.07,12.57
03-03-2022,ALCOUTIM,43,3,1974,"[960,Max]",Extremamente Elevado,,,,43,Algarve,FARO,0802,57536.33,2159,191,188,163,190,267,457,620,808,999,3.75,1.74,1.4,1.08
03-03-2022,ALENQUER,615,44,1396,"[960,Max]",Extremamente Elevado,,,,615,Lisboa e Vale do Tejo,LISBOA,1101,30421.92,44052,2298,2062,1629,1330,1155,2485,4114,6176,8474,144.8,27.85,20.3,13.52
03-03-2022,ALFÂNDEGA DA FÉ,27,2,601,"[480,960]",Muito Elevado,,,,27,Norte,BRAGANÇA,0401,32194.64,4550,325,277,301,274,325,599,900,1177,1502,14.13,4.67,3.66,2.8
03-03-2022,ALIJÓ,129,9,1216,"[960,Max]",Extremamente Elevado,,,,129,Norte,VILA REAL,1701,29759.89,10625,766,687,635,542,666,1208,1843,2530,3296,35.7,11.08,8.5,6.19
03-03-2022,ALJEZUR,131,9,2340,"[960,Max]",Extremamente Elevado,,,,131,Algarve,FARO,0803,32349.95,5594,316,336,335,320,410,730,1065,1401,1717,17.29,5.31,4.33,3.29
03-03-2022,ALJUSTREL,145,10,1757,"[960,Max]",Extremamente Elevado,,,,145,Alentejo,BEJA,0201,45847.41,8247,635,521,443,347,358,705,1148,1669,2304,17.99,5.03,3.64,2.5
03-03-2022,ALMADA,2135,152,1263,"[960,Max]",Extremamente Elevado,,,,2135,Lisboa e Vale do Tejo,SETÚBAL,1503,7000.89,169039,10469,9777,7876,6144,5111,11255,19131,28908,39377,2414.5,562.45,412.91,273.26
03-03-2022,ALMEIDA,115,8,1970,"[960,Max]",Extremamente Elevado,,,,115,Centro,GUARDA,0902,51798.46,5830,441,419,396,458,393,851,1247,1666,2107,11.26,4.07,3.22,2.41
03-03-2022,ALMEIRIM,413,30,1833,"[960,Max]",Extremamente Elevado,,,,413,Lisboa e Vale do Tejo,SANTARÉM,1403,22212.05,22546,1342,1353,1106,866,843,1709,2815,4168,5510,101.5,24.81,18.76,12.67
03-03-2022,ALMODÔVAR,107,8,1592,"[960,Max]",Extremamente Elevado,,,,107,Alentejo,BEJA,0202,77788.03,6725,414,443,396,373,328,701,1097,1540,1954,8.65,2.51,1.98,1.41
03-03-2022,ALPIARÇA,105,8,1489,"[960,Max]",Extremamente Elevado,,,,105,Lisboa e Vale do Tejo,SANTARÉM,1404,9536.33,7059,515,486,363,333,274,607,970,1456,1971,74.02,20.67,15.27,10.17
03-03-2022,ALTER DO CHÃO,75,5,2360,"[960,Max]",Extremamente Elevado,,,,75,Alentejo,PORTALEGRE,1201,36206.62,3165,201,163,136,208,187,395,531,694,895,8.74,2.47,1.92,1.47
03-03-2022,ALVAIÁZERE,100,7,1517,"[960,Max]",Extremamente Elevado,,,,100,Centro,LEIRIA,1002,16047.76,6597,419,389,346,406,539,945,1291,1680,2099,41.11,13.08,10.47,8.04
03-03-2022,ALVITO,69,5,2796,"[960,Max]",Extremamente Elevado,,,,69,Alentejo,BEJA,0203,26485.32,2477,145,110,105,111,89,200,305,415,560,9.35,2.11,1.57,1.15
03-03-2022,AMADORA,1513,108,822,"[480,960]",Muito Elevado,,,,1513,Lisboa e Vale do Tejo,LISBOA,1115,2378.47,184106,11186,10936,8780,6460,5890,12350,21130,32066,43252,7742.05,1818.84,1348.44,888.56
03-03-2022,AMARANTE,514,37,966,"[960,Max]",Extremamente Elevado,,,,514,Norte,PORTO,1301,30133.15,53193,3086,2413,1812,1643,1311,2954,4766,7179,10265,176.53,34.07,23.82,15.82
03-03-2022,AMARES,165,12,912,"[480,960]",Muito Elevado,,,,165,Norte,BRAGA,0301,8195.41,18129,1001,829,622,489,524,1013,1635,2464,3465,221.22,42.28,30.07,19.95
03-03-2022,ANADIA,372,27,1363,"[960,Max]",Extremamente Elevado,,,,372,Centro,AVEIRO,0103,21663.48,27258,1931,1698,1376,1208,1262,2470,3846,5544,7475,125.83,34.51,25.59,17.75
03-03-2022,ANGRA DO HEROÍSMO,1331,95,3938,"[960,Max]",Extremamente Elevado,,,,1331,Açores,AÇORES,4301,23899.66,33807,2006,1473,1122,768,635,1403,2525,3998,6004,141.45,25.12,16.73,10.56
03-03-2022,ANSIÃO,175,12,1451,"[960,Max]",Extremamente Elevado,,,,175,Centro,LEIRIA,1003,17609.42,12039,727,709,646,694,530,1224,1870,2579,3306,68.37,18.77,14.65,10.62
03-03-2022,ARCOS DE VALDEVEZ,207,15,991,"[960,Max]",Extremamente Elevado,,,,207,Norte,VIANA DO CASTELO,1601,44759.64,20926,1329,1338,1282,1343,1515,2858,4140,5478,6807,46.75,15.21,12.24,9.25
03-03-2022,ARGANIL,182,13,1656,"[960,Max]",Extremamente Elevado,,,,182,Centro,COIMBRA,0601,33283.93,11014,672,648,612,559,596,1155,1767,2415,3087,33.09,9.27,7.26,5.31
03-03-2022,ARMAMAR,69,5,1190,"[960,Max]",Extremamente Elevado,,,,69,Norte,VISEU,1801,11723.73,5769,357,305,309,285,310,595,904,1209,1566,49.21,13.36,10.31,7.71
03-03-2022,AROUCA,162,12,781,"[480,960]",Muito Elevado,,,,162,Norte,AVEIRO,0104,32910.52,20720,1306,1047,753,683,683,1366,2119,3166,4472,62.96,13.59,9.62,6.44
03-03-2022,ARRAIOLOS,85,6,1223,"[960,Max]",Extremamente Elevado,,,,85,Alentejo,ÉVORA,0702,68374.55,6928,435,384,283,367,480,847,1130,1514,1949,10.13,2.85,2.21,1.65
03-03-2022,ARRONCHES,31,2,1086,"[960,Max]",Extremamente Elevado,,,,31,Alentejo,PORTALEGRE,1202,31464.72,2820,155,142,162,187,179,366,528,670,825,8.96,2.62,2.13,1.68
03-03-2022,ARRUDA DOS VINHOS,190,14,1236,"[960,Max]",Extremamente Elevado,,,,190,Lisboa e Vale do Tejo,LISBOA,1102,7795.93,15412,738,738,562,509,438,947,1509,2247,2985,197.69,38.29,28.82,19.36
03-03-2022,AVEIRO,1114,80,1415,"[960,Max]",Extremamente Elevado,,,,1114,Centro,AVEIRO,0105,19757.57,78734,4520,4004,3050,2250,2103,4353,7403,11407,15927,398.49,80.61,57.73,37.47
03-03-2022,AVIS,107,8,2527,"[960,Max]",Extremamente Elevado,,,,107,Alentejo,PORTALEGRE,1203,60596.51,4247,315,225,206,251,273,524,730,955,1270,7.01,2.1,1.58,1.2
03-03-2022,AZAMBUJA,276,20,1213,"[960,Max]",Extremamente Elevado,,,,276,Lisboa e Vale do Tejo,LISBOA,1103,26265.65,22716,1322,1171,1070,798,618,1416,2486,3657,4979,86.48,18.96,13.92,9.46
03-03-2022,BAIÃO,111,8,592,"[480,960]",Muito Elevado,,,,111,Norte,PORTO,1302,17452.83,18748,1070,862,714,686,725,1411,2125,2987,4057,107.42,23.25,17.11,12.18
03-03-2022,BARCELOS,816,58,702,"[480,960]",Muito Elevado,,,,816,Norte,BRAGA,0302,37890.14,116187,6721,5325,3619,2991,2562,5553,9172,14497,21218,306.64,56.0,38.26,24.21
03-03-2022,BARRANCOS,14,1,863,"[480,960]",Muito Elevado,,,,14,Alentejo,BEJA,0204,16841.73,1634,90,65,65,94,61,155,220,285,375,9.7,2.23,1.69,1.31
03-03-2022,BARREIRO,633,45,843,"[480,960]",Muito Elevado,,,,633,Lisboa e Vale do Tejo,SETÚBAL,1504,3639.07,75147,5194,5565,4459,3105,1767,4872,9331,14896,20090,2065.05,552.07,409.34,256.42
03-03-2022,BATALHA,324,23,2029,"[960,Max]",Extremamente Elevado,,,,324,Centro,LEIRIA,1004,10341.6,15963,873,762,649,529,549,1078,1727,2489,3362,154.35,32.51,24.07,16.7
03-03-2022,BEJA,665,47,1980,"[960,Max]",Extremamente Elevado,,,,665,Alentejo,BEJA,0205,114647.55,33579,2005,1840,1386,1272,1039,2311,3697,5537,7542,29.29,6.58,4.83,3.22
03-03-2022,BELMONTE,174,12,2726,"[960,Max]",Extremamente Elevado,,,,174,Centro,CASTELO BRANCO,0501,11875.91,6398,444,321,325,310,355,665,990,1311,1755,53.87,14.78,11.04,8.34
03-03-2022,BENAVENTE,676,48,2210,"[960,Max]",Extremamente Elevado,,,,676,Lisboa e Vale do Tejo,SANTARÉM,1405,52138.39,30602,1468,1376,1141,876,643,1519,2660,4036,5504,58.69,10.56,7.74,5.1
03-03-2022,BOMBARRAL,204,15,1624,"[960,Max]",Extremamente Elevado,,,,204,Lisboa e Vale do Tejo,LEIRIA,1005,9128.55,12558,875,714,561,491,429,920,1481,2195,3070,137.56,33.63,24.04,16.22
03-03-2022,BORBA,102,7,1515,"[960,Max]",Extremamente Elevado,,,,102,Alentejo,ÉVORA,0703,14518.65,6736,430,375,279,436,392,828,1107,1482,1912,46.39,13.17,10.21,7.62
03-03-2022,BOTICAS,42,3,832,"[480,960]",Muito Elevado,,,,42,Norte,VILA REAL,1702,32195.66,4998,347,306,311,305,380,685,996,1302,1649,15.52,5.12,4.04,3.09
03-03-2022,BRAGA,1637,117,896,"[480,960]",Muito Elevado,,,,1637,Norte,BRAGA,0303,18339.95,182679,10029,7963,5241,4320,3671,7991,13232,21195,31224,996.07,170.25,115.57,72.15
03-03-2022,BRAGANÇA,270,19,804,"[480,960]",Muito Elevado,,,,270,Norte,BRAGANÇA,0402,117357.27,33607,2402,1855,1652,1393,1163,2556,4208,6063,8465,28.64,7.21,5.17,3.59
03-03-2022,CABECEIRAS DE BASTO,89,6,567,"[480,960]",Muito Elevado,,,,89,Norte,BRAGA,0304,24182.16,15628,774,594,544,575,574,1149,1693,2287,3061,64.63,12.66,9.46,7.0
03-03-2022,CADAVAL,283,20,2068,"[960,Max]",Extremamente Elevado,,,,283,Lisboa e Vale do Tejo,LISBOA,1104,17489.3,13673,813,796,756,621,625,1246,2002,2798,3611,78.18,20.65,16.0,11.45
03-03-2022,CALDAS DA RAINHA,837,60,1612,"[960,Max]",Extremamente Elevado,,,,837,Lisboa e Vale do Tejo,LEIRIA,1006,25569.47,51912,3035,2684,2186,1899,1705,3604,5790,8474,11509,203.03,45.01,33.14,22.64
03-03-2022,CALHETA,321,23,2954,"[960,Max]",Extremamente Elevado,,,,321,Madeira,MADEIRA,3101,11150.43,10867,576,497,507,399,415,814,1321,1818,2394,97.46,21.47,16.3,11.85
03-03-2022,CALHETA (AÇORES),171,12,5381,"[960,Max]",Extremamente Elevado,,,,171,Açores,AÇORES,4501,12626.4,3184,215,159,141,139,122,261,402,561,776,25.22,6.15,4.44,3.18
03-03-2022,CÂMARA DE LOBOS,672,48,1995,"[960,Max]",Extremamente Elevado,,,,672,Madeira,MADEIRA,3102,5216.67,33675,1396,1059,834,545,381,926,1760,2819,4215,645.49,80.79,54.03,33.74
03-03-2022,CAMINHA,154,11,969,"[960,Max]",Extremamente Elevado,,,,154,Norte,VIANA DO CASTELO,1602,13652.14,15877,1046,944,818,646,656,1302,2120,3064,4110,116.3,30.11,22.44,15.53
03-03-2022,CAMPO MAIOR,136,10,1733,"[960,Max]",Extremamente Elevado,,,,136,Alentejo,PORTALEGRE,1204,24720.16,7874,471,364,351,279,327,606,957,1321,1792,31.85,7.25,5.34,3.87
03-03-2022,CANTANHEDE,702,50,2004,"[960,Max]",Extremamente Elevado,,,,702,Centro,COIMBRA,0602,39088.02,35011,2346,2096,1880,1709,1451,3160,5040,7136,9482,89.57,24.26,18.26,12.89
03-03-2022,CARRAZEDA DE ANSIÃES,35,3,624,"[480,960]",Muito Elevado,,,,35,Norte,BRAGANÇA,0403,27924.09,5666,424,389,391,312,465,777,1168,1557,1981,20.29,7.09,5.58,4.18
03-03-2022,CARREGAL DO SAL,117,8,1267,"[960,Max]",Extremamente Elevado,,,,117,Centro,VISEU,1802,11689.21,9271,587,562,486,462,376,838,1324,1886,2473,79.31,21.16,16.13,11.33
03-03-2022,CARTAXO,323,23,1354,"[960,Max]",Extremamente Elevado,,,,323,Lisboa e Vale do Tejo,SANTARÉM,1406,15817.28,23843,1415,1376,1142,861,632,1493,2635,4011,5426,150.74,34.3,25.36,16.66
03-03-2022,CASCAIS,2948,211,1380,"[960,Max]",Extremamente Elevado,,,,2948,Lisboa e Vale do Tejo,LISBOA,1105,9740.17,213608,12151,11444,8680,6469,5248,11717,20397,31841,43992,2193.1,451.66,326.91,209.41
03-03-2022,CASTANHEIRA DE PÊRA,16,1,621,"[480,960]",Muito Elevado,,,,16,Centro,LEIRIA,1007,6677.45,2614,233,195,157,190,187,377,534,729,962,39.15,14.41,10.92,8.0
03-03-2022,CASTELO BRANCO,1180,84,2269,"[960,Max]",Extremamente Elevado,,,,1180,Centro,CASTELO BRANCO,0502,143819.15,51987,3528,3042,2499,2229,2225,4454,6953,9995,13523,36.15,9.4,6.95,4.83
03-03-2022,CASTELO DE PAIVA,239,17,1549,"[960,Max]",Extremamente Elevado,,,,239,Norte,AVEIRO,0106,11500.53,15454,881,697,545,420,431,851,1396,2093,2974,134.37,25.86,18.2,12.14
03-03-2022,CASTELO DE VIDE,76,5,2596,"[960,Max]",Extremamente Elevado,,,,76,Alentejo,PORTALEGRE,1205,26491.24,2919,204,173,179,147,170,317,496,669,873,11.02,3.3,2.53,1.87
03-03-2022,CASTRO DAIRE,103,7,746,"[480,960]",Muito Elevado,,,,103,Centro,VISEU,1803,37904.13,13823,942,857,765,732,773,1505,2270,3127,4069,36.47,10.74,8.25,5.99
03-03-2022,CASTRO MARIM,128,9,2049,"[960,Max]",Extremamente Elevado,,,,128,Algarve,FARO,0804,30084.37,6237,370,345,334,322,344,666,1000,1345,1715,20.73,5.7,4.47,3.32
03-03-2022,CASTRO VERDE,146,10,2104,"[960,Max]",Extremamente Elevado,,,,146,Alentejo,BEJA,0206,56944.23,6949,437,347,303,275,227,502,805,1152,1589,12.2,2.79,2.02,1.41
03-03-2022,CELORICO DA BEIRA,59,4,851,"[480,960]",Muito Elevado,,,,59,Centro,GUARDA,0903,24721.63,6928,430,416,363,369,535,904,1267,1683,2113,28.02,8.55,6.81,5.12
03-03-2022,CELORICO DE BASTO,100,7,524,"[480,960]",Muito Elevado,,,,100,Norte,BRAGA,0305,18107.02,19040,1001,802,668,728,729,1457,2125,2927,3928,105.15,21.69,16.17,11.74
03-03-2022,CHAMUSCA,98,7,1070,"[960,Max]",Extremamente Elevado,,,,98,Lisboa e Vale do Tejo,SANTARÉM,1407,74600.54,9197,629,583,553,465,579,1044,1597,2180,2809,12.33,3.77,2.92,2.14
03-03-2022,CHAVES,282,20,717,"[480,960]",Muito Elevado,,,,282,Norte,VILA REAL,1703,59122.95,39343,2676,2429,1991,1886,1918,3804,5795,8224,10900,66.54,18.44,13.91,9.8
03-03-2022,CINFÃES,105,8,578,"[480,960]",Muito Elevado,,,,105,Norte,VISEU,1804,23928.76,18244,1067,902,779,734,758,1492,2271,3173,4240,76.24,17.72,13.26,9.49
03-03-2022,COIMBRA,3453,247,2574,"[960,Max]",Extremamente Elevado,,,,3453,Centro,COIMBRA,0603,31939.94,134166,9489,8734,6353,5139,5074,10213,16566,25300,34789,420.06,108.92,79.21,51.87
03-03-2022,CONDEIXA-A-NOVA,556,40,3135,"[960,Max]",Extremamente Elevado,,,,556,Centro,COIMBRA,0604,13867.47,17733,871,809,717,583,490,1073,1790,2599,3470,127.88,25.02,18.74,12.91
03-03-2022,CONSTÂNCIA,47,3,1160,"[960,Max]",Extremamente Elevado,,,,47,Lisboa e Vale do Tejo,SANTARÉM,1408,8036.58,4030,211,183,187,148,155,303,490,673,884,50.14,11.0,8.37,6.1
03-03-2022,CORUCHE,380,27,2176,"[960,Max]",Extremamente Elevado,,,,380,Lisboa e Vale do Tejo,SANTARÉM,1409,111572.03,17471,1294,1090,1095,1096,1019,2115,3210,4300,5594,15.66,5.01,3.85,2.88
03-03-2022,CORVO,55,4,11915,"[960,Max]",Extremamente Elevado,,,,55,Açores,AÇORES,4901,1711.45,464,22,21,11,13,19,32,43,64,86,27.12,5.03,3.74,2.51
03-03-2022,COVILHÃ,1256,90,2685,"[960,Max]",Extremamente Elevado,,,,1256,Centro,CASTELO BRANCO,0503,55560.06,46787,3533,2998,2365,2111,2193,4304,6669,9667,13200,84.21,23.76,17.4,12.0
03-03-2022,CRATO,84,6,2681,"[960,Max]",Extremamente Elevado,,,,84,Alentejo,PORTALEGRE,1206,39806.88,3129,229,258,163,182,228,410,573,831,1060,7.86,2.66,2.09,1.44
03-03-2022,CUBA,45,3,990,"[960,Max]",Extremamente Elevado,,,,45,Alentejo,BEJA,0207,17208.72,4595,255,233,206,190,143,333,539,772,1027,26.7,5.97,4.49,3.13
03-03-2022,ELVAS,332,24,1617,"[960,Max]",Extremamente Elevado,,,,332,Alentejo,PORTALEGRE,1207,63128.86,20528,1057,1145,902,852,810,1662,2564,3709,4766,32.52,7.55,5.88,4.06
03-03-2022,ENTRONCAMENTO,311,22,1441,"[960,Max]",Extremamente Elevado,,,,311,Lisboa e Vale do Tejo,SANTARÉM,1410,1372.81,21558,1066,930,868,695,592,1287,2155,3085,4151,1570.14,302.33,224.69,156.96
03-03-2022,ESPINHO,299,21,1013,"[960,Max]",Extremamente Elevado,,,,299,Norte,AVEIRO,0107,2105.68,29516,2205,1993,1430,1177,960,2137,3567,5560,7765,1401.52,368.71,264.01,169.37
03-03-2022,ESPOSENDE,341,24,998,"[960,Max]",Extremamente Elevado,,,,341,Norte,BRAGA,0306,9540.98,34177,1831,1522,1095,894,723,1617,2712,4234,6065,358.21,63.57,44.38,28.42
03-03-2022,ESTARREJA,252,18,968,"[960,Max]",Extremamente Elevado,,,,252,Centro,AVEIRO,0108,10817.33,26006,1503,1399,1106,953,728,1681,2787,4186,5689,240.42,52.59,38.7,25.76
03-03-2022,ESTREMOZ,218,16,1714,"[960,Max]",Extremamente Elevado,,,,218,Alentejo,ÉVORA,0704,51379.95,12728,789,613,697,786,877,1663,2360,2973,3762,24.77,7.32,5.79,4.59
03-03-2022,ÉVORA,1327,95,2531,"[960,Max]",Extremamente Elevado,,,,1327,Alentejo,ÉVORA,0705,130707.58,52428,3569,2852,2176,1966,1803,3769,5945,8797,12366,40.11,9.46,6.73,4.55
03-03-2022,FAFE,198,14,413,"[240,480]",Elevado,,,,198,Norte,BRAGA,0307,21908.11,48060,3044,2455,1679,1403,1208,2611,4290,6745,9789,219.37,44.68,30.79,19.58
03-03-2022,FARO,1732,124,2839,"[960,Max]",Extremamente Elevado,,,,1732,Algarve,FARO,0805,20256.79,61015,3847,3364,2604,2055,1601,3656,6260,9624,13471,301.2,66.5,47.51,30.9
03-03-2022,FELGUEIRAS,231,17,410,"[240,480]",Elevado,,,,231,Norte,PORTO,1303,11573.75,56422,2951,2302,1601,1316,973,2289,3890,6192,9143,487.49,79.0,53.5,33.61
03-03-2022,FERREIRA DO ALENTEJO,145,10,1844,"[960,Max]",Extremamente Elevado,,,,145,Alentejo,BEJA,0208,64820.68,7845,515,414,372,343,345,688,1060,1474,1989,12.1,3.07,2.27,1.64
03-03-2022,FERREIRA DO ZÊZERE,179,13,2251,"[960,Max]",Extremamente Elevado,,,,179,Lisboa e Vale do Tejo,SANTARÉM,1411,19038.03,7959,470,370,416,465,456,921,1337,1707,2177,41.81,11.44,8.97,7.02
03-03-2022,FIGUEIRA DA FOZ,1136,81,1933,"[960,Max]",Extremamente Elevado,,,,1136,Centro,COIMBRA,0605,37905.26,58747,4032,3597,2887,2495,2043,4538,7425,11022,15054,154.98,39.72,29.08,19.59
03-03-2022,FIGUEIRA DE CASTELO RODRIGO,136,10,2434,"[960,Max]",Extremamente Elevado,,,,136,Centro,GUARDA,0904,50857.46,5584,347,352,290,352,391,743,1033,1385,1732,10.98,3.41,2.72,2.03
03-03-2022,FIGUEIRÓ DOS VINHOS,35,3,629,"[480,960]",Muito Elevado,,,,35,Centro,LEIRIA,1008,17344.0,5568,402,386,322,309,351,660,982,1368,1770,32.1,10.21,7.89,5.66
03-03-2022,FORNOS DE ALGODRES,70,5,1542,"[960,Max]",Extremamente Elevado,,,,70,Centro,GUARDA,0905,13145.05,4528,261,218,247,256,232,488,735,953,1214,34.45,9.24,7.25,5.59
03-03-2022,FREIXO DE ESPADA À CINTA,23,2,710,"[480,960]",Muito Elevado,,,,23,Norte,BRAGANÇA,0404,24414.29,3298,211,177,231,196,189,385,616,793,1004,13.51,4.11,3.25,2.52
03-03-2022,FRONTEIRA,82,6,2762,"[960,Max]",Extremamente Elevado,,,,82,Alentejo,PORTALEGRE,1208,24859.58,2974,213,182,149,156,168,324,473,655,868,11.96,3.49,2.63,1.9
03-03-2022,FUNCHAL,2987,213,2871,"[960,Max]",Extremamente Elevado,,,,2987,Madeira,MADEIRA,3103,7616.2,104024,6382,5086,3643,2821,1990,4811,8454,13540,19922,1365.86,261.58,177.78,111.0
03-03-2022,FUNDÃO,623,44,2350,"[960,Max]",Extremamente Elevado,,,,623,Centro,CASTELO BRANCO,0504,70019.79,26495,1781,1464,1432,1357,1643,3000,4432,5896,7677,37.84,10.96,8.42,6.33
03-03-2022,GAVIÃO,93,7,2859,"[960,Max]",Extremamente Elevado,,,,93,Alentejo,PORTALEGRE,1209,29459.45,3263,189,186,222,263,293,556,778,964,1153,11.08,3.91,3.27,2.64
03-03-2022,GÓIS,60,4,1590,"[960,Max]",Extremamente Elevado,,,,60,Centro,COIMBRA,0606,26330.19,3805,235,199,240,233,244,477,717,916,1151,14.45,4.37,3.48,2.72
03-03-2022,GOLEGÃ,91,6,1702,"[960,Max]",Extremamente Elevado,,,,91,Lisboa e Vale do Tejo,SANTARÉM,1412,8431.67,5339,356,299,281,243,255,498,779,1078,1434,63.32,17.01,12.78,9.24
03-03-2022,GONDOMAR,1763,126,1062,"[960,Max]",Extremamente Elevado,,,,1763,Norte,PORTO,1304,13191.76,165985,10555,8755,6222,4450,3364,7814,14036,22791,33346,1258.22,252.77,172.76,106.4
03-03-2022,GOUVEIA,222,16,1796,"[960,Max]",Extremamente Elevado,,,,222,Centro,GUARDA,0906,30061.17,12387,871,931,780,783,810,1593,2373,3304,4175,41.21,13.89,10.99,7.89
03-03-2022,GRÂNDOLA,155,11,1061,"[960,Max]",Extremamente Elevado,,,,155,Alentejo,SETÚBAL,1505,82593.66,14639,834,834,708,688,672,1360,2068,2902,3736,17.72,4.52,3.51,2.5
03-03-2022,GUARDA,769,55,1974,"[960,Max]",Extremamente Elevado,,,,769,Centro,GUARDA,0907,71209.58,38969,2477,2041,1686,1415,1474,2889,4575,6616,9093,54.72,12.77,9.29,6.42
03-03-2022,GUIMARÃES,777,55,510,"[480,960]",Muito Elevado,,,,777,Norte,BRAGA,0308,24099.96,152309,9394,7074,4809,3877,2948,6825,11634,18708,28102,631.99,116.61,77.63,48.27
03-03-2022,HORTA,1179,84,8122,"[960,Max]",Extremamente Elevado,,,,1179,Açores,AÇORES,4701,17305.53,14521,818,658,468,352,302,654,1122,1780,2598,83.91,15.01,10.29,6.48
03-03-2022,IDANHA-A-NOVA,210,15,2612,"[960,Max]",Extremamente Elevado,,,,210,Centro,CASTELO BRANCO,0505,141633.51,8043,518,490,519,672,974,1646,2165,2655,3173,5.68,2.24,1.87,1.53
03-03-2022,ÍLHAVO,443,32,1146,"[960,Max]",Extremamente Elevado,,,,443,Centro,AVEIRO,0110,7347.55,38699,2227,1943,1444,1193,850,2043,3487,5430,7657,526.66,104.21,73.9,47.46
03-03-2022,LAGOA (FARO),383,27,1684,"[960,Max]",Extremamente Elevado,,,,383,Algarve,FARO,0806,8825.45,22762,1314,1168,919,749,670,1419,2338,3506,4820,257.93,54.62,39.73,26.49
03-03-2022,LAGOA,375,27,2549,"[960,Max]",Extremamente Elevado,,,,375,Açores,AÇORES,4201,4559.32,14721,536,458,349,238,235,473,822,1280,1816,322.9,39.83,28.08,18.03
03-03-2022,LAGOS,500,36,1645,"[960,Max]",Extremamente Elevado,,,,500,Algarve,FARO,0807,21299.27,30374,1744,1434,1247,1053,1029,2082,3329,4763,6507,142.61,30.55,22.36,15.63
03-03-2022,LAJES DAS FLORES,47,3,3215,"[960,Max]",Extremamente Elevado,,,,47,Açores,AÇORES,4801,7004.79,1463,88,53,62,46,54,100,162,215,303,20.89,4.33,3.07,2.31
03-03-2022,LAJES DO PICO,253,18,5634,"[960,Max]",Extremamente Elevado,,,,253,Açores,AÇORES,4601,15531.09,4490,304,231,223,159,162,321,544,775,1079,28.91,6.95,4.99,3.5
03-03-2022,LAMEGO,264,19,1062,"[960,Max]",Extremamente Elevado,,,,264,Norte,VISEU,1805,16542.11,24895,1639,1284,1124,898,783,1681,2805,4089,5728,150.5,34.63,24.72,16.96
03-03-2022,LEIRIA,2850,204,2275,"[960,Max]",Extremamente Elevado,,,,2850,Centro,LEIRIA,1009,56508.83,125267,7389,6366,5090,3902,3159,7061,12151,18517,25906,221.68,45.84,32.77,21.5
03-03-2022,LISBOA,7699,550,1511,"[960,Max]",Extremamente Elevado,,,,7699,Lisboa e Vale do Tejo,LISBOA,1106,10005.43,509515,33197,33340,27706,23037,26770,49807,77513,110853,144050,5092.6,1439.78,1107.98,774.74
03-03-2022,LOULÉ,1458,104,2123,"[960,Max]",Extremamente Elevado,,,,1458,Algarve,FARO,0808,76366.91,68697,3890,3350,2780,2358,2251,4609,7389,10739,14629,89.96,19.16,14.06,9.68
03-03-2022,LOURES,2039,146,954,"[480,960]",Muito Elevado,,,,2039,Lisboa e Vale do Tejo,LISBOA,1107,16723.99,213687,12746,12794,9644,6669,5033,11702,21346,34140,46886,1277.73,280.35,204.14,127.64
03-03-2022,LOURINHÃ,503,36,1944,"[960,Max]",Extremamente Elevado,,,,503,Lisboa e Vale do Tejo,LISBOA,1108,14717.2,25855,1584,1243,992,842,645,1487,2479,3722,5306,175.68,36.05,25.29,16.84
03-03-2022,LOUSÃ,441,31,2570,"[960,Max]",Extremamente Elevado,,,,441,Centro,COIMBRA,0607,13840.01,17158,946,866,658,528,450,978,1636,2502,3448,123.97,24.91,18.08,11.82
03-03-2022,LOUSADA,185,13,395,"[240,480]",Elevado,,,,185,Norte,PORTO,1305,9608.01,46755,2289,1698,1176,853,621,1474,2650,4348,6637,486.63,69.08,45.25,27.58
03-03-2022,MAÇÃO,43,3,694,"[480,960]",Muito Elevado,,,,43,Lisboa e Vale do Tejo,SANTARÉM,1413,39997.98,6267,386,362,390,440,657,1097,1487,1849,2235,15.67,5.59,4.62,3.72
03-03-2022,MACEDO DE CAVALEIROS,119,8,818,"[480,960]",Muito Elevado,,,,119,Norte,BRAGANÇA,0405,69914.08,14516,1082,889,878,823,938,1761,2639,3528,4610,20.76,6.59,5.05,3.77
03-03-2022,MACHICO,563,40,2818,"[960,Max]",Extremamente Elevado,,,,563,Madeira,MADEIRA,3104,6825.1,19981,1197,860,662,455,331,786,1448,2308,3505,292.76,51.36,33.82,21.22
03-03-2022,MADALENA,255,18,4333,"[960,Max]",Extremamente Elevado,,,,255,Açores,AÇORES,4602,14712.33,5895,334,256,173,190,179,369,542,798,1132,40.07,7.69,5.42,3.68
03-03-2022,MAFRA,1230,88,1450,"[960,Max]",Extremamente Elevado,,,,1230,Lisboa e Vale do Tejo,LISBOA,1109,29165.5,84816,3613,3334,2839,2089,1899,3988,6827,10161,13774,290.81,47.23,34.84,23.41
03-03-2022,MAIA,1613,115,1161,"[960,Max]",Extremamente Elevado,,,,1613,Norte,PORTO,1306,8293.94,138971,7801,6617,4512,3339,2631,5970,10482,17099,24900,1675.56,300.22,206.16,126.38
03-03-2022,MANGUALDE,214,15,1154,"[960,Max]",Extremamente Elevado,,,,214,Centro,VISEU,1806,21925.56,18510,1198,1128,885,852,743,1595,2480,3608,4806,84.42,21.92,16.46,11.31
03-03-2022,MANTEIGAS,78,6,2579,"[960,Max]",Extremamente Elevado,,,,78,Centro,GUARDA,0908,12197.55,3007,258,197,159,167,146,313,472,669,927,24.65,7.6,5.48,3.87
03-03-2022,MARCO DE CANAVESES,662,47,1286,"[960,Max]",Extremamente Elevado,,,,662,Norte,PORTO,1307,20188.98,51496,2678,2060,1488,1265,1023,2288,3776,5836,8514,255.07,42.17,28.91,18.7
03-03-2022,MARINHA GRANDE,937,67,2434,"[960,Max]",Extremamente Elevado,,,,937,Centro,LEIRIA,1010,18725.19,38508,2365,2302,1638,1359,1058,2417,4055,6357,8722,205.65,46.58,33.95,21.66
03-03-2022,MARVÃO,41,3,1361,"[960,Max]",Extremamente Elevado,,,,41,Alentejo,PORTALEGRE,1210,15489.9,3005,198,185,142,197,237,434,576,761,959,19.4,6.19,4.91,3.72
03-03-2022,MATOSINHOS,1938,138,1105,"[960,Max]",Extremamente Elevado,,,,1938,Norte,PORTO,1308,6241.97,175357,11850,9977,7023,5024,3884,8908,15931,25908,37758,2809.31,604.9,415.06,255.22
03-03-2022,MEALHADA,370,26,1859,"[960,Max]",Extremamente Elevado,,,,370,Centro,AVEIRO,0111,11065.66,19914,1163,1039,810,828,831,1659,2469,3508,4671,179.96,42.21,31.7,22.31
03-03-2022,MÊDA,29,2,634,"[480,960]",Muito Elevado,,,,29,Centro,GUARDA,0909,28604.92,4587,343,306,290,288,443,731,1021,1327,1670,16.04,5.84,4.64,3.57
03-03-2022,MELGAÇO,58,4,713,"[480,960]",Muito Elevado,,,,58,Norte,VIANA DO CASTELO,1603,23824.58,8093,507,567,578,614,675,1289,1867,2434,2941,33.97,12.34,10.22,7.84
03-03-2022,MÉRTOLA,57,4,926,"[480,960]",Muito Elevado,,,,57,Alentejo,BEJA,0209,129287.34,6142,400,390,378,423,600,1023,1401,1791,2191,4.75,1.69,1.39,1.08
03-03-2022,MESÃO FRIO,22,2,559,"[480,960]",Muito Elevado,,,,22,Norte,VILA REAL,1704,2664.87,3964,265,205,168,157,120,277,445,650,915,148.74,34.33,24.39,16.7
03-03-2022,MIRA,117,8,985,"[960,Max]",Extremamente Elevado,,,,117,Centro,COIMBRA,0608,12403.38,11832,727,729,659,550,466,1016,1675,2404,3131,95.4,25.24,19.38,13.5
03-03-2022,MIRANDA DO CORVO,205,15,1613,"[960,Max]",Extremamente Elevado,,,,205,Centro,COIMBRA,0609,12637.79,12708,706,659,568,498,404,902,1470,2129,2835,100.55,22.43,16.85,11.63
03-03-2022,MIRANDA DO DOURO,26,2,384,"[240,480]",Elevado,,,,26,Norte,BRAGANÇA,0406,48718.31,6830,482,429,442,463,470,933,1375,1804,2286,14.02,4.69,3.7,2.82
03-03-2022,MIRANDELA,257,18,1181,"[960,Max]",Extremamente Elevado,,,,257,Norte,BRAGANÇA,0407,65895.67,21754,1640,1315,1204,1078,947,2025,3229,4544,6184,33.01,9.38,6.9,4.9
03-03-2022,MOGADOURO,69,5,821,"[480,960]",Muito Elevado,,,,69,Norte,BRAGANÇA,0408,76064.93,8392,589,529,576,630,655,1285,1861,2390,2979,11.03,3.92,3.14,2.45
03-03-2022,MOIMENTA DA BEIRA,54,4,556,"[480,960]",Muito Elevado,,,,54,Norte,VISEU,1807,21996.9,9736,576,514,471,416,461,877,1348,1862,2438,44.26,11.08,8.46,6.13
03-03-2022,MOITA,519,37,806,"[480,960]",Muito Elevado,,,,519,Lisboa e Vale do Tejo,SETÚBAL,1506,5525.98,64407,4226,3646,2623,1801,1425,3226,5849,9495,13721,1165.53,248.3,171.82,105.85
03-03-2022,MONÇÃO,132,9,739,"[480,960]",Muito Elevado,,,,132,Norte,VIANA DO CASTELO,1604,21130.85,17869,1161,1105,1031,1006,972,1978,3009,4114,5275,84.56,24.96,19.47,14.24
03-03-2022,MONCHIQUE,82,6,1607,"[960,Max]",Extremamente Elevado,,,,82,Algarve,FARO,0809,39530.43,5077,353,384,321,355,392,747,1068,1452,1805,12.84,4.57,3.67,2.7
03-03-2022,MONDIM DE BASTO,43,3,625,"[480,960]",Muito Elevado,,,,43,Norte,VILA REAL,1705,17207.52,6946,395,300,314,284,283,567,881,1181,1576,40.36,9.16,6.86,5.12
03-03-2022,MONFORTE,31,2,1052,"[960,Max]",Extremamente Elevado,,,,31,Alentejo,PORTALEGRE,1211,42024.82,2975,139,115,117,192,168,360,477,592,731,7.08,1.74,1.41,1.14
03-03-2022,MONTALEGRE,40,3,450,"[240,480]",Elevado,,,,40,Norte,VILA REAL,1706,80545.71,8997,699,628,595,603,730,1333,1928,2556,3255,11.17,4.04,3.17,2.39
03-03-2022,MONTEMOR-O-NOVO,215,15,1373,"[960,Max]",Extremamente Elevado,,,,215,Alentejo,ÉVORA,0706,123296.65,15647,991,953,868,878,971,1849,2717,3670,4661,12.69,3.78,2.98,2.2
03-03-2022,MONTEMOR-O-VELHO,508,36,2012,"[960,Max]",Extremamente Elevado,,,,508,Centro,COIMBRA,0610,22896.23,25224,1496,1397,1217,1057,988,2045,3262,4659,6155,110.17,26.88,20.35,14.25
03-03-2022,MONTIJO,872,62,1513,"[960,Max]",Extremamente Elevado,,,,872,Lisboa e Vale do Tejo,SETÚBAL,1507,34861.64,57614,2771,2441,1990,1554,1109,2663,4653,7094,9865,165.26,28.3,20.35,13.35
03-03-2022,MORA,62,4,1487,"[960,Max]",Extremamente Elevado,,,,62,Alentejo,ÉVORA,0707,44395.02,4138,336,275,252,238,257,495,747,1022,1358,9.32,3.06,2.3,1.68
03-03-2022,MORTÁGUA,226,16,2564,"[960,Max]",Extremamente Elevado,,,,226,Centro,VISEU,1808,25117.82,8803,638,584,535,499,460,959,1494,2078,2716,35.05,10.81,8.27,5.95
03-03-2022,MOURA,214,15,1558,"[960,Max]",Extremamente Elevado,,,,214,Alentejo,BEJA,0210,95845.55,13718,817,656,665,542,461,1003,1668,2324,3141,14.31,3.28,2.42,1.74
03-03-2022,MOURÃO,128,9,5220,"[960,Max]",Extremamente Elevado,,,,128,Alentejo,ÉVORA,0708,27862.98,2450,139,108,80,104,109,213,293,401,540,8.79,1.94,1.44,1.05
03-03-2022,MURÇA,33,2,611,"[480,960]",Muito Elevado,,,,33,Norte,VILA REAL,1707,18937.11,5463,384,341,307,306,319,625,932,1273,1657,28.85,8.75,6.72,4.92
03-03-2022,MURTOSA,86,6,836,"[480,960]",Muito Elevado,,,,86,Centro,AVEIRO,0112,7308.78,10279,509,473,403,353,409,762,1165,1638,2147,140.63,29.37,22.41,15.94
03-03-2022,NAZARÉ,204,15,1437,"[960,Max]",Extremamente Elevado,,,,204,Lisboa e Vale do Tejo,LEIRIA,1011,8243.43,14165,967,903,670,420,396,816,1486,2389,3356,171.84,40.71,28.98,18.03
03-03-2022,NELAS,242,17,1864,"[960,Max]",Extremamente Elevado,,,,242,Centro,VISEU,1809,12571.48,12974,924,787,668,604,583,1187,1855,2642,3566,103.21,28.37,21.02,14.76
03-03-2022,NISA,69,5,1141,"[960,Max]",Extremamente Elevado,,,,69,Alentejo,PORTALEGRE,1212,57567.84,6061,405,389,355,483,478,961,1316,1705,2110,10.53,3.67,2.96,2.29
03-03-2022,NORDESTE,96,7,1971,"[960,Max]",Extremamente Elevado,,,,96,Açores,AÇORES,4202,10146.8,4862,246,180,124,161,162,323,447,627,873,47.92,8.6,6.18,4.41
03-03-2022,ÓBIDOS,197,14,1664,"[960,Max]",Extremamente Elevado,,,,197,Lisboa e Vale do Tejo,LEIRIA,1012,14155.44,11850,743,650,574,452,436,888,1462,2112,2855,83.72,20.17,14.92,10.33
03-03-2022,ODEMIRA,719,51,2908,"[960,Max]",Extremamente Elevado,,,,719,Alentejo,BEJA,0211,172060.15,24717,1475,1317,1225,1397,1349,2746,3971,5288,6763,14.37,3.93,3.07,2.31
03-03-2022,ODIVELAS,1707,122,1055,"[960,Max]",Extremamente Elevado,,,,1707,Lisboa e Vale do Tejo,LISBOA,1116,2654.36,161774,9562,9038,6952,4641,3812,8453,15405,24443,34005,6095.48,1281.27,920.99,580.44
03-03-2022,OEIRAS,2191,156,1235,"[960,Max]",Extremamente Elevado,,,,2191,Lisboa e Vale do Tejo,LISBOA,1110,4588.31,177408,11580,11575,8566,6211,5855,12066,20632,32207,43787,3866.78,954.38,701.98,449.69
03-03-2022,OLEIROS,82,6,1637,"[960,Max]",Extremamente Elevado,,,,82,Centro,CASTELO BRANCO,0506,47109.31,5003,384,341,366,397,487,884,1250,1591,1975,10.62,4.19,3.38,2.65
03-03-2022,OLHÃO,959,68,2159,"[960,Max]",Extremamente Elevado,,,,959,Algarve,FARO,0810,13086.38,44405,2455,2309,1689,1342,1268,2610,4299,6608,9063,339.33,69.26,50.5,32.85
03-03-2022,OLIVEIRA DE AZEMÉIS,638,46,967,"[960,Max]",Extremamente Elevado,,,,638,Norte,AVEIRO,0113,16110.41,66011,4155,3614,2794,2183,1738,3921,6715,10329,14484,409.75,89.91,64.12,41.68
03-03-2022,OLIVEIRA DE FRADES,96,7,971,"[960,Max]",Extremamente Elevado,,,,96,Centro,VISEU,1810,14534.62,9936,553,475,438,359,415,774,1212,1687,2240,68.36,15.41,11.61,8.34
03-03-2022,OLIVEIRA DO BAIRRO,236,17,971,"[960,Max]",Extremamente Elevado,,,,236,Centro,AVEIRO,0114,8731.99,24277,1327,1182,999,786,810,1596,2595,3777,5104,278.02,58.45,43.25,29.72
03-03-2022,OLIVEIRA DO HOSPITAL,303,22,1574,"[960,Max]",Extremamente Elevado,,,,303,Centro,COIMBRA,0611,23451.66,19253,1161,1097,962,924,960,1884,2846,3943,5104,82.1,21.76,16.81,12.14
03-03-2022,OURÉM,615,44,1397,"[960,Max]",Extremamente Elevado,,,,615,Lisboa e Vale do Tejo,SANTARÉM,1421,41668.03,44044,2463,2069,1899,1817,1603,3420,5319,7388,9851,105.7,23.64,17.73,12.77
03-03-2022,OURIQUE,98,7,2134,"[960,Max]",Extremamente Elevado,,,,98,Alentejo,BEJA,0212,66331.36,4607,313,287,284,268,227,495,779,1066,1379,6.95,2.08,1.61,1.17
03-03-2022,OVAR,465,33,857,"[480,960]",Muito Elevado,,,,465,Centro,AVEIRO,0115,14770.25,54260,3294,2709,1994,1636,1234,2870,4864,7573,10867,367.37,73.57,51.27,32.93
03-03-2022,PAÇOS DE FERREIRA,201,14,354,"[240,480]",Elevado,,,,201,Norte,PORTO,1309,7099.29,56728,2903,2193,1518,1135,664,1799,3317,5510,8413,799.1,118.51,77.62,46.72
03-03-2022,PALMELA,825,59,1283,"[960,Max]",Extremamente Elevado,,,,825,Lisboa e Vale do Tejo,SETÚBAL,1508,46512.01,64269,3402,3244,2635,1846,1391,3237,5872,9116,12518,138.18,26.91,19.6,12.62
03-03-2022,PAMPILHOSA DA SERRA,50,4,1240,"[960,Max]",Extremamente Elevado,,,,50,Centro,COIMBRA,0612,39646.24,4037,238,254,295,339,423,762,1057,1311,1549,10.18,3.91,3.31,2.67
03-03-2022,PAREDES,485,35,564,"[480,960]",Muito Elevado,,,,485,Norte,PORTO,1310,15675.69,86067,4272,3532,2412,1717,1258,2975,5387,8919,13191,549.04,84.15,56.9,34.36
03-03-2022,PAREDES DE COURA,86,6,1003,"[960,Max]",Extremamente Elevado,,,,86,Norte,VIANA DO CASTELO,1605,13818.59,8535,466,528,407,465,515,980,1387,1915,2381,61.76,17.23,13.86,10.04
03-03-2022,PEDRÓGÃO GRANDE,117,8,3426,"[960,Max]",Extremamente Elevado,,,,117,Centro,LEIRIA,1013,12874.75,3410,175,173,196,221,252,473,669,842,1017,26.49,7.9,6.54,5.2
03-03-2022,PENACOVA,371,27,2712,"[960,Max]",Extremamente Elevado,,,,371,Centro,COIMBRA,0613,21673.23,13694,968,923,745,621,703,1324,2069,2992,3960,63.18,18.27,13.81,9.55
03-03-2022,PENAFIEL,597,43,856,"[480,960]",Muito Elevado,,,,597,Norte,PORTO,1311,21224.27,69772,3648,2823,2032,1663,1230,2893,4925,7748,11396,328.74,53.69,36.51,23.2
03-03-2022,PENALVA DO CASTELO,96,7,1344,"[960,Max]",Extremamente Elevado,,,,96,Centro,VISEU,1811,13433.92,7115,449,457,413,391,426,817,1230,1687,2136,52.96,15.9,12.56,9.16
03-03-2022,PENAMACOR,57,4,1207,"[960,Max]",Extremamente Elevado,,,,57,Centro,CASTELO BRANCO,0507,56370.69,4755,262,248,273,451,633,1084,1357,1605,1867,8.44,3.31,2.85,2.41
03-03-2022,PENEDONO,6,0,233,"[120,240]",Moderado,,,,6,Norte,VISEU,1812,13370.75,2591,172,113,129,156,138,294,423,536,708,19.38,5.3,4.01,3.16
03-03-2022,PENELA,137,10,2543,"[960,Max]",Extremamente Elevado,,,,137,Centro,COIMBRA,0614,13480.0,5397,314,324,274,359,344,703,977,1301,1615,40.04,11.98,9.65,7.25
03-03-2022,PENICHE,355,25,1340,"[960,Max]",Extremamente Elevado,,,,355,Lisboa e Vale do Tejo,LEIRIA,1014,7754.98,26501,1746,1504,1203,926,707,1633,2836,4340,6086,341.73,78.48,55.96,36.57
03-03-2022,PESO DA RÉGUA,210,15,1332,"[960,Max]",Extremamente Elevado,,,,210,Norte,VILA REAL,1708,9486.01,15773,1076,843,650,659,455,1114,1764,2607,3683,166.28,38.83,27.48,18.6
03-03-2022,PINHEL,130,9,1530,"[960,Max]",Extremamente Elevado,,,,130,Centro,GUARDA,0910,48452.12,8511,577,566,551,538,689,1227,1778,2344,2921,17.57,6.03,4.84,3.67
03-03-2022,POMBAL,1010,72,1963,"[960,Max]",Extremamente Elevado,,,,1010,Centro,LEIRIA,1015,62600.28,51461,3187,2791,2494,2328,2027,4355,6849,9640,12827,82.21,20.49,15.4,10.94
03-03-2022,PONTA DELGADA,2236,160,3291,"[960,Max]",Extremamente Elevado,,,,2236,Açores,AÇORES,4203,23298.65,67935,3108,2435,1726,1133,902,2035,3761,6196,9304,291.58,39.93,26.59,16.14
03-03-2022,PONTA DO SOL,146,10,1695,"[960,Max]",Extremamente Elevado,,,,146,Madeira,MADEIRA,3105,4622.03,8593,319,283,347,208,221,429,776,1059,1378,185.92,29.81,22.91,16.79
03-03-2022,PONTE DA BARCA,94,7,838,"[480,960]",Muito Elevado,,,,94,Norte,VIANA DO CASTELO,1606,18211.37,11180,635,576,517,554,490,1044,1561,2137,2772,61.39,15.22,11.73,8.57
03-03-2022,PONTE DE LIMA,400,29,967,"[960,Max]",Extremamente Elevado,,,,400,Norte,VIANA DO CASTELO,1607,32025.46,41315,2321,2022,1720,1596,1462,3058,4778,6800,9121,129.01,28.48,21.23,14.92
03-03-2022,PONTE DE SOR,270,19,1799,"[960,Max]",Extremamente Elevado,,,,270,Alentejo,PORTALEGRE,1213,83971.16,14994,939,800,716,739,831,1570,2286,3086,4025,17.86,4.79,3.68,2.72
03-03-2022,PORTALEGRE,643,46,2902,"[960,Max]",Extremamente Elevado,,,,643,Alentejo,PORTALEGRE,1214,44713.64,22172,1577,1351,1137,993,984,1977,3114,4465,6042,49.59,13.51,9.99,6.96
03-03-2022,PORTEL,94,7,1610,"[960,Max]",Extremamente Elevado,,,,94,Alentejo,ÉVORA,0709,60100.57,5828,336,358,283,331,305,636,919,1277,1613,9.7,2.68,2.12,1.53
03-03-2022,PORTIMÃO,998,71,1799,"[960,Max]",Extremamente Elevado,,,,998,Algarve,FARO,0811,18206.29,55483,3182,2927,2116,1582,1400,2982,5098,8025,11207,304.75,61.56,44.08,28.0
03-03-2022,PORTO,2792,199,1289,"[960,Max]",Extremamente Elevado,,,,2792,Norte,PORTO,1312,4142.02,216606,15790,15193,11280,9409,10044,19453,30733,45926,61716,5229.5,1490.0,1108.79,741.98
03-03-2022,PORTO DE MÓS,410,29,1762,"[960,Max]",Extremamente Elevado,,,,410,Centro,LEIRIA,1016,26183.41,23275,1355,1210,1034,888,872,1760,2794,4004,5359,88.89,20.47,15.29,10.67
03-03-2022,PORTO MONIZ,48,3,2033,"[960,Max]",Extremamente Elevado,,,,48,Madeira,MADEIRA,3106,8293.38,2342,143,130,95,98,120,218,313,443,586,28.24,7.07,5.34,3.77
03-03-2022,PORTO SANTO,408,29,7851,"[960,Max]",Extremamente Elevado,,,,408,Madeira,MADEIRA,3201,4300.7,5202,240,157,134,110,68,178,312,469,709,120.95,16.48,10.9,7.25
03-03-2022,PÓVOA DE LANHOSO,117,8,545,"[480,960]",Muito Elevado,,,,117,Norte,BRAGA,0309,13465.29,21499,1175,909,732,673,624,1297,2029,2938,4113,159.67,30.55,21.82,15.07
03-03-2022,PÓVOA DE VARZIM,540,39,860,"[480,960]",Muito Elevado,,,,540,Norte,PORTO,1313,8220.59,62784,3712,3120,2134,1594,1305,2899,5033,8153,11865,763.7,144.33,99.17,61.22
03-03-2022,POVOAÇÃO,146,10,2459,"[960,Max]",Extremamente Elevado,,,,146,Açores,AÇORES,4204,10640.77,5927,293,212,191,144,134,278,469,681,974,55.7,9.15,6.4,4.41
03-03-2022,VILA DA PRAIA DA VITÓRIA,692,49,3246,"[960,Max]",Extremamente Elevado,,,,692,Açores,AÇORES,4302,16127.06,21317,1133,789,619,436,336,772,1391,2180,3313,132.18,20.54,13.52,8.63
03-03-2022,PROENÇA-A-NOVA,81,6,1105,"[960,Max]",Extremamente Elevado,,,,81,Centro,CASTELO BRANCO,0508,39539.96,7298,508,465,389,400,560,960,1349,1814,2322,18.46,5.87,4.59,3.41
03-03-2022,REDONDO,186,13,2928,"[960,Max]",Extremamente Elevado,,,,186,Alentejo,ÉVORA,0710,36950.87,6353,349,325,288,288,354,642,930,1255,1604,17.19,4.34,3.4,2.52
03-03-2022,REGUENGOS DE MONSARAZ,156,11,1561,"[960,Max]",Extremamente Elevado,,,,156,Alentejo,ÉVORA,0711,46399.72,10015,602,511,455,462,473,935,1390,1901,2503,21.58,5.39,4.1,3.0
03-03-2022,RESENDE,33,2,329,"[240,480]",Elevado,,,,33,Norte,VISEU,1813,12334.93,10137,560,493,448,433,422,855,1303,1796,2356,82.18,19.1,14.56,10.56
03-03-2022,RIBEIRA BRAVA,268,19,2153,"[960,Max]",Extremamente Elevado,,,,268,Madeira,MADEIRA,3107,6544.88,12435,648,500,411,311,287,598,1009,1509,2157,189.99,32.96,23.06,15.42
03-03-2022,RIBEIRA DE PENA,22,2,367,"[240,480]",Elevado,,,,22,Norte,VILA REAL,1709,21745.98,6016,371,301,290,310,368,678,968,1269,1640,27.66,7.54,5.84,4.45
03-03-2022,RIBEIRA GRANDE,699,50,2130,"[960,Max]",Extremamente Elevado,,,,699,Açores,AÇORES,4205,18015.13,32811,1163,689,512,345,253,598,1110,1799,2962,182.13,16.44,9.99,6.16
03-03-2022,RIO MAIOR,440,31,2159,"[960,Max]",Extremamente Elevado,,,,440,Lisboa e Vale do Tejo,SANTARÉM,1414,27276.45,20379,1251,1144,941,795,648,1443,2384,3528,4779,74.71,17.52,12.93,8.74
03-03-2022,SABROSA,76,5,1292,"[960,Max]",Extremamente Elevado,,,,76,Norte,VILA REAL,1710,15692.45,5918,393,314,304,302,350,652,956,1270,1663,37.71,10.6,8.09,6.09
03-03-2022,SABUGAL,513,37,4846,"[960,Max]",Extremamente Elevado,,,,513,Centro,GUARDA,0911,82269.82,10585,724,707,694,796,1009,1805,2499,3206,3930,12.87,4.78,3.9,3.04
03-03-2022,SALVATERRA DE MAGOS,562,40,2639,"[960,Max]",Extremamente Elevado,,,,562,Lisboa e Vale do Tejo,SANTARÉM,1415,24393.2,21295,1275,1181,1060,799,772,1571,2631,3812,5087,87.3,20.85,15.63,10.79
03-03-2022,SANTA COMBA DÃO,176,13,1685,"[960,Max]",Extremamente Elevado,,,,176,Centro,VISEU,1814,11194.77,10452,732,684,569,538,464,1002,1571,2255,2987,93.36,26.68,20.14,14.03
03-03-2022,SANTA CRUZ,1248,89,2756,"[960,Max]",Extremamente Elevado,,,,1248,Madeira,MADEIRA,3108,8150.28,45281,1817,1301,974,716,523,1239,2213,3514,5331,555.6,65.41,43.12,27.15
03-03-2022,SANTA CRUZ DA GRACIOSA,327,23,7777,"[960,Max]",Extremamente Elevado,,,,327,Açores,AÇORES,4401,6065.78,4208,228,180,163,124,145,269,432,612,840,69.37,13.85,10.09,7.12
03-03-2022,SANTA CRUZ DAS FLORES,47,3,2171,"[960,Max]",Extremamente Elevado,,,,47,Açores,AÇORES,4802,7091.44,2165,125,98,74,56,51,107,181,279,404,30.53,5.7,3.93,2.55
03-03-2022,SANTA MARIA DA FEIRA,1108,79,799,"[480,960]",Muito Elevado,,,,1108,Norte,AVEIRO,0109,21587.65,138636,8182,6743,4771,3856,3079,6935,11706,18449,26631,642.19,123.36,85.46,54.22
03-03-2022,SANTA MARTA DE PENAGUIÃO,57,4,869,"[480,960]",Muito Elevado,,,,57,Norte,VILA REAL,1711,6928.13,6599,483,373,337,316,317,633,970,1343,1826,95.25,26.36,19.39,14.0
03-03-2022,SANTANA,120,9,1790,"[960,Max]",Extremamente Elevado,,,,120,Madeira,MADEIRA,3109,9547.3,6711,418,353,343,282,277,559,902,1255,1673,70.29,17.52,13.15,9.45
03-03-2022,SANTARÉM,1372,98,2389,"[960,Max]",Extremamente Elevado,,,,1372,Lisboa e Vale do Tejo,SANTARÉM,1416,55253.58,57421,3654,3441,2760,2466,2206,4672,7432,10873,14527,103.92,26.29,19.68,13.45
03-03-2022,SANTIAGO DO CACÉM,490,35,1701,"[960,Max]",Extremamente Elevado,,,,490,Alentejo,SETÚBAL,1509,105969.29,28791,2144,1689,1472,1295,1215,2510,3982,5671,7815,27.17,7.37,5.35,3.76
03-03-2022,SANTO TIRSO,511,37,751,"[480,960]",Muito Elevado,,,,511,Norte,PORTO,1314,13655.52,68055,4911,3935,2761,2257,1810,4067,6828,10763,15674,498.35,114.78,78.82,50.0
03-03-2022,SÃO BRÁS DE ALPORTEL,243,17,2333,"[960,Max]",Extremamente Elevado,,,,243,Algarve,FARO,0812,15336.92,10416,596,468,467,404,401,805,1272,1740,2336,67.91,15.23,11.35,8.29
03-03-2022,SÃO JOÃO DA MADEIRA,231,16,1052,"[960,Max]",Extremamente Elevado,,,,231,Norte,AVEIRO,0116,794.3,21958,1347,1069,796,601,593,1194,1990,3059,4406,2765.49,554.91,385.26,250.63
03-03-2022,SÃO JOÃO DA PESQUEIRA,51,4,722,"[480,960]",Muito Elevado,,,,51,Norte,VISEU,1815,26610.85,7125,417,330,294,328,328,656,950,1280,1697,26.77,6.38,4.81,3.57
03-03-2022,SÃO PEDRO DO SUL,263,19,1705,"[960,Max]",Extremamente Elevado,,,,263,Centro,VISEU,1816,34895.09,15403,990,962,861,759,909,1668,2529,3491,4481,44.14,12.84,10.0,7.25
03-03-2022,SÃO ROQUE DO PICO,100,7,3052,"[960,Max]",Extremamente Elevado,,,,100,Açores,AÇORES,4603,14236.1,3266,199,141,93,96,113,209,302,443,642,22.94,4.51,3.11,2.12
03-03-2022,SÃO VICENTE,71,5,1389,"[960,Max]",Extremamente Elevado,,,,71,Madeira,MADEIRA,3110,7883.71,5143,272,264,266,225,280,505,771,1035,1307,65.23,16.58,13.13,9.78
03-03-2022,SARDOAL,77,5,2045,"[960,Max]",Extremamente Elevado,,,,77,Lisboa e Vale do Tejo,SANTARÉM,1417,9214.72,3741,227,178,148,165,248,413,561,739,966,40.6,10.48,8.02,6.09
03-03-2022,SÁTÃO,121,9,1049,"[960,Max]",Extremamente Elevado,,,,121,Centro,VISEU,1817,20194.11,11580,765,671,515,465,476,941,1456,2127,2892,57.34,14.32,10.53,7.21
03-03-2022,SEIA,333,24,1498,"[960,Max]",Extremamente Elevado,,,,333,Centro,GUARDA,0912,43568.83,22234,1807,1589,1238,1122,721,1843,3081,4670,6477,51.03,14.87,10.72,7.07
03-03-2022,SEIXAL,1731,124,1032,"[960,Max]",Extremamente Elevado,,,,1731,Lisboa e Vale do Tejo,SETÚBAL,1510,9545.17,167752,10586,9270,6661,4391,2930,7321,13982,23252,33838,1757.49,354.51,243.6,146.49
03-03-2022,SERNANCELHE,58,4,1079,"[960,Max]",Extremamente Elevado,,,,58,Norte,VISEU,1818,22861.22,5396,305,293,286,273,260,533,819,1112,1417,23.6,6.2,4.86,3.58
03-03-2022,SERPA,145,10,1016,"[960,Max]",Extremamente Elevado,,,,145,Alentejo,BEJA,0213,110563.34,14304,903,761,719,697,626,1323,2042,2803,3706,12.94,3.35,2.54,1.85
03-03-2022,SERTÃ,277,20,1902,"[960,Max]",Extremamente Elevado,,,,277,Centro,CASTELO BRANCO,0509,44673.17,14577,870,779,790,767,1020,1787,2577,3356,4226,32.63,9.46,7.51,5.77
03-03-2022,SESIMBRA,841,60,1621,"[960,Max]",Extremamente Elevado,,,,841,Lisboa e Vale do Tejo,SETÚBAL,1511,19571.75,51858,2400,2321,1853,1257,1083,2340,4193,6514,8914,264.96,45.54,33.28,21.42
03-03-2022,SETÚBAL,1495,107,1299,"[960,Max]",Extremamente Elevado,,,,1495,Lisboa e Vale do Tejo,SETÚBAL,1512,23032.5,115126,7425,6929,5075,3775,2655,6430,11505,18434,25859,499.83,112.27,80.03,49.95
03-03-2022,SEVER DO VOUGA,188,13,1656,"[960,Max]",Extremamente Elevado,,,,188,Centro,AVEIRO,0117,12987.56,11331,766,637,568,540,567,1107,1675,2312,3078,87.24,23.7,17.8,12.9
03-03-2022,SILVES,701,50,1935,"[960,Max]",Extremamente Elevado,,,,701,Algarve,FARO,0813,68006.23,36226,2137,1869,1610,1423,1600,3023,4633,6502,8639,53.27,12.7,9.56,6.81
03-03-2022,SINES,202,14,1474,"[960,Max]",Extremamente Elevado,,,,202,Alentejo,SETÚBAL,1513,20330.17,13715,888,791,551,416,268,684,1235,2026,2914,67.46,14.33,9.97,6.07
03-03-2022,SINTRA,3507,250,896,"[480,960]",Muito Elevado,,,,3507,Lisboa e Vale do Tejo,LISBOA,1111,31922.73,391402,20490,18316,13545,9137,7284,16421,29966,48282,68772,1226.08,215.43,151.25,93.87
03-03-2022,SOBRAL DE MONTE AGRAÇO,145,10,1366,"[960,Max]",Extremamente Elevado,,,,145,Lisboa e Vale do Tejo,LISBOA,1112,5210.32,10651,564,507,352,272,212,484,836,1343,1907,204.43,36.6,25.78,16.05
03-03-2022,SOURE,352,25,2058,"[960,Max]",Extremamente Elevado,,,,352,Centro,COIMBRA,0615,26506.07,17120,1173,1142,1004,883,987,1870,2874,4016,5189,64.59,19.58,15.15,10.84
03-03-2022,SOUSEL,122,9,2773,"[960,Max]",Extremamente Elevado,,,,122,Alentejo,PORTALEGRE,1215,27932.18,4412,261,274,208,302,292,594,802,1076,1337,15.8,4.79,3.85,2.87
03-03-2022,TÁBUA,130,9,1147,"[960,Max]",Extremamente Elevado,,,,130,Centro,COIMBRA,0616,19978.58,11368,729,584,524,430,464,894,1418,2002,2731,56.9,13.67,10.02,7.1
03-03-2022,TABUAÇO,33,2,548,"[480,960]",Muito Elevado,,,,33,Norte,VISEU,1819,13385.67,6033,372,314,217,282,363,645,862,1176,1548,45.07,11.56,8.79,6.44
03-03-2022,TAROUCA,92,7,1176,"[960,Max]",Extremamente Elevado,,,,92,Norte,VISEU,1820,10008.49,7804,405,335,313,277,324,601,914,1249,1654,77.98,16.53,12.48,9.13
03-03-2022,TAVIRA,562,40,2293,"[960,Max]",Extremamente Elevado,,,,562,Algarve,FARO,0814,60696.7,24530,1493,1415,1252,1066,1277,2343,3595,5010,6503,40.41,10.71,8.25,5.92
03-03-2022,TERRAS DE BOURO,47,3,744,"[480,960]",Muito Elevado,,,,47,Norte,BRAGA,0310,27746.07,6361,391,372,296,319,340,659,955,1327,1718,22.93,6.19,4.78,3.44
03-03-2022,TOMAR,563,40,1531,"[960,Max]",Extremamente Elevado,,,,563,Lisboa e Vale do Tejo,SANTARÉM,1418,35120.44,36748,2403,2189,1868,1853,1822,3675,5543,7732,10135,104.64,28.86,22.02,15.78
03-03-2022,TONDELA,591,42,2242,"[960,Max]",Extremamente Elevado,,,,591,Centro,VISEU,1821,37121.73,26357,1768,1722,1518,1475,1417,2892,4410,6132,7900,71.0,21.28,16.52,11.88
03-03-2022,TORRE DE MONCORVO,91,7,1183,"[960,Max]",Extremamente Elevado,,,,91,Norte,BRAGANÇA,0409,53155.67,7695,556,478,488,551,719,1270,1758,2236,2792,14.48,5.25,4.21,3.31
03-03-2022,TORRES NOVAS,544,39,1558,"[960,Max]",Extremamente Elevado,,,,544,Lisboa e Vale do Tejo,SANTARÉM,1419,26999.68,34933,2324,1979,1738,1406,1475,2881,4619,6598,8922,129.38,33.04,24.44,17.11
03-03-2022,TORRES VEDRAS,1792,128,2282,"[960,Max]",Extremamente Elevado,,,,1792,Lisboa e Vale do Tejo,LISBOA,1113,40714.89,78530,4513,3945,3447,2628,2104,4732,8179,12124,16637,192.88,40.86,29.78,20.09
03-03-2022,TRANCOSO,118,8,1326,"[960,Max]",Extremamente Elevado,,,,118,Centro,GUARDA,0913,36152.47,8875,581,557,542,586,496,1082,1624,2181,2762,24.55,7.64,6.03,4.49
03-03-2022,TROFA,335,24,871,"[480,960]",Muito Elevado,,,,335,Norte,PORTO,1318,7201.76,38418,2336,1894,1231,939,684,1623,2854,4748,7084,533.44,98.36,65.93,39.63
03-03-2022,VAGOS,308,22,1353,"[960,Max]",Extremamente Elevado,,,,308,Centro,AVEIRO,0118,16491.5,22740,1320,1205,922,784,724,1508,2430,3635,4955,137.89,30.04,22.04,14.73
03-03-2022,VALE DE CAMBRA,188,13,882,"[480,960]",Muito Elevado,,,,188,Norte,AVEIRO,0119,14733.47,21327,1491,1363,1005,831,798,1629,2634,3997,5488,144.76,37.25,27.13,17.88
03-03-2022,VALENÇA,99,7,743,"[480,960]",Muito Elevado,,,,99,Norte,VIANA DO CASTELO,1608,11712.86,13290,867,791,582,582,503,1085,1667,2458,3325,113.46,28.39,20.99,14.23
03-03-2022,VALONGO,1012,72,1039,"[960,Max]",Extremamente Elevado,,,,1012,Norte,PORTO,1315,7512.45,97444,5629,4696,3207,2462,1829,4291,7498,12194,17823,1297.18,237.26,162.33,99.81
03-03-2022,VALPAÇOS,179,13,1208,"[960,Max]",Extremamente Elevado,,,,179,Norte,VILA REAL,1712,54873.93,14818,1217,1118,999,928,997,1925,2924,4042,5259,27.0,9.58,7.37,5.33
03-03-2022,VELAS,480,34,9430,"[960,Max]",Extremamente Elevado,,,,480,Açores,AÇORES,4502,11738.38,5093,278,208,166,153,113,266,432,640,918,43.39,7.82,5.45,3.68
03-03-2022,VENDAS NOVAS,125,9,1109,"[960,Max]",Extremamente Elevado,,,,125,Alentejo,ÉVORA,0712,22238.88,11255,677,768,655,501,532,1033,1688,2456,3133,50.61,14.09,11.04,7.59
03-03-2022,VIANA DO ALENTEJO,186,13,3622,"[960,Max]",Extremamente Elevado,,,,186,Alentejo,ÉVORA,0713,39367.29,5145,245,208,235,210,214,424,659,867,1112,13.07,2.82,2.2,1.67
03-03-2022,VIANA DO CASTELO,767,55,909,"[480,960]",Muito Elevado,,,,767,Norte,VIANA DO CASTELO,1609,31902.01,84417,5470,4433,3591,3061,2982,6043,9634,14067,19537,264.61,61.24,44.09,30.2
03-03-2022,VIDIGUEIRA,56,4,1023,"[960,Max]",Extremamente Elevado,,,,56,Alentejo,BEJA,0214,31661.09,5510,300,248,215,233,275,508,723,971,1271,17.4,4.01,3.07,2.28
03-03-2022,VIEIRA DO MINHO,78,6,662,"[480,960]",Muito Elevado,,,,78,Norte,BRAGA,0311,21644.35,11842,703,594,525,548,482,1030,1555,2149,2852,54.71,13.18,9.93,7.18
03-03-2022,VILA DE REI,93,7,2786,"[960,Max]",Extremamente Elevado,,,,93,Centro,CASTELO BRANCO,0510,19154.6,3323,169,128,172,247,302,549,721,849,1018,17.35,5.31,4.43,3.76
03-03-2022,VILA DO BISPO,126,9,2448,"[960,Max]",Extremamente Elevado,,,,126,Algarve,FARO,0815,17906.06,5154,302,302,314,232,233,465,779,1081,1383,28.78,7.72,6.04,4.35
03-03-2022,VILA DO CONDE,714,51,894,"[480,960]",Muito Elevado,,,,714,Norte,PORTO,1316,14902.77,79899,4726,3875,2819,2070,1743,3813,6632,10507,15233,536.13,102.21,70.5,44.5
03-03-2022,VILA DO PORTO,67,5,1194,"[960,Max]",Extremamente Elevado,,,,67,Açores,AÇORES,4101,9688.74,5616,274,212,135,96,123,219,354,566,840,57.96,8.67,5.84,3.65
03-03-2022,VILA FLOR,23,2,383,"[240,480]",Elevado,,,,23,Norte,BRAGANÇA,0410,26581.14,6044,429,362,422,294,331,625,1047,1409,1838,22.74,6.91,5.3,3.94
03-03-2022,VILA FRANCA DE XIRA,1949,139,1373,"[960,Max]",Extremamente Elevado,,,,1949,Lisboa e Vale do Tejo,LISBOA,1114,31819.39,141957,8501,6852,4869,3425,2472,5897,10766,17618,26119,446.14,82.09,55.37,33.84
03-03-2022,VILA FRANCA DO CAMPO,179,13,1621,"[960,Max]",Extremamente Elevado,,,,179,Açores,AÇORES,4206,7796.82,11051,450,344,248,217,154,371,619,963,1413,141.73,18.12,12.35,7.94
03-03-2022,VILA NOVA DA BARQUINHA,166,12,2225,"[960,Max]",Extremamente Elevado,,,,166,Lisboa e Vale do Tejo,SANTARÉM,1420,4952.97,7461,415,406,392,364,338,702,1094,1500,1915,150.64,38.66,30.28,22.09
03-03-2022,VILA NOVA DE CERVEIRA,74,5,831,"[480,960]",Muito Elevado,,,,74,Norte,VIANA DO CASTELO,1610,10846.66,8910,531,444,410,384,334,718,1128,1572,2103,82.14,19.39,14.49,10.4
03-03-2022,VILA NOVA DE FAMALICÃO,999,71,759,"[480,960]",Muito Elevado,,,,999,Norte,BRAGA,0312,20159.26,131676,7817,6164,4202,3282,2749,6031,10233,16397,24214,653.19,120.12,81.34,50.76
03-03-2022,VILA NOVA DE FOZ CÔA,104,7,1604,"[960,Max]",Extremamente Elevado,,,,104,Centro,GUARDA,0914,39815.18,6503,442,385,390,398,429,827,1217,1602,2044,16.33,5.13,4.02,3.06
03-03-2022,VILA NOVA DE GAIA,3158,226,1051,"[960,Max]",Extremamente Elevado,,,,3158,Norte,PORTO,1317,16846.43,300472,18349,15568,10972,8224,6281,14505,25477,41045,59394,1783.64,352.57,243.65,151.23
03-03-2022,VILA NOVA DE PAIVA,56,4,1195,"[960,Max]",Extremamente Elevado,,,,56,Centro,VISEU,1822,17553.28,4687,289,272,233,217,241,458,691,963,1252,26.7,7.13,5.49,3.94
03-03-2022,VILA NOVA DE POIARES,135,10,1940,"[960,Max]",Extremamente Elevado,,,,135,Centro,COIMBRA,0617,8445.3,6939,380,284,262,235,182,417,679,963,1343,82.17,15.9,11.4,8.04
03-03-2022,VILA POUCA DE AGUIAR,85,6,708,"[480,960]",Muito Elevado,,,,85,Norte,VILA REAL,1713,43706.62,11961,860,817,733,601,627,1228,1961,2778,3638,27.37,8.32,6.36,4.49
03-03-2022,VILA REAL,480,34,960,"[960,Max]",Extremamente Elevado,,,,480,Norte,VILA REAL,1714,37880.28,49962,3025,2498,2065,1579,1466,3045,5110,7608,10633,131.9,28.07,20.08,13.49
03-03-2022,VILA REAL DE SANTO ANTÓNIO,457,33,2436,"[960,Max]",Extremamente Elevado,,,,457,Algarve,FARO,0816,6125.0,18749,1172,1069,811,569,586,1155,1966,3035,4207,306.11,68.69,49.55,32.1
03-03-2022,VILA VELHA DE RÓDÃO,52,4,1655,"[960,Max]",Extremamente Elevado,,,,52,Centro,CASTELO BRANCO,0511,32991.16,3144,209,229,180,283,306,589,769,998,1207,9.53,3.66,3.03,2.33
03-03-2022,VILA VERDE,368,26,785,"[480,960]",Muito Elevado,,,,368,Norte,BRAGA,0313,22866.52,46911,2365,2063,1667,1494,1437,2931,4598,6661,9026,205.15,39.47,29.13,20.11
03-03-2022,VILA VIÇOSA,281,20,3675,"[960,Max]",Extremamente Elevado,,,,281,Alentejo,ÉVORA,0714,19485.89,7656,487,379,342,345,324,669,1011,1390,1877,39.29,9.63,7.13,5.19
03-03-2022,VIMIOSO,10,1,253,"[240,480]",Elevado,,,,10,Norte,BRAGANÇA,0411,48158.51,4023,274,230,261,293,335,628,889,1119,1393,8.35,2.89,2.32,1.85
03-03-2022,VINHAIS,33,2,421,"[240,480]",Elevado,,,,33,Norte,BRAGANÇA,0412,69475.09,7746,599,577,636,641,815,1456,2092,2669,3268,11.15,4.7,3.84,3.01
03-03-2022,VISEU,1602,114,1647,"[960,Max]",Extremamente Elevado,,,,1602,Centro,VISEU,1823,50710.14,97249,5769,5038,4140,3158,2710,5868,10008,15046,20815,191.77,41.05,29.67,19.74
03-03-2022,VIZELA,100,7,418,"[240,480]",Elevado,,,,100,Norte,BRAGA,0314,2469.83,23897,1258,928,655,509,371,880,1535,2463,3721,967.49,150.65,99.72,62.15
03-03-2022,VOUZELA,126,9,1309,"[960,Max]",Extremamente Elevado,,,,126,Centro,VISEU,1824,19369.46,9619,626,605,554,532,507,1039,1593,2198,2824,49.66,14.58,11.35,8.22
