data,concelho,confirmados_14,confirmados_1,incidencia,incidencia_categoria,incidencia_risco,distrito,dicofre,area,population,population_65_69,population_70_74,population_75_79,population_80_84,population_85_mais,population_80_mais,population_75_mais,population_70_mais,population_65_mais,densidade_populacional,densidade_1,densidade_2,densidade_3
11-11-2020,ABRANTES,142,10,404.0,"Acima de 240,0 ",Muito elevada,SANTARÉM,1401,71469.08,35130,2473,2213,1730,1748,2021,3769,5499,7712,10185,49.15,14.25,10.79,7.69
11-11-2020,ÁGUEDA,206,15,447.0,"Acima de 240,0 ",Muito elevada,AVEIRO,0101,33527.44,46075,3237,2713,2090,1635,1496,3131,5221,7934,11171,137.43,33.32,23.66,15.57
11-11-2020,AGUIAR DA BEIRA,8,1,172.0,"Entre 120,0 e 239,9",Elevada,GUARDA,0901,20676.57,4652,304,281,235,239,148,387,622,903,1207,22.5,5.84,4.37,3.01
11-11-2020,ALANDROAL,4,0,80.0,"Entre 60,0 e 119,9",Moderada,ÉVORA,0701,54267.81,4992,307,256,296,299,377,676,972,1228,1535,9.2,2.83,2.26,1.79
11-11-2020,ALBERGARIA-A-VELHA,109,8,451.0,"Acima de 240,0 ",Muito elevada,AVEIRO,0102,15882.5,24144,1550,1298,996,687,680,1367,2363,3661,5211,152.02,32.81,23.05,14.88
11-11-2020,ALBUFEIRA,118,8,284.0,"Acima de 240,0 ",Muito elevada,FARO,0801,14066.42,41528,2067,1717,1425,985,858,1843,3268,4985,7052,295.24,50.14,35.44,23.23
11-11-2020,ALCÁCER DO SAL,32,2,274.0,"Acima de 240,0 ",Muito elevada,SETÚBAL,1501,149987.3,11659,884,814,623,623,602,1225,1848,2662,3546,7.77,2.36,1.77,1.23
11-11-2020,ALCANENA,43,3,336.0,"Acima de 240,0 ",Muito elevada,SANTARÉM,1402,12732.86,12809,891,744,628,536,588,1124,1752,2496,3387,100.6,26.6,19.6,13.76
11-11-2020,ALCOBAÇA,96,7,179.0,"Entre 120,0 e 239,9",Elevada,LEIRIA,1001,40814.09,53555,3420,2927,2466,2059,1676,3735,6201,9128,12548,131.22,30.74,22.36,15.19
11-11-2020,ALCOCHETE,39,3,197.0,"Entre 120,0 e 239,9",Elevada,SETÚBAL,1502,12836.48,19787,857,834,691,476,447,923,1614,2448,3305,154.15,25.75,19.07,12.57
11-11-2020,ALCOUTIM,2,0,93.0,"Entre 60,0 e 119,9",Moderada,FARO,0802,57536.33,2159,191,188,163,190,267,457,620,808,999,3.75,1.74,1.4,1.08
11-11-2020,ALENQUER,187,13,424.0,"Acima de 240,0 ",Muito elevada,LISBOA,1101,30421.92,44052,2298,2062,1629,1330,1155,2485,4114,6176,8474,144.8,27.85,20.3,13.52
11-11-2020,ALFÂNDEGA DA FÉ,21,2,462.0,"Acima de 240,0 ",Muito elevada,BRAGANÇA,0401,32194.64,4550,325,277,301,274,325,599,900,1177,1502,14.13,4.67,3.66,2.8
11-11-2020,ALIJÓ,51,4,480.0,"Acima de 240,0 ",Muito elevada,VILA REAL,1701,29759.89,10625,766,687,635,542,666,1208,1843,2530,3296,35.7,11.08,8.5,6.19
11-11-2020,ALJEZUR,1,0,18.0,"Abaixo de 20,0",Muito baixa,FARO,0803,32349.95,5594,316,336,335,320,410,730,1065,1401,1717,17.29,5.31,4.33,3.29
11-11-2020,ALJUSTREL,20,1,243.0,"Acima de 240,0 ",Muito elevada,BEJA,0201,45847.41,8247,635,521,443,347,358,705,1148,1669,2304,17.99,5.03,3.64,2.5
11-11-2020,ALMADA,823,59,487.0,"Acima de 240,0 ",Muito elevada,SETÚBAL,1503,7000.89,169039,10469,9777,7876,6144,5111,11255,19131,28908,39377,2414.5,562.45,412.91,273.26
11-11-2020,ALMEIDA,21,1,360.0,"Acima de 240,0 ",Muito elevada,GUARDA,0902,51798.46,5830,441,419,396,458,393,851,1247,1666,2107,11.26,4.07,3.22,2.41
11-11-2020,ALMEIRIM,81,6,359.0,"Acima de 240,0 ",Muito elevada,SANTARÉM,1403,22212.05,22546,1342,1353,1106,866,843,1709,2815,4168,5510,101.5,24.81,18.76,12.67
11-11-2020,ALMODÔVAR,6,0,89.0,"Entre 60,0 e 119,9",Moderada,BEJA,0202,77788.03,6725,414,443,396,373,328,701,1097,1540,1954,8.65,2.51,1.98,1.41
11-11-2020,ALPIARÇA,3,0,42.0,"Entre 20,0 e 59,9",Baixa,SANTARÉM,1404,9536.33,7059,515,486,363,333,274,607,970,1456,1971,74.02,20.67,15.27,10.17
11-11-2020,ALTER DO CHÃO,6,0,190.0,"Entre 120,0 e 239,9",Elevada,PORTALEGRE,1201,36206.62,3165,201,163,136,208,187,395,531,694,895,8.74,2.47,1.92,1.47
11-11-2020,ALVAIÁZERE,18,1,273.0,"Acima de 240,0 ",Muito elevada,LEIRIA,1002,16047.76,6597,419,389,346,406,539,945,1291,1680,2099,41.11,13.08,10.47,8.04
11-11-2020,ALVITO,1,0,40.0,"Entre 20,0 e 59,9",Baixa,BEJA,0203,26485.32,2477,145,110,105,111,89,200,305,415,560,9.35,2.11,1.57,1.15
11-11-2020,AMADORA,773,55,420.0,"Acima de 240,0 ",Muito elevada,LISBOA,1115,2378.47,184106,11186,10936,8780,6460,5890,12350,21130,32066,43252,7742.05,1818.84,1348.44,888.56
11-11-2020,AMARANTE,551,39,1036.0,"Acima de 240,0 ",Muito elevada,PORTO,1301,30133.15,53193,3086,2413,1812,1643,1311,2954,4766,7179,10265,176.53,34.07,23.82,15.82
11-11-2020,AMARES,133,10,734.0,"Acima de 240,0 ",Muito elevada,BRAGA,0301,8195.41,18129,1001,829,622,489,524,1013,1635,2464,3465,221.22,42.28,30.07,19.95
11-11-2020,ANADIA,66,5,242.0,"Acima de 240,0 ",Muito elevada,AVEIRO,0103,21663.48,27258,1931,1698,1376,1208,1262,2470,3846,5544,7475,125.83,34.51,25.59,17.75
11-11-2020,ANGRA DO HEROÍSMO,17,1,50.0,"Entre 20,0 e 59,9",Baixa,AÇORES,4301,23899.66,33807,2006,1473,1122,768,635,1403,2525,3998,6004,141.45,25.12,16.73,10.56
11-11-2020,ANSIÃO,30,2,249.0,"Acima de 240,0 ",Muito elevada,LEIRIA,1003,17609.42,12039,727,709,646,694,530,1224,1870,2579,3306,68.37,18.77,14.65,10.62
11-11-2020,ARCOS DE VALDEVEZ,68,5,325.0,"Acima de 240,0 ",Muito elevada,VIANA DO CASTELO,1601,44759.64,20926,1329,1338,1282,1343,1515,2858,4140,5478,6807,46.75,15.21,12.24,9.25
11-11-2020,ARGANIL,47,3,427.0,"Acima de 240,0 ",Muito elevada,COIMBRA,0601,33283.93,11014,672,648,612,559,596,1155,1767,2415,3087,33.09,9.27,7.26,5.31
11-11-2020,ARMAMAR,8,1,139.0,"Entre 120,0 e 239,9",Elevada,VISEU,1801,11723.73,5769,357,305,309,285,310,595,904,1209,1566,49.21,13.36,10.31,7.71
11-11-2020,AROUCA,155,11,748.0,"Acima de 240,0 ",Muito elevada,AVEIRO,0104,32910.52,20720,1306,1047,753,683,683,1366,2119,3166,4472,62.96,13.59,9.62,6.44
11-11-2020,ARRAIOLOS,8,1,115.0,"Entre 60,0 e 119,9",Moderada,ÉVORA,0702,68374.55,6928,435,384,283,367,480,847,1130,1514,1949,10.13,2.85,2.21,1.65
11-11-2020,ARRONCHES,16,1,567.0,"Acima de 240,0 ",Muito elevada,PORTALEGRE,1202,31464.72,2820,155,142,162,187,179,366,528,670,825,8.96,2.62,2.13,1.68
11-11-2020,ARRUDA DOS VINHOS,49,4,318.0,"Acima de 240,0 ",Muito elevada,LISBOA,1102,7795.93,15412,738,738,562,509,438,947,1509,2247,2985,197.69,38.29,28.82,19.36
11-11-2020,AVEIRO,361,26,459.0,"Acima de 240,0 ",Muito elevada,AVEIRO,0105,19757.57,78734,4520,4004,3050,2250,2103,4353,7403,11407,15927,398.49,80.61,57.73,37.47
11-11-2020,AVIS,3,0,71.0,"Entre 60,0 e 119,9",Moderada,PORTALEGRE,1203,60596.51,4247,315,225,206,251,273,524,730,955,1270,7.01,2.1,1.58,1.2
11-11-2020,AZAMBUJA,99,7,436.0,"Acima de 240,0 ",Muito elevada,LISBOA,1103,26265.65,22716,1322,1171,1070,798,618,1416,2486,3657,4979,86.48,18.96,13.92,9.46
11-11-2020,BAIÃO,107,8,571.0,"Acima de 240,0 ",Muito elevada,PORTO,1302,17452.83,18748,1070,862,714,686,725,1411,2125,2987,4057,107.42,23.25,17.11,12.18
11-11-2020,BARCELOS,928,66,799.0,"Acima de 240,0 ",Muito elevada,BRAGA,0302,37890.14,116187,6721,5325,3619,2991,2562,5553,9172,14497,21218,306.64,56.0,38.26,24.21
11-11-2020,BARRANCOS,1,0,61.0,"Entre 60,0 e 119,9",Moderada,BEJA,0204,16841.73,1634,90,65,65,94,61,155,220,285,375,9.7,2.23,1.69,1.31
11-11-2020,BARREIRO,218,16,290.0,"Acima de 240,0 ",Muito elevada,SETÚBAL,1504,3639.07,75147,5194,5565,4459,3105,1767,4872,9331,14896,20090,2065.05,552.07,409.34,256.42
11-11-2020,BATALHA,27,2,169.0,"Entre 120,0 e 239,9",Elevada,LEIRIA,1004,10341.6,15963,873,762,649,529,549,1078,1727,2489,3362,154.35,32.51,24.07,16.7
11-11-2020,BEJA,108,8,322.0,"Acima de 240,0 ",Muito elevada,BEJA,0205,114647.55,33579,2005,1840,1386,1272,1039,2311,3697,5537,7542,29.29,6.58,4.83,3.22
11-11-2020,BELMONTE,113,8,1766.0,"Acima de 240,0 ",Muito elevada,CASTELO BRANCO,0501,11875.91,6398,444,321,325,310,355,665,990,1311,1755,53.87,14.78,11.04,8.34
11-11-2020,BENAVENTE,107,8,350.0,"Acima de 240,0 ",Muito elevada,SANTARÉM,1405,52138.39,30602,1468,1376,1141,876,643,1519,2660,4036,5504,58.69,10.56,7.74,5.1
11-11-2020,BOMBARRAL,7,1,56.0,"Entre 20,0 e 59,9",Baixa,LEIRIA,1005,9128.55,12558,875,714,561,491,429,920,1481,2195,3070,137.56,33.63,24.04,16.22
11-11-2020,BORBA,20,1,297.0,"Acima de 240,0 ",Muito elevada,ÉVORA,0703,14518.65,6736,430,375,279,436,392,828,1107,1482,1912,46.39,13.17,10.21,7.62
11-11-2020,BOTICAS,20,1,400.0,"Acima de 240,0 ",Muito elevada,VILA REAL,1702,32195.66,4998,347,306,311,305,380,685,996,1302,1649,15.52,5.12,4.04,3.09
11-11-2020,BRAGA,1505,108,824.0,"Acima de 240,0 ",Muito elevada,BRAGA,0303,18339.95,182679,10029,7963,5241,4320,3671,7991,13232,21195,31224,996.07,170.25,115.57,72.15
11-11-2020,BRAGANÇA,171,12,509.0,"Acima de 240,0 ",Muito elevada,BRAGANÇA,0402,117357.27,33607,2402,1855,1652,1393,1163,2556,4208,6063,8465,28.64,7.21,5.17,3.59
11-11-2020,CABECEIRAS DE BASTO,68,5,435.0,"Acima de 240,0 ",Muito elevada,BRAGA,0304,24182.16,15628,774,594,544,575,574,1149,1693,2287,3061,64.63,12.66,9.46,7.0
11-11-2020,CADAVAL,32,2,234.0,"Entre 120,0 e 239,9",Elevada,LISBOA,1104,17489.3,13673,813,796,756,621,625,1246,2002,2798,3611,78.18,20.65,16.0,11.45
11-11-2020,CALDAS DA RAINHA,110,8,212.0,"Entre 120,0 e 239,9",Elevada,LEIRIA,1006,25569.47,51912,3035,2684,2186,1899,1705,3604,5790,8474,11509,203.03,45.01,33.14,22.64
11-11-2020,CALHETA,8,1,74.0,"Entre 60,0 e 119,9",Moderada,MADEIRA,3101,11150.43,10867,576,497,507,399,415,814,1321,1818,2394,97.46,21.47,16.3,11.85
11-11-2020,CALHETA (AÇORES),0,0,0.0,"Abaixo de 20,0",Muito baixa,AÇORES,4501,12626.4,3184,215,159,141,139,122,261,402,561,776,25.22,6.15,4.44,3.18
11-11-2020,CÂMARA DE LOBOS,8,1,24.0,"Entre 20,0 e 59,9",Baixa,MADEIRA,3102,5216.67,33675,1396,1059,834,545,381,926,1760,2819,4215,645.49,80.79,54.03,33.74
11-11-2020,CAMINHA,154,11,970.0,"Acima de 240,0 ",Muito elevada,VIANA DO CASTELO,1602,13652.14,15877,1046,944,818,646,656,1302,2120,3064,4110,116.3,30.11,22.44,15.53
11-11-2020,CAMPO MAIOR,27,2,343.0,"Acima de 240,0 ",Muito elevada,PORTALEGRE,1204,24720.16,7874,471,364,351,279,327,606,957,1321,1792,31.85,7.25,5.34,3.87
11-11-2020,CANTANHEDE,126,9,360.0,"Acima de 240,0 ",Muito elevada,COIMBRA,0602,39088.02,35011,2346,2096,1880,1709,1451,3160,5040,7136,9482,89.57,24.26,18.26,12.89
11-11-2020,CARRAZEDA DE ANSIÃES,16,1,282.0,"Acima de 240,0 ",Muito elevada,BRAGANÇA,0403,27924.09,5666,424,389,391,312,465,777,1168,1557,1981,20.29,7.09,5.58,4.18
11-11-2020,CARREGAL DO SAL,10,1,108.0,"Entre 60,0 e 119,9",Moderada,VISEU,1802,11689.21,9271,587,562,486,462,376,838,1324,1886,2473,79.31,21.16,16.13,11.33
11-11-2020,CARTAXO,82,6,344.0,"Acima de 240,0 ",Muito elevada,SANTARÉM,1406,15817.28,23843,1415,1376,1142,861,632,1493,2635,4011,5426,150.74,34.3,25.36,16.66
11-11-2020,CASCAIS,1173,84,549.0,"Acima de 240,0 ",Muito elevada,LISBOA,1105,9740.17,213608,12151,11444,8680,6469,5248,11717,20397,31841,43992,2193.1,451.66,326.91,209.41
11-11-2020,CASTANHEIRA DE PÊRA,1,0,38.0,"Entre 20,0 e 59,9",Baixa,LEIRIA,1007,6677.45,2614,233,195,157,190,187,377,534,729,962,39.15,14.41,10.92,8.0
11-11-2020,CASTELO BRANCO,178,13,342.0,"Acima de 240,0 ",Muito elevada,CASTELO BRANCO,0502,143819.15,51987,3528,3042,2499,2229,2225,4454,6953,9995,13523,36.15,9.4,6.95,4.83
11-11-2020,CASTELO DE PAIVA,121,9,783.0,"Acima de 240,0 ",Muito elevada,AVEIRO,0106,11500.53,15454,881,697,545,420,431,851,1396,2093,2974,134.37,25.86,18.2,12.14
11-11-2020,CASTELO DE VIDE,1,0,34.0,"Entre 20,0 e 59,9",Baixa,PORTALEGRE,1205,26491.24,2919,204,173,179,147,170,317,496,669,873,11.02,3.3,2.53,1.87
11-11-2020,CASTRO DAIRE,81,6,586.0,"Acima de 240,0 ",Muito elevada,VISEU,1803,37904.13,13823,942,857,765,732,773,1505,2270,3127,4069,36.47,10.74,8.25,5.99
11-11-2020,CASTRO MARIM,6,0,96.0,"Entre 60,0 e 119,9",Moderada,FARO,0804,30084.37,6237,370,345,334,322,344,666,1000,1345,1715,20.73,5.7,4.47,3.32
11-11-2020,CASTRO VERDE,5,0,72.0,"Entre 60,0 e 119,9",Moderada,BEJA,0206,56944.23,6949,437,347,303,275,227,502,805,1152,1589,12.2,2.79,2.02,1.41
11-11-2020,CELORICO DA BEIRA,42,3,606.0,"Acima de 240,0 ",Muito elevada,GUARDA,0903,24721.63,6928,430,416,363,369,535,904,1267,1683,2113,28.02,8.55,6.81,5.12
11-11-2020,CELORICO DE BASTO,118,8,620.0,"Acima de 240,0 ",Muito elevada,BRAGA,0305,18107.02,19040,1001,802,668,728,729,1457,2125,2927,3928,105.15,21.69,16.17,11.74
11-11-2020,CHAMUSCA,25,2,272.0,"Acima de 240,0 ",Muito elevada,SANTARÉM,1407,74600.54,9197,629,583,553,465,579,1044,1597,2180,2809,12.33,3.77,2.92,2.14
11-11-2020,CHAVES,195,14,496.0,"Acima de 240,0 ",Muito elevada,VILA REAL,1703,59122.95,39343,2676,2429,1991,1886,1918,3804,5795,8224,10900,66.54,18.44,13.91,9.8
11-11-2020,CINFÃES,237,17,1299.0,"Acima de 240,0 ",Muito elevada,VISEU,1804,23928.76,18244,1067,902,779,734,758,1492,2271,3173,4240,76.24,17.72,13.26,9.49
11-11-2020,COIMBRA,508,36,379.0,"Acima de 240,0 ",Muito elevada,COIMBRA,0603,31939.94,134166,9489,8734,6353,5139,5074,10213,16566,25300,34789,420.06,108.92,79.21,51.87
11-11-2020,CONDEIXA-A-NOVA,58,4,327.0,"Acima de 240,0 ",Muito elevada,COIMBRA,0604,13867.47,17733,871,809,717,583,490,1073,1790,2599,3470,127.88,25.02,18.74,12.91
11-11-2020,CONSTÂNCIA,13,1,323.0,"Acima de 240,0 ",Muito elevada,SANTARÉM,1408,8036.58,4030,211,183,187,148,155,303,490,673,884,50.14,11.0,8.37,6.1
11-11-2020,CORUCHE,140,10,801.0,"Acima de 240,0 ",Muito elevada,SANTARÉM,1409,111572.03,17471,1294,1090,1095,1096,1019,2115,3210,4300,5594,15.66,5.01,3.85,2.88
11-11-2020,CORVO,0,0,0.0,"Abaixo de 20,0",Muito baixa,AÇORES,4901,1711.45,464,22,21,11,13,19,32,43,64,86,27.12,5.03,3.74,2.51
11-11-2020,COVILHÃ,192,14,410.0,"Acima de 240,0 ",Muito elevada,CASTELO BRANCO,0503,55560.06,46787,3533,2998,2365,2111,2193,4304,6669,9667,13200,84.21,23.76,17.4,12.0
11-11-2020,CRATO,10,1,320.0,"Acima de 240,0 ",Muito elevada,PORTALEGRE,1206,39806.88,3129,229,258,163,182,228,410,573,831,1060,7.86,2.66,2.09,1.44
11-11-2020,CUBA,16,1,348.0,"Acima de 240,0 ",Muito elevada,BEJA,0207,17208.72,4595,255,233,206,190,143,333,539,772,1027,26.7,5.97,4.49,3.13
11-11-2020,ELVAS,57,4,278.0,"Acima de 240,0 ",Muito elevada,PORTALEGRE,1207,63128.86,20528,1057,1145,902,852,810,1662,2564,3709,4766,32.52,7.55,5.88,4.06
11-11-2020,ENTRONCAMENTO,42,3,195.0,"Entre 120,0 e 239,9",Elevada,SANTARÉM,1410,1372.81,21558,1066,930,868,695,592,1287,2155,3085,4151,1570.14,302.33,224.69,156.96
11-11-2020,ESPINHO,261,19,884.0,"Acima de 240,0 ",Muito elevada,AVEIRO,0107,2105.68,29516,2205,1993,1430,1177,960,2137,3567,5560,7765,1401.52,368.71,264.01,169.37
11-11-2020,ESPOSENDE,204,15,597.0,"Acima de 240,0 ",Muito elevada,BRAGA,0306,9540.98,34177,1831,1522,1095,894,723,1617,2712,4234,6065,358.21,63.57,44.38,28.42
11-11-2020,ESTARREJA,91,7,350.0,"Acima de 240,0 ",Muito elevada,AVEIRO,0108,10817.33,26006,1503,1399,1106,953,728,1681,2787,4186,5689,240.42,52.59,38.7,25.76
11-11-2020,ESTREMOZ,75,5,589.0,"Acima de 240,0 ",Muito elevada,ÉVORA,0704,51379.95,12728,789,613,697,786,877,1663,2360,2973,3762,24.77,7.32,5.79,4.59
11-11-2020,ÉVORA,154,11,294.0,"Acima de 240,0 ",Muito elevada,ÉVORA,0705,130707.58,52428,3569,2852,2176,1966,1803,3769,5945,8797,12366,40.11,9.46,6.73,4.55
11-11-2020,FAFE,859,61,1787.0,"Acima de 240,0 ",Muito elevada,BRAGA,0307,21908.11,48060,3044,2455,1679,1403,1208,2611,4290,6745,9789,219.37,44.68,30.79,19.58
11-11-2020,FARO,213,15,349.0,"Acima de 240,0 ",Muito elevada,FARO,0805,20256.79,61015,3847,3364,2604,2055,1601,3656,6260,9624,13471,301.2,66.5,47.51,30.9
11-11-2020,FELGUEIRAS,970,69,1719.0,"Acima de 240,0 ",Muito elevada,PORTO,1303,11573.75,56422,2951,2302,1601,1316,973,2289,3890,6192,9143,487.49,79.0,53.5,33.61
11-11-2020,FERREIRA DO ALENTEJO,28,2,357.0,"Acima de 240,0 ",Muito elevada,BEJA,0208,64820.68,7845,515,414,372,343,345,688,1060,1474,1989,12.1,3.07,2.27,1.64
11-11-2020,FERREIRA DO ZÊZERE,7,1,88.0,"Entre 60,0 e 119,9",Moderada,SANTARÉM,1411,19038.03,7959,470,370,416,465,456,921,1337,1707,2177,41.81,11.44,8.97,7.02
11-11-2020,FIGUEIRA DA FOZ,299,21,509.0,"Acima de 240,0 ",Muito elevada,COIMBRA,0605,37905.26,58747,4032,3597,2887,2495,2043,4538,7425,11022,15054,154.98,39.72,29.08,19.59
11-11-2020,FIGUEIRA DE CASTELO RODRIGO,50,4,895.0,"Acima de 240,0 ",Muito elevada,GUARDA,0904,50857.46,5584,347,352,290,352,391,743,1033,1385,1732,10.98,3.41,2.72,2.03
11-11-2020,FIGUEIRÓ DOS VINHOS,6,0,108.0,"Entre 60,0 e 119,9",Moderada,LEIRIA,1008,17344.0,5568,402,386,322,309,351,660,982,1368,1770,32.1,10.21,7.89,5.66
11-11-2020,FORNOS DE ALGODRES,11,1,243.0,"Acima de 240,0 ",Muito elevada,GUARDA,0905,13145.05,4528,261,218,247,256,232,488,735,953,1214,34.45,9.24,7.25,5.59
11-11-2020,FREIXO DE ESPADA À CINTA,51,4,1546.0,"Acima de 240,0 ",Muito elevada,BRAGANÇA,0404,24414.29,3298,211,177,231,196,189,385,616,793,1004,13.51,4.11,3.25,2.52
11-11-2020,FRONTEIRA,2,0,67.0,"Entre 60,0 e 119,9",Moderada,PORTALEGRE,1208,24859.58,2974,213,182,149,156,168,324,473,655,868,11.96,3.49,2.63,1.9
11-11-2020,FUNCHAL,82,6,79.0,"Entre 60,0 e 119,9",Moderada,MADEIRA,3103,7616.2,104024,6382,5086,3643,2821,1990,4811,8454,13540,19922,1365.86,261.58,177.78,111.0
11-11-2020,FUNDÃO,183,13,691.0,"Acima de 240,0 ",Muito elevada,CASTELO BRANCO,0504,70019.79,26495,1781,1464,1432,1357,1643,3000,4432,5896,7677,37.84,10.96,8.42,6.33
11-11-2020,GAVIÃO,6,0,184.0,"Entre 120,0 e 239,9",Elevada,PORTALEGRE,1209,29459.45,3263,189,186,222,263,293,556,778,964,1153,11.08,3.91,3.27,2.64
11-11-2020,GÓIS,5,0,131.0,"Entre 120,0 e 239,9",Elevada,COIMBRA,0606,26330.19,3805,235,199,240,233,244,477,717,916,1151,14.45,4.37,3.48,2.72
11-11-2020,GOLEGÃ,8,1,150.0,"Entre 120,0 e 239,9",Elevada,SANTARÉM,1412,8431.67,5339,356,299,281,243,255,498,779,1078,1434,63.32,17.01,12.78,9.24
11-11-2020,GONDOMAR,1525,109,919.0,"Acima de 240,0 ",Muito elevada,PORTO,1304,13191.76,165985,10555,8755,6222,4450,3364,7814,14036,22791,33346,1258.22,252.77,172.76,106.4
11-11-2020,GOUVEIA,17,1,137.0,"Entre 120,0 e 239,9",Elevada,GUARDA,0906,30061.17,12387,871,931,780,783,810,1593,2373,3304,4175,41.21,13.89,10.99,7.89
11-11-2020,GRÂNDOLA,62,4,424.0,"Acima de 240,0 ",Muito elevada,SETÚBAL,1505,82593.66,14639,834,834,708,688,672,1360,2068,2902,3736,17.72,4.52,3.51,2.5
11-11-2020,GUARDA,411,29,1055.0,"Acima de 240,0 ",Muito elevada,GUARDA,0907,71209.58,38969,2477,2041,1686,1415,1474,2889,4575,6616,9093,54.72,12.77,9.29,6.42
11-11-2020,GUIMARÃES,2873,205,1886.0,"Acima de 240,0 ",Muito elevada,BRAGA,0308,24099.96,152309,9394,7074,4809,3877,2948,6825,11634,18708,28102,631.99,116.61,77.63,48.27
11-11-2020,HORTA,4,0,28.0,"Entre 20,0 e 59,9",Baixa,AÇORES,4701,17305.53,14521,818,658,468,352,302,654,1122,1780,2598,83.91,15.01,10.29,6.48
11-11-2020,IDANHA-A-NOVA,85,6,1057.0,"Acima de 240,0 ",Muito elevada,CASTELO BRANCO,0505,141633.51,8043,518,490,519,672,974,1646,2165,2655,3173,5.68,2.24,1.87,1.53
11-11-2020,ÍLHAVO,160,11,413.0,"Acima de 240,0 ",Muito elevada,AVEIRO,0110,7347.55,38699,2227,1943,1444,1193,850,2043,3487,5430,7657,526.66,104.21,73.9,47.46
11-11-2020,LAGOA (FARO),37,3,163.0,"Entre 120,0 e 239,9",Elevada,FARO,0806,8825.45,22762,1314,1168,919,749,670,1419,2338,3506,4820,257.93,54.62,39.73,26.49
11-11-2020,LAGOA,8,1,54.0,"Entre 20,0 e 59,9",Baixa,AÇORES,4201,4559.32,14721,536,458,349,238,235,473,822,1280,1816,322.9,39.83,28.08,18.03
11-11-2020,LAGOS,74,5,244.0,"Acima de 240,0 ",Muito elevada,FARO,0807,21299.27,30374,1744,1434,1247,1053,1029,2082,3329,4763,6507,142.61,30.55,22.36,15.63
11-11-2020,LAJES DAS FLORES,0,0,0.0,"Abaixo de 20,0",Muito baixa,AÇORES,4801,7004.79,1463,88,53,62,46,54,100,162,215,303,20.89,4.33,3.07,2.31
11-11-2020,LAJES DO PICO,0,0,0.0,"Abaixo de 20,0",Muito baixa,AÇORES,4601,15531.09,4490,304,231,223,159,162,321,544,775,1079,28.91,6.95,4.99,3.5
11-11-2020,LAMEGO,72,5,289.0,"Acima de 240,0 ",Muito elevada,VISEU,1805,16542.11,24895,1639,1284,1124,898,783,1681,2805,4089,5728,150.5,34.63,24.72,16.96
11-11-2020,LEIRIA,294,21,235.0,"Entre 120,0 e 239,9",Elevada,LEIRIA,1009,56508.83,125267,7389,6366,5090,3902,3159,7061,12151,18517,25906,221.68,45.84,32.77,21.5
11-11-2020,LISBOA,2935,210,576.0,"Acima de 240,0 ",Muito elevada,LISBOA,1106,10005.43,509515,33197,33340,27706,23037,26770,49807,77513,110853,144050,5092.6,1439.78,1107.98,774.74
11-11-2020,LOULÉ,148,11,215.0,"Entre 120,0 e 239,9",Elevada,FARO,0808,76366.91,68697,3890,3350,2780,2358,2251,4609,7389,10739,14629,89.96,19.16,14.06,9.68
11-11-2020,LOURES,1096,78,513.0,"Acima de 240,0 ",Muito elevada,LISBOA,1107,16723.99,213687,12746,12794,9644,6669,5033,11702,21346,34140,46886,1277.73,280.35,204.14,127.64
11-11-2020,LOURINHÃ,55,4,213.0,"Entre 120,0 e 239,9",Elevada,LISBOA,1108,14717.2,25855,1584,1243,992,842,645,1487,2479,3722,5306,175.68,36.05,25.29,16.84
11-11-2020,LOUSÃ,41,3,239.0,"Entre 120,0 e 239,9",Elevada,COIMBRA,0607,13840.01,17158,946,866,658,528,450,978,1636,2502,3448,123.97,24.91,18.08,11.82
11-11-2020,LOUSADA,1572,112,3362.0,"Acima de 240,0 ",Muito elevada,PORTO,1305,9608.01,46755,2289,1698,1176,853,621,1474,2650,4348,6637,486.63,69.08,45.25,27.58
11-11-2020,MAÇÃO,3,0,48.0,"Entre 20,0 e 59,9",Baixa,SANTARÉM,1413,39997.98,6267,386,362,390,440,657,1097,1487,1849,2235,15.67,5.59,4.62,3.72
11-11-2020,MACEDO DE CAVALEIROS,67,5,462.0,"Acima de 240,0 ",Muito elevada,BRAGANÇA,0405,69914.08,14516,1082,889,878,823,938,1761,2639,3528,4610,20.76,6.59,5.05,3.77
11-11-2020,MACHICO,6,0,30.0,"Entre 20,0 e 59,9",Baixa,MADEIRA,3104,6825.1,19981,1197,860,662,455,331,786,1448,2308,3505,292.76,51.36,33.82,21.22
11-11-2020,MADALENA,0,0,0.0,"Abaixo de 20,0",Muito baixa,AÇORES,4602,14712.33,5895,334,256,173,190,179,369,542,798,1132,40.07,7.69,5.42,3.68
11-11-2020,MAFRA,417,30,492.0,"Acima de 240,0 ",Muito elevada,LISBOA,1109,29165.5,84816,3613,3334,2839,2089,1899,3988,6827,10161,13774,290.81,47.23,34.84,23.41
11-11-2020,MAIA,1281,92,922.0,"Acima de 240,0 ",Muito elevada,PORTO,1306,8293.94,138971,7801,6617,4512,3339,2631,5970,10482,17099,24900,1675.56,300.22,206.16,126.38
11-11-2020,MANGUALDE,90,6,486.0,"Acima de 240,0 ",Muito elevada,VISEU,1806,21925.56,18510,1198,1128,885,852,743,1595,2480,3608,4806,84.42,21.92,16.46,11.31
11-11-2020,MANTEIGAS,79,6,2627.0,"Acima de 240,0 ",Muito elevada,GUARDA,0908,12197.55,3007,258,197,159,167,146,313,472,669,927,24.65,7.6,5.48,3.87
11-11-2020,MARCO DE CANAVESES,710,51,1379.0,"Acima de 240,0 ",Muito elevada,PORTO,1307,20188.98,51496,2678,2060,1488,1265,1023,2288,3776,5836,8514,255.07,42.17,28.91,18.7
11-11-2020,MARINHA GRANDE,88,6,229.0,"Entre 120,0 e 239,9",Elevada,LEIRIA,1010,18725.19,38508,2365,2302,1638,1359,1058,2417,4055,6357,8722,205.65,46.58,33.95,21.66
11-11-2020,MARVÃO,4,0,133.0,"Entre 120,0 e 239,9",Elevada,PORTALEGRE,1210,15489.9,3005,198,185,142,197,237,434,576,761,959,19.4,6.19,4.91,3.72
11-11-2020,MATOSINHOS,2052,147,1170.0,"Acima de 240,0 ",Muito elevada,PORTO,1308,6241.97,175357,11850,9977,7023,5024,3884,8908,15931,25908,37758,2809.31,604.9,415.06,255.22
11-11-2020,MEALHADA,127,9,638.0,"Acima de 240,0 ",Muito elevada,AVEIRO,0111,11065.66,19914,1163,1039,810,828,831,1659,2469,3508,4671,179.96,42.21,31.7,22.31
11-11-2020,MÊDA,23,2,501.0,"Acima de 240,0 ",Muito elevada,GUARDA,0909,28604.92,4587,343,306,290,288,443,731,1021,1327,1670,16.04,5.84,4.64,3.57
11-11-2020,MELGAÇO,10,1,124.0,"Entre 120,0 e 239,9",Elevada,VIANA DO CASTELO,1603,23824.58,8093,507,567,578,614,675,1289,1867,2434,2941,33.97,12.34,10.22,7.84
11-11-2020,MÉRTOLA,8,1,130.0,"Entre 120,0 e 239,9",Elevada,BEJA,0209,129287.34,6142,400,390,378,423,600,1023,1401,1791,2191,4.75,1.69,1.39,1.08
11-11-2020,MESÃO FRIO,5,0,126.0,"Entre 120,0 e 239,9",Elevada,VILA REAL,1704,2664.87,3964,265,205,168,157,120,277,445,650,915,148.74,34.33,24.39,16.7
11-11-2020,MIRA,50,4,423.0,"Acima de 240,0 ",Muito elevada,COIMBRA,0608,12403.38,11832,727,729,659,550,466,1016,1675,2404,3131,95.4,25.24,19.38,13.5
11-11-2020,MIRANDA DO CORVO,43,3,338.0,"Acima de 240,0 ",Muito elevada,COIMBRA,0609,12637.79,12708,706,659,568,498,404,902,1470,2129,2835,100.55,22.43,16.85,11.63
11-11-2020,MIRANDA DO DOURO,31,2,454.0,"Acima de 240,0 ",Muito elevada,BRAGANÇA,0406,48718.31,6830,482,429,442,463,470,933,1375,1804,2286,14.02,4.69,3.7,2.82
11-11-2020,MIRANDELA,75,5,345.0,"Acima de 240,0 ",Muito elevada,BRAGANÇA,0407,65895.67,21754,1640,1315,1204,1078,947,2025,3229,4544,6184,33.01,9.38,6.9,4.9
11-11-2020,MOGADOURO,69,5,822.0,"Acima de 240,0 ",Muito elevada,BRAGANÇA,0408,76064.93,8392,589,529,576,630,655,1285,1861,2390,2979,11.03,3.92,3.14,2.45
11-11-2020,MOIMENTA DA BEIRA,22,2,226.0,"Entre 120,0 e 239,9",Elevada,VISEU,1807,21996.9,9736,576,514,471,416,461,877,1348,1862,2438,44.26,11.08,8.46,6.13
11-11-2020,MOITA,169,12,262.0,"Acima de 240,0 ",Muito elevada,SETÚBAL,1506,5525.98,64407,4226,3646,2623,1801,1425,3226,5849,9495,13721,1165.53,248.3,171.82,105.85
11-11-2020,MONÇÃO,36,3,201.0,"Entre 120,0 e 239,9",Elevada,VIANA DO CASTELO,1604,21130.85,17869,1161,1105,1031,1006,972,1978,3009,4114,5275,84.56,24.96,19.47,14.24
11-11-2020,MONCHIQUE,0,0,0.0,"Abaixo de 20,0",Muito baixa,FARO,0809,39530.43,5077,353,384,321,355,392,747,1068,1452,1805,12.84,4.57,3.67,2.7
11-11-2020,MONDIM DE BASTO,21,1,302.0,"Acima de 240,0 ",Muito elevada,VILA REAL,1705,17207.52,6946,395,300,314,284,283,567,881,1181,1576,40.36,9.16,6.86,5.12
11-11-2020,MONFORTE,20,1,672.0,"Acima de 240,0 ",Muito elevada,PORTALEGRE,1211,42024.82,2975,139,115,117,192,168,360,477,592,731,7.08,1.74,1.41,1.14
11-11-2020,MONTALEGRE,29,2,322.0,"Acima de 240,0 ",Muito elevada,VILA REAL,1706,80545.71,8997,699,628,595,603,730,1333,1928,2556,3255,11.17,4.04,3.17,2.39
11-11-2020,MONTEMOR-O-NOVO,35,3,224.0,"Entre 120,0 e 239,9",Elevada,ÉVORA,0706,123296.65,15647,991,953,868,878,971,1849,2717,3670,4661,12.69,3.78,2.98,2.2
11-11-2020,MONTEMOR-O-VELHO,81,6,321.0,"Acima de 240,0 ",Muito elevada,COIMBRA,0610,22896.23,25224,1496,1397,1217,1057,988,2045,3262,4659,6155,110.17,26.88,20.35,14.25
11-11-2020,MONTIJO,113,8,196.0,"Entre 120,0 e 239,9",Elevada,SETÚBAL,1507,34861.64,57614,2771,2441,1990,1554,1109,2663,4653,7094,9865,165.26,28.3,20.35,13.35
11-11-2020,MORA,21,1,507.0,"Acima de 240,0 ",Muito elevada,ÉVORA,0707,44395.02,4138,336,275,252,238,257,495,747,1022,1358,9.32,3.06,2.3,1.68
11-11-2020,MORTÁGUA,20,1,227.0,"Entre 120,0 e 239,9",Elevada,VISEU,1808,25117.82,8803,638,584,535,499,460,959,1494,2078,2716,35.05,10.81,8.27,5.95
11-11-2020,MOURA,7,0,51.0,"Entre 20,0 e 59,9",Baixa,BEJA,0210,95845.55,13718,817,656,665,542,461,1003,1668,2324,3141,14.31,3.28,2.42,1.74
11-11-2020,MOURÃO,1,0,41.0,"Entre 20,0 e 59,9",Baixa,ÉVORA,0708,27862.98,2450,139,108,80,104,109,213,293,401,540,8.79,1.94,1.44,1.05
11-11-2020,MURÇA,65,5,1190.0,"Acima de 240,0 ",Muito elevada,VILA REAL,1707,18937.11,5463,384,341,307,306,319,625,932,1273,1657,28.85,8.75,6.72,4.92
11-11-2020,MURTOSA,30,2,292.0,"Acima de 240,0 ",Muito elevada,AVEIRO,0112,7308.78,10279,509,473,403,353,409,762,1165,1638,2147,140.63,29.37,22.41,15.94
11-11-2020,NAZARÉ,32,2,226.0,"Entre 120,0 e 239,9",Elevada,LEIRIA,1011,8243.43,14165,967,903,670,420,396,816,1486,2389,3356,171.84,40.71,28.98,18.03
11-11-2020,NELAS,69,5,532.0,"Acima de 240,0 ",Muito elevada,VISEU,1809,12571.48,12974,924,787,668,604,583,1187,1855,2642,3566,103.21,28.37,21.02,14.76
11-11-2020,NISA,2,0,33.0,"Entre 20,0 e 59,9",Baixa,PORTALEGRE,1212,57567.84,6061,405,389,355,483,478,961,1316,1705,2110,10.53,3.67,2.96,2.29
11-11-2020,NORDESTE,1,0,21.0,"Entre 20,0 e 59,9",Baixa,AÇORES,4202,10146.8,4862,246,180,124,161,162,323,447,627,873,47.92,8.6,6.18,4.41
11-11-2020,ÓBIDOS,20,1,169.0,"Entre 120,0 e 239,9",Elevada,LEIRIA,1012,14155.44,11850,743,650,574,452,436,888,1462,2112,2855,83.72,20.17,14.92,10.33
11-11-2020,ODEMIRA,38,3,154.0,"Entre 120,0 e 239,9",Elevada,BEJA,0211,172060.15,24717,1475,1317,1225,1397,1349,2746,3971,5288,6763,14.37,3.93,3.07,2.31
11-11-2020,ODIVELAS,872,62,539.0,"Acima de 240,0 ",Muito elevada,LISBOA,1116,2654.36,161774,9562,9038,6952,4641,3812,8453,15405,24443,34005,6095.48,1281.27,920.99,580.44
11-11-2020,OEIRAS,788,56,444.0,"Acima de 240,0 ",Muito elevada,LISBOA,1110,4588.31,177408,11580,11575,8566,6211,5855,12066,20632,32207,43787,3866.78,954.38,701.98,449.69
11-11-2020,OLEIROS,3,0,60.0,"Entre 60,0 e 119,9",Moderada,CASTELO BRANCO,0506,47109.31,5003,384,341,366,397,487,884,1250,1591,1975,10.62,4.19,3.38,2.65
11-11-2020,OLHÃO,86,6,194.0,"Entre 120,0 e 239,9",Elevada,FARO,0810,13086.38,44405,2455,2309,1689,1342,1268,2610,4299,6608,9063,339.33,69.26,50.5,32.85
11-11-2020,OLIVEIRA DE AZEMÉIS,787,56,1192.0,"Acima de 240,0 ",Muito elevada,AVEIRO,0113,16110.41,66011,4155,3614,2794,2183,1738,3921,6715,10329,14484,409.75,89.91,64.12,41.68
11-11-2020,OLIVEIRA DE FRADES,46,3,463.0,"Acima de 240,0 ",Muito elevada,VISEU,1810,14534.62,9936,553,475,438,359,415,774,1212,1687,2240,68.36,15.41,11.61,8.34
11-11-2020,OLIVEIRA DO BAIRRO,104,7,428.0,"Acima de 240,0 ",Muito elevada,AVEIRO,0114,8731.99,24277,1327,1182,999,786,810,1596,2595,3777,5104,278.02,58.45,43.25,29.72
11-11-2020,OLIVEIRA DO HOSPITAL,28,2,145.0,"Entre 120,0 e 239,9",Elevada,COIMBRA,0611,23451.66,19253,1161,1097,962,924,960,1884,2846,3943,5104,82.1,21.76,16.81,12.14
11-11-2020,OURÉM,207,15,470.0,"Acima de 240,0 ",Muito elevada,SANTARÉM,1421,41668.03,44044,2463,2069,1899,1817,1603,3420,5319,7388,9851,105.7,23.64,17.73,12.77
11-11-2020,OURIQUE,4,0,87.0,"Entre 60,0 e 119,9",Moderada,BEJA,0212,66331.36,4607,313,287,284,268,227,495,779,1066,1379,6.95,2.08,1.61,1.17
11-11-2020,OVAR,478,34,881.0,"Acima de 240,0 ",Muito elevada,AVEIRO,0115,14770.25,54260,3294,2709,1994,1636,1234,2870,4864,7573,10867,367.37,73.57,51.27,32.93
11-11-2020,PAÇOS DE FERREIRA,2098,150,3698.0,"Acima de 240,0 ",Muito elevada,PORTO,1309,7099.29,56728,2903,2193,1518,1135,664,1799,3317,5510,8413,799.1,118.51,77.62,46.72
11-11-2020,PALMELA,254,18,395.0,"Acima de 240,0 ",Muito elevada,SETÚBAL,1508,46512.01,64269,3402,3244,2635,1846,1391,3237,5872,9116,12518,138.18,26.91,19.6,12.62
11-11-2020,PAMPILHOSA DA SERRA,19,1,471.0,"Acima de 240,0 ",Muito elevada,COIMBRA,0612,39646.24,4037,238,254,295,339,423,762,1057,1311,1549,10.18,3.91,3.31,2.67
11-11-2020,PAREDES,1835,131,2132.0,"Acima de 240,0 ",Muito elevada,PORTO,1310,15675.69,86067,4272,3532,2412,1717,1258,2975,5387,8919,13191,549.04,84.15,56.9,34.36
11-11-2020,PAREDES DE COURA,52,4,609.0,"Acima de 240,0 ",Muito elevada,VIANA DO CASTELO,1605,13818.59,8535,466,528,407,465,515,980,1387,1915,2381,61.76,17.23,13.86,10.04
11-11-2020,PEDRÓGÃO GRANDE,7,0,205.0,"Entre 120,0 e 239,9",Elevada,LEIRIA,1013,12874.75,3410,175,173,196,221,252,473,669,842,1017,26.49,7.9,6.54,5.2
11-11-2020,PENACOVA,56,4,409.0,"Acima de 240,0 ",Muito elevada,COIMBRA,0613,21673.23,13694,968,923,745,621,703,1324,2069,2992,3960,63.18,18.27,13.81,9.55
11-11-2020,PENAFIEL,1434,102,2055.0,"Acima de 240,0 ",Muito elevada,PORTO,1311,21224.27,69772,3648,2823,2032,1663,1230,2893,4925,7748,11396,328.74,53.69,36.51,23.2
11-11-2020,PENALVA DO CASTELO,21,1,295.0,"Acima de 240,0 ",Muito elevada,VISEU,1811,13433.92,7115,449,457,413,391,426,817,1230,1687,2136,52.96,15.9,12.56,9.16
11-11-2020,PENAMACOR,14,1,294.0,"Acima de 240,0 ",Muito elevada,CASTELO BRANCO,0507,56370.69,4755,262,248,273,451,633,1084,1357,1605,1867,8.44,3.31,2.85,2.41
11-11-2020,PENEDONO,3,0,116.0,"Entre 60,0 e 119,9",Moderada,VISEU,1812,13370.75,2591,172,113,129,156,138,294,423,536,708,19.38,5.3,4.01,3.16
11-11-2020,PENELA,25,2,463.0,"Acima de 240,0 ",Muito elevada,COIMBRA,0614,13480.0,5397,314,324,274,359,344,703,977,1301,1615,40.04,11.98,9.65,7.25
11-11-2020,PENICHE,38,3,143.0,"Entre 120,0 e 239,9",Elevada,LEIRIA,1014,7754.98,26501,1746,1504,1203,926,707,1633,2836,4340,6086,341.73,78.48,55.96,36.57
11-11-2020,PESO DA RÉGUA,81,6,514.0,"Acima de 240,0 ",Muito elevada,VILA REAL,1708,9486.01,15773,1076,843,650,659,455,1114,1764,2607,3683,166.28,38.83,27.48,18.6
11-11-2020,PINHEL,19,1,223.0,"Entre 120,0 e 239,9",Elevada,GUARDA,0910,48452.12,8511,577,566,551,538,689,1227,1778,2344,2921,17.57,6.03,4.84,3.67
11-11-2020,POMBAL,117,8,227.0,"Entre 120,0 e 239,9",Elevada,LEIRIA,1015,62600.28,51461,3187,2791,2494,2328,2027,4355,6849,9640,12827,82.21,20.49,15.4,10.94
11-11-2020,PONTA DELGADA,49,3,72.0,"Entre 60,0 e 119,9",Moderada,AÇORES,4203,23298.65,67935,3108,2435,1726,1133,902,2035,3761,6196,9304,291.58,39.93,26.59,16.14
11-11-2020,PONTA DO SOL,7,0,81.0,"Entre 60,0 e 119,9",Moderada,MADEIRA,3105,4622.03,8593,319,283,347,208,221,429,776,1059,1378,185.92,29.81,22.91,16.79
11-11-2020,PONTE DA BARCA,17,1,152.0,"Entre 120,0 e 239,9",Elevada,VIANA DO CASTELO,1606,18211.37,11180,635,576,517,554,490,1044,1561,2137,2772,61.39,15.22,11.73,8.57
11-11-2020,PONTE DE LIMA,224,16,542.0,"Acima de 240,0 ",Muito elevada,VIANA DO CASTELO,1607,32025.46,41315,2321,2022,1720,1596,1462,3058,4778,6800,9121,129.01,28.48,21.23,14.92
11-11-2020,PONTE DE SOR,50,4,333.0,"Acima de 240,0 ",Muito elevada,PORTALEGRE,1213,83971.16,14994,939,800,716,739,831,1570,2286,3086,4025,17.86,4.79,3.68,2.72
11-11-2020,PORTALEGRE,58,4,262.0,"Acima de 240,0 ",Muito elevada,PORTALEGRE,1214,44713.64,22172,1577,1351,1137,993,984,1977,3114,4465,6042,49.59,13.51,9.99,6.96
11-11-2020,PORTEL,2,0,34.0,"Entre 20,0 e 59,9",Baixa,ÉVORA,0709,60100.57,5828,336,358,283,331,305,636,919,1277,1613,9.7,2.68,2.12,1.53
11-11-2020,PORTIMÃO,143,10,258.0,"Acima de 240,0 ",Muito elevada,FARO,0811,18206.29,55483,3182,2927,2116,1582,1400,2982,5098,8025,11207,304.75,61.56,44.08,28.0
11-11-2020,PORTO,2489,178,1149.0,"Acima de 240,0 ",Muito elevada,PORTO,1312,4142.02,216606,15790,15193,11280,9409,10044,19453,30733,45926,61716,5229.5,1490.0,1108.79,741.98
11-11-2020,PORTO DE MÓS,50,4,215.0,"Entre 120,0 e 239,9",Elevada,LEIRIA,1016,26183.41,23275,1355,1210,1034,888,872,1760,2794,4004,5359,88.89,20.47,15.29,10.67
11-11-2020,PORTO MONIZ,0,0,0.0,"Abaixo de 20,0",Muito baixa,MADEIRA,3106,8293.38,2342,143,130,95,98,120,218,313,443,586,28.24,7.07,5.34,3.77
11-11-2020,PORTO SANTO,1,0,19.0,"Abaixo de 20,0",Muito baixa,MADEIRA,3201,4300.7,5202,240,157,134,110,68,178,312,469,709,120.95,16.48,10.9,7.25
11-11-2020,PÓVOA DE LANHOSO,145,10,674.0,"Acima de 240,0 ",Muito elevada,BRAGA,0309,13465.29,21499,1175,909,732,673,624,1297,2029,2938,4113,159.67,30.55,21.82,15.07
11-11-2020,PÓVOA DE VARZIM,584,42,930.0,"Acima de 240,0 ",Muito elevada,PORTO,1313,8220.59,62784,3712,3120,2134,1594,1305,2899,5033,8153,11865,763.7,144.33,99.17,61.22
11-11-2020,POVOAÇÃO,1,0,17.0,"Abaixo de 20,0",Muito baixa,AÇORES,4204,10640.77,5927,293,212,191,144,134,278,469,681,974,55.7,9.15,6.4,4.41
11-11-2020,VILA DA PRAIA DA VITÓRIA,14,1,66.0,"Entre 60,0 e 119,9",Moderada,AÇORES,4302,16127.06,21317,1133,789,619,436,336,772,1391,2180,3313,132.18,20.54,13.52,8.63
11-11-2020,PROENÇA-A-NOVA,50,4,685.0,"Acima de 240,0 ",Muito elevada,CASTELO BRANCO,0508,39539.96,7298,508,465,389,400,560,960,1349,1814,2322,18.46,5.87,4.59,3.41
11-11-2020,REDONDO,51,4,803.0,"Acima de 240,0 ",Muito elevada,ÉVORA,0710,36950.87,6353,349,325,288,288,354,642,930,1255,1604,17.19,4.34,3.4,2.52
11-11-2020,REGUENGOS DE MONSARAZ,31,2,310.0,"Acima de 240,0 ",Muito elevada,ÉVORA,0711,46399.72,10015,602,511,455,462,473,935,1390,1901,2503,21.58,5.39,4.1,3.0
11-11-2020,RESENDE,43,3,424.0,"Acima de 240,0 ",Muito elevada,VISEU,1813,12334.93,10137,560,493,448,433,422,855,1303,1796,2356,82.18,19.1,14.56,10.56
11-11-2020,RIBEIRA BRAVA,5,0,40.0,"Entre 20,0 e 59,9",Baixa,MADEIRA,3107,6544.88,12435,648,500,411,311,287,598,1009,1509,2157,189.99,32.96,23.06,15.42
11-11-2020,RIBEIRA DE PENA,21,1,349.0,"Acima de 240,0 ",Muito elevada,VILA REAL,1709,21745.98,6016,371,301,290,310,368,678,968,1269,1640,27.66,7.54,5.84,4.45
11-11-2020,RIBEIRA GRANDE,26,2,79.0,"Entre 60,0 e 119,9",Moderada,AÇORES,4205,18015.13,32811,1163,689,512,345,253,598,1110,1799,2962,182.13,16.44,9.99,6.16
11-11-2020,RIO MAIOR,49,3,240.0,"Acima de 240,0 ",Muito elevada,SANTARÉM,1414,27276.45,20379,1251,1144,941,795,648,1443,2384,3528,4779,74.71,17.52,12.93,8.74
11-11-2020,SABROSA,35,2,591.0,"Acima de 240,0 ",Muito elevada,VILA REAL,1710,15692.45,5918,393,314,304,302,350,652,956,1270,1663,37.71,10.6,8.09,6.09
11-11-2020,SABUGAL,22,2,208.0,"Entre 120,0 e 239,9",Elevada,GUARDA,0911,82269.82,10585,724,707,694,796,1009,1805,2499,3206,3930,12.87,4.78,3.9,3.04
11-11-2020,SALVATERRA DE MAGOS,101,7,474.0,"Acima de 240,0 ",Muito elevada,SANTARÉM,1415,24393.2,21295,1275,1181,1060,799,772,1571,2631,3812,5087,87.3,20.85,15.63,10.79
11-11-2020,SANTA COMBA DÃO,28,2,268.0,"Acima de 240,0 ",Muito elevada,VISEU,1814,11194.77,10452,732,684,569,538,464,1002,1571,2255,2987,93.36,26.68,20.14,14.03
11-11-2020,SANTA CRUZ,79,6,174.0,"Entre 120,0 e 239,9",Elevada,MADEIRA,3108,8150.28,45281,1817,1301,974,716,523,1239,2213,3514,5331,555.6,65.41,43.12,27.15
11-11-2020,SANTA CRUZ DA GRACIOSA,1,0,24.0,"Entre 20,0 e 59,9",Baixa,AÇORES,4401,6065.78,4208,228,180,163,124,145,269,432,612,840,69.37,13.85,10.09,7.12
11-11-2020,SANTA CRUZ DAS FLORES,0,0,0.0,"Abaixo de 20,0",Muito baixa,AÇORES,4802,7091.44,2165,125,98,74,56,51,107,181,279,404,30.53,5.7,3.93,2.55
11-11-2020,SANTA MARIA DA FEIRA,1273,91,918.0,"Acima de 240,0 ",Muito elevada,AVEIRO,0109,21587.65,138636,8182,6743,4771,3856,3079,6935,11706,18449,26631,642.19,123.36,85.46,54.22
11-11-2020,SANTA MARTA DE PENAGUIÃO,42,3,636.0,"Acima de 240,0 ",Muito elevada,VILA REAL,1711,6928.13,6599,483,373,337,316,317,633,970,1343,1826,95.25,26.36,19.39,14.0
11-11-2020,SANTANA,1,0,15.0,"Abaixo de 20,0",Muito baixa,MADEIRA,3109,9547.3,6711,418,353,343,282,277,559,902,1255,1673,70.29,17.52,13.15,9.45
11-11-2020,SANTARÉM,305,22,531.0,"Acima de 240,0 ",Muito elevada,SANTARÉM,1416,55253.58,57421,3654,3441,2760,2466,2206,4672,7432,10873,14527,103.92,26.29,19.68,13.45
11-11-2020,SANTIAGO DO CACÉM,24,2,83.0,"Entre 60,0 e 119,9",Moderada,SETÚBAL,1509,105969.29,28791,2144,1689,1472,1295,1215,2510,3982,5671,7815,27.17,7.37,5.35,3.76
11-11-2020,SANTO TIRSO,1213,87,1782.0,"Acima de 240,0 ",Muito elevada,PORTO,1314,13655.52,68055,4911,3935,2761,2257,1810,4067,6828,10763,15674,498.35,114.78,78.82,50.0
11-11-2020,SÃO BRÁS DE ALPORTEL,34,2,326.0,"Acima de 240,0 ",Muito elevada,FARO,0812,15336.92,10416,596,468,467,404,401,805,1272,1740,2336,67.91,15.23,11.35,8.29
11-11-2020,SÃO JOÃO DA MADEIRA,225,16,1025.0,"Acima de 240,0 ",Muito elevada,AVEIRO,0116,794.3,21958,1347,1069,796,601,593,1194,1990,3059,4406,2765.49,554.91,385.26,250.63
11-11-2020,SÃO JOÃO DA PESQUEIRA,14,1,196.0,"Entre 120,0 e 239,9",Elevada,VISEU,1815,26610.85,7125,417,330,294,328,328,656,950,1280,1697,26.77,6.38,4.81,3.57
11-11-2020,SÃO PEDRO DO SUL,54,4,351.0,"Acima de 240,0 ",Muito elevada,VISEU,1816,34895.09,15403,990,962,861,759,909,1668,2529,3491,4481,44.14,12.84,10.0,7.25
11-11-2020,SÃO ROQUE DO PICO,1,0,31.0,"Entre 20,0 e 59,9",Baixa,AÇORES,4603,14236.1,3266,199,141,93,96,113,209,302,443,642,22.94,4.51,3.11,2.12
11-11-2020,SÃO VICENTE,0,0,0.0,"Abaixo de 20,0",Muito baixa,MADEIRA,3110,7883.71,5143,272,264,266,225,280,505,771,1035,1307,65.23,16.58,13.13,9.78
11-11-2020,SARDOAL,11,1,294.0,"Acima de 240,0 ",Muito elevada,SANTARÉM,1417,9214.72,3741,227,178,148,165,248,413,561,739,966,40.6,10.48,8.02,6.09
11-11-2020,SÁTÃO,28,2,242.0,"Acima de 240,0 ",Muito elevada,VISEU,1817,20194.11,11580,765,671,515,465,476,941,1456,2127,2892,57.34,14.32,10.53,7.21
11-11-2020,SEIA,153,11,688.0,"Acima de 240,0 ",Muito elevada,GUARDA,0912,43568.83,22234,1807,1589,1238,1122,721,1843,3081,4670,6477,51.03,14.87,10.72,7.07
11-11-2020,SEIXAL,726,52,433.0,"Acima de 240,0 ",Muito elevada,SETÚBAL,1510,9545.17,167752,10586,9270,6661,4391,2930,7321,13982,23252,33838,1757.49,354.51,243.6,146.49
11-11-2020,SERNANCELHE,5,0,93.0,"Entre 60,0 e 119,9",Moderada,VISEU,1818,22861.22,5396,305,293,286,273,260,533,819,1112,1417,23.6,6.2,4.86,3.58
11-11-2020,SERPA,5,0,35.0,"Entre 20,0 e 59,9",Baixa,BEJA,0213,110563.34,14304,903,761,719,697,626,1323,2042,2803,3706,12.94,3.35,2.54,1.85
11-11-2020,SERTÃ,22,2,151.0,"Entre 120,0 e 239,9",Elevada,CASTELO BRANCO,0509,44673.17,14577,870,779,790,767,1020,1787,2577,3356,4226,32.63,9.46,7.51,5.77
11-11-2020,SESIMBRA,194,14,374.0,"Acima de 240,0 ",Muito elevada,SETÚBAL,1511,19571.75,51858,2400,2321,1853,1257,1083,2340,4193,6514,8914,264.96,45.54,33.28,21.42
11-11-2020,SETÚBAL,682,49,592.0,"Acima de 240,0 ",Muito elevada,SETÚBAL,1512,23032.5,115126,7425,6929,5075,3775,2655,6430,11505,18434,25859,499.83,112.27,80.03,49.95
11-11-2020,SEVER DO VOUGA,138,10,1218.0,"Acima de 240,0 ",Muito elevada,AVEIRO,0117,12987.56,11331,766,637,568,540,567,1107,1675,2312,3078,87.24,23.7,17.8,12.9
11-11-2020,SILVES,59,4,163.0,"Entre 120,0 e 239,9",Elevada,FARO,0813,68006.23,36226,2137,1869,1610,1423,1600,3023,4633,6502,8639,53.27,12.7,9.56,6.81
11-11-2020,SINES,78,6,569.0,"Acima de 240,0 ",Muito elevada,SETÚBAL,1513,20330.17,13715,888,791,551,416,268,684,1235,2026,2914,67.46,14.33,9.97,6.07
11-11-2020,SINTRA,1797,128,459.0,"Acima de 240,0 ",Muito elevada,LISBOA,1111,31922.73,391402,20490,18316,13545,9137,7284,16421,29966,48282,68772,1226.08,215.43,151.25,93.87
11-11-2020,SOBRAL DE MONTE AGRAÇO,41,3,385.0,"Acima de 240,0 ",Muito elevada,LISBOA,1112,5210.32,10651,564,507,352,272,212,484,836,1343,1907,204.43,36.6,25.78,16.05
11-11-2020,SOURE,28,2,164.0,"Entre 120,0 e 239,9",Elevada,COIMBRA,0615,26506.07,17120,1173,1142,1004,883,987,1870,2874,4016,5189,64.59,19.58,15.15,10.84
11-11-2020,SOUSEL,13,1,295.0,"Acima de 240,0 ",Muito elevada,PORTALEGRE,1215,27932.18,4412,261,274,208,302,292,594,802,1076,1337,15.8,4.79,3.85,2.87
11-11-2020,TÁBUA,30,2,264.0,"Acima de 240,0 ",Muito elevada,COIMBRA,0616,19978.58,11368,729,584,524,430,464,894,1418,2002,2731,56.9,13.67,10.02,7.1
11-11-2020,TABUAÇO,13,1,215.0,"Entre 120,0 e 239,9",Elevada,VISEU,1819,13385.67,6033,372,314,217,282,363,645,862,1176,1548,45.07,11.56,8.79,6.44
11-11-2020,TAROUCA,16,1,205.0,"Entre 120,0 e 239,9",Elevada,VISEU,1820,10008.49,7804,405,335,313,277,324,601,914,1249,1654,77.98,16.53,12.48,9.13
11-11-2020,TAVIRA,60,4,245.0,"Acima de 240,0 ",Muito elevada,FARO,0814,60696.7,24530,1493,1415,1252,1066,1277,2343,3595,5010,6503,40.41,10.71,8.25,5.92
11-11-2020,TERRAS DE BOURO,13,1,204.0,"Entre 120,0 e 239,9",Elevada,BRAGA,0310,27746.07,6361,391,372,296,319,340,659,955,1327,1718,22.93,6.19,4.78,3.44
11-11-2020,TOMAR,82,6,223.0,"Entre 120,0 e 239,9",Elevada,SANTARÉM,1418,35120.44,36748,2403,2189,1868,1853,1822,3675,5543,7732,10135,104.64,28.86,22.02,15.78
11-11-2020,TONDELA,55,4,209.0,"Entre 120,0 e 239,9",Elevada,VISEU,1821,37121.73,26357,1768,1722,1518,1475,1417,2892,4410,6132,7900,71.0,21.28,16.52,11.88
11-11-2020,TORRE DE MONCORVO,39,3,507.0,"Acima de 240,0 ",Muito elevada,BRAGANÇA,0409,53155.67,7695,556,478,488,551,719,1270,1758,2236,2792,14.48,5.25,4.21,3.31
11-11-2020,TORRES NOVAS,74,5,212.0,"Acima de 240,0 ",Muito elevada,SANTARÉM,1419,26999.68,34933,2324,1979,1738,1406,1475,2881,4619,6598,8922,129.38,33.04,24.44,17.11
11-11-2020,TORRES VEDRAS,178,13,227.0,"Acima de 240,0 ",Muito elevada,LISBOA,1113,40714.89,78530,4513,3945,3447,2628,2104,4732,8179,12124,16637,192.88,40.86,29.78,20.09
11-11-2020,TRANCOSO,108,8,1217.0,"Acima de 240,0 ",Muito elevada,GUARDA,0913,36152.47,8875,581,557,542,586,496,1082,1624,2181,2762,24.55,7.64,6.03,4.49
11-11-2020,TROFA,460,33,1197.0,"Acima de 240,0 ",Muito elevada,PORTO,1318,7201.76,38418,2336,1894,1231,939,684,1623,2854,4748,7084,533.44,98.36,65.93,39.63
11-11-2020,VAGOS,70,5,308.0,"Acima de 240,0 ",Muito elevada,AVEIRO,0118,16491.5,22740,1320,1205,922,784,724,1508,2430,3635,4955,137.89,30.04,22.04,14.73
11-11-2020,VALE DE CAMBRA,143,10,671.0,"Acima de 240,0 ",Muito elevada,AVEIRO,0119,14733.47,21327,1491,1363,1005,831,798,1629,2634,3997,5488,144.76,37.25,27.13,17.88
11-11-2020,VALENÇA,105,7,790.0,"Acima de 240,0 ",Muito elevada,VIANA DO CASTELO,1608,11712.86,13290,867,791,582,582,503,1085,1667,2458,3325,113.46,28.39,20.99,14.23
11-11-2020,VALONGO,993,71,1019.0,"Acima de 240,0 ",Muito elevada,PORTO,1315,7512.45,97444,5629,4696,3207,2462,1829,4291,7498,12194,17823,1297.18,237.26,162.33,99.81
11-11-2020,VALPAÇOS,24,2,162.0,"Entre 120,0 e 239,9",Elevada,VILA REAL,1712,54873.93,14818,1217,1118,999,928,997,1925,2924,4042,5259,27.0,9.58,7.37,5.33
11-11-2020,VELAS,4,0,79.0,"Entre 60,0 e 119,9",Moderada,AÇORES,4502,11738.38,5093,278,208,166,153,113,266,432,640,918,43.39,7.82,5.45,3.68
11-11-2020,VENDAS NOVAS,8,1,71.0,"Entre 60,0 e 119,9",Moderada,ÉVORA,0712,22238.88,11255,677,768,655,501,532,1033,1688,2456,3133,50.61,14.09,11.04,7.59
11-11-2020,VIANA DO ALENTEJO,20,1,389.0,"Acima de 240,0 ",Muito elevada,ÉVORA,0713,39367.29,5145,245,208,235,210,214,424,659,867,1112,13.07,2.82,2.2,1.67
11-11-2020,VIANA DO CASTELO,272,19,322.0,"Acima de 240,0 ",Muito elevada,VIANA DO CASTELO,1609,31902.01,84417,5470,4433,3591,3061,2982,6043,9634,14067,19537,264.61,61.24,44.09,30.2
11-11-2020,VIDIGUEIRA,1,0,18.0,"Abaixo de 20,0",Muito baixa,BEJA,0214,31661.09,5510,300,248,215,233,275,508,723,971,1271,17.4,4.01,3.07,2.28
11-11-2020,VIEIRA DO MINHO,78,6,659.0,"Acima de 240,0 ",Muito elevada,BRAGA,0311,21644.35,11842,703,594,525,548,482,1030,1555,2149,2852,54.71,13.18,9.93,7.18
11-11-2020,VILA DE REI,2,0,60.0,"Entre 60,0 e 119,9",Moderada,CASTELO BRANCO,0510,19154.6,3323,169,128,172,247,302,549,721,849,1018,17.35,5.31,4.43,3.76
11-11-2020,VILA DO BISPO,24,2,466.0,"Acima de 240,0 ",Muito elevada,FARO,0815,17906.06,5154,302,302,314,232,233,465,779,1081,1383,28.78,7.72,6.04,4.35
11-11-2020,VILA DO CONDE,691,49,865.0,"Acima de 240,0 ",Muito elevada,PORTO,1316,14902.77,79899,4726,3875,2819,2070,1743,3813,6632,10507,15233,536.13,102.21,70.5,44.5
11-11-2020,VILA DO PORTO,2,0,36.0,"Entre 20,0 e 59,9",Baixa,AÇORES,4101,9688.74,5616,274,212,135,96,123,219,354,566,840,57.96,8.67,5.84,3.65
11-11-2020,VILA FLOR,17,1,281.0,"Acima de 240,0 ",Muito elevada,BRAGANÇA,0410,26581.14,6044,429,362,422,294,331,625,1047,1409,1838,22.74,6.91,5.3,3.94
11-11-2020,VILA FRANCA DE XIRA,735,53,518.0,"Acima de 240,0 ",Muito elevada,LISBOA,1114,31819.39,141957,8501,6852,4869,3425,2472,5897,10766,17618,26119,446.14,82.09,55.37,33.84
11-11-2020,VILA FRANCA DO CAMPO,1,0,9.0,"Abaixo de 20,0",Muito baixa,AÇORES,4206,7796.82,11051,450,344,248,217,154,371,619,963,1413,141.73,18.12,12.35,7.94
11-11-2020,VILA NOVA DA BARQUINHA,13,1,174.0,"Entre 120,0 e 239,9",Elevada,SANTARÉM,1420,4952.97,7461,415,406,392,364,338,702,1094,1500,1915,150.64,38.66,30.28,22.09
11-11-2020,VILA NOVA DE CERVEIRA,56,4,629.0,"Acima de 240,0 ",Muito elevada,VIANA DO CASTELO,1610,10846.66,8910,531,444,410,384,334,718,1128,1572,2103,82.14,19.39,14.49,10.4
11-11-2020,VILA NOVA DE FAMALICÃO,1776,127,1349.0,"Acima de 240,0 ",Muito elevada,BRAGA,0312,20159.26,131676,7817,6164,4202,3282,2749,6031,10233,16397,24214,653.19,120.12,81.34,50.76
11-11-2020,VILA NOVA DE FOZ CÔA,34,2,523.0,"Acima de 240,0 ",Muito elevada,GUARDA,0914,39815.18,6503,442,385,390,398,429,827,1217,1602,2044,16.33,5.13,4.02,3.06
11-11-2020,VILA NOVA DE GAIA,2638,188,878.0,"Acima de 240,0 ",Muito elevada,PORTO,1317,16846.43,300472,18349,15568,10972,8224,6281,14505,25477,41045,59394,1783.64,352.57,243.65,151.23
11-11-2020,VILA NOVA DE PAIVA,13,1,277.0,"Acima de 240,0 ",Muito elevada,VISEU,1822,17553.28,4687,289,272,233,217,241,458,691,963,1252,26.7,7.13,5.49,3.94
11-11-2020,VILA NOVA DE POIARES,7,1,101.0,"Entre 60,0 e 119,9",Moderada,COIMBRA,0617,8445.3,6939,380,284,262,235,182,417,679,963,1343,82.17,15.9,11.4,8.04
11-11-2020,VILA POUCA DE AGUIAR,66,5,552.0,"Acima de 240,0 ",Muito elevada,VILA REAL,1713,43706.62,11961,860,817,733,601,627,1228,1961,2778,3638,27.37,8.32,6.36,4.49
11-11-2020,VILA REAL,299,21,598.0,"Acima de 240,0 ",Muito elevada,VILA REAL,1714,37880.28,49962,3025,2498,2065,1579,1466,3045,5110,7608,10633,131.9,28.07,20.08,13.49
11-11-2020,VILA REAL DE SANTO ANTÓNIO,54,4,288.0,"Acima de 240,0 ",Muito elevada,FARO,0816,6125.0,18749,1172,1069,811,569,586,1155,1966,3035,4207,306.11,68.69,49.55,32.1
11-11-2020,VILA VELHA DE RÓDÃO,12,1,382.0,"Acima de 240,0 ",Muito elevada,CASTELO BRANCO,0511,32991.16,3144,209,229,180,283,306,589,769,998,1207,9.53,3.66,3.03,2.33
11-11-2020,VILA VERDE,222,16,473.0,"Acima de 240,0 ",Muito elevada,BRAGA,0313,22866.52,46911,2365,2063,1667,1494,1437,2931,4598,6661,9026,205.15,39.47,29.13,20.11
11-11-2020,VILA VIÇOSA,69,5,901.0,"Acima de 240,0 ",Muito elevada,ÉVORA,0714,19485.89,7656,487,379,342,345,324,669,1011,1390,1877,39.29,9.63,7.13,5.19
11-11-2020,VIMIOSO,8,1,199.0,"Entre 120,0 e 239,9",Elevada,BRAGANÇA,0411,48158.51,4023,274,230,261,293,335,628,889,1119,1393,8.35,2.89,2.32,1.85
11-11-2020,VINHAIS,14,1,181.0,"Entre 120,0 e 239,9",Elevada,BRAGANÇA,0412,69475.09,7746,599,577,636,641,815,1456,2092,2669,3268,11.15,4.7,3.84,3.01
11-11-2020,VISEU,305,22,314.0,"Acima de 240,0 ",Muito elevada,VISEU,1823,50710.14,97249,5769,5038,4140,3158,2710,5868,10008,15046,20815,191.77,41.05,29.67,19.74
11-11-2020,VIZELA,634,45,2653.0,"Acima de 240,0 ",Muito elevada,BRAGA,0314,2469.83,23897,1258,928,655,509,371,880,1535,2463,3721,967.49,150.65,99.72,62.15
11-11-2020,VOUZELA,14,1,146.0,"Entre 120,0 e 239,9",Elevada,VISEU,1824,19369.46,9619,626,605,554,532,507,1039,1593,2198,2824,49.66,14.58,11.35,8.22
20-11-2020,ABRANTES,203,15,578.0,"[480,960)",Muito Elevado,SANTARÉM,1401,71469.08,35130,2473,2213,1730,1748,2021,3769,5499,7712,10185,49.15,14.25,10.79,7.69
20-11-2020,ÁGUEDA,273,20,593.0,"[480,960)",Muito Elevado,AVEIRO,0101,33527.44,46075,3237,2713,2090,1635,1496,3131,5221,7934,11171,137.43,33.32,23.66,15.57
20-11-2020,AGUIAR DA BEIRA,11,1,236.0,"[120,240)",Moderado,GUARDA,0901,20676.57,4652,304,281,235,239,148,387,622,903,1207,22.5,5.84,4.37,3.01
20-11-2020,ALANDROAL,10,1,200.0,"[120,240)",Moderado,ÉVORA,0701,54267.81,4992,307,256,296,299,377,676,972,1228,1535,9.2,2.83,2.26,1.79
20-11-2020,ALBERGARIA-A-VELHA,140,10,580.0,"[480,960)",Muito Elevado,AVEIRO,0102,15882.5,24144,1550,1298,996,687,680,1367,2363,3661,5211,152.02,32.81,23.05,14.88
20-11-2020,ALBUFEIRA,125,9,301.0,"[240,480)",Elevado,FARO,0801,14066.42,41528,2067,1717,1425,985,858,1843,3268,4985,7052,295.24,50.14,35.44,23.23
20-11-2020,ALCÁCER DO SAL,31,2,266.0,"[240,480)",Elevado,SETÚBAL,1501,149987.3,11659,884,814,623,623,602,1225,1848,2662,3546,7.77,2.36,1.77,1.23
20-11-2020,ALCANENA,123,9,960.0,"[960, Max)",Extremamente Elevado,SANTARÉM,1402,12732.86,12809,891,744,628,536,588,1124,1752,2496,3387,100.6,26.6,19.6,13.76
20-11-2020,ALCOBAÇA,186,13,347.0,"[240,480)",Elevado,LEIRIA,1001,40814.09,53555,3420,2927,2466,2059,1676,3735,6201,9128,12548,131.22,30.74,22.36,15.19
20-11-2020,ALCOCHETE,58,4,293.0,"[240,480)",Elevado,SETÚBAL,1502,12836.48,19787,857,834,691,476,447,923,1614,2448,3305,154.15,25.75,19.07,12.57
20-11-2020,ALCOUTIM,2,0,93.0,"[60,120)",Moderado,FARO,0802,57536.33,2159,191,188,163,190,267,457,620,808,999,3.75,1.74,1.4,1.08
20-11-2020,ALENQUER,170,12,386.0,"[240,480)",Elevado,LISBOA,1101,30421.92,44052,2298,2062,1629,1330,1155,2485,4114,6176,8474,144.8,27.85,20.3,13.52
20-11-2020,ALFÂNDEGA DA FÉ,44,3,967.0,"[960, Max)",Extremamente Elevado,BRAGANÇA,0401,32194.64,4550,325,277,301,274,325,599,900,1177,1502,14.13,4.67,3.66,2.8
20-11-2020,ALIJÓ,60,4,565.0,"[480,960)",Muito Elevado,VILA REAL,1701,29759.89,10625,766,687,635,542,666,1208,1843,2530,3296,35.7,11.08,8.5,6.19
20-11-2020,ALJEZUR,3,0,54.0,"[20,60)",Moderado,FARO,0803,32349.95,5594,316,336,335,320,410,730,1065,1401,1717,17.29,5.31,4.33,3.29
20-11-2020,ALJUSTREL,19,1,230.0,"[120,240)",Moderado,BEJA,0201,45847.41,8247,635,521,443,347,358,705,1148,1669,2304,17.99,5.03,3.64,2.5
20-11-2020,ALMADA,1117,80,661.0,"[480,960)",Muito Elevado,SETÚBAL,1503,7000.89,169039,10469,9777,7876,6144,5111,11255,19131,28908,39377,2414.5,562.45,412.91,273.26
20-11-2020,ALMEIDA,20,1,343.0,"[240,480)",Elevado,GUARDA,0902,51798.46,5830,441,419,396,458,393,851,1247,1666,2107,11.26,4.07,3.22,2.41
20-11-2020,ALMEIRIM,80,6,355.0,"[240,480)",Elevado,SANTARÉM,1403,22212.05,22546,1342,1353,1106,866,843,1709,2815,4168,5510,101.5,24.81,18.76,12.67
20-11-2020,ALMODÔVAR,6,0,89.0,"[60,120)",Moderado,BEJA,0202,77788.03,6725,414,443,396,373,328,701,1097,1540,1954,8.65,2.51,1.98,1.41
20-11-2020,ALPIARÇA,10,1,142.0,"[120,240)",Moderado,SANTARÉM,1404,9536.33,7059,515,486,363,333,274,607,970,1456,1971,74.02,20.67,15.27,10.17
20-11-2020,ALTER DO CHÃO,7,0,221.0,"[120,240)",Moderado,PORTALEGRE,1201,36206.62,3165,201,163,136,208,187,395,531,694,895,8.74,2.47,1.92,1.47
20-11-2020,ALVAIÁZERE,6,0,91.0,"[60,120)",Moderado,LEIRIA,1002,16047.76,6597,419,389,346,406,539,945,1291,1680,2099,41.11,13.08,10.47,8.04
20-11-2020,ALVITO,1,0,40.0,"[20,60)",Moderado,BEJA,0203,26485.32,2477,145,110,105,111,89,200,305,415,560,9.35,2.11,1.57,1.15
20-11-2020,AMADORA,952,68,517.0,"[480,960)",Muito Elevado,LISBOA,1115,2378.47,184106,11186,10936,8780,6460,5890,12350,21130,32066,43252,7742.05,1818.84,1348.44,888.56
20-11-2020,AMARANTE,606,43,1139.0,"[960, Max)",Extremamente Elevado,PORTO,1301,30133.15,53193,3086,2413,1812,1643,1311,2954,4766,7179,10265,176.53,34.07,23.82,15.82
20-11-2020,AMARES,217,16,1197.0,"[960, Max)",Extremamente Elevado,BRAGA,0301,8195.41,18129,1001,829,622,489,524,1013,1635,2464,3465,221.22,42.28,30.07,19.95
20-11-2020,ANADIA,128,9,470.0,"[240,480)",Elevado,AVEIRO,0103,21663.48,27258,1931,1698,1376,1208,1262,2470,3846,5544,7475,125.83,34.51,25.59,17.75
20-11-2020,ANGRA DO HEROÍSMO,25,2,74.0,"[60,120)",Moderado,AÇORES,4301,23899.66,33807,2006,1473,1122,768,635,1403,2525,3998,6004,141.45,25.12,16.73,10.56
20-11-2020,ANSIÃO,34,2,282.0,"[240,480)",Elevado,LEIRIA,1003,17609.42,12039,727,709,646,694,530,1224,1870,2579,3306,68.37,18.77,14.65,10.62
20-11-2020,ARCOS DE VALDEVEZ,120,9,573.0,"[480,960)",Muito Elevado,VIANA DO CASTELO,1601,44759.64,20926,1329,1338,1282,1343,1515,2858,4140,5478,6807,46.75,15.21,12.24,9.25
20-11-2020,ARGANIL,104,7,944.0,"[480,960)",Muito Elevado,COIMBRA,0601,33283.93,11014,672,648,612,559,596,1155,1767,2415,3087,33.09,9.27,7.26,5.31
20-11-2020,ARMAMAR,49,3,849.0,"[480,960)",Muito Elevado,VISEU,1801,11723.73,5769,357,305,309,285,310,595,904,1209,1566,49.21,13.36,10.31,7.71
20-11-2020,AROUCA,215,15,1038.0,"[960, Max)",Extremamente Elevado,AVEIRO,0104,32910.52,20720,1306,1047,753,683,683,1366,2119,3166,4472,62.96,13.59,9.62,6.44
20-11-2020,ARRAIOLOS,6,0,87.0,"[60,120)",Moderado,ÉVORA,0702,68374.55,6928,435,384,283,367,480,847,1130,1514,1949,10.13,2.85,2.21,1.65
20-11-2020,ARRONCHES,8,1,284.0,"[240,480)",Elevado,PORTALEGRE,1202,31464.72,2820,155,142,162,187,179,366,528,670,825,8.96,2.62,2.13,1.68
20-11-2020,ARRUDA DOS VINHOS,51,4,331.0,"[240,480)",Elevado,LISBOA,1102,7795.93,15412,738,738,562,509,438,947,1509,2247,2985,197.69,38.29,28.82,19.36
20-11-2020,AVEIRO,400,29,508.0,"[480,960)",Muito Elevado,AVEIRO,0105,19757.57,78734,4520,4004,3050,2250,2103,4353,7403,11407,15927,398.49,80.61,57.73,37.47
20-11-2020,AVIS,7,1,165.0,"[120,240)",Moderado,PORTALEGRE,1203,60596.51,4247,315,225,206,251,273,524,730,955,1270,7.01,2.1,1.58,1.2
20-11-2020,AZAMBUJA,127,9,559.0,"[480,960)",Muito Elevado,LISBOA,1103,26265.65,22716,1322,1171,1070,798,618,1416,2486,3657,4979,86.48,18.96,13.92,9.46
20-11-2020,BAIÃO,122,9,651.0,"[480,960)",Muito Elevado,PORTO,1302,17452.83,18748,1070,862,714,686,725,1411,2125,2987,4057,107.42,23.25,17.11,12.18
20-11-2020,BARCELOS,1549,111,1333.0,"[960, Max)",Extremamente Elevado,BRAGA,0302,37890.14,116187,6721,5325,3619,2991,2562,5553,9172,14497,21218,306.64,56.0,38.26,24.21
20-11-2020,BARRANCOS,3,0,184.0,"[120,240)",Moderado,BEJA,0204,16841.73,1634,90,65,65,94,61,155,220,285,375,9.7,2.23,1.69,1.31
20-11-2020,BARREIRO,271,19,361.0,"[240,480)",Elevado,SETÚBAL,1504,3639.07,75147,5194,5565,4459,3105,1767,4872,9331,14896,20090,2065.05,552.07,409.34,256.42
20-11-2020,BATALHA,39,3,244.0,"[240,480)",Elevado,LEIRIA,1004,10341.6,15963,873,762,649,529,549,1078,1727,2489,3362,154.35,32.51,24.07,16.7
20-11-2020,BEJA,49,4,146.0,"[120,240)",Moderado,BEJA,0205,114647.55,33579,2005,1840,1386,1272,1039,2311,3697,5537,7542,29.29,6.58,4.83,3.22
20-11-2020,BELMONTE,108,8,1688.0,"[960, Max)",Extremamente Elevado,CASTELO BRANCO,0501,11875.91,6398,444,321,325,310,355,665,990,1311,1755,53.87,14.78,11.04,8.34
20-11-2020,BENAVENTE,83,6,271.0,"[240,480)",Elevado,SANTARÉM,1405,52138.39,30602,1468,1376,1141,876,643,1519,2660,4036,5504,58.69,10.56,7.74,5.1
20-11-2020,BOMBARRAL,26,2,207.0,"[120,240)",Moderado,LEIRIA,1005,9128.55,12558,875,714,561,491,429,920,1481,2195,3070,137.56,33.63,24.04,16.22
20-11-2020,BORBA,9,1,134.0,"[120,240)",Moderado,ÉVORA,0703,14518.65,6736,430,375,279,436,392,828,1107,1482,1912,46.39,13.17,10.21,7.62
20-11-2020,BOTICAS,26,2,520.0,"[480,960)",Muito Elevado,VILA REAL,1702,32195.66,4998,347,306,311,305,380,685,996,1302,1649,15.52,5.12,4.04,3.09
20-11-2020,BRAGA,2231,159,1221.0,"[960, Max)",Extremamente Elevado,BRAGA,0303,18339.95,182679,10029,7963,5241,4320,3671,7991,13232,21195,31224,996.07,170.25,115.57,72.15
20-11-2020,BRAGANÇA,191,14,568.0,"[480,960)",Muito Elevado,BRAGANÇA,0402,117357.27,33607,2402,1855,1652,1393,1163,2556,4208,6063,8465,28.64,7.21,5.17,3.59
20-11-2020,CABECEIRAS DE BASTO,132,9,845.0,"[480,960)",Muito Elevado,BRAGA,0304,24182.16,15628,774,594,544,575,574,1149,1693,2287,3061,64.63,12.66,9.46,7.0
20-11-2020,CADAVAL,50,4,366.0,"[240,480)",Elevado,LISBOA,1104,17489.3,13673,813,796,756,621,625,1246,2002,2798,3611,78.18,20.65,16.0,11.45
20-11-2020,CALDAS DA RAINHA,113,8,218.0,"[120,240)",Moderado,LEIRIA,1006,25569.47,51912,3035,2684,2186,1899,1705,3604,5790,8474,11509,203.03,45.01,33.14,22.64
20-11-2020,CALHETA,5,0,46.0,"[20,60]",Moderado,MADEIRA,3101,11150.43,10867,576,497,507,399,415,814,1321,1818,2394,97.46,21.47,16.3,11.85
20-11-2020,CALHETA (AÇORES),0,0,0.0,"[0,20}",Moderado,AÇORES,4501,12626.4,3184,215,159,141,139,122,261,402,561,776,25.22,6.15,4.44,3.18
20-11-2020,CÂMARA DE LOBOS,23,2,68.0,"[60,120)",Moderado,MADEIRA,3102,5216.67,33675,1396,1059,834,545,381,926,1760,2819,4215,645.49,80.79,54.03,33.74
20-11-2020,CAMINHA,175,12,1102.0,"[960, Max)",Extremamente Elevado,VIANA DO CASTELO,1602,13652.14,15877,1046,944,818,646,656,1302,2120,3064,4110,116.3,30.11,22.44,15.53
20-11-2020,CAMPO MAIOR,27,2,343.0,"[240,480)",Elevado,PORTALEGRE,1204,24720.16,7874,471,364,351,279,327,606,957,1321,1792,31.85,7.25,5.34,3.87
20-11-2020,CANTANHEDE,180,13,514.0,"[480,960)",Muito Elevado,COIMBRA,0602,39088.02,35011,2346,2096,1880,1709,1451,3160,5040,7136,9482,89.57,24.26,18.26,12.89
20-11-2020,CARRAZEDA DE ANSIÃES,13,1,229.0,"[120,240)",Moderado,BRAGANÇA,0403,27924.09,5666,424,389,391,312,465,777,1168,1557,1981,20.29,7.09,5.58,4.18
20-11-2020,CARREGAL DO SAL,20,1,216.0,"[120,240)",Moderado,VISEU,1802,11689.21,9271,587,562,486,462,376,838,1324,1886,2473,79.31,21.16,16.13,11.33
20-11-2020,CARTAXO,135,10,566.0,"[480,960)",Muito Elevado,SANTARÉM,1406,15817.28,23843,1415,1376,1142,861,632,1493,2635,4011,5426,150.74,34.3,25.36,16.66
20-11-2020,CASCAIS,1307,93,612.0,"[480,960)",Muito Elevado,LISBOA,1105,9740.17,213608,12151,11444,8680,6469,5248,11717,20397,31841,43992,2193.1,451.66,326.91,209.41
20-11-2020,CASTANHEIRA DE PÊRA,5,0,191.0,"[120,240)",Moderado,LEIRIA,1007,6677.45,2614,233,195,157,190,187,377,534,729,962,39.15,14.41,10.92,8.0
20-11-2020,CASTELO BRANCO,191,14,367.0,"[240,480)",Elevado,CASTELO BRANCO,0502,143819.15,51987,3528,3042,2499,2229,2225,4454,6953,9995,13523,36.15,9.4,6.95,4.83
20-11-2020,CASTELO DE PAIVA,194,14,1255.0,"[960, Max)",Extremamente Elevado,AVEIRO,0106,11500.53,15454,881,697,545,420,431,851,1396,2093,2974,134.37,25.86,18.2,12.14
20-11-2020,CASTELO DE VIDE,3,0,103.0,"[60,120)",Moderado,PORTALEGRE,1205,26491.24,2919,204,173,179,147,170,317,496,669,873,11.02,3.3,2.53,1.87
20-11-2020,CASTRO DAIRE,61,4,441.0,"[240,480)",Elevado,VISEU,1803,37904.13,13823,942,857,765,732,773,1505,2270,3127,4069,36.47,10.74,8.25,5.99
20-11-2020,CASTRO MARIM,4,0,64.0,"[60,120)",Moderado,FARO,0804,30084.37,6237,370,345,334,322,344,666,1000,1345,1715,20.73,5.7,4.47,3.32
20-11-2020,CASTRO VERDE,12,1,173.0,"[120,240)",Moderado,BEJA,0206,56944.23,6949,437,347,303,275,227,502,805,1152,1589,12.2,2.79,2.02,1.41
20-11-2020,CELORICO DA BEIRA,131,9,1891.0,"[960, Max)",Extremamente Elevado,GUARDA,0903,24721.63,6928,430,416,363,369,535,904,1267,1683,2113,28.02,8.55,6.81,5.12
20-11-2020,CELORICO DE BASTO,183,13,961.0,"[960, Max)",Extremamente Elevado,BRAGA,0305,18107.02,19040,1001,802,668,728,729,1457,2125,2927,3928,105.15,21.69,16.17,11.74
20-11-2020,CHAMUSCA,38,3,413.0,"[240,480)",Elevado,SANTARÉM,1407,74600.54,9197,629,583,553,465,579,1044,1597,2180,2809,12.33,3.77,2.92,2.14
20-11-2020,CHAVES,333,24,846.0,"[480,960)",Muito Elevado,VILA REAL,1703,59122.95,39343,2676,2429,1991,1886,1918,3804,5795,8224,10900,66.54,18.44,13.91,9.8
20-11-2020,CINFÃES,232,17,1272.0,"[960, Max)",Extremamente Elevado,VISEU,1804,23928.76,18244,1067,902,779,734,758,1492,2271,3173,4240,76.24,17.72,13.26,9.49
20-11-2020,COIMBRA,614,44,458.0,"[240,480)",Elevado,COIMBRA,0603,31939.94,134166,9489,8734,6353,5139,5074,10213,16566,25300,34789,420.06,108.92,79.21,51.87
20-11-2020,CONDEIXA-A-NOVA,72,5,406.0,"[240,480)",Elevado,COIMBRA,0604,13867.47,17733,871,809,717,583,490,1073,1790,2599,3470,127.88,25.02,18.74,12.91
20-11-2020,CONSTÂNCIA,24,2,596.0,"[480,960)",Muito Elevado,SANTARÉM,1408,8036.58,4030,211,183,187,148,155,303,490,673,884,50.14,11.0,8.37,6.1
20-11-2020,CORUCHE,91,7,521.0,"[480,960)",Muito Elevado,SANTARÉM,1409,111572.03,17471,1294,1090,1095,1096,1019,2115,3210,4300,5594,15.66,5.01,3.85,2.88
20-11-2020,CORVO,0,0,0.0,"[0,20]",Moderado,AÇORES,4901,1711.45,464,22,21,11,13,19,32,43,64,86,27.12,5.03,3.74,2.51
20-11-2020,COVILHÃ,316,23,675.0,"[480,960)",Muito Elevado,CASTELO BRANCO,0503,55560.06,46787,3533,2998,2365,2111,2193,4304,6669,9667,13200,84.21,23.76,17.4,12.0
20-11-2020,CRATO,40,3,1278.0,"[960, Max)",Extremamente Elevado,PORTALEGRE,1206,39806.88,3129,229,258,163,182,228,410,573,831,1060,7.86,2.66,2.09,1.44
20-11-2020,CUBA,13,1,283.0,"[240,480)",Elevado,BEJA,0207,17208.72,4595,255,233,206,190,143,333,539,772,1027,26.7,5.97,4.49,3.13
20-11-2020,ELVAS,69,5,336.0,"[240,480)",Elevado,PORTALEGRE,1207,63128.86,20528,1057,1145,902,852,810,1662,2564,3709,4766,32.52,7.55,5.88,4.06
20-11-2020,ENTRONCAMENTO,75,5,348.0,"[240,480)",Elevado,SANTARÉM,1410,1372.81,21558,1066,930,868,695,592,1287,2155,3085,4151,1570.14,302.33,224.69,156.96
20-11-2020,ESPINHO,370,26,1254.0,"[960, Max)",Extremamente Elevado,AVEIRO,0107,2105.68,29516,2205,1993,1430,1177,960,2137,3567,5560,7765,1401.52,368.71,264.01,169.37
20-11-2020,ESPOSENDE,278,20,813.0,"[480,960)",Muito Elevado,BRAGA,0306,9540.98,34177,1831,1522,1095,894,723,1617,2712,4234,6065,358.21,63.57,44.38,28.42
20-11-2020,ESTARREJA,163,12,627.0,"[480,960)",Muito Elevado,AVEIRO,0108,10817.33,26006,1503,1399,1106,953,728,1681,2787,4186,5689,240.42,52.59,38.7,25.76
20-11-2020,ESTREMOZ,34,2,267.0,"[240,480)",Elevado,ÉVORA,0704,51379.95,12728,789,613,697,786,877,1663,2360,2973,3762,24.77,7.32,5.79,4.59
20-11-2020,ÉVORA,208,15,397.0,"[240,480)",Elevado,ÉVORA,0705,130707.58,52428,3569,2852,2176,1966,1803,3769,5945,8797,12366,40.11,9.46,6.73,4.55
20-11-2020,FAFE,997,71,2074.0,"[960, Max)",Extremamente Elevado,BRAGA,0307,21908.11,48060,3044,2455,1679,1403,1208,2611,4290,6745,9789,219.37,44.68,30.79,19.58
20-11-2020,FARO,184,13,302.0,"[240,480)",Elevado,FARO,0805,20256.79,61015,3847,3364,2604,2055,1601,3656,6260,9624,13471,301.2,66.5,47.51,30.9
20-11-2020,FELGUEIRAS,1253,90,2221.0,"[960, Max)",Extremamente Elevado,PORTO,1303,11573.75,56422,2951,2302,1601,1316,973,2289,3890,6192,9143,487.49,79.0,53.5,33.61
20-11-2020,FERREIRA DO ALENTEJO,15,1,191.0,"[120,240)",Moderado,BEJA,0208,64820.68,7845,515,414,372,343,345,688,1060,1474,1989,12.1,3.07,2.27,1.64
20-11-2020,FERREIRA DO ZÊZERE,14,1,176.0,"[120,240)",Moderado,SANTARÉM,1411,19038.03,7959,470,370,416,465,456,921,1337,1707,2177,41.81,11.44,8.97,7.02
20-11-2020,FIGUEIRA DA FOZ,372,27,633.0,"[480,960)",Muito Elevado,COIMBRA,0605,37905.26,58747,4032,3597,2887,2495,2043,4538,7425,11022,15054,154.98,39.72,29.08,19.59
20-11-2020,FIGUEIRA DE CASTELO RODRIGO,82,6,1468.0,"[960, Max)",Extremamente Elevado,GUARDA,0904,50857.46,5584,347,352,290,352,391,743,1033,1385,1732,10.98,3.41,2.72,2.03
20-11-2020,FIGUEIRÓ DOS VINHOS,8,1,144.0,"[120,240)",Moderado,LEIRIA,1008,17344.0,5568,402,386,322,309,351,660,982,1368,1770,32.1,10.21,7.89,5.66
20-11-2020,FORNOS DE ALGODRES,9,1,199.0,"[120,240)",Moderado,GUARDA,0905,13145.05,4528,261,218,247,256,232,488,735,953,1214,34.45,9.24,7.25,5.59
20-11-2020,FREIXO DE ESPADA À CINTA,77,6,2335.0,"[960, Max)",Extremamente Elevado,BRAGANÇA,0404,24414.29,3298,211,177,231,196,189,385,616,793,1004,13.51,4.11,3.25,2.52
20-11-2020,FRONTEIRA,6,0,202.0,"[120,240)",Moderado,PORTALEGRE,1208,24859.58,2974,213,182,149,156,168,324,473,655,868,11.96,3.49,2.63,1.9
20-11-2020,FUNCHAL,83,6,80.0,"[60,120)",Moderado,MADEIRA,3103,7616.2,104024,6382,5086,3643,2821,1990,4811,8454,13540,19922,1365.86,261.58,177.78,111.0
20-11-2020,FUNDÃO,188,13,710.0,"[480,960)",Muito Elevado,CASTELO BRANCO,0504,70019.79,26495,1781,1464,1432,1357,1643,3000,4432,5896,7677,37.84,10.96,8.42,6.33
20-11-2020,GAVIÃO,13,1,398.0,"[240,480)",Elevado,PORTALEGRE,1209,29459.45,3263,189,186,222,263,293,556,778,964,1153,11.08,3.91,3.27,2.64
20-11-2020,GÓIS,4,0,105.0,"[60,120)",Moderado,COIMBRA,0606,26330.19,3805,235,199,240,233,244,477,717,916,1151,14.45,4.37,3.48,2.72
20-11-2020,GOLEGÃ,10,1,187.0,"[120,240)",Moderado,SANTARÉM,1412,8431.67,5339,356,299,281,243,255,498,779,1078,1434,63.32,17.01,12.78,9.24
20-11-2020,GONDOMAR,1997,143,1203.0,"[960, Max)",Extremamente Elevado,PORTO,1304,13191.76,165985,10555,8755,6222,4450,3364,7814,14036,22791,33346,1258.22,252.77,172.76,106.4
20-11-2020,GOUVEIA,26,2,210.0,"[120,240)",Moderado,GUARDA,0906,30061.17,12387,871,931,780,783,810,1593,2373,3304,4175,41.21,13.89,10.99,7.89
20-11-2020,GRÂNDOLA,49,4,335.0,"[240,480)",Elevado,SETÚBAL,1505,82593.66,14639,834,834,708,688,672,1360,2068,2902,3736,17.72,4.52,3.51,2.5
20-11-2020,GUARDA,300,21,770.0,"[480,960)",Muito Elevado,GUARDA,0907,71209.58,38969,2477,2041,1686,1415,1474,2889,4575,6616,9093,54.72,12.77,9.29,6.42
20-11-2020,GUIMARÃES,3569,255,2343.0,"[960, Max)",Extremamente Elevado,BRAGA,0308,24099.96,152309,9394,7074,4809,3877,2948,6825,11634,18708,28102,631.99,116.61,77.63,48.27
20-11-2020,HORTA,6,0,41.0,"[20,60)",Moderado,AÇORES,4701,17305.53,14521,818,658,468,352,302,654,1122,1780,2598,83.91,15.01,10.29,6.48
20-11-2020,IDANHA-A-NOVA,28,2,348.0,"[240,480)",Elevado,CASTELO BRANCO,0505,141633.51,8043,518,490,519,672,974,1646,2165,2655,3173,5.68,2.24,1.87,1.53
20-11-2020,ÍLHAVO,229,16,592.0,"[480,960)",Muito Elevado,AVEIRO,0110,7347.55,38699,2227,1943,1444,1193,850,2043,3487,5430,7657,526.66,104.21,73.9,47.46
20-11-2020,LAGOA (FARO),67,5,294.0,"[240,480)",Elevado,FARO,0806,8825.45,22762,1314,1168,919,749,670,1419,2338,3506,4820,257.93,54.62,39.73,26.49
20-11-2020,LAGOA,28,2,190.0,"[120,240)",Moderado,AÇORES,4201,4559.32,14721,536,458,349,238,235,473,822,1280,1816,322.9,39.83,28.08,18.03
20-11-2020,LAGOS,77,6,254.0,"[240,480)",Elevado,FARO,0807,21299.27,30374,1744,1434,1247,1053,1029,2082,3329,4763,6507,142.61,30.55,22.36,15.63
20-11-2020,LAJES DAS FLORES,0,0,0.0,"[0,20)",Moderado,AÇORES,4801,7004.79,1463,88,53,62,46,54,100,162,215,303,20.89,4.33,3.07,2.31
20-11-2020,LAJES DO PICO,0,0,0.0,"[0,20)",Moderado,AÇORES,4601,15531.09,4490,304,231,223,159,162,321,544,775,1079,28.91,6.95,4.99,3.5
20-11-2020,LAMEGO,124,9,498.0,"[480,960)",Muito Elevado,VISEU,1805,16542.11,24895,1639,1284,1124,898,783,1681,2805,4089,5728,150.5,34.63,24.72,16.96
20-11-2020,LEIRIA,386,28,308.0,"[240,480)",Elevado,LEIRIA,1009,56508.83,125267,7389,6366,5090,3902,3159,7061,12151,18517,25906,221.68,45.84,32.77,21.5
20-11-2020,LISBOA,3184,227,625.0,"[480,960)",Muito Elevado,LISBOA,1106,10005.43,509515,33197,33340,27706,23037,26770,49807,77513,110853,144050,5092.6,1439.78,1107.98,774.74
20-11-2020,LOULÉ,164,12,239.0,"[120,240)",Moderado,FARO,0808,76366.91,68697,3890,3350,2780,2358,2251,4609,7389,10739,14629,89.96,19.16,14.06,9.68
20-11-2020,LOURES,1248,89,584.0,"[480,960)",Muito Elevado,LISBOA,1107,16723.99,213687,12746,12794,9644,6669,5033,11702,21346,34140,46886,1277.73,280.35,204.14,127.64
20-11-2020,LOURINHÃ,41,3,159.0,"[120,240)",Moderado,LISBOA,1108,14717.2,25855,1584,1243,992,842,645,1487,2479,3722,5306,175.68,36.05,25.29,16.84
20-11-2020,LOUSÃ,77,6,449.0,"[240,480)",Elevado,COIMBRA,0607,13840.01,17158,946,866,658,528,450,978,1636,2502,3448,123.97,24.91,18.08,11.82
20-11-2020,LOUSADA,1305,93,2791.0,"[960, Max)",Extremamente Elevado,PORTO,1305,9608.01,46755,2289,1698,1176,853,621,1474,2650,4348,6637,486.63,69.08,45.25,27.58
20-11-2020,MAÇÃO,12,1,191.0,"[120,240)",Moderado,SANTARÉM,1413,39997.98,6267,386,362,390,440,657,1097,1487,1849,2235,15.67,5.59,4.62,3.72
20-11-2020,MACEDO DE CAVALEIROS,105,7,723.0,"[480,960)",Muito Elevado,BRAGANÇA,0405,69914.08,14516,1082,889,878,823,938,1761,2639,3528,4610,20.76,6.59,5.05,3.77
20-11-2020,MACHICO,8,1,40.0,"[20,60)",Moderado,MADEIRA,3104,6825.1,19981,1197,860,662,455,331,786,1448,2308,3505,292.76,51.36,33.82,21.22
20-11-2020,MADALENA,0,0,0.0,"[0,20)",Moderado,AÇORES,4602,14712.33,5895,334,256,173,190,179,369,542,798,1132,40.07,7.69,5.42,3.68
20-11-2020,MAFRA,388,28,457.0,"[240,480)",Elevado,LISBOA,1109,29165.5,84816,3613,3334,2839,2089,1899,3988,6827,10161,13774,290.81,47.23,34.84,23.41
20-11-2020,MAIA,1359,97,978.0,"[960, Max)",Extremamente Elevado,PORTO,1306,8293.94,138971,7801,6617,4512,3339,2631,5970,10482,17099,24900,1675.56,300.22,206.16,126.38
20-11-2020,MANGUALDE,97,7,524.0,"[480,960)",Muito Elevado,VISEU,1806,21925.56,18510,1198,1128,885,852,743,1595,2480,3608,4806,84.42,21.92,16.46,11.31
20-11-2020,MANTEIGAS,61,4,2029.0,"[960, Max)",Extremamente Elevado,GUARDA,0908,12197.55,3007,258,197,159,167,146,313,472,669,927,24.65,7.6,5.48,3.87
20-11-2020,MARCO DE CANAVESES,772,55,1499.0,"[960, Max)",Extremamente Elevado,PORTO,1307,20188.98,51496,2678,2060,1488,1265,1023,2288,3776,5836,8514,255.07,42.17,28.91,18.7
20-11-2020,MARINHA GRANDE,103,7,267.0,"[240,480)",Elevado,LEIRIA,1010,18725.19,38508,2365,2302,1638,1359,1058,2417,4055,6357,8722,205.65,46.58,33.95,21.66
20-11-2020,MARVÃO,4,0,133.0,"[120,240)",Moderado,PORTALEGRE,1210,15489.9,3005,198,185,142,197,237,434,576,761,959,19.4,6.19,4.91,3.72
20-11-2020,MATOSINHOS,1866,133,1064.0,"[960, Max)",Extremamente Elevado,PORTO,1308,6241.97,175357,11850,9977,7023,5024,3884,8908,15931,25908,37758,2809.31,604.9,415.06,255.22
20-11-2020,MEALHADA,145,10,728.0,"[480,960)",Muito Elevado,AVEIRO,0111,11065.66,19914,1163,1039,810,828,831,1659,2469,3508,4671,179.96,42.21,31.7,22.31
20-11-2020,MÊDA,24,2,523.0,"[480,960)",Muito Elevado,GUARDA,0909,28604.92,4587,343,306,290,288,443,731,1021,1327,1670,16.04,5.84,4.64,3.57
20-11-2020,MELGAÇO,22,2,272.0,"[240,480)",Elevado,VIANA DO CASTELO,1603,23824.58,8093,507,567,578,614,675,1289,1867,2434,2941,33.97,12.34,10.22,7.84
20-11-2020,MÉRTOLA,3,0,49.0,"[20,60)",Moderado,BEJA,0209,129287.34,6142,400,390,378,423,600,1023,1401,1791,2191,4.75,1.69,1.39,1.08
20-11-2020,MESÃO FRIO,10,1,252.0,"[240,480)",Elevado,VILA REAL,1704,2664.87,3964,265,205,168,157,120,277,445,650,915,148.74,34.33,24.39,16.7
20-11-2020,MIRA,56,4,473.0,"[240,480)",Elevado,COIMBRA,0608,12403.38,11832,727,729,659,550,466,1016,1675,2404,3131,95.4,25.24,19.38,13.5
20-11-2020,MIRANDA DO CORVO,120,9,944.0,"[480,960)",Muito Elevado,COIMBRA,0609,12637.79,12708,706,659,568,498,404,902,1470,2129,2835,100.55,22.43,16.85,11.63
20-11-2020,MIRANDA DO DOURO,28,2,410.0,"[240,480)",Elevado,BRAGANÇA,0406,48718.31,6830,482,429,442,463,470,933,1375,1804,2286,14.02,4.69,3.7,2.82
20-11-2020,MIRANDELA,109,8,501.0,"[480,960)",Muito Elevado,BRAGANÇA,0407,65895.67,21754,1640,1315,1204,1078,947,2025,3229,4544,6184,33.01,9.38,6.9,4.9
20-11-2020,MOGADOURO,58,4,691.0,"[480,960)",Muito Elevado,BRAGANÇA,0408,76064.93,8392,589,529,576,630,655,1285,1861,2390,2979,11.03,3.92,3.14,2.45
20-11-2020,MOIMENTA DA BEIRA,15,1,154.0,"[120,240)",Moderado,VISEU,1807,21996.9,9736,576,514,471,416,461,877,1348,1862,2438,44.26,11.08,8.46,6.13
20-11-2020,MOITA,230,16,357.0,"[240,480)",Elevado,SETÚBAL,1506,5525.98,64407,4226,3646,2623,1801,1425,3226,5849,9495,13721,1165.53,248.3,171.82,105.85
20-11-2020,MONÇÃO,55,4,308.0,"[240,480)",Elevado,VIANA DO CASTELO,1604,21130.85,17869,1161,1105,1031,1006,972,1978,3009,4114,5275,84.56,24.96,19.47,14.24
20-11-2020,MONCHIQUE,8,1,158.0,"[120,240)",Moderado,FARO,0809,39530.43,5077,353,384,321,355,392,747,1068,1452,1805,12.84,4.57,3.67,2.7
20-11-2020,MONDIM DE BASTO,48,3,691.0,"[480,960)",Muito Elevado,VILA REAL,1705,17207.52,6946,395,300,314,284,283,567,881,1181,1576,40.36,9.16,6.86,5.12
20-11-2020,MONFORTE,14,1,471.0,"[240,480)",Elevado,PORTALEGRE,1211,42024.82,2975,139,115,117,192,168,360,477,592,731,7.08,1.74,1.41,1.14
20-11-2020,MONTALEGRE,42,3,467.0,"[240,480)",Elevado,VILA REAL,1706,80545.71,8997,699,628,595,603,730,1333,1928,2556,3255,11.17,4.04,3.17,2.39
20-11-2020,MONTEMOR-O-NOVO,38,3,243.0,"[240,480)",Elevado,ÉVORA,0706,123296.65,15647,991,953,868,878,971,1849,2717,3670,4661,12.69,3.78,2.98,2.2
20-11-2020,MONTEMOR-O-VELHO,79,6,313.0,"[240,480)",Elevado,COIMBRA,0610,22896.23,25224,1496,1397,1217,1057,988,2045,3262,4659,6155,110.17,26.88,20.35,14.25
20-11-2020,MONTIJO,198,14,344.0,"[240,480)",Elevado,SETÚBAL,1507,34861.64,57614,2771,2441,1990,1554,1109,2663,4653,7094,9865,165.26,28.3,20.35,13.35
20-11-2020,MORA,33,2,797.0,"[480,960)",Muito Elevado,ÉVORA,0707,44395.02,4138,336,275,252,238,257,495,747,1022,1358,9.32,3.06,2.3,1.68
20-11-2020,MORTÁGUA,24,2,273.0,"[240,480)",Elevado,VISEU,1808,25117.82,8803,638,584,535,499,460,959,1494,2078,2716,35.05,10.81,8.27,5.95
20-11-2020,MOURA,8,1,58.0,"[20,60)",Moderado,BEJA,0210,95845.55,13718,817,656,665,542,461,1003,1668,2324,3141,14.31,3.28,2.42,1.74
20-11-2020,MOURÃO,1,0,41.0,"[20,60)",Moderado,ÉVORA,0708,27862.98,2450,139,108,80,104,109,213,293,401,540,8.79,1.94,1.44,1.05
20-11-2020,MURÇA,38,3,696.0,"[480,960)",Muito Elevado,VILA REAL,1707,18937.11,5463,384,341,307,306,319,625,932,1273,1657,28.85,8.75,6.72,4.92
20-11-2020,MURTOSA,72,5,700.0,"[480,960)",Muito Elevado,AVEIRO,0112,7308.78,10279,509,473,403,353,409,762,1165,1638,2147,140.63,29.37,22.41,15.94
20-11-2020,NAZARÉ,72,5,508.0,"[480,960)",Muito Elevado,LEIRIA,1011,8243.43,14165,967,903,670,420,396,816,1486,2389,3356,171.84,40.71,28.98,18.03
20-11-2020,NELAS,48,3,370.0,"[240,480)",Elevado,VISEU,1809,12571.48,12974,924,787,668,604,583,1187,1855,2642,3566,103.21,28.37,21.02,14.76
20-11-2020,NISA,37,3,610.0,"[480,960)",Muito Elevado,PORTALEGRE,1212,57567.84,6061,405,389,355,483,478,961,1316,1705,2110,10.53,3.67,2.96,2.29
20-11-2020,NORDESTE,1,0,21.0,"[20,60)",Moderado,AÇORES,4202,10146.8,4862,246,180,124,161,162,323,447,627,873,47.92,8.6,6.18,4.41
20-11-2020,ÓBIDOS,27,2,228.0,"[120,240)",Moderado,LEIRIA,1012,14155.44,11850,743,650,574,452,436,888,1462,2112,2855,83.72,20.17,14.92,10.33
20-11-2020,ODEMIRA,49,3,198.0,"[120,240)",Moderado,BEJA,0211,172060.15,24717,1475,1317,1225,1397,1349,2746,3971,5288,6763,14.37,3.93,3.07,2.31
20-11-2020,ODIVELAS,912,65,564.0,"[480,960)",Muito Elevado,LISBOA,1116,2654.36,161774,9562,9038,6952,4641,3812,8453,15405,24443,34005,6095.48,1281.27,920.99,580.44
20-11-2020,OEIRAS,734,52,414.0,"[240,480)",Elevado,LISBOA,1110,4588.31,177408,11580,11575,8566,6211,5855,12066,20632,32207,43787,3866.78,954.38,701.98,449.69
20-11-2020,OLEIROS,26,2,520.0,"[480,960)",Muito Elevado,CASTELO BRANCO,0506,47109.31,5003,384,341,366,397,487,884,1250,1591,1975,10.62,4.19,3.38,2.65
20-11-2020,OLHÃO,86,6,194.0,"[120,240)",Moderado,FARO,0810,13086.38,44405,2455,2309,1689,1342,1268,2610,4299,6608,9063,339.33,69.26,50.5,32.85
20-11-2020,OLIVEIRA DE AZEMÉIS,985,70,1492.0,"[960, Max)",Extremamente Elevado,AVEIRO,0113,16110.41,66011,4155,3614,2794,2183,1738,3921,6715,10329,14484,409.75,89.91,64.12,41.68
20-11-2020,OLIVEIRA DE FRADES,58,4,584.0,"[480,960)",Muito Elevado,VISEU,1810,14534.62,9936,553,475,438,359,415,774,1212,1687,2240,68.36,15.41,11.61,8.34
20-11-2020,OLIVEIRA DO BAIRRO,150,11,618.0,"[480,960)",Muito Elevado,AVEIRO,0114,8731.99,24277,1327,1182,999,786,810,1596,2595,3777,5104,278.02,58.45,43.25,29.72
20-11-2020,OLIVEIRA DO HOSPITAL,29,2,151.0,"[120,240)",Moderado,COIMBRA,0611,23451.66,19253,1161,1097,962,924,960,1884,2846,3943,5104,82.1,21.76,16.81,12.14
20-11-2020,OURÉM,257,18,584.0,"[480,960)",Muito Elevado,SANTARÉM,1421,41668.03,44044,2463,2069,1899,1817,1603,3420,5319,7388,9851,105.7,23.64,17.73,12.77
20-11-2020,OURIQUE,3,0,65.0,"[60,120)",Moderado,BEJA,0212,66331.36,4607,313,287,284,268,227,495,779,1066,1379,6.95,2.08,1.61,1.17
20-11-2020,OVAR,545,39,1004.0,"[960, Max)",Extremamente Elevado,AVEIRO,0115,14770.25,54260,3294,2709,1994,1636,1234,2870,4864,7573,10867,367.37,73.57,51.27,32.93
20-11-2020,PAÇOS DE FERREIRA,1437,103,2533.0,"[960, Max)",Extremamente Elevado,PORTO,1309,7099.29,56728,2903,2193,1518,1135,664,1799,3317,5510,8413,799.1,118.51,77.62,46.72
20-11-2020,PALMELA,221,16,344.0,"[240,480)",Elevado,SETÚBAL,1508,46512.01,64269,3402,3244,2635,1846,1391,3237,5872,9116,12518,138.18,26.91,19.6,12.62
20-11-2020,PAMPILHOSA DA SERRA,28,2,694.0,"[480,960)",Muito Elevado,COIMBRA,0612,39646.24,4037,238,254,295,339,423,762,1057,1311,1549,10.18,3.91,3.31,2.67
20-11-2020,PAREDES,1469,105,1707.0,"[960, Max)",Extremamente Elevado,PORTO,1310,15675.69,86067,4272,3532,2412,1717,1258,2975,5387,8919,13191,549.04,84.15,56.9,34.36
20-11-2020,PAREDES DE COURA,27,2,316.0,"[240,480)",Elevado,VIANA DO CASTELO,1605,13818.59,8535,466,528,407,465,515,980,1387,1915,2381,61.76,17.23,13.86,10.04
20-11-2020,PEDRÓGÃO GRANDE,6,0,176.0,"[120,240)",Moderado,LEIRIA,1013,12874.75,3410,175,173,196,221,252,473,669,842,1017,26.49,7.9,6.54,5.2
20-11-2020,PENACOVA,68,5,497.0,"[480,960)",Muito Elevado,COIMBRA,0613,21673.23,13694,968,923,745,621,703,1324,2069,2992,3960,63.18,18.27,13.81,9.55
20-11-2020,PENAFIEL,1471,105,2108.0,"[960, Max)",Extremamente Elevado,PORTO,1311,21224.27,69772,3648,2823,2032,1663,1230,2893,4925,7748,11396,328.74,53.69,36.51,23.2
20-11-2020,PENALVA DO CASTELO,27,2,379.0,"[240,480)",Elevado,VISEU,1811,13433.92,7115,449,457,413,391,426,817,1230,1687,2136,52.96,15.9,12.56,9.16
20-11-2020,PENAMACOR,24,2,505.0,"[480,960)",Muito Elevado,CASTELO BRANCO,0507,56370.69,4755,262,248,273,451,633,1084,1357,1605,1867,8.44,3.31,2.85,2.41
20-11-2020,PENEDONO,7,0,270.0,"[240,480)",Elevado,VISEU,1812,13370.75,2591,172,113,129,156,138,294,423,536,708,19.38,5.3,4.01,3.16
20-11-2020,PENELA,28,2,519.0,"[480,960)",Muito Elevado,COIMBRA,0614,13480.0,5397,314,324,274,359,344,703,977,1301,1615,40.04,11.98,9.65,7.25
20-11-2020,PENICHE,110,8,415.0,"[240,480)",Elevado,LEIRIA,1014,7754.98,26501,1746,1504,1203,926,707,1633,2836,4340,6086,341.73,78.48,55.96,36.57
20-11-2020,PESO DA RÉGUA,53,4,336.0,"[240,480)",Elevado,VILA REAL,1708,9486.01,15773,1076,843,650,659,455,1114,1764,2607,3683,166.28,38.83,27.48,18.6
20-11-2020,PINHEL,10,1,117.0,"[60,120)",Moderado,GUARDA,0910,48452.12,8511,577,566,551,538,689,1227,1778,2344,2921,17.57,6.03,4.84,3.67
20-11-2020,POMBAL,296,21,575.0,"[480,960)",Muito Elevado,LEIRIA,1015,62600.28,51461,3187,2791,2494,2328,2027,4355,6849,9640,12827,82.21,20.49,15.4,10.94
20-11-2020,PONTA DELGADA,127,9,187.0,"[120,240)",Moderado,AÇORES,4203,23298.65,67935,3108,2435,1726,1133,902,2035,3761,6196,9304,291.58,39.93,26.59,16.14
20-11-2020,PONTA DO SOL,5,0,58.0,"[20,60)",Moderado,MADEIRA,3105,4622.03,8593,319,283,347,208,221,429,776,1059,1378,185.92,29.81,22.91,16.79
20-11-2020,PONTE DA BARCA,33,2,295.0,"[240,480)",Elevado,VIANA DO CASTELO,1606,18211.37,11180,635,576,517,554,490,1044,1561,2137,2772,61.39,15.22,11.73,8.57
20-11-2020,PONTE DE LIMA,359,26,869.0,"[480,960)",Muito Elevado,VIANA DO CASTELO,1607,32025.46,41315,2321,2022,1720,1596,1462,3058,4778,6800,9121,129.01,28.48,21.23,14.92
20-11-2020,PONTE DE SOR,38,3,253.0,"[240,480)",Elevado,PORTALEGRE,1213,83971.16,14994,939,800,716,739,831,1570,2286,3086,4025,17.86,4.79,3.68,2.72
20-11-2020,PORTALEGRE,294,21,1326.0,"[960, Max)",Extremamente Elevado,PORTALEGRE,1214,44713.64,22172,1577,1351,1137,993,984,1977,3114,4465,6042,49.59,13.51,9.99,6.96
20-11-2020,PORTEL,2,0,34.0,"[20,60)",Moderado,ÉVORA,0709,60100.57,5828,336,358,283,331,305,636,919,1277,1613,9.7,2.68,2.12,1.53
20-11-2020,PORTIMÃO,205,15,369.0,"[240,480)",Elevado,FARO,0811,18206.29,55483,3182,2927,2116,1582,1400,2982,5098,8025,11207,304.75,61.56,44.08,28.0
20-11-2020,PORTO,2372,169,1095.0,"[960, Max)",Extremamente Elevado,PORTO,1312,4142.02,216606,15790,15193,11280,9409,10044,19453,30733,45926,61716,5229.5,1490.0,1108.79,741.98
20-11-2020,PORTO DE MÓS,73,5,314.0,"[240,480)",Elevado,LEIRIA,1016,26183.41,23275,1355,1210,1034,888,872,1760,2794,4004,5359,88.89,20.47,15.29,10.67
20-11-2020,PORTO MONIZ,0,0,0.0,"[0,20)",Moderado,MADEIRA,3106,8293.38,2342,143,130,95,98,120,218,313,443,586,28.24,7.07,5.34,3.77
20-11-2020,PORTO SANTO,1,0,19.0,"[0,20)",Moderado,MADEIRA,3201,4300.7,5202,240,157,134,110,68,178,312,469,709,120.95,16.48,10.9,7.25
20-11-2020,PÓVOA DE LANHOSO,286,20,1330.0,"[960, Max)",Extremamente Elevado,BRAGA,0309,13465.29,21499,1175,909,732,673,624,1297,2029,2938,4113,159.67,30.55,21.82,15.07
20-11-2020,PÓVOA DE VARZIM,1021,73,1626.0,"[960, Max)",Extremamente Elevado,PORTO,1313,8220.59,62784,3712,3120,2134,1594,1305,2899,5033,8153,11865,763.7,144.33,99.17,61.22
20-11-2020,POVOAÇÃO,2,0,34.0,"[20,60)",Moderado,AÇORES,4204,10640.77,5927,293,212,191,144,134,278,469,681,974,55.7,9.15,6.4,4.41
20-11-2020,VILA DA PRAIA DA VITÓRIA,29,2,136.0,"[120,240)",Moderado,AÇORES,4302,16127.06,21317,1133,789,619,436,336,772,1391,2180,3313,132.18,20.54,13.52,8.63
20-11-2020,PROENÇA-A-NOVA,46,3,630.0,"[480,960)",Muito Elevado,CASTELO BRANCO,0508,39539.96,7298,508,465,389,400,560,960,1349,1814,2322,18.46,5.87,4.59,3.41
20-11-2020,REDONDO,24,2,378.0,"[240,480)",Elevado,ÉVORA,0710,36950.87,6353,349,325,288,288,354,642,930,1255,1604,17.19,4.34,3.4,2.52
20-11-2020,REGUENGOS DE MONSARAZ,56,4,559.0,"[480,960)",Muito Elevado,ÉVORA,0711,46399.72,10015,602,511,455,462,473,935,1390,1901,2503,21.58,5.39,4.1,3.0
20-11-2020,RESENDE,51,4,503.0,"[480,960)",Muito Elevado,VISEU,1813,12334.93,10137,560,493,448,433,422,855,1303,1796,2356,82.18,19.1,14.56,10.56
20-11-2020,RIBEIRA BRAVA,6,0,48.0,"[20,60)",Moderado,MADEIRA,3107,6544.88,12435,648,500,411,311,287,598,1009,1509,2157,189.99,32.96,23.06,15.42
20-11-2020,RIBEIRA DE PENA,26,2,432.0,"[240,480)",Elevado,VILA REAL,1709,21745.98,6016,371,301,290,310,368,678,968,1269,1640,27.66,7.54,5.84,4.45
20-11-2020,RIBEIRA GRANDE,54,4,165.0,"[120,240)",Moderado,AÇORES,4205,18015.13,32811,1163,689,512,345,253,598,1110,1799,2962,182.13,16.44,9.99,6.16
20-11-2020,RIO MAIOR,67,5,329.0,"[240,480)",Elevado,SANTARÉM,1414,27276.45,20379,1251,1144,941,795,648,1443,2384,3528,4779,74.71,17.52,12.93,8.74
20-11-2020,SABROSA,32,2,541.0,"[480,960)",Muito Elevado,VILA REAL,1710,15692.45,5918,393,314,304,302,350,652,956,1270,1663,37.71,10.6,8.09,6.09
20-11-2020,SABUGAL,71,5,671.0,"[480,960)",Muito Elevado,GUARDA,0911,82269.82,10585,724,707,694,796,1009,1805,2499,3206,3930,12.87,4.78,3.9,3.04
20-11-2020,SALVATERRA DE MAGOS,87,6,409.0,"[240,480)",Elevado,SANTARÉM,1415,24393.2,21295,1275,1181,1060,799,772,1571,2631,3812,5087,87.3,20.85,15.63,10.79
20-11-2020,SANTA COMBA DÃO,18,1,172.0,"[120,240)",Moderado,VISEU,1814,11194.77,10452,732,684,569,538,464,1002,1571,2255,2987,93.36,26.68,20.14,14.03
20-11-2020,SANTA CRUZ,70,5,155.0,"[120,240)",Moderado,MADEIRA,3108,8150.28,45281,1817,1301,974,716,523,1239,2213,3514,5331,555.6,65.41,43.12,27.15
20-11-2020,SANTA CRUZ DA GRACIOSA,0,0,0.0,"[0,20)",Moderado,AÇORES,4401,6065.78,4208,228,180,163,124,145,269,432,612,840,69.37,13.85,10.09,7.12
20-11-2020,SANTA CRUZ DAS FLORES,2,0,92.0,"[60,120)",Moderado,AÇORES,4802,7091.44,2165,125,98,74,56,51,107,181,279,404,30.53,5.7,3.93,2.55
20-11-2020,SANTA MARIA DA FEIRA,2048,146,1477.0,"[960, Max)",Extremamente Elevado,AVEIRO,0109,21587.65,138636,8182,6743,4771,3856,3079,6935,11706,18449,26631,642.19,123.36,85.46,54.22
20-11-2020,SANTA MARTA DE PENAGUIÃO,56,4,849.0,"[480,960)",Muito Elevado,VILA REAL,1711,6928.13,6599,483,373,337,316,317,633,970,1343,1826,95.25,26.36,19.39,14.0
20-11-2020,SANTANA,0,0,0.0,"[0,20)",Moderado,MADEIRA,3109,9547.3,6711,418,353,343,282,277,559,902,1255,1673,70.29,17.52,13.15,9.45
20-11-2020,SANTARÉM,270,19,470.0,"[240,480)",Elevado,SANTARÉM,1416,55253.58,57421,3654,3441,2760,2466,2206,4672,7432,10873,14527,103.92,26.29,19.68,13.45
20-11-2020,SANTIAGO DO CACÉM,26,2,90.0,"[60,120)",Moderado,SETÚBAL,1509,105969.29,28791,2144,1689,1472,1295,1215,2510,3982,5671,7815,27.17,7.37,5.35,3.76
20-11-2020,SANTO TIRSO,1317,94,1935.0,"[960, Max)",Extremamente Elevado,PORTO,1314,13655.52,68055,4911,3935,2761,2257,1810,4067,6828,10763,15674,498.35,114.78,78.82,50.0
20-11-2020,SÃO BRÁS DE ALPORTEL,17,1,163.0,"[120,240)",Moderado,FARO,0812,15336.92,10416,596,468,467,404,401,805,1272,1740,2336,67.91,15.23,11.35,8.29
20-11-2020,SÃO JOÃO DA MADEIRA,339,24,1544.0,"[960, Max)",Extremamente Elevado,AVEIRO,0116,794.3,21958,1347,1069,796,601,593,1194,1990,3059,4406,2765.49,554.91,385.26,250.63
20-11-2020,SÃO JOÃO DA PESQUEIRA,26,2,365.0,"[240,480)",Elevado,VISEU,1815,26610.85,7125,417,330,294,328,328,656,950,1280,1697,26.77,6.38,4.81,3.57
20-11-2020,SÃO PEDRO DO SUL,79,6,513.0,"[480,960)",Muito Elevado,VISEU,1816,34895.09,15403,990,962,861,759,909,1668,2529,3491,4481,44.14,12.84,10.0,7.25
20-11-2020,SÃO ROQUE DO PICO,2,0,61.0,"[60,120)",Moderado,AÇORES,4603,14236.1,3266,199,141,93,96,113,209,302,443,642,22.94,4.51,3.11,2.12
20-11-2020,SÃO VICENTE,0,0,0.0,"[0,20)",Moderado,MADEIRA,3110,7883.71,5143,272,264,266,225,280,505,771,1035,1307,65.23,16.58,13.13,9.78
20-11-2020,SARDOAL,15,1,401.0,"[240,480)",Elevado,SANTARÉM,1417,9214.72,3741,227,178,148,165,248,413,561,739,966,40.6,10.48,8.02,6.09
20-11-2020,SÁTÃO,90,6,777.0,"[480,960)",Muito Elevado,VISEU,1817,20194.11,11580,765,671,515,465,476,941,1456,2127,2892,57.34,14.32,10.53,7.21
20-11-2020,SEIA,136,10,612.0,"[480,960)",Muito Elevado,GUARDA,0912,43568.83,22234,1807,1589,1238,1122,721,1843,3081,4670,6477,51.03,14.87,10.72,7.07
20-11-2020,SEIXAL,882,63,526.0,"[480,960)",Muito Elevado,SETÚBAL,1510,9545.17,167752,10586,9270,6661,4391,2930,7321,13982,23252,33838,1757.49,354.51,243.6,146.49
20-11-2020,SERNANCELHE,2,0,37.0,"[20,60)",Moderado,VISEU,1818,22861.22,5396,305,293,286,273,260,533,819,1112,1417,23.6,6.2,4.86,3.58
20-11-2020,SERPA,41,3,287.0,"[240,480)",Elevado,BEJA,0213,110563.34,14304,903,761,719,697,626,1323,2042,2803,3706,12.94,3.35,2.54,1.85
20-11-2020,SERTÃ,18,1,123.0,"[120,240)",Moderado,CASTELO BRANCO,0509,44673.17,14577,870,779,790,767,1020,1787,2577,3356,4226,32.63,9.46,7.51,5.77
20-11-2020,SESIMBRA,178,13,343.0,"[240,480)",Elevado,SETÚBAL,1511,19571.75,51858,2400,2321,1853,1257,1083,2340,4193,6514,8914,264.96,45.54,33.28,21.42
20-11-2020,SETÚBAL,599,43,520.0,"[480,960)",Muito Elevado,SETÚBAL,1512,23032.5,115126,7425,6929,5075,3775,2655,6430,11505,18434,25859,499.83,112.27,80.03,49.95
20-11-2020,SEVER DO VOUGA,66,5,582.0,"[480,960)",Muito Elevado,AVEIRO,0117,12987.56,11331,766,637,568,540,567,1107,1675,2312,3078,87.24,23.7,17.8,12.9
20-11-2020,SILVES,64,5,177.0,"[120,240)",Moderado,FARO,0813,68006.23,36226,2137,1869,1610,1423,1600,3023,4633,6502,8639,53.27,12.7,9.56,6.81
20-11-2020,SINES,69,5,503.0,"[480,960)",Muito Elevado,SETÚBAL,1513,20330.17,13715,888,791,551,416,268,684,1235,2026,2914,67.46,14.33,9.97,6.07
20-11-2020,SINTRA,1965,140,502.0,"[480,960)",Muito Elevado,LISBOA,1111,31922.73,391402,20490,18316,13545,9137,7284,16421,29966,48282,68772,1226.08,215.43,151.25,93.87
20-11-2020,SOBRAL DE MONTE AGRAÇO,36,3,338.0,"[240,480)",Elevado,LISBOA,1112,5210.32,10651,564,507,352,272,212,484,836,1343,1907,204.43,36.6,25.78,16.05
20-11-2020,SOURE,45,3,263.0,"[240,480)",Elevado,COIMBRA,0615,26506.07,17120,1173,1142,1004,883,987,1870,2874,4016,5189,64.59,19.58,15.15,10.84
20-11-2020,SOUSEL,9,1,204.0,"[120,240)",Moderado,PORTALEGRE,1215,27932.18,4412,261,274,208,302,292,594,802,1076,1337,15.8,4.79,3.85,2.87
20-11-2020,TÁBUA,24,2,211.0,"[120,240)",Moderado,COIMBRA,0616,19978.58,11368,729,584,524,430,464,894,1418,2002,2731,56.9,13.67,10.02,7.1
20-11-2020,TABUAÇO,12,1,199.0,"[120,240)",Moderado,VISEU,1819,13385.67,6033,372,314,217,282,363,645,862,1176,1548,45.07,11.56,8.79,6.44
20-11-2020,TAROUCA,38,3,487.0,"[480,960)",Muito Elevado,VISEU,1820,10008.49,7804,405,335,313,277,324,601,914,1249,1654,77.98,16.53,12.48,9.13
20-11-2020,TAVIRA,49,4,200.0,"[120,240)",Moderado,FARO,0814,60696.7,24530,1493,1415,1252,1066,1277,2343,3595,5010,6503,40.41,10.71,8.25,5.92
20-11-2020,TERRAS DE BOURO,20,1,314.0,"[240,480)",Elevado,BRAGA,0310,27746.07,6361,391,372,296,319,340,659,955,1327,1718,22.93,6.19,4.78,3.44
20-11-2020,TOMAR,140,10,381.0,"[240,480)",Elevado,SANTARÉM,1418,35120.44,36748,2403,2189,1868,1853,1822,3675,5543,7732,10135,104.64,28.86,22.02,15.78
20-11-2020,TONDELA,71,5,269.0,"[240,480)",Elevado,VISEU,1821,37121.73,26357,1768,1722,1518,1475,1417,2892,4410,6132,7900,71.0,21.28,16.52,11.88
20-11-2020,TORRE DE MONCORVO,50,4,650.0,"[480,960)",Muito Elevado,BRAGANÇA,0409,53155.67,7695,556,478,488,551,719,1270,1758,2236,2792,14.48,5.25,4.21,3.31
20-11-2020,TORRES NOVAS,137,10,392.0,"[240,480)",Elevado,SANTARÉM,1419,26999.68,34933,2324,1979,1738,1406,1475,2881,4619,6598,8922,129.38,33.04,24.44,17.11
20-11-2020,TORRES VEDRAS,252,18,321.0,"[240,480)",Elevado,LISBOA,1113,40714.89,78530,4513,3945,3447,2628,2104,4732,8179,12124,16637,192.88,40.86,29.78,20.09
20-11-2020,TRANCOSO,37,3,417.0,"[240,480)",Elevado,GUARDA,0913,36152.47,8875,581,557,542,586,496,1082,1624,2181,2762,24.55,7.64,6.03,4.49
20-11-2020,TROFA,668,48,1739.0,"[960, Max)",Extremamente Elevado,PORTO,1318,7201.76,38418,2336,1894,1231,939,684,1623,2854,4748,7084,533.44,98.36,65.93,39.63
20-11-2020,VAGOS,121,9,532.0,"[480,960)",Muito Elevado,AVEIRO,0118,16491.5,22740,1320,1205,922,784,724,1508,2430,3635,4955,137.89,30.04,22.04,14.73
20-11-2020,VALE DE CAMBRA,268,19,1257.0,"[960, Max)",Extremamente Elevado,AVEIRO,0119,14733.47,21327,1491,1363,1005,831,798,1629,2634,3997,5488,144.76,37.25,27.13,17.88
20-11-2020,VALENÇA,164,12,1234.0,"[960, Max)",Extremamente Elevado,VIANA DO CASTELO,1608,11712.86,13290,867,791,582,582,503,1085,1667,2458,3325,113.46,28.39,20.99,14.23
20-11-2020,VALONGO,1238,88,1270.0,"[960, Max)",Extremamente Elevado,PORTO,1315,7512.45,97444,5629,4696,3207,2462,1829,4291,7498,12194,17823,1297.18,237.26,162.33,99.81
20-11-2020,VALPAÇOS,96,7,648.0,"[480,960)",Muito Elevado,VILA REAL,1712,54873.93,14818,1217,1118,999,928,997,1925,2924,4042,5259,27.0,9.58,7.37,5.33
20-11-2020,VELAS,5,0,98.0,"[60,120)",Moderado,AÇORES,4502,11738.38,5093,278,208,166,153,113,266,432,640,918,43.39,7.82,5.45,3.68
20-11-2020,VENDAS NOVAS,8,1,71.0,"[60,120)",Moderado,ÉVORA,0712,22238.88,11255,677,768,655,501,532,1033,1688,2456,3133,50.61,14.09,11.04,7.59
20-11-2020,VIANA DO ALENTEJO,18,1,350.0,"[240,480)",Elevado,ÉVORA,0713,39367.29,5145,245,208,235,210,214,424,659,867,1112,13.07,2.82,2.2,1.67
20-11-2020,VIANA DO CASTELO,316,23,374.0,"[240,480)",Elevado,VIANA DO CASTELO,1609,31902.01,84417,5470,4433,3591,3061,2982,6043,9634,14067,19537,264.61,61.24,44.09,30.2
20-11-2020,VIDIGUEIRA,3,0,54.0,"[20,60)",Moderado,BEJA,0214,31661.09,5510,300,248,215,233,275,508,723,971,1271,17.4,4.01,3.07,2.28
20-11-2020,VIEIRA DO MINHO,144,10,1216.0,"[960, Max)",Extremamente Elevado,BRAGA,0311,21644.35,11842,703,594,525,548,482,1030,1555,2149,2852,54.71,13.18,9.93,7.18
20-11-2020,VILA DE REI,3,0,90.0,"[60,120)",Moderado,CASTELO BRANCO,0510,19154.6,3323,169,128,172,247,302,549,721,849,1018,17.35,5.31,4.43,3.76
20-11-2020,VILA DO BISPO,16,1,310.0,"[240,480)",Elevado,FARO,0815,17906.06,5154,302,302,314,232,233,465,779,1081,1383,28.78,7.72,6.04,4.35
20-11-2020,VILA DO CONDE,1282,92,1605.0,"[960, Max)",Extremamente Elevado,PORTO,1316,14902.77,79899,4726,3875,2819,2070,1743,3813,6632,10507,15233,536.13,102.21,70.5,44.5
20-11-2020,VILA DO PORTO,2,0,36.0,"[20,60)",Moderado,AÇORES,4101,9688.74,5616,274,212,135,96,123,219,354,566,840,57.96,8.67,5.84,3.65
20-11-2020,VILA FLOR,10,1,165.0,"[120,240)",Moderado,BRAGANÇA,0410,26581.14,6044,429,362,422,294,331,625,1047,1409,1838,22.74,6.91,5.3,3.94
20-11-2020,VILA FRANCA DE XIRA,836,60,589.0,"[480,960)",Muito Elevado,LISBOA,1114,31819.39,141957,8501,6852,4869,3425,2472,5897,10766,17618,26119,446.14,82.09,55.37,33.84
20-11-2020,VILA FRANCA DO CAMPO,3,0,27.0,"[20,60)",Moderado,AÇORES,4206,7796.82,11051,450,344,248,217,154,371,619,963,1413,141.73,18.12,12.35,7.94
20-11-2020,VILA NOVA DA BARQUINHA,24,2,322.0,"[240,480)",Elevado,SANTARÉM,1420,4952.97,7461,415,406,392,364,338,702,1094,1500,1915,150.64,38.66,30.28,22.09
20-11-2020,VILA NOVA DE CERVEIRA,42,3,471.0,"[240,480)",Elevado,VIANA DO CASTELO,1610,10846.66,8910,531,444,410,384,334,718,1128,1572,2103,82.14,19.39,14.49,10.4
20-11-2020,VILA NOVA DE FAMALICÃO,2445,175,1857.0,"[960, Max)",Extremamente Elevado,BRAGA,0312,20159.26,131676,7817,6164,4202,3282,2749,6031,10233,16397,24214,653.19,120.12,81.34,50.76
20-11-2020,VILA NOVA DE FOZ CÔA,37,3,569.0,"[480,960)",Muito Elevado,GUARDA,0914,39815.18,6503,442,385,390,398,429,827,1217,1602,2044,16.33,5.13,4.02,3.06
20-11-2020,VILA NOVA DE GAIA,3251,232,1082.0,"[960, Max)",Extremamente Elevado,PORTO,1317,16846.43,300472,18349,15568,10972,8224,6281,14505,25477,41045,59394,1783.64,352.57,243.65,151.23
20-11-2020,VILA NOVA DE PAIVA,34,2,725.0,"[480,960)",Muito Elevado,VISEU,1822,17553.28,4687,289,272,233,217,241,458,691,963,1252,26.7,7.13,5.49,3.94
20-11-2020,VILA NOVA DE POIARES,24,2,346.0,"[240,480)",Elevado,COIMBRA,0617,8445.3,6939,380,284,262,235,182,417,679,963,1343,82.17,15.9,11.4,8.04
20-11-2020,VILA POUCA DE AGUIAR,81,6,677.0,"[480,960)",Muito Elevado,VILA REAL,1713,43706.62,11961,860,817,733,601,627,1228,1961,2778,3638,27.37,8.32,6.36,4.49
20-11-2020,VILA REAL,338,24,677.0,"[480,960)",Muito Elevado,VILA REAL,1714,37880.28,49962,3025,2498,2065,1579,1466,3045,5110,7608,10633,131.9,28.07,20.08,13.49
20-11-2020,VILA REAL DE SANTO ANTÓNIO,28,2,149.0,"[120,240)",Moderado,FARO,0816,6125.0,18749,1172,1069,811,569,586,1155,1966,3035,4207,306.11,68.69,49.55,32.1
20-11-2020,VILA VELHA DE RÓDÃO,0,0,0.0,"[0,20)",Moderado,CASTELO BRANCO,0511,32991.16,3144,209,229,180,283,306,589,769,998,1207,9.53,3.66,3.03,2.33
20-11-2020,VILA VERDE,412,29,878.0,"[480,960)",Muito Elevado,BRAGA,0313,22866.52,46911,2365,2063,1667,1494,1437,2931,4598,6661,9026,205.15,39.47,29.13,20.11
20-11-2020,VILA VIÇOSA,19,1,248.0,"[240,480)",Elevado,ÉVORA,0714,19485.89,7656,487,379,342,345,324,669,1011,1390,1877,39.29,9.63,7.13,5.19
20-11-2020,VIMIOSO,16,1,398.0,"[240,480)",Elevado,BRAGANÇA,0411,48158.51,4023,274,230,261,293,335,628,889,1119,1393,8.35,2.89,2.32,1.85
20-11-2020,VINHAIS,28,2,361.0,"[240,480)",Elevado,BRAGANÇA,0412,69475.09,7746,599,577,636,641,815,1456,2092,2669,3268,11.15,4.7,3.84,3.01
20-11-2020,VISEU,414,30,426.0,"[240,480)",Elevado,VISEU,1823,50710.14,97249,5769,5038,4140,3158,2710,5868,10008,15046,20815,191.77,41.05,29.67,19.74
20-11-2020,VIZELA,603,43,2523.0,"[960, Max)",Extremamente Elevado,BRAGA,0314,2469.83,23897,1258,928,655,509,371,880,1535,2463,3721,967.49,150.65,99.72,62.15
20-11-2020,VOUZELA,20,1,208.0,"[120,240)",Moderado,VISEU,1824,19369.46,9619,626,605,554,532,507,1039,1593,2198,2824,49.66,14.58,11.35,8.22
26-11-2020,ABRANTES,147,10,418.0,"[240,480)",Elevado,SANTARÉM,1401,71469.08,35130,2473,2213,1730,1748,2021,3769,5499,7712,10185,49.15,14.25,10.79,7.69
26-11-2020,ÁGUEDA,322,23,699.0,"[480,960)",Muito Elevado,AVEIRO,0101,33527.44,46075,3237,2713,2090,1635,1496,3131,5221,7934,11171,137.43,33.32,23.66,15.57
26-11-2020,AGUIAR DA BEIRA,11,1,236.0,"[0,240)",Moderado,GUARDA,0901,20676.57,4652,304,281,235,239,148,387,622,903,1207,22.5,5.84,4.37,3.01
26-11-2020,ALANDROAL,27,2,541.0,"[480,960)",Muito Elevado,ÉVORA,0701,54267.81,4992,307,256,296,299,377,676,972,1228,1535,9.2,2.83,2.26,1.79
26-11-2020,ALBERGARIA-A-VELHA,167,12,692.0,"[480,960)",Muito Elevado,AVEIRO,0102,15882.5,24144,1550,1298,996,687,680,1367,2363,3661,5211,152.02,32.81,23.05,14.88
26-11-2020,ALBUFEIRA,113,8,272.0,"[240,480)",Elevado,FARO,0801,14066.42,41528,2067,1717,1425,985,858,1843,3268,4985,7052,295.24,50.14,35.44,23.23
26-11-2020,ALCÁCER DO SAL,24,2,206.0,"[0,240)",Moderado,SETÚBAL,1501,149987.3,11659,884,814,623,623,602,1225,1848,2662,3546,7.77,2.36,1.77,1.23
26-11-2020,ALCANENA,142,10,1109.0,"[960, Max)",Extremamente Elevado,SANTARÉM,1402,12732.86,12809,891,744,628,536,588,1124,1752,2496,3387,100.6,26.6,19.6,13.76
26-11-2020,ALCOBAÇA,206,15,385.0,"[240,480)",Elevado,LEIRIA,1001,40814.09,53555,3420,2927,2466,2059,1676,3735,6201,9128,12548,131.22,30.74,22.36,15.19
26-11-2020,ALCOCHETE,72,5,364.0,"[240,480)",Elevado,SETÚBAL,1502,12836.48,19787,857,834,691,476,447,923,1614,2448,3305,154.15,25.75,19.07,12.57
26-11-2020,ALCOUTIM,0,0,0.0,"[0,240)",Moderado,FARO,0802,57536.33,2159,191,188,163,190,267,457,620,808,999,3.75,1.74,1.4,1.08
26-11-2020,ALENQUER,187,13,424.0,"[240,480)",Elevado,LISBOA,1101,30421.92,44052,2298,2062,1629,1330,1155,2485,4114,6176,8474,144.8,27.85,20.3,13.52
26-11-2020,ALFÂNDEGA DA FÉ,44,3,967.0,"[960, Max)",Extremamente Elevado,BRAGANÇA,0401,32194.64,4550,325,277,301,274,325,599,900,1177,1502,14.13,4.67,3.66,2.8
26-11-2020,ALIJÓ,67,5,631.0,"[480,960)",Muito Elevado,VILA REAL,1701,29759.89,10625,766,687,635,542,666,1208,1843,2530,3296,35.7,11.08,8.5,6.19
26-11-2020,ALJEZUR,5,0,89.0,"[0,240)",Moderado,FARO,0803,32349.95,5594,316,336,335,320,410,730,1065,1401,1717,17.29,5.31,4.33,3.29
26-11-2020,ALJUSTREL,14,1,170.0,"[0,240)",Moderado,BEJA,0201,45847.41,8247,635,521,443,347,358,705,1148,1669,2304,17.99,5.03,3.64,2.5
26-11-2020,ALMADA,1155,82,683.0,"[480,960)",Muito Elevado,SETÚBAL,1503,7000.89,169039,10469,9777,7876,6144,5111,11255,19131,28908,39377,2414.5,562.45,412.91,273.26
26-11-2020,ALMEIDA,20,1,343.0,"[240,480)",Elevado,GUARDA,0902,51798.46,5830,441,419,396,458,393,851,1247,1666,2107,11.26,4.07,3.22,2.41
26-11-2020,ALMEIRIM,69,5,306.0,"[240,480)",Elevado,SANTARÉM,1403,22212.05,22546,1342,1353,1106,866,843,1709,2815,4168,5510,101.5,24.81,18.76,12.67
26-11-2020,ALMODÔVAR,5,0,74.0,"[0,240)",Moderado,BEJA,0202,77788.03,6725,414,443,396,373,328,701,1097,1540,1954,8.65,2.51,1.98,1.41
26-11-2020,ALPIARÇA,11,1,156.0,"[0,240)",Moderado,SANTARÉM,1404,9536.33,7059,515,486,363,333,274,607,970,1456,1971,74.02,20.67,15.27,10.17
26-11-2020,ALTER DO CHÃO,7,0,221.0,"[0,240)",Moderado,PORTALEGRE,1201,36206.62,3165,201,163,136,208,187,395,531,694,895,8.74,2.47,1.92,1.47
26-11-2020,ALVAIÁZERE,9,1,136.0,"[0,240)",Moderado,LEIRIA,1002,16047.76,6597,419,389,346,406,539,945,1291,1680,2099,41.11,13.08,10.47,8.04
26-11-2020,ALVITO,2,0,81.0,"[0,240)",Moderado,BEJA,0203,26485.32,2477,145,110,105,111,89,200,305,415,560,9.35,2.11,1.57,1.15
26-11-2020,AMADORA,983,70,534.0,"[480,960)",Muito Elevado,LISBOA,1115,2378.47,184106,11186,10936,8780,6460,5890,12350,21130,32066,43252,7742.05,1818.84,1348.44,888.56
26-11-2020,AMARANTE,614,44,1154.0,"[960, Max)",Extremamente Elevado,PORTO,1301,30133.15,53193,3086,2413,1812,1643,1311,2954,4766,7179,10265,176.53,34.07,23.82,15.82
26-11-2020,AMARES,217,16,1197.0,"[960, Max)",Extremamente Elevado,BRAGA,0301,8195.41,18129,1001,829,622,489,524,1013,1635,2464,3465,221.22,42.28,30.07,19.95
26-11-2020,ANADIA,182,13,668.0,"[480,960)",Muito Elevado,AVEIRO,0103,21663.48,27258,1931,1698,1376,1208,1262,2470,3846,5544,7475,125.83,34.51,25.59,17.75
26-11-2020,ANGRA DO HEROÍSMO,44,3,130.0,"[0,240)",Moderado,AÇORES,4301,23899.66,33807,2006,1473,1122,768,635,1403,2525,3998,6004,141.45,25.12,16.73,10.56
26-11-2020,ANSIÃO,56,4,465.0,"[240,480)",Elevado,LEIRIA,1003,17609.42,12039,727,709,646,694,530,1224,1870,2579,3306,68.37,18.77,14.65,10.62
26-11-2020,ARCOS DE VALDEVEZ,112,8,535.0,"[480,960)",Muito Elevado,VIANA DO CASTELO,1601,44759.64,20926,1329,1338,1282,1343,1515,2858,4140,5478,6807,46.75,15.21,12.24,9.25
26-11-2020,ARGANIL,74,5,672.0,"[480,960)",Muito Elevado,COIMBRA,0601,33283.93,11014,672,648,612,559,596,1155,1767,2415,3087,33.09,9.27,7.26,5.31
26-11-2020,ARMAMAR,78,6,1352.0,"[960, Max)",Extremamente Elevado,VISEU,1801,11723.73,5769,357,305,309,285,310,595,904,1209,1566,49.21,13.36,10.31,7.71
26-11-2020,AROUCA,196,14,946.0,"[480,960)",Muito Elevado,AVEIRO,0104,32910.52,20720,1306,1047,753,683,683,1366,2119,3166,4472,62.96,13.59,9.62,6.44
26-11-2020,ARRAIOLOS,15,1,217.0,"[0,240)",Moderado,ÉVORA,0702,68374.55,6928,435,384,283,367,480,847,1130,1514,1949,10.13,2.85,2.21,1.65
26-11-2020,ARRONCHES,9,1,319.0,"[240,480)",Elevado,PORTALEGRE,1202,31464.72,2820,155,142,162,187,179,366,528,670,825,8.96,2.62,2.13,1.68
26-11-2020,ARRUDA DOS VINHOS,39,3,253.0,"[240,480)",Elevado,LISBOA,1102,7795.93,15412,738,738,562,509,438,947,1509,2247,2985,197.69,38.29,28.82,19.36
26-11-2020,AVEIRO,475,34,603.0,"[480,960)",Muito Elevado,AVEIRO,0105,19757.57,78734,4520,4004,3050,2250,2103,4353,7403,11407,15927,398.49,80.61,57.73,37.47
26-11-2020,AVIS,7,1,165.0,"[0,240)",Moderado,PORTALEGRE,1203,60596.51,4247,315,225,206,251,273,524,730,955,1270,7.01,2.1,1.58,1.2
26-11-2020,AZAMBUJA,171,12,753.0,"[480,960)",Muito Elevado,LISBOA,1103,26265.65,22716,1322,1171,1070,798,618,1416,2486,3657,4979,86.48,18.96,13.92,9.46
26-11-2020,BAIÃO,152,11,811.0,"[480,960)",Muito Elevado,PORTO,1302,17452.83,18748,1070,862,714,686,725,1411,2125,2987,4057,107.42,23.25,17.11,12.18
26-11-2020,BARCELOS,1873,134,1612.0,"[960, Max)",Extremamente Elevado,BRAGA,0302,37890.14,116187,6721,5325,3619,2991,2562,5553,9172,14497,21218,306.64,56.0,38.26,24.21
26-11-2020,BARRANCOS,4,0,245.0,"[240,480)",Elevado,BEJA,0204,16841.73,1634,90,65,65,94,61,155,220,285,375,9.7,2.23,1.69,1.31
26-11-2020,BARREIRO,356,25,474.0,"[240,480)",Elevado,SETÚBAL,1504,3639.07,75147,5194,5565,4459,3105,1767,4872,9331,14896,20090,2065.05,552.07,409.34,256.42
26-11-2020,BATALHA,38,3,238.0,"[0,240)",Moderado,LEIRIA,1004,10341.6,15963,873,762,649,529,549,1078,1727,2489,3362,154.35,32.51,24.07,16.7
26-11-2020,BEJA,52,4,155.0,"[0,240)",Moderado,BEJA,0205,114647.55,33579,2005,1840,1386,1272,1039,2311,3697,5537,7542,29.29,6.58,4.83,3.22
26-11-2020,BELMONTE,96,7,1500.0,"[960, Max)",Extremamente Elevado,CASTELO BRANCO,0501,11875.91,6398,444,321,325,310,355,665,990,1311,1755,53.87,14.78,11.04,8.34
26-11-2020,BENAVENTE,85,6,278.0,"[240,480)",Elevado,SANTARÉM,1405,52138.39,30602,1468,1376,1141,876,643,1519,2660,4036,5504,58.69,10.56,7.74,5.1
26-11-2020,BOMBARRAL,30,2,239.0,"[0,240)",Moderado,LEIRIA,1005,9128.55,12558,875,714,561,491,429,920,1481,2195,3070,137.56,33.63,24.04,16.22
26-11-2020,BORBA,5,0,74.0,"[0,240)",Moderado,ÉVORA,0703,14518.65,6736,430,375,279,436,392,828,1107,1482,1912,46.39,13.17,10.21,7.62
26-11-2020,BOTICAS,32,2,640.0,"[480,960)",Muito Elevado,VILA REAL,1702,32195.66,4998,347,306,311,305,380,685,996,1302,1649,15.52,5.12,4.04,3.09
26-11-2020,BRAGA,2473,177,1354.0,"[960, Max)",Extremamente Elevado,BRAGA,0303,18339.95,182679,10029,7963,5241,4320,3671,7991,13232,21195,31224,996.07,170.25,115.57,72.15
26-11-2020,BRAGANÇA,264,19,786.0,"[480,960)",Muito Elevado,BRAGANÇA,0402,117357.27,33607,2402,1855,1652,1393,1163,2556,4208,6063,8465,28.64,7.21,5.17,3.59
26-11-2020,CABECEIRAS DE BASTO,177,13,1133.0,"[960, Max)",Extremamente Elevado,BRAGA,0304,24182.16,15628,774,594,544,575,574,1149,1693,2287,3061,64.63,12.66,9.46,7.0
26-11-2020,CADAVAL,40,3,293.0,"[240,480)",Elevado,LISBOA,1104,17489.3,13673,813,796,756,621,625,1246,2002,2798,3611,78.18,20.65,16.0,11.45
26-11-2020,CALDAS DA RAINHA,132,9,254.0,"[240,480)",Elevado,LEIRIA,1006,25569.47,51912,3035,2684,2186,1899,1705,3604,5790,8474,11509,203.03,45.01,33.14,22.64
26-11-2020,CALHETA,4,0,37.0,"[0,240)",Moderado,MADEIRA,3101,11150.43,10867,576,497,507,399,415,814,1321,1818,2394,97.46,21.47,16.3,11.85
26-11-2020,CALHETA (AÇORES),1,0,31.0,"[0,240)",Moderado,AÇORES,4501,12626.4,3184,215,159,141,139,122,261,402,561,776,25.22,6.15,4.44,3.18
26-11-2020,CÂMARA DE LOBOS,44,3,131.0,"[0,240)",Moderado,MADEIRA,3102,5216.67,33675,1396,1059,834,545,381,926,1760,2819,4215,645.49,80.79,54.03,33.74
26-11-2020,CAMINHA,129,9,812.0,"[480,960)",Muito Elevado,VIANA DO CASTELO,1602,13652.14,15877,1046,944,818,646,656,1302,2120,3064,4110,116.3,30.11,22.44,15.53
26-11-2020,CAMPO MAIOR,11,1,140.0,"[0,240)",Moderado,PORTALEGRE,1204,24720.16,7874,471,364,351,279,327,606,957,1321,1792,31.85,7.25,5.34,3.87
26-11-2020,CANTANHEDE,190,14,543.0,"[480,960)",Muito Elevado,COIMBRA,0602,39088.02,35011,2346,2096,1880,1709,1451,3160,5040,7136,9482,89.57,24.26,18.26,12.89
26-11-2020,CARRAZEDA DE ANSIÃES,9,1,159.0,"[0,240)",Moderado,BRAGANÇA,0403,27924.09,5666,424,389,391,312,465,777,1168,1557,1981,20.29,7.09,5.58,4.18
26-11-2020,CARREGAL DO SAL,30,2,324.0,"[240,480)",Elevado,VISEU,1802,11689.21,9271,587,562,486,462,376,838,1324,1886,2473,79.31,21.16,16.13,11.33
26-11-2020,CARTAXO,166,12,696.0,"[480,960)",Muito Elevado,SANTARÉM,1406,15817.28,23843,1415,1376,1142,861,632,1493,2635,4011,5426,150.74,34.3,25.36,16.66
26-11-2020,CASCAIS,1098,78,514.0,"[480,960)",Muito Elevado,LISBOA,1105,9740.17,213608,12151,11444,8680,6469,5248,11717,20397,31841,43992,2193.1,451.66,326.91,209.41
26-11-2020,CASTANHEIRA DE PÊRA,4,0,153.0,"[0,240)",Moderado,LEIRIA,1007,6677.45,2614,233,195,157,190,187,377,534,729,962,39.15,14.41,10.92,8.0
26-11-2020,CASTELO BRANCO,255,18,491.0,"[480,960)",Muito Elevado,CASTELO BRANCO,0502,143819.15,51987,3528,3042,2499,2229,2225,4454,6953,9995,13523,36.15,9.4,6.95,4.83
26-11-2020,CASTELO DE PAIVA,178,13,1152.0,"[960, Max)",Extremamente Elevado,AVEIRO,0106,11500.53,15454,881,697,545,420,431,851,1396,2093,2974,134.37,25.86,18.2,12.14
26-11-2020,CASTELO DE VIDE,8,1,274.0,"[240,480)",Elevado,PORTALEGRE,1205,26491.24,2919,204,173,179,147,170,317,496,669,873,11.02,3.3,2.53,1.87
26-11-2020,CASTRO DAIRE,61,4,441.0,"[240,480)",Elevado,VISEU,1803,37904.13,13823,942,857,765,732,773,1505,2270,3127,4069,36.47,10.74,8.25,5.99
26-11-2020,CASTRO MARIM,4,0,64.0,"[0,240)",Moderado,FARO,0804,30084.37,6237,370,345,334,322,344,666,1000,1345,1715,20.73,5.7,4.47,3.32
26-11-2020,CASTRO VERDE,17,1,245.0,"[240,480)",Elevado,BEJA,0206,56944.23,6949,437,347,303,275,227,502,805,1152,1589,12.2,2.79,2.02,1.41
26-11-2020,CELORICO DA BEIRA,86,6,1241.0,"[960, Max)",Extremamente Elevado,GUARDA,0903,24721.63,6928,430,416,363,369,535,904,1267,1683,2113,28.02,8.55,6.81,5.12
26-11-2020,CELORICO DE BASTO,168,12,882.0,"[480,960)",Muito Elevado,BRAGA,0305,18107.02,19040,1001,802,668,728,729,1457,2125,2927,3928,105.15,21.69,16.17,11.74
26-11-2020,CHAMUSCA,50,4,544.0,"[480,960)",Muito Elevado,SANTARÉM,1407,74600.54,9197,629,583,553,465,579,1044,1597,2180,2809,12.33,3.77,2.92,2.14
26-11-2020,CHAVES,465,33,1182.0,"[960, Max)",Extremamente Elevado,VILA REAL,1703,59122.95,39343,2676,2429,1991,1886,1918,3804,5795,8224,10900,66.54,18.44,13.91,9.8
26-11-2020,CINFÃES,217,15,1189.0,"[960, Max)",Extremamente Elevado,VISEU,1804,23928.76,18244,1067,902,779,734,758,1492,2271,3173,4240,76.24,17.72,13.26,9.49
26-11-2020,COIMBRA,682,49,508.0,"[480,960)",Muito Elevado,COIMBRA,0603,31939.94,134166,9489,8734,6353,5139,5074,10213,16566,25300,34789,420.06,108.92,79.21,51.87
26-11-2020,CONDEIXA-A-NOVA,83,6,468.0,"[240,480)",Elevado,COIMBRA,0604,13867.47,17733,871,809,717,583,490,1073,1790,2599,3470,127.88,25.02,18.74,12.91
26-11-2020,CONSTÂNCIA,18,1,447.0,"[240,480)",Elevado,SANTARÉM,1408,8036.58,4030,211,183,187,148,155,303,490,673,884,50.14,11.0,8.37,6.1
26-11-2020,CORUCHE,77,6,441.0,"[240,480)",Elevado,SANTARÉM,1409,111572.03,17471,1294,1090,1095,1096,1019,2115,3210,4300,5594,15.66,5.01,3.85,2.88
26-11-2020,CORVO,0,0,0.0,"[0,20)",Moderado,AÇORES,4901,1711.45,464,22,21,11,13,19,32,43,64,86,27.12,5.03,3.74,2.51
26-11-2020,COVILHÃ,357,25,763.0,"[480,960)",Muito Elevado,CASTELO BRANCO,0503,55560.06,46787,3533,2998,2365,2111,2193,4304,6669,9667,13200,84.21,23.76,17.4,12.0
26-11-2020,CRATO,39,3,1246.0,"[960, Max)",Extremamente Elevado,PORTALEGRE,1206,39806.88,3129,229,258,163,182,228,410,573,831,1060,7.86,2.66,2.09,1.44
26-11-2020,CUBA,28,2,609.0,"[480,960)",Muito Elevado,BEJA,0207,17208.72,4595,255,233,206,190,143,333,539,772,1027,26.7,5.97,4.49,3.13
26-11-2020,ELVAS,57,4,278.0,"[240,480)",Elevado,PORTALEGRE,1207,63128.86,20528,1057,1145,902,852,810,1662,2564,3709,4766,32.52,7.55,5.88,4.06
26-11-2020,ENTRONCAMENTO,69,5,320.0,"[240,480)",Elevado,SANTARÉM,1410,1372.81,21558,1066,930,868,695,592,1287,2155,3085,4151,1570.14,302.33,224.69,156.96
26-11-2020,ESPINHO,427,31,1447.0,"[960, Max)",Extremamente Elevado,AVEIRO,0107,2105.68,29516,2205,1993,1430,1177,960,2137,3567,5560,7765,1401.52,368.71,264.01,169.37
26-11-2020,ESPOSENDE,340,24,995.0,"[960, Max)",Extremamente Elevado,BRAGA,0306,9540.98,34177,1831,1522,1095,894,723,1617,2712,4234,6065,358.21,63.57,44.38,28.42
26-11-2020,ESTARREJA,170,12,654.0,"[480,960)",Muito Elevado,AVEIRO,0108,10817.33,26006,1503,1399,1106,953,728,1681,2787,4186,5689,240.42,52.59,38.7,25.76
26-11-2020,ESTREMOZ,28,2,220.0,"[0,240)",Moderado,ÉVORA,0704,51379.95,12728,789,613,697,786,877,1663,2360,2973,3762,24.77,7.32,5.79,4.59
26-11-2020,ÉVORA,278,20,530.0,"[480,960)",Muito Elevado,ÉVORA,0705,130707.58,52428,3569,2852,2176,1966,1803,3769,5945,8797,12366,40.11,9.46,6.73,4.55
26-11-2020,FAFE,1034,74,2151.0,"[960, Max)",Extremamente Elevado,BRAGA,0307,21908.11,48060,3044,2455,1679,1403,1208,2611,4290,6745,9789,219.37,44.68,30.79,19.58
26-11-2020,FARO,179,13,293.0,"[240,480)",Elevado,FARO,0805,20256.79,61015,3847,3364,2604,2055,1601,3656,6260,9624,13471,301.2,66.5,47.51,30.9
26-11-2020,FELGUEIRAS,1095,78,1941.0,"[960, Max)",Extremamente Elevado,PORTO,1303,11573.75,56422,2951,2302,1601,1316,973,2289,3890,6192,9143,487.49,79.0,53.5,33.61
26-11-2020,FERREIRA DO ALENTEJO,13,1,166.0,"[0,240)",Moderado,BEJA,0208,64820.68,7845,515,414,372,343,345,688,1060,1474,1989,12.1,3.07,2.27,1.64
26-11-2020,FERREIRA DO ZÊZERE,17,1,214.0,"[0,240)",Moderado,SANTARÉM,1411,19038.03,7959,470,370,416,465,456,921,1337,1707,2177,41.81,11.44,8.97,7.02
26-11-2020,FIGUEIRA DA FOZ,459,33,781.0,"[480,960)",Muito Elevado,COIMBRA,0605,37905.26,58747,4032,3597,2887,2495,2043,4538,7425,11022,15054,154.98,39.72,29.08,19.59
26-11-2020,FIGUEIRA DE CASTELO RODRIGO,45,3,806.0,"[480,960)",Muito Elevado,GUARDA,0904,50857.46,5584,347,352,290,352,391,743,1033,1385,1732,10.98,3.41,2.72,2.03
26-11-2020,FIGUEIRÓ DOS VINHOS,10,1,180.0,"[0,240)",Moderado,LEIRIA,1008,17344.0,5568,402,386,322,309,351,660,982,1368,1770,32.1,10.21,7.89,5.66
26-11-2020,FORNOS DE ALGODRES,7,1,155.0,"[0,240)",Moderado,GUARDA,0905,13145.05,4528,261,218,247,256,232,488,735,953,1214,34.45,9.24,7.25,5.59
26-11-2020,FREIXO DE ESPADA À CINTA,104,7,3153.0,"[960, Max)",Extremamente Elevado,BRAGANÇA,0404,24414.29,3298,211,177,231,196,189,385,616,793,1004,13.51,4.11,3.25,2.52
26-11-2020,FRONTEIRA,6,0,202.0,"[0,240)",Moderado,PORTALEGRE,1208,24859.58,2974,213,182,149,156,168,324,473,655,868,11.96,3.49,2.63,1.9
26-11-2020,FUNCHAL,101,7,97.0,"[0,240)",Moderado,MADEIRA,3103,7616.2,104024,6382,5086,3643,2821,1990,4811,8454,13540,19922,1365.86,261.58,177.78,111.0
26-11-2020,FUNDÃO,172,12,649.0,"[480,960)",Muito Elevado,CASTELO BRANCO,0504,70019.79,26495,1781,1464,1432,1357,1643,3000,4432,5896,7677,37.84,10.96,8.42,6.33
26-11-2020,GAVIÃO,47,3,1440.0,"[960, Max)",Extremamente Elevado,PORTALEGRE,1209,29459.45,3263,189,186,222,263,293,556,778,964,1153,11.08,3.91,3.27,2.64
26-11-2020,GÓIS,6,0,158.0,"[0,240)",Moderado,COIMBRA,0606,26330.19,3805,235,199,240,233,244,477,717,916,1151,14.45,4.37,3.48,2.72
26-11-2020,GOLEGÃ,20,1,375.0,"[240,480)",Elevado,SANTARÉM,1412,8431.67,5339,356,299,281,243,255,498,779,1078,1434,63.32,17.01,12.78,9.24
26-11-2020,GONDOMAR,1985,142,1196.0,"[960, Max)",Extremamente Elevado,PORTO,1304,13191.76,165985,10555,8755,6222,4450,3364,7814,14036,22791,33346,1258.22,252.77,172.76,106.4
26-11-2020,GOUVEIA,47,3,379.0,"[240,480)",Elevado,GUARDA,0906,30061.17,12387,871,931,780,783,810,1593,2373,3304,4175,41.21,13.89,10.99,7.89
26-11-2020,GRÂNDOLA,50,4,342.0,"[240,480)",Elevado,SETÚBAL,1505,82593.66,14639,834,834,708,688,672,1360,2068,2902,3736,17.72,4.52,3.51,2.5
26-11-2020,GUARDA,255,18,654.0,"[480,960)",Muito Elevado,GUARDA,0907,71209.58,38969,2477,2041,1686,1415,1474,2889,4575,6616,9093,54.72,12.77,9.29,6.42
26-11-2020,GUIMARÃES,3492,249,2293.0,"[960, Max)",Extremamente Elevado,BRAGA,0308,24099.96,152309,9394,7074,4809,3877,2948,6825,11634,18708,28102,631.99,116.61,77.63,48.27
26-11-2020,HORTA,1,0,7.0,"[0,240)",Moderado,AÇORES,4701,17305.53,14521,818,658,468,352,302,654,1122,1780,2598,83.91,15.01,10.29,6.48
26-11-2020,IDANHA-A-NOVA,19,1,236.0,"[0,240)",Moderado,CASTELO BRANCO,0505,141633.51,8043,518,490,519,672,974,1646,2165,2655,3173,5.68,2.24,1.87,1.53
26-11-2020,ÍLHAVO,248,18,641.0,"[480,960)",Muito Elevado,AVEIRO,0110,7347.55,38699,2227,1943,1444,1193,850,2043,3487,5430,7657,526.66,104.21,73.9,47.46
26-11-2020,LAGOA (FARO),95,7,417.0,"[240,480)",Elevado,FARO,0806,8825.45,22762,1314,1168,919,749,670,1419,2338,3506,4820,257.93,54.62,39.73,26.49
26-11-2020,LAGOA,29,2,197.0,"[0,240)",Moderado,AÇORES,4201,4559.32,14721,536,458,349,238,235,473,822,1280,1816,322.9,39.83,28.08,18.03
26-11-2020,LAGOS,82,6,270.0,"[240,480)",Elevado,FARO,0807,21299.27,30374,1744,1434,1247,1053,1029,2082,3329,4763,6507,142.61,30.55,22.36,15.63
26-11-2020,LAJES DAS FLORES,0,0,0.0,"[0,20)",Moderado,AÇORES,4801,7004.79,1463,88,53,62,46,54,100,162,215,303,20.89,4.33,3.07,2.31
26-11-2020,LAJES DO PICO,0,0,0.0,"[0,240)",Moderado,AÇORES,4601,15531.09,4490,304,231,223,159,162,321,544,775,1079,28.91,6.95,4.99,3.5
26-11-2020,LAMEGO,162,12,651.0,"[480,960)",Muito Elevado,VISEU,1805,16542.11,24895,1639,1284,1124,898,783,1681,2805,4089,5728,150.5,34.63,24.72,16.96
26-11-2020,LEIRIA,457,33,365.0,"[240,480)",Elevado,LEIRIA,1009,56508.83,125267,7389,6366,5090,3902,3159,7061,12151,18517,25906,221.68,45.84,32.77,21.5
26-11-2020,LISBOA,3281,234,644.0,"[480,960)",Muito Elevado,LISBOA,1106,10005.43,509515,33197,33340,27706,23037,26770,49807,77513,110853,144050,5092.6,1439.78,1107.98,774.74
26-11-2020,LOULÉ,184,13,268.0,"[240,480)",Elevado,FARO,0808,76366.91,68697,3890,3350,2780,2358,2251,4609,7389,10739,14629,89.96,19.16,14.06,9.68
26-11-2020,LOURES,1329,95,622.0,"[480,960)",Muito Elevado,LISBOA,1107,16723.99,213687,12746,12794,9644,6669,5033,11702,21346,34140,46886,1277.73,280.35,204.14,127.64
26-11-2020,LOURINHÃ,40,3,155.0,"[0,240)",Moderado,LISBOA,1108,14717.2,25855,1584,1243,992,842,645,1487,2479,3722,5306,175.68,36.05,25.29,16.84
26-11-2020,LOUSÃ,90,6,525.0,"[480,960)",Muito Elevado,COIMBRA,0607,13840.01,17158,946,866,658,528,450,978,1636,2502,3448,123.97,24.91,18.08,11.82
26-11-2020,LOUSADA,1129,81,2415.0,"[960, Max)",Extremamente Elevado,PORTO,1305,9608.01,46755,2289,1698,1176,853,621,1474,2650,4348,6637,486.63,69.08,45.25,27.58
26-11-2020,MAÇÃO,19,1,303.0,"[240,480)",Elevado,SANTARÉM,1413,39997.98,6267,386,362,390,440,657,1097,1487,1849,2235,15.67,5.59,4.62,3.72
26-11-2020,MACEDO DE CAVALEIROS,133,9,916.0,"[480,960)",Muito Elevado,BRAGANÇA,0405,69914.08,14516,1082,889,878,823,938,1761,2639,3528,4610,20.76,6.59,5.05,3.77
26-11-2020,MACHICO,10,1,50.0,"[0,240)",Moderado,MADEIRA,3104,6825.1,19981,1197,860,662,455,331,786,1448,2308,3505,292.76,51.36,33.82,21.22
26-11-2020,MADALENA,0,0,0.0,"[0,240)",Moderado,AÇORES,4602,14712.33,5895,334,256,173,190,179,369,542,798,1132,40.07,7.69,5.42,3.68
26-11-2020,MAFRA,395,28,466.0,"[240,480)",Elevado,LISBOA,1109,29165.5,84816,3613,3334,2839,2089,1899,3988,6827,10161,13774,290.81,47.23,34.84,23.41
26-11-2020,MAIA,1411,101,1015.0,"[960, Max)",Extremamente Elevado,PORTO,1306,8293.94,138971,7801,6617,4512,3339,2631,5970,10482,17099,24900,1675.56,300.22,206.16,126.38
26-11-2020,MANGUALDE,77,6,416.0,"[240,480)",Elevado,VISEU,1806,21925.56,18510,1198,1128,885,852,743,1595,2480,3608,4806,84.42,21.92,16.46,11.31
26-11-2020,MANTEIGAS,41,3,1363.0,"[960, Max)",Extremamente Elevado,GUARDA,0908,12197.55,3007,258,197,159,167,146,313,472,669,927,24.65,7.6,5.48,3.87
26-11-2020,MARCO DE CANAVESES,707,51,1373.0,"[960, Max)",Extremamente Elevado,PORTO,1307,20188.98,51496,2678,2060,1488,1265,1023,2288,3776,5836,8514,255.07,42.17,28.91,18.7
26-11-2020,MARINHA GRANDE,127,9,330.0,"[240,480)",Elevado,LEIRIA,1010,18725.19,38508,2365,2302,1638,1359,1058,2417,4055,6357,8722,205.65,46.58,33.95,21.66
26-11-2020,MARVÃO,21,2,699.0,"[480,960)",Muito Elevado,PORTALEGRE,1210,15489.9,3005,198,185,142,197,237,434,576,761,959,19.4,6.19,4.91,3.72
26-11-2020,MATOSINHOS,1662,119,948.0,"[480,960)",Muito Elevado,PORTO,1308,6241.97,175357,11850,9977,7023,5024,3884,8908,15931,25908,37758,2809.31,604.9,415.06,255.22
26-11-2020,MEALHADA,107,8,537.0,"[480,960)",Muito Elevado,AVEIRO,0111,11065.66,19914,1163,1039,810,828,831,1659,2469,3508,4671,179.96,42.21,31.7,22.31
26-11-2020,MÊDA,19,1,414.0,"[240,480)",Elevado,GUARDA,0909,28604.92,4587,343,306,290,288,443,731,1021,1327,1670,16.04,5.84,4.64,3.57
26-11-2020,MELGAÇO,31,2,383.0,"[240,480)",Elevado,VIANA DO CASTELO,1603,23824.58,8093,507,567,578,614,675,1289,1867,2434,2941,33.97,12.34,10.22,7.84
26-11-2020,MÉRTOLA,6,0,98.0,"[0,240)",Moderado,BEJA,0209,129287.34,6142,400,390,378,423,600,1023,1401,1791,2191,4.75,1.69,1.39,1.08
26-11-2020,MESÃO FRIO,13,1,328.0,"[240,480)",Elevado,VILA REAL,1704,2664.87,3964,265,205,168,157,120,277,445,650,915,148.74,34.33,24.39,16.7
26-11-2020,MIRA,63,4,532.0,"[480,960)",Muito Elevado,COIMBRA,0608,12403.38,11832,727,729,659,550,466,1016,1675,2404,3131,95.4,25.24,19.38,13.5
26-11-2020,MIRANDA DO CORVO,164,12,1291.0,"[960, Max)",Extremamente Elevado,COIMBRA,0609,12637.79,12708,706,659,568,498,404,902,1470,2129,2835,100.55,22.43,16.85,11.63
26-11-2020,MIRANDA DO DOURO,49,3,717.0,"[480,960)",Muito Elevado,BRAGANÇA,0406,48718.31,6830,482,429,442,463,470,933,1375,1804,2286,14.02,4.69,3.7,2.82
26-11-2020,MIRANDELA,117,8,538.0,"[480,960)",Muito Elevado,BRAGANÇA,0407,65895.67,21754,1640,1315,1204,1078,947,2025,3229,4544,6184,33.01,9.38,6.9,4.9
26-11-2020,MOGADOURO,43,3,512.0,"[480,960)",Muito Elevado,BRAGANÇA,0408,76064.93,8392,589,529,576,630,655,1285,1861,2390,2979,11.03,3.92,3.14,2.45
26-11-2020,MOIMENTA DA BEIRA,14,1,144.0,"[0,240)",Moderado,VISEU,1807,21996.9,9736,576,514,471,416,461,877,1348,1862,2438,44.26,11.08,8.46,6.13
26-11-2020,MOITA,262,19,407.0,"[240,480)",Elevado,SETÚBAL,1506,5525.98,64407,4226,3646,2623,1801,1425,3226,5849,9495,13721,1165.53,248.3,171.82,105.85
26-11-2020,MONÇÃO,80,6,448.0,"[240,480)",Elevado,VIANA DO CASTELO,1604,21130.85,17869,1161,1105,1031,1006,972,1978,3009,4114,5275,84.56,24.96,19.47,14.24
26-11-2020,MONCHIQUE,18,1,355.0,"[240,480)",Elevado,FARO,0809,39530.43,5077,353,384,321,355,392,747,1068,1452,1805,12.84,4.57,3.67,2.7
26-11-2020,MONDIM DE BASTO,107,8,1540.0,"[960, Max)",Extremamente Elevado,VILA REAL,1705,17207.52,6946,395,300,314,284,283,567,881,1181,1576,40.36,9.16,6.86,5.12
26-11-2020,MONFORTE,8,1,269.0,"[240,480)",Elevado,PORTALEGRE,1211,42024.82,2975,139,115,117,192,168,360,477,592,731,7.08,1.74,1.41,1.14
26-11-2020,MONTALEGRE,49,4,545.0,"[480,960)",Muito Elevado,VILA REAL,1706,80545.71,8997,699,628,595,603,730,1333,1928,2556,3255,11.17,4.04,3.17,2.39
26-11-2020,MONTEMOR-O-NOVO,56,4,358.0,"[240,480)",Elevado,ÉVORA,0706,123296.65,15647,991,953,868,878,971,1849,2717,3670,4661,12.69,3.78,2.98,2.2
26-11-2020,MONTEMOR-O-VELHO,115,8,456.0,"[240,480)",Elevado,COIMBRA,0610,22896.23,25224,1496,1397,1217,1057,988,2045,3262,4659,6155,110.17,26.88,20.35,14.25
26-11-2020,MONTIJO,230,16,399.0,"[240,480)",Elevado,SETÚBAL,1507,34861.64,57614,2771,2441,1990,1554,1109,2663,4653,7094,9865,165.26,28.3,20.35,13.35
26-11-2020,MORA,23,2,556.0,"[480,960)",Muito Elevado,ÉVORA,0707,44395.02,4138,336,275,252,238,257,495,747,1022,1358,9.32,3.06,2.3,1.68
26-11-2020,MORTÁGUA,28,2,318.0,"[240,480)",Elevado,VISEU,1808,25117.82,8803,638,584,535,499,460,959,1494,2078,2716,35.05,10.81,8.27,5.95
26-11-2020,MOURA,7,0,51.0,"[0,240)",Moderado,BEJA,0210,95845.55,13718,817,656,665,542,461,1003,1668,2324,3141,14.31,3.28,2.42,1.74
26-11-2020,MOURÃO,8,1,327.0,"[240,480)",Elevado,ÉVORA,0708,27862.98,2450,139,108,80,104,109,213,293,401,540,8.79,1.94,1.44,1.05
26-11-2020,MURÇA,44,3,805.0,"[480,960)",Muito Elevado,VILA REAL,1707,18937.11,5463,384,341,307,306,319,625,932,1273,1657,28.85,8.75,6.72,4.92
26-11-2020,MURTOSA,98,7,953.0,"[480,960)",Muito Elevado,AVEIRO,0112,7308.78,10279,509,473,403,353,409,762,1165,1638,2147,140.63,29.37,22.41,15.94
26-11-2020,NAZARÉ,67,5,473.0,"[240,480)",Elevado,LEIRIA,1011,8243.43,14165,967,903,670,420,396,816,1486,2389,3356,171.84,40.71,28.98,18.03
26-11-2020,NELAS,22,2,170.0,"[0,240)",Moderado,VISEU,1809,12571.48,12974,924,787,668,604,583,1187,1855,2642,3566,103.21,28.37,21.02,14.76
26-11-2020,NISA,49,3,808.0,"[480,960)",Muito Elevado,PORTALEGRE,1212,57567.84,6061,405,389,355,483,478,961,1316,1705,2110,10.53,3.67,2.96,2.29
26-11-2020,NORDESTE,1,0,21.0,"[0,240)",Moderado,AÇORES,4202,10146.8,4862,246,180,124,161,162,323,447,627,873,47.92,8.6,6.18,4.41
26-11-2020,ÓBIDOS,28,2,236.0,"[0,240)",Moderado,LEIRIA,1012,14155.44,11850,743,650,574,452,436,888,1462,2112,2855,83.72,20.17,14.92,10.33
26-11-2020,ODEMIRA,103,7,417.0,"[240,480)",Elevado,BEJA,0211,172060.15,24717,1475,1317,1225,1397,1349,2746,3971,5288,6763,14.37,3.93,3.07,2.31
26-11-2020,ODIVELAS,862,62,533.0,"[480,960)",Muito Elevado,LISBOA,1116,2654.36,161774,9562,9038,6952,4641,3812,8453,15405,24443,34005,6095.48,1281.27,920.99,580.44
26-11-2020,OEIRAS,711,51,401.0,"[240,480)",Elevado,LISBOA,1110,4588.31,177408,11580,11575,8566,6211,5855,12066,20632,32207,43787,3866.78,954.38,701.98,449.69
26-11-2020,OLEIROS,34,2,680.0,"[480,960)",Muito Elevado,CASTELO BRANCO,0506,47109.31,5003,384,341,366,397,487,884,1250,1591,1975,10.62,4.19,3.38,2.65
26-11-2020,OLHÃO,82,6,185.0,"[0,240)",Moderado,FARO,0810,13086.38,44405,2455,2309,1689,1342,1268,2610,4299,6608,9063,339.33,69.26,50.5,32.85
26-11-2020,OLIVEIRA DE AZEMÉIS,870,62,1318.0,"[960, Max)",Extremamente Elevado,AVEIRO,0113,16110.41,66011,4155,3614,2794,2183,1738,3921,6715,10329,14484,409.75,89.91,64.12,41.68
26-11-2020,OLIVEIRA DE FRADES,41,3,413.0,"[240,480)",Elevado,VISEU,1810,14534.62,9936,553,475,438,359,415,774,1212,1687,2240,68.36,15.41,11.61,8.34
26-11-2020,OLIVEIRA DO BAIRRO,170,12,700.0,"[480,960)",Muito Elevado,AVEIRO,0114,8731.99,24277,1327,1182,999,786,810,1596,2595,3777,5104,278.02,58.45,43.25,29.72
26-11-2020,OLIVEIRA DO HOSPITAL,29,2,151.0,"[0,240)",Moderado,COIMBRA,0611,23451.66,19253,1161,1097,962,924,960,1884,2846,3943,5104,82.1,21.76,16.81,12.14
26-11-2020,OURÉM,242,17,549.0,"[480,960)",Muito Elevado,SANTARÉM,1421,41668.03,44044,2463,2069,1899,1817,1603,3420,5319,7388,9851,105.7,23.64,17.73,12.77
26-11-2020,OURIQUE,3,0,65.0,"[0,240)",Moderado,BEJA,0212,66331.36,4607,313,287,284,268,227,495,779,1066,1379,6.95,2.08,1.61,1.17
26-11-2020,OVAR,549,39,1012.0,"[960, Max)",Extremamente Elevado,AVEIRO,0115,14770.25,54260,3294,2709,1994,1636,1234,2870,4864,7573,10867,367.37,73.57,51.27,32.93
26-11-2020,PAÇOS DE FERREIRA,1126,80,1985.0,"[960, Max)",Extremamente Elevado,PORTO,1309,7099.29,56728,2903,2193,1518,1135,664,1799,3317,5510,8413,799.1,118.51,77.62,46.72
26-11-2020,PALMELA,230,16,358.0,"[240,480)",Elevado,SETÚBAL,1508,46512.01,64269,3402,3244,2635,1846,1391,3237,5872,9116,12518,138.18,26.91,19.6,12.62
26-11-2020,PAMPILHOSA DA SERRA,25,2,619.0,"[480,960)",Muito Elevado,COIMBRA,0612,39646.24,4037,238,254,295,339,423,762,1057,1311,1549,10.18,3.91,3.31,2.67
26-11-2020,PAREDES,1337,95,1553.0,"[960, Max)",Extremamente Elevado,PORTO,1310,15675.69,86067,4272,3532,2412,1717,1258,2975,5387,8919,13191,549.04,84.15,56.9,34.36
26-11-2020,PAREDES DE COURA,24,2,281.0,"[240,480)",Elevado,VIANA DO CASTELO,1605,13818.59,8535,466,528,407,465,515,980,1387,1915,2381,61.76,17.23,13.86,10.04
26-11-2020,PEDRÓGÃO GRANDE,2,0,59.0,"[0,240)",Moderado,LEIRIA,1013,12874.75,3410,175,173,196,221,252,473,669,842,1017,26.49,7.9,6.54,5.2
26-11-2020,PENACOVA,77,5,562.0,"[480,960)",Muito Elevado,COIMBRA,0613,21673.23,13694,968,923,745,621,703,1324,2069,2992,3960,63.18,18.27,13.81,9.55
26-11-2020,PENAFIEL,1298,93,1860.0,"[960, Max)",Extremamente Elevado,PORTO,1311,21224.27,69772,3648,2823,2032,1663,1230,2893,4925,7748,11396,328.74,53.69,36.51,23.2
26-11-2020,PENALVA DO CASTELO,34,2,478.0,"[240,480)",Elevado,VISEU,1811,13433.92,7115,449,457,413,391,426,817,1230,1687,2136,52.96,15.9,12.56,9.16
26-11-2020,PENAMACOR,20,1,421.0,"[240,480)",Elevado,CASTELO BRANCO,0507,56370.69,4755,262,248,273,451,633,1084,1357,1605,1867,8.44,3.31,2.85,2.41
26-11-2020,PENEDONO,12,1,463.0,"[240,480)",Elevado,VISEU,1812,13370.75,2591,172,113,129,156,138,294,423,536,708,19.38,5.3,4.01,3.16
26-11-2020,PENELA,28,2,519.0,"[480,960)",Muito Elevado,COIMBRA,0614,13480.0,5397,314,324,274,359,344,703,977,1301,1615,40.04,11.98,9.65,7.25
26-11-2020,PENICHE,128,9,483.0,"[480,960)",Muito Elevado,LEIRIA,1014,7754.98,26501,1746,1504,1203,926,707,1633,2836,4340,6086,341.73,78.48,55.96,36.57
26-11-2020,PESO DA RÉGUA,44,3,279.0,"[240,480)",Elevado,VILA REAL,1708,9486.01,15773,1076,843,650,659,455,1114,1764,2607,3683,166.28,38.83,27.48,18.6
26-11-2020,PINHEL,8,1,94.0,"[0,240)",Moderado,GUARDA,0910,48452.12,8511,577,566,551,538,689,1227,1778,2344,2921,17.57,6.03,4.84,3.67
26-11-2020,POMBAL,303,22,589.0,"[480,960)",Muito Elevado,LEIRIA,1015,62600.28,51461,3187,2791,2494,2328,2027,4355,6849,9640,12827,82.21,20.49,15.4,10.94
26-11-2020,PONTA DELGADA,156,11,230.0,"[0,240)",Moderado,AÇORES,4203,23298.65,67935,3108,2435,1726,1133,902,2035,3761,6196,9304,291.58,39.93,26.59,16.14
26-11-2020,PONTA DO SOL,3,0,35.0,"[0,240)",Moderado,MADEIRA,3105,4622.03,8593,319,283,347,208,221,429,776,1059,1378,185.92,29.81,22.91,16.79
26-11-2020,PONTE DA BARCA,61,4,546.0,"[480,960)",Muito Elevado,VIANA DO CASTELO,1606,18211.37,11180,635,576,517,554,490,1044,1561,2137,2772,61.39,15.22,11.73,8.57
26-11-2020,PONTE DE LIMA,338,24,818.0,"[480,960)",Muito Elevado,VIANA DO CASTELO,1607,32025.46,41315,2321,2022,1720,1596,1462,3058,4778,6800,9121,129.01,28.48,21.23,14.92
26-11-2020,PONTE DE SOR,25,2,167.0,"[0,240)",Moderado,PORTALEGRE,1213,83971.16,14994,939,800,716,739,831,1570,2286,3086,4025,17.86,4.79,3.68,2.72
26-11-2020,PORTALEGRE,341,24,1538.0,"[960, Max)",Extremamente Elevado,PORTALEGRE,1214,44713.64,22172,1577,1351,1137,993,984,1977,3114,4465,6042,49.59,13.51,9.99,6.96
26-11-2020,PORTEL,0,0,0.0,"[0,240)",Moderado,ÉVORA,0709,60100.57,5828,336,358,283,331,305,636,919,1277,1613,9.7,2.68,2.12,1.53
26-11-2020,PORTIMÃO,243,17,438.0,"[240,480)",Elevado,FARO,0811,18206.29,55483,3182,2927,2116,1582,1400,2982,5098,8025,11207,304.75,61.56,44.08,28.0
26-11-2020,PORTO,2207,158,1019.0,"[960, Max)",Extremamente Elevado,PORTO,1312,4142.02,216606,15790,15193,11280,9409,10044,19453,30733,45926,61716,5229.5,1490.0,1108.79,741.98
26-11-2020,PORTO DE MÓS,68,5,292.0,"[240,480)",Elevado,LEIRIA,1016,26183.41,23275,1355,1210,1034,888,872,1760,2794,4004,5359,88.89,20.47,15.29,10.67
26-11-2020,PORTO MONIZ,1,0,43.0,"[0,240)",Moderado,MADEIRA,3106,8293.38,2342,143,130,95,98,120,218,313,443,586,28.24,7.07,5.34,3.77
26-11-2020,PORTO SANTO,0,0,0.0,"[0,240)",Moderado,MADEIRA,3201,4300.7,5202,240,157,134,110,68,178,312,469,709,120.95,16.48,10.9,7.25
26-11-2020,PÓVOA DE LANHOSO,399,29,1856.0,"[960, Max)",Extremamente Elevado,BRAGA,0309,13465.29,21499,1175,909,732,673,624,1297,2029,2938,4113,159.67,30.55,21.82,15.07
26-11-2020,PÓVOA DE VARZIM,1232,88,1962.0,"[960, Max)",Extremamente Elevado,PORTO,1313,8220.59,62784,3712,3120,2134,1594,1305,2899,5033,8153,11865,763.7,144.33,99.17,61.22
26-11-2020,POVOAÇÃO,16,1,270.0,"[240,480)",Elevado,AÇORES,4204,10640.77,5927,293,212,191,144,134,278,469,681,974,55.7,9.15,6.4,4.41
26-11-2020,VILA DA PRAIA DA VITÓRIA,37,3,174.0,"[0,240)",Moderado,AÇORES,4302,16127.06,21317,1133,789,619,436,336,772,1391,2180,3313,132.18,20.54,13.52,8.63
26-11-2020,PROENÇA-A-NOVA,27,2,370.0,"[240,480)",Elevado,CASTELO BRANCO,0508,39539.96,7298,508,465,389,400,560,960,1349,1814,2322,18.46,5.87,4.59,3.41
26-11-2020,REDONDO,20,1,315.0,"[240,480)",Elevado,ÉVORA,0710,36950.87,6353,349,325,288,288,354,642,930,1255,1604,17.19,4.34,3.4,2.52
26-11-2020,REGUENGOS DE MONSARAZ,65,5,649.0,"[480,960)",Muito Elevado,ÉVORA,0711,46399.72,10015,602,511,455,462,473,935,1390,1901,2503,21.58,5.39,4.1,3.0
26-11-2020,RESENDE,53,4,523.0,"[480,960)",Muito Elevado,VISEU,1813,12334.93,10137,560,493,448,433,422,855,1303,1796,2356,82.18,19.1,14.56,10.56
26-11-2020,RIBEIRA BRAVA,3,0,24.0,"[0,240)",Moderado,MADEIRA,3107,6544.88,12435,648,500,411,311,287,598,1009,1509,2157,189.99,32.96,23.06,15.42
26-11-2020,RIBEIRA DE PENA,14,1,233.0,"[0,240)",Moderado,VILA REAL,1709,21745.98,6016,371,301,290,310,368,678,968,1269,1640,27.66,7.54,5.84,4.45
26-11-2020,RIBEIRA GRANDE,44,3,134.0,"[0,240)",Moderado,AÇORES,4205,18015.13,32811,1163,689,512,345,253,598,1110,1799,2962,182.13,16.44,9.99,6.16
26-11-2020,RIO MAIOR,87,6,427.0,"[240,480)",Elevado,SANTARÉM,1414,27276.45,20379,1251,1144,941,795,648,1443,2384,3528,4779,74.71,17.52,12.93,8.74
26-11-2020,SABROSA,18,1,304.0,"[240,480)",Elevado,VILA REAL,1710,15692.45,5918,393,314,304,302,350,652,956,1270,1663,37.71,10.6,8.09,6.09
26-11-2020,SABUGAL,92,7,869.0,"[480,960)",Muito Elevado,GUARDA,0911,82269.82,10585,724,707,694,796,1009,1805,2499,3206,3930,12.87,4.78,3.9,3.04
26-11-2020,SALVATERRA DE MAGOS,78,6,366.0,"[240,480)",Elevado,SANTARÉM,1415,24393.2,21295,1275,1181,1060,799,772,1571,2631,3812,5087,87.3,20.85,15.63,10.79
26-11-2020,SANTA COMBA DÃO,20,1,191.0,"[0,240)",Moderado,VISEU,1814,11194.77,10452,732,684,569,538,464,1002,1571,2255,2987,93.36,26.68,20.14,14.03
26-11-2020,SANTA CRUZ,47,3,104.0,"[0,240)",Moderado,MADEIRA,3108,8150.28,45281,1817,1301,974,716,523,1239,2213,3514,5331,555.6,65.41,43.12,27.15
26-11-2020,SANTA CRUZ DA GRACIOSA,2,0,48.0,"[0,240)",Moderado,AÇORES,4401,6065.78,4208,228,180,163,124,145,269,432,612,840,69.37,13.85,10.09,7.12
26-11-2020,SANTA CRUZ DAS FLORES,2,0,92.0,"[0,240)",Moderado,AÇORES,4802,7091.44,2165,125,98,74,56,51,107,181,279,404,30.53,5.7,3.93,2.55
26-11-2020,SANTA MARIA DA FEIRA,2186,156,1577.0,"[960, Max)",Extremamente Elevado,AVEIRO,0109,21587.65,138636,8182,6743,4771,3856,3079,6935,11706,18449,26631,642.19,123.36,85.46,54.22
26-11-2020,SANTA MARTA DE PENAGUIÃO,44,3,667.0,"[480,960)",Muito Elevado,VILA REAL,1711,6928.13,6599,483,373,337,316,317,633,970,1343,1826,95.25,26.36,19.39,14.0
26-11-2020,SANTANA,3,0,45.0,"[0,240)",Moderado,MADEIRA,3109,9547.3,6711,418,353,343,282,277,559,902,1255,1673,70.29,17.52,13.15,9.45
26-11-2020,SANTARÉM,288,21,502.0,"[480,960)",Muito Elevado,SANTARÉM,1416,55253.58,57421,3654,3441,2760,2466,2206,4672,7432,10873,14527,103.92,26.29,19.68,13.45
26-11-2020,SANTIAGO DO CACÉM,41,3,142.0,"[0,240)",Moderado,SETÚBAL,1509,105969.29,28791,2144,1689,1472,1295,1215,2510,3982,5671,7815,27.17,7.37,5.35,3.76
26-11-2020,SANTO TIRSO,1199,86,1762.0,"[960, Max)",Extremamente Elevado,PORTO,1314,13655.52,68055,4911,3935,2761,2257,1810,4067,6828,10763,15674,498.35,114.78,78.82,50.0
26-11-2020,SÃO BRÁS DE ALPORTEL,15,1,144.0,"[0,240)",Moderado,FARO,0812,15336.92,10416,596,468,467,404,401,805,1272,1740,2336,67.91,15.23,11.35,8.29
26-11-2020,SÃO JOÃO DA MADEIRA,331,24,1507.0,"[960, Max)",Extremamente Elevado,AVEIRO,0116,794.3,21958,1347,1069,796,601,593,1194,1990,3059,4406,2765.49,554.91,385.26,250.63
26-11-2020,SÃO JOÃO DA PESQUEIRA,24,2,337.0,"[240,480)",Elevado,VISEU,1815,26610.85,7125,417,330,294,328,328,656,950,1280,1697,26.77,6.38,4.81,3.57
26-11-2020,SÃO PEDRO DO SUL,67,5,435.0,"[240,480)",Elevado,VISEU,1816,34895.09,15403,990,962,861,759,909,1668,2529,3491,4481,44.14,12.84,10.0,7.25
26-11-2020,SÃO ROQUE DO PICO,1,0,31.0,"[0,240)",Moderado,AÇORES,4603,14236.1,3266,199,141,93,96,113,209,302,443,642,22.94,4.51,3.11,2.12
26-11-2020,SÃO VICENTE,1,0,19.0,"[0,240)",Moderado,MADEIRA,3110,7883.71,5143,272,264,266,225,280,505,771,1035,1307,65.23,16.58,13.13,9.78
26-11-2020,SARDOAL,31,2,829.0,"[480,960)",Muito Elevado,SANTARÉM,1417,9214.72,3741,227,178,148,165,248,413,561,739,966,40.6,10.48,8.02,6.09
26-11-2020,SÁTÃO,96,7,829.0,"[480,960)",Muito Elevado,VISEU,1817,20194.11,11580,765,671,515,465,476,941,1456,2127,2892,57.34,14.32,10.53,7.21
26-11-2020,SEIA,153,11,688.0,"[480,960)",Muito Elevado,GUARDA,0912,43568.83,22234,1807,1589,1238,1122,721,1843,3081,4670,6477,51.03,14.87,10.72,7.07
26-11-2020,SEIXAL,923,66,550.0,"[480,960)",Muito Elevado,SETÚBAL,1510,9545.17,167752,10586,9270,6661,4391,2930,7321,13982,23252,33838,1757.49,354.51,243.6,146.49
26-11-2020,SERNANCELHE,3,0,56.0,"[0,240)",Moderado,VISEU,1818,22861.22,5396,305,293,286,273,260,533,819,1112,1417,23.6,6.2,4.86,3.58
26-11-2020,SERPA,65,5,454.0,"[240,480)",Elevado,BEJA,0213,110563.34,14304,903,761,719,697,626,1323,2042,2803,3706,12.94,3.35,2.54,1.85
26-11-2020,SERTÃ,15,1,103.0,"[0,240)",Moderado,CASTELO BRANCO,0509,44673.17,14577,870,779,790,767,1020,1787,2577,3356,4226,32.63,9.46,7.51,5.77
26-11-2020,SESIMBRA,202,14,390.0,"[240,480)",Elevado,SETÚBAL,1511,19571.75,51858,2400,2321,1853,1257,1083,2340,4193,6514,8914,264.96,45.54,33.28,21.42
26-11-2020,SETÚBAL,577,41,501.0,"[480,960)",Muito Elevado,SETÚBAL,1512,23032.5,115126,7425,6929,5075,3775,2655,6430,11505,18434,25859,499.83,112.27,80.03,49.95
26-11-2020,SEVER DO VOUGA,51,4,450.0,"[240,480)",Elevado,AVEIRO,0117,12987.56,11331,766,637,568,540,567,1107,1675,2312,3078,87.24,23.7,17.8,12.9
26-11-2020,SILVES,68,5,188.0,"[0,240)",Moderado,FARO,0813,68006.23,36226,2137,1869,1610,1423,1600,3023,4633,6502,8639,53.27,12.7,9.56,6.81
26-11-2020,SINES,78,6,569.0,"[480,960)",Muito Elevado,SETÚBAL,1513,20330.17,13715,888,791,551,416,268,684,1235,2026,2914,67.46,14.33,9.97,6.07
26-11-2020,SINTRA,2098,150,536.0,"[480,960)",Muito Elevado,LISBOA,1111,31922.73,391402,20490,18316,13545,9137,7284,16421,29966,48282,68772,1226.08,215.43,151.25,93.87
26-11-2020,SOBRAL DE MONTE AGRAÇO,47,3,441.0,"[240,480)",Elevado,LISBOA,1112,5210.32,10651,564,507,352,272,212,484,836,1343,1907,204.43,36.6,25.78,16.05
26-11-2020,SOURE,71,5,415.0,"[240,480)",Elevado,COIMBRA,0615,26506.07,17120,1173,1142,1004,883,987,1870,2874,4016,5189,64.59,19.58,15.15,10.84
26-11-2020,SOUSEL,4,0,91.0,"[0,240)",Moderado,PORTALEGRE,1215,27932.18,4412,261,274,208,302,292,594,802,1076,1337,15.8,4.79,3.85,2.87
26-11-2020,TÁBUA,27,2,238.0,"[0,240)",Moderado,COIMBRA,0616,19978.58,11368,729,584,524,430,464,894,1418,2002,2731,56.9,13.67,10.02,7.1
26-11-2020,TABUAÇO,13,1,215.0,"[0,240)",Moderado,VISEU,1819,13385.67,6033,372,314,217,282,363,645,862,1176,1548,45.07,11.56,8.79,6.44
26-11-2020,TAROUCA,47,3,602.0,"[480,960)",Muito Elevado,VISEU,1820,10008.49,7804,405,335,313,277,324,601,914,1249,1654,77.98,16.53,12.48,9.13
26-11-2020,TAVIRA,58,4,236.0,"[0,240)",Moderado,FARO,0814,60696.7,24530,1493,1415,1252,1066,1277,2343,3595,5010,6503,40.41,10.71,8.25,5.92
26-11-2020,TERRAS DE BOURO,25,2,393.0,"[240,480)",Elevado,BRAGA,0310,27746.07,6361,391,372,296,319,340,659,955,1327,1718,22.93,6.19,4.78,3.44
26-11-2020,TOMAR,118,8,321.0,"[240,480)",Elevado,SANTARÉM,1418,35120.44,36748,2403,2189,1868,1853,1822,3675,5543,7732,10135,104.64,28.86,22.02,15.78
26-11-2020,TONDELA,62,4,235.0,"[0,240)",Moderado,VISEU,1821,37121.73,26357,1768,1722,1518,1475,1417,2892,4410,6132,7900,71.0,21.28,16.52,11.88
26-11-2020,TORRE DE MONCORVO,48,3,624.0,"[480,960)",Muito Elevado,BRAGANÇA,0409,53155.67,7695,556,478,488,551,719,1270,1758,2236,2792,14.48,5.25,4.21,3.31
26-11-2020,TORRES NOVAS,145,10,415.0,"[240,480)",Elevado,SANTARÉM,1419,26999.68,34933,2324,1979,1738,1406,1475,2881,4619,6598,8922,129.38,33.04,24.44,17.11
26-11-2020,TORRES VEDRAS,385,27,490.0,"[480,960)",Muito Elevado,LISBOA,1113,40714.89,78530,4513,3945,3447,2628,2104,4732,8179,12124,16637,192.88,40.86,29.78,20.09
26-11-2020,TRANCOSO,39,3,439.0,"[240,480)",Elevado,GUARDA,0913,36152.47,8875,581,557,542,586,496,1082,1624,2181,2762,24.55,7.64,6.03,4.49
26-11-2020,TROFA,753,54,1960.0,"[960, Max)",Extremamente Elevado,PORTO,1318,7201.76,38418,2336,1894,1231,939,684,1623,2854,4748,7084,533.44,98.36,65.93,39.63
26-11-2020,VAGOS,131,9,576.0,"[480,960)",Muito Elevado,AVEIRO,0118,16491.5,22740,1320,1205,922,784,724,1508,2430,3635,4955,137.89,30.04,22.04,14.73
26-11-2020,VALE DE CAMBRA,267,19,1252.0,"[960, Max)",Extremamente Elevado,AVEIRO,0119,14733.47,21327,1491,1363,1005,831,798,1629,2634,3997,5488,144.76,37.25,27.13,17.88
26-11-2020,VALENÇA,188,13,1415.0,"[960, Max)",Extremamente Elevado,VIANA DO CASTELO,1608,11712.86,13290,867,791,582,582,503,1085,1667,2458,3325,113.46,28.39,20.99,14.23
26-11-2020,VALONGO,1258,90,1291.0,"[960, Max)",Extremamente Elevado,PORTO,1315,7512.45,97444,5629,4696,3207,2462,1829,4291,7498,12194,17823,1297.18,237.26,162.33,99.81
26-11-2020,VALPAÇOS,133,10,898.0,"[480,960)",Muito Elevado,VILA REAL,1712,54873.93,14818,1217,1118,999,928,997,1925,2924,4042,5259,27.0,9.58,7.37,5.33
26-11-2020,VELAS,2,0,39.0,"[0,240)",Moderado,AÇORES,4502,11738.38,5093,278,208,166,153,113,266,432,640,918,43.39,7.82,5.45,3.68
26-11-2020,VENDAS NOVAS,7,0,62.0,"[0,240)",Moderado,ÉVORA,0712,22238.88,11255,677,768,655,501,532,1033,1688,2456,3133,50.61,14.09,11.04,7.59
26-11-2020,VIANA DO ALENTEJO,11,1,214.0,"[0,240)",Moderado,ÉVORA,0713,39367.29,5145,245,208,235,210,214,424,659,867,1112,13.07,2.82,2.2,1.67
26-11-2020,VIANA DO CASTELO,485,35,575.0,"[480,960)",Muito Elevado,VIANA DO CASTELO,1609,31902.01,84417,5470,4433,3591,3061,2982,6043,9634,14067,19537,264.61,61.24,44.09,30.2
26-11-2020,VIDIGUEIRA,5,0,91.0,"[0,240)",Moderado,BEJA,0214,31661.09,5510,300,248,215,233,275,508,723,971,1271,17.4,4.01,3.07,2.28
26-11-2020,VIEIRA DO MINHO,170,12,1436.0,"[960, Max)",Extremamente Elevado,BRAGA,0311,21644.35,11842,703,594,525,548,482,1030,1555,2149,2852,54.71,13.18,9.93,7.18
26-11-2020,VILA DE REI,2,0,60.0,"[0,240)",Moderado,CASTELO BRANCO,0510,19154.6,3323,169,128,172,247,302,549,721,849,1018,17.35,5.31,4.43,3.76
26-11-2020,VILA DO BISPO,23,2,446.0,"[240,480)",Elevado,FARO,0815,17906.06,5154,302,302,314,232,233,465,779,1081,1383,28.78,7.72,6.04,4.35
26-11-2020,VILA DO CONDE,1444,103,1807.0,"[960, Max)",Extremamente Elevado,PORTO,1316,14902.77,79899,4726,3875,2819,2070,1743,3813,6632,10507,15233,536.13,102.21,70.5,44.5
26-11-2020,VILA DO PORTO,5,0,89.0,"[0,240)",Moderado,AÇORES,4101,9688.74,5616,274,212,135,96,123,219,354,566,840,57.96,8.67,5.84,3.65
26-11-2020,VILA FLOR,12,1,199.0,"[0,240)",Moderado,BRAGANÇA,0410,26581.14,6044,429,362,422,294,331,625,1047,1409,1838,22.74,6.91,5.3,3.94
26-11-2020,VILA FRANCA DE XIRA,795,57,560.0,"[480,960)",Muito Elevado,LISBOA,1114,31819.39,141957,8501,6852,4869,3425,2472,5897,10766,17618,26119,446.14,82.09,55.37,33.84
26-11-2020,VILA FRANCA DO CAMPO,7,0,63.0,"[0,240)",Moderado,AÇORES,4206,7796.82,11051,450,344,248,217,154,371,619,963,1413,141.73,18.12,12.35,7.94
26-11-2020,VILA NOVA DA BARQUINHA,21,1,281.0,"[240,480)",Elevado,SANTARÉM,1420,4952.97,7461,415,406,392,364,338,702,1094,1500,1915,150.64,38.66,30.28,22.09
26-11-2020,VILA NOVA DE CERVEIRA,36,3,404.0,"[240,480)",Elevado,VIANA DO CASTELO,1610,10846.66,8910,531,444,410,384,334,718,1128,1572,2103,82.14,19.39,14.49,10.4
26-11-2020,VILA NOVA DE FAMALICÃO,2774,198,2107.0,"[960, Max)",Extremamente Elevado,BRAGA,0312,20159.26,131676,7817,6164,4202,3282,2749,6031,10233,16397,24214,653.19,120.12,81.34,50.76
26-11-2020,VILA NOVA DE FOZ CÔA,34,2,523.0,"[480,960)",Muito Elevado,GUARDA,0914,39815.18,6503,442,385,390,398,429,827,1217,1602,2044,16.33,5.13,4.02,3.06
26-11-2020,VILA NOVA DE GAIA,3311,237,1102.0,"[960, Max)",Extremamente Elevado,PORTO,1317,16846.43,300472,18349,15568,10972,8224,6281,14505,25477,41045,59394,1783.64,352.57,243.65,151.23
26-11-2020,VILA NOVA DE PAIVA,37,3,789.0,"[480,960)",Muito Elevado,VISEU,1822,17553.28,4687,289,272,233,217,241,458,691,963,1252,26.7,7.13,5.49,3.94
26-11-2020,VILA NOVA DE POIARES,36,3,519.0,"[480,960)",Muito Elevado,COIMBRA,0617,8445.3,6939,380,284,262,235,182,417,679,963,1343,82.17,15.9,11.4,8.04
26-11-2020,VILA POUCA DE AGUIAR,99,7,828.0,"[480,960)",Muito Elevado,VILA REAL,1713,43706.62,11961,860,817,733,601,627,1228,1961,2778,3638,27.37,8.32,6.36,4.49
26-11-2020,VILA REAL,327,23,654.0,"[480,960)",Muito Elevado,VILA REAL,1714,37880.28,49962,3025,2498,2065,1579,1466,3045,5110,7608,10633,131.9,28.07,20.08,13.49
26-11-2020,VILA REAL DE SANTO ANTÓNIO,25,2,133.0,"[0,240)",Moderado,FARO,0816,6125.0,18749,1172,1069,811,569,586,1155,1966,3035,4207,306.11,68.69,49.55,32.1
26-11-2020,VILA VELHA DE RÓDÃO,0,0,0.0,"[0,240)",Moderado,CASTELO BRANCO,0511,32991.16,3144,209,229,180,283,306,589,769,998,1207,9.53,3.66,3.03,2.33
26-11-2020,VILA VERDE,477,34,1017.0,"[960, Max)",Extremamente Elevado,BRAGA,0313,22866.52,46911,2365,2063,1667,1494,1437,2931,4598,6661,9026,205.15,39.47,29.13,20.11
26-11-2020,VILA VIÇOSA,15,1,196.0,"[0,240)",Moderado,ÉVORA,0714,19485.89,7656,487,379,342,345,324,669,1011,1390,1877,39.29,9.63,7.13,5.19
26-11-2020,VIMIOSO,28,2,696.0,"[480,960)",Muito Elevado,BRAGANÇA,0411,48158.51,4023,274,230,261,293,335,628,889,1119,1393,8.35,2.89,2.32,1.85
26-11-2020,VINHAIS,29,2,374.0,"[240,480)",Elevado,BRAGANÇA,0412,69475.09,7746,599,577,636,641,815,1456,2092,2669,3268,11.15,4.7,3.84,3.01
26-11-2020,VISEU,448,32,461.0,"[240,480)",Elevado,VISEU,1823,50710.14,97249,5769,5038,4140,3158,2710,5868,10008,15046,20815,191.77,41.05,29.67,19.74
26-11-2020,VIZELA,463,33,1937.0,"[960, Max)",Extremamente Elevado,BRAGA,0314,2469.83,23897,1258,928,655,509,371,880,1535,2463,3721,967.49,150.65,99.72,62.15
26-11-2020,VOUZELA,30,2,312.0,"[240,480)",Elevado,VISEU,1824,19369.46,9619,626,605,554,532,507,1039,1593,2198,2824,49.66,14.58,11.35,8.22
