;TYPE;DATE;YEAR;WEEK;REGION;AGEGROUP;TOTAL_VAC_1;TOTAL_VAC_2;TOTAL_VAC_UNK;TOTAL;CUMUL_VAC_1;CUMUL_VAC_2;CUMUL_VAC_UNK;CUMUL;CUMUL_VAC_INIT;CUMUL_VAC_COMPLETE;CUMUL_VAC_LEAST;COVER_1_VAC;COVER;COVER_INIT;COVER_COMPLETE;COVER_LEAST;RECEIVED;DISTRIBUTED
1;REGIONAL;04/01/21;2021;1;Outro;All;23;0;0;23;24;0;0;24;24;0;24;NA;NA;NA;NA;NA;NA;NA
2;REGIONAL;11/01/21;2021;2;Outro;All;6;0;0;6;30;0;0;30;30;0;30;NA;NA;NA;NA;NA;NA;NA
3;REGIONAL;18/01/21;2021;3;Outro;All;23;1;0;24;53;1;0;54;52;1;53;NA;NA;NA;NA;NA;NA;NA
4;REGIONAL;25/01/21;2021;4;Outro;All;6;20;0;26;59;21;0;80;38;21;59;NA;NA;NA;NA;NA;NA;NA
5;REGIONAL;01/02/21;2021;5;Outro;All;9;5;0;14;68;26;0;94;42;26;68;NA;NA;NA;NA;NA;NA;NA
6;REGIONAL;08/02/21;2021;6;Outro;All;83;22;0;105;151;48;0;199;103;48;151;NA;NA;NA;NA;NA;NA;NA
7;REGIONAL;15/02/21;2021;7;Outro;All;64;7;0;71;215;55;0;270;160;55;215;NA;NA;NA;NA;NA;NA;NA
8;REGIONAL;22/02/21;2021;8;Outro;All;98;7;0;105;313;62;0;375;251;62;313;NA;NA;NA;NA;NA;NA;NA
9;REGIONAL;01/03/21;2021;9;Outro;All;72;83;0;155;385;145;0;530;240;145;385;NA;NA;NA;NA;NA;NA;NA
10;REGIONAL;08/03/21;2021;10;Outro;All;50;60;0;110;435;205;0;640;230;205;435;NA;NA;NA;NA;NA;NA;NA
11;REGIONAL;15/03/21;2021;11;Outro;All;60;97;0;157;495;302;0;797;193;302;495;NA;NA;NA;NA;NA;NA;NA
12;REGIONAL;22/03/21;2021;12;Outro;All;58;21;0;79;553;323;0;876;230;323;553;NA;NA;NA;NA;NA;NA;NA
13;REGIONAL;29/03/21;2021;13;Outro;All;43;51;0;94;596;374;0;970;223;374;597;NA;NA;NA;NA;NA;NA;NA
14;REGIONAL;05/04/21;2021;14;Outro;All;99;50;0;149;695;424;0;1119;272;424;696;NA;NA;NA;NA;NA;NA;NA
15;REGIONAL;12/04/21;2021;15;Outro;All;184;51;1;236;879;475;1;1355;405;475;880;NA;NA;NA;NA;NA;NA;NA
16;REGIONAL;19/04/21;2021;16;Outro;All;114;51;0;165;993;526;1;1520;468;526;994;NA;NA;NA;NA;NA;NA;NA
17;REGIONAL;26/04/21;2021;17;Outro;All;73;43;0;116;1066;569;1;1636;498;569;1067;NA;NA;NA;NA;NA;NA;NA
18;REGIONAL;03/05/21;2021;18;Outro;All;31;87;0;118;1097;656;1;1754;442;656;1098;NA;NA;NA;NA;NA;NA;NA
19;REGIONAL;10/05/21;2021;19;Outro;All;55;135;1;191;1152;791;2;1945;364;791;1155;NA;NA;NA;NA;NA;NA;NA
20;REGIONAL;17/05/21;2021;20;Outro;All;21;82;0;103;1173;873;2;2048;303;873;1176;NA;NA;NA;NA;NA;NA;NA
21;REGIONAL;24/05/21;2021;21;Outro;All;27;70;0;97;1200;943;2;2145;260;943;1203;NA;NA;NA;NA;NA;NA;NA
22;REGIONAL;31/05/21;2021;22;Outro;All;35;43;0;78;1235;986;2;2223;253;986;1239;NA;NA;NA;NA;NA;NA;NA
23;REGIONAL;07/06/21;2021;23;Outro;All;36;67;0;103;1271;1053;2;2326;232;1053;1285;NA;NA;NA;NA;NA;NA;NA
24;REGIONAL;14/06/21;2021;24;Outro;All;28;49;0;77;1299;1102;2;2403;229;1102;1331;NA;NA;NA;NA;NA;NA;NA
25;REGIONAL;21/06/21;2021;25;Outro;All;61;42;2;105;1360;1144;4;2508;253;1144;1397;NA;NA;NA;NA;NA;NA;NA
26;REGIONAL;28/06/21;2021;26;Outro;All;34;56;0;90;1394;1200;4;2598;240;1200;1440;NA;NA;NA;NA;NA;NA;NA
27;REGIONAL;05/07/21;2021;27;Outro;All;52;109;0;161;1446;1309;4;2759;197;1309;1506;NA;NA;NA;NA;NA;NA;NA
28;REGIONAL;12/07/21;2021;28;Outro;All;30;59;1;90;1476;1368;5;2849;180;1368;1548;NA;NA;NA;NA;NA;NA;NA
29;REGIONAL;19/07/21;2021;29;Outro;All;34;84;0;118;1510;1452;5;2967;161;1452;1613;NA;NA;NA;NA;NA;NA;NA
30;REGIONAL;26/07/21;2021;30;Outro;All;24;44;0;68;1534;1496;5;3035;164;1496;1660;NA;NA;NA;NA;NA;NA;NA
31;REGIONAL;04/01/21;2021;1;ARS Alentejo;All;3468;1;0;3469;4692;1;0;4693;4691;1;4692;0,010143374;2,16E-06;0,010141212;2,16E-06;0,010143374;NA;NA
32;REGIONAL;11/01/21;2021;2;ARS Alentejo;All;5357;10;0;5367;10049;11;0;10060;10038;11;10049;0,021724373;2,38E-05;0,021700593;2,38E-05;0,021724373;NA;NA
33;REGIONAL;18/01/21;2021;3;ARS Alentejo;All;10444;1134;0;11578;20493;1145;0;21638;19348;1145;20493;0,044302675;0,002475312;0,041827364;0,002475312;0,044302675;NA;NA
34;REGIONAL;25/01/21;2021;4;ARS Alentejo;All;2294;3122;0;5416;22787;4267;0;27054;18520;4267;22787;0,049261946;0,00922459;0,040037357;0,00922459;0,049261946;NA;NA
35;REGIONAL;01/02/21;2021;5;ARS Alentejo;All;1446;4345;0;5791;24233;8612;0;32845;15621;8612;24233;0,052387973;0,018617803;0,03377017;0,018617803;0,052387973;NA;NA
36;REGIONAL;08/02/21;2021;6;ARS Alentejo;All;3333;8794;0;12127;27566;17406;0;44972;10160;17406;27566;0,0595934;0,037629062;0,021964338;0,037629062;0,0595934;NA;NA
37;REGIONAL;15/02/21;2021;7;ARS Alentejo;All;4058;2813;0;6871;31624;20219;0;51843;11405;20219;31624;0,068366165;0,04371033;0,024655834;0,04371033;0,068366165;NA;NA
38;REGIONAL;22/02/21;2021;8;ARS Alentejo;All;12038;1650;0;13688;43662;21869;0;65531;21793;21869;43662;0,094390446;0,047277373;0,047113073;0,047277373;0,094390446;NA;NA
39;REGIONAL;01/03/21;2021;9;ARS Alentejo;All;10453;2829;1;13283;54115;24698;1;78814;29417;24698;54115;0,116988205;0,053393231;0,063594974;0,053393231;0,116988205;NA;NA
40;REGIONAL;08/03/21;2021;10;ARS Alentejo;All;5829;1671;0;7500;59944;26369;1;86314;33575;26369;59944;0,129589595;0,057005673;0,072583923;0,057005673;0,129589595;NA;NA
41;REGIONAL;15/03/21;2021;11;ARS Alentejo;All;3699;7729;0;11428;63643;34098;1;97742;29546;34098;63644;0,137586258;0,073714567;0,063873852;0,073714567;0,137588419;NA;NA
42;REGIONAL;22/03/21;2021;12;ARS Alentejo;All;11896;2104;0;14000;75539;36202;1;111742;39339;36202;75541;0,163303558;0,078263088;0,085044793;0,078263088;0,163307881;NA;NA
43;REGIONAL;29/03/21;2021;13;ARS Alentejo;All;6155;6275;0;12430;81694;42477;1;124172;39219;42477;81696;0,176609709;0,091828661;0,084785372;0,091828661;0,176614033;NA;NA
44;REGIONAL;05/04/21;2021;14;ARS Alentejo;All;14050;4303;0;18353;95744;46780;1;142525;48968;46780;95748;0,206983622;0,101131077;0,105861192;0,101131077;0,206992269;NA;NA
45;REGIONAL;12/04/21;2021;15;ARS Alentejo;All;21902;2959;0;24861;117646;49739;1;167386;67911;49739;117650;0,254332336;0,107527974;0,146813009;0,107527974;0,254340983;NA;NA
46;REGIONAL;19/04/21;2021;16;ARS Alentejo;All;11359;5955;1;17315;129005;55694;2;184701;73315;55694;129009;0,278888726;0,120401757;0,158495616;0,120401757;0,278897373;NA;NA
47;REGIONAL;26/04/21;2021;17;ARS Alentejo;All;20223;2776;0;22999;149228;58470;2;207700;90767;58470;149237;0,322607703;0,126403037;0,196224123;0,126403037;0,32262716;NA;NA
48;REGIONAL;03/05/21;2021;18;ARS Alentejo;All;13680;14305;1;27986;162908;72775;3;235686;93251;72775;166026;0,352181733;0,15732822;0,201594144;0,15732822;0,358922364;NA;NA
49;REGIONAL;10/05/21;2021;19;ARS Alentejo;All;17429;15244;0;32673;180337;88019;3;268359;95942;88019;183961;0,389860518;0,190283375;0,207411667;0,190283375;0,397695042;NA;NA
50;REGIONAL;17/05/21;2021;20;ARS Alentejo;All;13212;12201;1;25414;193549;100220;4;293773;100371;100220;200591;0,418422805;0,216660037;0,216986476;0,216660037;0,433646513;NA;NA
51;REGIONAL;24/05/21;2021;21;ARS Alentejo;All;7177;18507;5;25689;200726;118727;9;319462;91172;118727;209899;0,433938361;0,25666929;0,19709967;0,25666929;0,453768959;NA;NA
52;REGIONAL;31/05/21;2021;22;ARS Alentejo;All;17389;7277;1;24667;218115;126004;10;344129;101623;126004;227627;0,471530672;0,272401031;0,219693105;0,272401031;0,492094135;NA;NA
53;REGIONAL;07/06/21;2021;23;ARS Alentejo;All;13795;15248;0;29043;231910;141252;10;373172;100805;141252;242057;0,501353315;0,305364833;0,217924716;0,305364833;0,523289549;NA;NA
54;REGIONAL;14/06/21;2021;24;ARS Alentejo;All;10218;19201;1;29420;242128;160453;11;402592;93484;160453;253937;0,52344304;0,346874405;0,202097854;0,346874405;0,548972259;NA;NA
55;REGIONAL;21/06/21;2021;25;ARS Alentejo;All;10625;14341;1;24967;252753;174794;12;427559;92719;174794;267513;0,546412636;0,377877415;0,200444043;0,377877415;0,578321458;NA;NA
56;REGIONAL;28/06/21;2021;26;ARS Alentejo;All;11093;27157;0;38250;263846;201951;12;465809;77185;201951;279136;0,570393975;0,436586621;0,166861953;0,436586621;0,603448574;NA;NA
57;REGIONAL;05/07/21;2021;27;ARS Alentejo;All;15297;27744;2;43043;279143;229695;14;508852;65421;229695;295116;0,603463707;0,496564829;0,141430017;0,496564829;0,637994846;NA;NA
58;REGIONAL;12/07/21;2021;28;ARS Alentejo;All;8135;20443;1;28579;287278;250138;15;537431;56750;250138;306888;0,62105031;0,540759413;0,122684665;0,540759413;0,663444077;NA;NA
59;REGIONAL;19/07/21;2021;29;ARS Alentejo;All;3493;16685;2;20180;290771;266823;17;557611;47893;266823;314716;0,628601633;0,576829785;0,10353721;0,576829785;0,680366995;NA;NA
60;REGIONAL;26/07/21;2021;30;ARS Alentejo;All;2167;16230;0;18397;292938;283053;17;576008;38396;283053;321449;0,633286349;0,611916518;0,083006174;0,611916518;0,694922692;NA;NA
61;REGIONAL;04/01/21;2021;1;ARS Algarve;All;1251;1;0;1252;2309;1;0;2310;2308;1;2309;0,005272051;2,28E-06;0,005269767;2,28E-06;0,005272051;NA;NA
62;REGIONAL;11/01/21;2021;2;ARS Algarve;All;1356;3;0;1359;3665;4;0;3669;3661;4;3665;0,008368153;9,13E-06;0,00835902;9,13E-06;0,008368153;NA;NA
63;REGIONAL;18/01/21;2021;3;ARS Algarve;All;3396;947;0;4343;7061;951;0;8012;6110;951;7061;0,016122109;0,002171382;0,013950727;0,002171382;0,016122109;NA;NA
64;REGIONAL;25/01/21;2021;4;ARS Algarve;All;2151;1230;1;3382;9212;2181;1;11394;7031;2181;9212;0,021033404;0,004979793;0,016053611;0,004979793;0,021033404;NA;NA
65;REGIONAL;01/02/21;2021;5;ARS Algarve;All;1216;1248;0;2464;10428;3429;1;13858;7001;3429;10430;0,02380985;0,007829303;0,015985113;0,007829303;0,023814417;NA;NA
66;REGIONAL;08/02/21;2021;6;ARS Algarve;All;2396;2902;0;5298;12824;6331;1;19156;6495;6331;12826;0,029280544;0,014455328;0,014829783;0,014455328;0,029285111;NA;NA
67;REGIONAL;15/02/21;2021;7;ARS Algarve;All;3189;2121;0;5310;16013;8452;1;24466;7563;8452;16015;0,036561865;0,019298125;0,017268306;0,019298125;0,036566431;NA;NA
68;REGIONAL;22/02/21;2021;8;ARS Algarve;All;8501;1072;0;9573;24514;9524;1;34039;14992;9524;24516;0,05597187;0,021745782;0,034230655;0,021745782;0,055976437;NA;NA
69;REGIONAL;01/03/21;2021;9;ARS Algarve;All;4648;556;0;5204;29162;10080;1;39243;19084;10080;29164;0,066584469;0,023015275;0,043573761;0,023015275;0,066589036;NA;NA
70;REGIONAL;08/03/21;2021;10;ARS Algarve;All;5117;1545;0;6662;34279;11625;1;45905;22657;11625;34282;0,078267918;0,026542914;0,051731854;0,026542914;0,078274768;NA;NA
71;REGIONAL;15/03/21;2021;11;ARS Algarve;All;2699;3007;0;5706;36978;14632;1;51611;22349;14632;36981;0,08443044;0,033408681;0,051028609;0,033408681;0,08443729;NA;NA
72;REGIONAL;22/03/21;2021;12;ARS Algarve;All;9427;4299;0;13726;46405;18931;1;65337;27477;18931;46408;0,105954746;0,043224422;0,062737174;0,043224422;0,105961596;NA;NA
73;REGIONAL;29/03/21;2021;13;ARS Algarve;All;4229;2918;0;7147;50634;21849;1;72484;28788;21849;50637;0,115610658;0,049886979;0,065730529;0,049886979;0,115617508;NA;NA
74;REGIONAL;05/04/21;2021;14;ARS Algarve;All;8675;1795;0;10470;59309;23644;1;82954;35670;23644;59314;0,135417951;0,053985433;0,081443935;0,053985433;0,135429367;NA;NA
75;REGIONAL;12/04/21;2021;15;ARS Algarve;All;13671;2157;0;15828;72980;25801;1;98782;47184;25801;72985;0,166632418;0,058910428;0,107733406;0,058910428;0,166643834;NA;NA
76;REGIONAL;19/04/21;2021;16;ARS Algarve;All;7266;5512;0;12778;80246;31313;1;111560;48939;31313;80252;0,183222595;0,071495765;0,11174053;0,071495765;0,183236295;NA;NA
77;REGIONAL;26/04/21;2021;17;ARS Algarve;All;16411;3250;0;19661;96657;34563;1;131221;62103;34563;96666;0,220693198;0,078916364;0,141797383;0,078916364;0,220713748;NA;NA
78;REGIONAL;03/05/21;2021;18;ARS Algarve;All;16597;8941;3;25541;113254;43504;4;156762;70309;43504;113813;0,258588488;0,099331004;0,160533827;0,099331004;0,259864831;NA;NA
79;REGIONAL;10/05/21;2021;19;ARS Algarve;All;9745;11306;0;21051;122999;54810;4;177813;70716;54810;125526;0,28083887;0,125145558;0,161463114;0,125145558;0,286608672;NA;NA
80;REGIONAL;17/05/21;2021;20;ARS Algarve;All;12033;10899;2;22934;135032;65709;6;200747;74381;65709;140090;0,308313355;0,150030824;0,169831267;0,150030824;0,319862091;NA;NA
81;REGIONAL;24/05/21;2021;21;ARS Algarve;All;7608;18816;7;26431;142640;84525;13;227178;68965;84525;153490;0,325684408;0,192992671;0,157465123;0,192992671;0,350457794;NA;NA
82;REGIONAL;31/05/21;2021;22;ARS Algarve;All;8162;12755;1;20918;150802;97280;14;248096;72892;97280;170172;0,344320387;0,22211567;0,166431491;0,22211567;0,388547161;NA;NA
83;REGIONAL;07/06/21;2021;23;ARS Algarve;All;17073;6334;0;23407;167875;103614;14;271503;84986;103614;188600;0,383302509;0,236577848;0,194045254;0,236577848;0,430623102;NA;NA
84;REGIONAL;14/06/21;2021;24;ARS Algarve;All;15412;13412;1;28825;183287;117026;15;300328;87207;117026;204233;0,418492134;0,26720095;0,199116378;0,26720095;0,466317328;NA;NA
85;REGIONAL;21/06/21;2021;25;ARS Algarve;All;19424;10172;3;29599;202711;127198;18;329927;97820;127198;225018;0,462842204;0,290426285;0,223348631;0,290426285;0,513774916;NA;NA
86;REGIONAL;28/06/21;2021;26;ARS Algarve;All;17292;16367;7;33666;220003;143565;25;363593;101141;143565;244706;0,50232436;0,327796424;0,230931342;0,327796424;0,558727767;NA;NA
87;REGIONAL;05/07/21;2021;27;ARS Algarve;All;19173;31723;1;50897;239176;175288;26;414490;89840;175288;265128;0,546101331;0,400228326;0,205128205;0,400228326;0,605356531;NA;NA
88;REGIONAL;12/07/21;2021;28;ARS Algarve;All;9746;27033;6;36785;248922;202321;32;451275;79074;202321;281395;0,568353997;0,461951732;0,180546613;0,461951732;0,642498345;NA;NA
89;REGIONAL;19/07/21;2021;29;ARS Algarve;All;4327;27267;3;31597;253249;229588;35;482872;61934;229588;291522;0,578233669;0,524209421;0,141411512;0,524209421;0,665620933;NA;NA
90;REGIONAL;26/07/21;2021;30;ARS Algarve;All;3302;22072;3;25377;256551;251660;38;508249;47021;251660;298681;0,585772998;0,574605567;0,107361235;0,574605567;0,681966801;NA;NA
91;REGIONAL;04/01/21;2021;1;ARS Centro;All;9013;7;0;9020;15622;7;0;15629;15616;7;15623;0,009422872;4,22E-06;0,009419253;4,22E-06;0,009423475;NA;NA
92;REGIONAL;11/01/21;2021;2;ARS Centro;All;12637;22;1;12660;28259;29;1;28289;28231;29;28260;0,017045252;1,75E-05;0,017028363;1,75E-05;0,017045856;NA;NA
93;REGIONAL;18/01/21;2021;3;ARS Centro;All;36808;6308;2;43118;65067;6337;3;71407;58731;6337;65068;0,039247087;0,003822349;0,035425341;0,003822349;0,03924769;NA;NA
94;REGIONAL;25/01/21;2021;4;ARS Centro;All;4838;8539;3;13380;69905;14876;6;84787;55030;14876;69906;0,04216527;0,0089729;0,033192973;0,0089729;0,042165873;NA;NA
95;REGIONAL;01/02/21;2021;5;ARS Centro;All;2698;9172;0;11870;72603;24048;6;96657;48556;24048;72604;0,043792649;0,014505263;0,029287989;0,014505263;0,043793252;NA;NA
96;REGIONAL;08/02/21;2021;6;ARS Centro;All;7519;27153;4;34676;80122;51201;10;131333;28922;51201;80123;0,048327956;0,030883399;0,01744516;0,030883399;0,048328559;NA;NA
97;REGIONAL;15/02/21;2021;7;ARS Centro;All;25505;10001;4;35510;105627;61202;14;166843;44426;61202;105628;0,063712052;0,036915798;0,026796857;0,036915798;0,063712655;NA;NA
98;REGIONAL;22/02/21;2021;8;ARS Centro;All;38393;3106;2;41501;144020;64308;16;208344;79713;64308;144021;0,086869926;0,038789274;0,048081256;0,038789274;0,086870529;NA;NA
99;REGIONAL;01/03/21;2021;9;ARS Centro;All;28478;5922;1;34401;172498;70230;17;242745;102275;70230;172505;0,104047275;0,042361303;0,061690194;0,042361303;0,104051497;NA;NA
100;REGIONAL;08/03/21;2021;10;ARS Centro;All;17658;13520;0;31178;190156;83750;17;273923;106418;83750;190168;0,11469822;0,050516292;0,064189167;0,050516292;0,114705458;NA;NA
101;REGIONAL;15/03/21;2021;11;ARS Centro;All;16632;24151;2;40785;206788;107901;19;314708;98906;107901;206807;0,124730303;0,065083682;0,059658082;0,065083682;0,124741764;NA;NA
102;REGIONAL;22/03/21;2021;12;ARS Centro;All;47835;4326;0;52161;254623;112227;19;366869;142421;112227;254648;0,1535834;0,067693037;0,085905442;0,067693037;0,153598479;NA;NA
103;REGIONAL;29/03/21;2021;13;ARS Centro;All;24361;16731;2;41094;278984;128958;21;407963;150059;128958;279017;0,168277458;0,077784835;0,090512528;0,077784835;0,168297363;NA;NA
104;REGIONAL;05/04/21;2021;14;ARS Centro;All;49880;10174;0;60054;328864;139132;21;468017;189774;139132;328906;0,198364056;0,083921584;0,114467806;0,083921584;0,19838939;NA;NA
105;REGIONAL;12/04/21;2021;15;ARS Centro;All;77697;12003;2;89702;406561;151135;23;557719;255471;151135;406606;0,245229302;0,091161549;0,154094896;0,091161549;0,245256445;NA;NA
106;REGIONAL;19/04/21;2021;16;ARS Centro;All;30066;24155;6;54227;436627;175290;29;611946;261382;175290;436672;0,2633645;0,105731352;0,15766029;0,105731352;0,263391643;NA;NA
107;REGIONAL;26/04/21;2021;17;ARS Centro;All;56763;17915;4;74682;493390;193205;33;686628;301504;193205;494709;0,297602783;0,116537315;0,181861062;0,116537315;0,298398377;NA;NA
108;REGIONAL;03/05/21;2021;18;ARS Centro;All;60145;49127;2;109274;553535;242332;35;795902;318369;242332;560701;0,33388102;0,146169719;0,192033686;0,146169719;0,338203405;NA;NA
109;REGIONAL;10/05/21;2021;19;ARS Centro;All;50820;55728;0;106548;604355;298060;35;902450;319522;298060;617582;0,364534608;0,179783712;0,192729152;0,179783712;0,372512864;NA;NA
110;REGIONAL;17/05/21;2021;20;ARS Centro;All;44990;41733;4;86727;649345;339793;39;989177;330549;339793;670342;0,391671658;0,204956206;0,199380414;0,204956206;0,40433662;NA;NA
111;REGIONAL;24/05/21;2021;21;ARS Centro;All;24220;56367;12;80599;673565;396160;51;1069776;306751;396160;702911;0,406280668;0,238955631;0,185025946;0,238955631;0,423981576;NA;NA
112;REGIONAL;31/05/21;2021;22;ARS Centro;All;44316;37750;2;82068;717881;433910;53;1151844;315674;433910;749584;0,433011175;0,261725661;0,190408117;0,261725661;0,452133778;NA;NA
113;REGIONAL;07/06/21;2021;23;ARS Centro;All;58334;40855;2;99191;776215;474765;55;1251035;334918;474765;809683;0,468197054;0,286368563;0,202015706;0,286368563;0,488384269;NA;NA
114;REGIONAL;14/06/21;2021;24;ARS Centro;All;51953;65768;10;117731;828168;540533;65;1368766;327000;540533;867533;0,499534044;0,326038479;0,19723973;0,326038479;0,523278209;NA;NA
115;REGIONAL;21/06/21;2021;25;ARS Centro;All;59559;47739;3;107301;887727;588272;68;1476067;345145;588272;933417;0,535458818;0,35483367;0,208184423;0,35483367;0,563018094;NA;NA
116;REGIONAL;28/06/21;2021;26;ARS Centro;All;49880;77083;3;126966;937607;665355;71;1603033;320136;665355;985491;0,565545416;0,401328563;0,193099505;0,401328563;0,594428068;NA;NA
117;REGIONAL;05/07/21;2021;27;ARS Centro;All;59292;104921;11;164224;996899;770276;82;1767257;282513;770276;1052789;0,601309141;0,46461477;0,170406079;0,46461477;0,635020849;NA;NA
118;REGIONAL;12/07/21;2021;28;ARS Centro;All;28403;81966;10;110379;1025302;852242;92;1877636;243338;852242;1095580;0,618441251;0,514054989;0,146776518;0,514054989;0,660831507;NA;NA
119;REGIONAL;19/07/21;2021;29;ARS Centro;All;16800;80621;18;97439;1042102;932863;110;1975075;195080;932863;1127943;0,628574669;0,562683932;0,117668277;0,562683932;0,680352209;NA;NA
120;REGIONAL;26/07/21;2021;30;ARS Centro;All;13292;63146;5;76443;1055394;996009;115;2051518;157263;996009;1153272;0,636592132;0,600772311;0,094857834;0,600772311;0,695630145;NA;NA
121;REGIONAL;04/01/21;2021;1;ARS Lisboa e Vale do Tejo;All;12684;23;0;12707;23385;23;0;23408;23362;23;23385;0,006348137;6,24E-06;0,006341893;6,24E-06;0,006348137;NA;NA
122;REGIONAL;11/01/21;2021;2;ARS Lisboa e Vale do Tejo;All;13226;1105;0;14331;36611;1128;0;37739;35483;1128;36611;0,009938492;0,000306209;0,009632283;0,000306209;0,009938492;NA;NA
123;REGIONAL;18/01/21;2021;3;ARS Lisboa e Vale do Tejo;All;37966;9055;0;47021;74577;10183;0;84760;64394;10183;74577;0,020244815;0,002764297;0,017480519;0,002764297;0,020244815;NA;NA
124;REGIONAL;25/01/21;2021;4;ARS Lisboa e Vale do Tejo;All;17276;11878;11;29165;91853;22061;11;113925;69793;22061;91854;0,024934591;0,005988721;0,018946141;0,005988721;0,024934863;NA;NA
125;REGIONAL;01/02/21;2021;5;ARS Lisboa e Vale do Tejo;All;8697;8941;1;17639;100550;31002;12;131564;69550;31002;100552;0,027295496;0,008415862;0,018880176;0,008415862;0,027296038;NA;NA
126;REGIONAL;08/02/21;2021;6;ARS Lisboa e Vale do Tejo;All;14364;30553;0;44917;114914;61555;12;176481;53361;61555;114916;0,031194774;0,016709838;0,014485479;0,016709838;0,031195317;NA;NA
127;REGIONAL;15/02/21;2021;7;ARS Lisboa e Vale do Tejo;All;32993;19079;3;52075;147907;80634;15;228556;67275;80634;147909;0,040151117;0,02188906;0,0182626;0,02188906;0,04015166;NA;NA
128;REGIONAL;22/02/21;2021;8;ARS Lisboa e Vale do Tejo;All;49279;6705;0;55984;197186;87339;15;284540;109849;87339;197188;0,053528489;0,023709212;0,02981982;0,023709212;0,053529032;NA;NA
129;REGIONAL;01/03/21;2021;9;ARS Lisboa e Vale do Tejo;All;45035;12821;0;57856;242221;100160;15;342396;142069;100160;242229;0,065753776;0,027189625;0,038566323;0,027189625;0,065755948;NA;NA
130;REGIONAL;08/03/21;2021;10;ARS Lisboa e Vale do Tejo;All;33648;16550;1;50199;275869;116710;16;392595;159179;116710;275889;0,074887927;0,03168232;0,043211036;0,03168232;0,074893356;NA;NA
131;REGIONAL;15/03/21;2021;11;ARS Lisboa e Vale do Tejo;All;25945;28989;3;54937;301814;145699;19;447532;156141;145699;301840;0,081931006;0,03955173;0,042386335;0,03955173;0,081938064;NA;NA
132;REGIONAL;22/03/21;2021;12;ARS Lisboa e Vale do Tejo;All;89129;7541;3;96673;390943;153240;22;544205;237735;153240;390975;0,106126135;0,041598824;0,064535998;0,041598824;0,106134822;NA;NA
133;REGIONAL;29/03/21;2021;13;ARS Lisboa e Vale do Tejo;All;45499;23817;3;69319;436442;177057;25;613524;259423;177057;436480;0,118477381;0,048064232;0,070423464;0,048064232;0,118487697;NA;NA
134;REGIONAL;05/04/21;2021;14;ARS Lisboa e Vale do Tejo;All;87325;19588;1;106914;523767;196645;26;720438;327204;196645;523849;0,142182793;0,053381628;0,088823424;0,053381628;0,142205053;NA;NA
135;REGIONAL;12/04/21;2021;15;ARS Lisboa e Vale do Tejo;All;163571;14238;2;177811;687338;210883;28;898249;476545;210883;687428;0,18658609;0,057246703;0,129363818;0,057246703;0,186610521;NA;NA
136;REGIONAL;19/04/21;2021;16;ARS Lisboa e Vale do Tejo;All;79183;53600;7;132790;766521;264483;35;1031039;502129;264483;766612;0,208081258;0,071797062;0,1363089;0,071797062;0,208105961;NA;NA
137;REGIONAL;26/04/21;2021;17;ARS Lisboa e Vale do Tejo;All;107592;25515;7;133114;874113;289998;42;1164153;584235;289998;874233;0,237288389;0,078723412;0,158597552;0,078723412;0,237320964;NA;NA
138;REGIONAL;03/05/21;2021;18;ARS Lisboa e Vale do Tejo;All;107730;65194;9;172933;981843;355192;51;1337086;629469;355192;984661;0,266532981;0,0964211;0,17087686;0,0964211;0,26729796;NA;NA
139;REGIONAL;10/05/21;2021;19;ARS Lisboa e Vale do Tejo;All;90326;112827;13;203166;1072169;468019;64;1540252;609545;468019;1077564;0,29105305;0,127049334;0,165468253;0,127049334;0,292517587;NA;NA
140;REGIONAL;17/05/21;2021;20;ARS Lisboa e Vale do Tejo;All;109873;70915;3;180791;1182042;538934;67;1721043;651121;538934;1190055;0,320879385;0,146300056;0,176754553;0,146300056;0,323054609;NA;NA
141;REGIONAL;24/05/21;2021;21;ARS Lisboa e Vale do Tejo;All;110593;88617;45;199255;1292635;627551;112;1920298;686123;627551;1313674;0,350901172;0,170356196;0,186256263;0,170356196;0,356612459;NA;NA
142;REGIONAL;31/05/21;2021;22;ARS Lisboa e Vale do Tejo;All;92074;86543;21;178638;1384709;714094;133;2098936;712415;714094;1426509;0,375895756;0,193849325;0,19339354;0,193849325;0,387242864;NA;NA
143;REGIONAL;07/06/21;2021;23;ARS Lisboa e Vale do Tejo;All;151893;53738;9;205640;1536602;767832;142;2304576;825170;767832;1593002;0,417128921;0,208437145;0,224002228;0,208437145;0,432439373;NA;NA
144;REGIONAL;14/06/21;2021;24;ARS Lisboa e Vale do Tejo;All;147602;121347;11;268960;1684204;889179;153;2573536;860954;889179;1750133;0,457197243;0,241378234;0,233716221;0,241378234;0,475094455;NA;NA
145;REGIONAL;21/06/21;2021;25;ARS Lisboa e Vale do Tejo;All;120104;153375;22;273501;1804308;1042554;175;2847037;842277;1042554;1884831;0,489800904;0,283013705;0,228646127;0,283013705;0,511659832;NA;NA
146;REGIONAL;28/06/21;2021;26;ARS Lisboa e Vale do Tejo;All;130678;165968;16;296662;1934986;1208522;191;3143699;817881;1208522;2026403;0,525275004;0,328067696;0,222023542;0,328067696;0,550091238;NA;NA
147;REGIONAL;05/07/21;2021;27;ARS Lisboa e Vale do Tejo;All;143601;273064;13;416678;2078587;1481586;204;3560377;700129;1481586;2181715;0,564257207;0,402194172;0,190058359;0,402194172;0,592252531;NA;NA
148;REGIONAL;12/07/21;2021;28;ARS Lisboa e Vale do Tejo;All;79995;215572;22;295589;2158582;1697158;226;3855966;603462;1697158;2300620;0,585972803;0,46071376;0,16381695;0,46071376;0,62453071;NA;NA
149;REGIONAL;19/07/21;2021;29;ARS Lisboa e Vale do Tejo;All;57071;185545;15;242631;2215653;1882703;241;4098597;526397;1882703;2409100;0,601465406;0,511082161;0,142896738;0,511082161;0,653978899;NA;NA
150;REGIONAL;26/07/21;2021;30;ARS Lisboa e Vale do Tejo;All;34359;161768;25;196152;2250012;2044471;266;4294749;434784;2044471;2479255;0,610792566;0,554996012;0,118027297;0,554996012;0,673023309;NA;NA
151;REGIONAL;04/01/21;2021;1;ARS Norte;All;16568;19;0;16587;29869;22;0;29891;29852;22;29874;0,008390284;6,18E-06;0,008385509;6,18E-06;0,008391689;NA;NA
152;REGIONAL;11/01/21;2021;2;ARS Norte;All;15168;29;0;15197;45037;51;0;45088;44991;51;45042;0,012651017;1,43E-05;0,012638095;1,43E-05;0,012652421;NA;NA
153;REGIONAL;18/01/21;2021;3;ARS Norte;All;31973;12728;1;44702;77010;12779;1;89790;64236;12779;77015;0,02163232;0,003589656;0,018044069;0,003589656;0,021633725;NA;NA
154;REGIONAL;25/01/21;2021;4;ARS Norte;All;14256;15682;6;29944;91266;28461;7;119734;62810;28461;91271;0,02563687;0,007994773;0,017643501;0,007994773;0,025638274;NA;NA
155;REGIONAL;01/02/21;2021;5;ARS Norte;All;5557;12213;1;17771;96823;40674;8;137505;56156;40674;96830;0,027197846;0,011425438;0,015774374;0,011425438;0,027199813;NA;NA
156;REGIONAL;08/02/21;2021;6;ARS Norte;All;8822;28649;6;37477;105645;69323;14;174982;36329;69323;105652;0,02967597;0,019473021;0,010204916;0,019473021;0,029677937;NA;NA
157;REGIONAL;15/02/21;2021;7;ARS Norte;All;32920;15095;3;48018;138565;84418;17;223000;54154;84418;138572;0,038923289;0,023713248;0,015212007;0,023713248;0,038925255;NA;NA
158;REGIONAL;22/02/21;2021;8;ARS Norte;All;64712;4268;1;68981;203277;88686;18;291981;114598;88686;203284;0,057101067;0,024912141;0,032190893;0,024912141;0,057103033;NA;NA
159;REGIONAL;01/03/21;2021;9;ARS Norte;All;47896;7015;2;54913;251173;95701;20;346894;155481;95701;251182;0,070555185;0,026882673;0,043675039;0,026882673;0,070557713;NA;NA
160;REGIONAL;08/03/21;2021;10;ARS Norte;All;25473;14094;0;39567;276646;109795;20;386461;166866;109795;276661;0,07771062;0,030841717;0,046873117;0,030841717;0,077714834;NA;NA
161;REGIONAL;15/03/21;2021;11;ARS Norte;All;26739;42266;4;69009;303385;152061;24;455470;151342;152061;303403;0,085221679;0,042714352;0,042512383;0,042714352;0,085226735;NA;NA
162;REGIONAL;22/03/21;2021;12;ARS Norte;All;88869;2269;0;91138;392254;154330;24;546608;237946;154330;392276;0,110185224;0,04335172;0,066839684;0,04335172;0,110191404;NA;NA
163;REGIONAL;29/03/21;2021;13;ARS Norte;All;54016;32592;1;86609;446270;186922;25;633217;259391;186922;446313;0,125358467;0,052506902;0,072863643;0,052506902;0,125370546;NA;NA
164;REGIONAL;05/04/21;2021;14;ARS Norte;All;82297;13564;5;95866;528567;200486;30;729083;328151;200486;528637;0,14847592;0,056317067;0,092178516;0,056317067;0,148495583;NA;NA
165;REGIONAL;12/04/21;2021;15;ARS Norte;All;135737;19080;3;154820;664304;219566;33;883903;444811;219566;664377;0,186604816;0,061676692;0,12494863;0,061676692;0,186625322;NA;NA
166;REGIONAL;19/04/21;2021;16;ARS Norte;All;64939;46339;2;111280;729243;265905;35;995183;463413;265905;729318;0,204846359;0,074693444;0,130173983;0,074693444;0,204867427;NA;NA
167;REGIONAL;26/04/21;2021;17;ARS Norte;All;126267;36653;2;162922;855510;302558;37;1158105;553048;302558;855606;0,240315105;0,084989372;0,1553527;0,084989372;0,240342072;NA;NA
168;REGIONAL;03/05/21;2021;18;ARS Norte;All;154996;73049;4;228049;1010506;375607;41;1386154;635191;375607;1010798;0,283853907;0,105509037;0,178426894;0,105509037;0,283935931;NA;NA
169;REGIONAL;10/05/21;2021;19;ARS Norte;All;99382;100740;8;200130;1109888;476347;49;1586284;640535;476347;1116882;0,311770583;0,133807179;0,179928038;0,133807179;0,313735217;NA;NA
170;REGIONAL;17/05/21;2021;20;ARS Norte;All;110346;70843;5;181194;1220234;547190;54;1767478;687616;547190;1234806;0,342767077;0,153707172;0,19315322;0,153707172;0,346860392;NA;NA
171;REGIONAL;24/05/21;2021;21;ARS Norte;All;72635;128552;22;201209;1292869;675742;76;1968687;651752;675742;1327494;0,363170448;0,189817781;0,183078924;0,189817781;0,372896706;NA;NA
172;REGIONAL;31/05/21;2021;22;ARS Norte;All;54500;172059;35;226594;1347369;847801;111;2195281;558330;847801;1406131;0,378479648;0,238149626;0,156836428;0,238149626;0,394986055;NA;NA
173;REGIONAL;07/06/21;2021;23;ARS Norte;All;106056;106041;13;212110;1453425;953842;124;2407391;565933;953842;1519775;0,408271069;0,267936834;0,158972132;0,267936834;0,426908966;NA;NA
174;REGIONAL;14/06/21;2021;24;ARS Norte;All;104331;151443;15;255789;1557756;1105285;139;2663180;533993;1105285;1639278;0,437577933;0,310477588;0,150000098;0,310477588;0,460477686;NA;NA
175;REGIONAL;21/06/21;2021;25;ARS Norte;All;145231;104340;6;249577;1702987;1209625;145;2912757;590921;1209625;1800546;0,478373719;0,33978698;0,16599133;0,33978698;0,50577831;NA;NA
176;REGIONAL;28/06/21;2021;26;ARS Norte;All;162221;115527;12;277760;1865208;1325152;157;3190517;643051;1325152;1968203;0,523942043;0,372238831;0,18063479;0,372238831;0,552873621;NA;NA
177;REGIONAL;05/07/21;2021;27;ARS Norte;All;173996;156553;20;330569;2039204;1481705;177;3521086;674398;1481705;2156103;0,572817997;0,416214998;0,189440248;0,416214998;0,605655246;NA;NA
178;REGIONAL;12/07/21;2021;28;ARS Norte;All;103875;154738;19;258632;2143079;1636443;196;3779718;671940;1636443;2308383;0,601996769;0,459681327;0,188749789;0,459681327;0,648431116;NA;NA
179;REGIONAL;19/07/21;2021;29;ARS Norte;All;50999;187499;11;238509;2194078;1823942;207;4018227;586249;1823942;2410191;0,616322528;0,51235031;0,164678952;0,51235031;0,677029262;NA;NA
180;REGIONAL;26/07/21;2021;30;ARS Norte;All;30155;170525;17;200697;2224233;1994467;224;4218924;476166;1994467;2470633;0,62479315;0,560251251;0,133756335;0,560251251;0,694007586;NA;NA
181;REGIONAL;04/01/21;2021;1;RA_Madeira;All;1727;0;0;1727;2367;0;0;2367;2367;0;2367;0,009321724;0;0,009321724;0;0,009321724;NA;NA
182;REGIONAL;11/01/21;2021;2;RA_Madeira;All;1762;0;0;1762;4129;0;0;4129;4129;0;4129;0,016260835;0;0,016260835;0;0,016260835;NA;NA
183;REGIONAL;18/01/21;2021;3;RA_Madeira;All;1081;539;0;1620;5210;539;0;5749;4671;539;5210;0,020518031;0,002122691;0,01839534;0,002122691;0,020518031;NA;NA
184;REGIONAL;25/01/21;2021;4;RA_Madeira;All;411;1632;0;2043;5621;2171;0;7792;3450;2171;5621;0,022136632;0,008549836;0,013586796;0,008549836;0,022136632;NA;NA
185;REGIONAL;01/02/21;2021;5;RA_Madeira;All;2238;1521;0;3759;7859;3692;0;11551;4167;3692;7859;0,030950327;0,014539841;0,016410487;0,014539841;0,030950327;NA;NA
186;REGIONAL;08/02/21;2021;6;RA_Madeira;All;3166;1088;0;4254;11025;4780;0;15805;6245;4780;11025;0,043418674;0,018824604;0,02459407;0,018824604;0,043418674;NA;NA
187;REGIONAL;15/02/21;2021;7;RA_Madeira;All;2504;639;0;3143;13529;5419;0;18948;8110;5419;13529;0,053279931;0,021341115;0,031938816;0,021341115;0,053279931;NA;NA
188;REGIONAL;22/02/21;2021;8;RA_Madeira;All;2261;2156;0;4417;15790;7575;0;23365;8215;7575;15790;0,062184205;0,029831878;0,032352327;0,029831878;0,062184205;NA;NA
189;REGIONAL;01/03/21;2021;9;RA_Madeira;All;1439;3121;0;4560;17229;10696;0;27925;6534;10696;17230;0,067851278;0,042123006;0,02573221;0,042123006;0,067855216;NA;NA
190;REGIONAL;08/03/21;2021;10;RA_Madeira;All;4907;2399;0;7306;22136;13095;0;35231;9042;13095;22137;0,087176034;0,051570752;0,03560922;0,051570752;0,087179972;NA;NA
191;REGIONAL;15/03/21;2021;11;RA_Madeira;All;3124;2354;0;5478;25260;15449;0;40709;9812;15449;25261;0,099478976;0,060841279;0,038641635;0,060841279;0,099482914;NA;NA
192;REGIONAL;22/03/21;2021;12;RA_Madeira;All;5298;183;0;5481;30558;15632;0;46190;14927;15632;30559;0,120343569;0,06156197;0,058785537;0,06156197;0,120347507;NA;NA
193;REGIONAL;29/03/21;2021;13;RA_Madeira;All;1213;1264;0;2477;31771;16896;0;48667;14876;16896;31772;0,125120607;0,066539857;0,058584689;0,066539857;0,125124546;NA;NA
194;REGIONAL;05/04/21;2021;14;RA_Madeira;All;10227;1304;0;11531;41998;18200;0;60198;23799;18200;41999;0,165396597;0,071675272;0,093725263;0,071675272;0,165400535;NA;NA
195;REGIONAL;12/04/21;2021;15;RA_Madeira;All;8444;1307;0;9751;50442;19507;0;69949;30937;19507;50444;0,198650772;0,076822501;0,121836147;0,076822501;0,198658648;NA;NA
196;REGIONAL;19/04/21;2021;16;RA_Madeira;All;9835;2136;0;11971;60277;21643;0;81920;38637;21643;60280;0,237382986;0,0852345;0,152160301;0,0852345;0,237394801;NA;NA
197;REGIONAL;26/04/21;2021;17;RA_Madeira;All;8835;808;0;9643;69112;22451;0;91563;46665;22451;69116;0,272176999;0,088416567;0,183776184;0,088416567;0,272192751;NA;NA
198;REGIONAL;03/05/21;2021;18;RA_Madeira;All;7625;5296;0;12921;76737;27747;0;104484;48994;27747;76741;0,302205787;0,109273284;0,192948256;0,109273284;0,30222154;NA;NA
199;REGIONAL;10/05/21;2021;19;RA_Madeira;All;11615;6444;0;18059;88352;34191;0;122543;54167;34191;88358;0,347948;0,134651056;0,213320574;0,134651056;0,347971629;NA;NA
200;REGIONAL;17/05/21;2021;20;RA_Madeira;All;2349;7620;0;9969;90701;41811;0;132512;48896;41811;90707;0,357198836;0,164660153;0,192562312;0,164660153;0,357222465;NA;NA
201;REGIONAL;24/05/21;2021;21;RA_Madeira;All;3457;8985;0;12442;94158;50796;0;144954;43370;50796;94166;0,370813199;0,200044895;0,170799809;0,200044895;0,370844705;NA;NA
202;REGIONAL;31/05/21;2021;22;RA_Madeira;All;7578;10941;0;18519;101736;61737;0;163473;40317;61737;102054;0,400656892;0,243132761;0,158776479;0,243132761;0,40190924;NA;NA
203;REGIONAL;07/06/21;2021;23;RA_Madeira;All;3619;15307;0;18926;105355;77044;0;182399;30728;77044;107772;0,414909244;0,303414815;0,121013063;0,303414815;0,424427878;NA;NA
204;REGIONAL;14/06/21;2021;24;RA_Madeira;All;3518;8103;0;11621;108873;85147;0;194020;28663;85147;113810;0,428763838;0,335326063;0,112880676;0,335326063;0,44820674;NA;NA
205;REGIONAL;21/06/21;2021;25;RA_Madeira;All;12575;3701;0;16276;121448;88848;0;210296;37681;88848;126529;0,478286725;0,349901348;0,14839538;0,349901348;0,498296728;NA;NA
206;REGIONAL;28/06/21;2021;26;RA_Madeira;All;9991;12286;0;22277;131439;101134;0;232573;35561;101134;136695;0,517633298;0,398286095;0,140046392;0,398286095;0,538332487;NA;NA
207;REGIONAL;05/07/21;2021;27;RA_Madeira;All;12445;6887;0;19332;143884;108021;0;251905;41501;108021;149522;0,566644219;0,42540849;0,16343931;0,42540849;0,5888478;NA;NA
208;REGIONAL;12/07/21;2021;28;RA_Madeira;All;10372;5558;0;15930;154256;113579;0;267835;47554;113579;161133;0,607491247;0,447297015;0,187277245;0,447297015;0,634574261;NA;NA
209;REGIONAL;19/07/21;2021;29;RA_Madeira;All;4159;14646;0;18805;158415;128225;0;286640;39433;128225;167658;0,623870228;0,504975918;0,155295109;0,504975918;0,660271027;NA;NA
210;REGIONAL;26/07/21;2021;30;RA_Madeira;All;5510;13623;0;19133;163925;141848;0;305773;34555;141848;176403;0,64556972;0,55862604;0,136084561;0,55862604;0,694710601;NA;NA
211;REGIONAL;04/01/21;2021;1;RA_Acores;All;3643;2;0;3645;5627;2;0;5629;5625;2;5627;0,023232769;8,26E-06;0,023224512;8,26E-06;0,023232769;NA;NA
212;REGIONAL;11/01/21;2021;2;RA_Acores;All;1;0;0;1;5628;2;0;5630;5626;2;5628;0,023236898;8,26E-06;0,023228641;8,26E-06;0,023236898;NA;NA
213;REGIONAL;18/01/21;2021;3;RA_Acores;All;28;1923;7;1958;5656;1925;7;7588;3731;1925;5656;0,023352505;0,007947944;0,015404561;0,007947944;0,023352505;NA;NA
214;REGIONAL;25/01/21;2021;4;RA_Acores;All;280;3498;47;3825;5936;5423;54;11413;513;5423;5936;0,024508569;0,022390494;0,002118075;0,022390494;0,024508569;NA;NA
215;REGIONAL;01/02/21;2021;5;RA_Acores;All;1879;17;0;1896;7815;5440;54;13309;2375;5440;7815;0,032266588;0,022460683;0,009805905;0,022460683;0,032266588;NA;NA
216;REGIONAL;08/02/21;2021;6;RA_Acores;All;1059;3;0;1062;8874;5443;54;14371;3431;5443;8874;0,03663899;0,02247307;0,01416592;0,02247307;0,03663899;NA;NA
217;REGIONAL;15/02/21;2021;7;RA_Acores;All;2076;322;3;2401;10950;5765;57;16772;5185;5765;10950;0,045210383;0,023802544;0,021407839;0,023802544;0,045210383;NA;NA
218;REGIONAL;22/02/21;2021;8;RA_Acores;All;1480;1611;13;3104;12430;7376;70;19876;5054;7376;12430;0,05132101;0,030454044;0,020866966;0,030454044;0,05132101;NA;NA
219;REGIONAL;01/03/21;2021;9;RA_Acores;All;755;1155;8;1918;13185;8531;78;21794;4654;8531;13185;0,054438256;0,035222811;0,019215445;0,035222811;0,054438256;NA;NA
220;REGIONAL;08/03/21;2021;10;RA_Acores;All;2621;2060;9;4690;15806;10591;87;26484;5215;10591;15806;0,065259846;0,043728143;0,021531703;0,043728143;0,065259846;NA;NA
221;REGIONAL;15/03/21;2021;11;RA_Acores;All;2532;1439;8;3979;18338;12030;95;30463;6309;12030;18339;0,075713973;0,049669489;0,026048613;0,049669489;0,075718102;NA;NA
222;REGIONAL;22/03/21;2021;12;RA_Acores;All;4115;731;0;4846;22453;12761;95;35309;9694;12761;22455;0,092703994;0,052687644;0,040024608;0,052687644;0,092712251;NA;NA
223;REGIONAL;29/03/21;2021;13;RA_Acores;All;1951;764;0;2715;24404;13525;95;38024;10882;13525;24407;0,100759287;0,055842049;0,044929625;0,055842049;0,100771673;NA;NA
224;REGIONAL;05/04/21;2021;14;RA_Acores;All;3891;2360;1;6252;28295;15885;96;44276;12417;15885;28302;0,116824456;0,065586022;0,051267336;0,065586022;0,116853357;NA;NA
225;REGIONAL;12/04/21;2021;15;RA_Acores;All;4244;2407;0;6651;32539;18292;96;50927;14254;18292;32546;0,134347092;0,075524048;0,058851945;0,075524048;0,134375993;NA;NA
226;REGIONAL;19/04/21;2021;16;RA_Acores;All;7995;1061;0;9056;40534;19353;96;59983;21188;19353;40541;0,167356865;0,079904707;0,087481059;0,079904707;0,167385766;NA;NA
227;REGIONAL;26/04/21;2021;17;RA_Acores;All;9272;2965;1;12238;49806;22318;97;72221;27497;22318;49815;0,205639118;0,092146606;0,113529672;0,092146606;0,205676277;NA;NA
228;REGIONAL;03/05/21;2021;18;RA_Acores;All;9755;2835;0;12590;59561;25153;97;84811;34419;25153;59572;0,245915583;0,103851759;0,14210924;0,103851759;0,245960999;NA;NA
229;REGIONAL;10/05/21;2021;19;RA_Acores;All;9464;2309;1;11774;69025;27462;98;96585;41574;27462;69036;0,284990566;0,113385164;0,171650819;0,113385164;0,285035983;NA;NA
230;REGIONAL;17/05/21;2021;20;RA_Acores;All;12174;5088;0;17262;81199;32550;98;113847;48664;32550;81214;0,335254603;0,134392509;0,200924026;0,134392509;0,335316535;NA;NA
231;REGIONAL;24/05/21;2021;21;RA_Acores;All;5672;8207;0;13879;86871;40757;98;127726;46129;40757;86886;0,358673168;0,168277588;0,190457513;0,168277588;0,3587351;NA;NA
232;REGIONAL;31/05/21;2021;22;RA_Acores;All;5494;10137;1;15632;92365;50894;99;143358;41488;50894;92382;0,381356807;0,210131255;0,171295742;0,210131255;0,381426997;NA;NA
233;REGIONAL;07/06/21;2021;23;RA_Acores;All;7916;12000;4;19920;100281;62894;103;163278;37404;62894;100298;0,414040404;0,25967688;0,154433714;0,25967688;0,414110594;NA;NA
234;REGIONAL;14/06/21;2021;24;RA_Acores;All;9312;7713;2;17027;109593;70607;105;180305;39479;70607;110086;0,45248781;0,291522331;0,163000979;0,291522331;0,454523309;NA;NA
235;REGIONAL;21/06/21;2021;25;RA_Acores;All;7550;10140;3;17693;117143;80747;108;197998;39704;80747;120451;0,483660266;0,333388384;0,163929959;0,333388384;0,497318343;NA;NA
236;REGIONAL;28/06/21;2021;26;RA_Acores;All;6709;12529;7;19245;123852;93276;115;217243;35432;93276;128708;0,511360399;0,385118146;0,146291716;0,385118146;0,531409862;NA;NA
237;REGIONAL;05/07/21;2021;27;RA_Acores;All;6147;16148;9;22304;129999;109424;124;239547;27165;109424;136589;0,536740146;0,451790042;0,112158909;0,451790042;0,563948951;NA;NA
238;REGIONAL;12/07/21;2021;28;RA_Acores;All;2810;11681;3;14494;132809;121105;127;254041;19919;121105;141024;0,54834208;0,50001858;0,082241609;0,50001858;0,582260189;NA;NA
239;REGIONAL;19/07/21;2021;29;RA_Acores;All;5708;8940;4;14652;138517;130045;131;268693;18478;130045;148523;0,571909282;0,53693007;0,076292005;0,53693007;0,613222076;NA;NA
240;REGIONAL;26/07/21;2021;30;RA_Acores;All;7081;8005;5;15091;145598;138050;136;283784;20298;138050;158348;0,60114533;0,569981131;0,083806425;0,569981131;0,653787557;NA;NA
241;AGES;04/01/21;2021;1;All;0-17 anos;4;0;0;4;6;0;0;6;6;0;6;3,53E-06;0;3,53E-06;0;3,53E-06;NA;NA
242;AGES;04/01/21;2021;1;All;18-24 anos;1790;2;0;1792;3146;2;0;3148;3144;2;3146;0,004027267;2,56E-06;0,004024706;2,56E-06;0,004027267;NA;NA
243;AGES;04/01/21;2021;1;All;25-49 anos;27488;40;0;27528;51222;43;0;51265;51184;43;51227;0,015374775;1,29E-05;0,015363369;1,29E-05;0,015376276;NA;NA
244;AGES;04/01/21;2021;1;All;50-64 anos;12976;8;0;12984;22182;8;0;22190;22175;8;22183;0,010202462;3,68E-06;0,010199243;3,68E-06;0,010202922;NA;NA
245;AGES;04/01/21;2021;1;All;65-79 anos;2307;0;0;2307;3259;0;0;3259;3259;0;3259;0,002001771;0;0,002001771;0;0,002001771;NA;NA
246;AGES;04/01/21;2021;1;All;80 ou mais anos;3811;3;0;3814;4079;3;0;4082;4076;3;4079;0,005984536;4,40E-06;0,005980135;4,40E-06;0,005984536;NA;NA
247;AGES;04/01/21;2021;1;All;Desconhecido;1;0;0;1;1;0;0;1;1;0;1;NA;NA;NA;NA;NA;NA;NA
248;AGES;11/01/21;2021;2;All;0-17 anos;15;0;0;15;21;0;0;21;21;0;21;1,23E-05;0;1,23E-05;0;1,23E-05;NA;NA
249;AGES;11/01/21;2021;2;All;18-24 anos;1404;56;0;1460;4550;58;0;4608;4492;58;4550;0,005824559;7,42E-05;0,005750312;7,42E-05;0,005824559;NA;NA
250;AGES;11/01/21;2021;2;All;25-49 anos;16426;784;0;17210;67648;827;0;68475;66826;827;67653;0,020305196;0,000248232;0,020058465;0,000248232;0,020306697;NA;NA
251;AGES;11/01/21;2021;2;All;50-64 anos;11662;302;0;11964;33844;310;0;34154;33535;310;33845;0,015566321;0,000142582;0,015424199;0,000142582;0,015566781;NA;NA
252;AGES;11/01/21;2021;2;All;65-79 anos;5527;27;0;5554;8786;27;0;8813;8759;27;8786;0,005396614;1,66E-05;0,005380029;1,66E-05;0,005396614;NA;NA
253;AGES;11/01/21;2021;2;All;80 ou mais anos;14479;0;1;14480;18558;3;1;18562;18555;3;18558;0,027227512;4,40E-06;0,027223111;4,40E-06;0,027227512;NA;NA
254;AGES;11/01/21;2021;2;All;Desconhecido;0;0;0;0;1;0;0;1;1;0;1;NA;NA;NA;NA;NA;NA;NA
255;AGES;18/01/21;2021;3;All;0-17 anos;69;1;0;70;90;1;0;91;89;1;90;5,29E-05;5,88E-07;5,23E-05;5,88E-07;5,29E-05;NA;NA
256;AGES;18/01/21;2021;3;All;18-24 anos;3811;1195;0;5006;8361;1253;0;9614;7108;1253;8361;0,010703107;0,001603994;0,009099114;0,001603994;0,010703107;NA;NA
257;AGES;18/01/21;2021;3;All;25-49 anos;37356;21703;5;59064;105004;22530;5;127539;82479;22530;105009;0,031517958;0,006762596;0,024756863;0,006762596;0,031519459;NA;NA
258;AGES;18/01/21;2021;3;All;50-64 anos;27384;8569;2;35955;61228;8879;2;70109;52350;8879;61229;0,028161409;0,004083837;0,024078032;0,004083837;0,028161869;NA;NA
259;AGES;18/01/21;2021;3;All;65-79 anos;14071;908;1;14980;22857;935;1;23793;21922;935;22857;0,014039426;0,000574304;0,013465122;0,000574304;0,014039426;NA;NA
260;AGES;18/01/21;2021;3;All;80 ou mais anos;39028;259;2;39289;57586;262;3;57851;57324;262;57586;0,084487742;0,000384395;0,084103347;0,000384395;0,084487742;NA;NA
261;AGES;18/01/21;2021;3;All;Desconhecido;0;0;0;0;1;0;0;1;1;0;1;NA;NA;NA;NA;NA;NA;NA
262;AGES;25/01/21;2021;4;All;0-17 anos;14;3;0;17;104;4;0;108;100;4;104;6,11E-05;2,35E-06;5,88E-05;2,35E-06;6,11E-05;NA;NA
263;AGES;25/01/21;2021;4;All;18-24 anos;1369;1625;1;2995;9730;2878;1;12609;6853;2878;9731;0,012455596;0,003684194;0,008772682;0,003684194;0,012456876;NA;NA
264;AGES;25/01/21;2021;4;All;25-49 anos;15551;26050;19;41620;120555;48580;24;169159;71980;48580;120560;0,03618574;0,014581753;0,021605488;0,014581753;0,036187241;NA;NA
265;AGES;25/01/21;2021;4;All;50-64 anos;10732;12398;11;23141;71960;21277;13;93250;50684;21277;71961;0,03309752;0,009786214;0,023311767;0,009786214;0,03309798;NA;NA
266;AGES;25/01/21;2021;4;All;65-79 anos;6488;2140;14;8642;29345;3075;15;32435;26270;3075;29345;0,018024542;0,001888753;0,016135789;0,001888753;0,018024542;NA;NA
267;AGES;25/01/21;2021;4;All;80 ou mais anos;7358;3385;23;10766;64944;3647;26;68617;61297;3647;64944;0,095283088;0,005350724;0,089932364;0,005350724;0,095283088;NA;NA
268;AGES;25/01/21;2021;4;All;Desconhecido;0;0;0;0;1;0;0;1;1;0;1;NA;NA;NA;NA;NA;NA;NA
269;AGES;01/02/21;2021;5;All;0-17 anos;35;4;0;39;139;8;0;147;131;8;139;8,17E-05;4,70E-06;7,70E-05;4,70E-06;8,17E-05;NA;NA
270;AGES;01/02/21;2021;5;All;18-24 anos;974;936;0;1910;10704;3814;1;14519;6891;3814;10705;0,013702435;0,004882389;0,008821327;0,004882389;0,013703716;NA;NA
271;AGES;01/02/21;2021;5;All;25-49 anos;9968;12508;1;22477;130523;61088;25;191636;69443;61088;130531;0,039177731;0,018336149;0,020843983;0,018336149;0,039180132;NA;NA
272;AGES;01/02/21;2021;5;All;50-64 anos;5521;9201;1;14723;77481;30478;14;107973;47005;30478;77483;0,035636867;0,014018152;0,021619635;0,014018152;0,035637787;NA;NA
273;AGES;01/02/21;2021;5;All;65-79 anos;2720;4171;0;6891;32065;7246;15;39326;24820;7246;32066;0,019695244;0,004450701;0,015245157;0,004450701;0,019695859;NA;NA
274;AGES;01/02/21;2021;5;All;80 ou mais anos;4522;10642;0;15164;69466;14289;26;83781;55177;14289;69466;0,101917575;0,020964216;0,080953359;0,020964216;0,101917575;NA;NA
275;AGES;01/02/21;2021;5;All;Desconhecido;0;0;0;0;1;0;0;1;1;0;1;NA;NA;NA;NA;NA;NA;NA
276;AGES;08/02/21;2021;6;All;0-17 anos;36;67;0;103;175;75;0;250;100;75;175;0,000102839;4,41E-05;5,88E-05;4,41E-05;0,000102839;NA;NA
277;AGES;08/02/21;2021;6;All;18-24 anos;1456;3046;0;4502;12160;6860;1;19021;5301;6860;12161;0,015566294;0,008781643;0,006785931;0,008781643;0,015567574;NA;NA
278;AGES;08/02/21;2021;6;All;25-49 anos;13784;30762;3;44549;144307;91850;28;236185;52465;91850;144315;0,043315131;0,027569659;0,015747873;0,027569659;0,043317532;NA;NA
279;AGES;08/02/21;2021;6;All;50-64 anos;6856;22252;3;29111;84337;52730;17;137084;31609;52730;84339;0,038790239;0,024252811;0,014538348;0,024252811;0,038791159;NA;NA
280;AGES;08/02/21;2021;6;All;65-79 anos;3713;11499;2;15214;35778;18745;17;54540;17034;18745;35779;0,021975876;0,011513718;0,010462772;0,011513718;0,02197649;NA;NA
281;AGES;08/02/21;2021;6;All;80 ou mais anos;14896;31538;2;46436;84362;45827;28;130217;38535;45827;84362;0,123772356;0,067235435;0,056536921;0,067235435;0,123772356;NA;NA
282;AGES;08/02/21;2021;6;All;Desconhecido;1;0;0;1;2;0;0;2;2;0;2;NA;NA;NA;NA;NA;NA;NA
283;AGES;15/02/21;2021;7;All;0-17 anos;32;16;0;48;207;91;0;298;116;91;207;0,000121644;5,35E-05;6,82E-05;5,35E-05;0,000121644;NA;NA
284;AGES;15/02/21;2021;7;All;18-24 anos;2289;1729;0;4018;14449;8589;1;23039;5861;8589;14450;0,018496496;0,010994976;0,0075028;0,010994976;0,018497776;NA;NA
285;AGES;15/02/21;2021;7;All;25-49 anos;22212;18936;7;41155;166519;110786;35;277340;55741;110786;166527;0,049982276;0,033253481;0,016731196;0,033253481;0,049984677;NA;NA
286;AGES;15/02/21;2021;7;All;50-64 anos;25052;12934;2;37988;109389;65664;19;175072;43727;65664;109391;0,050312738;0,030201717;0,020111941;0,030201717;0,050313658;NA;NA
287;AGES;15/02/21;2021;7;All;65-79 anos;5057;7214;2;12273;40835;25959;19;66813;14877;25959;40836;0,02508203;0,015944764;0,009137881;0,015944764;0,025082644;NA;NA
288;AGES;15/02/21;2021;7;All;80 ou mais anos;48667;9248;2;57917;133029;55075;30;188134;77954;55075;133029;0,195174518;0,080803709;0,114370809;0,080803709;0,195174518;NA;NA
289;AGES;15/02/21;2021;7;All;Desconhecido;0;0;0;0;2;0;0;2;2;0;2;NA;NA;NA;NA;NA;NA;NA
290;AGES;22/02/21;2021;8;All;0-17 anos;21;32;0;53;228;123;0;351;105;123;228;0,000133985;7,23E-05;6,17E-05;7,23E-05;0,000133985;NA;NA
291;AGES;22/02/21;2021;8;All;18-24 anos;1289;695;1;1985;15738;9284;2;25024;6455;9284;15739;0,020146574;0,011884661;0,008263193;0,011884661;0,020147854;NA;NA
292;AGES;22/02/21;2021;8;All;25-49 anos;11470;7271;7;18748;177989;118057;42;296088;59940;118057;177997;0,053425106;0,035435941;0,017991566;0,035435941;0,053427507;NA;NA
293;AGES;22/02/21;2021;8;All;50-64 anos;49740;4957;2;54699;159129;70621;21;229771;88510;70621;159131;0,073190319;0,032481656;0,040709582;0,032481656;0,073191238;NA;NA
294;AGES;22/02/21;2021;8;All;65-79 anos;11625;2435;2;14062;52460;28394;21;80875;24067;28394;52461;0,032222439;0,017440411;0,014782643;0,017440411;0,032223053;NA;NA
295;AGES;22/02/21;2021;8;All;80 ou mais anos;102617;5185;4;107806;235646;60260;34;295940;175386;60260;235646;0,345729838;0,088410922;0,257318916;0,088410922;0,345729838;NA;NA
296;AGES;22/02/21;2021;8;All;Desconhecido;0;0;0;0;2;0;0;2;2;0;2;NA;NA;NA;NA;NA;NA;NA
297;AGES;01/03/21;2021;9;All;0-17 anos;11;30;0;41;239;153;0;392;86;153;239;0,000140449;8,99E-05;5,05E-05;8,99E-05;0,000140449;NA;NA
298;AGES;01/03/21;2021;9;All;18-24 anos;898;1024;1;1923;16636;10308;3;26947;6330;10308;16638;0,021296124;0,013195507;0,008103178;0,013195507;0,021298685;NA;NA
299;AGES;01/03/21;2021;9;All;25-49 anos;7435;9920;4;17359;185424;127977;46;313447;57462;127977;185439;0,055656793;0,038413524;0,017247771;0,038413524;0,055661295;NA;NA
300;AGES;01/03/21;2021;9;All;50-64 anos;30041;5951;4;35996;189170;76572;25;265767;112603;76572;189175;0,087007475;0,035218779;0,051790996;0,035218779;0,087009775;NA;NA
301;AGES;01/03/21;2021;9;All;65-79 anos;13168;3774;2;16944;65628;32168;23;97819;33465;32168;65633;0,040310603;0,01975851;0,020555164;0,01975851;0,040313674;NA;NA
302;AGES;01/03/21;2021;9;All;80 ou mais anos;87223;12803;1;100027;322869;73063;35;395967;249806;73063;322869;0,473699732;0,107194941;0,36650479;0,107194941;0,473699732;NA;NA
303;AGES;01/03/21;2021;9;All;Desconhecido;0;0;0;0;2;0;0;2;2;0;2;NA;NA;NA;NA;NA;NA;NA
304;AGES;08/03/21;2021;10;All;0-17 anos;14;25;0;39;253;178;0;431;75;178;253;0,000148676;0,000104602;4,41E-05;0,000104602;0,000148676;NA;NA
305;AGES;08/03/21;2021;10;All;18-24 anos;1334;639;1;1974;17970;10947;4;28921;7028;10947;17975;0,023003808;0,014013505;0,008996704;0,014013505;0,023010209;NA;NA
306;AGES;08/03/21;2021;10;All;25-49 anos;16069;6144;7;22220;201493;134121;53;335667;67400;134121;201521;0,060480057;0,040257705;0,020230757;0,040257705;0,060488462;NA;NA
307;AGES;08/03/21;2021;10;All;50-64 anos;22000;4260;1;26261;211170;80832;26;292028;130347;80832;211179;0,097126228;0,037178137;0,05995223;0,037178137;0,097130368;NA;NA
308;AGES;08/03/21;2021;10;All;65-79 anos;15730;3513;1;19244;81358;35681;24;117063;45686;35681;81367;0,049972421;0,021916295;0,028061654;0,021916295;0,049977949;NA;NA
309;AGES;08/03/21;2021;10;All;80 ou mais anos;40156;37318;0;77474;363025;110381;35;473441;252644;110381;363025;0,532614915;0,161946331;0,370668584;0,161946331;0,532614915;NA;NA
310;AGES;08/03/21;2021;10;All;Desconhecido;0;0;0;0;2;0;0;2;2;0;2;NA;NA;NA;NA;NA;NA;NA
311;AGES;15/03/21;2021;11;All;0-17 anos;3;23;0;26;256;201;0;457;55;201;256;0,000150439;0,000118118;3,23E-05;0,000118118;0,000150439;NA;NA
312;AGES;15/03/21;2021;11;All;18-24 anos;251;380;1;632;18221;11327;5;29553;6900;11327;18227;0,023325119;0,014499952;0,008832848;0,014499952;0,0233328;NA;NA
313;AGES;15/03/21;2021;11;All;25-49 anos;4430;3118;1;7549;205923;137239;54;343216;68718;137239;205957;0,061809764;0,041193603;0,020626367;0,041193603;0,06181997;NA;NA
314;AGES;15/03/21;2021;11;All;50-64 anos;4316;2282;3;6601;215486;83114;29;298629;132388;83114;215502;0,099111344;0,038227728;0,060890975;0,038227728;0,099118703;NA;NA
315;AGES;15/03/21;2021;11;All;65-79 anos;18045;6804;4;24853;99403;42485;28;141916;56931;42485;99416;0,061056179;0,026095508;0,034968656;0,026095508;0,061064164;NA;NA
316;AGES;15/03/21;2021;11;All;80 ou mais anos;54385;97425;8;151818;417410;207806;43;625259;209604;207806;417410;0,612406285;0,304884168;0,307522117;0,304884168;0,612406285;NA;NA
317;AGES;15/03/21;2021;11;All;Desconhecido;0;0;0;0;2;0;0;2;2;0;2;NA;NA;NA;NA;NA;NA;NA
318;AGES;22/03/21;2021;12;All;0-17 anos;27;10;0;37;283;211;0;494;72;211;283;0,000166306;0,000123995;4,23E-05;0,000123995;0,000166306;NA;NA
319;AGES;22/03/21;2021;12;All;18-24 anos;3124;128;0;3252;21345;11455;5;32805;9897;11455;21352;0,027324223;0,014663808;0,012669376;0,014663808;0,027333184;NA;NA
320;AGES;22/03/21;2021;12;All;25-49 anos;41915;1383;1;43299;247838;138622;55;386515;109255;138622;247877;0,074390954;0,041608723;0,032793937;0,041608723;0,07440266;NA;NA
321;AGES;22/03/21;2021;12;All;50-64 anos;34308;921;0;35229;249794;84035;29;333858;165780;84035;249815;0,114891079;0,038651336;0,076249401;0,038651336;0,114900737;NA;NA
322;AGES;22/03/21;2021;12;All;65-79 anos;52711;2138;0;54849;152114;44623;28;196765;107511;44623;152134;0,093432789;0,027408729;0,066036345;0,027408729;0,093445074;NA;NA
323;AGES;22/03/21;2021;12;All;80 ou mais anos;124542;16894;2;141438;541952;224700;45;766697;317252;224700;541952;0,795129037;0,32967033;0,465458707;0,32967033;0,795129037;NA;NA
324;AGES;22/03/21;2021;12;All;Desconhecido;0;0;0;0;2;0;0;2;2;0;2;NA;NA;NA;NA;NA;NA;NA
325;AGES;29/03/21;2021;13;All;0-17 anos;12;13;0;25;295;224;0;519;71;224;295;0,000173357;0,000131634;4,17E-05;0,000131634;0,000173357;NA;NA
326;AGES;29/03/21;2021;13;All;18-24 anos;541;78;1;620;21886;11533;6;33425;10360;11533;21893;0,02801677;0,014763657;0,013262073;0,014763657;0,02802573;NA;NA
327;AGES;29/03/21;2021;13;All;25-49 anos;4387;912;1;5300;252225;139534;56;391815;112752;139534;252286;0,075707754;0,041882469;0,033843595;0,041882469;0,075726064;NA;NA
328;AGES;29/03/21;2021;13;All;50-64 anos;7618;705;1;8324;257412;84740;30;342182;172703;84740;257443;0,118394927;0,038975596;0,079433589;0,038975596;0,118409185;NA;NA
329;AGES;29/03/21;2021;13;All;65-79 anos;88162;7296;0;95458;240276;51919;28;292223;188382;51919;240301;0,147584423;0,031890142;0,115709637;0,031890142;0,147599778;NA;NA
330;AGES;29/03/21;2021;13;All;80 ou mais anos;36747;75408;3;112158;578699;300108;48;878855;278591;300108;578699;0,84904268;0,440305756;0,408736924;0,440305756;0,84904268;NA;NA
331;AGES;29/03/21;2021;13;All;Desconhecido;0;0;0;0;2;0;0;2;2;0;2;NA;NA;NA;NA;NA;NA;NA
332;AGES;05/04/21;2021;14;All;0-17 anos;23;2;0;25;318;226;0;544;92;226;318;0,000186873;0,000132809;5,41E-05;0,000132809;0,000186873;NA;NA
333;AGES;05/04/21;2021;14;All;18-24 anos;763;139;0;902;22649;11672;6;34327;10991;11672;22663;0,028993503;0,014941594;0,014069831;0,014941594;0,029011425;NA;NA
334;AGES;05/04/21;2021;14;All;25-49 anos;8887;1066;0;9953;261112;140600;56;401768;120615;140600;261215;0,078375272;0,042202439;0,03620375;0,042202439;0,078406189;NA;NA
335;AGES;05/04/21;2021;14;All;50-64 anos;15054;849;0;15903;272466;85589;30;358085;186936;85589;272525;0,125318913;0,039366088;0,085979962;0,039366088;0,12534605;NA;NA
336;AGES;05/04/21;2021;14;All;65-79 anos;201340;5250;1;206591;441616;57169;29;498814;384483;57169;441652;0,271253235;0,035114842;0,236160505;0,035114842;0,271275348;NA;NA
337;AGES;05/04/21;2021;14;All;80 ou mais anos;30377;45832;6;76215;609076;345940;54;955070;263136;345940;609076;0,893610528;0,507548526;0,386062002;0,507548526;0,893610528;NA;NA
338;AGES;05/04/21;2021;14;All;Desconhecido;0;0;0;0;2;0;0;2;2;0;2;NA;NA;NA;NA;NA;NA;NA
339;AGES;12/04/21;2021;15;All;0-17 anos;42;4;0;46;360;230;0;590;130;230;360;0,000211555;0,00013516;7,64E-05;0,00013516;0,000211555;NA;NA
340;AGES;12/04/21;2021;15;All;18-24 anos;4264;80;0;4344;26913;11752;6;38671;15182;11752;26934;0,034451947;0,015044004;0,019434826;0,015044004;0,03447883;NA;NA
341;AGES;12/04/21;2021;15;All;25-49 anos;88899;636;1;89536;350011;141236;57;491304;208880;141236;350116;0,10505916;0,042393341;0,062697336;0,042393341;0,105090677;NA;NA
342;AGES;12/04/21;2021;15;All;50-64 anos;87842;494;0;88336;360308;86083;30;446421;274289;86083;360372;0,165721253;0,0395933;0,12615739;0,0395933;0,16575069;NA;NA
343;AGES;12/04/21;2021;15;All;65-79 anos;233869;3508;2;237379;675485;60677;31;736193;614845;60677;675522;0,414902295;0,037269557;0,377655464;0,037269557;0,414925021;NA;NA
344;AGES;12/04/21;2021;15;All;80 ou mais anos;10534;49480;5;60019;619610;395420;59;1015089;224190;395420;619610;0,909065567;0,580143488;0,328922079;0,580143488;0,909065567;NA;NA
345;AGES;12/04/21;2021;15;All;Desconhecido;0;0;0;0;2;0;0;2;2;0;2;NA;NA;NA;NA;NA;NA;NA
346;AGES;19/04/21;2021;16;All;0-17 anos;30;8;0;38;390;238;0;628;152;238;390;0,000229184;0,000139861;8,93E-05;0,000139861;0,000229184;NA;NA
347;AGES;19/04/21;2021;16;All;18-24 anos;1283;80;0;1363;28196;11832;6;40034;16385;11832;28217;0,036094345;0,015146414;0,020974814;0,015146414;0,036121228;NA;NA
348;AGES;19/04/21;2021;16;All;25-49 anos;10815;694;1;11510;360826;141930;58;502814;219003;141930;360933;0,108305386;0,042601651;0,065735852;0,042601651;0,108337503;NA;NA
349;AGES;19/04/21;2021;16;All;50-64 anos;14297;1691;2;15990;374605;87774;32;462411;286896;87774;374670;0,172297063;0,040371064;0,131955895;0,040371064;0,172326959;NA;NA
350;AGES;19/04/21;2021;16;All;65-79 anos;175899;13173;2;189074;851384;73850;33;925267;777573;73850;851423;0,522944514;0,045360792;0,477607677;0,045360792;0,522968469;NA;NA
351;AGES;19/04/21;2021;16;All;80 ou mais anos;8433;123163;11;131607;628043;518583;70;1146696;109460;518583;628043;0,921438108;0,760843029;0,160595079;0,760843029;0,921438108;NA;NA
352;AGES;19/04/21;2021;16;All;Desconhecido;0;0;0;0;2;0;0;2;2;0;2;NA;NA;NA;NA;NA;NA;NA
353;AGES;26/04/21;2021;17;All;0-17 anos;48;23;0;71;438;261;0;699;177;261;438;0,000257392;0,000153377;0,000104014;0,000153377;0,000257392;NA;NA
354;AGES;26/04/21;2021;17;All;18-24 anos;2596;146;0;2742;30792;11978;6;42776;18855;11978;30833;0,039417544;0,015333312;0,024136717;0,015333312;0,039470029;NA;NA
355;AGES;26/04/21;2021;17;All;25-49 anos;10637;811;6;11454;371463;142741;64;514268;228873;142741;371614;0,111498184;0,042845081;0,068698427;0,042845081;0,111543508;NA;NA
356;AGES;26/04/21;2021;17;All;50-64 anos;32784;2864;1;35649;407389;90638;33;498060;317078;90638;407716;0,187375844;0,041688341;0,145837904;0,041688341;0,187526246;NA;NA
357;AGES;26/04/21;2021;17;All;65-79 anos;293216;46310;3;339529;1144600;120160;36;1264796;1025477;120160;1145637;0,703046206;0,073805724;0,629877437;0,073805724;0,703683161;NA;NA
358;AGES;26/04/21;2021;17;All;80 ou mais anos;6154;39771;4;45929;634197;558354;74;1192625;75854;558354;634208;0,930466996;0,819193357;0,111289778;0,819193357;0,930483135;NA;NA
359;AGES;26/04/21;2021;17;All;Desconhecido;1;0;0;1;3;0;0;3;3;0;3;NA;NA;NA;NA;NA;NA;NA
360;AGES;03/05/21;2021;18;All;0-17 anos;103;12;1;116;541;273;1;815;268;273;541;0,00031792;0,000160429;0,000157491;0,000160429;0,00031792;NA;NA
361;AGES;03/05/21;2021;18;All;18-24 anos;1794;780;2;2576;32586;12758;8;45352;19894;12758;32652;0,041714085;0,016331808;0,025466765;0,016331808;0,041798573;NA;NA
362;AGES;03/05/21;2021;18;All;25-49 anos;9899;7814;2;17715;381362;150555;66;531983;231019;150555;381574;0,114469463;0,045190528;0,069342569;0,045190528;0,114533097;NA;NA
363;AGES;03/05/21;2021;18;All;50-64 anos;151274;14503;4;165781;558663;105141;37;663841;459494;105141;564635;0,256953308;0,048358899;0,21134119;0,048358899;0,259700089;NA;NA
364;AGES;03/05/21;2021;18;All;65-79 anos;202381;163955;6;366342;1346981;284115;42;1631138;1070426;284115;1354541;0,827354431;0,174511596;0,657486404;0,174511596;0,831998;NA;NA
365;AGES;03/05/21;2021;18;All;80 ou mais anos;5107;31770;4;36881;639304;590124;78;1229506;49339;590124;639463;0,937959771;0,865804956;0,072388093;0,865804956;0,938193049;NA;NA
366;AGES;03/05/21;2021;18;All;Desconhecido;1;0;0;1;4;0;0;4;4;0;4;NA;NA;NA;NA;NA;NA;NA
367;AGES;10/05/21;2021;19;All;0-17 anos;152;38;0;190;693;311;1;1005;382;311;693;0,000407243;0,00018276;0,000224483;0,00018276;0,000407243;NA;NA
368;AGES;10/05/21;2021;19;All;18-24 anos;2183;5345;2;7530;34769;18103;10;52882;16746;18103;34849;0,044508593;0,023174065;0,021436938;0,023174065;0,044611003;NA;NA
369;AGES;10/05/21;2021;19;All;25-49 anos;24710;99839;5;124554;406072;250394;71;656537;155973;250394;406367;0,121886407;0,075158162;0,046816792;0,075158162;0,121974954;NA;NA
370;AGES;10/05/21;2021;19;All;50-64 anos;166479;109387;8;275874;725142;214528;45;939715;526290;214528;740818;0,33352421;0,098670718;0,242063563;0,098670718;0,340734281;NA;NA
371;AGES;10/05/21;2021;19;All;65-79 anos;91529;80144;6;171679;1438510;364259;48;1802817;1089627;364259;1453886;0,883574172;0,223738343;0,66928021;0,223738343;0,893018553;NA;NA
372;AGES;10/05/21;2021;19;All;80 ou mais anos;3783;9979;2;13764;643087;600103;80;1243270;43344;600103;643447;0,943510028;0,880445723;0,063592482;0,880445723;0,944038205;NA;NA
373;AGES;10/05/21;2021;19;All;Desconhecido;0;1;0;1;4;1;0;5;3;1;4;NA;NA;NA;NA;NA;NA;NA
374;AGES;17/05/21;2021;20;All;0-17 anos;303;23;0;326;996;334;1;1331;662;334;996;0,000585302;0,000196276;0,000389026;0,000196276;0,000585302;NA;NA
375;AGES;17/05/21;2021;20;All;18-24 anos;2026;2391;2;4419;36795;20494;12;57301;16384;20494;36878;0,047102122;0,026234839;0,020973533;0,026234839;0,047208372;NA;NA
376;AGES;17/05/21;2021;20;All;25-49 anos;32079;21628;2;53709;438151;272022;73;710246;166538;272022;438560;0,131515227;0,081650013;0,049987979;0,081650013;0,131637992;NA;NA
377;AGES;17/05/21;2021;20;All;50-64 anos;224591;75398;3;299992;949733;289926;48;1239707;693679;289926;983605;0,436823337;0,133349523;0,319053014;0,133349523;0,452402537;NA;NA
378;AGES;17/05/21;2021;20;All;65-79 anos;41254;111578;7;152839;1479764;475837;55;1955656;1024475;475837;1500312;0,908913565;0,292272757;0,62926198;0,292272757;0,921534736;NA;NA
379;AGES;17/05/21;2021;20;All;80 ou mais anos;4745;8363;1;13109;647832;608466;81;1256379;40160;608466;648626;0,950471691;0,892715562;0,058921052;0,892715562;0,951636614;NA;NA
380;AGES;17/05/21;2021;20;All;Desconhecido;0;0;0;0;4;1;0;5;3;1;4;NA;NA;NA;NA;NA;NA;NA
381;AGES;24/05/21;2021;21;All;0-17 anos;281;37;0;318;1277;371;1;1649;906;371;1277;0,000750432;0,000218019;0,000532413;0,000218019;0,000750432;NA;NA
382;AGES;24/05/21;2021;21;All;18-24 anos;2197;3184;5;5386;38992;23678;17;62687;15411;23678;39089;0,049914552;0,03031075;0,019727974;0,03031075;0,050038724;NA;NA
383;AGES;24/05/21;2021;21;All;25-49 anos;25782;18057;27;43866;463933;290079;100;754112;174513;290079;464592;0,139253941;0,087069995;0,052381751;0,087069995;0,139451746;NA;NA
384;AGES;24/05/21;2021;21;All;50-64 anos;175092;98136;38;273266;1124825;388062;86;1512973;814634;388062;1202696;0,517355731;0,17848652;0,374685456;0,17848652;0,553171976;NA;NA
385;AGES;24/05/21;2021;21;All;65-79 anos;23591;202361;21;225973;1503355;678198;76;2181629;850320;678198;1528518;0,923403835;0,416568697;0,522290975;0,416568697;0,938859672;NA;NA
386;AGES;24/05/21;2021;21;All;80 ou mais anos;4446;6345;0;10791;652278;614811;81;1267170;38736;614811;653547;0,956994674;0,902024678;0,05683182;0,902024678;0,958856497;NA;NA
387;AGES;24/05/21;2021;21;All;Desconhecido;0;1;0;1;4;2;0;6;2;2;4;NA;NA;NA;NA;NA;NA;NA
388;AGES;31/05/21;2021;22;All;0-17 anos;266;102;0;368;1543;473;1;2017;1070;473;1543;0,000906747;0,000277959;0,000628788;0,000277959;0,000906747;NA;NA
389;AGES;31/05/21;2021;22;All;18-24 anos;2223;2537;2;4762;41215;26215;19;67449;15102;26215;41317;0,052760265;0,033558422;0,019332416;0,033558422;0,052890838;NA;NA
390;AGES;31/05/21;2021;22;All;25-49 anos;41892;23305;17;65214;505825;313384;117;819326;193441;313384;506825;0,151828227;0,094065214;0,058063172;0,094065214;0,152128387;NA;NA
391;AGES;31/05/21;2021;22;All;50-64 anos;163512;168258;14;331784;1288337;556320;100;1844757;859695;556320;1416015;0,592561981;0,255875661;0,395410962;0,255875661;0,651286622;NA;NA
392;AGES;31/05/21;2021;22;All;65-79 anos;18609;137268;24;155901;1521964;815466;100;2337530;737336;815466;1552802;0,934834017;0,500882647;0,452892956;0,500882647;0,953775603;NA;NA
393;AGES;31/05/21;2021;22;All;80 ou mais anos;3046;6035;4;9085;655324;620846;85;1276255;36346;620846;657192;0,961463636;0,910878974;0,053325313;0,910878974;0,964204287;NA;NA
394;AGES;31/05/21;2021;22;All;Desconhecido;0;0;0;0;4;2;0;6;2;2;4;NA;NA;NA;NA;NA;NA;NA
395;AGES;07/06/21;2021;23;All;0-17 anos;384;151;0;535;1927;624;1;2552;1304;624;1928;0,001132406;0,000366695;0,000766298;0,000366695;0,001132993;NA;NA
396;AGES;07/06/21;2021;23;All;18-24 anos;2724;2821;0;5545;43939;29036;19;72994;15027;29036;44063;0,05624732;0,037169648;0,019236407;0,037169648;0,056406055;NA;NA
397;AGES;07/06/21;2021;23;All;25-49 anos;127301;31566;7;158874;633126;344950;124;978200;291226;344950;636176;0,190038844;0,103540052;0,087414278;0,103540052;0,19095433;NA;NA
398;AGES;07/06/21;2021;23;All;50-64 anos;209512;138768;13;348293;1497849;695088;113;2193050;953922;695088;1649010;0,688925623;0,319701074;0,43875004;0,319701074;0,758451113;NA;NA
399;AGES;07/06/21;2021;23;All;65-79 anos;16049;71466;7;87522;1538013;886932;107;2425052;684033;886932;1570965;0,944691774;0,544779117;0,420152722;0,544779117;0,964931839;NA;NA
400;AGES;07/06/21;2021;23;All;80 ou mais anos;2751;4818;1;7570;658075;625664;86;1283825;34661;625664;660325;0,965499787;0,91794774;0,050853152;0,91794774;0,968800892;NA;NA
401;AGES;07/06/21;2021;23;All;Desconhecido;0;0;0;0;4;2;0;6;2;2;4;NA;NA;NA;NA;NA;NA;NA
402;AGES;07/06/21;2021;23;All;NA;1;0;0;1;1;0;0;1;1;0;1;NA;NA;NA;NA;NA;NA;NA
403;AGES;14/06/21;2021;24;All;0-17 anos;556;325;0;881;2483;949;1;3433;1537;949;2486;0,00145914;0,000557682;0,000903221;0,000557682;0,001460903;NA;NA
404;AGES;14/06/21;2021;24;All;18-24 anos;2780;4438;3;7221;46719;33474;22;80215;13630;33474;47104;0,059806061;0,042850834;0,017448075;0,042850834;0,060298909;NA;NA
405;AGES;14/06/21;2021;24;All;25-49 anos;239480;84683;11;324174;872606;429633;135;1302374;463148;429633;892781;0,261921063;0,128958467;0,139018316;0,128958467;0,267976783;NA;NA
406;AGES;14/06/21;2021;24;All;50-64 anos;86062;230450;21;316533;1583911;925538;134;2509583;826006;925538;1751544;0,728509264;0,425695009;0,379915932;0,425695009;0,80561094;NA;NA
407;AGES;14/06/21;2021;24;All;65-79 anos;10871;62396;5;73272;1548884;949328;112;2498324;633870;949328;1583198;0,951369054;0,583104533;0,389341166;0,583104533;0,972445699;NA;NA
408;AGES;14/06/21;2021;24;All;80 ou mais anos;2625;4744;0;7369;660700;630408;86;1291194;32815;630408;663223;0,969351076;0,924907936;0,048144779;0,924907936;0,973052715;NA;NA
409;AGES;14/06/21;2021;24;All;Desconhecido;0;0;0;0;4;2;0;6;2;2;4;NA;NA;NA;NA;NA;NA;NA
410;AGES;14/06/21;2021;24;All;NA;0;0;0;0;1;0;0;1;1;0;1;NA;NA;NA;NA;NA;NA;NA
411;AGES;21/06/21;2021;25;All;0-17 anos;387;277;1;665;2870;1226;2;4098;1653;1226;2879;0,001686562;0,000720462;0,000971389;0,000720462;0,00169185;NA;NA
412;AGES;21/06/21;2021;25;All;18-24 anos;2500;2861;1;5362;49219;36335;23;85577;13739;36335;50074;0,063006369;0,046513265;0,017587608;0,046513265;0,064100874;NA;NA
413;AGES;21/06/21;2021;25;All;25-49 anos;272141;55664;10;327815;1144747;485297;145;1630189;704989;485297;1190286;0,343606796;0,145666551;0,211609213;0,145666551;0,357275764;NA;NA
414;AGES;21/06/21;2021;25;All;50-64 anos;86400;183359;16;269775;1670311;1108897;150;2779358;745086;1108897;1853983;0,768248366;0,510029754;0,342697319;0,510029754;0,852727073;NA;NA
415;AGES;21/06/21;2021;25;All;65-79 anos;10297;96924;9;107230;1559181;1046252;121;2605554;549149;1046252;1595401;0,957693768;0,642638039;0,337303094;0,642638039;0,979941132;NA;NA
416;AGES;21/06/21;2021;25;All;80 ou mais anos;3404;4765;3;8172;664104;635173;89;1299366;31901;635173;667074;0,974345281;0,931898942;0,046803797;0,931898942;0,978702739;NA;NA
417;AGES;21/06/21;2021;25;All;Desconhecido;0;0;0;0;4;2;0;6;2;2;4;NA;NA;NA;NA;NA;NA;NA
418;AGES;21/06/21;2021;25;All;NA;0;0;0;0;1;0;0;1;1;0;1;NA;NA;NA;NA;NA;NA;NA
419;AGES;28/06/21;2021;26;All;0-17 anos;176;268;0;444;3046;1494;2;4542;1561;1494;3055;0,001789988;0,000877952;0,000917325;0,000877952;0,001795277;NA;NA
420;AGES;28/06/21;2021;26;All;18-24 anos;1837;2600;1;4438;51056;38935;24;90015;13075;38935;52010;0,065357954;0,049841585;0,016737607;0,049841585;0,066579192;NA;NA
421;AGES;28/06/21;2021;26;All;25-49 anos;314360;58561;16;372937;1459107;543858;161;2003126;975237;543858;1519095;0,437964966;0,163244197;0,292726743;0,163244197;0,45597094;NA;NA
422;AGES;28/06/21;2021;26;All;50-64 anos;59208;178249;14;237471;1729519;1287146;164;3016829;632878;1287146;1920024;0,795480689;0,592014188;0,291088;0,592014188;0,883102189;NA;NA
423;AGES;28/06/21;2021;26;All;65-79 anos;9052;181900;13;190965;1568233;1228152;134;2796519;377680;1228152;1605832;0,963253766;0,754366245;0,231981907;0,754366245;0,986348152;NA;NA
424;AGES;28/06/21;2021;26;All;80 ou mais anos;3264;5395;1;8660;667368;640568;90;1308026;30192;640568;670760;0,979134084;0,939814258;0,044296425;0,939814258;0,984110682;NA;NA
425;AGES;28/06/21;2021;26;All;Desconhecido;1;0;0;1;5;2;0;7;3;2;5;NA;NA;NA;NA;NA;NA;NA
426;AGES;28/06/21;2021;26;All;NA;0;0;0;0;1;0;0;1;1;0;1;NA;NA;NA;NA;NA;NA;NA
427;AGES;05/07/21;2021;27;All;0-17 anos;395;649;0;1044;3441;2143;2;5586;1307;2143;3450;0,002022111;0,001259339;0,000768061;0,001259339;0,0020274;NA;NA
428;AGES;05/07/21;2021;27;All;18-24 anos;11518;4814;4;16336;62574;43749;28;106351;21221;43749;64970;0,08010241;0,056004096;0,027165488;0,056004096;0,083169584;NA;NA
429;AGES;05/07/21;2021;27;All;25-49 anos;366123;145807;8;511938;1825230;689665;169;2515064;1223426;689665;1913091;0,547860297;0,207009567;0,367223052;0,207009567;0,574232619;NA;NA
430;AGES;05/07/21;2021;27;All;50-64 anos;41165;257146;23;298334;1770684;1544292;187;3315163;423841;1544292;1968133;0,814414255;0,71028677;0,194942831;0,71028677;0,905229601;NA;NA
431;AGES;05/07/21;2021;27;All;65-79 anos;8129;203500;19;211648;1576362;1431652;153;3008167;183395;1431652;1615047;0,968246832;0,879361792;0,112646478;0,879361792;0,99200827;NA;NA
432;AGES;05/07/21;2021;27;All;80 ou mais anos;2673;5232;2;7907;670041;645800;92;1315933;27971;645800;673771;0,983055796;0,947490427;0,041037867;0,947490427;0,988528294;NA;NA
433;AGES;05/07/21;2021;27;All;Desconhecido;0;1;0;1;5;3;0;8;2;3;5;NA;NA;NA;NA;NA;NA;NA
434;AGES;05/07/21;2021;27;All;NA;0;0;0;0;1;0;0;1;1;0;1;NA;NA;NA;NA;NA;NA;NA
435;AGES;12/07/21;2021;28;All;0-17 anos;225;297;0;522;3666;2440;2;6108;1249;2440;3689;0,002154333;0,001433871;0,000733978;0,001433871;0,002167849;NA;NA
436;AGES;12/07/21;2021;28;All;18-24 anos;13873;7631;3;21507;76447;51380;31;127858;33515;51380;84895;0,097861555;0,065772714;0,042903319;0,065772714;0,108676033;NA;NA
437;AGES;12/07/21;2021;28;All;25-49 anos;206428;314168;38;520634;2031658;1003833;207;3035698;1210535;1003833;2214368;0,609821642;0,301310107;0,363353695;0,301310107;0,664663802;NA;NA
438;AGES;12/07/21;2021;28;All;50-64 anos;15270;133851;12;149133;1785954;1678143;199;3464296;316316;1678143;1994459;0,82143759;0,771850642;0,145487427;0,771850642;0,917338069;NA;NA
439;AGES;12/07/21;2021;28;All;65-79 anos;5468;57568;7;63043;1581830;1489220;160;3071210;133563;1489220;1622783;0,971605434;0,914721711;0,082038232;0,914721711;0,996759943;NA;NA
440;AGES;12/07/21;2021;28;All;80 ou mais anos;2102;3532;2;5636;672143;649332;94;1321569;27039;649332;676371;0,986139761;0,952672428;0,039670476;0,952672428;0,992342904;NA;NA
441;AGES;12/07/21;2021;28;All;Desconhecido;0;3;0;3;5;6;0;11;-1;6;5;NA;NA;NA;NA;NA;NA;NA
442;AGES;12/07/21;2021;28;All;NA;0;0;0;0;1;0;0;1;1;0;1;NA;NA;NA;NA;NA;NA;NA
443;AGES;19/07/21;2021;29;All;0-17 anos;217;236;0;453;3883;2676;2;6561;1241;2676;3917;0,002281853;0,001572557;0,000729276;0,001572557;0,002301833;NA;NA
444;AGES;19/07/21;2021;29;All;18-24 anos;19253;19339;0;38592;95700;70719;31;166450;50579;70719;121298;0,122507761;0,090529011;0,064747336;0,090529011;0,155276347;NA;NA
445;AGES;19/07/21;2021;29;All;25-49 anos;102916;341587;23;444526;2134574;1345420;230;3480224;1065085;1345420;2410505;0,640712867;0,403840722;0,319695482;0,403840722;0,723536204;NA;NA
446;AGES;19/07/21;2021;29;All;50-64 anos;10876;114584;22;125482;1796830;1792727;221;3589778;231015;1792727;2023742;0,826439933;0,824552786;0,106253803;0,824552786;0,930806589;NA;NA
447;AGES;19/07/21;2021;29;All;65-79 anos;7135;42460;7;49602;1588965;1531680;167;3120812;100956;1531680;1632636;0,975987956;0,940801863;0,062010076;0,940801863;1,002811939;NA;NA
448;AGES;19/07/21;2021;29;All;80 ou mais anos;2194;3081;1;5276;674337;652413;95;1326845;26749;652413;679162;0,989358705;0,957192741;0,039245001;0,957192741;0,996437741;NA;NA
449;AGES;19/07/21;2021;29;All;Desconhecido;0;0;0;0;5;6;0;11;-1;6;5;NA;NA;NA;NA;NA;NA;NA
450;AGES;19/07/21;2021;29;All;NA;0;0;0;0;1;0;0;1;1;0;1;NA;NA;NA;NA;NA;NA;NA
451;AGES;26/07/21;2021;30;All;0-17 anos;1572;204;0;1776;5455;2880;2;8337;2616;2880;5496;0,003205642;0,001692438;0,001537298;0%;0%;NA;NA
452;AGES;26/07/21;2021;30;All;18-24 anos;18997;19901;4;38902;114697;90620;35;205352;67083;90620;157703;0,146826255;0,116004736;0,085874484;12%;20%;NA;NA
453;AGES;26/07/21;2021;30;All;25-49 anos;56031;321254;28;377313;2190605;1666674;258;3857537;857131;1666674;2523805;0,657531109;0,500268193;0,257276094;50%;76%;NA;NA
454;AGES;26/07/21;2021;30;All;50-64 anos;8847;80569;18;89434;1805677;1873296;239;3679212;174551;1873296;2047847;0,830509051;0,861609958;0,080283564;86%;94%;NA;NA
455;AGES;26/07/21;2021;30;All;65-79 anos;8002;30740;5;38747;1596967;1562420;172;3159559;80335;1562420;1642755;0,980903015;0,959683255;0,049344065;96%;100%;NA;NA
456;AGES;26/07/21;2021;30;All;80 ou mais anos;2441;2743;0;5184;676778;655156;95;1332029;26932;655156;682088;0,992940037;0,961217154;0,039513491;96%;100%;NA;NA
457;AGES;26/07/21;2021;30;All;Desconhecido;0;2;0;2;5;8;0;13;;8;6;NA;NA;NA;NA;NA;NA;NA
458;AGES;26/07/21;2021;30;All;NA;0;0;0;0;1;0;0;1;1;0;1;NA;NA;NA;NA;NA;NA;NA
459;GENERAL;04/01/21;2021;1;All;All;48377;53;0;48430;83895;56;0;83951;83845;56;83901;0,008146528;5,44E-06;0,008141673;5,44E-06;0,008147111;NA;NA
460;GENERAL;11/01/21;2021;2;All;All;49513;1169;1;50683;133408;1225;1;134634;132189;1225;133414;0,012954431;0,000118952;0,012836062;0,000118952;0,012955014;NA;NA
461;GENERAL;18/01/21;2021;3;All;All;121719;32635;10;154364;255127;33860;11;288998;221273;33860;255133;0,024773816;0,003287937;0,021486462;0,003287937;0,024774399;NA;NA
462;GENERAL;25/01/21;2021;4;All;All;41512;45601;68;87181;296639;79461;79;376179;217185;79461;296646;0,028804791;0,00771597;0,021089501;0,00771597;0,028805471;NA;NA
463;GENERAL;01/02/21;2021;5;All;All;23740;37462;2;61204;320379;116923;81;437383;203468;116923;320391;0,031110037;0,011353674;0,019757528;0,011353674;0,031111202;NA;NA
464;GENERAL;08/02/21;2021;6;All;All;40742;99164;10;139916;361121;216087;91;577299;145046;216087;361133;0,035066242;0,020982881;0,014084526;0,020982881;0,035067408;NA;NA
465;GENERAL;15/02/21;2021;7;All;All;103309;50077;13;153399;464430;266164;104;730698;198278;266164;464442;0,045097945;0,025845551;0,019253559;0,025845551;0,04509911;651900;571981
466;GENERAL;22/02/21;2021;8;All;All;176762;20575;16;197353;641192;286739;120;928051;354465;286739;641204;0,062262217;0,027843463;0,034419919;0,027843463;0,062263382;830730;718143
467;GENERAL;01/03/21;2021;9;All;All;138776;33502;12;172290;779968;320241;132;1100341;459754;320241;779995;0,075737902;0,031096637;0,044643887;0,031096637;0,075740524;1002999;933847
468;GENERAL;08/03/21;2021;10;All;All;95303;51899;10;147212;875271;372140;142;1247553;503182;372140;875322;0,084992191;0,03613623;0,048860913;0,03613623;0,084997143;1186389;1095103
469;GENERAL;15/03/21;2021;11;All;All;81430;110032;17;191479;956701;482172;159;1439032;474598;482172;956770;0,092899358;0,046820761;0,046085297;0,046820761;0,092906058;1468929;1264093
470;GENERAL;22/03/21;2021;12;All;All;256627;21474;3;278104;1213328;503646;162;1717136;709769;503646;1213415;0,11781883;0,04890597;0,068921308;0,04890597;0,117827278;1713540;1462079
471;GENERAL;29/03/21;2021;13;All;All;137467;84412;6;221885;1350795;588058;168;1939021;762861;588058;1350919;0,131167406;0,057102701;0,074076746;0,057102701;0,131179447;1883850;1753999
472;GENERAL;05/04/21;2021;14;All;All;256444;53138;7;309589;1607239;641196;175;2248610;966255;641196;1607451;0,156069108;0,062262605;0,093827088;0,062262605;0,156089694;2344530;1996561
473;GENERAL;12/04/21;2021;15;All;All;425450;54202;8;479660;2032689;695398;183;2728270;1337518;695398;2032916;0,197381944;0,067525829;0,129878158;0,067525829;0,197403987;2684460;2360167
474;GENERAL;19/04/21;2021;16;All;All;210757;138809;16;349582;2243446;834207;199;3077852;1409471;834207;2243678;0,217847262;0,081004718;0,136865072;0,081004718;0,21786979;2983590;2679813
475;GENERAL;26/04/21;2021;17;All;All;345436;89925;14;435375;2588882;924132;213;3513227;1666317;924132;2590449;0,25139043;0,089736783;0,161805809;0,089736783;0,251542592;3400260;3039329
476;GENERAL;03/05/21;2021;18;All;All;370559;218834;19;589412;2959441;1142966;232;4102639;1830444;1142966;2973410;0,287373139;0,110986408;0,177743174;0,110986408;0,288729582;4128420;3581288
477;GENERAL;10/05/21;2021;19;All;All;288836;304733;23;593592;3248277;1447699;255;4696231;1832365;1447699;3280064;0,315420229;0,140577158;0,177929711;0,140577158;0,318506869;4655370;4171038
478;GENERAL;17/05/21;2021;20;All;All;304998;219381;15;524394;3553275;1667080;270;5220625;1941901;1667080;3608981;0,345036711;0,1618799;0,188566079;0,1618799;0,350445979;5197920;4686071
479;GENERAL;24/05/21;2021;21;All;All;231389;328121;91;559601;3784664;1995201;361;5780226;1894522;1995201;3889723;0,367505476;0,193741715;0,183965395;0,193741715;0,37770711;5728470;5126418
480;GENERAL;31/05/21;2021;22;All;All;229548;337505;61;567114;4014212;2332706;422;6347340;1842992;2332706;4175698;0,389795472;0,226514752;0,178961633;0,226514752;0,405476386;6254220;5644760
481;GENERAL;07/06/21;2021;23;All;All;358722;249590;28;608340;4372934;2582296;450;6955680;1980176;2582296;4562472;0,424628762;0,250750904;0,192282729;0,250750904;0,443033633;7263540;6299315
482;GENERAL;14/06/21;2021;24;All;All;342374;387036;40;729450;4715308;2969332;490;7685130;1971009;2969332;4940341;0,457874599;0,288333593;0,191392578;0,288333593;0,479726171;7880400;6896272
483;GENERAL;21/06/21;2021;25;All;All;375129;343850;40;719019;5090437;3313182;530;8404149;2046520;3313182;5359702;0,494301072;0,321722755;0,198724988;0,321722755;0,520447742;8604606;7566600
484;GENERAL;28/06/21;2021;26;All;All;387898;426973;45;814916;5478335;3740155;575;9219065;2030627;3740155;5770782;0,531967464;0,36318348;0,197181716;0,36318348;0,560365196;9519240;8357319
485;GENERAL;05/07/21;2021;27;All;All;430003;617149;56;1047208;5908338;4357304;631;10266273;1881164;4357304;6238468;0,573722414;0,423111029;0,182668282;0,423111029;0,605779311;11510810;10694447
486;GENERAL;12/07/21;2021;28;All;All;243366;517050;62;760478;6151704;4874354;693;11026751;1722217;4874354;6596571;0,597354192;0,473318579;0,167233915;0,473318579;0,640552494;12300690;11385656
487;GENERAL;19/07/21;2021;29;All;All;142591;521287;53;663931;6294295;5395641;746;11690682;1475625;5395641;6871266;0,611200328;0,523937558;0,14328888;0,523937558;0,667226438;12886770;12043017
488;GENERAL;26/07/21;2021;30;All;All;95890;455413;55;551358;6390185;5851054;801;12242040;1208647;5851054;7059701;0,620511617;0,568159917;0,117364287;0,568159917;0,685524204;13644850;12597147