;TYPE;DATE;YEAR;WEEK;REGION;AGEGROUP;TOTAL_VAC_1;TOTAL_VAC_2;TOTAL_VAC_UNK;TOTAL;CUMUL_VAC_1;CUMUL_VAC_2;CUMUL_VAC_UNK;CUMUL;COVER_1_VAC;COVER;RECIEVED;DISTRIBUTED
1;REGIONAL;08/02/2021;2021;6;ARS Alentejo;All;3332;8771;1;12104;27521;17347;1;44869;0,058970623;0,037170284;NA;NA
2;REGIONAL;15/02/2021;2021;7;ARS Alentejo;All;4039;2804;1;6844;31560;20151;2;51713;0,06762519;0,043178555;NA;NA
3;REGIONAL;22/02/2021;2021;8;ARS Alentejo;All;12008;1646;0;13654;43568;21797;2;65367;0,093355332;0,046705522;NA;NA
4;REGIONAL;01/03/2021;2021;9;ARS Alentejo;All;10371;2817;0;13188;53939;24614;2;78555;0,115577793;0,052741649;NA;NA
5;REGIONAL;08/03/2021;2021;10;ARS Alentejo;All;5776;1661;0;7437;59715;26275;2;85992;0,127954317;0,056300756;NA;NA
6;REGIONAL;15/03/2021;2021;11;ARS Alentejo;All;3665;7702;0;11367;63380;33977;2;97359;0,135807495;0,072804217;NA;NA
7;REGIONAL;22/03/2021;2021;12;ARS Alentejo;All;11777;2089;0;13866;75157;36066;2;111225;0,161042662;0,077280422;NA;NA
8;REGIONAL;08/02/2021;2021;6;ARS Algarve;All;2361;2896;1;5258;12711;6303;1;19015;0,028993673;0,014377084;NA;NA
9;REGIONAL;15/02/2021;2021;7;ARS Algarve;All;3166;2109;0;5275;15877;8412;1;24290;0,036215289;0,019187694;NA;NA
10;REGIONAL;22/02/2021;2021;8;ARS Algarve;All;8429;1063;0;9492;24306;9475;1;33782;0,055441759;0,021612387;NA;NA
11;REGIONAL;01/03/2021;2021;9;ARS Algarve;All;4577;544;0;5121;28883;10019;1;38903;0,065881854;0,022853246;NA;NA
12;REGIONAL;08/03/2021;2021;10;ARS Algarve;All;5034;1530;0;6564;33917;11549;1;45467;0,077364361;0,026343161;NA;NA
13;REGIONAL;15/03/2021;2021;11;ARS Algarve;All;2631;2993;0;5624;36548;14542;1;51091;0,083365647;0,033170166;NA;NA
14;REGIONAL;22/03/2021;2021;12;ARS Algarve;All;9305;4274;0;13579;45853;18816;1;64670;0,104590266;0,042919121;NA;NA
15;REGIONAL;08/02/2021;2021;6;ARS Centro;All;7460;27027;4;34491;79684;50871;8;130563;0,049006421;0,031286151;NA;NA
16;REGIONAL;15/02/2021;2021;7;ARS Centro;All;25166;9855;3;35024;104850;60726;11;165587;0,064483752;0,03734707;NA;NA
17;REGIONAL;22/02/2021;2021;8;ARS Centro;All;38070;3066;1;41137;142920;63792;12;206724;0,087897165;0,039232689;NA;NA
18;REGIONAL;01/03/2021;2021;9;ARS Centro;All;28226;5732;1;33959;171146;69524;13;240683;0,105256425;0,042757924;NA;NA
19;REGIONAL;08/03/2021;2021;10;ARS Centro;All;17386;13382;0;30768;188532;82906;13;271451;0,115948981;0,050987982;NA;NA
20;REGIONAL;15/03/2021;2021;11;ARS Centro;All;16406;23985;2;40393;204938;106891;15;311844;0,126038828;0,065738986;NA;NA
21;REGIONAL;22/03/2021;2021;12;ARS Centro;All;47307;4199;0;51506;252245;111090;15;363350;0,155133085;0,068321411;NA;NA
22;REGIONAL;08/02/2021;2021;6;ARS Lisboa e Vale do Tejo;All;14267;30203;1;44471;114122;60633;2;174757;0,030906984;0,016420876;NA;NA
23;REGIONAL;15/02/2021;2021;7;ARS Lisboa e Vale do Tejo;All;32507;18958;3;51468;146629;79591;5;226225;0,039710662;0,021555158;NA;NA
24;REGIONAL;22/02/2021;2021;8;ARS Lisboa e Vale do Tejo;All;48880;6607;0;55487;195509;86198;5;281712;0,052948543;0,023344493;NA;NA
25;REGIONAL;01/03/2021;2021;9;ARS Lisboa e Vale do Tejo;All;44404;12488;1;56893;239913;98686;6;338605;0,064974215;0,026726544;NA;NA
26;REGIONAL;08/03/2021;2021;10;ARS Lisboa e Vale do Tejo;All;32664;16318;0;48982;272577;115004;6;387587;0,073820412;0,031145851;NA;NA
27;REGIONAL;15/03/2021;2021;11;ARS Lisboa e Vale do Tejo;All;25349;28741;1;54091;297926;143745;7;441678;0,080685532;0,038929606;NA;NA
28;REGIONAL;22/03/2021;2021;12;ARS Lisboa e Vale do Tejo;All;87805;7385;0;95190;385731;151130;7;536868;0,104465239;0,040929642;NA;NA
29;REGIONAL;08/02/2021;2021;6;ARS Norte;All;8455;28446;6;36907;104786;68604;7;173397;0,029307998;0,019188116;NA;NA
30;REGIONAL;15/02/2021;2021;7;ARS Norte;All;32741;14836;3;47580;137527;83440;10;220977;0,038465454;0,023337654;NA;NA
31;REGIONAL;22/02/2021;2021;8;ARS Norte;All;64263;4207;1;68471;201790;87647;11;289448;0,056439419;0,024514326;NA;NA
32;REGIONAL;01/03/2021;2021;9;ARS Norte;All;47428;6390;0;53818;249218;94037;11;343266;0,069704738;0,026301569;NA;NA
33;REGIONAL;08/03/2021;2021;10;ARS Norte;All;25031;13622;0;38653;274249;107659;11;381919;0,076705755;0,030111559;NA;NA
34;REGIONAL;15/03/2021;2021;11;ARS Norte;All;26363;42021;5;68389;300612;149680;16;450308;0,084079323;0,041864573;NA;NA
35;REGIONAL;22/03/2021;2021;12;ARS Norte;All;88018;2171;0;90189;388630;151851;16;540497;0,108697415;0,042471789;NA;NA
36;REGIONAL;08/02/2021;2021;6;Outro;All;68;119;0;187;685;438;1;1124;NA;NA;NA;NA
37;REGIONAL;15/02/2021;2021;7;Outro;All;146;106;1;253;831;544;2;1377;NA;NA;NA;NA
38;REGIONAL;22/02/2021;2021;8;Outro;All;73;19;0;92;904;563;2;1469;NA;NA;NA;NA
39;REGIONAL;01/03/2021;2021;9;Outro;All;55;35;0;90;959;598;2;1559;NA;NA;NA;NA
40;REGIONAL;08/03/2021;2021;10;Outro;All;276;13;0;289;1235;611;2;1848;NA;NA;NA;NA
41;REGIONAL;15/03/2021;2021;11;Outro;All;18;26;0;44;1253;637;2;1892;NA;NA;NA;NA
42;REGIONAL;22/03/2021;2021;12;Outro;All;309;4;0;313;1562;641;2;2205;NA;NA;NA;NA
43;REGIONAL;08/02/2021;2021;6;RA_Madeira;All;3158;1085;0;4243;10990;4773;0;15763;0,043224492;0,018772566;NA;NA
44;REGIONAL;15/02/2021;2021;7;RA_Madeira;All;2494;638;0;3132;13484;5411;0;18895;0,053033581;0,021281868;NA;NA
45;REGIONAL;22/02/2021;2021;8;RA_Madeira;All;2255;2155;0;4410;15739;7566;0;23305;0,061902664;0,029757644;NA;NA
46;REGIONAL;01/03/2021;2021;9;RA_Madeira;All;1431;3116;0;4547;17170;10682;0;27852;0,067530894;0,042013105;NA;NA
47;REGIONAL;08/03/2021;2021;10;RA_Madeira;All;4881;2400;0;7281;22051;13082;0;35133;0,086728232;0,051452485;NA;NA
48;REGIONAL;15/03/2021;2021;11;RA_Madeira;All;3102;2347;0;5449;25153;15429;0;40582;0,09892863;0,060683411;NA;NA
49;REGIONAL;22/03/2021;2021;12;RA_Madeira;All;5276;185;0;5461;30429;15614;0;46043;0,119667734;0,061399231;NA;NA
50;REGIONAL;15/03/2021;2021;11;RA_Acores;All;2029;1238;0;3267;13845;8376;0;22221;0,05702318;0,034498097;NA;NA
51;REGIONAL;22/03/2021;2021;12;RA_Acores;All;3182;611;0;3793;17367;9316;0;26683;0,071529185;0,03836966;NA;NA
52;AGES;08/02/2021;2021;6;All;0-17 anos;30;67;0;97;160;72;0;232;9,32E-05;4,19E-05;NA;NA
53;AGES;08/02/2021;2021;6;All;18-24 anos;1385;3028;0;4413;11704;6552;0;18256;0,015088288;0,008446554;NA;NA
54;AGES;08/02/2021;2021;6;All;25-49 anos;13016;30586;5;43607;139317;88474;10;227801;0,041455336;0,026326431;NA;NA
55;AGES;08/02/2021;2021;6;All;50-64 anos;6530;22079;2;28611;81961;50929;4;132894;0,037908385;0,023555547;NA;NA
56;AGES;08/02/2021;2021;6;All;65-79 anos;3505;11383;3;14891;34467;18035;3;52505;0,021480642;0,011239834;NA;NA
57;AGES;08/02/2021;2021;6;All;80 ou mais anos;14635;31404;3;46042;82886;44907;3;127796;0,12263728;0,066443939;NA;NA
58;AGES;15/02/2021;2021;7;All;0-17 anos;20;16;0;36;180;88;0;268;0,000104831;5,13E-05;NA;NA
59;AGES;15/02/2021;2021;7;All;18-24 anos;2181;1682;0;3863;13885;8234;0;22119;0,017899938;0,010614915;NA;NA
60;AGES;15/02/2021;2021;7;All;25-49 anos;20984;18562;6;39552;160301;107036;16;267353;0,047699361;0,031849763;NA;NA
61;AGES;15/02/2021;2021;7;All;50-64 anos;24279;12735;2;37016;106240;63664;6;169910;0,049137845;0,029445705;NA;NA
62;AGES;15/02/2021;2021;7;All;65-79 anos;4690;7128;1;11819;39157;25163;4;64324;0,02440356;0,015682171;NA;NA
63;AGES;15/02/2021;2021;7;All;80 ou mais anos;48105;9183;2;57290;130991;54090;5;185086;0,193812947;0,080031012;NA;NA
64;AGES;22/02/2021;2021;8;All;0-17 anos;21;31;0;52;204;119;0;323;0,000118808;6,93E-05;NA;NA
65;AGES;22/02/2021;2021;8;All;18-24 anos;1236;621;0;1857;15121;8855;0;23976;0,019493336;0,011415481;NA;NA
66;AGES;22/02/2021;2021;8;All;25-49 anos;10845;6426;1;17272;171146;113462;17;284625;0,050926412;0,033761891;NA;NA
67;AGES;22/02/2021;2021;8;All;50-64 anos;49017;4546;1;53564;155257;68210;7;223474;0,071809058;0,031548309;NA;NA
68;AGES;22/02/2021;2021;8;All;65-79 anos;11122;2201;0;13323;50279;27364;4;77647;0,031335051;0,017053886;NA;NA
69;AGES;22/02/2021;2021;8;All;80 ou mais anos;101737;4938;0;106675;232728;59028;5;291761;0,344341975;0,087337227;NA;NA
70;AGES;01/03/2021;2021;9;All;0-17 anos;8;26;0;34;209;142;0;351;0,00012172;8,27E-05;NA;NA
71;AGES;01/03/2021;2021;9;All;18-24 anos;869;903;0;1772;15990;9758;0;25748;0,020613613;0,012579589;NA;NA
72;AGES;01/03/2021;2021;9;All;25-49 anos;7043;8693;0;15736;178189;122155;17;300361;0,053022136;0,036348591;NA;NA
73;AGES;01/03/2021;2021;9;All;50-64 anos;29577;5453;1;35031;184834;73663;8;258505;0,085488934;0,034070416;NA;NA
74;AGES;01/03/2021;2021;9;All;65-79 anos;12708;3538;0;16246;62987;30902;4;93893;0,039254974;0,01925885;NA;NA
75;AGES;01/03/2021;2021;9;All;80 ou mais anos;86287;12509;1;98797;319015;71537;6;390558;0,47201134;0,105845415;NA;NA
76;AGES;08/03/2021;2021;10;All;0-17 anos;12;11;0;23;221;153;0;374;0,000128709;8,91E-05;NA;NA
77;AGES;08/03/2021;2021;10;All;18-24 anos;1264;513;0;1777;17254;10271;0;27525;0,022243107;0,013240927;NA;NA
78;AGES;08/03/2021;2021;10;All;25-49 anos;14689;4926;0;19615;192878;127081;17;319976;0,057393013;0,037814377;NA;NA
79;AGES;08/03/2021;2021;10;All;50-64 anos;20924;3671;0;24595;205758;77334;8;283100;0,095166647;0,035768318;NA;NA
80;AGES;08/03/2021;2021;10;All;65-79 anos;15043;3171;0;18214;78030;34073;4;112107;0,048630124;0,021235092;NA;NA
81;AGES;08/03/2021;2021;10;All;80 ou mais anos;39116;36634;0;75750;358131;108171;6;466308;0,529886974;0,160048708;NA;NA
82;AGES;15/03/2021;2021;11;All;0-17 anos;1;23;0;24;239;180;0;419;0,000139192;0,000104831;NA;NA
83;AGES;15/03/2021;2021;11;All;18-24 anos;223;363;1;587;17873;10949;1;28823;0,023041094;0,014114975;NA;NA
84;AGES;15/03/2021;2021;11;All;25-49 anos;3985;2919;0;6904;200757;132770;17;333544;0,059737497;0,039507203;NA;NA
85;AGES;15/03/2021;2021;11;All;50-64 anos;3883;2210;1;6094;211786;81045;9;292840;0,097954702;0,03748472;NA;NA
86;AGES;15/03/2021;2021;11;All;65-79 anos;17453;6602;2;24057;97322;41657;6;138985;0,06065335;0,025961618;NA;NA
87;AGES;15/03/2021;2021;11;All;80 ou mais anos;54016;96936;4;150956;415672;206673;10;622355;0,615024051;0,305791262;NA;NA
88;AGES;15/03/2021;2021;11;All;Desconhecido;2;0;0;2;3;0;0;3;NA;NA;NA;NA
89;AGES;22/03/2021;2021;12;All;0-17 anos;28;10;0;38;267;190;0;457;0,000153752;0,000108908;NA;NA
90;AGES;22/03/2021;2021;12;All;18-24 anos;3067;115;0;3182;20944;11072;1;32017;0,027000094;0,014273541;NA;NA
91;AGES;22/03/2021;2021;12;All;25-49 anos;40938;1177;0;42115;241723;134059;17;375799;0,07192739;0,039890759;NA;NA
92;AGES;22/03/2021;2021;12;All;50-64 anos;33103;836;0;33939;244942;81913;9;326864;0,113289928;0,037886185;NA;NA
93;AGES;22/03/2021;2021;12;All;65-79 anos;52019;2005;0;54024;149459;43673;6;193138;0,09314635;0,027218037;NA;NA
94;AGES;22/03/2021;2021;12;All;80 ou mais anos;123824;16775;0;140599;539633;223614;10;763257;0,798435482;0,330856993;NA;NA
95;AGES;22/03/2021;2021;12;All;Desconhecido;0;0;0;0;0;0;0;0;NA;NA;NA;NA
96;GENERAL;08/02/2021;2021;6;All;All;39101;98547;13;137661;350499;208969;20;559488;0,03404255;0,020296314;651900;571981
97;GENERAL;15/02/2021;2021;7;All;All;100259;49306;11;149576;450758;258275;31;709064;0,043780301;0,025085206;830730;718143
98;GENERAL;22/02/2021;2021;8;All;All;173978;18763;2;192743;624736;277038;33;901807;0,060678081;0,02690758;1002999;933847
99;GENERAL;01/03/2021;2021;9;All;All;136492;31122;2;167616;761228;308160;35;1069423;0,073934997;0,029930334;1186389;1095103
100;GENERAL;08/03/2021;2021;10;All;All;91048;48926;0;139974;852276;357086;35;1209397;0,082778121;0,034682319;1468929;1264093
101;GENERAL;15/03/2021;2021;11;All;All;79563;109053;8;188624;943655;473277;43;1416975;0,091653394;0,045967481;1713540;1462079
102;GENERAL;22/03/2021;2021;12;All;All;252979;20918;0;273897;1196971;494521;43;1691535;0,116256952;0,048030825;1883850;1753999
