;TYPE;DATE;YEAR;WEEK;REGION;AGEGROUP;TOTAL_VAC_1;TOTAL_VAC_2;TOTAL_VAC_UNK;TOTAL;CUMUL_VAC_1;CUMUL_VAC_2;CUMUL_VAC_UNK;CUMUL;CUMUL_VAC_INIT;CUMUL_VAC_COMPLETE;CUMUL_VAC_LEAST;COVER_1_VAC;COVER;COVER_INIT;COVER_COMPLETE;COVER_LEAST
1;REGIONAL;04/01/21;2021;1;ARS Alentejo;All;3472;1;0;3473;4696;1;0;4697;4695;1;4696;0,010152021;2,16E-06;0,010149859;2,16E-06;0,010152021
2;REGIONAL;11/01/21;2021;2;ARS Alentejo;All;5352;10;0;5362;10048;11;0;10059;10037;11;10048;0,021722212;2,38E-05;0,021698431;2,38E-05;0,021722212
3;REGIONAL;18/01/21;2021;3;ARS Alentejo;All;10429;1133;0;11562;20477;1144;0;21621;19333;1144;20477;0,044268086;0,00247315;0,041794936;0,00247315;0,044268086
4;REGIONAL;25/01/21;2021;4;ARS Alentejo;All;2293;3122;0;5415;22770;4266;0;27036;18504;4266;22770;0,049225195;0,009222428;0,040002767;0,009222428;0,049225195
5;REGIONAL;01/02/21;2021;5;ARS Alentejo;All;1448;4338;0;5786;24218;8604;0;32822;15614;8604;24218;0,052355546;0,018600508;0,033755037;0,018600508;0,052355546
6;REGIONAL;08/02/21;2021;6;ARS Alentejo;All;3334;8777;0;12111;27552;17381;0;44933;10171;17381;27552;0,059563135;0,037575016;0,021988119;0,037575016;0,059563135
7;REGIONAL;15/02/21;2021;7;ARS Alentejo;All;4057;2812;0;6869;31609;20193;0;51802;11416;20193;31609;0,068333737;0,043654122;0,024679615;0,043654122;0,068333737
8;REGIONAL;22/02/21;2021;8;ARS Alentejo;All;12033;1651;0;13684;43642;21844;0;65486;21798;21844;43642;0,094347209;0,047223327;0,047123882;0,047223327;0,094347209
9;REGIONAL;01/03/21;2021;9;ARS Alentejo;All;10455;2831;1;13287;54097;24675;1;78773;29422;24675;54097;0,116949292;0,053343508;0,063605783;0,053343508;0,116949292
10;REGIONAL;08/03/21;2021;10;ARS Alentejo;All;5827;1669;0;7496;59924;26344;1;86269;33580;26344;59924;0,129546359;0,056951627;0,072594732;0,056951627;0,129546359
11;REGIONAL;15/03/21;2021;11;ARS Alentejo;All;3703;7728;0;11431;63627;34072;1;97700;29556;34072;63628;0,137551668;0,073658359;0,063895471;0,073658359;0,13755383
12;REGIONAL;22/03/21;2021;12;ARS Alentejo;All;11905;2107;0;14012;75532;36179;1;111712;39355;36179;75534;0,163288425;0,078213365;0,085079383;0,078213365;0,163292748
13;REGIONAL;29/03/21;2021;13;ARS Alentejo;All;6156;6277;0;12433;81688;42456;1;124145;39234;42456;81690;0,176596738;0,091783262;0,0848178;0,091783262;0,176601062
14;REGIONAL;05/04/21;2021;14;ARS Alentejo;All;14050;4302;0;18352;95738;46758;1;142497;48984;46758;95742;0,206970651;0,101083516;0,105895782;0,101083516;0,206979298
15;REGIONAL;12/04/21;2021;15;ARS Alentejo;All;21906;2964;0;24870;117644;49722;1;167367;67927;49722;117649;0,254328012;0,107491223;0,146847599;0,107491223;0,254338822
16;REGIONAL;19/04/21;2021;16;ARS Alentejo;All;11368;5957;1;17326;129012;55679;2;184693;73338;55679;129017;0,278903858;0,120369329;0,158545338;0,120369329;0,278914668
17;REGIONAL;26/04/21;2021;17;ARS Alentejo;All;20213;2775;0;22988;149225;58454;2;207681;90782;58454;149236;0,322601218;0,126368447;0,19625655;0,126368447;0,322624998
18;REGIONAL;03/05/21;2021;18;ARS Alentejo;All;13669;14310;1;27980;162894;72764;3;235661;93252;72764;166016;0,352151467;0,15730444;0,201596306;0,15730444;0,358900745
19;REGIONAL;10/05/21;2021;19;ARS Alentejo;All;17428;15250;0;32678;180322;88014;3;268339;95936;88014;183950;0,38982809;0,190272565;0,207398696;0,190272565;0,397671261
20;REGIONAL;17/05/21;2021;20;ARS Alentejo;All;13211;12206;1;25418;193533;100220;4;293757;100354;100220;200574;0,418388215;0,216660037;0,216949724;0,216660037;0,433609761
21;REGIONAL;24/05/21;2021;21;ARS Alentejo;All;7184;18506;1;25691;200717;118726;5;319448;91159;118726;209885;0,433918905;0,256667128;0,197071566;0,256667128;0,453738694
22;REGIONAL;31/05/21;2021;22;ARS Alentejo;All;17384;7290;1;24675;218101;126016;6;344123;101594;126016;227610;0,471500406;0,272426973;0,219630411;0,272426973;0,492057384
23;REGIONAL;07/06/21;2021;23;ARS Alentejo;All;13790;15248;0;29038;231891;141264;6;373161;100769;141264;242033;0,501312239;0,305390775;0,21784689;0,305390775;0,523237665
24;REGIONAL;14/06/21;2021;24;ARS Alentejo;All;10208;19217;1;29426;242099;160481;7;402587;93431;160481;253912;0,523380346;0,346934937;0,201983276;0,346934937;0,548918213
25;REGIONAL;21/06/21;2021;25;ARS Alentejo;All;10541;14161;1;24703;252640;174642;8;427290;92573;174642;267215;0,546168347;0,377548814;0,200128414;0,377548814;0,577677228
26;REGIONAL;28/06/21;2021;26;ARS Alentejo;All;10961;28725;3;39689;263601;203367;11;466979;76903;203367;280270;0,569864323;0,439647792;0,166252313;0,439647792;0,605900105
27;REGIONAL;05/07/21;2021;27;ARS Alentejo;All;15329;27775;1;43105;278930;231142;12;510084;65154;231142;296296;0,603003234;0,499693018;0,140852804;0,499693018;0,640545822
28;REGIONAL;12/07/21;2021;28;ARS Alentejo;All;8167;20278;1;28446;287097;251420;13;538530;56520;251420;307940;0,620659017;0,543530897;0,122187441;0,543530897;0,665718338
29;REGIONAL;19/07/21;2021;29;ARS Alentejo;All;3491;16695;2;20188;290588;268115;15;558718;47647;268115;315762;0,628206015;0,579622888;0,103005396;0,579622888;0,682628284
30;REGIONAL;26/07/21;2021;30;ARS Alentejo;All;2231;16461;0;18692;292819;284576;15;577410;38021;284576;322597;0,63302909;0,615209007;0,082195483;0,615209007;0,69740449
31;REGIONAL;02/08/21;2021;31;ARS Alentejo;All;4928;19910;13;24851;297747;304486;28;602261;29101;304486;333587;0,643682659;0,658251327;0,062911831;0,658251327;0,721163159
32;REGIONAL;09/08/21;2021;32;ARS Alentejo;All;14792;14360;0;29152;312539;318846;28;631413;36811;318846;355657;0,67566066;0,689295412;0,079579651;0,689295412;0,768875063
33;REGIONAL;04/01/21;2021;1;ARS Algarve;All;1249;2;0;1251;2306;2;0;2308;2304;2;2306;0,005265201;4,57E-06;0,005260634;4,56652E-06;0,005265201
34;REGIONAL;11/01/21;2021;2;ARS Algarve;All;1354;3;0;1357;3660;5;0;3665;3655;5;3660;0,008356737;1,14E-05;0,00834532;1,14163E-05;0,008356737
35;REGIONAL;18/01/21;2021;3;ARS Algarve;All;3392;945;0;4337;7052;950;0;8002;6102;950;7052;0,016101559;0,002169098;0,013932461;0,002169098;0,016101559
36;REGIONAL;25/01/21;2021;4;ARS Algarve;All;2141;1229;0;3370;9193;2179;0;11372;7014;2179;9193;0,020990022;0,004975227;0,016014796;0,004975227;0,020990022
37;REGIONAL;01/02/21;2021;5;ARS Algarve;All;1213;1242;0;2455;10406;3421;0;13827;6986;3421;10407;0,023759618;0,007811037;0,015950864;0,007811037;0,023761902
38;REGIONAL;08/02/21;2021;6;ARS Algarve;All;2398;2896;0;5294;12804;6317;0;19121;6488;6317;12805;0,029234879;0,014423362;0,0148138;0,014423362;0,029237162
39;REGIONAL;15/02/21;2021;7;ARS Algarve;All;3194;2112;0;5306;15998;8429;0;24427;7570;8429;15999;0,036527616;0,01924561;0,017284289;0,01924561;0,036529899
40;REGIONAL;22/02/21;2021;8;ARS Algarve;All;8503;1065;0;9568;24501;9494;0;33995;15008;9494;24502;0,055942188;0,021677284;0,034267187;0,021677284;0,055944471
41;REGIONAL;01/03/21;2021;9;ARS Algarve;All;4653;561;0;5214;29154;10055;0;39209;19100;10055;29155;0,066566203;0,022958193;0,043610293;0,022958193;0,066568486
42;REGIONAL;08/03/21;2021;10;ARS Algarve;All;5127;1544;0;6671;34281;11599;0;45880;22683;11599;34282;0,078272484;0,026483549;0,051791219;0,026483549;0,078274768
43;REGIONAL;15/03/21;2021;11;ARS Algarve;All;2702;3008;0;5710;36983;14607;0;51590;22377;14607;36984;0,084441857;0,033351599;0,051092541;0,033351599;0,08444414
44;REGIONAL;22/03/21;2021;12;ARS Algarve;All;9426;4305;0;13731;46409;18912;0;65321;27498;18912;46410;0,105963879;0,04318104;0,062785122;0,04318104;0,105966162
45;REGIONAL;29/03/21;2021;13;ARS Algarve;All;4226;2921;0;7147;50635;21833;0;72468;28804;21833;50637;0,115612942;0,049850446;0,065767062;0,049850446;0,115617508
46;REGIONAL;05/04/21;2021;14;ARS Algarve;All;8662;1796;0;10458;59297;23629;0;82926;35673;23629;59302;0,135390552;0,053951184;0,081450784;0,053951184;0,135401968
47;REGIONAL;12/04/21;2021;15;ARS Algarve;All;13665;2161;0;15826;72962;25790;0;98752;47177;25790;72967;0,166591319;0,058885312;0,107717424;0,058885312;0,166602735
48;REGIONAL;19/04/21;2021;16;ARS Algarve;All;7260;5508;0;12768;80222;31298;0;111520;48930;31298;80228;0,183167797;0,071461516;0,111719981;0,071461516;0,183181496
49;REGIONAL;26/04/21;2021;17;ARS Algarve;All;16379;3248;0;19627;96601;34546;0;131147;62065;34546;96611;0,220565336;0,078877549;0,141710619;0,078877549;0,220588168
50;REGIONAL;03/05/21;2021;18;ARS Algarve;All;16559;8938;2;25499;113160;43484;2;156646;70235;43484;113719;0,258373861;0,099285339;0,160364865;0,099285339;0,259650204
51;REGIONAL;10/05/21;2021;19;ARS Algarve;All;9719;11311;0;21030;122879;54795;2;177676;70607;54795;125402;0,280564879;0,125111309;0,161214238;0,125111309;0,286325547
52;REGIONAL;17/05/21;2021;20;ARS Algarve;All;12000;10889;3;22892;134879;65684;5;200568;74243;65684;139927;0,307964016;0,149973742;0,169516177;0,149973742;0,319489919
53;REGIONAL;24/05/21;2021;21;ARS Algarve;All;7602;18791;2;26395;142481;84475;7;226963;68832;84475;153307;0,325321369;0,192878508;0,157161449;0,192878508;0,350039957
54;REGIONAL;31/05/21;2021;22;ARS Algarve;All;8148;12727;1;20876;150629;97202;8;247839;72742;97202;169944;0,343925383;0,221937576;0,166089002;0,221937576;0,388026577
55;REGIONAL;07/06/21;2021;23;ARS Algarve;All;17032;6327;0;23359;167661;103529;8;271198;84798;103529;188327;0,382813891;0,236383771;0,193616001;0,236383771;0,429999772
56;REGIONAL;14/06/21;2021;24;ARS Algarve;All;15337;13408;0;28745;182998;116937;8;299943;86948;116937;203885;0,417832272;0,26699774;0,198525013;0,26699774;0,465522753
57;REGIONAL;21/06/21;2021;25;ARS Algarve;All;19327;10174;2;29503;202325;127111;10;329446;97471;127111;224582;0,461960865;0,290227641;0,222551773;0,290227641;0,512779414
58;REGIONAL;28/06/21;2021;26;ARS Algarve;All;17165;16397;7;33569;219490;143508;17;363015;100693;143508;244201;0,501153047;0,327666279;0,229908441;0,327666279;0,55757472
59;REGIONAL;05/07/21;2021;27;ARS Algarve;All;19167;31652;1;50820;238657;175160;18;413835;89444;175160;264604;0,544916318;0,399936069;0,204224034;0,399936069;0,604160102
60;REGIONAL;12/07/21;2021;28;ARS Algarve;All;9803;26919;4;36726;248460;202079;22;450561;78816;202079;280895;0,56729913;0,461399183;0,179957531;0,461399183;0,641356714
61;REGIONAL;19/07/21;2021;29;ARS Algarve;All;4321;27159;1;31481;252781;229238;23;482042;61740;229238;290978;0,577165103;0,523410279;0,140968559;0,523410279;0,664378839
62;REGIONAL;26/07/21;2021;30;ARS Algarve;All;3955;24669;3;28627;256736;253907;26;510669;45658;253907;299565;0,586195402;0,579736055;0,104249149;0,579736055;0,683985204
63;REGIONAL;02/08/21;2021;31;ARS Algarve;All;3915;22570;1;26486;260651;276477;27;537155;30976;276477;307453;0,59513437;0,631269265;0,070726305;0,631269265;0,70199557
64;REGIONAL;09/08/21;2021;32;ARS Algarve;All;11391;13964;2;25357;272042;290441;29;562512;34019;290441;324460;0,621143001;0,663152727;0,07767427;0,663152727;0,740826997
65;REGIONAL;04/01/21;2021;1;ARS Centro;All;9021;7;0;9028;15639;8;0;15647;15633;8;15641;0,009433126;4,83E-06;0,009429507;4,82544E-06;0,009434332
66;REGIONAL;11/01/21;2021;2;ARS Centro;All;12620;22;1;12643;28259;30;1;28290;28231;30;28261;0,017045252;1,81E-05;0,017028363;1,80954E-05;0,017046459
67;REGIONAL;18/01/21;2021;3;ARS Centro;All;36734;6311;2;43047;64993;6341;3;71337;58654;6341;64995;0,039202452;0,003824762;0,035378896;0,003824762;0,039203658
68;REGIONAL;25/01/21;2021;4;ARS Centro;All;4860;8538;3;13401;69853;14879;6;84738;54976;14879;69855;0,042133905;0,008974709;0,033160402;0,008974709;0,042135111
69;REGIONAL;01/02/21;2021;5;ARS Centro;All;2705;9151;0;11856;72558;24030;6;96594;48530;24030;72560;0,043765505;0,014494406;0,029272306;0,014494406;0,043766712
70;REGIONAL;08/02/21;2021;6;ARS Centro;All;7527;27108;4;34639;80085;51138;10;131233;28949;51138;80087;0,048305638;0,030845398;0,017461446;0,030845398;0,048306845
71;REGIONAL;15/02/21;2021;7;ARS Centro;All;25517;9990;3;35510;105602;61128;13;166743;44476;61128;105604;0,063696972;0,036871163;0,026827016;0,036871163;0,063698179
72;REGIONAL;22/02/21;2021;8;ARS Centro;All;38408;3114;1;41523;144010;64242;14;208266;79770;64242;144012;0,086863894;0,038749464;0,048115637;0,038749464;0,086865101
73;REGIONAL;01/03/21;2021;9;ARS Centro;All;28498;5929;1;34428;172508;70171;15;242694;102347;70171;172518;0,104053307;0,042325716;0,061733623;0,042325716;0,104059338
74;REGIONAL;08/03/21;2021;10;ARS Centro;All;17702;13531;0;31233;190210;83702;15;273927;106529;83702;190231;0,114730792;0,050487339;0,06425612;0,050487339;0,114743459
75;REGIONAL;15/03/21;2021;11;ARS Centro;All;16654;24177;2;40833;206864;107879;17;314760;99014;107879;206893;0,124776145;0,065070412;0,059723225;0,065070412;0,124793637
76;REGIONAL;22/03/21;2021;12;ARS Centro;All;47825;4349;1;52175;254689;112228;18;366935;142497;112228;254725;0,153623209;0,06769364;0,085951284;0,06769364;0,153644924
77;REGIONAL;29/03/21;2021;13;ARS Centro;All;24366;16766;2;41134;279055;128994;20;408069;150109;128994;279103;0,168320284;0,077806549;0,090542687;0,077806549;0,168349236
78;REGIONAL;05/04/21;2021;14;ARS Centro;All;49868;10216;0;60084;328923;139210;20;468153;189773;139210;328983;0,198399644;0,083968632;0,114467202;0,083968632;0,198435835
79;REGIONAL;12/04/21;2021;15;ARS Centro;All;77632;12023;2;89657;406555;151233;22;557810;255385;151233;406618;0,245225683;0,091220661;0,154043022;0,091220661;0,245263683
80;REGIONAL;19/04/21;2021;16;ARS Centro;All;30020;24171;6;54197;436575;175404;28;612007;261236;175404;436640;0,263333134;0,105800115;0,157572226;0,105800115;0,263372341
81;REGIONAL;26/04/21;2021;17;ARS Centro;All;56563;17932;3;74498;493138;193336;31;686505;301143;193336;494479;0,297450782;0,116616331;0,181643315;0,116616331;0,298259646
82;REGIONAL;03/05/21;2021;18;ARS Centro;All;59936;49126;2;109064;553074;242462;33;795569;317795;242462;560257;0,333602955;0,146248132;0,191687461;0,146248132;0,337935594
83;REGIONAL;10/05/21;2021;19;ARS Centro;All;50611;55727;0;106338;603685;298189;33;901907;318708;298189;616897;0,364130477;0,179861522;0,192238164;0,179861522;0,372099686
84;REGIONAL;17/05/21;2021;20;ARS Centro;All;44809;41702;3;86514;648494;339891;36;988421;329568;339891;669459;0,391158352;0,205015318;0,198788695;0,205015318;0,403804012
85;REGIONAL;24/05/21;2021;21;ARS Centro;All;24138;56225;7;80370;672632;396116;43;1068791;305808;396116;701924;0,405717901;0,238929091;0,184457147;0,238929091;0,423386238
86;REGIONAL;31/05/21;2021;22;ARS Centro;All;44210;37708;0;81918;716842;433824;43;1150709;314663;433824;748487;0,432384472;0,261673787;0,189798303;0,261673787;0,45147209
87;REGIONAL;07/06/21;2021;23;ARS Centro;All;58267;40783;1;99051;775109;474607;44;1249760;333910;474607;808517;0,467529937;0,286273261;0,201407701;0,286273261;0,487680961
88;REGIONAL;14/06/21;2021;24;ARS Centro;All;51902;65669;7;117578;827011;540276;51;1367338;326032;540276;866308;0,498836165;0,325883462;0,196655852;0,325883462;0,522539314
89;REGIONAL;21/06/21;2021;25;ARS Centro;All;59475;47637;3;107115;886486;587913;54;1474453;344180;587913;932093;0,534710272;0,354617129;0,207602355;0,354617129;0,562219484
90;REGIONAL;28/06/21;2021;26;ARS Centro;All;49839;77000;2;126841;936325;664913;56;1601294;319230;664913;984143;0,56477214;0,401061958;0,192553024;0,401061958;0,593614982
91;REGIONAL;05/07/21;2021;27;ARS Centro;All;59418;104734;9;164161;995743;769647;65;1765455;281919;769647;1051566;0,600611865;0,46423537;0,17004779;0,46423537;0,63428316
92;REGIONAL;12/07/21;2021;28;ARS Centro;All;28519;81942;7;110468;1024262;851589;72;1875923;242864;851589;1094453;0,617813944;0,513661113;0,146490611;0,513661113;0,660151724
93;REGIONAL;19/07/21;2021;29;ARS Centro;All;16806;80552;15;97373;1041068;932141;87;1973296;194637;932141;1126778;0,627950981;0,562248436;0,117401068;0,562248436;0,679649504
94;REGIONAL;26/07/21;2021;30;ARS Centro;All;14309;68783;4;83096;1055377;1000924;91;2056392;153204;1000924;1154128;0,636581878;0,603736939;0,092409528;0,603736939;0,696146466
95;REGIONAL;02/08/21;2021;31;ARS Centro;All;19182;74878;5;94065;1074559;1075802;96;2150457;116558;1075802;1192360;0,648152069;0,648901821;0,070305408;0,648901821;0,719207229
96;REGIONAL;09/08/21;2021;32;ARS Centro;All;50273;46727;5;97005;1124832;1122529;101;2247462;143457;1122529;1265986;0,678475717;0,677086594;0,086530336;0,677086594;0,763616930
97;REGIONAL;04/01/21;2021;1;ARS Lisboa e Vale do Tejo;All;12707;21;0;12728;23421;22;0;23443;23399;22;23421;0,00635791;5,97E-06;0,006351937;5,97216E-06;0,00635791
98;REGIONAL;11/01/21;2021;2;ARS Lisboa e Vale do Tejo;All;13201;1106;0;14307;36622;1128;0;37750;35494;1128;36622;0,009941478;0,000306209;0,009635269;0,000306209;0,009941478
99;REGIONAL;18/01/21;2021;3;ARS Lisboa e Vale do Tejo;All;37747;9060;0;46807;74369;10188;0;84557;64182;10188;74370;0,020188351;0,002765654;0,017422969;0,002765654;0,020188623
100;REGIONAL;25/01/21;2021;4;ARS Lisboa e Vale do Tejo;All;17255;11889;6;29150;91624;22077;6;113707;69549;22077;91626;0,024872426;0,005993065;0,018879905;0,005993065;0,024872969
101;REGIONAL;01/02/21;2021;5;ARS Lisboa e Vale do Tejo;All;8681;8926;0;17607;100305;31003;6;131314;69306;31003;100309;0,027228987;0,008416134;0,018813939;0,008416134;0,027230073
102;REGIONAL;08/02/21;2021;6;ARS Lisboa e Vale do Tejo;All;14347;30381;0;44728;114652;61384;6;176042;53272;61384;114656;0,031123651;0,016663418;0,014461319;0,016663418;0,031124737
103;REGIONAL;15/02/21;2021;7;ARS Lisboa e Vale do Tejo;All;32972;19053;1;52026;147624;80437;7;228068;67191;80437;147628;0,040074294;0,021835582;0,018239798;0,021835582;0,04007538
104;REGIONAL;22/02/21;2021;8;ARS Lisboa e Vale do Tejo;All;49319;6659;0;55978;196943;87096;7;284046;109851;87096;196947;0,053462524;0,023643247;0,029820363;0,023643247;0,05346361
105;REGIONAL;01/03/21;2021;9;ARS Lisboa e Vale do Tejo;All;45061;12800;1;57862;242004;99896;8;341908;142117;99896;242013;0,065694869;0,027117959;0,038579353;0,027117959;0,065697312
106;REGIONAL;08/03/21;2021;10;ARS Lisboa e Vale do Tejo;All;33730;16550;0;50280;275734;116446;8;392188;159307;116446;275753;0,07485128;0,031610654;0,043245783;0,031610654;0,074856437
107;REGIONAL;15/03/21;2021;11;ARS Lisboa e Vale do Tejo;All;26026;28985;2;55013;301760;145431;10;447201;156354;145431;301785;0,081916347;0,039478978;0,042444156;0,039478978;0,081923134
108;REGIONAL;22/03/21;2021;12;ARS Lisboa e Vale do Tejo;All;89272;7584;2;96858;391032;153015;12;544059;238048;153015;391063;0,106150295;0,041537745;0,064620966;0,041537745;0,106158711
109;REGIONAL;29/03/21;2021;13;ARS Lisboa e Vale do Tejo;All;45545;23844;0;69389;436577;176859;12;613448;259758;176859;436617;0,118514028;0,048010483;0,070514404;0,048010483;0,118524887
110;REGIONAL;05/04/21;2021;14;ARS Lisboa e Vale do Tejo;All;87402;19623;2;107027;523979;196482;14;720475;327586;196482;524068;0,142240343;0,05333738;0,088927123;0,05333738;0,142264503
111;REGIONAL;12/04/21;2021;15;ARS Lisboa e Vale do Tejo;All;163590;14284;2;177876;687569;210766;16;898351;476903;210766;687669;0,186648797;0,057214942;0,129461002;0,057214942;0,186675943
112;REGIONAL;19/04/21;2021;16;ARS Lisboa e Vale do Tejo;All;79212;53650;4;132866;766781;264416;20;1031217;502467;264416;766883;0,208151838;0,071778874;0,136400654;0,071778874;0,208179528
113;REGIONAL;26/04/21;2021;17;ARS Lisboa e Vale do Tejo;All;107593;25551;4;133148;874374;289967;24;1164365;584538;289967;874505;0,23735924;0,078714997;0,158679805;0,078714997;0,237394802
114;REGIONAL;03/05/21;2021;18;ARS Lisboa e Vale do Tejo;All;107767;65357;7;173131;982141;355324;31;1337496;629654;355324;984978;0,266613876;0,096456933;0,17092708;0,096456933;0,267384014
115;REGIONAL;10/05/21;2021;19;ARS Lisboa e Vale do Tejo;All;90415;112989;7;203411;1072556;468313;38;1540907;609660;468313;1077973;0,291158105;0,127129144;0,165499471;0,127129144;0,292628615
116;REGIONAL;17/05/21;2021;20;ARS Lisboa e Vale do Tejo;All;109930;71047;2;180979;1182486;539360;40;1721886;651168;539360;1190528;0,320999914;0,146415698;0,176767312;0,146415698;0,32318301
117;REGIONAL;24/05/21;2021;21;ARS Lisboa e Vale do Tejo;All;110608;88713;11;199332;1293094;628073;51;1921218;686099;628073;1314172;0,351025773;0,170497899;0,186249748;0,170497899;0,356747647
118;REGIONAL;31/05/21;2021;22;ARS Lisboa e Vale do Tejo;All;92083;86634;13;178730;1385177;714707;64;2099948;712294;714707;1427001;0,376022801;0,194015731;0,193360693;0,194015731;0,387376424
119;REGIONAL;07/06/21;2021;23;ARS Lisboa e Vale do Tejo;All;151883;53794;6;205683;1537060;768501;70;2305631;824916;768501;1593417;0,417253251;0,208618753;0,223933277;0,208618753;0,43255203
120;REGIONAL;14/06/21;2021;24;ARS Lisboa e Vale do Tejo;All;147419;121097;6;268522;1684479;889598;76;2574153;860352;889598;1749950;0,457271895;0,241491976;0,233552801;0,241491976;0,475044778
121;REGIONAL;21/06/21;2021;25;ARS Lisboa e Vale do Tejo;All;119805;153404;17;273226;1804284;1043002;93;2847379;841293;1043002;1884295;0,489794389;0,28313532;0,228379009;0,28313532;0,511514329
122;REGIONAL;28/06/21;2021;26;ARS Lisboa e Vale do Tejo;All;130199;166199;11;296409;1934483;1209201;104;3143788;816327;1209201;2025528;0,525138459;0,328252019;0,22160169;0,328252019;0,549853709
123;REGIONAL;05/07/21;2021;27;ARS Lisboa e Vale do Tejo;All;143577;273031;10;416618;2078060;1482232;114;3560406;698426;1482232;2180658;0,564114146;0,402369537;0,189596059;0,402369537;0,591965596
124;REGIONAL;12/07/21;2021;28;ARS Lisboa e Vale do Tejo;All;79728;215157;15;294900;2157788;1697389;129;3855306;601428;1697389;2298817;0,585757262;0,460776468;0,163264796;0,460776468;0,624041264
125;REGIONAL;19/07/21;2021;29;ARS Lisboa e Vale do Tejo;All;56781;185053;12;241846;2214569;1882442;141;4097152;524109;1882442;2406551;0,601171141;0,51101131;0,142275633;0,51101131;0,653286942
126;REGIONAL;26/07/21;2021;30;ARS Lisboa e Vale do Tejo;All;36127;179804;24;215955;2250696;2062246;165;4313107;418266;2062246;2480512;0,610978246;0,559821248;0,113543289;0,559821248;0,673364537
127;REGIONAL;02/08/21;2021;31;ARS Lisboa e Vale do Tejo;All;45237;177582;15;222834;2295933;2239828;180;4535941;329130;2239828;2568958;0,623258368;0,608027997;0,08934626;0,608027997;0,697374257
128;REGIONAL;09/08/21;2021;32;ARS Lisboa e Vale do Tejo;All;106821;110342;3;217166;2402754;2350170;183;4753107;368572;2350170;2718742;0,652256201;0,637981648;0,100053261;0,637981648;0,738034909
129;REGIONAL;04/01/21;2021;1;ARS Norte;All;16650;25;0;16675;29989;28;0;30017;29967;28;29995;0,008423992;7,87E-06;0,008417812;7,86528E-06;0,008425678
130;REGIONAL;11/01/21;2021;2;ARS Norte;All;15354;32;0;15386;45343;60;0;45403;45289;60;45349;0,012736973;1,69E-05;0,012721804;1,68542E-05;0,012738658
131;REGIONAL;18/01/21;2021;3;ARS Norte;All;32429;12738;1;45168;77772;12798;1;90571;64980;12798;77778;0,021846368;0,003594993;0,01825306;0,003594993;0,021848054
132;REGIONAL;25/01/21;2021;4;ARS Norte;All;14382;15715;5;30102;92154;28513;6;120673;63647;28513;92160;0,025886311;0,00800938;0,017878617;0,00800938;0,025887997
133;REGIONAL;01/02/21;2021;5;ARS Norte;All;5649;12282;1;17932;97803;40795;7;138605;57018;40795;97813;0,027473131;0,011459427;0,016016513;0,011459427;0,02747594
134;REGIONAL;08/02/21;2021;6;ARS Norte;All;8921;28942;6;37869;106724;69737;13;176474;36997;69737;106734;0,029979064;0,019589315;0,010392559;0,019589315;0,029981873
135;REGIONAL;15/02/21;2021;7;ARS Norte;All;33028;15201;3;48232;139752;84938;16;224706;54824;84938;139762;0,03925672;0,023859317;0,015400212;0,023859317;0,039259529
136;REGIONAL;22/02/21;2021;8;ARS Norte;All;64833;4345;0;69178;204585;89283;16;293884;115312;89283;204595;0,057468488;0,02507984;0,032391457;0,02507984;0,057471297
137;REGIONAL;01/03/21;2021;9;ARS Norte;All;48050;7103;2;55155;252635;96386;18;349039;156264;96386;252650;0,070965864;0,027075092;0,043894986;0,027075092;0,070970078
138;REGIONAL;08/03/21;2021;10;ARS Norte;All;25695;14172;0;39867;278330;110558;18;388906;167800;110558;278358;0,07818366;0,031056045;0,04713548;0,031056045;0,078191526
139;REGIONAL;15/03/21;2021;11;ARS Norte;All;26900;42366;4;69270;305230;152924;22;458176;152340;152924;305264;0,085739944;0,042956771;0,042792724;0,042956771;0,085749495
140;REGIONAL;22/03/21;2021;12;ARS Norte;All;89073;2378;0;91451;394303;155302;22;549627;239041;155302;394343;0,110760794;0,043624758;0,067147273;0,043624758;0,11077203
141;REGIONAL;29/03/21;2021;13;ARS Norte;All;54147;32703;1;86851;448450;188005;23;636478;260506;188005;448511;0,125970835;0,05281112;0,07317685;0,05281112;0,12598797
142;REGIONAL;05/04/21;2021;14;ARS Norte;All;82477;13672;5;96154;530927;201677;28;732632;329350;201677;531027;0,149138851;0,056651622;0,092515318;0,056651622;0,149166941
143;REGIONAL;12/04/21;2021;15;ARS Norte;All;136031;19181;3;155215;666958;220858;31;887847;446207;220858;667065;0,187350332;0,062039618;0,12534077;0,062039618;0,187380388
144;REGIONAL;19/04/21;2021;16;ARS Norte;All;65232;46466;2;111700;732190;267324;33;999547;464974;267324;732298;0,205674179;0,075092045;0,130612472;0,075092045;0,205704517
145;REGIONAL;26/04/21;2021;17;ARS Norte;All;126821;36748;2;163571;859011;304072;35;1163118;555072;304072;859144;0,241298546;0,085414659;0,155921247;0,085414659;0,241335906
146;REGIONAL;03/05/21;2021;18;ARS Norte;All;155644;73263;4;228911;1014655;377335;39;1392029;637664;377335;1014999;0,285019372;0,105994436;0,179121567;0,105994436;0,285116003
147;REGIONAL;10/05/21;2021;19;ARS Norte;All;99986;101036;9;201031;1114641;478371;48;1593060;643370;478371;1121741;0,313105714;0,134375726;0,180724398;0,134375726;0,315100124
148;REGIONAL;17/05/21;2021;20;ARS Norte;All;110959;71133;5;182097;1225600;549504;53;1775157;690825;549504;1240329;0,344274402;0,154357181;0,194054637;0,154357181;0,348411818
149;REGIONAL;24/05/21;2021;21;ARS Norte;All;73078;129130;12;202220;1298678;678634;65;1977377;654935;678634;1333569;0,364802212;0,190630152;0,183973038;0,190630152;0,37460319
150;REGIONAL;31/05/21;2021;22;ARS Norte;All;54969;172526;33;227528;1353647;851160;98;2204905;561642;851160;1412802;0,380243155;0,239093179;0,157766778;0,239093179;0,396859957
151;REGIONAL;07/06/21;2021;23;ARS Norte;All;106783;106590;11;213384;1460430;957750;109;2418289;569549;957750;1527299;0,410238793;0,269034602;0,159987876;0,269034602;0,429022478
152;REGIONAL;14/06/21;2021;24;ARS Norte;All;105110;152417;12;257539;1565540;1110167;121;2675828;537918;1110167;1648085;0,43976448;0,311848955;0,151102642;0,311848955;0,462951597
153;REGIONAL;21/06/21;2021;25;ARS Norte;All;146254;105354;5;251613;1711794;1215521;126;2927441;595372;1215521;1810893;0,48084763;0,341443183;0,167241628;0,341443183;0,508684811
154;REGIONAL;28/06/21;2021;26;ARS Norte;All;163660;117233;10;280903;1875454;1332754;136;3208344;648224;1332754;1980978;0,526820173;0,374374254;0,1820879;0,374374254;0,556462154
155;REGIONAL;05/07/21;2021;27;ARS Norte;All;176018;157908;15;333941;2051472;1490662;151;3542285;680604;1490662;2171266;0,576264112;0,418731044;0,19118353;0,418731044;0,609914575
156;REGIONAL;12/07/21;2021;28;ARS Norte;All;105274;156798;19;262091;2156746;1647460;170;3804376;678509;1647460;2325969;0,605835867;0,462776033;0,190595039;0,462776033;0,653371072
157;REGIONAL;19/07/21;2021;29;ARS Norte;All;51563;189435;13;241011;2208309;1836895;183;4045387;592400;1836895;2429295;0,620320055;0,515988844;0,166406785;0,515988844;0,682395628
158;REGIONAL;26/07/21;2021;30;ARS Norte;All;35151;185230;17;220398;2243460;2022125;200;4265785;477960;2022125;2500085;0,630194067;0,568020459;0,134260275;0,568020459;0,702280734
159;REGIONAL;02/08/21;2021;31;ARS Norte;All;41589;189700;22;231311;2285049;2211825;222;4497096;368257;2211825;2580082;0,641876531;0,621307709;0,103444401;0,621307709;0,72475211
160;REGIONAL;09/08/21;2021;32;ARS Norte;All;118871;147756;5;266632;2403920;2359581;227;4763728;398745;2359581;2758326;0,675267721;0,662812775;0,112008564;0,662812775;0,774821339
161;REGIONAL;04/01/21;2021;1;Outro;All;0;0;0;0;0;0;0;0;0;0;0;NA;NA;NA;NA;NA
162;REGIONAL;11/01/21;2021;2;Outro;All;0;0;0;0;0;0;0;0;0;0;0;NA;NA;NA;NA;NA
163;REGIONAL;18/01/21;2021;3;Outro;All;0;0;0;0;0;0;0;0;0;0;0;NA;NA;NA;NA;NA
164;REGIONAL;25/01/21;2021;4;Outro;All;0;0;0;0;0;0;0;0;0;0;0;NA;NA;NA;NA;NA
165;REGIONAL;01/02/21;2021;5;Outro;All;0;0;0;0;0;0;0;0;0;0;0;NA;NA;NA;NA;NA
166;REGIONAL;08/02/21;2021;6;Outro;All;0;0;0;0;0;0;0;0;0;0;0;NA;NA;NA;NA;NA
167;REGIONAL;15/02/21;2021;7;Outro;All;0;0;0;0;0;0;0;0;0;0;0;NA;NA;NA;NA;NA
168;REGIONAL;22/02/21;2021;8;Outro;All;0;0;0;0;0;0;0;0;0;0;0;NA;NA;NA;NA;NA
169;REGIONAL;01/03/21;2021;9;Outro;All;0;0;0;0;0;0;0;0;0;0;0;NA;NA;NA;NA;NA
170;REGIONAL;08/03/21;2021;10;Outro;All;0;0;0;0;0;0;0;0;0;0;0;NA;NA;NA;NA;NA
171;REGIONAL;15/03/21;2021;11;Outro;All;0;0;0;0;0;0;0;0;0;0;0;NA;NA;NA;NA;NA
172;REGIONAL;22/03/21;2021;12;Outro;All;0;0;0;0;0;0;0;0;0;0;0;NA;NA;NA;NA;NA
173;REGIONAL;29/03/21;2021;13;Outro;All;0;0;0;0;0;0;0;0;0;0;0;NA;NA;NA;NA;NA
174;REGIONAL;05/04/21;2021;14;Outro;All;0;0;0;0;0;0;0;0;0;0;0;NA;NA;NA;NA;NA
175;REGIONAL;12/04/21;2021;15;Outro;All;0;0;0;0;0;0;0;0;0;0;0;NA;NA;NA;NA;NA
176;REGIONAL;19/04/21;2021;16;Outro;All;0;0;0;0;0;0;0;0;0;0;0;NA;NA;NA;NA;NA
177;REGIONAL;26/04/21;2021;17;Outro;All;0;0;0;0;0;0;0;0;0;0;0;NA;NA;NA;NA;NA
178;REGIONAL;03/05/21;2021;18;Outro;All;0;0;0;0;0;0;0;0;0;0;0;NA;NA;NA;NA;NA
179;REGIONAL;10/05/21;2021;19;Outro;All;0;0;0;0;0;0;0;0;0;0;0;NA;NA;NA;NA;NA
180;REGIONAL;17/05/21;2021;20;Outro;All;0;0;0;0;0;0;0;0;0;0;0;NA;NA;NA;NA;NA
181;REGIONAL;24/05/21;2021;21;Outro;All;0;0;0;0;0;0;0;0;0;0;0;NA;NA;NA;NA;NA
182;REGIONAL;31/05/21;2021;22;Outro;All;0;0;0;0;0;0;0;0;0;0;0;NA;NA;NA;NA;NA
183;REGIONAL;07/06/21;2021;23;Outro;All;0;0;0;0;0;0;0;0;0;0;0;NA;NA;NA;NA;NA
184;REGIONAL;14/06/21;2021;24;Outro;All;0;0;0;0;0;0;0;0;0;0;0;NA;NA;NA;NA;NA
185;REGIONAL;21/06/21;2021;25;Outro;All;0;0;0;0;0;0;0;0;0;0;0;NA;NA;NA;NA;NA
186;REGIONAL;28/06/21;2021;26;Outro;All;0;0;0;0;0;0;0;0;0;0;0;NA;NA;NA;NA;NA
187;REGIONAL;05/07/21;2021;27;Outro;All;0;0;0;0;0;0;0;0;0;0;0;NA;NA;NA;NA;NA
188;REGIONAL;12/07/21;2021;28;Outro;All;0;0;0;0;0;0;0;0;0;0;0;NA;NA;NA;NA;NA
189;REGIONAL;19/07/21;2021;29;Outro;All;0;0;0;0;0;0;0;0;0;0;0;NA;NA;NA;NA;NA
190;REGIONAL;26/07/21;2021;30;Outro;All;0;0;0;0;0;0;0;0;0;0;0;NA;NA;NA;NA;NA
191;REGIONAL;02/08/21;2021;31;Outro;All;0;0;0;0;0;0;0;0;0;0;0;NA;NA;NA;NA;NA
192;REGIONAL;09/08/21;2021;32;Outro;All;0;0;0;0;0;0;0;0;0;0;0;NA;NA;NA;NA;NA
193;REGIONAL;04/01/21;2021;1;RA_Madeira;All;1728;0;0;1728;2368;0;0;2368;2368;0;2368;0,009325662;0;0,009325662;0;0,009325662
194;REGIONAL;11/01/21;2021;2;RA_Madeira;All;1765;0;0;1765;4133;0;0;4133;4133;0;4133;0,016276588;0;0,016276588;0;0,016276588
195;REGIONAL;18/01/21;2021;3;RA_Madeira;All;1082;540;0;1622;5215;540;0;5755;4675;540;5215;0,020537722;0,002126629;0,018411093;0,002126629;0,020537722
196;REGIONAL;25/01/21;2021;4;RA_Madeira;All;416;1632;0;2048;5631;2172;0;7803;3459;2172;5631;0,022176014;0,008553774;0,01362224;0,008553774;0,022176014
197;REGIONAL;01/02/21;2021;5;RA_Madeira;All;2238;1521;0;3759;7869;3693;0;11562;4176;3693;7869;0,030989709;0,014543779;0,01644593;0,014543779;0,030989709
198;REGIONAL;08/02/21;2021;6;RA_Madeira;All;3167;1088;0;4255;11036;4781;0;15817;6255;4781;11036;0,043461994;0,018828543;0,024633452;0,018828543;0,043461994
199;REGIONAL;15/02/21;2021;7;RA_Madeira;All;2506;639;0;3145;13542;5420;0;18962;8122;5420;13542;0,053331128;0,021345053;0,031986075;0,021345053;0,053331128
200;REGIONAL;22/02/21;2021;8;RA_Madeira;All;2265;2158;0;4423;15807;7578;0;23385;8229;7578;15807;0,062251155;0,029843693;0,032407462;0,029843693;0,062251155
201;REGIONAL;01/03/21;2021;9;RA_Madeira;All;1440;3121;0;4561;17247;10699;0;27946;6549;10699;17248;0,067922165;0,04213482;0,025791283;0,04213482;0,067926104
202;REGIONAL;08/03/21;2021;10;RA_Madeira;All;4909;2399;0;7308;22156;13098;0;35254;9059;13098;22157;0,087254798;0,051582566;0,03567617;0,051582566;0,087258736
203;REGIONAL;15/03/21;2021;11;RA_Madeira;All;3127;2354;0;5481;25283;15452;0;40735;9832;15452;25284;0,099569555;0,060853093;0,038720399;0,060853093;0,099573493
204;REGIONAL;22/03/21;2021;12;RA_Madeira;All;5305;186;0;5491;30588;15638;0;46226;14951;15638;30589;0,120461715;0,061585599;0,058880054;0,061585599;0,120465653
205;REGIONAL;29/03/21;2021;13;RA_Madeira;All;1217;1267;0;2484;31805;16905;0;48710;14901;16905;31806;0,125254506;0,0665753;0,058683144;0,0665753;0,125258444
206;REGIONAL;05/04/21;2021;14;RA_Madeira;All;10228;1304;0;11532;42033;18209;0;60242;23825;18209;42034;0,165534434;0,071710715;0,093827656;0,071710715;0,165538372
207;REGIONAL;12/04/21;2021;15;RA_Madeira;All;8446;1309;0;9755;50479;19518;0;69997;30963;19518;50481;0,198796486;0,076865822;0,12193854;0,076865822;0,198804362
208;REGIONAL;19/04/21;2021;16;RA_Madeira;All;9840;2137;0;11977;60319;21655;0;81974;38667;21655;60322;0,237548391;0,085281759;0,152278447;0,085281759;0,237560205
209;REGIONAL;26/04/21;2021;17;RA_Madeira;All;8838;810;0;9648;69157;22465;0;91622;46696;22465;69161;0,272354218;0,088471702;0,183898268;0,088471702;0,27236997
210;REGIONAL;03/05/21;2021;18;RA_Madeira;All;7629;5298;0;12927;76786;27763;0;104549;49028;27763;76791;0,302398759;0,109336295;0,193082155;0,109336295;0,30241845
211;REGIONAL;10/05/21;2021;19;RA_Madeira;All;11620;6447;0;18067;88406;34210;0;122616;54203;34210;88413;0,348160663;0,134725881;0,213462349;0,134725881;0,34818823
212;REGIONAL;17/05/21;2021;20;RA_Madeira;All;2352;7623;0;9975;90758;41833;0;132591;48932;41833;90765;0,357423313;0,164746793;0,192704087;0,164746793;0,357450881
213;REGIONAL;24/05/21;2021;21;RA_Madeira;All;3463;8992;0;12455;94221;50825;0;145046;43405;50825;94230;0,371061306;0,200159103;0,170937646;0,200159103;0,37109675
214;REGIONAL;31/05/21;2021;22;RA_Madeira;All;7581;10944;0;18525;101802;61769;0;163571;40352;61769;102121;0,400916813;0,243258783;0,158914317;0,243258783;0,4021731
215;REGIONAL;07/06/21;2021;23;RA_Madeira;All;3628;15314;0;18942;105430;77083;0;182513;30765;77083;107848;0,415204609;0,303568405;0,121158776;0,303568405;0,424727181
216;REGIONAL;14/06/21;2021;24;RA_Madeira;All;3523;8114;0;11637;108953;85197;0;194150;28694;85197;113891;0,429078894;0,335522973;0,113002761;0,335522973;0,448525734
217;REGIONAL;21/06/21;2021;25;RA_Madeira;All;12578;3704;0;16282;121531;88901;0;210432;37712;88901;126613;0,478613595;0,350110073;0,148517464;0,350110073;0,498627537
218;REGIONAL;28/06/21;2021;26;RA_Madeira;All;10006;12291;0;22297;131537;101192;0;232729;35602;101192;136794;0,518019242;0,39851451;0,140207858;0,39851451;0,538722369
219;REGIONAL;05/07/21;2021;27;RA_Madeira;All;12504;6893;0;19397;144041;108085;0;252126;41595;108085;149680;0,567262517;0,425660535;0,163809501;0,425660535;0,589470036
220;REGIONAL;12/07/21;2021;28;RA_Madeira;All;10390;5564;0;15954;154431;113649;0;268080;47662;113649;161311;0,608180433;0,447572689;0,187702571;0,447572689;0,635275261
221;REGIONAL;19/07/21;2021;29;RA_Madeira;All;4169;14650;0;18819;158600;128299;0;286899;39549;128299;167848;0,624598796;0,505267345;0,155751941;0,505267345;0,661019285
222;REGIONAL;26/07/21;2021;30;RA_Madeira;All;5509;13627;0;19136;164109;141926;0;306035;34665;141926;176591;0,646294349;0,55893322;0,136517763;0,55893322;0,695450983
223;REGIONAL;02/08/21;2021;31;RA_Madeira;All;4369;14138;0;18507;168478;156064;0;324542;26962;156064;183026;0,663500352;0,614611516;0,106181795;0,614611516;0,720793311
224;REGIONAL;09/08/21;2021;32;RA_Madeira;All;5115;10948;0;16063;173593;167012;0;340605;22751;167012;189763;0,683644254;0,657726949;0,089598028;0,657726949;0,747324976
225;REGIONAL;04/01/21;2021;1;RA_Acores;All;3644;2;0;3646;5630;2;0;5632;5628;2;5630;0,023245156;8,26E-06;0,023236898;8,2576E-06;0,023245156
226;REGIONAL;11/01/21;2021;2;RA_Acores;All;1;0;0;1;5631;2;0;5633;5629;2;5631;0,023249285;8,26E-06;0,023241027;8,2576E-06;0,023249285
227;REGIONAL;18/01/21;2021;3;RA_Acores;All;29;1924;7;1960;5660;1926;7;7593;3734;1926;5660;0,02336902;0,007952073;0,015416947;0,007952073;0,02336902
228;REGIONAL;25/01/21;2021;4;RA_Acores;All;280;3500;47;3827;5940;5426;54;11420;514;5426;5940;0,024525085;0,02240288;0,002122204;0,02240288;0,024525085
229;REGIONAL;01/02/21;2021;5;RA_Acores;All;1879;17;0;1896;7819;5443;54;13316;2376;5443;7819;0,032283104;0,02247307;0,009810034;0,02247307;0,032283104
230;REGIONAL;08/02/21;2021;6;RA_Acores;All;1059;3;0;1062;8878;5446;54;14378;3432;5446;8878;0,036655505;0,022485456;0,014170049;0,022485456;0,036655505
231;REGIONAL;15/02/21;2021;7;RA_Acores;All;2079;322;3;2404;10957;5768;57;16782;5189;5768;10957;0,045239285;0,023814931;0,021424354;0,023814931;0,045239285
232;REGIONAL;22/02/21;2021;8;RA_Acores;All;1481;1614;13;3108;12438;7382;70;19890;5056;7382;12438;0,051354041;0,030478817;0,020875223;0,030478817;0,051354041
233;REGIONAL;01/03/21;2021;9;RA_Acores;All;758;1157;8;1923;13196;8539;78;21813;4657;8539;13196;0,054483673;0,035255841;0,019227831;0,035255841;0,054483673
234;REGIONAL;08/03/21;2021;10;RA_Acores;All;2621;2062;9;4692;15817;10601;87;26505;5216;10601;15817;0,065305263;0,043769431;0,021535832;0,043769431;0,065305263
235;REGIONAL;15/03/21;2021;11;RA_Acores;All;2537;1439;8;3984;18354;12040;95;30489;6315;12040;18355;0,075780034;0,049710777;0,026073385;0,049710777;0,075784163
236;REGIONAL;22/03/21;2021;12;RA_Acores;All;4115;738;0;4853;22469;12778;95;35342;9693;12778;22471;0,092770055;0,052757833;0,040020479;0,052757833;0,092778312
237;REGIONAL;29/03/21;2021;13;RA_Acores;All;1953;766;0;2719;24422;13544;95;38061;10881;13544;24425;0,100833605;0,055920496;0,044925496;0,055920496;0,100845992
238;REGIONAL;05/04/21;2021;14;RA_Acores;All;3894;2366;2;6262;28316;15910;97;44323;12414;15910;28324;0,116911161;0,065689242;0,051254949;0,065689242;0,116944191
239;REGIONAL;12/04/21;2021;15;RA_Acores;All;4247;2407;0;6654;32563;18317;97;50977;14254;18317;32571;0,134446183;0,075627268;0,058851945;0,075627268;0,134479214
240;REGIONAL;19/04/21;2021;16;RA_Acores;All;7998;1061;0;9059;40561;19378;97;60036;21191;19378;40569;0,167468342;0,080007927;0,087493446;0,080007927;0,167501373
241;REGIONAL;26/04/21;2021;17;RA_Acores;All;9280;2968;1;12249;49841;22346;98;72285;27506;22346;49852;0,205783626;0,092262212;0,113566831;0,092262212;0,205829043
242;REGIONAL;03/05/21;2021;18;RA_Acores;All;9757;2837;0;12594;59598;25183;98;84879;34429;25183;59612;0,246068348;0,103975624;0,142150528;0,103975624;0,246126151
243;REGIONAL;10/05/21;2021;19;RA_Acores;All;9466;2315;1;11782;69064;27498;99;96661;41581;27498;69079;0,285151589;0,1135338;0,171679721;0,1135338;0,285213521
244;REGIONAL;17/05/21;2021;20;RA_Acores;All;12179;5092;0;17271;81243;32590;99;113932;48672;32590;81262;0,33543627;0,134557661;0,200957056;0,134557661;0,335514717
245;REGIONAL;24/05/21;2021;21;RA_Acores;All;5676;8207;0;13883;86919;40797;99;127815;46141;40797;86938;0,358871351;0,16844274;0,190507058;0,16844274;0,358949798
246;REGIONAL;31/05/21;2021;22;RA_Acores;All;5494;10151;0;15645;92413;50948;99;143460;41487;50948;92435;0,381554989;0,21035421;0,171291613;0,21035421;0,381645823
247;REGIONAL;07/06/21;2021;23;RA_Acores;All;7918;12009;4;19931;100331;62957;103;163391;37397;62957;100354;0,414246845;0,259936994;0,154404813;0,259936994;0,414341807
248;REGIONAL;14/06/21;2021;24;RA_Acores;All;9312;7720;1;17033;109643;70677;104;180424;39465;70677;110142;0,45269425;0,291811347;0,162943175;0,291811347;0,454754522
249;REGIONAL;21/06/21;2021;25;RA_Acores;All;7553;10150;0;17703;117196;80827;104;198127;39687;80827;120514;0,483879092;0,333718688;0,163859769;0,333718688;0,497578458
250;REGIONAL;28/06/21;2021;26;RA_Acores;All;6713;12532;7;19252;123909;93359;111;217379;35417;93359;128776;0,511595741;0,385460836;0,146229784;0,385460836;0,531690621
251;REGIONAL;05/07/21;2021;27;RA_Acores;All;6172;16158;7;22337;130081;109517;118;239716;27168;109517;136685;0,537078707;0,452174021;0,112171296;0,452174021;0,564345316
252;REGIONAL;12/07/21;2021;28;RA_Acores;All;2845;11750;3;14598;132926;121267;121;254314;19889;121267;141156;0,548825149;0,500687446;0,082117745;0,500687446;0,582805191
253;REGIONAL;19/07/21;2021;29;RA_Acores;All;5724;8950;3;14677;138650;130217;124;268991;18451;130217;148668;0,572458413;0,537640224;0,076180528;0,537640224;0,613820752
254;REGIONAL;26/07/21;2021;30;RA_Acores;All;7156;8881;5;16042;145806;139098;129;285033;19472;139098;158570;0,602004121;0,574308116;0,080396035;0,574308116;0,654704151
255;REGIONAL;02/08/21;2021;31;RA_Acores;All;9732;6568;2;16302;155538;145666;131;301335;26292;145666;171958;0,642185623;0,601426088;0,108554465;0,601426088;0,709980553
256;REGIONAL;09/08/21;2021;32;RA_Acores;All;5015;6532;4;11551;160553;152198;135;312886;26354;152198;178552;0,662891565;0,628395424;0,108810451;0,628395424;0,737205874
257;AGES;04/01/21;2021;1;All;0-17 anos;4;0;0;4;6;0;0;6;6;0;6;3,53E-06;0;3,53E-06;0;3,52591E-06
258;AGES;04/01/21;2021;1;All;18-24 anos;1799;2;0;1801;3157;3;0;3160;3154;3;3157;0,004041348;3,84E-06;0,004037508;3,84037E-06;0,004041348
259;AGES;04/01/21;2021;1;All;25-49 anos;27576;42;0;27618;51362;46;0;51408;51322;46;51368;0,015416797;1,38E-05;0,015404791;1,38073E-05;0,015418598
260;AGES;04/01/21;2021;1;All;50-64 anos;12987;7;0;12994;22200;7;0;22207;22195;7;22202;0,010210741;3,22E-06;0,010208442;3,2196E-06;0,010211661
261;AGES;04/01/21;2021;1;All;65-79 anos;2308;1;0;2309;3260;1;0;3261;3259;1;3260;0,002002386;6,14E-07;0,002001771;6,14229E-07;0,002002386
262;AGES;04/01/21;2021;1;All;80 ou mais anos;3796;6;0;3802;4063;6;0;4069;4057;6;4063;0,005961062;8,80E-06;0,005952259;8,80295E-06;0,005961062
263;AGES;04/01/21;2021;1;All;Desconhecido;1;0;0;1;1;0;0;1;1;0;1;NA;NA;NA;NA;NA
264;AGES;11/01/21;2021;2;All;0-17 anos;15;0;0;15;21;0;0;21;21;0;21;1,23E-05;0;1,23E-05;0;1,23407E-05
265;AGES;11/01/21;2021;2;All;18-24 anos;1417;56;0;1473;4574;59;0;4633;4515;59;4574;0,005855282;7,55E-05;0,005779755;7,55273E-05;0,005855282
266;AGES;11/01/21;2021;2;All;25-49 anos;16528;787;0;17315;67890;833;0;68723;67063;833;67896;0,020377835;0,000250033;0,020129603;0,000250033;0,020379636
267;AGES;11/01/21;2021;2;All;50-64 anos;11674;303;0;11977;33874;310;0;34184;33566;310;33876;0,01558012;0,000142582;0,015438457;0,000142582;0,015581039
268;AGES;11/01/21;2021;2;All;65-79 anos;5531;27;0;5558;8791;28;0;8819;8763;28;8791;0,005399685;1,72E-05;0,005382486;1,71984E-05;0,005399685
269;AGES;11/01/21;2021;2;All;80 ou mais anos;14482;0;1;14483;18545;6;1;18552;18539;6;18545;0,027208439;8,80E-06;0,027199636;8,80295E-06;0,027208439
270;AGES;11/01/21;2021;2;All;Desconhecido;0;0;0;0;1;0;0;1;1;0;1;NA;NA;NA;NA;NA
271;AGES;18/01/21;2021;3;All;0-17 anos;69;1;0;70;90;1;0;91;89;1;90;5,29E-05;5,88E-07;5,23E-05;5,87652E-07;5,28887E-05
272;AGES;18/01/21;2021;3;All;18-24 anos;3824;1196;0;5020;8398;1255;0;9653;7143;1255;8398;0,010750472;0,001606554;0,009143918;0,001606554;0,010750472
273;AGES;18/01/21;2021;3;All;25-49 anos;37460;21711;5;59176;105350;22544;5;127899;82813;22544;105357;0,031621813;0,006766798;0,024857117;0,006766798;0,031623914
274;AGES;18/01/21;2021;3;All;50-64 anos;27397;8575;2;35974;61271;8885;2;70158;52388;8885;61273;0,028181186;0,004086596;0,02409551;0,004086596;0,028182106
275;AGES;18/01/21;2021;3;All;65-79 anos;14078;911;1;14990;22869;939;1;23809;21930;939;22869;0,014046797;0,000576761;0,013470036;0,000576761;0,014046797
276;AGES;18/01/21;2021;3;All;80 ou mais anos;39014;257;2;39273;57559;263;3;57825;57296;263;57559;0,084448129;0,000385862;0,084062266;0,000385862;0,084448129
277;AGES;18/01/21;2021;3;All;Desconhecido;0;0;0;0;1;0;0;1;1;0;1;NA;NA;NA;NA;NA
278;AGES;25/01/21;2021;4;All;0-17 anos;14;3;0;17;104;4;0;108;100;4;104;6,11E-05;2,35E-06;5,88E-05;2,35061E-06;6,11158E-05
279;AGES;25/01/21;2021;4;All;18-24 anos;1372;1628;1;3001;9770;2883;1;12654;6888;2883;9771;0,012506801;0,003690594;0,008817486;0,003690594;0,012508081
280;AGES;25/01/21;2021;4;All;25-49 anos;15601;26078;14;41693;120951;48622;19;169592;72336;48622;120958;0,036304603;0,01459436;0,021712344;0,01459436;0,036306704
281;AGES;25/01/21;2021;4;All;50-64 anos;10756;12408;9;23173;72027;21293;11;93331;50736;21293;72029;0,033128337;0,009793573;0,023335684;0,009793573;0,033129256
282;AGES;25/01/21;2021;4;All;65-79 anos;6522;2138;14;8674;29391;3077;15;32483;26314;3077;29391;0,018052797;0,001889982;0,016162815;0,001889982;0,018052797
283;AGES;25/01/21;2021;4;All;80 ou mais anos;7362;3370;23;10755;64921;3633;26;68580;61288;3633;64921;0,095249343;0,005330184;0,08991916;0,005330184;0,095249343
284;AGES;25/01/21;2021;4;All;Desconhecido;0;0;0;0;1;0;0;1;1;0;1;NA;NA;NA;NA;NA
285;AGES;01/02/21;2021;5;All;0-17 anos;35;4;0;39;139;8;0;147;131;8;139;8,17E-05;4,70E-06;7,70E-05;4,70122E-06;8,16836E-05
286;AGES;01/02/21;2021;5;All;18-24 anos;976;940;0;1916;10746;3823;1;14570;6925;3823;10748;0,013756201;0,00489391;0,008864851;0,00489391;0,013758761
287;AGES;01/02/21;2021;5;All;25-49 anos;10006;12519;1;22526;130957;61141;20;192118;69828;61141;130969;0,039308;0,018352058;0,020959544;0,018352058;0,039311602
288;AGES;01/02/21;2021;5;All;50-64 anos;5533;9205;0;14738;77560;30498;11;108069;47065;30498;77563;0,035673203;0,014027351;0,021647232;0,014027351;0,035674583
289;AGES;01/02/21;2021;5;All;65-79 anos;2737;4168;0;6905;32128;7245;15;39388;24883;7245;32128;0,019733941;0,004450087;0,015283854;0,004450087;0,019733941
290;AGES;01/02/21;2021;5;All;80 ou mais anos;4526;10641;0;15167;69447;14274;26;83747;55173;14274;69447;0,101889699;0,020942209;0,08094749;0,020942209;0,101889699
291;AGES;01/02/21;2021;5;All;Desconhecido;0;0;0;0;1;0;0;1;1;0;1;NA;NA;NA;NA;NA
292;AGES;08/02/21;2021;6;All;0-17 anos;37;67;0;104;176;75;0;251;101;75;176;0,000103427;4,41E-05;5,94E-05;4,40739E-05;0,000103427
293;AGES;08/02/21;2021;6;All;18-24 anos;1459;3052;0;4511;12205;6875;1;19081;5332;6875;12207;0,0156239;0,008800845;0,006825615;0,008800845;0,01562646
294;AGES;08/02/21;2021;6;All;25-49 anos;13816;30788;3;44607;144773;91929;23;236725;52856;91929;144785;0,043455005;0,027593371;0,015865236;0,027593371;0,043458607
295;AGES;08/02/21;2021;6;All;50-64 anos;6872;22262;3;29137;84432;52760;14;137206;31675;52760;84435;0,038833933;0,024266609;0,014568704;0,024266609;0,038835313
296;AGES;08/02/21;2021;6;All;65-79 anos;3732;11506;2;15240;35860;18751;17;54628;17109;18751;35860;0,022026242;0,011517403;0,010508839;0,011517403;0,022026242
297;AGES;08/02/21;2021;6;All;80 ou mais anos;14836;31520;2;46358;84283;45794;28;130105;38489;45794;84283;0,12365645;0,067187019;0,056469432;0,067187019;0,12365645
298;AGES;08/02/21;2021;6;All;Desconhecido;1;0;0;1;2;0;0;2;2;0;2;NA;NA;NA;NA;NA
299;AGES;15/02/21;2021;7;All;0-17 anos;32;16;0;48;208;91;0;299;117;91;208;0,000122232;5,35E-05;6,88E-05;5,34763E-05;0,000122232
300;AGES;15/02/21;2021;7;All;18-24 anos;2292;1731;0;4023;14497;8606;1;23104;5893;8606;14499;0,018557942;0,011016738;0,007543764;0,011016738;0,018560502
301;AGES;15/02/21;2021;7;All;25-49 anos;22257;18963;6;41226;167030;110892;29;277951;56150;110892;167042;0,050135657;0,033285298;0,016853961;0,033285298;0,050139259
302;AGES;15/02/21;2021;7;All;50-64 anos;25079;12947;2;38028;109511;65707;16;175234;43807;65707;109514;0,050368852;0,030221495;0,020148736;0,030221495;0,050370231
303;AGES;15/02/21;2021;7;All;65-79 anos;5085;7227;0;12312;40945;25978;17;66940;14967;25978;40945;0,025149595;0,015956434;0,009193161;0,015956434;0,025149595
304;AGES;15/02/21;2021;7;All;80 ou mais anos;48608;9245;2;57855;132891;55039;30;187960;77852;55039;132891;0,194972051;0,080750891;0,114221159;0,080750891;0,194972051
305;AGES;15/02/21;2021;7;All;Desconhecido;0;0;0;0;2;0;0;2;2;0;2;NA;NA;NA;NA;NA
306;AGES;22/02/21;2021;8;All;0-17 anos;23;32;0;55;231;123;0;354;108;123;231;0,000135748;7,23E-05;6,35E-05;7,22812E-05;0,000135748
307;AGES;22/02/21;2021;8;All;18-24 anos;1304;695;1;2000;15801;9301;2;25104;6502;9301;15803;0,020227222;0,011906423;0,008323359;0,011906423;0,020229782
308;AGES;22/02/21;2021;8;All;25-49 anos;11551;7285;5;18841;178581;118177;34;296792;60416;118177;178593;0,053602801;0,03547196;0,018134442;0,03547196;0,053606403
309;AGES;22/02/21;2021;8;All;50-64 anos;49785;4954;2;54741;159296;70661;18;229975;88638;70661;159299;0,073267129;0,032500054;0,040768455;0,032500054;0,073268509
310;AGES;22/02/21;2021;8;All;65-79 anos;11639;2452;2;14093;52584;28430;19;81033;24154;28430;52584;0,032298604;0,017462523;0,014836081;0,017462523;0,032298604
311;AGES;22/02/21;2021;8;All;80 ou mais anos;102540;5188;4;107732;235431;60227;34;295692;175204;60227;235431;0,345414399;0,088362505;0,257051893;0,088362505;0,345414399
312;AGES;22/02/21;2021;8;All;Desconhecido;0;0;0;0;2;0;0;2;2;0;2;NA;NA;NA;NA;NA
313;AGES;01/03/21;2021;9;All;0-17 anos;11;30;0;41;242;153;0;395;89;153;242;0,000142212;8,99E-05;5,23E-05;8,99108E-05;0,000142212
314;AGES;01/03/21;2021;9;All;18-24 anos;910;1029;1;1940;16711;10330;3;27044;6384;10330;16714;0,021392134;0,013223669;0,008172305;0,013223669;0,021395974
315;AGES;01/03/21;2021;9;All;25-49 anos;7505;9958;4;17467;186086;128135;38;314259;57973;128135;186108;0,055855498;0,03846095;0,017401152;0,03846095;0,055862102
316;AGES;01/03/21;2021;9;All;50-64 anos;30100;5964;4;36068;189396;76625;22;266043;112777;76625;189402;0,087111423;0,035243156;0,051871026;0,035243156;0,087114182
317;AGES;01/03/21;2021;9;All;65-79 anos;13215;3778;2;16995;65799;32208;21;98028;33596;32208;65804;0,040415636;0,019783079;0,020635628;0,019783079;0,040418707
318;AGES;01/03/21;2021;9;All;80 ou mais anos;87174;12743;2;99919;322605;72970;36;395611;249635;72970;322605;0,473312402;0,107058496;0,366253906;0,107058496;0,473312402
319;AGES;01/03/21;2021;9;All;Desconhecido;0;0;0;0;2;0;0;2;2;0;2;NA;NA;NA;NA;NA
320;AGES;08/03/21;2021;10;All;0-17 anos;16;25;0;41;258;178;0;436;80;178;258;0,000151614;0,000104602;4,70E-05;0,000104602;0,000151614
321;AGES;08/03/21;2021;10;All;18-24 anos;1340;642;1;1983;18051;10972;4;29027;7085;10972;18057;0,023107498;0,014045508;0,009069671;0,014045508;0,023115179
322;AGES;08/03/21;2021;10;All;25-49 anos;16207;6176;7;22390;202293;134311;45;336649;68017;134311;202328;0,060720185;0,040314735;0,020415955;0,040314735;0,060730691
323;AGES;08/03/21;2021;10;All;50-64 anos;22115;4275;1;26391;211511;80900;23;292434;130625;80900;211525;0,097283069;0,037209414;0,060080095;0,037209414;0,097289508
324;AGES;08/03/21;2021;10;All;65-79 anos;15810;3545;0;19355;81609;35753;21;117383;45871;35753;81624;0,050126593;0,02196052;0,028175286;0,02196052;0,050135806
325;AGES;08/03/21;2021;10;All;80 ou mais anos;40123;37264;0;77387;362728;110234;36;472998;252494;110234;362728;0,532179169;0,161730659;0,37044851;0,161730659;0,532179169
326;AGES;08/03/21;2021;10;All;Desconhecido;0;0;0;0;2;0;0;2;2;0;2;NA;NA;NA;NA;NA
327;AGES;15/03/21;2021;11;All;0-17 anos;4;23;0;27;262;201;0;463;61;201;262;0,000153965;0,000118118;3,58E-05;0,000118118;0,000153965
328;AGES;15/03/21;2021;11;All;18-24 anos;263;388;1;652;18314;11360;5;29679;6961;11360;18321;0,023444171;0,014542196;0,008910935;0,014542196;0,023453132
329;AGES;15/03/21;2021;11;All;25-49 anos;4536;3182;1;7719;206829;137493;46;344368;69378;137493;206871;0,062081709;0,041269843;0,020824472;0,041269843;0,062094316
330;AGES;15/03/21;2021;11;All;50-64 anos;4427;2296;2;6725;215938;83196;25;299159;132765;83196;215961;0,099319238;0,038265443;0,061064373;0,038265443;0,099329817
331;AGES;15/03/21;2021;11;All;65-79 anos;18062;6813;4;24879;99671;42566;25;142262;57125;42566;99691;0,061220792;0,02614526;0,035087816;0,02614526;0,061233076
332;AGES;15/03/21;2021;11;All;80 ou mais anos;54357;97355;8;151720;417085;207589;44;624718;209496;207589;417085;0,611929459;0,304565795;0,307363664;0,304565795;0,611929459
333;AGES;15/03/21;2021;11;All;Desconhecido;0;0;0;0;2;0;0;2;2;0;2;NA;NA;NA;NA;NA
334;AGES;22/03/21;2021;12;All;0-17 anos;29;11;0;40;291;212;0;503;79;212;291;0,000171007;0,000124582;4,64E-05;0,000124582;0,000171007
335;AGES;22/03/21;2021;12;All;18-24 anos;3139;144;0;3283;21453;11504;5;32962;9957;11504;21461;0,027462476;0,014726534;0,012746184;0,014726534;0,027472717
336;AGES;22/03/21;2021;12;All;25-49 anos;42055;1494;1;43550;248884;138987;47;387918;109944;138987;248931;0,074704921;0,041718282;0,033000746;0,041718282;0,074719028
337;AGES;22/03/21;2021;12;All;50-64 anos;34431;951;1;35383;250369;84147;26;334542;166252;84147;250399;0,115155546;0,038702849;0,076466495;0,038702849;0,115169344
338;AGES;22/03/21;2021;12;All;65-79 anos;52734;2164;0;54898;152405;44730;25;197160;107703;44730;152433;0,09361153;0,027474451;0,066154277;0,027474451;0,093628728
339;AGES;22/03/21;2021;12;All;80 ou mais anos;124533;16883;1;141417;541618;224472;45;766135;317146;224472;541618;0,794639006;0,329335818;0,465303188;0,329335818;0,794639006
340;AGES;22/03/21;2021;12;All;Desconhecido;0;0;0;0;2;0;0;2;2;0;2;NA;NA;NA;NA;NA
341;AGES;29/03/21;2021;13;All;0-17 anos;16;14;0;30;307;226;0;533;81;226;307;0,000180409;0,000132809;4,76E-05;0,000132809;0,000180409
342;AGES;29/03/21;2021;13;All;18-24 anos;551;87;0;638;22004;11591;5;33600;10423;11591;22014;0,028167824;0,014837904;0,013342721;0,014837904;0,028180625
343;AGES;29/03/21;2021;13;All;25-49 anos;4465;1008;1;5474;253349;139995;48;393392;113424;139995;253419;0,076045133;0,042020842;0,034045302;0,042020842;0,076066144
344;AGES;29/03/21;2021;13;All;50-64 anos;7672;729;1;8402;258041;84876;27;342944;173206;84876;258082;0,118684231;0,039038148;0,07966494;0,039038148;0,118703089
345;AGES;29/03/21;2021;13;All;65-79 anos;88173;7326;0;95499;240578;52056;25;292659;188557;52056;240613;0,14776992;0,031974291;0,115817127;0,031974291;0,147791418
346;AGES;29/03/21;2021;13;All;80 ou mais anos;36733;75380;1;112114;578351;299852;46;878249;278500;299852;578352;0,848532109;0,439930163;0,408603413;0,439930163;0,848533576
347;AGES;29/03/21;2021;13;All;Desconhecido;0;0;0;0;2;0;0;2;2;0;2;NA;NA;NA;NA;NA
348;AGES;05/04/21;2021;14;All;0-17 anos;28;2;0;30;335;228;0;563;107;228;335;0,000196863;0,000133985;6,29E-05;0,000133985;0,000196863
349;AGES;05/04/21;2021;14;All;18-24 anos;779;152;0;931;22783;11743;5;34531;11062;11743;22805;0,02916504;0,015032483;0,014160719;0,015032483;0,029193203
350;AGES;05/04/21;2021;14;All;25-49 anos;9008;1164;0;10172;262357;141159;48;403564;121322;141159;262481;0,078748971;0,042370228;0,036415962;0,042370228;0,078786191
351;AGES;05/04/21;2021;14;All;50-64 anos;15107;890;0;15997;273148;85766;27;358941;187455;85766;273221;0,125632595;0,039447498;0,086218673;0,039447498;0,12566617
352;AGES;05/04/21;2021;14;All;65-79 anos;201290;5273;2;206565;441868;57329;27;499224;384586;57329;441915;0,271408021;0,035213119;0,236223771;0,035213119;0,27143689
353;AGES;05/04/21;2021;14;All;80 ou mais anos;30369;45798;7;76174;608720;345650;53;954423;263071;345650;608721;0,89308822;0,507123051;0,385966637;0,507123051;0,893089687
354;AGES;05/04/21;2021;14;All;Desconhecido;0;0;0;0;2;0;0;2;2;0;2;NA;NA;NA;NA;NA
355;AGES;12/04/21;2021;15;All;0-17 anos;45;4;0;49;380;232;0;612;148;232;380;0,000223308;0,000136335;8,70E-05;0,000136335;0,000223308
356;AGES;12/04/21;2021;15;All;18-24 anos;4272;91;0;4363;27055;11834;5;38894;15250;11834;27084;0,034633725;0,015148974;0,019521874;0,015148974;0,034670848
357;AGES;12/04/21;2021;15;All;25-49 anos;89005;721;1;89727;351362;141880;49;493291;209613;141880;351493;0,105464676;0,042586643;0,062917353;0,042586643;0,105503996
358;AGES;12/04/21;2021;15;All;50-64 anos;87926;524;0;88450;361074;86290;27;447391;274865;86290;361155;0,16607357;0,039688508;0,126422317;0,039688508;0,166110825
359;AGES;12/04/21;2021;15;All;65-79 anos;233750;3527;2;237279;675618;60856;29;736503;614810;60856;675666;0,414983987;0,037379504;0,377633966;0,037379504;0,41501347
360;AGES;12/04/21;2021;15;All;80 ou mais anos;10519;49462;4;59985;619239;395112;57;1014408;224128;395112;619240;0,908521252;0,579691603;0,328831115;0,579691603;0,908522719
361;AGES;12/04/21;2021;15;All;Desconhecido;0;0;0;0;2;0;0;2;2;0;2;NA;NA;NA;NA;NA
362;AGES;19/04/21;2021;16;All;0-17 anos;33;13;0;46;413;245;0;658;168;245;413;0,0002427;0,000143975;9,87E-05;0,000143975;0,0002427
363;AGES;19/04/21;2021;16;All;18-24 anos;1293;86;0;1379;28348;11920;5;40273;16457;11920;28377;0,036288924;0,015259065;0,021066982;0,015259065;0,036326047
364;AGES;19/04/21;2021;16;All;25-49 anos;10958;771;1;11730;362320;142651;50;505021;219803;142651;362454;0,108753824;0,042818066;0,065975979;0,042818066;0,108794046
365;AGES;19/04/21;2021;16;All;50-64 anos;14374;1733;2;16109;375448;88023;29;463500;287508;88023;375531;0,172684795;0,04048559;0,13223738;0,04048559;0,17272297
366;AGES;19/04/21;2021;16;All;65-79 anos;175849;13177;2;189028;851467;74033;31;925531;777484;74033;851517;0,522995495;0,045473196;0,477553011;0,045473196;0,523026207
367;AGES;19/04/21;2021;16;All;80 ou mais anos;8423;123170;8;131601;627662;518282;65;1146009;109381;518282;627663;0,920879121;0,760401414;0,160479174;0,760401414;0,920880588
368;AGES;19/04/21;2021;16;All;Desconhecido;0;0;0;0;2;0;0;2;2;0;2;NA;NA;NA;NA;NA
369;AGES;26/04/21;2021;17;All;0-17 anos;49;27;0;76;462;272;0;734;190;272;462;0,000271495;0,000159841;0,000111654;0,000159841;0,000271495
370;AGES;26/04/21;2021;17;All;18-24 anos;2608;159;1;2768;30956;12079;6;43041;18928;12079;31007;0,039627484;0,015462604;0,024230166;0,015462604;0,039692771
371;AGES;26/04/21;2021;17;All;25-49 anos;10818;870;3;11691;373138;143521;53;516712;229799;143521;373320;0,112000951;0,043079205;0,068976375;0,043079205;0,11205558
372;AGES;26/04/21;2021;17;All;50-64 anos;32857;2900;1;35758;408305;90923;30;499258;317728;90923;408651;0,187797152;0,041819425;0,146136867;0,041819425;0,187956293
373;AGES;26/04/21;2021;17;All;65-79 anos;293210;46309;3;339522;1144677;120342;34;1265053;1025385;120342;1145727;0,703093502;0,073917514;0,629820928;0,073917514;0,703738442
374;AGES;26/04/21;2021;17;All;80 ou mais anos;6144;39767;2;45913;633806;558049;67;1191922;75769;558049;633818;0,929893338;0,818745874;0,11116507;0,818745874;0,929910944
375;AGES;26/04/21;2021;17;All;Desconhecido;1;0;0;1;3;0;0;3;3;0;3;NA;NA;NA;NA;NA
376;AGES;03/05/21;2021;18;All;0-17 anos;105;15;1;121;567;287;1;855;280;287;567;0,000333199;0,000168656;0,000164543;0,000168656;0,000333199
377;AGES;03/05/21;2021;18;All;18-24 anos;1802;790;2;2594;32758;12869;8;45635;19967;12869;32836;0,041934266;0,016473901;0,025560214;0,016473901;0,042034115
378;AGES;03/05/21;2021;18;All;25-49 anos;10106;7930;2;18038;383244;151451;55;534750;232045;151451;383496;0,115034364;0,045459471;0,069650533;0,045459471;0,115110004
379;AGES;03/05/21;2021;18;All;50-64 anos;151425;14605;3;166033;559730;105528;33;665291;460201;105528;565729;0,257444067;0,048536897;0,21166637;0,048536897;0,260203267
380;AGES;03/05/21;2021;18;All;65-79 anos;202419;164012;4;366435;1347096;284354;38;1631488;1070317;284354;1354671;0,827425067;0,174658397;0,657419453;0,174658397;0,83207785
381;AGES;03/05/21;2021;18;All;80 ou mais anos;5103;31777;4;36884;638909;589826;71;1228806;49243;589826;639069;0,937380243;0,865367743;0,072247245;0,865367743;0,937614988
382;AGES;03/05/21;2021;18;All;Desconhecido;1;0;0;1;4;0;0;4;4;0;4;NA;NA;NA;NA;NA
383;AGES;10/05/21;2021;19;All;0-17 anos;160;43;0;203;727;330;1;1058;397;330;727;0,000427223;0,000193925;0,000233298;0,000193925;0,000427223
384;AGES;10/05/21;2021;19;All;18-24 anos;2210;5361;0;7571;34968;18230;8;53206;16831;18230;35061;0,044763337;0,02333664;0,021545748;0,02333664;0,044882389
385;AGES;10/05/21;2021;19;All;25-49 anos;24922;100038;3;124963;408166;251489;58;659713;157020;251489;408509;0,122514941;0,075486836;0,04713106;0,075486836;0,122617896
386;AGES;10/05/21;2021;19;All;50-64 anos;166611;109536;7;276154;726341;215064;40;941445;526986;215064;742050;0,334075682;0,098917247;0,242383684;0,098917247;0,341300931
387;AGES;10/05/21;2021;19;All;65-79 anos;91562;80123;5;171690;1438658;364477;43;1803178;1089577;364477;1454054;0,883665078;0,223872245;0,669249498;0,223872245;0,893121744
388;AGES;10/05/21;2021;19;All;80 ou mais anos;3780;9973;2;13755;642689;599799;73;1242561;43251;599799;643050;0,942926099;0,879999707;0,063456037;0,879999707;0,943455743
389;AGES;10/05/21;2021;19;All;Desconhecido;0;1;0;1;4;1;0;5;3;1;4;NA;NA;NA;NA;NA
390;AGES;17/05/21;2021;20;All;0-17 anos;312;25;0;337;1039;355;1;1395;684;355;1039;0,000610571;0,000208617;0,000401954;0,000208617;0,000610571
391;AGES;17/05/21;2021;20;All;18-24 anos;2054;2402;1;4457;37022;20632;9;57663;16486;20632;37118;0,04739271;0,026411496;0,021104106;0,026411496;0,047515601
392;AGES;17/05/21;2021;20;All;25-49 anos;32334;21786;2;54122;440500;273275;60;713835;167687;273275;440962;0,132220302;0,082026113;0,050332862;0,082026113;0,132358975
393;AGES;17/05/21;2021;20;All;50-64 anos;224696;75548;3;300247;951037;290612;43;1241692;694350;290612;984962;0,437423103;0,133665044;0,319361635;0,133665044;0,45302668
394;AGES;17/05/21;2021;20;All;65-79 anos;41297;111570;7;152874;1479955;476047;50;1956052;1024480;476047;1500527;0,909030882;0,292401745;0,629265051;0,292401745;0,921666796
395;AGES;17/05/21;2021;20;All;80 ou mais anos;4747;8361;1;13109;647436;608160;74;1255670;40072;608160;648232;0,949890697;0,892266612;0,058791942;0,892266612;0,951058554
396;AGES;17/05/21;2021;20;All;Desconhecido;0;0;0;0;4;1;0;5;3;1;4;NA;NA;NA;NA;NA
397;AGES;24/05/21;2021;21;All;0-17 anos;292;39;0;331;1331;394;1;1726;937;394;1331;0,000782165;0,000231535;0,00055063;0,000231535;0,000782165
398;AGES;24/05/21;2021;21;All;18-24 anos;2212;3211;0;5423;39234;23843;9;63086;15506;23843;39349;0,050224342;0,03052197;0,019849586;0,03052197;0,050371556
399;AGES;24/05/21;2021;21;All;25-49 anos;26022;18206;7;44235;466522;291481;67;758070;175757;291481;467238;0,140031055;0,087490819;0,05275515;0,087490819;0,140245969
400;AGES;24/05/21;2021;21;All;50-64 anos;175165;98314;11;273490;1126202;388926;54;1515182;815262;388926;1204188;0,517989073;0,178883911;0,374974301;0,178883911;0,553858211
401;AGES;24/05/21;2021;21;All;65-79 anos;23611;202448;15;226074;1503566;678495;65;2182126;850266;678495;1528761;0,923533437;0,416751123;0,522257807;0,416751123;0,93900893
402;AGES;24/05/21;2021;21;All;80 ou mais anos;4447;6345;0;10792;651883;614505;74;1266462;38649;614505;653154;0,956415147;0,901575727;0,056704177;0,901575727;0,958279904
403;AGES;24/05/21;2021;21;All;Desconhecido;0;1;0;1;4;2;0;6;2;2;4;NA;NA;NA;NA;NA
404;AGES;31/05/21;2021;22;All;0-17 anos;267;110;0;377;1598;504;1;2103;1094;504;1598;0,000939068;0,000296177;0,000642891;0,000296177;0,000939068
405;AGES;31/05/21;2021;22;All;18-24 anos;2256;2568;1;4825;41490;26411;10;67911;15201;26411;41612;0,053112299;0,033809326;0,019459148;0,033809326;0,053268474
406;AGES;31/05/21;2021;22;All;25-49 anos;42123;23471;15;65609;508645;314952;82;823679;194767;314952;509719;0,152674677;0,094535865;0,058461184;0,094535865;0,152997049
407;AGES;31/05/21;2021;22;All;50-64 anos;163562;168461;6;332029;1289764;557387;60;1847211;860226;557387;1417613;0,59321832;0,25636642;0,395655192;0,25636642;0,652021612
408;AGES;31/05/21;2021;22;All;65-79 anos;18614;137327;23;155964;1522180;815822;88;2338090;737232;815822;1553054;0,93496669;0,501101312;0,452829076;0,501101312;0,953930388
409;AGES;31/05/21;2021;22;All;80 ou mais anos;3047;6043;3;9093;654930;620548;77;1275555;36252;620548;656800;0,960885576;0,910441761;0,0531874;0,910441761;0,963629161
410;AGES;31/05/21;2021;22;All;Desconhecido;0;0;0;0;4;2;0;6;2;2;4;NA;NA;NA;NA;NA
411;AGES;07/06/21;2021;23;All;0-17 anos;387;161;0;548;1985;665;1;2651;1321;665;1986;0,001166489;0,000390789;0,000776288;0,000390789;0,001167077
412;AGES;07/06/21;2021;23;All;18-24 anos;2759;2840;0;5599;44249;29251;10;73510;15144;29251;44395;0,056644158;0,037444875;0,019386181;0,037444875;0,056831056
413;AGES;07/06/21;2021;23;All;25-49 anos;127682;31758;5;159445;636327;346710;87;983124;292750;346710;639460;0,190999655;0,104068333;0,087871721;0,104068333;0,191940055
414;AGES;07/06/21;2021;23;All;50-64 anos;209668;138968;9;348645;1499432;696355;69;2195856;954444;696355;1650799;0,689653713;0,320283822;0,43899013;0,320283822;0,759273952
415;AGES;07/06/21;2021;23;All;65-79 anos;16054;71526;7;87587;1538234;887348;95;2425677;683874;887348;1571222;0,944827518;0,545034636;0,420055059;0,545034636;0,965089696
416;AGES;07/06/21;2021;23;All;80 ou mais anos;2750;4812;1;7563;657680;625360;78;1283118;34568;625360;659928;0,96492026;0,917501724;0,050716707;0,917501724;0,96821843
417;AGES;07/06/21;2021;23;All;Desconhecido;0;0;0;0;4;2;0;6;2;2;4;NA;NA;NA;NA;NA
418;AGES;07/06/21;2021;23;All;NA;1;0;0;1;1;0;0;1;1;0;1;NA;NA;NA;NA;NA
419;AGES;14/06/21;2021;24;All;0-17 anos;566;327;0;893;2551;992;1;3544;1561;992;2553;0,001499101;0,000582951;0,000917325;0,000582951;0,001500276
420;AGES;14/06/21;2021;24;All;18-24 anos;2861;4455;0;7316;47110;33706;10;80826;13818;33706;47524;0,060306589;0,043147822;0,017688738;0,043147822;0,06083656
421;AGES;14/06/21;2021;24;All;25-49 anos;239739;84954;7;324700;876066;431664;94;1307824;464710;431664;896374;0,262959616;0,129568091;0,139487165;0,129568091;0,269055257
422;AGES;14/06/21;2021;24;All;50-64 anos;86145;230695;15;316855;1585577;927050;84;2512711;826386;927050;1753436;0,729275529;0,426390443;0,38009071;0,426390443;0,806481153
423;AGES;14/06/21;2021;24;All;65-79 anos;10877;62445;5;73327;1549111;949793;100;2499004;633665;949793;1583458;0,951508484;0,583390149;0,389215249;0,583390149;0,972605399
424;AGES;14/06/21;2021;24;All;80 ou mais anos;2623;4766;0;7389;660303;630126;78;1290507;32697;630126;662823;0,968768615;0,924494197;0,047971655;0,924494197;0,972465852
425;AGES;14/06/21;2021;24;All;Desconhecido;0;0;0;0;4;2;0;6;2;2;4;NA;NA;NA;NA;NA
426;AGES;14/06/21;2021;24;All;NA;0;0;0;0;1;0;0;1;1;0;1;NA;NA;NA;NA;NA
427;AGES;21/06/21;2021;25;All;0-17 anos;395;286;1;682;2946;1278;2;4226;1677;1278;2955;0,001731223;0,000751019;0,000985493;0,000751019;0,001736512
428;AGES;21/06/21;2021;25;All;18-24 anos;2598;2925;0;5523;49708;36631;10;86349;13994;36631;50625;0,063632349;0,046892182;0,01791404;0,046892182;0,064806221
429;AGES;21/06/21;2021;25;All;25-49 anos;272398;56049;2;328449;1148464;487713;96;1636273;706623;487713;1194336;0,344722489;0,146391736;0,212099673;0,146391736;0,35849141
430;AGES;21/06/21;2021;25;All;50-64 anos;86443;183552;16;270011;1672020;1110602;100;2782722;745346;1110602;1855948;0,769034409;0,510813957;0,342816904;0,510813957;0,853630861
431;AGES;21/06/21;2021;25;All;65-79 anos;10298;96999;7;107304;1559409;1046792;107;2606308;548875;1046792;1595667;0,957833812;0,642969722;0,337134795;0,642969722;0,980104517
432;AGES;21/06/21;2021;25;All;80 ou mais anos;3401;4773;2;8176;663704;634899;80;1298683;31770;634899;666669;0,973758418;0,931496941;0,046611599;0,931496941;0,97810854
433;AGES;21/06/21;2021;25;All;Desconhecido;0;0;0;0;4;2;0;6;2;2;4;NA;NA;NA;NA;NA
434;AGES;21/06/21;2021;25;All;NA;0;0;0;0;1;0;0;1;1;0;1;NA;NA;NA;NA;NA
435;AGES;28/06/21;2021;26;All;0-17 anos;189;269;0;458;3135;1547;2;4684;1597;1547;3144;0,001842289;0,000909098;0,00093848;0,000909098;0,001847578
436;AGES;28/06/21;2021;26;All;18-24 anos;1923;3013;1;4937;51631;39644;11;91286;13385;39644;53029;0,066094025;0,050749192;0,017134445;0,050749192;0,067883637
437;AGES;28/06/21;2021;26;All;25-49 anos;314811;61150;16;375977;1463275;548863;112;2012250;976994;548863;1525857;0,439216031;0,164746496;0,293254123;0,164746496;0,458000619
438;AGES;28/06/21;2021;26;All;50-64 anos;59290;178539;11;237840;1731310;1289141;111;3020562;633049;1289141;1922190;0,796304448;0,592931775;0,291166651;0,592931775;0,884098426
439;AGES;28/06/21;2021;26;All;65-79 anos;9064;182005;11;191080;1568473;1228797;118;2797388;377314;1228797;1606111;0,963401181;0,754762422;0,2317571;0,754762422;0,986519522
440;AGES;28/06/21;2021;26;All;80 ou mais anos;3265;5401;1;8667;666969;640300;81;1307350;30053;640300;670353;0,978548688;0,93942106;0,04409249;0,93942106;0,983513549
441;AGES;28/06/21;2021;26;All;Desconhecido;1;0;0;1;5;2;0;7;3;2;5;NA;NA;NA;NA;NA
442;AGES;28/06/21;2021;26;All;NA;0;0;0;0;1;0;0;1;1;0;1;NA;NA;NA;NA;NA
443;AGES;05/07/21;2021;27;All;0-17 anos;408;655;0;1063;3543;2202;2;5747;1350;2202;3552;0,002082052;0,00129401;0,00079333;0,00129401;0,00208734
444;AGES;05/07/21;2021;27;All;18-24 anos;11662;4869;1;16532;63293;44513;12;107818;21647;44513;66160;0,081022818;0,05698211;0,02771082;0,05698211;0,084692931
445;AGES;05/07/21;2021;27;All;25-49 anos;367935;146290;6;514231;1831210;695153;118;2526481;1226663;695153;1921816;0,549655252;0,208656843;0,368194669;0,208656843;0,576851512
446;AGES;05/07/21;2021;27;All;50-64 anos;41338;257488;19;298845;1772648;1546629;130;3319407;423865;1546629;1970494;0,815317584;0,711361658;0,19495387;0,711361658;0,906315528
447;AGES;05/07/21;2021;27;All;65-79 anos;8165;203620;15;211800;1576638;1432417;133;3009188;182951;1432417;1615368;0,968416359;0,879831677;0,112373761;0,879831677;0,992205437
448;AGES;05/07/21;2021;27;All;80 ou mais anos;2677;5228;2;7907;669646;645528;83;1315257;27831;645528;673359;0,982476269;0,94709136;0,040832465;0,94709136;0,987923825
449;AGES;05/07/21;2021;27;All;Desconhecido;0;1;0;1;5;3;0;8;2;3;5;NA;NA;NA;NA;NA
450;AGES;05/07/21;2021;27;All;NA;0;0;0;0;1;0;0;1;1;0;1;NA;NA;NA;NA;NA
451;AGES;12/07/21;2021;28;All;0-17 anos;240;304;0;544;3783;2506;2;6291;1301;2506;3807;0,002223088;0,001472656;0,000764535;0,001472656;0,002237192
452;AGES;12/07/21;2021;28;All;18-24 anos;13991;7693;1;21685;77284;52206;13;129503;34026;52206;86232;0,098933018;0,066830096;0,043557462;0,066830096;0,110387557
453;AGES;12/07/21;2021;28;All;25-49 anos;207523;315126;30;522679;2038733;1010279;148;3049160;1214163;1010279;2224442;0,611945271;0,303244935;0,364442674;0,303244935;0,66768761
454;AGES;12/07/21;2021;28;All;50-64 anos;15377;134117;11;149505;1788025;1680746;141;3468912;316222;1680746;1996968;0,822390132;0,773047874;0,145444193;0,773047874;0,918492067
455;AGES;12/07/21;2021;28;All;65-79 anos;5485;57636;5;63126;1582123;1490053;138;3072314;133068;1490053;1623121;0,971785403;0,915233364;0,081734189;0,915233364;0,996967553
456;AGES;12/07/21;2021;28;All;80 ou mais anos;2110;3530;2;5642;671756;649058;85;1320899;26907;649058;675965;0,985571971;0,952270427;0,039476812;0,952270427;0,991747238
457;AGES;12/07/21;2021;28;All;Desconhecido;0;2;0;2;5;5;0;10;0;5;5;NA;NA;NA;NA;NA
458;AGES;12/07/21;2021;28;All;NA;0;0;0;0;1;0;0;1;1;0;1;NA;NA;NA;NA;NA
459;AGES;19/07/21;2021;29;All;0-17 anos;232;246;0;478;4015;2752;2;6769;1298;2752;4050;0,002359423;0,001617219;0,000762772;0,001617219;0,002379991
460;AGES;19/07/21;2021;29;All;18-24 anos;19299;19448;0;38747;96583;71654;13;168250;51098;71654;122752;0,123638109;0,091725926;0,06541172;0,091725926;0,157137645
461;AGES;19/07/21;2021;29;All;25-49 anos;103082;342466;20;445568;2141815;1352745;168;3494728;1068267;1352745;2421012;0,642886323;0,406039391;0,32065059;0,406039391;0,726689981
462;AGES;19/07/21;2021;29;All;50-64 anos;10897;114756;18;125671;1798922;1795502;159;3594583;230807;1795502;2026309;0,827402134;0,825829128;0,106158135;0,825829128;0,931987263
463;AGES;19/07/21;2021;29;All;65-79 anos;7147;42499;7;49653;1589270;1532552;145;3121967;100441;1532552;1632993;0,976175296;0,941337471;0,061693748;0,941337471;1,003031219
464;AGES;19/07/21;2021;29;All;80 ou mais anos;2198;3079;1;5278;673954;652137;86;1326177;26621;652137;678758;0,988796784;0,956787805;0,039057204;0,956787805;0,995845009
465;AGES;19/07/21;2021;29;All;Desconhecido;0;0;0;0;5;5;0;10;0;5;5;NA;NA;NA;NA;NA
466;AGES;19/07/21;2021;29;All;NA;0;0;0;0;1;0;0;1;1;0;1;NA;NA;NA;NA;NA
467;AGES;26/07/21;2021;30;All;0-17 anos;1602;370;0;1972;5617;3122;2;8741;2539;3122;5661;0,003300842;0,00183465;0,001492049;0,00183465;0,0033266987
468;AGES;26/07/21;2021;30;All;18-24 anos;20786;22365;5;43156;117369;94019;18;211406;68868;94019;162887;0,150246744;0,120355874;0,088159503;0,120355874;0,2085153775
469;AGES;26/07/21;2021;30;All;25-49 anos;61056;352441;27;413524;2202871;1705186;195;3908252;839874;1705186;2545060;0,661212867;0,511827939;0,25209624;0,511827939;0,7639241785
470;AGES;26/07/21;2021;30;All;50-64 anos;9799;87086;16;96901;1808721;1882588;175;3691484;170188;1882588;2052776;0,831909119;0,865883751;0,078276832;0,865883751;0,9441605828
471;AGES;26/07/21;2021;30;All;65-79 anos;8612;32316;5;40933;1597882;1564868;150;3162900;78946;1564868;1643814;0,981465034;0,961186886;0,048490901;0,961186886;1,0000000000
472;AGES;26/07/21;2021;30;All;80 ou mais anos;2583;2875;0;5458;676537;655012;86;1331635;26831;655012;681843;0,992586452;0,961005883;0,039365308;0,961005883;1,0000000000
473;AGES;26/07/21;2021;30;All;Desconhecido;0;2;0;2;5;7;0;12;-1;7;6;NA;NA;NA;NA;NA
474;AGES;26/07/21;2021;30;All;NA;0;0;0;0;1;0;0;1;1;0;1;NA;NA;NA;NA;NA
475;AGES;02/08/21;2021;31;All;0-17 anos;4574;198;0;4772;10191;3320;2;13513;6946;3320;10266;0,005988763;0,001951005;0,004081832;0,001951005;0,0060328368
476;AGES;02/08/21;2021;31;All;18-24 anos;53550;56119;3;109672;170919;150138;21;321078;114152;150138;264290;0,218797325;0,192195091;0,146128588;0,192195091;0,3383236791
477;AGES;02/08/21;2021;31;All;25-49 anos;52245;381489;37;433771;2255116;2086675;232;4342023;562340;2086675;2649015;0,676894705;0,626335523;0,168791747;0,626335523;0,7951272692
478;AGES;02/08/21;2021;31;All;50-64 anos;8556;53742;14;62312;1817277;1936330;189;3753796;139570;1936330;2075900;0,835844394;0,890602024;0,064194287;0,890602024;0,9547963118
479;AGES;02/08/21;2021;31;All;65-79 anos;7575;11679;3;19257;1605457;1576547;153;3182157;76644;1576547;1653191;0,986117816;0,968360464;0,047076947;0,968360464;1,0000000000
480;AGES;02/08/21;2021;31;All;80 ou mais anos;2452;2119;1;4572;678989;657131;87;1336207;27624;657131;684755;0,996183923;0,96411479;0,040528764;0,96411479;1,0000000000
481;AGES;02/08/21;2021;31;All;Desconhecido;0;0;0;0;5;7;0;12;-1;7;6;NA;NA;NA;NA;NA
482;AGES;02/08/21;2021;31;All;NA;0;0;0;0;1;0;0;1;1;0;1;NA;NA;NA;NA;NA
483;AGES;09/08/21;2021;32;All;0-17 anos;141897;460;0;142357;152088;3780;2;155870;148512;3780;152292;0,089374838;0,002221325;0,087273394;0,002221325;0,0894947191
484;AGES;09/08/21;2021;32;All;18-24 anos;86984;82153;3;169140;257903;232291;24;490218;188845;232291;421136;0,330147534;0,297361027;0,241744808;0,297361027;0,5391058342
485;AGES;09/08/21;2021;32;All;25-49 anos;69937;235892;12;305841;2325053;2322567;244;4647864;455244;2322567;2777811;0,697886967;0,69714077;0,136645855;0,69714077;0,8337866243
486;AGES;09/08/21;2021;32;All;50-64 anos;7318;24152;1;31471;1824595;1960482;190;3785267;133785;1960482;2094267;0,839210259;0,901710575;0,061533515;0,901710575;0,9632440905
487;AGES;09/08/21;2021;32;All;65-79 anos;4572;6248;2;10822;1610029;1582795;155;3192979;76422;1582795;1659217;0,98892607;0,972198165;0,046940588;0,972198165;1,0000000000
488;AGES;09/08/21;2021;32;All;80 ou mais anos;1570;1723;1;3294;680559;658854;88;1339501;27901;658854;686755;0,99848736;0,966642703;0,040935166;0,966642703;1,0000000000
489;AGES;09/08/21;2021;32;All;Desconhecido;0;1;0;1;5;8;0;13;-1;8;7;NA;NA;NA;NA;NA
490;AGES;09/08/21;2021;32;All;NA;0;0;0;0;1;0;0;1;1;0;1;NA;NA;NA;NA;NA
491;GENERAL;04/01/21;2021;1;All;All;48471;58;0;48529;84049;63;0;84112;83994;63;84057;0,008161482;6,12E-06;0,008156141;6,11754E-06;0,008162259
492;GENERAL;11/01/21;2021;2;All;All;49647;1173;1;50821;133696;1236;1;134933;132468;1236;133704;0,012982397;0,00012002;0,012863154;0,00012002;0,012983174
493;GENERAL;18/01/21;2021;3;All;All;121842;32651;10;154503;255538;33887;11;289436;221660;33887;255547;0,024813726;0,003290558;0,021524041;0,003290558;0,0248146
494;GENERAL;25/01/21;2021;4;All;All;41627;45625;61;87313;297165;79512;72;376749;217663;79512;297175;0,028855868;0,007720922;0,021135917;0,007720922;0,028856839
495;GENERAL;01/02/21;2021;5;All;All;23813;37477;1;61291;320978;116989;73;438040;204006;116989;320995;0,031168202;0,011360083;0,01980977;0,011360083;0,031169853
496;GENERAL;08/02/21;2021;6;All;All;40753;99195;10;139958;361731;216184;83;577998;145564;216184;361748;0,035125476;0,0209923;0,014134826;0,0209923;0,035127126
497;GENERAL;15/02/21;2021;7;All;All;103353;50129;10;153492;465084;266313;93;731490;198788;266313;465101;0,045161451;0,02586002;0,019303082;0,02586002;0,045163101
498;GENERAL;22/02/21;2021;8;All;All;176842;20606;14;197462;641926;286919;107;928952;355024;286919;641943;0,062333491;0,027860942;0,0344742;0,027860942;0,062335142
499;GENERAL;01/03/21;2021;9;All;All;138915;33502;13;172430;780841;320421;120;1101382;460456;320421;780877;0,075822674;0,031114115;0,044712054;0,031114115;0,075826169
500;GENERAL;08/03/21;2021;10;All;All;95611;51927;9;147547;876452;372348;129;1248929;504174;372348;876522;0,085106871;0,036156427;0,048957241;0,036156427;0,085113668
501;GENERAL;15/03/21;2021;11;All;All;81649;110057;16;191722;958101;482405;145;1440651;475788;482405;958193;0,093035303;0,046843387;0,04620085;0,046843387;0,093044237
502;GENERAL;22/03/21;2021;12;All;All;256921;21647;3;278571;1215022;504052;148;1719222;711083;504052;1215135;0,117983324;0,048945394;0,069048903;0,048945394;0,117994297
503;GENERAL;29/03/21;2021;13;All;All;137610;84544;3;222157;1352632;588596;151;1941379;764193;588596;1352789;0,131345786;0,057154942;0,074206089;0,057154942;0,131361031
504;GENERAL;05/04/21;2021;14;All;All;256581;53279;9;309869;1609213;641875;160;2251248;967605;641875;1609480;0,156260791;0,062328539;0,093958179;0,062328539;0,156286717
505;GENERAL;12/04/21;2021;15;All;All;425517;54329;7;479853;2034730;696204;167;2731101;1338816;696204;2035020;0,197580133;0,067604094;0,130004199;0,067604094;0,197608293
506;GENERAL;19/04/21;2021;16;All;All;210930;138950;13;349893;2245660;835154;180;3080994;1410803;835154;2245957;0,21806225;0,081096675;0,136994414;0,081096675;0,21809109
507;GENERAL;26/04/21;2021;17;All;All;345687;90032;10;435729;2591347;925186;190;3516723;1667802;925186;2592988;0,251629791;0,08983913;0,161950009;0,08983913;0,251789139
508;GENERAL;03/05/21;2021;18;All;All;370961;219129;16;590106;2962308;1144315;206;4106829;1832057;1144315;2976372;0,287651535;0,111117401;0,177899803;0,111117401;0,289017204
509;GENERAL;10/05/21;2021;19;All;All;289245;305075;17;594337;3251553;1449390;223;4701166;1834065;1449390;3283455;0,315738341;0,140741361;0,178094787;0,140741361;0,318836148
510;GENERAL;17/05/21;2021;20;All;All;305440;219692;14;525146;3556993;1669082;237;5226312;1943762;1669082;3612844;0,345397743;0,162074302;0,188746789;0,162074302;0,350821091
511;GENERAL;24/05/21;2021;21;All;All;231749;328564;33;560346;3788742;1997646;270;5786658;1896379;1997646;3894025;0,367901465;0,193979134;0,184145717;0,193979134;0,378124851
512;GENERAL;31/05/21;2021;22;All;All;229869;337980;48;567897;4018611;2335626;318;6354555;1844774;2335626;4180400;0,390222632;0,226798295;0,179134673;0,226798295;0,405932968
513;GENERAL;07/06/21;2021;23;All;All;359301;250065;22;609388;4377912;2585691;340;6963943;1982104;2585691;4567795;0,425112145;0,251080572;0,192469945;0,251080572;0,443550517
514;GENERAL;14/06/21;2021;24;All;All;342811;387642;27;730480;4720723;2973333;367;7694423;1972840;2973333;4946173;0,458400416;0,288722105;0,191570375;0,288722105;0,480292481
515;GENERAL;21/06/21;2021;25;All;All;375533;344584;28;720145;5096256;3317917;395;8414568;2048288;3317917;5366205;0,494866119;0,322182541;0,198896667;0,322182541;0,521079208
516;GENERAL;28/06/21;2021;26;All;All;388543;430377;40;818960;5484799;3748294;435;9233528;2032396;3748294;5780690;0,532595143;0,363973808;0,197353493;0,363973808;0,561327301
517;GENERAL;05/07/21;2021;27;All;All;432185;618151;43;1050379;5916984;4366445;478;10283907;1884310;4366445;6250755;0,574561974;0,423998655;0,182973771;0,423998655;0,606972426
518;GENERAL;12/07/21;2021;28;All;All;244726;518408;49;763183;6161710;4884853;527;11047090;1725688;4884853;6610541;0,598325813;0,474338072;0,167570963;0,474338072;0,641909035
519;GENERAL;19/07/21;2021;29;All;All;142855;522494;46;665395;6304565;5407347;573;11712485;1478533;5407347;6885880;0,612197585;0,525074255;0,143571259;0,525074255;0,668645514
520;GENERAL;26/07/21;2021;30;All;All;104438;497455;53;601946;6409003;5904802;626;12314431;1187246;5904802;7092048;0,622338917;0,573379055;0,115286167;0,573379055;0,6886652220
521;GENERAL;02/08/21;2021;31;All;All;128952;505346;58;634356;6537955;6410148;684;12948787;927276;6410148;7337424;0,634860654;0,622450101;0,090042077;0,622450101;0,7124921783
522;GENERAL;09/08/21;2021;32;All;All;312278;350629;19;662926;6850233;6760777;703;13611713;1030709;6760777;7791486;0,665184053;0,65649753;0,10008582;0,65649753;0,7565833503
;;;;;;;;;;;;;;;;;;;;;;