;TYPE;DATE;YEAR;WEEK;REGION;AGEGROUP;TOTAL_VAC_1;TOTAL_VAC_2;TOTAL_VAC_UNK;TOTAL;CUMUL_VAC_1;CUMUL_VAC_2;CUMUL_VAC_UNK;CUMUL;CUMUL_VAC_INIT;CUMUL_VAC_COMPLETE;CUMUL_VAC_LEAST;COVER_1_VAC;COVER_INIT;COVER_COMPLETE;COVER_LEAST
1;REGIONAL;04/01/2021;2021;1;ARS Alentejo;All;3484;1;0;3485;4712;1;0;4713;4711;1;4712;0,010051152;0,010049019;2,13E-06;0,010051152
2;REGIONAL;11/01/2021;2021;2;ARS Alentejo;All;5360;12;0;5372;10072;13;0;10085;10058;14;10072;0,02148455;0,021454687;2,99E-05;0,02148455
3;REGIONAL;18/01/2021;2021;3;ARS Alentejo;All;10434;1133;0;11567;20506;1146;0;21652;19355;1151;20506;0,043741281;0,041286087;0,002455194;0,043741281
4;REGIONAL;25/01/2021;2021;4;ARS Alentejo;All;2300;3122;0;5422;22806;4268;0;27074;18530;4276;22806;0,048647403;0,039526282;0,009121121;0,048647403
5;REGIONAL;01/02/2021;2021;5;ARS Alentejo;All;1455;4344;0;5799;24261;8612;0;32873;15640;8621;24261;0,051751059;0,033361632;0,018389427;0,051751059
6;REGIONAL;08/02/2021;2021;6;ARS Alentejo;All;3337;8785;0;12122;27598;17397;0;44995;10188;17410;27598;0,058869203;0,021731989;0,037137214;0,058869203
7;REGIONAL;15/02/2021;2021;7;ARS Alentejo;All;4061;2812;0;6873;31659;20209;0;51868;11437;20222;31659;0,067531708;0,024396227;0,043135482;0,067531708
8;REGIONAL;22/02/2021;2021;8;ARS Alentejo;All;12037;1653;0;13690;43696;21862;0;65558;21817;21879;43696;0,093207793;0,046537771;0,046670023;0,093207793
9;REGIONAL;01/03/2021;2021;9;ARS Alentejo;All;10465;2836;1;13302;54161;24698;1;78860;29441;24720;54161;0,11553065;0,0628005;0,05273015;0,11553065
10;REGIONAL;08/03/2021;2021;10;ARS Alentejo;All;5837;1675;0;7512;59998;26373;1;86372;33594;26404;59998;0,127981536;0,071659251;0,056322285;0,127981536
11;REGIONAL;15/03/2021;2021;11;ARS Alentejo;All;3715;7740;0;11455;63713;34113;1;97827;29569;34145;63714;0,13590599;0,063073536;0,072834587;0,135908123
12;REGIONAL;22/03/2021;2021;12;ARS Alentejo;All;11918;2114;0;14032;75631;36227;1;111859;39372;36261;75633;0,161328237;0,083984283;0,07734822;0,161332503
13;REGIONAL;29/03/2021;2021;13;ARS Alentejo;All;6157;6296;0;12453;81788;42523;1;124312;39230;42560;81790;0,174461713;0,083681384;0,090784596;0,174465979
14;REGIONAL;05/04/2021;2021;14;ARS Alentejo;All;14057;4315;0;18372;95845;46838;1;142684;48969;46880;95849;0,204446653;0,104455612;0,099999573;0,204455186
15;REGIONAL;12/04/2021;2021;15;ARS Alentejo;All;21913;2970;0;24883;117758;49808;1;167567;67909;49854;117763;0,251189201;0,144856464;0,106343403;0,251199867
16;REGIONAL;19/04/2021;2021;16;ARS Alentejo;All;11376;5965;1;17342;129134;55773;2;184909;73317;55822;129139;0,275455309;0,156392251;0,119073724;0,275465975
17;REGIONAL;26/04/2021;2021;17;ARS Alentejo;All;20224;2785;0;23009;149358;58558;2;207918;90759;58610;149369;0,318595057;0,193597724;0,125020798;0,318618521
18;REGIONAL;03/05/2021;2021;18;ARS Alentejo;All;13682;14331;1;28014;163040;72889;3;235932;93215;72951;166166;0,347780086;0,198836609;0,155611537;0,354448147
19;REGIONAL;10/05/2021;2021;19;ARS Alentejo;All;17437;15276;0;32713;180477;88165;3;268645;95864;88245;184109;0,384974893;0,204487182;0,188235118;0,392722301
20;REGIONAL;17/05/2021;2021;20;ARS Alentejo;All;13224;12224;1;25449;193701;100389;4;294094;100163;100584;200747;0,413182964;0,213657365;0,214555399;0,428212764
21;REGIONAL;24/05/2021;2021;21;ARS Alentejo;All;7202;18529;0;25731;200903;118918;4;319825;90512;119566;210078;0,428545527;0,193070849;0,25504584;0,448116689
22;REGIONAL;31/05/2021;2021;22;ARS Alentejo;All;17402;7311;0;24713;218305;126229;4;344538;100195;127626;227821;0,465665675;0,213725624;0,2722386;0,485964224
23;REGIONAL;07/06/2021;2021;23;ARS Alentejo;All;13821;15278;0;29099;232126;141507;4;373637;98776;143500;242276;0,495147205;0,21069876;0,306099377;0,516798137
24;REGIONAL;14/06/2021;2021;24;ARS Alentejo;All;10239;19249;1;29489;242365;160756;5;403126;90973;163218;254191;0,516987982;0,194054206;0,348159777;0,542213984
25;REGIONAL;21/06/2021;2021;25;ARS Alentejo;All;10557;14188;1;24746;252922;174944;6;427872;89416;178104;267520;0,539507084;0,190732975;0,379913055;0,57064603
26;REGIONAL;28/06/2021;2021;26;ARS Alentejo;All;10987;28772;3;39762;263909;203716;9;467634;73071;207533;280604;0,562943417;0,155867509;0,442687958;0,598555467
27;REGIONAL;05/07/2021;2021;27;ARS Alentejo;All;15353;27825;1;43179;279262;231541;10;510813;59925;236737;296662;0,595692851;0,12782582;0,504982914;0,632808734
28;REGIONAL;12/07/2021;2021;28;ARS Alentejo;All;8198;20323;1;28522;287460;251864;11;539335;49802;258540;308342;0,613179978;0,106232482;0,551490821;0,657723303
29;REGIONAL;19/07/2021;2021;29;ARS Alentejo;All;3521;16747;3;20271;290981;268611;14;559606;39642;276561;316203;0,620690611;0,084560219;0,589931357;0,674491576
30;REGIONAL;26/07/2021;2021;30;ARS Alentejo;All;2249;16509;0;18758;293230;285120;14;578364;28977;294093;323070;0,625487946;0,061810743;0,627328808;0,689139551
31;REGIONAL;02/08/2021;2021;31;ARS Alentejo;All;4957;19990;13;24960;298187;305110;27;603324;18907;315205;334112;0,636061706;0,040330459;0,672362746;0,712693205
32;REGIONAL;09/08/2021;2021;32;ARS Alentejo;All;14861;14421;0;29282;313048;319531;27;632606;24993;331281;356274;0,667761656;0,053312486;0,706654408;0,759966894
33;REGIONAL;16/08/2021;2021;33;ARS Alentejo;All;22190;6576;0;28766;335238;326107;27;661372;42225;340058;382283;0,715095072;0,090070008;0,725376598;0,815446606
34;REGIONAL;23/08/2021;2021;34;ARS Alentejo;All;12935;4590;0;17525;348173;330697;27;678897;51281;346070;397351;0,742686678;0,109387332;0,738200776;0,847588108
35;REGIONAL;30/08/2021;2021;35;ARS Alentejo;All;4731;15789;2;20522;352904;346486;29;699419;40900;362806;403706;0,752778358;0,087243655;0,773900282;0,861143937
36;REGIONAL;06/09/2021;2021;36;ARS Alentejo;All;2571;15083;7;17661;355475;361569;36;717080;27983;378379;406362;0,75826255;0,059690445;81%;87%
37;REGIONAL;04/01/2021;2021;1;ARS Algarve;All;1258;3;0;1261;2325;3;0;2328;2321;4;2325;0,004973315;0,004964759;8,56E-06;0,004973315
38;REGIONAL;11/01/2021;2021;2;ARS Algarve;All;1362;4;0;1366;3687;7;0;3694;3677;10;3687;0,007886715;0,007865325;2,14E-05;0,007886715
39;REGIONAL;18/01/2021;2021;3;ARS Algarve;All;3400;946;0;4346;7087;953;0;8040;6131;956;7087;0,01515952;0,013114579;0,002044942;0,01515952
40;REGIONAL;25/01/2021;2021;4;ARS Algarve;All;2154;1231;0;3385;9241;2184;0;11425;7054;2187;9241;0,019767056;0,015088931;0,004678125;0,019767056
41;REGIONAL;01/02/2021;2021;5;ARS Algarve;All;1225;1246;0;2471;10466;3430;0;13896;7034;3433;10467;0,022387405;0,01504615;0,007343394;0,022389544
42;REGIONAL;08/02/2021;2021;6;ARS Algarve;All;2410;2898;0;5308;12876;6328;0;19204;6544;6333;12877;0,027542541;0,013998011;0,013546669;0,02754468
43;REGIONAL;15/02/2021;2021;7;ARS Algarve;All;3214;2116;0;5330;16090;8444;0;24534;7639;8452;16091;0,03441748;0,016340282;0,018079338;0,034419619
44;REGIONAL;22/02/2021;2021;8;ARS Algarve;All;8519;1067;1;9587;24609;9511;1;34121;15081;9529;24610;0,052640135;0,032259169;0,020383106;0,052642274
45;REGIONAL;01/03/2021;2021;9;ARS Algarve;All;4665;563;0;5228;29274;10074;1;39349;19177;10099;29276;0,062618852;0,04102076;0,02160237;0,06262313
46;REGIONAL;08/03/2021;2021;10;ARS Algarve;All;5142;1553;0;6695;34416;11627;1;46044;22767;11652;34419;0,0736179;0,048699986;0,024924331;0,073624317
47;REGIONAL;15/03/2021;2021;11;ARS Algarve;All;2722;3019;0;5741;37138;14646;1;51785;22470;14671;37141;0,079440422;0,048064685;0,031382154;0,079446839
48;REGIONAL;22/03/2021;2021;12;ARS Algarve;All;9446;4315;0;13761;46584;18961;1;65546;27596;18991;46587;0,099645986;0,059029508;0,040622894;0,099652403
49;REGIONAL;29/03/2021;2021;13;ARS Algarve;All;4236;2934;0;7170;50820;21895;1;72716;28899;21925;50824;0,108707045;0,061816704;0,046898897;0,108715601
50;REGIONAL;05/04/2021;2021;14;ARS Algarve;All;8679;1815;0;10494;59499;23710;1;83210;35766;23742;59508;0,127271949;0,076505631;0,05078557;0,127291201
51;REGIONAL;12/04/2021;2021;15;ARS Algarve;All;13684;2176;0;15860;73183;25886;1;99070;47274;25918;73192;0,156542851;0,101121937;0,055440165;0,156562102
52;REGIONAL;19/04/2021;2021;16;ARS Algarve;All;7271;5521;0;12792;80454;31407;1;111862;49021;31443;80464;0,172095958;0,104858875;0,067258473;0,172117349
53;REGIONAL;26/04/2021;2021;17;ARS Algarve;All;16398;3272;0;19670;96852;34679;1;131532;62136;34731;96867;0,207172269;0,132912651;0,074291704;0,207204355
54;REGIONAL;03/05/2021;2021;18;ARS Algarve;All;16576;8961;2;25539;113428;43640;3;157071;70290;43704;113994;0,242629333;0,150354549;0,093485492;0,243840041
55;REGIONAL;10/05/2021;2021;19;ARS Algarve;All;9737;11333;0;21070;123165;54973;3;178141;70651;55045;125696;0,263457363;0,15112675;0,117744575;0,268871325
56;REGIONAL;17/05/2021;2021;20;ARS Algarve;All;12032;10915;3;22950;135197;65888;6;201091;74242;66014;140256;0,289194537;0,158808116;0,141207927;0,300016043
57;REGIONAL;24/05/2021;2021;21;ARS Algarve;All;7633;18817;0;26450;142830;84705;6;227541;68750;84925;153675;0,305521984;0,147060396;0,181659697;0,328720093
58;REGIONAL;31/05/2021;2021;22;ARS Algarve;All;8186;12750;2;20938;151016;97455;8;248479;72582;97771;170353;0,323032332;0,155257275;0,209138066;0,364395341
59;REGIONAL;07/06/2021;2021;23;ARS Algarve;All;17066;6354;0;23420;168082;103809;8;271899;84338;104434;188772;0,359537535;0,180404068;0,223390624;0,403794693
60;REGIONAL;14/06/2021;2021;24;ARS Algarve;All;15370;13440;0;28810;183452;117249;8;300709;86279;118089;204368;0,392414892;0,184555985;0,252599493;0,437155478
61;REGIONAL;21/06/2021;2021;25;ARS Algarve;All;19356;10218;2;29576;202808;127467;10;330285;96312;128787;225099;0,433818544;0,206017177;0,27548316;0,481500337
62;REGIONAL;28/06/2021;2021;26;ARS Algarve;All;17197;16450;7;33654;220005;143917;17;363939;99113;145644;244757;0,470603964;0,212008685;0,3115413;0,523549984
63;REGIONAL;05/07/2021;2021;27;ARS Algarve;All;19203;31728;1;50932;239208;175645;18;414871;87193;178016;265209;0,511680339;0,186511086;0,38078696;0,567298046
64;REGIONAL;12/07/2021;2021;28;ARS Algarve;All;9822;26995;4;36821;249030;202640;22;451692;75999;205529;281528;0,532690189;0,162566445;0,439638927;0,602205371
65;REGIONAL;19/07/2021;2021;29;ARS Algarve;All;4349;27213;1;31563;253379;229853;23;483255;58273;233377;291650;0,541992962;0,124649461;0,499207478;0,62385694
66;REGIONAL;26/07/2021;2021;30;ARS Algarve;All;3988;24742;3;28733;257367;254595;26;511988;41534;258749;300283;0,550523535;0,088843731;0,553479716;0,642323447
67;REGIONAL;02/08/2021;2021;31;ARS Algarve;All;3933;22623;1;26557;261300;277218;27;538545;26173;282031;308204;0,558936459;0,055985626;0,603281319;0,659266944
68;REGIONAL;09/08/2021;2021;32;ARS Algarve;All;11456;14017;2;25475;272756;291235;29;564020;28309;296981;325290;0,583441534;0,060554658;0,63526027;0,695814929
69;REGIONAL;16/08/2021;2021;33;ARS Algarve;All;16645;7764;2;24411;289401;298999;31;588431;39533;305915;345448;0,619046193;0,084563471;0,654370635;0,738934106
70;REGIONAL;23/08/2021;2021;34;ARS Algarve;All;13552;5292;0;18844;302953;304291;31;607275;48290;312342;360632;0,648034738;0,103295222;0,668118376;0,771413598
71;REGIONAL;30/08/2021;2021;35;ARS Algarve;All;6480;12129;4;18613;309433;316420;35;625888;42708;325587;368295;0,661895849;0,091354988;0,696450229;0,787805217
72;REGIONAL;06/09/2021;2021;36;ARS Algarve;All;3290;15719;1;19010;312723;332139;36;644898;30487;341747;372234;0,668933358;0,065213532;73%;80%
73;REGIONAL;04/01/2021;2021;1;ARS Centro;All;9072;18;0;9090;15729;19;0;15748;15711;20;15731;0,009475872;0,009465028;1,20E-05;0,009477077
74;REGIONAL;11/01/2021;2021;2;ARS Centro;All;12683;25;1;12709;28412;44;1;28457;28358;56;28414;0,017116694;0,017084162;3,37E-05;0,017117899
75;REGIONAL;18/01/2021;2021;3;ARS Centro;All;36796;6319;2;43117;65208;6363;3;71574;58807;6403;65210;0,039284294;0,035428038;0,003857461;0,039285499
76;REGIONAL;25/01/2021;2021;4;ARS Centro;All;4893;8543;3;13439;70101;14906;6;85013;55153;14950;70103;0,042232062;0,0332267;0,009006567;0,042233267
77;REGIONAL;01/02/2021;2021;5;ARS Centro;All;2727;9167;0;11894;72828;24073;6;96907;48710;24121;72831;0,043874932;0,029345141;0,014531598;0,04387674
78;REGIONAL;08/02/2021;2021;6;ARS Centro;All;7558;27136;4;34698;80386;51209;10;131605;29103;51286;80389;0,048428219;0,017532984;0,030897042;0,048430026
79;REGIONAL;15/02/2021;2021;7;ARS Centro;All;25556;10002;3;35561;105942;61211;13;167166;44568;61377;105945;0,063824327;0,02684981;0,036976324;0,063826134
80;REGIONAL;22/02/2021;2021;8;ARS Centro;All;38438;3134;1;41573;144380;64345;14;208739;79834;64549;144383;0,086981143;0,048095668;0,038887282;0,086982951
81;REGIONAL;01/03/2021;2021;9;ARS Centro;All;28560;5950;1;34511;172940;70295;15;243250;102425;70529;172954;0,104186999;0,061705524;0,042489909;0,104195433
82;REGIONAL;08/03/2021;2021;10;ARS Centro;All;17754;13567;0;31321;190694;83862;15;274571;106587;84136;190723;0,114882824;0,064212904;0,050687391;0,114900295
83;REGIONAL;15/03/2021;2021;11;ARS Centro;All;16732;24236;2;40970;207426;108098;17;315541;99085;108383;207468;0,12496295;0,059693355;0,065294897;0,124988252
84;REGIONAL;22/03/2021;2021;12;ARS Centro;All;47900;4411;1;52312;255326;112509;18;367853;142458;112917;255375;0,15382011;0,085823242;0,068026387;0,153849629
85;REGIONAL;29/03/2021;2021;13;ARS Centro;All;24429;16840;2;41271;279755;129349;20;409124;150032;129790;279822;0,168537261;0,090386168;0,078191457;0,168577625
86;REGIONAL;05/04/2021;2021;14;ARS Centro;All;49921;10282;1;60204;329676;139631;21;469328;189604;140156;329760;0,198611965;0,114226158;0,084436412;0,19866257
87;REGIONAL;12/04/2021;2021;15;ARS Centro;All;77686;12079;2;89767;407362;151710;23;559095;255037;152416;407453;0,245413579;0,153646003;0,091822399;0,245468402
88;REGIONAL;19/04/2021;2021;16;ARS Centro;All;30064;24244;7;54315;437426;175954;30;613410;260714;176806;437520;0,263525514;0,157066088;0,106516055;0,263582144
89;REGIONAL;26/04/2021;2021;17;ARS Centro;All;56640;17978;0;74618;494066;193932;30;688028;300472;194965;495437;0,297648051;0,181018134;0,117455871;0,298474004
90;REGIONAL;03/05/2021;2021;18;ARS Centro;All;60009;49202;1;109212;554075;243134;31;797240;316892;244400;561292;0,333800229;0,190910296;0,147237785;0,338148081
91;REGIONAL;10/05/2021;2021;19;ARS Centro;All;50691;55810;1;106502;604766;298944;32;903742;317627;300391;618018;0,364338816;0,191353094;0,180969336;0,372322429
92;REGIONAL;17/05/2021;2021;20;ARS Centro;All;44907;41778;3;86688;649673;340722;35;990430;327755;342938;670693;0,391392855;0,197454666;0,206601603;0,404056268
93;REGIONAL;24/05/2021;2021;21;ARS Centro;All;24241;56341;6;80588;673914;397063;41;1071018;302971;400302;703273;0,405996747;0,182523646;0,241160311;0,423683957
94;REGIONAL;31/05/2021;2021;22;ARS Centro;All;44320;37818;0;82138;718234;434881;41;1153156;308888;441067;749955;0,43269715;0,186088319;0,265719019;0,451807338
95;REGIONAL;07/06/2021;2021;23;ARS Centro;All;58398;40913;1;99312;776632;475794;42;1252468;325591;484531;810122;0,467878788;0,196150973;0,291903729;0,488054702
96;REGIONAL;14/06/2021;2021;24;ARS Centro;All;52026;65818;7;117851;828658;541612;49;1370319;315237;552813;868050;0,49922164;0,189913248;0,333039942;0,52295319
97;REGIONAL;21/06/2021;2021;25;ARS Centro;All;59588;47767;3;107358;888246;589379;52;1477677;329803;604159;933962;0,535120188;0,198688475;0,363973131;0,562661606
98;REGIONAL;28/06/2021;2021;26;ARS Centro;All;49931;77181;2;127114;938177;666560;54;1604791;301389;684733;986122;0,565200916;0,181570577;0,412514609;0,594085186
99;REGIONAL;05/07/2021;2021;27;ARS Centro;All;59506;104960;9;164475;997683;771520;63;1769266;259538;794125;1053663;0,601050063;0,156357612;0,478417375;0,634774986
100;REGIONAL;12/07/2021;2021;28;ARS Centro;All;28575;82168;8;110751;1026258;853688;71;1880017;216023;880605;1096628;0,618264956;0,130142177;0,530516899;0,660659076
101;REGIONAL;19/07/2021;2021;29;ARS Centro;All;16900;80766;15;97681;1043158;934454;86;1977698;163214;965874;1129088;0,628446292;0,09832761;0,581886861;0,680214471
102;REGIONAL;26/07/2021;2021;30;ARS Centro;All;14406;69003;5;83414;1057564;1003457;91;2061112;116475;1040084;1156559;0,637125128;0,07016989;0,626594373;0,696764263
103;REGIONAL;02/08/2021;2021;31;ARS Centro;All;19263;75126;4;94393;1076827;1078583;95;2155505;74856;1120068;1194924;0,648730044;0,045096693;0,674780408;0,719877101
104;REGIONAL;09/08/2021;2021;32;ARS Centro;All;50499;46934;4;97437;1127326;1125517;99;2252942;93121;1175725;1268846;0,679152961;0,056100367;0,708310742;0,764411109
105;REGIONAL;16/08/2021;2021;33;ARS Centro;All;61298;35988;7;97293;1188624;1161505;106;2350235;131556;1219452;1351008;0,716081692;0,079255377;0,734653895;0,813909272
106;REGIONAL;23/08/2021;2021;34;ARS Centro;All;50998;18382;2;69382;1239622;1179887;108;2419617;163791;1243940;1407731;0,746805229;0,098675221;0,749406591;0,848081812
107;REGIONAL;30/08/2021;2021;35;ARS Centro;All;20675;48185;2;68862;1260297;1228072;110;2488479;133345;1296642;1429987;0,759260799;0,080333153;0,781156696;0,861489849
108;REGIONAL;06/09/2021;2021;36;ARS Centro;All;7742;50908;15;58665;1268039;1278980;125;2547144;89218;1348982;1438200;0,763924935;0,053749021;81%;87%
109;REGIONAL;04/01/2021;2021;1;ARS Lisboa e Vale do Tejo;All;12766;21;0;12787;23527;24;0;23551;23504;24;23528;0,006390461;0,006384214;6,52E-06;0,006390733
110;REGIONAL;11/01/2021;2021;2;ARS Lisboa e Vale do Tejo;All;13265;1115;0;14380;36792;1139;0;37931;35640;1153;36793;0,009993533;0,009680624;0,000313181;0,009993804
111;REGIONAL;18/01/2021;2021;3;ARS Lisboa e Vale do Tejo;All;37869;9064;0;46933;74661;10203;0;84864;64322;10341;74663;0,020279603;0,017471298;0,002808848;0,020280146
112;REGIONAL;25/01/2021;2021;4;ARS Lisboa e Vale do Tejo;All;17318;11903;1;29222;91979;22106;1;114086;69672;22310;91982;0,02498356;0,018924478;0,006059897;0,024984375
113;REGIONAL;01/02/2021;2021;5;ARS Lisboa e Vale do Tejo;All;8753;8939;0;17692;100732;31045;1;131778;69471;31267;100738;0,027361071;0,018869882;0,008492819;0,027362701
114;REGIONAL;08/02/2021;2021;6;ARS Lisboa e Vale do Tejo;All;14429;30435;0;44864;115161;61480;1;176642;53273;61894;115167;0,031280311;0,014470142;0,016811799;0,031281941
115;REGIONAL;15/02/2021;2021;7;ARS Lisboa e Vale do Tejo;All;33037;19081;0;52118;148198;80561;1;228760;67077;81127;148204;0,040253902;0,018219618;0,022035913;0,040255532
116;REGIONAL;22/02/2021;2021;8;ARS Lisboa e Vale do Tejo;All;49414;6680;0;56094;197612;87241;1;284854;109498;88120;197618;0,053675853;0,029742114;0,023935369;0,053677483
117;REGIONAL;01/03/2021;2021;9;ARS Lisboa e Vale do Tejo;All;45229;12846;0;58075;242841;100087;1;342929;141664;101191;242855;0,065961064;0,038479121;0,027485746;0,065964867
118;REGIONAL;08/03/2021;2021;10;ARS Lisboa e Vale do Tejo;All;33961;16606;1;50568;276802;116693;2;393497;158933;117895;276828;0,075185634;0,043169769;0,032022927;0,075192696
119;REGIONAL;15/03/2021;2021;11;ARS Lisboa e Vale do Tejo;All;26273;29050;1;55324;303075;145743;3;448821;156095;147016;303111;0,08232197;0,042398904;0,039932844;0,082331748
120;REGIONAL;22/03/2021;2021;12;ARS Lisboa e Vale do Tejo;All;89520;7703;0;97223;392595;153446;3;546044;237651;154990;392641;0,10663761;0,064551344;0,042098761;0,106650105
121;REGIONAL;29/03/2021;2021;13;ARS Lisboa e Vale do Tejo;All;45711;23952;0;69663;438306;177398;3;615707;259340;179025;438365;0,119053743;0,070442563;0,048627207;0,119069769
122;REGIONAL;05/04/2021;2021;14;ARS Lisboa e Vale do Tejo;All;87557;19750;1;107308;525863;197148;4;723015;327018;198959;525977;0,142836189;0,088825426;0,054041728;0,142867154
123;REGIONAL;12/04/2021;2021;15;ARS Lisboa e Vale do Tejo;All;163763;14426;1;178190;689626;211574;5;901205;476233;213523;689756;0,187317894;0,129355568;0,057997637;0,187353205
124;REGIONAL;19/04/2021;2021;16;ARS Lisboa e Vale do Tejo;All;79391;53811;1;133203;769017;265385;6;1034408;501559;267591;769150;0,208882271;0,136234677;0,072683719;0,208918397
125;REGIONAL;26/04/2021;2021;17;ARS Lisboa e Vale do Tejo;All;107824;25663;2;133489;876841;291048;8;1167897;583606;293398;877004;0,238169689;0,158520483;0,07969348;0,238213963
126;REGIONAL;03/05/2021;2021;18;ARS Lisboa e Vale do Tejo;All;107993;65622;2;173617;984834;356670;10;1341514;628535;359175;987710;0,26750301;0,170724208;0,097559988;0,268284196
127;REGIONAL;10/05/2021;2021;19;ARS Lisboa e Vale do Tejo;All;90609;113279;3;203891;1075443;469949;13;1545405;608155;472751;1080906;0,292114448;0,165188543;0,128409778;0,293598321
128;REGIONAL;17/05/2021;2021;20;ARS Lisboa e Vale do Tejo;All;110169;71314;1;181484;1185612;541263;14;1726889;648639;545075;1193714;0,32203882;0,176184905;0,148054599;0,324239505
129;REGIONAL;24/05/2021;2021;21;ARS Lisboa e Vale do Tejo;All;110876;89007;3;199886;1296488;630270;17;1926775;675495;642174;1317669;0,352155229;0,183479597;0,174428866;0,357908464
130;REGIONAL;31/05/2021;2021;22;ARS Lisboa e Vale do Tejo;All;92384;86991;7;179382;1388872;717261;24;2106157;696723;734102;1430825;0,377248796;0,189245599;0,199398574;0,388644172
131;REGIONAL;07/06/2021;2021;23;ARS Lisboa e Vale do Tejo;All;152296;54119;3;206418;1541168;771380;27;2312575;802886;794807;1597693;0,418615807;0,218081851;0,215887414;0,433969265
132;REGIONAL;14/06/2021;2021;24;ARS Lisboa e Vale do Tejo;All;147803;121460;4;269267;1688971;892840;31;2581842;831723;922943;1754666;0,458762418;0,225914627;0,250692026;0,476606654
133;REGIONAL;21/06/2021;2021;25;ARS Lisboa e Vale do Tejo;All;120236;153848;13;274097;1809207;1046688;44;2855939;804825;1084685;1889510;0,491421213;0,218608527;0,294624782;0,513233309
134;REGIONAL;28/06/2021;2021;26;ARS Lisboa e Vale do Tejo;All;130509;166713;8;297230;1939716;1213401;52;3153169;769964;1261156;2031120;0,526870385;0,209139497;0,342558265;0,551697762
135;REGIONAL;05/07/2021;2021;27;ARS Lisboa e Vale do Tejo;All;143869;273683;8;417560;2083585;1487084;60;3570729;640562;1546077;2186639;0,565948434;0,173991011;0,419949201;0,593940212
136;REGIONAL;12/07/2021;2021;28;ARS Lisboa e Vale do Tejo;All;79970;215797;15;295782;2163555;1702881;75;3866511;533295;1771845;2305140;0,58767008;0,144854887;0,481272855;0,626127742
137;REGIONAL;19/07/2021;2021;29;ARS Lisboa e Vale do Tejo;All;57065;185645;7;242717;2220620;1888526;82;4109228;444538;1968758;2413296;0,603170214;0,120746495;0,534758844;0,655505339
138;REGIONAL;26/07/2021;2021;30;ARS Lisboa e Vale do Tejo;All;36412;180414;10;216836;2257032;2068940;92;4326064;326520;2161121;2487641;0,61306053;0,088690158;0,587008951;0,675699109
139;REGIONAL;02/08/2021;2021;31;ARS Lisboa e Vale do Tejo;All;45491;178242;8;223741;2302523;2247182;100;4549805;222361;2354086;2576447;0,625416906;0,060398237;0,639422574;0,699820811
140;REGIONAL;09/08/2021;2021;32;ARS Lisboa e Vale do Tejo;All;107372;110934;3;218309;2409895;2358116;103;4768114;240662;2486309;2726971;0,654581551;0,065369199;0,675337308;0,740706506
141;REGIONAL;16/08/2021;2021;33;ARS Lisboa e Vale do Tejo;All;107352;90832;8;198192;2517247;2448948;111;4966306;281261;2593200;2874461;0,683740762;0,076396798;0,704371301;0,780768099
142;REGIONAL;23/08/2021;2021;34;ARS Lisboa e Vale do Tejo;All;88933;60707;5;149645;2606180;2509655;116;5115951;321716;2668613;2990329;0,707896961;0,087385284;0,724855164;0,812240448
143;REGIONAL;30/08/2021;2021;35;ARS Lisboa e Vale do Tejo;All;48653;100537;13;149203;2654833;2610192;129;5265154;264742;2782618;3047360;0,721112207;0,071909867;0,75582148;0,827731347
144;REGIONAL;06/09/2021;2021;36;ARS Lisboa e Vale do Tejo;All;27368;91482;79;118929;2682201;2701674;208;5384083;195747;2879391;3075138;0,72854597;0,053169277;78%;84%
145;REGIONAL;04/01/2021;2021;1;ARS Norte;All;16740;36;0;16776;30144;43;0;30187;30104;47;30151;0,008414478;0,008403312;1,31E-05;0,008416432
146;REGIONAL;11/01/2021;2021;2;ARS Norte;All;15455;38;0;15493;45599;81;0;45680;45496;110;45606;0,012728628;0,012699877;3,07E-05;0,012730582
147;REGIONAL;18/01/2021;2021;3;ARS Norte;All;32552;12751;1;45304;78151;12832;1;90984;65260;12898;78158;0,021815282;0,018216853;0,003600383;0,021817236
148;REGIONAL;25/01/2021;2021;4;ARS Norte;All;14431;15740;1;30172;92582;28572;2;121156;63941;28649;92590;0,02584359;0,017848664;0,007997159;0,025845823
149;REGIONAL;01/02/2021;2021;5;ARS Norte;All;5717;12298;1;18016;98299;40870;3;139172;57360;40951;98311;0,027439449;0,016011626;0,011431173;0,027442799
150;REGIONAL;08/02/2021;2021;6;ARS Norte;All;8974;28975;6;37955;107273;69845;9;177127;37289;69996;107285;0,029944476;0,010408952;0,019538873;0,029947825
151;REGIONAL;15/02/2021;2021;7;ARS Norte;All;33107;15221;4;48332;140380;85066;13;225459;54810;85582;140392;0,039186053;0,015299812;0,023889591;0,039189403
152;REGIONAL;22/02/2021;2021;8;ARS Norte;All;64910;4375;0;69285;205290;89441;13;294744;115076;90226;205302;0,057305207;0,032122626;0,02518593;0,057308556
153;REGIONAL;01/03/2021;2021;9;ARS Norte;All;48151;7146;2;55299;253441;96587;15;350043;155985;97476;253461;0,070746207;0,043542075;0,027209715;0,07075179
154;REGIONAL;08/03/2021;2021;10;ARS Norte;All;25837;14234;0;40071;279278;110821;15;390114;167459;111854;279313;0,077958417;0,046744959;0,031223228;0,077968187
155;REGIONAL;15/03/2021;2021;11;ARS Norte;All;27047;42472;3;69522;306325;153293;18;459636;152012;154359;306371;0,08550839;0,042433041;0,043088189;0,085521231
156;REGIONAL;22/03/2021;2021;12;ARS Norte;All;89208;2487;0;91695;395533;155780;18;551331;238629;156956;395585;0,110410153;0,066611545;0,043813123;0,110424668
157;REGIONAL;29/03/2021;2021;13;ARS Norte;All;54279;32806;1;87086;449812;188586;19;638417;260044;189845;449889;0,12556174;0,072589386;0,052993847;0,125583234
158;REGIONAL;05/04/2021;2021;14;ARS Norte;All;82604;13811;5;96420;532416;202397;24;734837;328796;203743;532539;0,148620044;0,091781006;0,056873373;0,148654379
159;REGIONAL;12/04/2021;2021;15;ARS Norte;All;136150;19273;1;155424;668566;221670;25;890261;445575;223123;668698;0,186625324;0,124379012;0,062283158;0,186662171
160;REGIONAL;19/04/2021;2021;16;ARS Norte;All;65397;46579;2;111978;733963;268249;27;1002239;463989;270108;734097;0,204880419;0,129519146;0,075398679;0,204917825
161;REGIONAL;26/04/2021;2021;17;ARS Norte;All;127028;36850;3;163881;860991;305099;30;1166120;553995;307158;861153;0,240339359;0,154643665;0,085740916;0,24038458
162;REGIONAL;03/05/2021;2021;18;ARS Norte;All;155897;73483;3;229383;1016888;378582;33;1395503;636136;381131;1017267;0,28385687;0,177572726;0,106389939;0,283962665
163;REGIONAL;10/05/2021;2021;19;ARS Norte;All;100178;101275;8;201461;1117066;479857;41;1596964;640704;483510;1124214;0,311820828;0,17884785;0,134968291;0,31381614
164;REGIONAL;17/05/2021;2021;20;ARS Norte;All;111205;71378;4;182587;1228271;551235;45;1779551;678990;564086;1243076;0,342862893;0,189535107;0,157460494;0,346995601
165;REGIONAL;24/05/2021;2021;21;ARS Norte;All;73325;129423;9;202757;1301596;680658;54;1982308;629828;706755;1336583;0,363331032;0,175811894;0,197285505;0,373097398
166;REGIONAL;31/05/2021;2021;22;ARS Norte;All;55299;172867;10;228176;1356895;853525;64;2210484;530272;885907;1416179;0,378767345;0,148021562;0,247294479;0,395316041
167;REGIONAL;07/06/2021;2021;23;ARS Norte;All;107213;106912;7;214132;1464108;960437;71;2424616;528170;1002967;1531137;0,408695072;0,147434804;0,279970924;0,427405729
168;REGIONAL;14/06/2021;2021;24;ARS Norte;All;105457;152886;13;258356;1569565;1113323;84;2682972;486338;1165959;1652297;0,438132625;0,135757706;0,325468953;0,461226659
169;REGIONAL;21/06/2021;2021;25;ARS Norte;All;146616;105671;5;252292;1716181;1218994;89;2935264;530311;1285188;1815499;0,479059412;0,148032449;0,358750859;0,506783307
170;REGIONAL;28/06/2021;2021;26;ARS Norte;All;163942;117682;8;281632;1880123;1336676;97;3216896;567430;1418486;1985916;0,524822626;0,158393947;0,395960023;0,55435397
171;REGIONAL;05/07/2021;2021;27;ARS Norte;All;176315;158883;11;335209;2056438;1495559;108;3552105;580721;1595859;2176580;0,574039672;0,162104033;0,445472403;0,607576436
172;REGIONAL;12/07/2021;2021;28;ARS Norte;All;105539;157370;21;262930;2161977;1652929;129;3815035;561751;1769916;2331667;0,603500115;0,156808695;0,494059145;0,650867841
173;REGIONAL;19/07/2021;2021;29;ARS Norte;All;51864;190000;12;241876;2213841;1842929;141;4056911;462113;1973280;2435393;0,617977572;0,128995474;0,550826723;0,679822197
174;REGIONAL;26/07/2021;2021;30;ARS Norte;All;35419;185757;16;221192;2249260;2028686;157;4278103;335947;2170595;2506542;0,627864528;0,093777155;0,605905766;0,699682922
175;REGIONAL;02/08/2021;2021;31;ARS Norte;All;41913;190246;8;232167;2291173;2218932;165;4510270;214196;2372750;2586946;0,639564236;0,059791252;0,662335861;0,722127112
176;REGIONAL;09/08/2021;2021;32;ARS Norte;All;119396;148374;6;267776;2410569;2367306;171;4778046;226955;2538932;2765887;0,672892759;0,063352833;0,708724354;0,772077187
177;REGIONAL;16/08/2021;2021;33;ARS Norte;All;148827;81200;8;230035;2559396;2448506;179;5008081;313211;2639780;2952991;0,71443673;0,087430567;0,736875338;0,824305905
178;REGIONAL;23/08/2021;2021;34;ARS Norte;All;119019;34075;3;153097;2678415;2482581;182;5161178;385677;2689653;3075330;0,747660016;0,107658922;0,750797022;0,858455944
179;REGIONAL;30/08/2021;2021;35;ARS Norte;All;44835;111359;10;156204;2723250;2593940;192;5317382;310221;2811541;3121762;0,76017538;0,08659593;0,784821169;0,871417099
180;REGIONAL;06/09/2021;2021;36;ARS Norte;All;22147;128936;51;151134;2745397;2722876;243;5468516;199726;2945296;3145022;0,766357553;0,055752057;82%;88%
181;REGIONAL;04/01/2021;2021;1;RA Madeira;All;1831;2;0;1833;2535;2;0;2537;2533;2;2535;0,010097188;0,010089222;7,97E-06;0,010097188
182;REGIONAL;11/01/2021;2021;2;RA Madeira;All;1798;3;0;1801;4333;5;0;4338;4325;8;4333;0,017258823;0,017226958;3,19E-05;0,017258823
183;REGIONAL;18/01/2021;2021;3;RA Madeira;All;1163;596;1;1760;5496;601;1;6098;4892;604;5496;0,021891181;0,019485382;0,002405799;0,021891181
184;REGIONAL;25/01/2021;2021;4;RA Madeira;All;483;1724;3;2210;5979;2325;4;8308;3651;2328;5979;0,023815024;0,01454234;0,009272684;0,023815024
185;REGIONAL;01/02/2021;2021;5;RA Madeira;All;2256;1544;0;3800;8235;3869;4;12108;4363;3872;8235;0,032800924;0,017378316;0,015422608;0,032800924
186;REGIONAL;08/02/2021;2021;6;RA Madeira;All;3181;1160;1;4342;11416;5029;5;16450;6384;5032;11416;0,045471202;0,025428184;0,020043018;0,045471202
187;REGIONAL;15/02/2021;2021;7;RA Madeira;All;2592;711;1;3304;14008;5740;6;19754;8264;5744;14008;0,055795427;0,032916434;0,022878993;0,055795427
188;REGIONAL;22/02/2021;2021;8;RA Madeira;All;2272;2161;1;4434;16280;7901;7;24188;8375;7905;16280;0,064845057;0,03335856;0,031486497;0,064845057
189;REGIONAL;01/03/2021;2021;9;RA Madeira;All;1458;3130;3;4591;17738;11031;10;28779;6703;11035;17738;0,070652434;0,026698797;0,043953637;0,070652434
190;REGIONAL;08/03/2021;2021;10;RA Madeira;All;4982;2391;0;7373;22720;13422;10;36152;9294;13426;22720;0,090496296;0,037019039;0,053477256;0,090496296
191;REGIONAL;15/03/2021;2021;11;RA Madeira;All;3128;2329;2;5459;25848;15751;12;41611;10092;15756;25848;0,102955469;0,040197562;0,062757906;0,102955469
192;REGIONAL;22/03/2021;2021;12;RA Madeira;All;5498;193;0;5691;31346;15944;12;47302;15397;15949;31346;0,124854616;0,061327969;0,063526647;0,124854616
193;REGIONAL;29/03/2021;2021;13;RA Madeira;All;1224;1261;1;2486;32570;17205;13;49788;15360;17211;32571;0,129729945;0,061180594;0,068553334;0,129733928
194;REGIONAL;05/04/2021;2021;14;RA Madeira;All;10222;1301;0;11523;42792;18506;13;61311;24279;18514;42793;0,170445312;0,096705967;0,073743328;0,170449295
195;REGIONAL;12/04/2021;2021;15;RA Madeira;All;8532;1309;0;9841;51324;19815;13;71152;31497;19829;51326;0,20442922;0,125456066;0,07898112;0,204437186
196;REGIONAL;19/04/2021;2021;16;RA Madeira;All;9832;2144;0;11976;61156;21959;13;83128;39116;22043;61159;0,243591173;0,155803394;0,087799729;0,243603123
197;REGIONAL;26/04/2021;2021;17;RA Madeira;All;8822;829;1;9652;69978;22788;14;92780;47114;22885;69999;0,278730184;0,18766032;0,091153509;0,278813829
198;REGIONAL;03/05/2021;2021;18;RA Madeira;All;7657;5349;0;13006;77635;28137;14;105786;49422;28255;77677;0,30922887;0,196853342;0,112542818;0,30939616
199;REGIONAL;10/05/2021;2021;19;RA Madeira;All;11599;6561;5;18165;89234;34698;19;123951;54449;34828;89277;0,355428981;0,216876444;0,138723811;0,355600255
200;REGIONAL;17/05/2021;2021;20;RA Madeira;All;2399;7717;7;10123;91633;42415;26;134074;49133;42551;91684;0,364984466;0,195702223;0,169485382;0,365187605
201;REGIONAL;24/05/2021;2021;21;RA Madeira;All;3502;8992;3;12497;95135;51407;29;146571;43635;51560;95195;0,378933323;0,173803075;0,205369234;0,379172309
202;REGIONAL;31/05/2021;2021;22;RA Madeira;All;7644;11013;5;18662;102779;62420;34;165233;40564;62614;103178;0,409380228;0,161570939;0,24939855;0,410969489
203;REGIONAL;07/06/2021;2021;23;RA Madeira;All;3715;15284;5;19004;106494;77704;39;184237;31055;77936;108991;0,424177487;0,123695531;0,310427786;0,434123317
204;REGIONAL;14/06/2021;2021;24;RA Madeira;All;3762;8361;5;12128;110256;86065;44;196365;28946;86336;115282;0,439161953;0,115295149;0,343885924;0,459181072
205;REGIONAL;21/06/2021;2021;25;RA Madeira;All;12626;3748;15;16389;122882;89813;59;212754;37815;90226;128041;0,48945272;0,150621365;0,359380228;0,510001593
206;REGIONAL;28/06/2021;2021;26;RA Madeira;All;10155;12369;21;22545;133037;102182;80;235299;35679;102710;138389;0,529901219;0,142113439;0,409105393;0,551218832
207;REGIONAL;05/07/2021;2021;27;RA Madeira;All;12790;7009;10;19809;145827;109191;90;255108;41520;110070;151590;0,580845216;0,165378794;0,438421095;0,603799888
208;REGIONAL;12/07/2021;2021;28;RA Madeira;All;10665;5912;9;16586;156492;115103;99;271694;47158;116575;163733;0,623325102;0,187835577;0,464331236;0,652166813
209;REGIONAL;19/07/2021;2021;29;RA Madeira;All;4269;14847;8;19124;160761;129950;107;290818;38856;131676;170532;0,640329005;0,154767785;0,524480204;0,679247989
210;REGIONAL;26/07/2021;2021;30;RA Madeira;All;5571;13890;5;19466;166332;143840;112;310284;33471;145981;179452;0,66251892;0,133318729;0,581458615;0,714777344
211;REGIONAL;02/08/2021;2021;31;RA Madeira;All;4558;14377;1;18936;170890;158217;113;329220;25426;160715;186141;0,680673942;0,101274596;0,640145782;0,741420378
212;REGIONAL;09/08/2021;2021;32;RA Madeira;All;5418;11054;3;16475;176308;169271;116;345695;21250;172022;193272;0,702254441;0,084641122;0,685182825;0,769823946
213;REGIONAL;16/08/2021;2021;33;RA Madeira;All;3623;8164;4;11791;179931;177435;120;357486;17772;180394;198166;0,716685255;0,070787859;0,718529435;0,789317295
214;REGIONAL;23/08/2021;2021;34;RA Madeira;All;2192;6284;2;8478;182123;183719;122;365964;14464;186855;201319;0,725416235;0,057611726;0,744264319;0,801876046
215;REGIONAL;30/08/2021;2021;35;RA Madeira;All;1801;5857;2;7660;183924;189576;124;373624;11216;192941;204157;0,732589819;0,04467458;0,768505537;0,813180116
216;REGIONAL;06/09/2021;2021;36;RA Madeira;All;1304;4786;2;6092;185228;194362;126;379716;8157;197947;206104;0,737783797;0,032490241;79%;82%
217;REGIONAL;04/01/2021;2021;1;RA Acores;All;3683;3;1;3687;5724;4;4;5732;5720;4;5724;0,024186903;0,024170001;1,69E-05;0,024186903
218;REGIONAL;11/01/2021;2021;2;RA Acores;All;24;3;0;27;5748;7;4;5759;5741;7;5748;0,024288316;0,024258737;2,96E-05;0,024288316
219;REGIONAL;18/01/2021;2021;3;RA Acores;All;87;1985;5;2077;5835;1992;9;7836;3843;1992;5835;0,024655937;0,016238691;0,008417245;0,024655937
220;REGIONAL;25/01/2021;2021;4;RA Acores;All;315;3613;9;3937;6150;5605;18;11773;545;5605;6150;0,025986977;0,002302911;0,023684066;0,025986977
221;REGIONAL;01/02/2021;2021;5;RA Acores;All;1882;35;1;1918;8032;5640;19;13691;2392;5640;8032;0,033939414;0,010107455;0,023831959;0,033939414
222;REGIONAL;08/02/2021;2021;6;RA Acores;All;1065;55;1;1121;9097;5695;20;14812;3402;5695;9097;0,038439598;0,014375235;0,024064363;0,038439598
223;REGIONAL;15/02/2021;2021;7;RA Acores;All;2096;369;2;2467;11193;6064;22;17279;5129;6064;11193;0,047296298;0,021672716;0,025623582;0,047296298
224;REGIONAL;22/02/2021;2021;8;RA Acores;All;1498;1641;8;3147;12691;7705;30;20426;4985;7706;12691;0,053626134;0,021064241;0,032561893;0,053626134
225;REGIONAL;01/03/2021;2021;9;RA Acores;All;783;1201;5;1989;13474;8906;35;22415;4567;8907;13474;0,05693472;0,019297971;0,037636749;0,05693472
226;REGIONAL;08/03/2021;2021;10;RA Acores;All;2769;2072;3;4844;16243;10978;38;27259;5254;10989;16243;0,068635198;0,022200907;0,046434291;0,068635198
227;REGIONAL;15/03/2021;2021;11;RA Acores;All;2527;1455;9;3991;18770;12433;47;31250;6321;12450;18771;0,079313099;0,026709542;0,052607783;0,079317324
228;REGIONAL;22/03/2021;2021;12;RA Acores;All;4163;749;6;4918;22933;13182;53;36168;9725;13209;22934;0,096903958;0,041093228;0,055814956;0,096908184
229;REGIONAL;29/03/2021;2021;13;RA Acores;All;2223;777;4;3004;25156;13959;57;39172;11168;13990;25158;0,106297299;0,04719066;0,059115091;0,106305751
230;REGIONAL;05/04/2021;2021;14;RA Acores;All;3892;2370;15;6277;29048;16329;72;45449;12676;16378;29054;0,122743042;0,053562751;0,069205644;0,122768395
231;REGIONAL;12/04/2021;2021;15;RA Acores;All;4223;2390;18;6631;33271;18719;90;52080;14493;18785;33278;0,140587432;0,06124053;0,079376482;0,140617011
232;REGIONAL;19/04/2021;2021;16;RA Acores;All;7869;1071;18;8958;41140;19790;108;61038;21234;19913;41147;0,173838086;0,089724792;0,084142873;0,173867665
233;REGIONAL;26/04/2021;2021;17;RA Acores;All;9299;2980;16;12295;50439;22770;124;73333;27507;22956;50463;0,213131241;0,116231508;0,097001145;0,213232653
234;REGIONAL;03/05/2021;2021;18;RA Acores;All;9722;2952;20;12694;60161;25722;144;86027;34257;25961;60218;0,254211792;0,1447538;0,109698847;0,254452647
235;REGIONAL;10/05/2021;2021;19;RA Acores;All;9436;2420;15;11871;69597;28142;159;97898;41243;28414;69657;0,294083843;0,174273315;0,120064059;0,294337374
236;REGIONAL;17/05/2021;2021;20;RA Acores;All;12085;5180;14;17279;81682;33322;173;115177;48115;33634;81749;0,345149309;0,203311121;0,142121298;0,345432419
237;REGIONAL;24/05/2021;2021;21;RA Acores;All;5600;8172;93;13865;87282;41494;266;129042;45528;41831;87359;0,368812247;0,192379689;0,176757924;0,369137613
238;REGIONAL;31/05/2021;2021;22;RA Acores;All;5521;10486;31;16038;92803;51980;297;145080;40593;52354;92947;0,392141369;0,171526724;0,22122312;0,392749845
239;REGIONAL;07/06/2021;2021;23;RA Acores;All;7869;12191;56;20116;100672;64171;353;165196;36243;64597;100840;0,425392023;0,153145692;0,272956219;0,426101911
240;REGIONAL;14/06/2021;2021;24;RA Acores;All;9258;7853;87;17198;109930;72024;440;182394;38049;72513;110562;0,464511931;0,160776989;0,306405473;0,467182462
241;REGIONAL;21/06/2021;2021;25;RA Acores;All;7551;10019;366;17936;117481;82043;806;200330;38051;82617;120668;0,496418868;0,160785441;0,349100175;0,509885615
242;REGIONAL;28/06/2021;2021;26;RA Acores;All;6721;12486;195;19402;124202;94529;1001;219732;33684;95225;128909;0,524818619;0,142332574;0,40237559;0,544708164
243;REGIONAL;05/07/2021;2021;27;RA Acores;All;6207;16309;65;22581;130409;110838;1066;242313;25358;111685;137043;0,551046451;0,107150855;0,471927727;0,579078582
244;REGIONAL;12/07/2021;2021;28;RA Acores;All;2966;11904;56;14926;133375;122742;1122;257239;18049;123689;141738;0,563579357;0,076266495;0,522650925;0,598917421
245;REGIONAL;19/07/2021;2021;29;RA Acores;All;5697;9016;42;14755;139072;131758;1164;271994;16405;132909;149314;0,587652172;0,069319733;0,561610263;0,630929996
246;REGIONAL;26/07/2021;2021;30;RA Acores;All;6990;9010;30;16030;146062;140768;1194;288024;16802;142275;159077;0,617188589;0,070997266;0,601186527;0,672183793
247;REGIONAL;02/08/2021;2021;31;RA Acores;All;9592;6666;24;16282;155654;147434;1218;304306;23058;149262;172320;0,657719822;0,097432149;0,630710268;0,728142417
248;REGIONAL;09/08/2021;2021;32;RA Acores;All;5003;6589;33;11625;160657;154023;1251;315931;22823;156103;178926;0,678860122;0,09643915;0,659617083;0,756056233
249;REGIONAL;16/08/2021;2021;33;RA Acores;All;2350;7325;35;9710;163007;161348;1286;325641;18525;163549;182074;0,688790106;0,078277845;0,69108034;0,769358185
250;REGIONAL;23/08/2021;2021;34;RA Acores;All;5691;9328;14;15033;168698;170676;1300;340674;15179;173003;188182;0,712837567;0,064139239;0,73102845;0,79516769
251;REGIONAL;30/08/2021;2021;35;RA Acores;All;3132;5534;13;8679;171830;176210;1313;349353;12913;178633;191546;0,72607191;0,054564201;0,754818155;0,809382355
252;REGIONAL;06/09/2021;2021;36;RA Acores;All;2077;2669;15;4761;173907;178879;1328;354114;11802;182053;193855;0,734848325;0,049869643;77%;82%
253;REGIONAL;04/01/2021;2021;1;Outro;All;0;0;0;0;0;0;0;0;0;0;0;NA;NA;NA;NA
254;REGIONAL;11/01/2021;2021;2;Outro;All;0;0;0;0;0;0;0;0;0;0;0;NA;NA;NA;NA
255;REGIONAL;18/01/2021;2021;3;Outro;All;0;0;0;0;0;0;0;0;0;0;0;NA;NA;NA;NA
256;REGIONAL;25/01/2021;2021;4;Outro;All;0;0;0;0;0;0;0;0;0;0;0;NA;NA;NA;NA
257;REGIONAL;01/02/2021;2021;5;Outro;All;0;0;0;0;0;0;0;0;0;0;0;NA;NA;NA;NA
258;REGIONAL;08/02/2021;2021;6;Outro;All;0;0;0;0;0;0;0;0;0;0;0;NA;NA;NA;NA
259;REGIONAL;15/02/2021;2021;7;Outro;All;0;0;0;0;0;0;0;0;0;0;0;NA;NA;NA;NA
260;REGIONAL;22/02/2021;2021;8;Outro;All;0;0;0;0;0;0;0;0;0;0;0;NA;NA;NA;NA
261;REGIONAL;01/03/2021;2021;9;Outro;All;0;0;0;0;0;0;0;0;0;0;0;NA;NA;NA;NA
262;REGIONAL;08/03/2021;2021;10;Outro;All;0;0;0;0;0;0;0;0;0;0;0;NA;NA;NA;NA
263;REGIONAL;15/03/2021;2021;11;Outro;All;0;0;0;0;0;0;0;0;0;0;0;NA;NA;NA;NA
264;REGIONAL;22/03/2021;2021;12;Outro;All;0;0;0;0;0;0;0;0;0;0;0;NA;NA;NA;NA
265;REGIONAL;29/03/2021;2021;13;Outro;All;0;0;0;0;0;0;0;0;0;0;0;NA;NA;NA;NA
266;REGIONAL;05/04/2021;2021;14;Outro;All;0;0;0;0;0;0;0;0;0;0;0;NA;NA;NA;NA
267;REGIONAL;12/04/2021;2021;15;Outro;All;0;0;0;0;0;0;0;0;0;0;0;NA;NA;NA;NA
268;REGIONAL;19/04/2021;2021;16;Outro;All;0;0;0;0;0;0;0;0;0;0;0;NA;NA;NA;NA
269;REGIONAL;26/04/2021;2021;17;Outro;All;0;0;0;0;0;0;0;0;0;0;0;NA;NA;NA;NA
270;REGIONAL;03/05/2021;2021;18;Outro;All;0;0;0;0;0;0;0;0;0;0;0;NA;NA;NA;NA
271;REGIONAL;10/05/2021;2021;19;Outro;All;0;0;0;0;0;0;0;0;0;0;0;NA;NA;NA;NA
272;REGIONAL;17/05/2021;2021;20;Outro;All;0;0;0;0;0;0;0;0;0;0;0;NA;NA;NA;NA
273;REGIONAL;24/05/2021;2021;21;Outro;All;0;0;0;0;0;0;0;0;0;0;0;NA;NA;NA;NA
274;REGIONAL;31/05/2021;2021;22;Outro;All;0;0;0;0;0;0;0;0;0;0;0;NA;NA;NA;NA
275;REGIONAL;07/06/2021;2021;23;Outro;All;0;0;0;0;0;0;0;0;0;0;0;NA;NA;NA;NA
276;REGIONAL;14/06/2021;2021;24;Outro;All;0;0;0;0;0;0;0;0;0;0;0;NA;NA;NA;NA
277;REGIONAL;21/06/2021;2021;25;Outro;All;0;0;0;0;0;0;0;0;0;0;0;NA;NA;NA;NA
278;REGIONAL;28/06/2021;2021;26;Outro;All;0;0;0;0;0;0;0;0;0;0;0;NA;NA;NA;NA
279;REGIONAL;05/07/2021;2021;27;Outro;All;0;0;0;0;0;0;0;0;0;0;0;NA;NA;NA;NA
280;REGIONAL;12/07/2021;2021;28;Outro;All;0;0;0;0;0;0;0;0;0;0;0;NA;NA;NA;NA
281;REGIONAL;19/07/2021;2021;29;Outro;All;0;0;0;0;0;0;0;0;0;0;0;NA;NA;NA;NA
282;REGIONAL;26/07/2021;2021;30;Outro;All;0;0;0;0;0;0;0;0;0;0;0;NA;NA;NA;NA
283;REGIONAL;02/08/2021;2021;31;Outro;All;0;0;0;0;0;0;0;0;0;0;0;NA;NA;NA;NA
284;REGIONAL;09/08/2021;2021;32;Outro;All;0;0;0;0;0;0;0;0;0;0;0;NA;NA;NA;NA
285;REGIONAL;16/08/2021;2021;33;Outro;All;0;0;0;0;0;0;0;0;0;0;0;NA;NA;NA;NA
286;REGIONAL;23/08/2021;2021;34;Outro;All;0;0;0;0;0;0;0;0;0;0;0;NA;NA;NA;NA
287;REGIONAL;30/08/2021;2021;35;Outro;All;0;0;0;0;0;0;0;0;0;0;0;NA;NA;NA;NA
288;REGIONAL;06/09/2021;2021;36;Outro;All;0;0;0;0;0;0;0;0;0;0;0;NA;NA;NA;NA
289;AGES;04/01/2021;2021;1;All;12-17 anos;5;0;0;5;7;0;0;7;7;0;7;1,12E-05;1,12E-05;0;1,12E-05
290;AGES;11/01/2021;2021;2;All;12-17 anos;15;0;0;15;22;0;0;22;22;0;22;3,53E-05;3,53E-05;0;3,53E-05
291;AGES;18/01/2021;2021;3;All;12-17 anos;70;1;0;71;92;1;0;93;91;1;92;0,000147794;0,000146187;1,61E-06;0,000147794
292;AGES;25/01/2021;2021;4;All;12-17 anos;15;3;0;18;107;4;0;111;103;4;107;0,000171891;0,000165465;6,43E-06;0,000171891
293;AGES;01/02/2021;2021;5;All;12-17 anos;35;4;0;39;142;8;0;150;134;8;142;0,000228116;0,000215265;1,29E-05;0,000228116
294;AGES;08/02/2021;2021;6;All;12-17 anos;38;66;0;104;180;74;0;254;106;74;180;0,000289162;0,000170284;0,000118878;0,000289162
295;AGES;15/02/2021;2021;7;All;12-17 anos;32;16;0;48;212;90;0;302;122;90;212;0,000340568;0,000195987;0,000144581;0,000340568
296;AGES;22/02/2021;2021;8;All;12-17 anos;23;32;0;55;235;122;0;357;113;122;235;0,000377517;0,000181529;0,000195987;0,000377517
297;AGES;01/03/2021;2021;9;All;12-17 anos;12;30;0;42;247;152;0;399;95;152;247;0,000396794;0,000152613;0,000244181;0,000396794
298;AGES;08/03/2021;2021;10;All;12-17 anos;19;25;0;44;266;177;0;443;88;178;266;0,000427317;0,000141368;0,000285949;0,000427317
299;AGES;15/03/2021;2021;11;All;12-17 anos;5;23;0;28;271;200;0;471;70;201;271;0,000435349;0,000112452;0,000322897;0,000435349
300;AGES;22/03/2021;2021;12;All;12-17 anos;32;11;0;43;303;211;0;514;91;212;303;0,000486756;0,000146187;0,000340568;0,000486756
301;AGES;29/03/2021;2021;13;All;12-17 anos;15;14;0;29;318;225;0;543;92;226;318;0,000510852;0,000147794;0,000363059;0,000510852
302;AGES;05/04/2021;2021;14;All;12-17 anos;29;5;0;34;347;230;0;577;116;231;347;0,00055744;0,000186349;0,000371091;0,00055744
303;AGES;12/04/2021;2021;15;All;12-17 anos;47;7;0;54;394;237;0;631;156;238;394;0,000632943;0,000250607;0,000382336;0,000632943
304;AGES;19/04/2021;2021;16;All;12-17 anos;31;14;0;45;425;251;0;676;171;254;425;0,000682743;0,000274704;0,000408039;0,000682743
305;AGES;26/04/2021;2021;17;All;12-17 anos;50;26;0;76;475;277;0;752;194;281;475;0,000763066;0,000311652;0,000451414;0,000763066
306;AGES;03/05/2021;2021;18;All;12-17 anos;110;15;0;125;585;292;0;877;288;297;585;0,000939776;0,000462659;0,000477117;0,000939776
307;AGES;10/05/2021;2021;19;All;12-17 anos;164;44;0;208;749;336;0;1085;408;341;749;0,001203234;0,000655433;0,000547801;0,001203234
308;AGES;17/05/2021;2021;20;All;12-17 anos;314;26;0;340;1063;362;0;1425;696;367;1063;0,001707661;0,001118092;0,000589569;0,001707661
309;AGES;24/05/2021;2021;21;All;12-17 anos;301;40;0;341;1364;402;0;1766;951;413;1364;0,002191203;0,001527738;0,000663466;0,002191203
310;AGES;31/05/2021;2021;22;All;12-17 anos;274;113;0;387;1638;515;0;2153;1101;537;1638;0,002631372;0,001768706;0,000862666;0,002631372
311;AGES;07/06/2021;2021;23;All;12-17 anos;396;165;0;561;2034;680;0;2714;1327;708;2035;0,003267528;0,002131765;0,001137369;0,003269134
312;AGES;14/06/2021;2021;24;All;12-17 anos;581;332;0;913;2615;1012;0;3627;1572;1045;2617;0,004200877;0,002525346;0,001678745;0,00420409
313;AGES;21/06/2021;2021;25;All;12-17 anos;407;290;2;699;3022;1302;2;4326;1683;1345;3028;0,004854704;0,002703662;0,002160681;0,004864343
314;AGES;28/06/2021;2021;26;All;12-17 anos;219;278;0;497;3241;1580;2;4823;1619;1628;3247;0,005206518;0,002600849;0,002615307;0,005216156
315;AGES;05/07/2021;2021;27;All;12-17 anos;432;658;1;1091;3673;2238;3;5914;1382;2297;3679;0,005900506;0,00222012;0,003690025;0,005910145
316;AGES;12/07/2021;2021;28;All;12-17 anos;265;316;2;583;3938;2554;5;6497;1325;2634;3959;0,006326216;0,002128552;0,0042314;0,006359952
317;AGES;19/07/2021;2021;29;All;12-17 anos;265;270;1;536;4203;2824;6;7033;1307;2928;4235;0,006751927;0,002099635;0,004703698;0,006803333
318;AGES;26/07/2021;2021;30;All;12-17 anos;1619;381;0;2000;5822;3205;6;9033;2506;3357;5863;0,009352776;0,004025774;0,005392866;0,00941864
319;AGES;02/08/2021;2021;31;All;12-17 anos;4595;203;1;4799;10417;3408;7;13832;6766;3721;10487;0,016734432;0,010869268;0,005977616;0,016846884
320;AGES;09/08/2021;2021;32;All;12-17 anos;142633;408;2;143043;153050;3816;9;156875;137856;15388;153244;0,245867798;0,221459335;0,024720116;0,246179451
321;AGES;16/08/2021;2021;33;All;12-17 anos;177781;1569;1;179351;330831;5385;10;336226;301890;29201;331091;0,531464813;0,484972425;0,046910066;0,531882491
322;AGES;23/08/2021;2021;34;All;12-17 anos;131938;3932;3;135873;462769;9317;13;472099;421051;42003;463054;0,743417153;0,676399101;0,067475891;0,743874992
323;AGES;30/08/2021;2021;35;All;12-17 anos;41955;109945;13;151913;504724;119262;26;624012;348358;156658;505016;0,810815934;0,559621134;0,251663885;0,811285019
324;AGES;06/09/2021;2021;36;All;12-17 anos;20407;162236;15;182658;525131;281498;41;806670;204718;320708;525426;0,843598843;33%;52%;84%
325;AGES;04/01/2021;2021;1;All;18-24 anos;1840;2;0;1842;3205;3;0;3208;3201;4;3205;0,004102794;0,004097673;5,12E-06;0,004102794
326;AGES;11/01/2021;2021;2;All;18-24 anos;1437;56;0;1493;4642;59;0;4701;4581;61;4642;0,00594233;0,005864243;7,81E-05;0,00594233
327;AGES;18/01/2021;2021;3;All;18-24 anos;3861;1199;0;5060;8503;1258;0;9761;7240;1263;8503;0,010884885;0,00926809;0,001616795;0,010884885
328;AGES;25/01/2021;2021;4;All;18-24 anos;1395;1644;1;3040;9898;2902;1;12801;6992;2908;9900;0,012670656;0,008950619;0,003722597;0,012673217
329;AGES;01/02/2021;2021;5;All;18-24 anos;989;944;0;1933;10887;3846;1;14734;7036;3854;10890;0,013936698;0,009006945;0,004933594;0,013940538
330;AGES;08/02/2021;2021;6;All;18-24 anos;1474;3072;0;4546;12361;6918;1;19280;5426;6938;12364;0,015823599;0,006945947;0,008881493;0,015827439
331;AGES;15/02/2021;2021;7;All;18-24 anos;2327;1746;1;4074;14688;8664;2;23354;5965;8726;14691;0,018802445;0,007635933;0,011170352;0,018806285
332;AGES;22/02/2021;2021;8;All;18-24 anos;1329;699;0;2028;16017;9363;2;25382;6569;9451;16020;0,020503728;0,008409127;0,012098441;0,020507569
333;AGES;01/03/2021;2021;9;All;18-24 anos;950;1040;1;1991;16967;10403;3;27373;6456;10516;16972;0,021719845;0,008264473;0,013461772;0,021726246
334;AGES;08/03/2021;2021;10;All;18-24 anos;1379;644;1;2024;18346;11047;4;29397;7181;11173;18354;0,023485135;0,009192562;0,014302813;0,023495376
335;AGES;15/03/2021;2021;11;All;18-24 anos;272;394;2;668;18618;11441;6;30065;7058;11569;18627;0,023833328;0,009035107;0,014809742;0,023844849
336;AGES;22/03/2021;2021;12;All;18-24 anos;3231;171;0;3402;21849;11612;6;33467;10100;11759;21859;0,027969405;0,012929241;0,015052965;0,027982206
337;AGES;29/03/2021;2021;13;All;18-24 anos;680;99;0;779;22529;11711;6;34246;10668;11873;22541;0,028839889;0,013656351;0,015198899;0,02885525
338;AGES;05/04/2021;2021;14;All;18-24 anos;801;177;0;978;23330;11888;6;35224;11299;12056;23355;0,029865267;0,014464109;0,015433162;0,02989727
339;AGES;12/04/2021;2021;15;All;18-24 anos;4296;99;0;4395;27626;11987;6;39619;15486;12172;27658;0,035364675;0,019823983;0,015581656;0,035405639
340;AGES;19/04/2021;2021;16;All;18-24 anos;1306;102;0;1408;28932;12089;6;41027;16649;12315;28964;0,037036516;0,021312766;0,015764713;0,037077479
341;AGES;26/04/2021;2021;17;All;18-24 anos;2673;176;0;2849;31605;12265;6;43876;19147;12520;31667;0,040458284;0,024510513;0,016027139;0,040537652
342;AGES;03/05/2021;2021;18;All;18-24 anos;1843;835;0;2678;33448;13100;6;46554;20170;13390;33560;0,04281755;0,025820079;0,017140846;0,042960924
343;AGES;10/05/2021;2021;19;All;18-24 anos;2241;5411;0;7652;35689;18511;6;54206;16979;18837;35816;0,045686306;0,021735207;0,024113675;0,045848881
344;AGES;17/05/2021;2021;20;All;18-24 anos;2100;2466;0;4566;37789;20977;6;58772;16549;21372;37921;0,048374564;0,021184754;0,027358786;0,04854354
345;AGES;24/05/2021;2021;21;All;18-24 anos;2265;3283;0;5548;40054;24260;6;64320;15332;24874;40206;0,051274042;0,019626844;0,031841777;0,051468621
346;AGES;31/05/2021;2021;22;All;18-24 anos;2353;2679;2;5034;42407;26939;8;69354;14758;27810;42568;0,054286171;0,018892054;0,035600218;0,054492271
347;AGES;07/06/2021;2021;23;All;18-24 anos;2828;2916;1;5745;45235;29855;9;75099;14476;30949;45425;0,057906359;0,018531059;0,039618523;0,058149582
348;AGES;14/06/2021;2021;24;All;18-24 anos;3078;4559;2;7639;48313;34414;11;82738;13008;35774;48782;0,061846577;0,016651839;0,045795116;0,062446955
349;AGES;21/06/2021;2021;25;All;18-24 anos;2803;3011;7;5821;51116;37425;18;88559;12961;39131;52092;0,065434762;0,016591673;0,050092489;0,066684162
350;AGES;28/06/2021;2021;26;All;18-24 anos;2043;3067;7;5117;53159;40492;25;93676;12192;42436;54628;0,068050053;0,015607258;0,054323295;0,069930553
351;AGES;05/07/2021;2021;27;All;18-24 anos;11809;5067;12;16888;64968;45559;37;110564;19613;48443;68056;0,083167024;0,02510705;0,062012993;0,087120044
352;AGES;12/07/2021;2021;28;All;18-24 anos;14090;7816;7;21913;79058;53375;44;132477;30780;57497;88277;0,101203956;0,039402183;0,073603226;0,113005409
353;AGES;19/07/2021;2021;29;All;18-24 anos;19453;19624;0;39077;98511;72999;44;171554;45865;79187;125052;0,126106186;0,058712836;0,101369091;0,160081928
354;AGES;26/07/2021;2021;30;All;18-24 anos;20944;22556;11;43511;119455;95555;55;215065;61425;104003;165428;0,15291708;0,078631549;0,133136621;0,21176817
355;AGES;02/08/2021;2021;31;All;18-24 anos;53814;56382;4;110200;173269;151937;59;325265;101196;166049;267245;0,221805613;0,129543316;0,212563126;0,342106442
356;AGES;09/08/2021;2021;32;All;18-24 anos;87438;82468;7;169913;260707;234405;66;495178;164955;259789;424744;0,333736999;0,211162672;0,332561846;0,543724518
357;AGES;16/08/2021;2021;33;All;18-24 anos;94039;74205;12;168256;354746;308610;78;663434;228959;345870;574829;0,454118475;0,293095657;0,442756105;0,735851762
358;AGES;23/08/2021;2021;34;All;18-24 anos;56108;43620;6;99734;410854;352230;84;763168;249149;396068;645217;0,525943611;0,318941338;0,507015714;0,825957052
359;AGES;30/08/2021;2021;35;All;18-24 anos;22578;100236;5;122819;433432;452466;89;885987;170728;500680;671408;0,554846225;0,218552821;0,640931929;0,859484751
360;AGES;06/09/2021;2021;36;All;18-24 anos;12797;78258;16;91071;446229;530724;105;977058;104111;580984;685095;0,571227958;13%;74%;88%
361;AGES;04/01/2021;2021;1;All;25-49 anos;27919;67;0;27986;51931;77;2;52010;51858;80;51938;0,015587588;0,015565676;2,40E-05;0,015589689
362;AGES;11/01/2021;2021;2;All;25-49 anos;16762;806;0;17568;68693;883;2;69578;67804;896;68700;0,020618863;0,020352021;0,000268943;0,020620964
363;AGES;18/01/2021;2021;3;All;25-49 anos;37754;21821;6;59581;106447;22704;8;129159;83699;22756;106455;0,031951088;0,025123058;0,006830432;0,03195349
364;AGES;25/01/2021;2021;4;All;25-49 anos;15771;26272;10;42053;122218;48976;18;171212;73176;49050;122226;0,036684905;0,021964479;0,014722828;0,036687307
365;AGES;01/02/2021;2021;5;All;25-49 anos;10098;12574;2;22674;132316;61550;20;193886;70697;61633;132330;0,039715917;0,021220383;0,018499736;0,039720119
366;AGES;08/02/2021;2021;6;All;25-49 anos;13908;30931;5;44844;146224;92481;25;238730;53564;92674;146238;0,043890537;0,016077749;0,02781699;0,043894739
367;AGES;15/02/2021;2021;7;All;25-49 anos;22429;19076;6;41511;168653;111557;31;280241;56578;112089;168667;0,050622816;0,01698243;0,033644589;0,050627018
368;AGES;22/02/2021;2021;8;All;25-49 anos;11681;7343;2;19026;180334;118900;33;299267;60679;119669;180348;0,05412898;0,018213384;0,035919799;0,054133183
369;AGES;01/03/2021;2021;9;All;25-49 anos;7656;10037;6;17699;187990;128937;39;316966;58130;129885;188015;0,056427002;0,017448277;0,038986229;0,056434506
370;AGES;08/03/2021;2021;10;All;25-49 anos;16461;6290;2;22753;204451;135227;41;339719;68156;136337;204493;0,061367929;0,020457677;0,040922859;0,061380536
371;AGES;15/03/2021;2021;11;All;25-49 anos;4694;3322;5;8021;209145;138549;46;347740;69497;139699;209196;0,062776878;0,020860191;0,041931995;0,062792187
372;AGES;22/03/2021;2021;12;All;25-49 anos;42412;1690;0;44102;251557;140239;46;391842;110041;141574;251615;0,075507247;0,033029862;0,042494794;0,075524656
373;AGES;29/03/2021;2021;13;All;25-49 anos;4731;1164;2;5897;256288;141403;48;397739;113562;142809;256371;0,076927302;0,034086724;0,042865492;0,076952215
374;AGES;05/04/2021;2021;14;All;25-49 anos;9127;1311;1;10439;265415;142714;49;408178;121327;144230;265557;0,079666859;0,036417463;0,043292018;0,079709482
375;AGES;12/04/2021;2021;15;All;25-49 anos;89325;853;0;90178;354740;143567;49;498356;209666;145229;354895;0,106478615;0,062933262;0,043591878;0,106525139
376;AGES;19/04/2021;2021;16;All;25-49 anos;11168;907;1;12076;365908;144474;50;510432;219552;146516;366068;0,109830797;0,065900639;0,043978183;0,109878823
377;AGES;26/04/2021;2021;17;All;25-49 anos;11146;1010;3;12159;377054;145484;53;522591;229603;147685;377288;0,113176376;0,068917543;0,04432907;0,113246613
378;AGES;03/05/2021;2021;18;All;25-49 anos;10472;8131;4;18607;387526;153615;57;541198;231826;156033;387859;0,116319647;0,069584798;0,046834802;0,1164196
379;AGES;10/05/2021;2021;19;All;25-49 anos;25235;100458;9;125702;412761;254073;66;666900;156281;256911;413192;0,123894175;0,046909242;0,077114302;0,124023543
380;AGES;17/05/2021;2021;20;All;25-49 anos;32752;22074;7;54833;445513;276147;73;721733;166309;279772;446081;0,133725002;0,049919242;0,08397625;0,133895492
381;AGES;24/05/2021;2021;21;All;25-49 anos;26440;18461;6;44907;471953;294608;79;766640;172370;300418;472788;0,141661221;0,051738509;0,090173345;0,141911855
382;AGES;31/05/2021;2021;22;All;25-49 anos;42669;23916;23;66608;514622;318524;102;833248;189005;326838;515843;0,154468731;0,056731664;0,098103562;0,154835226
383;AGES;07/06/2021;2021;23;All;25-49 anos;128389;32175;22;160586;643011;350699;124;993834;281987;364331;646318;0,193005921;0,084641104;0,109357445;0,193998549
384;AGES;14/06/2021;2021;24;All;25-49 anos;240396;85576;41;326013;883407;436275;165;1319847;443987;460001;903988;0,265163087;0,133266958;0,138073714;0,271340672
385;AGES;21/06/2021;2021;25;All;25-49 anos;273045;56353;161;329559;1156452;492628;326;1649406;672355;530168;1202523;0,347120164;0,201813804;0,159135012;0,360948816
386;AGES;28/06/2021;2021;26;All;25-49 anos;315443;61676;122;377241;1471895;554304;448;2026647;925215;609537;1534752;0,441803407;0,27771216;0,182958379;0,460670539
387;AGES;05/07/2021;2021;27;All;25-49 anos;368725;147411;19;516155;1840620;701715;467;2542802;1150977;780778;1931755;0,552479753;0,34547679;0,234358008;0,579834798
388;AGES;12/07/2021;2021;28;All;25-49 anos;208353;316540;59;524952;2048973;1018255;526;3067754;1116915;1118799;2235714;0,615018906;0,335252754;0,335818255;0,671071008
389;AGES;19/07/2021;2021;29;All;25-49 anos;103668;343699;52;447419;2152641;1361954;578;3515173;954702;1478560;2433262;0,64613585;0,286562966;0,443803971;0,730366936
390;AGES;26/07/2021;2021;30;All;25-49 anos;61430;353748;30;415208;2214071;1715702;608;3930381;711486;1846444;2557930;0,664574654;0,21355935;0,554227883;0,767787232
391;AGES;02/08/2021;2021;31;All;25-49 anos;52588;382965;36;435589;2266659;2098667;644;4365970;418405;2243982;2662387;0,680359447;0,125588275;0,673552728;0,799141003
392;AGES;09/08/2021;2021;32;All;25-49 anos;70412;237154;34;307600;2337071;2335821;678;4673570;291848;2500133;2791981;0,701494285;0,087600977;0,750438908;0,838039886
393;AGES;16/08/2021;2021;33;All;25-49 anos;77881;145006;31;222918;2414952;2480827;709;4896488;252590;2660850;2913440;0,724871014;0,075817312;0,798679658;0,87449697
394;AGES;23/08/2021;2021;34;All;25-49 anos;88054;79450;14;167518;2503006;2560277;723;5064006;265046;2756589;3021635;0,751301267;0,0795561;0,827416637;0,906972737
395;AGES;30/08/2021;2021;35;All;25-49 anos;46332;80106;14;126452;2549338;2640383;737;5190458;225368;2850039;3075407;0,765208261;0,067646368;0,855466552;0,923112919
396;AGES;06/09/2021;2021;36;All;25-49 anos;24714;63214;66;87994;2574052;2703597;803;5278452;182662;2919262;3101924;0,772626405;5%;88%;93%
397;AGES;04/01/2021;2021;1;All;50-64 anos;12996;5;0;13001;22251;5;0;22256;22248;6;22254;0,010234199;0,010232819;2,76E-06;0,010235578
398;AGES;11/01/2021;2021;2;All;50-64 anos;11696;308;0;12004;33947;313;0;34260;33625;325;33950;0,015613695;0,015465594;0,000149482;0,015615075
399;AGES;18/01/2021;2021;3;All;50-64 anos;27448;8599;2;36049;61395;8912;2;70309;52452;8946;61398;0,028238219;0,024124946;0,004114653;0,028239599
400;AGES;25/01/2021;2021;4;All;50-64 anos;10786;12418;4;23208;72181;21330;6;93517;50807;21377;72184;0,033199168;0,02336834;0,009832208;0,033200548
401;AGES;01/02/2021;2021;5;All;50-64 anos;5563;9224;0;14787;77744;30554;6;108304;47141;30608;77749;0,035757832;0,021682187;0,014077945;0,035760132
402;AGES;08/02/2021;2021;6;All;50-64 anos;6910;22289;3;29202;84654;52843;9;137506;31707;52952;84659;0,038936041;0,014583422;0,024354918;0,03893834
403;AGES;15/02/2021;2021;7;All;50-64 anos;25135;12968;1;38104;109789;65811;10;175610;43753;66041;109794;0,050496716;0,0201239;0,030375116;0,050499015
404;AGES;22/02/2021;2021;8;All;50-64 anos;49844;4966;4;54814;159633;70777;14;230424;88455;71183;159638;0,07342213;0,040684285;0,032740144;0,07342443
405;AGES;01/03/2021;2021;9;All;50-64 anos;30207;5993;3;36203;189840;76770;17;266627;112590;77260;189850;0,087315637;0,051785017;0,03553522;0,087320237
406;AGES;08/03/2021;2021;10;All;50-64 anos;22353;4286;1;26640;212193;81056;18;293267;130589;81623;212212;0,09759675;0,060063537;0,037541953;0,097605489
407;AGES;15/03/2021;2021;11;All;50-64 anos;4660;2325;1;6986;216853;83381;19;300253;132919;83971;216890;0,099740086;0,061135204;0,038621899;0,099757104
408;AGES;22/03/2021;2021;12;All;50-64 anos;34622;985;2;35609;251475;84366;21;335862;166425;85095;251520;0,115664243;0,076546065;0,039138876;0,115684941
409;AGES;29/03/2021;2021;13;All;50-64 anos;7818;777;1;8596;259293;85143;22;344458;173459;85896;259355;0,11926008;0,079781306;0,03950729;0,119288596
410;AGES;05/04/2021;2021;14;All;50-64 anos;15214;960;1;16175;274507;86103;23;360633;187665;86943;274608;0,126257657;0,086315261;0,039988851;0,126304112
411;AGES;12/04/2021;2021;15;All;50-64 anos;88034;595;0;88629;362541;86698;23;449262;275022;87631;362653;0,166748307;0,126494528;0,040305292;0,16679982
412;AGES;19/04/2021;2021;16;All;50-64 anos;14468;1822;4;16294;377009;88520;27;465556;287420;89703;377123;0,173402766;0,132196905;0,041258295;0,1734552
413;AGES;26/04/2021;2021;17;All;50-64 anos;32963;2960;4;35927;409972;91480;31;501483;317546;92804;410350;0,188563878;0,146053157;0,042684579;0,188737736
414;AGES;03/05/2021;2021;18;All;50-64 anos;151530;14836;9;166375;561502;106316;40;667858;459544;107997;567541;0,258259087;0,211364187;0,049672497;0,261036685
415;AGES;10/05/2021;2021;19;All;50-64 anos;166723;109810;11;276544;728225;216126;51;944402;525555;218429;743984;0,334942215;0,241725505;0,100464957;0,342190462
416;AGES;17/05/2021;2021;20;All;50-64 anos;224790;75830;12;300632;953015;291956;63;1245034;689322;297700;987022;0,438332871;0,317049041;0,136925123;0,453974163
417;AGES;24/05/2021;2021;21;All;50-64 anos;175300;98505;81;273886;1128315;390461;144;1518920;800853;405602;1206455;0,518960933;0,368346978;0,186553925;0,554900903
418;AGES;31/05/2021;2021;22;All;50-64 anos;163716;168895;14;332625;1292031;559356;158;1851545;837414;582723;1420137;0,594261011;0,385162965;0,268019544;0,653182509
419;AGES;07/06/2021;2021;23;All;50-64 anos;209917;139301;40;349258;1501948;698657;198;2200803;920588;733048;1653636;0,690810931;0,423418289;0,337160522;0,760578811
420;AGES;14/06/2021;2021;24;All;50-64 anos;86330;231203;62;317595;1588278;929860;260;2518398;785562;970892;1756454;0,730517836;0,361313984;0,446555278;0,807869262
421;AGES;21/06/2021;2021;25;All;50-64 anos;86566;183797;211;270574;1674844;1113657;471;2788972;696377;1162612;1858989;0,770333289;0,320293941;0,534735608;0,855029549
422;AGES;28/06/2021;2021;26;All;50-64 anos;59390;178924;72;238386;1734234;1292581;543;3027358;576319;1349048;1925367;0,797649322;0,265074067;0,620485599;0,885559666
423;AGES;05/07/2021;2021;27;All;50-64 anos;41433;258076;47;299556;1775667;1550657;590;3326914;359232;1614571;1973803;0,816706153;0,165226354;0,742611126;0,90783748
424;AGES;12/07/2021;2021;28;All;50-64 anos;15422;134508;32;149962;1791089;1685165;622;3476876;245063;1755294;2000357;0,823799398;0,112715087;0,807335728;0,920050815
425;AGES;19/07/2021;2021;29;All;50-64 anos;10928;114975;25;125928;1802017;1800140;647;3602804;152799;1876977;2029776;0,828825659;0,070278877;0,863303009;0,933581887
426;AGES;26/07/2021;2021;30;All;50-64 anos;9828;87367;20;97215;1811845;1887507;667;3700019;85209;1971109;2056318;0,833345982;0,039191309;0,906598393;0,945789702
427;AGES;02/08/2021;2021;31;All;50-64 anos;8609;53919;13;62541;1820454;1941426;680;3762560;48347;2031172;2079519;0,837305634;0,022236879;0,934223968;0,956460847
428;AGES;09/08/2021;2021;32;All;50-64 anos;7347;24303;5;31655;1827801;1965729;685;3794215;37267;2060708;2097975;0,840684837;0,017140707;0,947808853;0,96494956
429;AGES;16/08/2021;2021;33;All;50-64 anos;7518;12969;12;20499;1835319;1978698;697;3814714;35110;2077907;2113017;0,844142691;0,01614861;0,955719418;0,971868028
430;AGES;23/08/2021;2021;34;All;50-64 anos;11289;8187;2;19478;1846608;1986885;699;3834192;38393;2090877;2129270;0,849334991;0,017658603;0,961684883;0,979343486
431;AGES;30/08/2021;2021;35;All;50-64 anos;12868;6047;10;18925;1859476;1992932;709;3853117;42891;2102333;2145224;0,855253541;0,019727428;0,966953993;0,986681422
432;AGES;06/09/2021;2021;36;All;50-64 anos;5526;3942;45;9513;1865002;1996874;754;3862630;42803;2108574;2151377;0,857795188;2%;97%;99%
433;AGES;04/01/2021;2021;1;All;65-79 anos;2303;2;0;2305;3266;3;0;3269;3263;3;3266;0,002006071;0,002004228;1,84E-06;0,002006071
434;AGES;11/01/2021;2021;2;All;65-79 anos;5544;29;0;5573;8810;32;0;8842;8769;41;8810;0,005411355;0,005386172;2,52E-05;0,005411355
435;AGES;18/01/2021;2021;3;All;65-79 anos;14125;918;0;15043;22935;950;0;23885;21956;979;22935;0,014087336;0,013486006;0,00060133;0,014087336
436;AGES;25/01/2021;2021;4;All;65-79 anos;6559;2153;0;8712;29494;3103;0;32597;26346;3148;29494;0,018116062;0,01618247;0,001933592;0,018116062
437;AGES;01/02/2021;2021;5;All;65-79 anos;2795;4179;0;6974;32289;7282;0;39571;24961;7328;32289;0,019832832;0,015331763;0,004501068;0,019832832
438;AGES;08/02/2021;2021;6;All;65-79 anos;3785;11544;2;15331;36074;18826;2;54902;17181;18893;36074;0,022157687;0,010553064;0,011604623;0,022157687
439;AGES;15/02/2021;2021;7;All;65-79 anos;5124;7254;0;12378;41198;26080;2;67280;15019;26179;41198;0,025304995;0,009225101;0,016079894;0,025304995
440;AGES;22/02/2021;2021;8;All;65-79 anos;11664;2473;4;14141;52862;28553;6;81421;24151;28711;52862;0,032469359;0,014834238;0,017635121;0,032469359
441;AGES;01/03/2021;2021;9;All;65-79 anos;13292;3810;1;17103;66154;32363;7;98524;33621;32542;66163;0,040633687;0,020650984;0,019988231;0,040639216
442;AGES;08/03/2021;2021;10;All;65-79 anos;15926;3580;0;19506;82080;35943;7;118030;45955;36148;82103;0,050415894;0,028226881;0,02220314;0,050430022
443;AGES;15/03/2021;2021;11;All;65-79 anos;18155;6842;4;25001;100235;42785;11;143031;57266;43000;100266;0,061567217;0,035174423;0,026411835;0,061586258
444;AGES;22/03/2021;2021;12;All;65-79 anos;52821;2206;3;55030;153056;44991;14;198061;107827;45268;153095;0,094011393;0,066230441;0,027804906;0,094035348
445;AGES;29/03/2021;2021;13;All;65-79 anos;88278;7376;1;95655;241334;52367;15;293716;188700;52686;241386;0,148234277;0,115904962;0,032361255;0,148266217
446;AGES;05/04/2021;2021;14;All;65-79 anos;201386;5345;8;206739;442720;57712;23;500455;384642;58147;442789;0,271931344;0,236258168;0,035715558;0,271973726
447;AGES;12/04/2021;2021;15;All;65-79 anos;233744;3598;8;237350;676464;61310;31;737805;614664;61873;676537;0,415503625;0,377544289;0,038004174;0,415548463
448;AGES;19/04/2021;2021;16;All;65-79 anos;175810;13243;12;189065;852274;74553;43;926870;777059;75291;852350;0,523491178;0,477291964;0,046245895;0,523537859
449;AGES;26/04/2021;2021;17;All;65-79 anos;293266;46387;11;339664;1145540;120940;54;1266534;1024702;121916;1146618;0,703623581;0,62940141;0,07488431;0,70428572
450;AGES;03/05/2021;2021;18;All;65-79 anos;202474;164279;10;366763;1348014;285219;64;1633297;1069165;286465;1355630;0,827988929;0,656711862;0,175955034;0,832666895
451;AGES;10/05/2021;2021;19;All;65-79 anos;91540;80249;10;171799;1439554;365468;74;1805096;1087838;367164;1455002;0,884215427;0,668181355;0,225522678;0,893704033
452;AGES;17/05/2021;2021;20;All;65-79 anos;41311;111740;11;153062;1480865;477208;85;1958158;1017165;484343;1501508;0,90958983;0,624771968;0,297497386;0,922269354
453;AGES;24/05/2021;2021;21;All;65-79 anos;23619;202630;27;226276;1504484;679838;112;2184434;833949;695816;1529765;0,924097299;0,512235436;0,427390179;0,939625615
454;AGES;31/05/2021;2021;22;All;65-79 anos;18690;137535;14;156239;1523174;817373;126;2340673;717712;836452;1554164;0,935577234;0,440839331;0,513772851;0,954612182
455;AGES;07/06/2021;2021;23;All;65-79 anos;16094;71680;8;87782;1539268;889053;134;2428455;661391;910987;1572378;0,945462631;0,406245355;0,559554389;0,965799744
456;AGES;14/06/2021;2021;24;All;65-79 anos;10899;62615;12;73526;1550167;951668;146;2501981;608949;975684;1584633;0,95215711;0,374033972;0,599293146;0,973327117
457;AGES;21/06/2021;2021;25;All;65-79 anos;10304;97195;21;107520;1560471;1048863;167;2609501;521393;1075463;1596856;0,958486123;0,320254561;0,660580274;0,980834835
458;AGES;28/06/2021;2021;26;All;65-79 anos;9071;182287;42;191400;1569542;1231150;209;2800901;346734;1260580;1607314;0,964057792;0,212973985;0,774284454;0,987258439
459;AGES;05/07/2021;2021;27;All;65-79 anos;8166;203942;24;212132;1577708;1435092;233;3013033;149092;1467483;1616575;0,969073583;0,09157659;0,901370221;0,992946811
460;AGES;12/07/2021;2021;28;All;65-79 anos;5491;57750;12;63253;1583199;1492842;245;3076286;95835;1528504;1624339;0,972446313;0,05886461;0,938851073;0,997715683
461;AGES;19/07/2021;2021;29;All;65-79 anos;7144;42583;9;49736;1590343;1535425;254;3126022;58072;1576144;1634216;0,976834363;0,035669491;0,96811293;1
462;AGES;26/07/2021;2021;30;All;65-79 anos;8623;32382;7;41012;1598966;1567807;261;3167034;30461;1614591;1645052;0,982130858;0,018710021;0,991728182;1
463;AGES;02/08/2021;2021;31;All;65-79 anos;7613;11708;4;19325;1606579;1579515;265;3186359;22595;1631880;1654475;0,986806981;0,013878498;1;1
464;AGES;09/08/2021;2021;32;All;65-79 anos;4595;6268;2;10865;1611174;1585783;267;3197224;19311;1641220;1660531;0,989629362;0,011861371;1;1
465;AGES;16/08/2021;2021;33;All;65-79 anos;3688;2972;7;6667;1614862;1588755;274;3203891;18984;1646390;1665374;0,991894638;0,011660518;1;1
466;AGES;23/08/2021;2021;34;All;65-79 anos;4298;2499;1;6798;1619160;1591254;275;3210689;19991;1651017;1671008;0,994534593;0,012279047;1;1
467;AGES;30/08/2021;2021;35;All;65-79 anos;4891;2235;4;7130;1624051;1593489;279;3217819;21525;1655541;1677066;0,997538785;0,013221273;1;1
468;AGES;06/09/2021;2021;36;All;65-79 anos;2238;1364;26;3628;1626289;1594853;305;3221447;21668;1657845;1679513;0,998913429;1%;100%;100%
469;AGES;04/01/2021;2021;1;All;80 ou mais anos;3770;8;1;3779;4035;8;2;4045;4026;9;4035;0,005919981;0,005906777;1,32E-05;0,005919981
470;AGES;11/01/2021;2021;2;All;80 ou mais anos;14493;1;1;14495;18528;9;3;18540;18493;35;18528;0,027183497;0,027132147;5,14E-05;0,027183497
471;AGES;18/01/2021;2021;3;All;80 ou mais anos;39043;256;1;39300;57571;265;4;57840;57171;400;57571;0,084465735;0,083878871;0,000586863;0,084465735
472;AGES;25/01/2021;2021;4;All;80 ou mais anos;7368;3386;2;10756;64939;3651;6;68596;61121;3818;64939;0,095275752;0,089674144;0,005601608;0,095275752
473;AGES;01/02/2021;2021;5;All;80 ou mais anos;4534;10648;0;15182;69473;14299;6;83778;54999;14474;69473;0,101927845;0,080692205;0,02123564;0,101927845
474;AGES;08/02/2021;2021;6;All;80 ou mais anos;14838;31542;2;46382;84311;45841;8;130160;38196;46115;84311;0,123697531;0,056039555;0,067657976;0,123697531
475;AGES;15/02/2021;2021;7;All;80 ou mais anos;48616;9252;2;57870;132927;55093;10;188030;77484;55443;132927;0,195024868;0,113681245;0,081343623;0,195024868
476;AGES;22/02/2021;2021;8;All;80 ou mais anos;102547;5198;1;107746;235474;60291;11;295776;174696;60778;235474;0,345477486;0,256306577;0,089170909;0,345477486
477;AGES;01/03/2021;2021;9;All;80 ou mais anos;87194;12762;1;99957;322668;73053;12;395733;249067;73602;322669;0,473404833;0,365420561;0,107985739;0,4734063
478;AGES;08/03/2021;2021;10;All;80 ou mais anos;40143;37273;0;77416;362811;110326;12;473149;251915;110897;362812;0,532300943;0,369599026;0,162703385;0,532302411
479;AGES;15/03/2021;2021;11;All;80 ou mais anos;54358;97395;5;151758;417169;207721;17;624907;208830;208340;417170;0,6120527;0,306386537;0,30566763;0,612054167
480;AGES;22/03/2021;2021;12;All;80 ou mais anos;124534;16909;2;141445;541703;224630;19;766352;316339;225365;541704;0,794763714;0,464119192;0,33064599;0,794765181
481;AGES;29/03/2021;2021;13;All;80 ou mais anos;36737;75436;4;112177;578440;300066;23;878529;277587;300856;578443;0,848662686;0,407263898;0,44140319;0,848667087
482;AGES;05/04/2021;2021;14;All;80 ou mais anos;30375;45846;12;76233;608815;345912;35;954762;262054;346765;608819;0,8932276;0,384474537;0,508758931;0,893233469
483;AGES;12/04/2021;2021;15;All;80 ou mais anos;10505;49471;14;59990;619320;395383;49;1014752;223019;396305;619324;0,908640092;0,327204038;0,581441923;0,90864596
484;AGES;19/04/2021;2021;16;All;80 ou mais anos;8417;123247;12;131676;627737;518630;61;1146428;108094;519647;627741;0,920989158;0,158590942;0,762404085;0,920995026
485;AGES;26/04/2021;2021;17;All;80 ou mais anos;6136;39798;4;45938;633873;558428;65;1192366;74391;559497;633888;0,929991637;0,109143327;0,820870318;0,930013645
486;AGES;03/05/2021;2021;18;All;80 ou mais anos;5105;31803;6;36914;638978;590231;71;1229280;47747;591394;639141;0,937481477;0,070052378;0,867668246;0,937720624
487;AGES;10/05/2021;2021;19;All;80 ou mais anos;3782;9981;2;13765;642760;600212;73;1243045;41624;601500;643124;0,943030267;0,061068971;0,882495342;0,943564313
488;AGES;17/05/2021;2021;20;All;80 ou mais anos;4753;8370;3;13126;647513;608582;76;1256171;36987;611326;648313;0,950003668;0,054265761;0,896911633;0,951177394
489;AGES;24/05/2021;2021;21;All;80 ou mais anos;4453;6360;0;10813;651966;614942;76;1266984;33256;619986;653242;0,956536921;0,048791796;0,909617219;0,958409014
490;AGES;31/05/2021;2021;22;All;80 ou mais anos;3053;6096;2;9151;655019;621038;78;1276135;29820;627075;656895;0,961016153;0,043750642;0,920017899;0,963768541
491;AGES;07/06/2021;2021;23;All;80 ou mais anos;2754;4814;1;7569;657773;625852;79;1283704;27283;632743;660026;0,965056706;0,040028463;0,928333749;0,968362212
492;AGES;14/06/2021;2021;24;All;80 ou mais anos;2629;4781;0;7410;660402;630633;79;1291114;24459;638468;662927;0,968913863;0,03588521;0,936733227;0,972618436
493;AGES;21/06/2021;2021;25;All;80 ou mais anos;3405;4809;3;8217;663807;635442;82;1299331;21758;645036;666794;0,973909535;0,031922417;0,946369518;0,978291935
494;AGES;28/06/2021;2021;26;All;80 ou mais anos;3274;5420;1;8695;667081;640862;83;1308026;18244;652246;670490;0,978713009;0,026766825;0,956947725;0,98371455
495;AGES;05/07/2021;2021;27;All;80 ou mais anos;2678;5242;2;7922;669759;646104;85;1315948;14515;658984;673499;0,982642058;0,021295794;0,966833434;0,988129227
496;AGES;12/07/2021;2021;28;All;80 ou mais anos;2114;3536;2;5652;671873;649640;87;1321600;12156;663955;676111;0,985743629;0,017834769;0,974126674;0,991961443
497;AGES;19/07/2021;2021;29;All;80 ou mais anos;2207;3082;1;5290;674080;652722;88;1326890;10294;668622;678916;0,988981646;0,015102921;0,980973899;0,99607682
498;AGES;26/07/2021;2021;30;All;80 ou mais anos;2591;2889;1;5481;676671;655611;89;1332371;8638;673375;682013;0,992783051;0,012673308;0,9879473;1
499;AGES;02/08/2021;2021;31;All;80 ou mais anos;2488;2092;1;4581;679159;657703;90;1336952;7667;677293;684960;0,99643334;0,011248698;0,993695623;1
500;AGES;09/08/2021;2021;32;All;80 ou mais anos;1575;1721;1;3297;680734;659424;91;1340249;6870;680094;686964;0,998744113;0,010079373;0,997805132;1
501;AGES;16/08/2021;2021;33;All;80 ou mais anos;1343;1128;1;2472;682077;660552;92;1342721;6511;682107;688618;1,000714506;0,009552664;1;1
502;AGES;23/08/2021;2021;34;All;80 ou mais anos;1535;970;0;2505;683612;661522;92;1345226;6633;683897;690530;1,002966593;0,009731657;1;1
503;AGES;30/08/2021;2021;35;All;80 ou mais anos;1663;819;0;2482;685275;662341;92;1347708;7027;685485;692512;1,005406476;0,010309717;1;1
504;AGES;06/09/2021;2021;36;All;80 ou mais anos;761;568;2;1331;686036;662909;94;1349039;6960;686384;693344;1,006522983;1%;100%;100%
505;AGES;04/01/2021;2021;1;All;Desconhecido;1;0;0;1;1;0;0;1;1;0;1;NA;NA;NA;NA
506;AGES;11/01/2021;2021;2;All;Desconhecido;0;0;0;0;1;0;0;1;1;0;1;NA;NA;NA;NA
507;AGES;18/01/2021;2021;3;All;Desconhecido;0;0;0;0;1;0;0;1;1;0;1;NA;NA;NA;NA
508;AGES;25/01/2021;2021;4;All;Desconhecido;0;0;0;0;1;0;0;1;1;0;1;NA;NA;NA;NA
509;AGES;01/02/2021;2021;5;All;Desconhecido;0;0;0;0;1;0;0;1;1;0;1;NA;NA;NA;NA
510;AGES;08/02/2021;2021;6;All;Desconhecido;1;0;0;1;2;0;0;2;2;0;2;NA;NA;NA;NA
511;AGES;15/02/2021;2021;7;All;Desconhecido;0;0;0;0;2;0;0;2;2;0;2;NA;NA;NA;NA
512;AGES;22/02/2021;2021;8;All;Desconhecido;0;0;0;0;2;0;0;2;2;0;2;NA;NA;NA;NA
513;AGES;01/03/2021;2021;9;All;Desconhecido;0;0;0;0;2;0;0;2;2;0;2;NA;NA;NA;NA
514;AGES;08/03/2021;2021;10;All;Desconhecido;0;0;0;0;2;0;0;2;2;0;2;NA;NA;NA;NA
515;AGES;15/03/2021;2021;11;All;Desconhecido;0;0;0;0;2;0;0;2;2;0;2;NA;NA;NA;NA
516;AGES;22/03/2021;2021;12;All;Desconhecido;0;0;0;0;2;0;0;2;2;0;2;NA;NA;NA;NA
517;AGES;29/03/2021;2021;13;All;Desconhecido;0;0;0;0;2;0;0;2;2;0;2;NA;NA;NA;NA
518;AGES;05/04/2021;2021;14;All;Desconhecido;0;0;0;0;2;0;0;2;2;0;2;NA;NA;NA;NA
519;AGES;12/04/2021;2021;15;All;Desconhecido;0;0;0;0;2;0;0;2;2;0;2;NA;NA;NA;NA
520;AGES;19/04/2021;2021;16;All;Desconhecido;0;0;0;0;2;0;0;2;2;0;2;NA;NA;NA;NA
521;AGES;26/04/2021;2021;17;All;Desconhecido;1;0;0;1;3;0;0;3;3;0;3;NA;NA;NA;NA
522;AGES;03/05/2021;2021;18;All;Desconhecido;1;0;0;1;4;0;0;4;4;0;4;NA;NA;NA;NA
523;AGES;10/05/2021;2021;19;All;Desconhecido;0;1;0;1;4;1;0;5;3;1;4;NA;NA;NA;NA
524;AGES;17/05/2021;2021;20;All;Desconhecido;0;0;0;0;4;1;0;5;3;1;4;NA;NA;NA;NA
525;AGES;24/05/2021;2021;21;All;Desconhecido;0;1;0;1;4;2;0;6;2;2;4;NA;NA;NA;NA
526;AGES;31/05/2021;2021;22;All;Desconhecido;0;0;0;0;4;2;0;6;2;2;4;NA;NA;NA;NA
527;AGES;07/06/2021;2021;23;All;Desconhecido;0;0;0;0;4;2;0;6;2;2;4;NA;NA;NA;NA
528;AGES;14/06/2021;2021;24;All;Desconhecido;0;0;0;0;4;2;0;6;2;2;4;NA;NA;NA;NA
529;AGES;21/06/2021;2021;25;All;Desconhecido;0;0;0;0;4;2;0;6;2;2;4;NA;NA;NA;NA
530;AGES;28/06/2021;2021;26;All;Desconhecido;1;0;0;1;5;2;0;7;3;2;5;NA;NA;NA;NA
531;AGES;05/07/2021;2021;27;All;Desconhecido;0;1;0;1;5;3;0;8;2;3;5;NA;NA;NA;NA
532;AGES;12/07/2021;2021;28;All;Desconhecido;0;2;0;2;5;5;0;10;0;5;5;NA;NA;NA;NA
533;AGES;19/07/2021;2021;29;All;Desconhecido;0;0;0;0;5;5;0;10;0;5;5;NA;NA;NA;NA
534;AGES;26/07/2021;2021;30;All;Desconhecido;0;2;0;2;5;7;0;12;-1;7;6;NA;NA;NA;NA
535;AGES;02/08/2021;2021;31;All;Desconhecido;0;0;0;0;5;7;0;12;-1;7;6;NA;NA;NA;NA
536;AGES;09/08/2021;2021;32;All;Desconhecido;0;1;0;1;5;8;0;13;-1;8;7;NA;NA;NA;NA
537;AGES;16/08/2021;2021;33;All;Desconhecido;1;0;0;1;6;8;0;14;0;8;8;NA;NA;NA;NA
538;AGES;23/08/2021;2021;34;All;Desconhecido;0;0;0;0;6;8;0;14;0;8;8;NA;NA;NA;NA
539;AGES;30/08/2021;2021;35;All;Desconhecido;0;1;0;1;6;9;0;15;-1;9;8;NA;NA;NA;NA
540;AGES;06/09/2021;2021;36;All;Desconhecido;2;1;0;3;8;10;0;18;0;10;10;NA;NA;NA;NA
541;GENERAL;04/01/2021;2021;1;All;All;48834;84;1;48919;84696;96;4;84796;84604;102;84706;0,008184855;0,008175965;9,86E-06;0,008185822
542;GENERAL;11/01/2021;2021;2;All;All;49947;1200;1;51148;134643;1296;5;135944;133295;1358;134653;0,013011636;0,012881368;0,000131234;0,013012602
543;GENERAL;18/01/2021;2021;3;All;All;122301;32794;9;155104;256944;34090;14;291048;222610;34345;256955;0,024830565;0,021512594;0,003319033;0,024831628
544;GENERAL;25/01/2021;2021;4;All;All;41894;45876;17;87787;298838;79966;31;378835;218546;80305;298851;0,028879119;0,021119857;0,007760518;0,028880375
545;GENERAL;01/02/2021;2021;5;All;All;24015;37573;2;61590;322853;117539;33;440425;204970;117905;322875;0,031199881;0,019807899;0,011394108;0,031202007
546;GENERAL;08/02/2021;2021;6;All;All;40954;99444;12;140410;363807;216983;45;580835;146183;217646;363829;0,035157595;0,014126839;0,021032883;0,035159721
547;GENERAL;15/02/2021;2021;7;All;All;103663;50312;10;153985;467470;267295;55;734820;198924;268568;467492;0,045175385;0,019223625;0,025953885;0,045177511
548;GENERAL;22/02/2021;2021;8;All;All;177088;20711;11;197810;644558;288006;66;932630;354666;289914;644580;0,062288822;0,034274227;0,028016721;0,062290948
549;GENERAL;01/03/2021;2021;9;All;All;139311;33672;12;172995;783869;321678;78;1105625;459962;323957;783919;0,075751564;0,044449826;0,031306569;0,075756396
550;GENERAL;08/03/2021;2021;10;All;All;96282;52098;4;148384;880151;373776;82;1254009;503888;376356;880244;0,085056067;0,048694749;0,036370306;0,085065055
551;GENERAL;15/03/2021;2021;11;All;All;82144;110301;17;192462;962295;484077;99;1446471;475644;486780;962424;0,092994303;0,045965304;0,047041465;0,093006769
552;GENERAL;22/03/2021;2021;12;All;All;257653;21972;7;279632;1219948;506049;106;1726103;710828;509273;1220101;0,117893384;0,068693025;0,049215144;0,117908169
553;GENERAL;29/03/2021;2021;13;All;All;138259;84866;8;223133;1358207;590915;114;1949236;764073;594346;1358419;0,131254462;0,073838517;0,057436432;0,13127495
554;GENERAL;05/04/2021;2021;14;All;All;256932;53644;22;310598;1615139;644559;136;2259834;967108;648372;1615480;0,156083867;0,093459421;0,062657399;0,156116821
555;GENERAL;12/04/2021;2021;15;All;All;425951;54623;22;480596;2041090;699182;158;2740430;1338018;703448;2041466;0,197246937;0,129303437;0,067979836;0,197283273
556;GENERAL;19/04/2021;2021;16;All;All;211200;139335;29;350564;2252290;838517;187;3090994;1408950;843726;2252676;0,217656891;0,136158166;0,081536027;0,217694193
557;GENERAL;26/04/2021;2021;17;All;All;346235;90357;22;436614;2598525;928874;209;3527608;1665589;934703;2600292;0,251116363;0,160959256;0,090327866;0,251287122
558;GENERAL;03/05/2021;2021;18;All;All;371536;219900;29;591465;2970061;1148774;238;4119073;1828747;1155577;2984324;0,287020873;0,176726526;0,111672696;0,288399222
559;GENERAL;10/05/2021;2021;19;All;All;289687;305954;32;595673;3259748;1454728;270;4714746;1828693;1463184;3291877;0,315015657;0,176721307;0,141399234;0,318120541
560;GENERAL;17/05/2021;2021;20;All;All;306021;220506;33;526560;3565769;1675234;303;5241306;1927037;1694882;3621919;0,344588927;0,186225078;0,163790074;0,350015153
561;GENERAL;24/05/2021;2021;21;All;All;232379;329281;114;561774;3798148;2004515;417;5803080;1856719;2047113;3903832;0,367045578;0,179429685;0,197828988;0,377258673
562;GENERAL;31/05/2021;2021;22;All;All;230756;339236;55;570047;4028904;2343751;472;6373127;1789817;2401441;4191258;0,389345386;0,172964407;0,232070551;0,405034958
563;GENERAL;07/06/2021;2021;23;All;All;360378;251051;72;611501;4389282;2594802;544;6984628;1907059;2672772;4579831;0,424171609;0,184294444;0,258291447;0,442585891
564;GENERAL;14/06/2021;2021;24;All;All;343915;389067;117;733099;4733197;2983869;661;7717727;1877545;3081871;4959416;0,457406881;0,181442269;0,297825973;0,479268241
565;GENERAL;21/06/2021;2021;25;All;All;376530;345459;405;722394;5109727;3329328;1066;8440121;1926533;3453766;5380299;0,493794002;0,186176373;0,333765177;0,519941549
566;GENERAL;28/06/2021;2021;26;All;All;389442;431653;244;821339;5499169;3760981;1310;9261460;1880330;3915487;5795817;0,531428913;0,181711406;0,378384989;0,560096395
567;GENERAL;05/07/2021;2021;27;All;All;433243;620397;105;1053745;5932412;4381378;1415;10315205;1694817;4572569;6267386;0,573296668;0,163783793;0,441884105;0,605667898
568;GENERAL;12/07/2021;2021;28;All;All;245735;520469;114;766318;6178147;4901847;1529;11081523;1502077;5126699;6628776;0,597044016;0,145157777;0,495434143;0,64059192
569;GENERAL;19/07/2021;2021;29;All;All;143665;524234;88;667987;6321812;5426081;1617;11749510;1223041;5682435;6905476;0,61092752;0,118192285;0,54913938;0,667331665
570;GENERAL;26/07/2021;2021;30;All;All;105035;499325;69;604429;6426847;5925406;1686;12353939;899726;6212898;7112624;0,621077897;0,086947757;0,600402285;0,687350042
571;GENERAL;02/08/2021;2021;31;All;All;129707;507270;59;637036;6556554;6432676;1745;12990975;604977;6754117;7359094;0,633612527;0,058463791;0,652704628;0,71116842
572;GENERAL;09/08/2021;2021;32;All;All;314005;352323;51;666379;6870559;6784999;1796;13657354;658113;7157353;7815466;0,663957355;0,06359875;0,691672565;0,755271315
573;GENERAL;16/08/2021;2021;33;All;All;362285;237849;64;600198;7232844;7022848;1860;14257552;844083;7442348;8286431;0,698967867;0,081570527;0,719213923;0,80078445
574;GENERAL;23/08/2021;2021;34;All;All;293320;138658;26;432004;7526164;7161506;1886;14689556;1000398;7620476;8620874;0,727313737;0,096676502;0,736427864;0,833104366
575;GENERAL;30/08/2021;2021;35;All;All;130307;299390;46;429743;7656471;7460896;1932;15119299;816045;7950768;8766813;0,73990635;0,078860989;0,768346635;0,847207625
576;GENERAL;06/09/2021;2021;36;All;All;66499;309583;170;376252;7722970;7770479;2102;15495551;563120;8273795;8836915;0,746332683;5%;80%;85%
