"";"TYPE";"DATE";"YEAR";"WEEK";"REGION";"AGEGROUP";"TOTAL_VAC_1";"TOTAL_VAC_2";"TOTAL_VAC_UNK";"TOTAL";"CUMUL_VAC_1";"CUMUL_VAC_2";"CUMUL_VAC_UNK";"CUMUL";"CUMUL_VAC_INIT";"CUMUL_VAC_COMPLETE";"CUMUL_VAC_LEAST";"COVER_1_VAC";"COVER_INIT";"COVER_COMPLETE";"COVER_LEAST"
"1";"REGIONAL";2021-01-04;2021;1;"ARS Alentejo";"All";3489;2;0;3491;4718;3;0;4721;4715;3;4718;0,0100639502391201;0,0100575509490147;6,39929010541764e-06;0,0100639502391201
"2";"REGIONAL";2021-01-11;2021;2;"ARS Alentejo";"All";5367;12;0;5379;10085;15;0;10100;10069;16;10085;0,0215122802377123;0,0214781506904834;3,41295472288941e-05;0,0215122802377123
"3";"REGIONAL";2021-01-18;2021;3;"ARS Alentejo";"All";10440;1133;0;11573;20525;1148;0;21673;19372;1153;20525;0,0437818098045657;0,0413223493073835;0,00245946049718218;0,0437818098045657
"4";"REGIONAL";2021-01-25;2021;4;"ARS Alentejo";"All";2359;3123;0;5482;22884;4271;0;27155;18605;4279;22884;0,0488137849241257;0,0396862641370984;0,00912752078702736;0,0488137849241257
"5";"REGIONAL";2021-02-01;2021;5;"ARS Alentejo";"All";1458;4347;0;5805;24342;8618;0;32960;15715;8627;24342;0,0519238399153587;0,0335216146688794;0,0184022252464793;0,0519238399153587
"6";"REGIONAL";2021-02-08;2021;6;"ARS Alentejo";"All";3290;8788;0;12078;27632;17406;0;45038;10213;17419;27632;0,0589417280643001;0,0217853166155434;0,0371564114487566;0,0589417280643001
"7";"REGIONAL";2021-02-15;2021;7;"ARS Alentejo";"All";4066;2834;0;6900;31698;20240;0;51938;11445;20253;31698;0,0676148992538428;0,0244132917521683;0,0432016075016745;0,0676148992538428
"8";"REGIONAL";2021-02-22;2021;8;"ARS Alentejo";"All";12044;1635;0;13679;43742;21875;0;65617;21850;21892;43742;0,0933059159303928;0,0466081629344585;0,0466977529959343;0,0933059159303928
"9";"REGIONAL";2021-03-01;2021;9;"ARS Alentejo";"All";10475;2839;1;13315;54217;24714;1;78932;29480;24737;54217;0,115650103881809;0,0628836907692373;0,052766413112572;0,115650103881809
"10";"REGIONAL";2021-03-08;2021;10;"ARS Alentejo";"All";5847;1677;0;7524;60064;26391;1;86456;33641;26423;60064;0,128122320297268;0,0717595061454516;0,0563628141518168;0,128122320297268
"11";"REGIONAL";2021-03-15;2021;11;"ARS Alentejo";"All";3726;7749;0;11475;63790;34140;1;97931;29618;34173;63791;0,136070238608197;0,0631780581140865;0,0728943135908123;0,136072371704899
"12";"REGIONAL";2021-03-22;2021;12;"ARS Alentejo";"All";11922;2122;0;14044;75712;36262;1;111975;39417;36297;75714;0,161501017487127;0,0840802726950824;0,077425010985448;0,16150528368053
"13";"REGIONAL";2021-03-29;2021;13;"ARS Alentejo";"All";6164;6311;0;12475;81876;42573;1;124450;39267;42611;81878;0,174649425557058;0,0837603081898115;0,0908933835606503;0,174653691750462
"14";"REGIONAL";2021-04-05;2021;14;"ARS Alentejo";"All";14061;4325;0;18386;95937;46898;1;142836;49000;46941;95941;0,204642898281151;0,104521738388488;0,10012969227947;0,204651430667958
"15";"REGIONAL";2021-04-12;2021;15;"ARS Alentejo";"All";21916;2978;0;24894;117853;49876;1;167730;67935;49923;117858;0,251391845597928;0,144911924437182;0,106490586644255;0,251402511081437
"16";"REGIONAL";2021-04-19;2021;16;"ARS Alentejo";"All";11381;5984;1;17366;129234;55860;2;185096;73329;55910;129239;0,275668619161181;0,156417848046723;0,119261436597967;0,27567928464469
"17";"REGIONAL";2021-04-26;2021;17;"ARS Alentejo";"All";20236;2796;0;23032;149470;58656;2;208128;90774;58709;149483;0,318833964018925;0,193629720009727;0,125231974266321;0,318861694276048
"18";"REGIONAL";2021-05-03;2021;18;"ARS Alentejo";"All";13693;14353;1;28047;163163;73009;3;236175;93217;73074;166291;0,348042457156753;0,198840875252239;0,155873908387763;0,354714783640002
"19";"REGIONAL";2021-05-10;2021;19;"ARS Alentejo";"All";17444;15300;0;32744;180607;88309;3;268919;95848;88393;184241;0,385252196023054;0,20445305267469;0,188550816762727;0,393003869437417
"20";"REGIONAL";2021-05-17;2021;20;"ARS Alentejo";"All";13231;12252;1;25484;193838;100561;4;294403;100125;100761;200886;0,413475198484648;0,213576307268314;0,214932956770662;0,428509264038976
"21";"REGIONAL";2021-05-24;2021;21;"ARS Alentejo";"All";7209;18571;0;25780;201047;119132;4;320183;90437;119788;210225;0,428852692607967;0,192910866421218;0,255519387715923;0,448430254137141
"22";"REGIONAL";2021-05-31;2021;22;"ARS Alentejo";"All";17414;7334;0;24748;218461;126466;4;344931;100105;127877;227982;0,465998438573214;0,213533645334278;0,27277400693683;0,486307652271108
"23";"REGIONAL";2021-06-07;2021;23;"ARS Alentejo";"All";13830;15304;0;29134;232291;141770;4;374065;98666;143782;242448;0,49549916595919;0,210464119180379;0,306700909979053;0,517165029159432
"24";"REGIONAL";2021-06-14;2021;24;"ARS Alentejo";"All";10250;19276;1;29527;242541;161046;5;403592;90845;163529;254374;0,5173634071527;0,193781169875555;0,348823170549614;0,542604340425169
"25";"REGIONAL";2021-06-21;2021;25;"ARS Alentejo";"All";10567;14226;1;24794;253108;175272;6;428386;89275;178454;267729;0,539903840000683;0,19043220805372;0,380659638824066;0,571091846877786
"26";"REGIONAL";2021-06-28;2021;26;"ARS Alentejo";"All";11000;28813;3;39816;264108;204085;9;468202;72901;207925;280826;0,563367903720547;0,15550488265835;0,443524131722988;0,599029014381338
"27";"REGIONAL";2021-07-05;2021;27;"ARS Alentejo";"All";15339;27909;0;43248;279447;231994;9;511450;59648;237225;296873;0,596087474029548;0,127234952069317;0,5060238650859;0,633258817155217
"28";"REGIONAL";2021-07-12;2021;28;"ARS Alentejo";"All";8194;20372;1;28567;287641;252366;10;540017;49467;259085;308552;0,613566068404145;0,105517894548231;0,552653358987376;0,658171253535608
"29";"REGIONAL";2021-07-19;2021;29;"ARS Alentejo";"All";3531;16775;3;20309;291172;269141;13;560326;39292;277138;316430;0,621098032858222;0,0838136356073566;0,591162153745078;0,674975789352435
"30";"REGIONAL";2021-07-26;2021;30;"ARS Alentejo";"All";2254;16546;0;18800;293426;285687;13;579126;28601;294708;323309;0,625906032824092;0,06100869876835;0,628640662795807;0,689649361564157
"31";"REGIONAL";2021-08-02;2021;31;"ARS Alentejo";"All";4961;20021;13;24995;298387;305708;26;604121;18510;315854;334364;0,636488325561751;0,0394836199504268;0,673747125652194;0,713230745602621
"32";"REGIONAL";2021-08-09;2021;32;"ARS Alentejo";"All";14874;14448;0;29322;313261;320156;26;633443;24582;331964;356546;0,668216005904412;0,0524357831237921;0,708111313518287;0,760547096642079
"33";"REGIONAL";2021-08-16;2021;33;"ARS Alentejo";"All";22216;6592;0;28808;335477;326748;26;662251;41820;340762;382582;0,715604882231731;0,0892061040695219;0,726878298300775;0,816084402370297
"34";"REGIONAL";2021-08-23;2021;34;"ARS Alentejo";"All";12977;4611;0;17588;348454;331359;26;679839;50896;346798;397694;0,743286078131066;0,108566089735112;0,739753669992876;0,848319759727987
"35";"REGIONAL";2021-08-30;2021;35;"ARS Alentejo";"All";4752;15831;2;20585;353206;347190;28;700424;40495;363577;404072;0,753422553658048;0,0863797509396291;0,775544899552476;0,861924650492105
"36";"REGIONAL";2021-09-06;2021;36;"ARS Alentejo";"All";2612;15200;6;17818;355818;362390;34;718242;27492;379278;406770;0,758994202243164;0,0586430945260472;0,80903665086753;0,867679745393578
"37";"REGIONAL";2021-09-13;2021;37;"ARS Alentejo";"All";1823;15822;4;17649;357641;378212;38;735891;13278;395344;408622;0,762882837530557;0,0283232580065785;0,843306982478744;0,871630240485322
"38";"REGIONAL";2021-09-20;2021;38;"ARS Alentejo";"All";1600;3609;6;5215;359241;381821;44;741106;11016;399223;410239;0,766295792253446;0,0234981932670936;0,851581264585049;0,875079457852142
"39";"REGIONAL";2021-09-27;2021;39;"ARS Alentejo";"All";1117;2402;5;3524;360358;384223;49;744630;9439;401992;411431;0,768678461269363;0,0201342997683457;0,857487809352349;0,877622109120695
"40";"REGIONAL";2021-10-04;2021;40;"ARS Alentejo";"All";474;1667;3;2144;360832;385890;52;746774;8258;403758;412016;0,769689549106019;0,017615112563513;0,861254858127738;0,878869970691251
"41";"REGIONAL";2021-01-04;2021;1;"ARS Algarve";"All";1266;3;0;1269;2336;3;0;2339;2332;4;2336;0,00499684488604156;0,00498828864479834;8,55624124322185e-06;0,00499684488604156
"42";"REGIONAL";2021-01-11;2021;2;"ARS Algarve";"All";1369;6;0;1375;3705;9;0;3714;3693;12;3705;0,00792521845153424;0,00789954972780458;2,56687237296656e-05;0,00792521845153424
"43";"REGIONAL";2021-01-18;2021;3;"ARS Algarve";"All";3418;947;0;4365;7123;956;0;8079;6164;959;7123;0,0152365265938673;0,0131851677558049;0,00205135883806244;0,0152365265938673
"44";"REGIONAL";2021-01-25;2021;4;"ARS Algarve";"All";2166;1235;0;3401;9289;2191;0;11480;7095;2194;9289;0,0198697312270719;0,0151766329051648;0,00469309832190719;0,0198697312270719
"45";"REGIONAL";2021-02-01;2021;5;"ARS Algarve";"All";1237;1249;0;2486;10526;3440;0;13966;7084;3443;10527;0,0225157488315383;0,0151531032417459;0,00736478465010321;0,0225178878918491
"46";"REGIONAL";2021-02-08;2021;6;"ARS Algarve";"All";2425;2900;0;5325;12951;6340;0;19291;6607;6345;12952;0,0277029700852416;0,0141327714734917;0,0135723376720607;0,0277051091455524
"47";"REGIONAL";2021-02-15;2021;7;"ARS Algarve";"All";3224;2120;0;5344;16175;8460;0;24635;7708;8468;16176;0,0345993005272784;0,0164878768756885;0,0181135627119007;0,0346014395875892
"48";"REGIONAL";2021-02-22;2021;8;"ARS Algarve";"All";8536;1072;1;9609;24711;9532;1;34244;15163;9549;24712;0,0528583193403138;0,0324345714927432;0,0204258869078814;0,0528604584006246
"49";"REGIONAL";2021-03-01;2021;9;"ARS Algarve";"All";4677;567;0;5244;29388;10099;1;39488;19266;10124;29390;0,0628627044139509;0,0412111359479781;0,0216558465865945;0,0628669825345726
"50";"REGIONAL";2021-03-08;2021;10;"ARS Algarve";"All";5151;1559;0;6710;34539;11658;1;46198;22859;11683;34542;0,0738810040749099;0,0488967796447021;0,0249906416111402;0,0738874212558423
"51";"REGIONAL";2021-03-15;2021;11;"ARS Algarve";"All";2738;3025;0;5763;37277;14683;1;51961;22572;14708;37280;0,0797377512058953;0,0482828693355009;0,0314612990513268;0,0797441683868277
"52";"REGIONAL";2021-03-22;2021;12;"ARS Algarve";"All";9465;4327;0;13792;46742;19010;1;65753;27705;19040;46745;0,099983957047669;0,0592626659108654;0,040727708317736;0,0999903742286014
"53";"REGIONAL";2021-03-29;2021;13;"ARS Algarve";"All";4248;2943;0;7191;50990;21953;1;72944;29011;21983;50994;0,109070685247971;0,0620562786767773;0,0470229628124365;0,109079241489214
"54";"REGIONAL";2021-04-05;2021;14;"ARS Algarve";"All";8686;1827;0;10513;59676;23780;1;83457;35874;23812;59686;0,127650563107627;0,0767366495898352;0,0509353041208997;0,127671953710735
"55";"REGIONAL";2021-04-12;2021;15;"ARS Algarve";"All";13691;2194;0;15885;73367;25974;1;99342;47372;26006;73378;0,156936437822864;0,101331565043476;0,0556284024428069;0,156959967486283
"56";"REGIONAL";2021-04-19;2021;16;"ARS Algarve";"All";7286;5543;0;12829;80653;31517;1;112171;49112;31553;80665;0,172521631247393;0,105053529984278;0,0674937699868448;0,172547299971123
"57";"REGIONAL";2021-04-26;2021;17;"ARS Algarve";"All";16411;3294;0;19705;97064;34811;1;131876;62218;34864;97082;0,207625750008021;0,133088054417694;0,0745761986759217;0,207664253093616
"58";"REGIONAL";2021-05-03;2021;18;"ARS Algarve";"All";16588;8983;2;25573;113652;43794;3;157449;70363;43860;114223;0,243108482443663;0,150510700649205;0,0938191852319276;0,244329885881132
"59";"REGIONAL";2021-05-10;2021;19;"ARS Algarve";"All";9755;11355;0;21110;123407;55149;3;178559;70722;55223;125945;0,26397501577557;0,151278623300784;0,11812532754361;0,269403950844394
"60";"REGIONAL";2021-05-17;2021;20;"ARS Algarve";"All";12056;10931;2;22989;135463;66080;5;201548;74323;66208;140531;0,28976352688264;0,158981379479994;0,141622905057808;0,300604284537803
"61";"REGIONAL";2021-05-24;2021;21;"ARS Algarve";"All";7654;18837;0;26491;143117;84917;5;228039;68831;85143;153974;0,306135894501545;0,147233660253051;0,18212601204291;0,32935967229596
"62";"REGIONAL";2021-05-31;2021;22;"ARS Algarve";"All";8203;12780;2;20985;151320;97697;7;249024;72656;98019;170675;0,323682606231083;0,155415565941882;0,209668552604841;0,365084118546722
"63";"REGIONAL";2021-06-07;2021;23;"ARS Algarve";"All";17095;6374;0;23469;168415;104071;7;272493;84421;104704;189125;0,360249842244302;0,180581610498508;0,223968170782575;0,404549781281083
"64";"REGIONAL";2021-06-14;2021;24;"ARS Algarve";"All";15395;13480;0;28875;183810;117551;7;301368;86347;118402;204749;0,393180675729152;0,184701440657119;0,253269018919988;0,437970459577108
"65";"REGIONAL";2021-06-21;2021;25;"ARS Algarve";"All";19395;10270;2;29667;203205;127821;9;331035;96368;129156;225524;0,434667750457224;0,206136964031701;0,27627247350239;0,482409437534091
"66";"REGIONAL";2021-06-28;2021;26;"ARS Algarve";"All";17228;16513;7;33748;220433;144334;16;364783;99138;146079;245217;0,471519481491781;0,212062161092632;0,312471791142151;0,524533952234783
"67";"REGIONAL";2021-07-05;2021;27;"ARS Algarve";"All";19215;31841;1;51057;239648;176175;17;415840;87124;178564;265688;0,512621525363908;0,186363490518615;0,381959165338667;0,568322655857282
"68";"REGIONAL";2021-07-12;2021;28;"ARS Algarve";"All";9839;27056;4;36899;249487;203231;21;452739;75888;206141;282029;0,533667739761923;0,162329008866405;0,440948031529749;0,603277040396154
"69";"REGIONAL";2021-07-19;2021;29;"ARS Algarve";"All";4361;27278;1;31640;253848;230509;22;484379;58109;234056;292165;0,542996181777345;0,124298655600595;0,500659900105883;0,624958555706478
"70";"REGIONAL";2021-07-26;2021;30;"ARS Algarve";"All";4009;24794;5;28808;257857;255303;27;513187;41344;259482;300826;0,551571674563364;0,0884373094899411;0,555047647568423;0,643484957058364
"71";"REGIONAL";2021-08-02;2021;31;"ARS Algarve";"All";3955;22678;1;26634;261812;277981;28;539821;25953;282822;308775;0,5600316580926;0,0555150322463342;0,604973315222623;0,660488347468957
"72";"REGIONAL";2021-08-09;2021;32;"ARS Algarve";"All";11493;14051;3;25547;273305;292032;31;565368;28101;297807;325908;0,584615878244687;0,0601097337939443;0,637027133980043;0,697136867773987
"73";"REGIONAL";2021-08-16;2021;33;"ARS Algarve";"All";16669;7801;3;24473;289974;299833;34;589841;39318;306782;346100;0,620271874565503;0,0841035733002492;0,656225200269522;0,740328773569771
"74";"REGIONAL";2021-08-23;2021;34;"ARS Algarve";"All";13585;5324;1;18910;303559;305157;35;608751;48081;313242;361323;0,649331008887796;0,102848158803837;0,670043529877325;0,772891688681162
"75";"REGIONAL";2021-08-30;2021;35;"ARS Algarve";"All";6498;12167;4;18669;310057;317324;39;627420;42473;326532;369005;0,66323062278741;0,0908523085808404;0,698471641407929;0,78932394998877
"76";"REGIONAL";2021-09-06;2021;36;"ARS Algarve";"All";3302;15745;1;19048;313359;333069;40;646468;30234;342722;372956;0,670293799933689;0,0646723494368924;0,73310302783987;0,797775377276762
"77";"REGIONAL";2021-09-13;2021;37;"ARS Algarve";"All";2262;12076;4;14342;315621;345145;44;660810;21154;355099;376253;0,675132354356731;0,0452496818147788;0,759578177306709;0,804827859121488
"78";"REGIONAL";2021-09-20;2021;38;"ARS Algarve";"All";1856;6658;7;8521;317477;351803;51;669331;16879;362011;378890;0,679102450293586;0,0361051989860854;0,774363362174997;0,810468561161082
"79";"REGIONAL";2021-09-27;2021;39;"ARS Algarve";"All";1150;3887;6;5043;318627;355690;57;674374;14322;366172;380494;0,681562369651012;0,0306356217713558;0,783263992128258;0,813899613899614
"80";"REGIONAL";2021-10-04;2021;40;"ARS Algarve";"All";760;3025;1;3786;319387;358715;58;678160;12122;369317;381439;0,683188055487224;0,0259296890875838;0,789991336805741;0,815921025893325
"81";"REGIONAL";2021-01-04;2021;1;"ARS Centro";"All";9098;19;0;9117;15780;21;0;15801;15760;22;15782;0,00950659678293873;0,00949454786432918;1,32538104705103e-05;0,00950780167479969
"82";"REGIONAL";2021-01-11;2021;2;"ARS Centro";"All";12715;26;1;12742;28495;47;1;28543;28438;59;28497;0,0171666967889632;0,017132357370926;3,55443098981866e-05;0,0171679016808241
"83";"REGIONAL";2021-01-18;2021;3;"ARS Centro";"All";36826;6326;2;43154;65321;6373;3;71697;58910;6413;65323;0,0393523706247364;0,0354900897644436;0,00386348575215374;0,0393535755165974
"84";"REGIONAL";2021-01-25;2021;4;"ARS Centro";"All";4911;8554;3;13468;70232;14927;6;85165;55263;14971;70234;0,0423109825893126;0,0332929694559913;0,00901921802518224;0,0423121874811736
"85";"REGIONAL";2021-02-01;2021;5;"ARS Centro";"All";2743;9175;0;11918;72975;24102;6;97083;48828;24150;72978;0,0439634917766131;0,0294162298933671;0,0145490692210374;0,0439652991144045
"86";"REGIONAL";2021-02-08;2021;6;"ARS Centro";"All";7576;27158;4;34738;80551;51260;10;131821;29216;51338;80554;0,0485276221459124;0,0176010603048376;0,0309283691788662;0,0485294294837038
"87";"REGIONAL";2021-02-15;2021;7;"ARS Centro";"All";25575;10030;3;35608;106126;61290;13;167429;44665;61464;106129;0,0639351768178806;0,0269082474847882;0,0370287366708838;0,063936984155672
"88";"REGIONAL";2021-02-22;2021;8;"ARS Centro";"All";38449;3168;1;41618;144575;64458;14;209047;79907;64671;144578;0,0870986203988192;0,0481396469666847;0,0389607807699259;0,0871004277366106
"89";"REGIONAL";2021-03-01;2021;9;"ARS Centro";"All";28587;5969;1;34557;173162;70427;15;243604;102505;70671;173176;0,104320742213386;0,0617537201036207;0,0425754563527923;0,104329176456413
"90";"REGIONAL";2021-03-08;2021;10;"ARS Centro";"All";17783;13600;0;31383;190945;84027;15;274987;106664;84311;190975;0,115034038195072;0,0642592927284776;0,0507928188445087;0,115052111572986
"91";"REGIONAL";2021-03-15;2021;11;"ARS Centro";"All";16756;24299;2;41057;207701;108326;17;316044;99122;108622;207744;0,125128622206157;0,0597156455208145;0,065438881860353;0,125154527381168
"92";"REGIONAL";2021-03-22;2021;12;"ARS Centro";"All";47948;4456;1;52405;255649;112782;18;368449;142497;113203;255700;0,154014699680704;0,0858467377552865;0,0681986866678716;0,154045424423158
"93";"REGIONAL";2021-03-29;2021;13;"ARS Centro";"All";24459;16902;2;41363;280108;129684;20;409812;150038;130139;280177;0,168749924694259;0,0903897825170191;0,0784017109464426;0,168791493463462
"94";"REGIONAL";2021-04-05;2021;14;"ARS Centro";"All";49943;10330;1;60274;330051;140014;21;470086;189584;140554;330138;0,198837881800108;0,114214109283692;0,0846761853123682;0,19889029459606
"95";"REGIONAL";2021-04-12;2021;15;"ARS Centro";"All";77706;12116;2;89824;407757;152130;23;559910;254993;152858;407851;0,245651545273812;0,15361949515031;0,0920886800409663;0,245708175191277
"96";"REGIONAL";2021-04-19;2021;16;"ARS Centro";"All";30098;24296;8;54402;437855;176426;31;614312;260647;177305;437952;0,263783962889331;0,157025724441231;0,106816675703356;0,263842400144587
"97";"REGIONAL";2021-04-26;2021;17;"ARS Centro";"All";56684;18003;0;74687;494539;194429;31;688999;300422;195491;495913;0,297933008012531;0,180988011325983;0,117772757395024;0,298760768721007
"98";"REGIONAL";2021-05-03;2021;18;"ARS Centro";"All";60041;49261;1;109303;554580;243690;32;798302;316810;244990;561800;0,334104464124345;0,190860895234653;0,147593228507741;0,338454123742394
"99";"REGIONAL";2021-05-10;2021;19;"ARS Centro";"All";50743;55859;1;106603;605323;299549;33;904905;317543;301037;618580;0,364674377974577;0,191302488101693;0,181358515573227;0,37266100367492
"100";"REGIONAL";2021-05-17;2021;20;"ARS Centro";"All";44959;41829;4;86792;650282;341378;37;991697;327648;343667;671315;0,391759744562926;0,19739020422917;0,207040785589493;0,404430989818664
"101";"REGIONAL";2021-05-24;2021;21;"ARS Centro";"All";24289;56402;6;80697;674571;397780;43;1072394;302848;401098;703946;0,406392553768299;0,182449545153322;0,24163985782276;0,424089402976083
"102";"REGIONAL";2021-05-31;2021;22;"ARS Centro";"All";44381;37879;0;82260;718952;435659;43;1154654;308754;441937;750691;0,433129706608832;0,186007590818724;0,266243147177541;0,452250737996265
"103";"REGIONAL";2021-06-07;2021;23;"ARS Centro";"All";58466;40993;1;99460;777418;476652;44;1254114;325430;485499;810929;0,468352310380143;0,196053979155371;0,292486896801012;0,488540875956383
"104";"REGIONAL";2021-06-14;2021;24;"ARS Centro";"All";52072;65915;8;117995;829490;542567;52;1372109;315011;553894;868905;0,49972287487198;0,189777095005723;0,333691186216037;0,52346828122176
"105";"REGIONAL";2021-06-21;2021;25;"ARS Centro";"All";59642;47852;3;107497;889132;590419;55;1479606;329519;605358;934877;0,535653955057534;0,198517380565094;0,364695463582143;0,563212844147238
"106";"REGIONAL";2021-06-28;2021;26;"ARS Centro";"All";49989;77308;3;127300;939121;667727;58;1606906;301038;686071;987109;0,565769624676185;0,181359118019158;0,413320681968793;0,594679799987951
"107";"REGIONAL";2021-07-05;2021;27;"ARS Centro";"All";59553;105110;8;164671;998674;772837;66;1771577;259076;795631;1054707;0,601647087173926;0,156079281884451;0,479324658111934;0,635403939996385
"108";"REGIONAL";2021-07-12;2021;28;"ARS Centro";"All";28621;82295;6;110922;1027295;855132;72;1882499;215478;882252;1097730;0,61888969215013;0,129813844207482;0,531509127055847;0,661322971263329
"109";"REGIONAL";2021-07-19;2021;29;"ARS Centro";"All";16925;80848;16;97789;1044220;935980;88;1980288;162607;967613;1130220;0,629086089523465;0,0979619254171938;0,582934514127357;0,680896439544551
"110";"REGIONAL";2021-07-26;2021;30;"ARS Centro";"All";14435;69112;6;83553;1058655;1005092;94;2063841;115789;1041944;1157733;0,637782396529911;0,069756611844087;0,627714922585698;0,697471534429785
"111";"REGIONAL";2021-08-02;2021;31;"ARS Centro";"All";19285;75266;5;94556;1077940;1080358;99;2158397;74056;1122083;1196139;0,649400566299175;0,0446147358274595;0,675994337008254;0,720609072835713
"112";"REGIONAL";2021-08-09;2021;32;"ARS Centro";"All";50575;47030;6;97611;1128515;1127388;105;2256008;92297;1177864;1270161;0,679869269233086;0,0556039520453039;0,709599373456232;0,765203325501536
"113";"REGIONAL";2021-08-16;2021;33;"ARS Centro";"All";61383;36085;7;97475;1189898;1163473;112;2353483;130719;1221715;1352434;0,716849207783601;0,0787511295861196;0,736017229953612;0,814768359539731
"114";"REGIONAL";2021-08-23;2021;34;"ARS Centro";"All";51151;18458;3;69612;1241049;1181931;115;2423095;163040;1246284;1409324;0,747664919573468;0,0982227845050907;0,750818724019519;0,84904150852461
"115";"REGIONAL";2021-08-30;2021;35;"ARS Centro";"All";20724;48293;3;69020;1261773;1230224;118;2492115;132521;1299110;1431631;0,760150009036689;0,0798367371528405;0,782643532742936;0,862480269895777
"116";"REGIONAL";2021-09-06;2021;36;"ARS Centro";"All";7791;51018;9;58818;1269564;1281242;127;2550933;88332;1351569;1439901;0,764843665281041;0,0532152539309597;0,814247243809868;0,867462497740828
"117";"REGIONAL";2021-09-13;2021;37;"ARS Centro";"All";5875;42625;8;48508;1275439;1323867;135;2599441;50732;1395261;1445993;0,768383035122598;0,0305632869449967;0,840569311404301;0,871132598349298
"118";"REGIONAL";2021-09-20;2021;38;"ARS Centro";"All";4036;18678;6;22720;1279475;1342545;141;2622161;35481;1414625;1450106;0,770814506898006;0,0213753840592807;0,852235074402072;0,873610458461353
"119";"REGIONAL";2021-09-27;2021;39;"ARS Centro";"All";2874;9787;7;12668;1282349;1352332;148;2634829;28019;1425101;1453120;0,772545936502199;0,0168799325260558;0,858546297969757;0,875426230495813
"120";"REGIONAL";2021-10-04;2021;40;"ARS Centro";"All";1548;5476;9;7033;1283897;1357808;157;2641862;23924;1430880;1454804;0,773478522802578;0,0144129164407494;0,862027833001988;0,876440749442738
"121";"REGIONAL";2021-01-04;2021;1;"ARS Lisboa e Vale do Tejo";"All";12794;26;0;12820;23574;31;0;23605;23545;31;23576;0,00640322730913703;0,00639535025848949;8,42029551977805e-06;0,00640377055400927
"122";"REGIONAL";2021-01-11;2021;2;"ARS Lisboa e Vale do Tejo";"All";13306;1118;0;14424;36880;1149;0;38029;35719;1163;36882;0,0100174354441747;0,00970208179583717;0,000315896893209738;0,0100179786890469
"123";"REGIONAL";2021-01-18;2021;3;"ARS Lisboa e Vale do Tejo";"All";37932;9065;0;46997;74812;10214;0;85026;64462;10353;74815;0,0203206176911495;0,0175093254772882;0,00281210708116975;0,0203214325584579
"124";"REGIONAL";2021-01-25;2021;4;"ARS Lisboa e Vale do Tejo";"All";17371;11910;1;29282;92183;22124;1;114308;69858;22329;92187;0,0250389710290226;0,0189750001426018;0,00606505737616529;0,0250400575187671
"125";"REGIONAL";2021-02-01;2021;5;"ARS Lisboa e Vale do Tejo";"All";8790;8941;0;17731;100973;31065;1;132039;69692;31288;100980;0,0274265322425338;0,0189299108182055;0,00849852278138115;0,0274284335995867
"126";"REGIONAL";2021-02-08;2021;6;"ARS Lisboa e Vale do Tejo";"All";14457;30467;0;44924;115430;61532;1;176963;53489;61949;115438;0,0313533778015478;0,0145288124857228;0,0168267382953139;0,0313555507810367
"127";"REGIONAL";2021-02-15;2021;7;"ARS Lisboa e Vale do Tejo";"All";33078;19097;0;52175;148508;80629;1;229138;67316;81200;148516;0,0403381047435871;0,01828453590998;0,0220557418130961;0,040340277723076
"128";"REGIONAL";2021-02-22;2021;8;"ARS Lisboa e Vale do Tejo";"All";49487;6698;0;56185;197995;87327;1;285323;109791;88212;198003;0,0537798842399502;0,0298216988842565;0,0239603583351826;0,0537820572194391
"129";"REGIONAL";2021-03-01;2021;9;"ARS Lisboa e Vale do Tejo";"All";45306;12872;0;58178;243301;100199;1;343501;142005;101313;243318;0,0660860103308877;0,0385717440414865;0,0275188838708153;0,0660906279123018
"130";"REGIONAL";2021-03-08;2021;10;"ARS Lisboa e Vale do Tejo";"All";34067;16634;1;50702;277368;116833;2;394203;159352;118047;277399;0,0753393718622516;0,0432835784408927;0,0320642137168787;0,0753477921577713
"131";"REGIONAL";2021-03-15;2021;11;"ARS Lisboa e Vale do Tejo";"All";26392;29097;1;55490;303760;145930;3;449693;156585;147217;303802;0,08250803119638;0,0425319991601434;0,0399874401785537;0,0825194393386972
"132";"REGIONAL";2021-03-22;2021;12;"ARS Lisboa e Vale do Tejo";"All";89644;7756;0;97400;393404;153686;3;547093;238215;155244;393459;0,106857352860089;0,0647045386207719;0,042167753473304;0,106872292094076
"133";"REGIONAL";2021-03-29;2021;13;"ARS Lisboa e Vale do Tejo";"All";45809;24048;0;69857;439213;177734;3;616950;259909;179376;439285;0,119300105036396;0,0705971157499998;0,048722546101797;0,119319661851797
"134";"REGIONAL";2021-04-05;2021;14;"ARS Lisboa e Vale do Tejo";"All";87640;19816;1;107457;526853;197550;4;724407;327603;199381;526984;0,143105095338117;0,0889843249408338;0,0541563529364151;0,143140677877249
"135";"REGIONAL";2021-04-12;2021;15;"ARS Lisboa e Vale do Tejo";"All";163864;14494;1;178359;690717;212044;5;902766;476848;214017;690865;0,187614234210792;0,129522615419843;0,0581318189114948;0,187654434331338
"136";"REGIONAL";2021-04-19;2021;16;"ARS Lisboa e Vale do Tejo";"All";79469;53910;1;133380;770186;265954;6;1036146;502148;268189;770337;0,209199797586961;0,136394663053726;0,0728461495210889;0,209240812574815
"137";"REGIONAL";2021-04-26;2021;17;"ARS Lisboa e Vale do Tejo";"All";107917;25749;2;133668;878103;291703;8;1169814;584203;294084;878287;0,238512476025925;0,158682642049706;0,0798798125044648;0,238562454554171
"138";"REGIONAL";2021-05-03;2021;18;"ARS Lisboa e Vale do Tejo";"All";108080;65796;3;173879;986183;357499;11;1343693;629037;360043;989080;0,267869428921977;0,170860562350794;0,0977957567686274;0,268656319119422
"139";"REGIONAL";2021-05-10;2021;19;"ARS Lisboa e Vale do Tejo";"All";90714;113465;3;204182;1076897;470964;14;1547875;608581;473808;1082389;0,292509386592336;0,165304253797485;0,128696883214032;0,294001137011518
"140";"REGIONAL";2021-05-17;2021;20;"ARS Lisboa e Vale do Tejo";"All";110278;71455;2;181735;1187175;542419;16;1729610;649032;546276;1195308;0,322463365602984;0,176291652961051;0,148380817914912;0,324672470875963
"141";"REGIONAL";2021-05-24;2021;21;"ARS Lisboa e Vale do Tejo";"All";110986;89200;2;200188;1298161;631619;18;1929798;675811;643577;1319388;0,352609653298406;0,183565430177959;0,174809952572006;0,358375382749965
"142";"REGIONAL";2021-05-31;2021;22;"ARS Lisboa e Vale do Tejo";"All";92510;87239;7;179756;1390671;718858;25;2109554;696914;735769;1432683;0,377737444864041;0,189297478447439;0,199851368202954;0,389148846650393
"143";"REGIONAL";2021-06-07;2021;23;"ARS Lisboa e Vale do Tejo";"All";152486;54306;3;206795;1543157;773164;28;2316349;803066;796686;1599752;0,419156063658521;0,218130743286648;0,21639779214419;0,434528535430838
"144";"REGIONAL";2021-06-14;2021;24;"ARS Lisboa e Vale do Tejo";"All";148019;121679;4;269702;1691176;894843;32;2586051;831888;925068;1756956;0,459361345030844;0,225959445140552;0,251269223738389;0,477228668878941
"145";"REGIONAL";2021-06-21;2021;25;"ARS Lisboa e Vale do Tejo";"All";120401;154095;12;274508;1811577;1048938;44;2860559;804917;1087073;1891990;0,492064957962354;0,218633516415909;0,295273416502312;0,513906932918222
"146";"REGIONAL";2021-06-28;2021;26;"ARS Lisboa e Vale do Tejo";"All";130656;167052;8;297716;1942233;1215990;52;3158275;769872;1263903;2033775;0,527554058976293;0,209114508142018;0,343304411881743;0,552418920023762
"147";"REGIONAL";2021-07-05;2021;27;"ARS Lisboa e Vale do Tejo";"All";144020;274129;8;418157;2086253;1490119;60;3576432;640177;1549303;2189480;0,566673122226565;0,173886436289192;0,420825455150926;0,594711891440118
"148";"REGIONAL";2021-07-12;2021;28;"ARS Lisboa e Vale do Tejo";"All";80094;216172;16;296282;2166347;1706291;76;3872714;532678;1775470;2308148;0,58842844962531;0,144687296028527;0,482257486661301;0,626944782689828
"149";"REGIONAL";2021-07-19;2021;29;"ARS Lisboa e Vale do Tejo";"All";57171;185931;8;243110;2223518;1892222;84;4115824;443767;1972688;2416455;0,603957375920834;0,120537073610495;0,535826320268385;0,65636339387888
"150";"REGIONAL";2021-07-26;2021;30;"ARS Lisboa e Vale do Tejo";"All";36551;180675;11;217237;2260069;2072897;95;4333061;325631;2165341;2490972;0,613885447583525;0,0884486854968015;0,588155197454572;0,676603882951373
"151";"REGIONAL";2021-08-02;2021;31;"ARS Lisboa e Vale do Tejo";"All";45621;178557;9;224187;2305690;2251454;104;4557248;221327;2358638;2579965;0,626277134741841;0,0601173789195457;0,640658999489621;0,700776378409167
"152";"REGIONAL";2021-08-09;2021;32;"ARS Lisboa e Vale do Tejo";"All";107528;111272;4;218804;2413218;2362726;108;4776052;239490;2491238;2730728;0,655484152053153;0,0650508572268273;0,676676134519382;0,741726991746209
"153";"REGIONAL";2021-08-16;2021;33;"ARS Lisboa e Vale do Tejo";"All";107555;91126;8;198689;2520773;2453852;116;4974741;280045;2598447;2878492;0,684698503170241;0,0760665051237498;0,705796504273572;0,781863009397321
"154";"REGIONAL";2021-08-23;2021;34;"ARS Lisboa e Vale do Tejo";"All";89246;60933;6;150185;2610019;2514785;122;5124926;320649;2674079;2994728;0,708939719104374;0,0870954625200423;0,726339852362341;0,813435314882383
"155";"REGIONAL";2021-08-30;2021;35;"ARS Lisboa e Vale do Tejo";"All";48859;100848;16;149723;2658878;2615633;138;5274649;263582;2788403;3051985;0,722210919710852;0,0715947849578754;0,757392815749538;0,828987600707414
"156";"REGIONAL";2021-09-06;2021;36;"ARS Lisboa e Vale do Tejo";"All";27527;91745;55;119327;2686405;2707378;193;5393976;194446;2885487;3079933;0,729687870509979;0,0528158962141536;0,783763008337994;0,836578904552148
"157";"REGIONAL";2021-09-13;2021;37;"ARS Lisboa e Vale do Tejo";"All";19784;81710;86;101580;2706189;2789088;279;5495556;128842;2971087;3099929;0,735061648786214;0,0349963779148143;0,807013888870026;0,842010266784841
"158";"REGIONAL";2021-09-20;2021;38;"ARS Lisboa e Vale do Tejo";"All";15090;31725;111;46926;2721279;2820813;390;5542482;107708;3007458;3115166;0,739160431347293;0,0292559093498147;0,816893068494215;0,84614897784403
"159";"REGIONAL";2021-09-27;2021;39;"ARS Lisboa e Vale do Tejo";"All";9202;20376;61;29639;2730481;2841189;451;5572121;93290;3031458;3124748;0,741659901004487;0,0253396570658095;0,82341200696114;0,848751664026949
"160";"REGIONAL";2021-10-04;2021;40;"ARS Lisboa e Vale do Tejo";"All";4467;17668;50;22185;2734948;2858857;501;5594306;80050;3050337;3130387;0,742873238426643;0,0217433760115559;0,828539966932685;0,850283342944241
"161";"REGIONAL";2021-01-04;2021;1;"ARS Norte";"All";16808;44;0;16852;30258;51;0;30309;30210;55;30265;0,00844630006110434;0,00843290121111647;1,53528489444358e-05;0,0084482540600609
"162";"REGIONAL";2021-01-11;2021;2;"ARS Norte";"All";15527;41;0;15568;45785;92;0;45877;45670;122;45792;0,0127805488894726;0,0127484474780433;3,40554103858394e-05;0,0127825028884292
"163";"REGIONAL";2021-01-18;2021;3;"ARS Norte";"All";32609;12758;1;45368;78394;12850;1;91245;65480;12921;78401;0,0218831134572746;0,018278264525121;0,00360680293111009;0,0218850674562311
"164";"REGIONAL";2021-01-25;2021;4;"ARS Norte";"All";14465;15764;1;30230;92859;28614;2;121475;64171;28696;92867;0,0259209127296612;0,0179128667202435;0,00801027915108236;0,0259231458713258
"165";"REGIONAL";2021-02-01;2021;5;"ARS Norte";"All";5762;12312;1;18075;98621;40926;3;139550;57621;41012;98633;0,0275293330136219;0,0160844819823152;0,0114482007438037;0,0275326827261189
"166";"REGIONAL";2021-02-08;2021;6;"ARS Norte";"All";9015;29003;5;38023;107636;69929;8;177573;37558;70090;107648;0,030045804526969;0,0104840418300931;0,0195651124093728;0,0300491542394659
"167";"REGIONAL";2021-02-15;2021;7;"ARS Norte";"All";33154;15249;4;48407;140790;85178;12;225980;55111;85691;140802;0,0393005018706749;0,0153838337850328;0,0239200177981391;0,0393038515831718
"168";"REGIONAL";2021-02-22;2021;8;"ARS Norte";"All";64961;4403;0;69364;205751;89581;12;295344;115393;90370;205763;0,057433891330302;0,0322111145135506;0,0252261265292484;0,057437241042799
"169";"REGIONAL";2021-03-01;2021;9;"ARS Norte";"All";48227;7178;2;55407;253978;96759;14;350751;156346;97654;254000;0,0708961067129076;0,0436428458375775;0,0272594020149079;0,0709022478524854
"170";"REGIONAL";2021-03-08;2021;10;"ARS Norte";"All";25932;14282;0;40214;279910;111041;14;390965;167885;112067;279952;0,078134835418855;0,0468638735461201;0,0312826858664743;0,0781465594125944
"171";"REGIONAL";2021-03-15;2021;11;"ARS Norte";"All";27148;42527;3;69678;307058;153568;17;460643;152482;154630;307112;0,0857130016578285;0,0425642384135538;0,0431638369505111;0,0857280753640649
"172";"REGIONAL";2021-03-22;2021;12;"ARS Norte";"All";89312;2562;0;91874;396370;156130;17;552517;239133;157297;396430;0,110643795201928;0,0667522332114503;0,0439083105529622;0,110660543764412
"173";"REGIONAL";2021-03-29;2021;13;"ARS Norte";"All";54350;32913;2;87265;450720;189043;19;639782;260511;190298;450809;0,125815201386111;0,0727197460247985;0,0531202990623317;0,12584004508713
"174";"REGIONAL";2021-04-05;2021;14;"ARS Norte";"All";82673;13880;5;96558;533393;202923;24;736340;329275;204257;533532;0,148892766491263;0,0919147152032564;0,0570168521244295;0,148931567327686
"175";"REGIONAL";2021-04-12;2021;15;"ARS Norte";"All";136232;19346;2;155580;669625;222269;26;891920;446053;223720;669773;0,186920935898506;0,124512442367499;0,0624498066518032;0,186962249019302
"176";"REGIONAL";2021-04-19;2021;16;"ARS Norte";"All";65504;46653;3;112160;735129;268922;29;1004080;464485;270794;735279;0,205205899848621;0,129657600762841;0,0755901704919918;0,205247771254833
"177";"REGIONAL";2021-04-26;2021;17;"ARS Norte";"All";127131;36935;2;164068;862260;305857;31;1168148;554500;307939;862439;0,240693591469622;0,154784631630721;0,0859589263836476;0,240743558014369
"178";"REGIONAL";2021-05-03;2021;18;"ARS Norte";"All";156023;73607;3;229633;1018283;379464;34;1397781;636627;382056;1018683;0,28424627421249;0,177709784817261;0,106648146478461;0,284357931295722
"179";"REGIONAL";2021-05-10;2021;19;"ARS Norte";"All";100311;101402;8;201721;1118594;480866;42;1599502;641173;484594;1125767;0,312247358402768;0,178978767568195;0,135270881479635;0,31424964904783
"180";"REGIONAL";2021-05-17;2021;20;"ARS Norte";"All";111329;71493;4;182826;1229923;552359;46;1782328;679382;565376;1244758;0,343324036950679;0,189644531301249;0,157820587723806;0,347465119025055
"181";"REGIONAL";2021-05-24;2021;21;"ARS Norte";"All";73463;129613;9;203085;1303386;681972;55;1985413;630116;708297;1338413;0,363830697714407;0,175892286644947;0,197715942705401;0,373608229350348
"182";"REGIONAL";2021-05-31;2021;22;"ARS Norte";"All";55457;173083;9;228549;1358843;855055;64;2213962;530444;887738;1418182;0,379311114876436;0,148069574645133;0,247805589386101;0,395875164031234
"183";"REGIONAL";2021-06-07;2021;23;"ARS Norte";"All";107428;107084;9;214521;1466271;962139;73;2428483;528304;1005061;1533365;0,409298857720124;0,14747220924984;0,280555449326247;0,428027658576087
"184";"REGIONAL";2021-06-14;2021;24;"ARS Norte";"All";105645;153127;14;258786;1571916;1115266;87;2687269;486347;1168377;1654724;0,438788889115305;0,1357602186469;0,326143919839147;0,461904138486047
"185";"REGIONAL";2021-06-21;2021;25;"ARS Norte";"All";146780;105865;6;252651;1718696;1221131;93;2939920;530186;1287918;1818104;0,479761455807383;0,147997555826448;0,359512918305816;0,507510474132264
"186";"REGIONAL";2021-06-28;2021;26;"ARS Norte";"All";164103;117953;10;282066;1882799;1339084;103;3221986;567123;1421597;1988720;0,525569611631542;0,158308250034823;0,396828436379329;0,555136686414152
"187";"REGIONAL";2021-07-05;2021;27;"ARS Norte";"All";176470;159239;12;335721;2059269;1498323;115;3557707;580163;1599424;2179587;0,574829925326534;0,161948270948195;0,446467546729187;0,608415817677382
"188";"REGIONAL";2021-07-12;2021;28;"ARS Norte";"All";105686;157690;21;263397;2164955;1656013;136;3821104;560988;1773871;2334859;0,604331401572746;0,156595709520748;0,495163154725733;0,651758864246481
"189";"REGIONAL";2021-07-19;2021;29;"ARS Norte";"All";52015;190269;12;242296;2216970;1846282;148;4063400;461218;1977545;2438763;0,618851009533561;0,128745641535542;0,552017266651351;0,680762908186893
"190";"REGIONAL";2021-07-26;2021;30;"ARS Norte";"All";35553;186037;18;221608;2252523;2032319;166;4285008;334906;2175167;2510073;0,628775370233952;0,0934865677924585;0,607182006907665;0,700668574700124
"191";"REGIONAL";2021-08-02;2021;31;"ARS Norte";"All";42127;190539;8;232674;2294650;2222858;174;4517682;213077;2377647;2590724;0,640534815097266;0,0594788908097009;0,663702822439836;0,723181713249537
"192";"REGIONAL";2021-08-09;2021;32;"ARS Norte";"All";119686;148630;6;268322;2414336;2371488;180;4786004;225830;2544175;2770005;0,673944289256607;0,0630387977658534;0,71018789933109;0,773226697096944
"193";"REGIONAL";2021-08-16;2021;33;"ARS Norte";"All";149095;81457;9;230561;2563431;2452945;189;5016565;312086;2645358;2957444;0,715563071317891;0,0871165311940581;0,738432395962815;0,825548927156873
"194";"REGIONAL";2021-08-23;2021;34;"ARS Norte";"All";119413;34264;8;153685;2682844;2487209;197;5170250;384715;2695475;3080190;0,748896339517926;0,107390386939248;0,752422191063693;0,859812578002941
"195";"REGIONAL";2021-08-30;2021;35;"ARS Norte";"All";44998;111674;13;156685;2727842;2598883;210;5326935;309081;2817712;3126793;0,761457203096139;0,0862777073562757;0,786543758271347;0,872821465627623
"196";"REGIONAL";2021-09-06;2021;36;"ARS Norte";"All";22491;129311;18;151820;2750333;2728194;228;5478755;198518;2951894;3150412;0,767735401743581;0,0554148521227547;0,823999685127025;0,87941453724978
"197";"REGIONAL";2021-09-13;2021;37;"ARS Norte";"All";14980;97287;16;112283;2765313;2825481;244;5591038;114480;3051785;3166265;0,771916959510629;0,0319562572210729;0,85188352937991;0,883839786600983
"198";"REGIONAL";2021-09-20;2021;38;"ARS Norte";"All";10435;37177;7;47619;2775748;2862658;251;5638657;86144;3090984;3177128;0,774829813669451;0,0240464694448996;0,862825644393963;0,886872113838863
"199";"REGIONAL";2021-09-27;2021;39;"ARS Norte";"All";6729;18866;18;25613;2782477;2881524;269;5664270;72411;3111688;3184099;0,776708164952126;0,020213002634828;0,868605015022065;0,888818017656893
"200";"REGIONAL";2021-10-04;2021;40;"ARS Norte";"All";4815;14725;24;19564;2787292;2896249;293;5683834;61713;3127543;3189256;0,778052237091534;0,0172267339437812;0,873030822658684;0,890257556602465
"201";"REGIONAL";2021-01-04;2021;1;"RA Madeira";"All";1837;3;0;1840;2548;3;0;2551;2545;3;2548;0,0101489683740938;0,0101370190392735;1,19493348203617e-05;0,0101489683740938
"202";"REGIONAL";2021-01-11;2021;2;"RA Madeira";"All";1801;4;0;1805;4349;7;0;4356;4340;9;4349;0,0173225523779176;0,0172867043734565;3,5848004461085e-05;0,0173225523779176
"203";"REGIONAL";2021-01-18;2021;3;"RA Madeira";"All";1172;599;1;1772;5521;606;1;6128;4913;608;5521;0,0219907591810723;0,0195690273241456;0,00242173185692663;0,0219907591810723
"204";"REGIONAL";2021-01-25;2021;4;"RA Madeira";"All";487;1728;3;2218;6008;2334;4;8346;3672;2336;6008;0,0239305345335776;0,0146259858201227;0,00930454871345495;0,0239305345335776
"205";"REGIONAL";2021-02-01;2021;5;"RA Madeira";"All";2262;1544;0;3806;8270;3878;4;12152;4390;3880;8270;0,0329403329881303;0,0174858599537959;0,0154544730343344;0,0329403329881303
"206";"REGIONAL";2021-02-08;2021;6;"RA Madeira";"All";3183;1161;1;4345;11453;5039;5;16497;6412;5041;11453;0,0456185772325341;0,0255397116227197;0,0200788656098144;0,0456185772325341
"207";"REGIONAL";2021-02-15;2021;7;"RA Madeira";"All";2598;712;1;3311;14051;5751;6;19808;8297;5754;14051;0,0559667011869673;0,0330478770015136;0,0229188241854537;0,0559667011869673
"208";"REGIONAL";2021-02-22;2021;8;"RA Madeira";"All";2275;2165;1;4441;16326;7916;7;24249;8407;7919;16326;0,0650282800924082;0,0334860192782602;0,031542260814148;0,0650282800924082
"209";"REGIONAL";2021-03-01;2021;9;"RA Madeira";"All";1464;3132;3;4599;17790;11048;10;28848;6739;11051;17790;0,0708595554847447;0,0268421891181391;0,0440173663666056;0,0708595554847447
"210";"REGIONAL";2021-03-08;2021;10;"RA Madeira";"All";5000;2394;0;7394;22790;13442;10;36242;9345;13445;22790;0,0907751135186808;0,0372221779654266;0,0535529355532542;0,0907751135186808
"211";"REGIONAL";2021-03-15;2021;11;"RA Madeira";"All";3140;2330;2;5472;25930;15772;12;41714;10154;15776;25930;0,103282083963993;0,0404445152553175;0,0628375687086752;0,103282083963993
"212";"REGIONAL";2021-03-22;2021;12;"RA Madeira";"All";5574;196;0;5770;31504;15968;12;47484;15533;15972;31505;0,125483948060225;0,0618696725882259;0,0636182585836055;0,125487931171831
"213";"REGIONAL";2021-03-29;2021;13;"RA Madeira";"All";1229;1271;1;2501;32733;17239;13;49985;15491;17244;32735;0,130379192224966;0,0617023819007409;0,0686847765474389;0,13038715844818
"214";"REGIONAL";2021-04-05;2021;14;"RA Madeira";"All";10225;1307;0;11532;42958;18546;13;61517;24407;18553;42960;0,171106508404366;0,0972158049868557;0,0738986696407233;0,171114474627579
"215";"REGIONAL";2021-04-12;2021;15;"RA Madeira";"All";8536;1317;0;9853;51494;19863;13;71370;31621;19876;51497;0,205106349079901;0,125949972118219;0,0791683262965028;0,205118298414722
"216";"REGIONAL";2021-04-19;2021;16;"RA Madeira";"All";9844;2149;0;11993;61338;22012;13;83363;39248;22094;61342;0,244316099737115;0,156329164343185;0,0880028678403569;0,244332032183542
"217";"REGIONAL";2021-04-26;2021;17;"RA Madeira";"All";8832;833;1;9666;70170;22845;14;93029;47252;22940;70192;0,279494941448259;0,18820998964391;0,0913725802596989;0,279582569903609
"218";"REGIONAL";2021-05-03;2021;18;"RA Madeira";"All";7663;5357;0;13020;77833;28202;14;106049;49558;28318;77876;0,31001752569107;0,197395045009161;0,112793754481001;0,310188799490162
"219";"REGIONAL";2021-05-10;2021;19;"RA Madeira";"All";11613;6566;5;18184;89446;34768;19;124233;54594;34896;89490;0,35627340078069;0,217453995060942;0,138994662630447;0,356448657691389
"220";"REGIONAL";2021-05-17;2021;20;"RA Madeira";"All";2408;7723;7;10138;91854;42491;26;134371;49281;42625;91906;0,365864733529834;0,196291723094081;0,169780132239305;0,366071855333386
"221";"REGIONAL";2021-05-24;2021;21;"RA Madeira";"All";3523;8999;3;12525;95377;51490;29;146896;43797;51641;95438;0,379897235720545;0,17444833904246;0,205691866486099;0,380140205528559
"222";"REGIONAL";2021-05-31;2021;22;"RA Madeira";"All";7655;11034;5;18694;103032;62524;34;165590;40717;62716;103433;0,410387955070501;0,162180355293555;0,249804827531267;0,411985182824823
"223";"REGIONAL";2021-06-07;2021;23;"RA Madeira";"All";3726;15303;4;19033;106758;77827;38;184623;31201;78057;109258;0,42522902891739;0,124277065243368;0,31090974269099;0,435186807934358
"224";"REGIONAL";2021-06-14;2021;24;"RA Madeira";"All";3769;8379;5;12153;110527;86206;43;196776;29085;86474;115559;0,440241376563371;0,115848801083406;0,344435593085318;0,460284394168725
"225";"REGIONAL";2021-06-21;2021;25;"RA Madeira";"All";12652;3757;13;16422;123179;89963;56;213198;37972;90373;128345;0,490635704612443;0,151246713932924;0,359965745240182;0,511212459173106
"226";"REGIONAL";2021-06-28;2021;26;"RA Madeira";"All";10170;12380;21;22571;133349;102343;77;235769;35841;102867;138708;0,531143949653469;0,142758703098861;0,409730741655381;0,552489444754242
"227";"REGIONAL";2021-07-05;2021;27;"RA Madeira";"All";12800;7029;11;19840;146149;109372;88;255609;41674;110247;151921;0,582127778220346;0,165992193101251;0,439126105313471;0,605118298414722
"228";"REGIONAL";2021-07-12;2021;28;"RA Madeira";"All";10671;5929;9;16609;156820;115301;97;272218;47303;116769;164072;0,624631562176372;0,188413128335856;0,465103959212937;0,653517087548793
"229";"REGIONAL";2021-07-19;2021;29;"RA Madeira";"All";4281;14872;8;19161;161101;130173;105;291379;38993;131894;170887;0,641683262965028;0,155313470883454;0,525348522265594;0,680661993149048
"230";"REGIONAL";2021-07-26;2021;30;"RA Madeira";"All";5574;13916;5;19495;166675;144089;110;310874;33589;146225;179814;0,66388512706126;0,133788735760376;0,582430494702462;0,716219230462838
"231";"REGIONAL";2021-08-02;2021;31;"RA Madeira";"All";4567;14403;1;18971;171242;158492;111;329845;25532;160986;186518;0,682075997769457;0,101696805544491;0,641225205130248;0,742922010674739
"232";"REGIONAL";2021-08-09;2021;32;"RA Madeira";"All";5422;11072;4;16498;176664;169564;115;346343;21345;172311;193656;0,703672428901458;0,0850195172468733;0,686333944077113;0,771353461323986
"233";"REGIONAL";2021-08-16;2021;33;"RA Madeira";"All";3629;8176;4;11809;180293;177740;119;358152;17861;180695;198556;0,718127140922489;0,0711423564088266;0,719728351788417;0,790870708197244
"234";"REGIONAL";2021-08-23;2021;34;"RA Madeira";"All";2195;6303;3;8501;182488;184043;122;366653;14540;187174;201714;0,726870070899387;0,0579144427626862;0,745534931888791;0,803449374651478
"235";"REGIONAL";2021-08-30;2021;35;"RA Madeira";"All";1806;5873;2;7681;184294;189916;124;374334;11287;193275;204562;0,734063570461244;0,0449573807058074;0,7698358958018;0,814793276507608
"236";"REGIONAL";2021-09-06;2021;36;"RA Madeira";"All";1307;4796;2;6105;185601;194712;126;380439;8225;198290;206515;0,739269497331315;0,0327610929658249;0,789811200509838;0,822572293475663
"237";"REGIONAL";2021-09-13;2021;37;"RA Madeira";"All";845;2890;2;3737;186446;197602;128;384176;6363;201395;207758;0,74263522663905;0,0253445391539871;0,802178762048913;0,8275233012029
"238";"REGIONAL";2021-09-20;2021;38;"RA Madeira";"All";812;2135;1;2948;187258;199737;129;387124;5047;203785;208832;0,745869513263762;0,0201027642794551;0,811698398789134;0,831801163068589
"239";"REGIONAL";2021-09-27;2021;39;"RA Madeira";"All";787;1355;7;2149;188045;201092;136;389273;4354;205303;209657;0,749004222098303;0,0173424679359516;0,817744762208237;0,835087230144189
"240";"REGIONAL";2021-10-04;2021;40;"RA Madeira";"All";634;865;128;1627;188679;201957;264;390900;4003;206322;210325;0,751529514857006;0,0159443957619693;0,821803552935553;0,837747948697523
"241";"REGIONAL";2021-01-04;2021;1;"RA Acores";"All";3688;3;1;3692;5729;4;4;5737;5725;4;5729;0,0242080310322534;0,0241911289334353;1,69020988181207e-05;0,0242080310322534
"242";"REGIONAL";2021-01-11;2021;2;"RA Acores";"All";29;3;0;32;5758;7;4;5769;5751;7;5758;0,0243305712486848;0,0243009925757531;2,95786729317113e-05;0,0243305712486848
"243";"REGIONAL";2021-01-18;2021;3;"RA Acores";"All";88;1985;5;2078;5846;1992;9;7847;3854;1992;5846;0,0247024174226835;0,0162851722112593;0,00841724521142413;0,0247024174226835
"244";"REGIONAL";2021-01-25;2021;4;"RA Acores";"All";316;3617;9;3942;6162;5609;18;11789;553;5609;6162;0,026037683229315;0,00233671516160519;0,0237009680677098;0,026037683229315
"245";"REGIONAL";2021-02-01;2021;5;"RA Acores";"All";1887;36;1;1924;8049;5645;19;13713;2404;5645;8049;0,0340112483467635;0,0101581613896906;0,0238530869570729;0,0340112483467635
"246";"REGIONAL";2021-02-08;2021;6;"RA Acores";"All";1066;59;1;1126;9115;5704;20;14839;3411;5704;9115;0,0385156576817926;0,0144132647671525;0,0241023929146402;0,0385156576817926
"247";"REGIONAL";2021-02-15;2021;7;"RA Acores";"All";2097;370;2;2469;11212;6074;22;17308;5138;6074;11212;0,0473765829871924;0,0217107459318761;0,0256658370553163;0,0473765829871924
"248";"REGIONAL";2021-02-22;2021;8;"RA Acores";"All";1504;1642;8;3154;12716;7716;30;20462;4999;7717;12716;0,0537317721428058;0,0211233979979464;0,0326083741448594;0,0537317721428058
"249";"REGIONAL";2021-03-01;2021;9;"RA Acores";"All";786;1204;5;1995;13502;8920;35;22457;4581;8921;13502;0,0570530345605666;0,0193571286714528;0,0376959058891138;0,0570530345605666
"250";"REGIONAL";2021-03-08;2021;10;"RA Acores";"All";2774;2075;3;4852;16276;10995;38;27309;5270;11006;16276;0,0687746400909333;0,0222685151928741;0,0465061248980592;0,0687746400909333
"251";"REGIONAL";2021-03-15;2021;11;"RA Acores";"All";2537;1459;9;4005;18813;12454;47;31314;6343;12471;18814;0,0794947962663264;0,026802503200835;0,0526965185901959;0,0794990217910309
"252";"REGIONAL";2021-03-22;2021;12;"RA Acores";"All";4167;752;6;4925;22980;13206;53;36239;9748;13233;22981;0,0971025577101036;0,0411904148197602;0,0559163684150479;0,0971067832348082
"253";"REGIONAL";2021-03-29;2021;13;"RA Acores";"All";2229;780;5;3014;25209;13986;58;39253;11193;14018;25211;0,106521252276501;0,0472962980178064;0,0592334053081041;0,10652970332591
"254";"REGIONAL";2021-04-05;2021;14;"RA Acores";"All";3903;2381;15;6299;29112;16367;73;45552;12700;16419;29119;0,123013475198283;0,0536641637475333;0,0693788901236811;0,123043053871214
"255";"REGIONAL";2021-04-12;2021;15;"RA Acores";"All";4241;2399;18;6658;33353;18766;91;52210;14526;18835;33361;0,140933925470195;0,0613799718580055;0,079587757809826;0,140967729667831
"256";"REGIONAL";2021-04-19;2021;16;"RA Acores";"All";7919;1072;18;9009;41272;19838;109;61219;21316;19964;41280;0,17439585560537;0,0900712846017654;0,0843583752012406;0,174429659803006
"257";"REGIONAL";2021-04-26;2021;17;"RA Acores";"All";9314;2990;17;12321;50586;22828;126;73540;27596;23017;50613;0,213752392703364;0,116607579746215;0,0972589021241713;0,213866481870386
"258";"REGIONAL";2021-05-03;2021;18;"RA Acores";"All";9729;2959;20;12708;60315;25787;146;86248;34346;26029;60375;0,254862522553738;0,145129871501794;0,109986182534216;0,25511605403601
"259";"REGIONAL";2021-05-10;2021;19;"RA Acores";"All";9460;2425;15;11900;69775;28212;161;98148;41351;28487;69838;0,294835986258594;0,174729672057028;0,120372522257951;0,295102194314979
"260";"REGIONAL";2021-05-17;2021;20;"RA Acores";"All";12103;5185;14;17302;81878;33397;175;115450;48235;33713;81948;0,345977511757523;0,203818184123013;0,142455114363826;0,34627329848684
"261";"REGIONAL";2021-05-24;2021;21;"RA Acores";"All";5607;8186;93;13886;87485;41583;268;129336;45641;41924;87565;0,369670028775823;0,192857173039462;0,177150897712723;0,370008070752186
"262";"REGIONAL";2021-05-31;2021;22;"RA Acores";"All";5527;10498;32;16057;93012;52081;300;145393;40700;52459;93159;0,393024503817762;0,171978855474379;0,221666800474949;0,393645655949327
"263";"REGIONAL";2021-06-07;2021;23;"RA Acores";"All";7875;12224;56;20155;100887;64305;356;165548;36322;64736;101058;0,426300510865937;0,153479508317945;0,273543567272466;0,427023075590411
"264";"REGIONAL";2021-06-14;2021;24;"RA Acores";"All";9275;7861;88;17224;110162;72166;444;182772;38133;72664;110797;0,465492252500454;0,16113193355785;0,307043527129981;0,468175460687831
"265";"REGIONAL";2021-06-21;2021;25;"RA Acores";"All";7561;10025;366;17952;117723;82191;810;200724;38135;82779;120914;0,497441444791407;0,161140384607259;0,349784709516304;0,510925094123563
"266";"REGIONAL";2021-06-28;2021;26;"RA Acores";"All";6743;12492;195;19430;124466;94683;1005;220154;33785;95394;129179;0,525934157874054;0,142759352142552;0,403089703663952;0,545849055806505
"267";"REGIONAL";2021-07-05;2021;27;"RA Acores";"All";6218;16324;65;22607;130684;111007;1070;242761;25459;111870;137329;0,552208470486823;0,107577633452634;0,472709448695792;0,580287082148426
"268";"REGIONAL";2021-07-12;2021;28;"RA Acores";"All";2972;11942;57;14971;133656;122949;1127;257732;18118;123915;142033;0,564766729908686;0,0765580565966779;0,523605893761858;0,600163950358536
"269";"REGIONAL";2021-07-19;2021;29;"RA Acores";"All";5701;9036;42;14779;139357;131985;1169;272511;16456;133158;149614;0,588856446249213;0,0695352345377487;0,56266241860583;0,632197653143579
"270";"REGIONAL";2021-07-26;2021;30;"RA Acores";"All";7010;9026;30;16066;146367;141011;1199;288577;16857;142546;159403;0,61847737442797;0,0712296699442653;0,60233164453196;0,673561314476225
"271";"REGIONAL";2021-08-02;2021;31;"RA Acores";"All";9607;6691;25;16323;155974;147702;1224;304900;23111;149565;172676;0,659071990264391;0,0976561014463971;0,631990602433057;0,729646703879454
"272";"REGIONAL";2021-08-09;2021;32;"RA Acores";"All";5035;6621;33;11689;161009;154323;1257;316589;22875;156448;179323;0,680347507151701;0,096658877616128;0,661074888974338;0,757733766590466
"273";"REGIONAL";2021-08-16;2021;33;"RA Acores";"All";2367;7397;36;9800;163376;161720;1293;326389;18529;163968;182497;0,690349324127324;0,0782947472502398;0,692850834752405;0,771145582002645
"274";"REGIONAL";2021-08-23;2021;34;"RA Acores";"All";5729;9366;14;15109;169105;171086;1307;341498;15189;173460;188649;0,714557355159577;0,064181494737109;0,732959515247806;0,797141009984915
"275";"REGIONAL";2021-08-30;2021;35;"RA Acores";"All";3147;5543;13;8703;172252;176629;1320;350201;12931;179097;192028;0,727855081404733;0,0546402599542798;0,756778798007243;0,811419057961522
"276";"REGIONAL";2021-09-06;2021;36;"RA Acores";"All";2098;2900;15;5013;174350;179529;1335;355214;11612;182749;194361;0,736720232234838;0,0490667928690045;0,772210414228187;0,821277207097191
"277";"REGIONAL";2021-09-13;2021;37;"RA Acores";"All";870;5319;30;6219;175220;184848;1365;361433;6955;188382;195337;0,740396438727779;0,0293885243200074;0,796012794888805;0,825401319208813
"278";"REGIONAL";2021-09-20;2021;38;"RA Acores";"All";779;3371;20;4170;175999;188219;1385;365603;4287;191924;196211;0,743688122472608;0,0181148244083209;0,810979603392251;0,829094427800572
"279";"REGIONAL";2021-09-27;2021;39;"RA Acores";"All";522;1598;23;2143;176521;189817;1408;367746;3219;193664;196883;0,745893846368373;0,0136019640238827;0,818332016378134;0,831933980402016
"280";"REGIONAL";2021-10-04;2021;40;"RA Acores";"All";403;718;7;1128;176924;190535;1415;368874;2852;194514;197366;0,747596732824299;0,0120511964573201;0,821923712376984;0,833974908834304
"281";"REGIONAL";2021-01-04;2021;1;"Outro";"All";0;0;0;0;0;0;0;0;0;0;0;NA;NA;NA;NA
"282";"REGIONAL";2021-01-11;2021;2;"Outro";"All";0;0;0;0;0;0;0;0;0;0;0;NA;NA;NA;NA
"283";"REGIONAL";2021-01-18;2021;3;"Outro";"All";0;0;0;0;0;0;0;0;0;0;0;NA;NA;NA;NA
"284";"REGIONAL";2021-01-25;2021;4;"Outro";"All";0;0;0;0;0;0;0;0;0;0;0;NA;NA;NA;NA
"285";"REGIONAL";2021-02-01;2021;5;"Outro";"All";0;0;0;0;0;0;0;0;0;0;0;NA;NA;NA;NA
"286";"REGIONAL";2021-02-08;2021;6;"Outro";"All";0;0;0;0;0;0;0;0;0;0;0;NA;NA;NA;NA
"287";"REGIONAL";2021-02-15;2021;7;"Outro";"All";0;0;0;0;0;0;0;0;0;0;0;NA;NA;NA;NA
"288";"REGIONAL";2021-02-22;2021;8;"Outro";"All";0;0;0;0;0;0;0;0;0;0;0;NA;NA;NA;NA
"289";"REGIONAL";2021-03-01;2021;9;"Outro";"All";0;0;0;0;0;0;0;0;0;0;0;NA;NA;NA;NA
"290";"REGIONAL";2021-03-08;2021;10;"Outro";"All";0;0;0;0;0;0;0;0;0;0;0;NA;NA;NA;NA
"291";"REGIONAL";2021-03-15;2021;11;"Outro";"All";0;0;0;0;0;0;0;0;0;0;0;NA;NA;NA;NA
"292";"REGIONAL";2021-03-22;2021;12;"Outro";"All";0;0;0;0;0;0;0;0;0;0;0;NA;NA;NA;NA
"293";"REGIONAL";2021-03-29;2021;13;"Outro";"All";0;0;0;0;0;0;0;0;0;0;0;NA;NA;NA;NA
"294";"REGIONAL";2021-04-05;2021;14;"Outro";"All";0;0;0;0;0;0;0;0;0;0;0;NA;NA;NA;NA
"295";"REGIONAL";2021-04-12;2021;15;"Outro";"All";0;0;0;0;0;0;0;0;0;0;0;NA;NA;NA;NA
"296";"REGIONAL";2021-04-19;2021;16;"Outro";"All";0;0;0;0;0;0;0;0;0;0;0;NA;NA;NA;NA
"297";"REGIONAL";2021-04-26;2021;17;"Outro";"All";0;0;0;0;0;0;0;0;0;0;0;NA;NA;NA;NA
"298";"REGIONAL";2021-05-03;2021;18;"Outro";"All";0;0;0;0;0;0;0;0;0;0;0;NA;NA;NA;NA
"299";"REGIONAL";2021-05-10;2021;19;"Outro";"All";0;0;0;0;0;0;0;0;0;0;0;NA;NA;NA;NA
"300";"REGIONAL";2021-05-17;2021;20;"Outro";"All";0;0;0;0;0;0;0;0;0;0;0;NA;NA;NA;NA
"301";"REGIONAL";2021-05-24;2021;21;"Outro";"All";0;0;0;0;0;0;0;0;0;0;0;NA;NA;NA;NA
"302";"REGIONAL";2021-05-31;2021;22;"Outro";"All";0;0;0;0;0;0;0;0;0;0;0;NA;NA;NA;NA
"303";"REGIONAL";2021-06-07;2021;23;"Outro";"All";0;0;0;0;0;0;0;0;0;0;0;NA;NA;NA;NA
"304";"REGIONAL";2021-06-14;2021;24;"Outro";"All";0;0;0;0;0;0;0;0;0;0;0;NA;NA;NA;NA
"305";"REGIONAL";2021-06-21;2021;25;"Outro";"All";0;0;0;0;0;0;0;0;0;0;0;NA;NA;NA;NA
"306";"REGIONAL";2021-06-28;2021;26;"Outro";"All";0;0;0;0;0;0;0;0;0;0;0;NA;NA;NA;NA
"307";"REGIONAL";2021-07-05;2021;27;"Outro";"All";0;0;0;0;0;0;0;0;0;0;0;NA;NA;NA;NA
"308";"REGIONAL";2021-07-12;2021;28;"Outro";"All";0;0;0;0;0;0;0;0;0;0;0;NA;NA;NA;NA
"309";"REGIONAL";2021-07-19;2021;29;"Outro";"All";0;0;0;0;0;0;0;0;0;0;0;NA;NA;NA;NA
"310";"REGIONAL";2021-07-26;2021;30;"Outro";"All";0;0;0;0;0;0;0;0;0;0;0;NA;NA;NA;NA
"311";"REGIONAL";2021-08-02;2021;31;"Outro";"All";0;0;0;0;0;0;0;0;0;0;0;NA;NA;NA;NA
"312";"REGIONAL";2021-08-09;2021;32;"Outro";"All";0;0;0;0;0;0;0;0;0;0;0;NA;NA;NA;NA
"313";"REGIONAL";2021-08-16;2021;33;"Outro";"All";0;0;0;0;0;0;0;0;0;0;0;NA;NA;NA;NA
"314";"REGIONAL";2021-08-23;2021;34;"Outro";"All";0;0;0;0;0;0;0;0;0;0;0;NA;NA;NA;NA
"315";"REGIONAL";2021-08-30;2021;35;"Outro";"All";0;0;0;0;0;0;0;0;0;0;0;NA;NA;NA;NA
"316";"REGIONAL";2021-09-06;2021;36;"Outro";"All";0;0;0;0;0;0;0;0;0;0;0;NA;NA;NA;NA
"317";"REGIONAL";2021-09-13;2021;37;"Outro";"All";0;0;0;0;0;0;0;0;0;0;0;NA;NA;NA;NA
"318";"REGIONAL";2021-09-20;2021;38;"Outro";"All";0;0;0;0;0;0;0;0;0;0;0;NA;NA;NA;NA
"319";"REGIONAL";2021-09-27;2021;39;"Outro";"All";0;0;0;0;0;0;0;0;0;0;0;NA;NA;NA;NA
"320";"REGIONAL";2021-10-04;2021;40;"Outro";"All";0;0;0;0;0;0;0;0;0;0;0;NA;NA;NA;NA
"321";"AGES";2021-01-04;2021;1;"All";"12-17 anos";5;0;0;5;7;0;0;7;7;0;7;1,12451786296625e-05;1,12451786296625e-05;0;1,12451786296625e-05
"322";"AGES";2021-01-11;2021;2;"All";"12-17 anos";15;0;0;15;22;0;0;22;22;0;22;3,53419899789394e-05;3,53419899789394e-05;0;3,53419899789394e-05
"323";"AGES";2021-01-18;2021;3;"All";"12-17 anos";70;1;0;71;92;1;0;93;91;1;92;0,000147793776275565;0,000146187322185613;1,60645408995179e-06;0,000147793776275565
"324";"AGES";2021-01-25;2021;4;"All";"12-17 anos";15;3;0;18;107;4;0;111;103;4;107;0,000171890587624842;0,000165464771265034;6,42581635980716e-06;0,000171890587624842
"325";"AGES";2021-02-01;2021;5;"All";"12-17 anos";35;4;0;39;142;8;0;150;134;8;142;0,000228116480773154;0,00021526484805354;1,28516327196143e-05;0,000228116480773154
"326";"AGES";2021-02-08;2021;6;"All";"12-17 anos";38;66;0;104;180;74;0;254;106;74;180;0,000289161736191322;0,00017028413353489;0,000118877602656432;0,000289161736191322
"327";"AGES";2021-02-15;2021;7;"All";"12-17 anos";32;16;0;48;212;90;0;302;122;90;212;0,00034056826706978;0,000195987398974118;0,000144580868095661;0,00034056826706978
"328";"AGES";2021-02-22;2021;8;"All";"12-17 anos";24;33;0;57;236;123;0;359;113;123;236;0,000379123165228623;0,000181529312164552;0,00019759385306407;0,000379123165228623
"329";"AGES";2021-03-01;2021;9;"All";"12-17 anos";12;30;0;42;248;153;0;401;95;153;248;0,000398400614308044;0,00015261313854542;0,000245787475762624;0,000398400614308044
"330";"AGES";2021-03-08;2021;10;"All";"12-17 anos";19;25;0;44;267;178;0;445;88;179;267;0,000428923242017128;0,000141367959915758;0,00028755528210137;0,000428923242017128
"331";"AGES";2021-03-15;2021;11;"All";"12-17 anos";5;23;0;28;272;201;0;473;70;202;272;0,000436955512466887;0,000112451786296625;0,000324503726170262;0,000436955512466887
"332";"AGES";2021-03-22;2021;12;"All";"12-17 anos";33;11;0;44;305;212;0;517;92;213;305;0,000489968497435296;0,000147793776275565;0,000342174721159731;0,000489968497435296
"333";"AGES";2021-03-29;2021;13;"All";"12-17 anos";15;14;0;29;320;226;0;546;93;227;320;0,000514065308784573;0,000149400230365517;0,000364665078419056;0,000514065308784573
"334";"AGES";2021-04-05;2021;14;"All";"12-17 anos";32;6;0;38;352;232;0;584;119;233;352;0,00056547183966303;0,000191168036704263;0,000374303802958767;0,00056547183966303
"335";"AGES";2021-04-12;2021;15;"All";"12-17 anos";47;9;0;56;399;241;0;640;157;242;399;0,000640975181890764;0,000252213292122431;0,000388761889768333;0,000640975181890764
"336";"AGES";2021-04-19;2021;16;"All";"12-17 anos";31;14;0;45;430;255;0;685;172;258;430;0,00069077525867927;0,000276310103471708;0,000414465155207562;0,00069077525867927
"337";"AGES";2021-04-26;2021;17;"All";"12-17 anos";50;27;0;77;480;282;0;762;194;286;480;0,000771097963176859;0,000311652093450647;0,000459445869726212;0,000771097963176859
"338";"AGES";2021-05-03;2021;18;"All";"12-17 anos";110;15;0;125;590;297;0;887;288;302;590;0,000947807913071556;0,000462658777906116;0,000485149135165441;0,000947807913071556
"339";"AGES";2021-05-10;2021;19;"All";"12-17 anos";167;46;0;213;757;343;0;1100;409;348;757;0,00121608574609351;0,000657039722790282;0,000559046023303223;0,00121608574609351
"340";"AGES";2021-05-17;2021;20;"All";"12-17 anos";316;26;0;342;1073;369;0;1442;699;374;1073;0,00172372523851827;0,0011229114088763;0,00060081382964197;0,00172372523851827
"341";"AGES";2021-05-24;2021;21;"All";"12-17 anos";304;40;0;344;1377;409;0;1786;957;420;1377;0,00221208728186362;0,00153737656408386;0,000674710717779752;0,00221208728186362
"342";"AGES";2021-05-31;2021;22;"All";"12-17 anos";280;116;0;396;1657;525;0;2182;1109;548;1657;0,00266189442705012;0,00178155758575654;0,000880336841293581;0,00266189442705012
"343";"AGES";2021-06-07;2021;23;"All";"12-17 anos";402;165;0;567;2059;690;0;2749;1341;719;2060;0,00330768897121074;0,00215425493462535;0,00115504049067534;0,00330929542530069
"344";"AGES";2021-06-14;2021;24;"All";"12-17 anos";587;336;0;923;2646;1026;0;3672;1589;1060;2649;0,00425067752201244;0,00255265554893339;0,0017028413353489;0,00425549688428229
"345";"AGES";2021-06-21;2021;25;"All";"12-17 anos";413;296;2;711;3059;1322;2;4383;1701;1367;3068;0,00491414306116253;0,002732578407008;0,0021960227409641;0,00492860114797209
"346";"AGES";2021-06-28;2021;26;"All";"12-17 anos";233;282;0;515;3292;1604;2;4898;1647;1654;3301;0,00528844686412129;0,0026458298861506;0,00265707506478026;0,00530290495093086
"347";"AGES";2021-07-05;2021;27;"All";"12-17 anos";442;666;1;1109;3734;2270;3;6007;1413;2331;3744;0,00599849957187999;0,00226991962910188;0,00374464448367762;0,0060145641127795
"348";"AGES";2021-07-12;2021;28;"All";"12-17 anos";277;320;2;599;4011;2590;5;6606;1365;2672;4037;0,00644348735479663;0,00219280983278419;0,00429244532835118;0,00648525516113538
"349";"AGES";2021-07-19;2021;29;"All";"12-17 anos";274;278;2;554;4285;2868;7;7160;1347;2975;4322;0,00688365577544342;0,00216389365916506;0,00477920091760658;0,00694309457677164
"350";"AGES";2021-07-26;2021;30;"All";"12-17 anos";1630;393;0;2023;5915;3261;7;9183;2546;3415;5961;0,00950217594206484;0,00409003211301726;0,00548604071718536;0,00957607283020262
"351";"AGES";2021-08-02;2021;31;"All";"12-17 anos";4629;214;1;4844;10544;3475;8;14027;6827;3792;10619;0,0169384519244517;0,0109672620721009;0,00609167390909719;0,0170589359811981
"352";"AGES";2021-08-09;2021;32;"All";"12-17 anos";142691;418;2;143111;153235;3893;10;157138;137931;15504;153435;0,246164992473763;0,22157981908114;0,0249064642106126;0,246486283291753
"353";"AGES";2021-08-16;2021;33;"All";"12-17 anos";177915;1584;1;179500;331150;5477;11;336638;302060;29356;331416;0,531977271887535;0,485245522410838;0,0471590662646248;0,532404588675463
"354";"AGES";2021-08-23;2021;34;"All";"12-17 anos";132406;3940;4;136350;463556;9417;15;472988;421702;42144;463846;0,744681432121692;0,67744490264085;0,0677024011669282;0,745147303807778
"355";"AGES";2021-08-30;2021;35;"All";"12-17 anos";42111;110104;13;152228;505667;119521;28;625216;349022;156943;505965;0,812330820303652;0,560687819383154;0,252121724239304;0,812809543622458
"356";"AGES";2021-09-06;2021;36;"All";"12-17 anos";20523;162719;14;183256;526190;282240;42;808472;205000;321491;526491;0,845300077591733;0,329323088440117;0,516460531832691;0,845783620272808
"357";"AGES";2021-09-13;2021;37;"All";"12-17 anos";12816;126877;31;139724;539006;409117;73;948196;89690;449619;539309;0,865888393208555;0,144082867327776;0,722292281470034;0,86637514879781
"358";"AGES";2021-09-20;2021;38;"All";"12-17 anos";5635;41659;16;47310;544641;450776;89;995506;52717;492228;544945;0,874940762005433;0,0846874402599885;0,79074168378879;0,875429124048778
"359";"AGES";2021-09-27;2021;39;"All";"12-17 anos";3217;17203;14;20434;547858;467979;103;1015940;37932;510230;548162;0,880108724812808;0,0609360165400513;0,819661070316102;0,880597086856153
"360";"AGES";2021-10-04;2021;40;"All";"12-17 anos";2306;10934;3;13243;550164;478913;106;1029183;28898;521571;550469;0,883813207944237;0,0464233102914268;0,837879866150245;0,884303176441672
"361";"AGES";2021-01-04;2021;1;"All";"18-24 anos";1853;4;0;1857;3222;5;0;3227;3216;6;3222;0,00412455595737191;0,00411687522002112;7,68073735078567e-06;0,00412455595737191
"362";"AGES";2021-01-11;2021;2;"All";"18-24 anos";1446;56;0;1502;4668;61;0;4729;4605;63;4668;0,00597561365891126;0,00589496591672801;8,06477421832496e-05;0,00597561365891126
"363";"AGES";2021-01-18;2021;3;"All";"18-24 anos";3875;1201;0;5076;8543;1262;0;9805;7276;1267;8543;0,010936089864627;0,00931417416071943;0,00162191570390758;0,010936089864627
"364";"AGES";2021-01-25;2021;4;"All";"18-24 anos";1398;1646;1;3045;9941;2908;1;12850;7029;2914;9943;0,0127257016673601;0,00899798380644542;0,00373027810669824;0,0127282619131437
"365";"AGES";2021-02-01;2021;5;"All";"18-24 anos";999;944;0;1943;10940;3852;1;14793;7083;3860;10943;0,0140045444362659;0,00906711044260249;0,00494127436233878;0,0140083848049413
"366";"AGES";2021-02-08;2021;6;"All";"18-24 anos";1483;3075;0;4558;12423;6927;1;19351;5479;6947;12426;0,0159029666848017;0,00701379332415912;0,00889301372931801;0,0159068070534771
"367";"AGES";2021-02-15;2021;7;"All";"18-24 anos";2332;1749;1;4082;14755;8676;2;23433;6022;8736;14758;0,0188882132684738;0,00770890005440522;0,0111831535827439;0,0188920536371492
"368";"AGES";2021-02-22;2021;8;"All";"18-24 anos";1339;708;0;2047;16094;9384;2;25480;6624;9473;16097;0,0206022978205908;0,00847953403526738;0,0121266041539988;0,0206061381892662
"369";"AGES";2021-03-01;2021;9;"All";"18-24 anos";957;1046;1;2004;17051;10430;3;27484;6512;10544;17056;0,0218273754280411;0,00833616027138605;0,013497615771114;0,0218337760425001
"370";"AGES";2021-03-08;2021;10;"All";"18-24 anos";1397;647;1;2045;18448;11077;4;29529;7253;11203;18456;0,0236157071078824;0,00928473133420808;0,0143412167568087;0,0236259480910167
"371";"AGES";2021-03-15;2021;11;"All";"18-24 anos";282;399;2;683;18730;11476;6;30212;7135;11604;18739;0,0239767017633693;0,00913367683297597;0,0148545460364195;0,0239882228693955
"372";"AGES";2021-03-22;2021;12;"All";"18-24 anos";3294;180;0;3474;22024;11656;6;33686;10233;11801;22034;0,0281934265689506;0,013099497551765;0,0151067302461036;0,0282062277978686
"373";"AGES";2021-03-29;2021;13;"All";"18-24 anos";687;108;0;795;22711;11764;6;34481;10800;11924;22724;0,0290728709956156;0,0138253272314142;0,0152641853617947;0,0290895125932089
"374";"AGES";2021-04-05;2021;14;"All";"18-24 anos";808;194;0;1002;23519;11958;6;35483;11422;12125;23547;0,0301072102921881;0,0146215636701123;0,0155214900630461;0,0301430537331584
"375";"AGES";2021-04-12;2021;15;"All";"18-24 anos";4306;108;0;4414;27825;12066;6;39897;15607;12253;27860;0,0356194194642686;0,0199788779722853;0,0156853457931961;0,0356642237654815
"376";"AGES";2021-04-19;2021;16;"All";"18-24 anos";1315;107;0;1422;29140;12173;6;41319;16773;12402;29175;0,0373027810669824;0,0214715012641214;0,015876084104074;0,0373475853681953
"377";"AGES";2021-04-26;2021;17;"All";"18-24 anos";2685;184;0;2869;31825;12357;6;44188;19273;12617;31890;0,040739911031459;0,0246718084936154;0,0161513105258105;0,0408231190194259
"378";"AGES";2021-05-03;2021;18;"All";"18-24 anos";1855;845;0;2700;33680;13202;6;46888;20299;13497;33796;0,0431145389957436;0,0259852145805997;0,0172778186705924;0,0432630332511921
"379";"AGES";2021-05-10;2021;19;"All";"18-24 anos";2265;5422;0;7687;35945;18624;6;54575;17121;18955;36076;0,0460140173456652;0,0219169840304669;0,0242647294140237;0,0461817134444907
"380";"AGES";2021-05-17;2021;20;"All";"18-24 anos";2113;2478;0;4591;38058;21102;6;59166;16690;21504;38194;0,0487189170160335;0,0213652510641022;0,0275277626652159;0,048893013729318
"381";"AGES";2021-05-24;2021;21;"All";"18-24 anos";2288;3303;0;5591;40346;24405;6;64757;15476;25028;40504;0,0516478381924665;0,0198111818734599;0,0320389157359106;0,0518500976093705
"382";"AGES";2021-05-31;2021;22;"All";"18-24 anos";2392;2695;2;5089;42738;27100;8;69846;14921;27984;42905;0,0547098921496464;0,0191007136685122;0,0358229590040644;0,0549236726725766
"383";"AGES";2021-06-07;2021;23;"All";"18-24 anos";2873;2937;1;5811;45611;30037;9;75657;14664;31146;45810;0,0583876852177809;0,0187717220853202;0,0398707075879284;0,0586424296732486
"384";"AGES";2021-06-14;2021;24;"All";"18-24 anos";3155;4585;2;7742;48766;34622;11;83399;13245;36001;49246;0,0624264729414024;0,0169552277018594;0,0460857042276058;0,0630409319294652
"385";"AGES";2021-06-21;2021;25;"All";"18-24 anos";2909;3039;7;5955;51675;37661;18;89354;13281;39390;52671;0,0661503504336416;0,0170013121259641;0,050424040707908;0,067425352833872
"386";"AGES";2021-06-28;2021;26;"All";"18-24 anos";2111;3093;7;5211;53786;40754;25;94565;12559;42722;55281;0,0688526898582264;0,0160770633980862;0,0546894101833776;0,0707664735814638
"387";"AGES";2021-07-05;2021;27;"All";"18-24 anos";11897;5100;13;17010;65683;45854;38;111575;20045;48764;68809;0,0840823119019426;0,0256600633660831;0,0624239126956188;0,0880839760617019
"388";"AGES";2021-07-12;2021;28;"All";"18-24 anos";14171;7867;6;22044;79854;53721;44;133619;31250;57876;89126;0,102222933401607;0,0400038403686754;0,0740883924856786;0,114092232854354
"389";"AGES";2021-07-19;2021;29;"All";"18-24 anos";19500;19670;0;39170;99354;73391;44;172789;46346;79621;125967;0,12718532979166;0,0593285755432522;0,101924664767818;0,16125324031107
"390";"AGES";2021-07-26;2021;30;"All";"18-24 anos";21011;22619;11;43641;120365;96010;55;216430;61911;104516;166427;0,15408199187122;0,079253688354082;0,133793324159119;0,213047012513201
"391";"AGES";2021-08-02;2021;31;"All";"18-24 anos";53933;56475;4;110412;174298;152485;59;326842;101734;166678;268412;0,22312285979454;0,130232022274138;0,213368323359042;0,343600345633181
"392";"AGES";2021-08-09;2021;32;"All";"18-24 anos";87707;82605;7;170319;262005;235090;66;497161;165643;260606;426249;0,335398598265434;0,212043396166032;0,333607706339809;0,545651102505841
"393";"AGES";2021-08-16;2021;33;"All";"18-24 anos";94298;74420;13;168731;356303;309510;79;665892;229731;346949;576680;0,456111626716165;0,294083912055557;0,44413735718629;0,738221269241847
"394";"AGES";2021-08-23;2021;34;"All";"18-24 anos";56328;43794;6;100128;412631;353304;85;766020;249968;397350;647318;0,528218388965341;0,319989759016866;0,508656831055781;0,828646590072647
"395";"AGES";2021-08-30;2021;35;"All";"18-24 anos";22678;100484;5;123167;435309;453788;90;889187;171393;502220;673613;0,557249015905527;0,219404102793868;0,642903318718597;0,862307421512465
"396";"AGES";2021-09-06;2021;36;"All";"18-24 anos";12921;78479;15;91415;448230;532267;105;980602;104668;582763;687431;0,573789483790444;0,133987902838673;0,746008256792652;0,879996159631325
"397";"AGES";2021-09-13;2021;37;"All";"18-24 anos";9061;52561;5;61627;457291;584828;110;1042229;60325;636748;697073;0,585388677313022;0,077223413447691;0,815115691106346;0,892339104554037
"398";"AGES";2021-09-20;2021;38;"All";"18-24 anos";7143;18650;6;25799;464434;603478;116;1068028;47727;656855;704582;0,594532595129132;0,0610964252568247;0,840855122091721;0,901951547348545
"399";"AGES";2021-09-27;2021;39;"All";"18-24 anos";4956;11382;6;16344;469390;614860;122;1084372;40202;669633;709835;0,600876884180881;0,0514635004960476;0,857212532403111;0,908676032899158
"400";"AGES";2021-10-04;2021;40;"All";"18-24 anos";2942;9355;17;12314;472332;624215;139;1096686;33493;679724;713217;0,60464300572855;0,0428751560149774;0,87013025250424;0,913005408519218
"401";"AGES";2021-01-04;2021;1;"All";"25-49 anos";28013;78;0;28091;52103;89;2;52194;52018;92;52110;0,0156392153708127;0,0156137018052499;2,76146827268058e-05;0,0156413164879767
"402";"AGES";2021-01-11;2021;2;"All";"25-49 anos";16882;814;0;17696;68985;903;2;69890;68075;917;68992;0,0207065096511815;0,020433364419862;0,000275246348483489;0,0207086107683455
"403";"AGES";2021-01-18;2021;3;"All";"25-49 anos";37865;21836;6;59707;106850;22739;8;129597;84064;22794;106858;0,0320720527104261;0,025232616182024;0,006841837805161;0,032074453987185
"404";"AGES";2021-01-25;2021;4;"All";"25-49 anos";15855;26292;10;42157;122705;49031;18;171754;73605;49108;122713;0,0368310830868773;0,022093246979419;0,0147402373842172;0,0368334843636361
"405";"AGES";2021-02-01;2021;5;"All";"25-49 anos";10151;12590;2;22743;132856;61621;20;194497;71163;61707;132870;0,0398780031342665;0,0213602572487792;0,0185219481198153;0,0398822053685945
"406";"AGES";2021-02-08;2021;6;"All";"25-49 anos";13941;30965;5;44911;146797;92586;25;239408;54028;92784;146812;0,0440625280461621;0,0162170225909116;0,0278500078491734;0,044067030440085
"407";"AGES";2021-02-15;2021;7;"All";"25-49 anos";22477;19094;6;41577;169274;111680;31;280985;57073;112216;169289;0,0508092152597536;0,0171310085572499;0,0336827090964266;0,0508137176536765
"408";"AGES";2021-02-22;2021;8;"All";"25-49 anos";11754;7380;2;19136;181028;119060;33;300121;61210;119833;181043;0,0543372911376979;0,0183727688011716;0,0359690247304492;0,0543417935316208
"409";"AGES";2021-03-01;2021;9;"All";"25-49 anos";7737;10069;6;17812;188765;129129;39;317933;58706;130085;188791;0,0566596259231033;0,0176211691756507;0,0390462608969189;0,0566674300725696
"410";"AGES";2021-03-08;2021;10;"All";"25-49 anos";16565;6351;2;22918;205330;135480;41;340851;68785;136590;205375;0,0616317696119026;0,0206464777322102;0,040998799061461;0,0616452767936712
"411";"AGES";2021-03-15;2021;11;"All";"25-49 anos";4784;3394;5;8183;210114;138874;46;349034;70143;140026;210169;0,0630677331136966;0,0210540944620255;0,0420301474293882;0,0630842418914137
"412";"AGES";2021-03-22;2021;12;"All";"25-49 anos";42530;1802;0;44332;252644;140676;46;393366;110704;142005;252709;0,0758335206829471;0,0332288677890034;0,0426241632676094;0,0758530310566128
"413";"AGES";2021-03-29;2021;13;"All";"25-49 anos";4815;1278;2;6095;257459;141954;48;399461;114194;143355;257549;0,0772787891321816;0,0342764247750529;0,0430293787206658;0,0773058034957187
"414";"AGES";2021-04-05;2021;14;"All";"25-49 anos";9194;1410;1;10605;266653;143364;49;410066;121939;144869;266808;0,080038456447293;0,0366011608372172;0,0434838203472786;0,0800849811844958
"415";"AGES";2021-04-12;2021;15;"All";"25-49 anos";89432;933;0;90365;356085;144297;49;500431;210303;145952;356255;0,106882329334507;0,0631244632771244;0,0438088931885083;0,106933356465633
"416";"AGES";2021-04-19;2021;16;"All";"25-49 anos";11294;961;2;12257;367379;145258;51;512688;220258;147296;367554;0,110272331798817;0,0661125520439218;0,0442123076839956;0,110324859727917
"417";"AGES";2021-04-26;2021;17;"All";"25-49 anos";11282;1078;3;12363;378661;146336;54;525051;230381;148534;378915;0,113658732347989;0,069151067622655;0,044583905262428;0,113734972885083
"418";"AGES";2021-05-03;2021;18;"All";"25-49 anos";10615;8223;4;18842;389276;154559;58;543893;232658;156973;389631;0,116844926447392;0,0698345310201434;0,0471169520834228;0,116951483103566
"419";"AGES";2021-05-10;2021;19;"All";"25-49 anos";25457;100608;10;126075;414733;255167;68;669968;157189;258003;415192;0,124486089253656;0,0471817865559118;0,0774420759517836;0,124623862507695
"420";"AGES";2021-05-17;2021;20;"All";"25-49 anos";32980;22177;7;55164;447713;277344;75;725132;167341;280971;448312;0,134385352692026;0,0502290067628958;0,0843361415264496;0,134565148289345
"421";"AGES";2021-05-24;2021;21;"All";"25-49 anos";26674;18585;6;45265;474387;295929;81;770397;173518;301744;475262;0,142391809725231;0,052083092580325;0,0905713567904055;0,14265444937073
"422";"AGES";2021-05-31;2021;22;"All";"25-49 anos";42912;24074;22;67008;517299;320003;103;837405;190240;328337;518577;0,155272258259717;0,0571023613255168;0,0985535008964266;0,155655862221943
"423";"AGES";2021-06-07;2021;23;"All";"25-49 anos";128735;32337;21;161093;646034;352340;124;998498;283389;366025;649414;0,193913303703579;0,0850619274268128;0,109865915707382;0,194927843134194
"424";"AGES";2021-06-14;2021;24;"All";"25-49 anos";240728;85771;42;326541;886762;438111;166;1325039;445491;461945;907436;0,266170122654215;0,133718398072255;0,138657224046025;0,27237562211828
"425";"AGES";2021-06-21;2021;25;"All";"25-49 anos";273324;56574;160;330058;1160086;494685;326;1655097;673896;532399;1206295;0,348210943758797;0,202276350335473;0,159804668142051;0,362081018477524
"426";"AGES";2021-06-28;2021;26;"All";"25-49 anos";315738;62018;124;377880;1475824;556703;450;2032977;926691;612191;1538882;0,442982733919625;0,278155195117244;0,183755002534848;0,461910197652092
"427";"AGES";2021-07-05;2021;27;"All";"25-49 anos";368975;147887;19;516881;1844799;704590;469;2549858;1152200;784008;1936208;0,553734120431834;0,345843885193758;0,235327523644322;0,581171408838079
"428";"AGES";2021-07-12;2021;28;"All";"25-49 anos";208587;317074;59;525720;2053386;1021664;528;3075578;1117824;1122648;2240472;0,616343509844184;0,335525598960968;0,336973568846556;0,672499167807523
"429";"AGES";2021-07-19;2021;29;"All";"25-49 anos";103887;344159;53;448099;2157273;1365823;581;3523677;955377;1482919;2438296;0,64752618967505;0,2867655732553;0,445112366245133;0,731877939500432
"430";"AGES";2021-07-26;2021;30;"All";"25-49 anos";61654;354246;31;415931;2218927;1720069;612;3939608;711906;1851347;2563253;0,666032229336338;0,213685416535972;0,555699565458954;0,769384981994927
"431";"AGES";2021-08-02;2021;31;"All";"25-49 anos";52810;383583;37;436430;2271737;2103652;649;4376038;418465;2249542;2668007;0,681883657540714;0,125606284861661;0,675221615332873;0,800827900194533
"432";"AGES";2021-08-09;2021;32;"All";"25-49 anos";70645;237669;36;308350;2342382;2341321;685;4684388;291645;2506272;2797917;0,703088432119358;0,0875400450419488;0,752281588120404;0,839821633162352
"433";"AGES";2021-08-16;2021;33;"All";"25-49 anos";78089;145455;31;223575;2420471;2486776;716;4907963;252161;2667499;2919660;0,726527594722114;0,0756885435986314;0,800675419120346;0,876363962718978
"434";"AGES";2021-08-23;2021;34;"All";"25-49 anos";88311;79788;19;168118;2508782;2566564;735;5076081;264554;2763614;3028168;0,753034988703494;0,0794084214576891;0,829525258579987;0,908933680037676
"435";"AGES";2021-08-30;2021;35;"All";"25-49 anos";46501;80456;19;126976;2555283;2647020;754;5203057;224681;2857449;3082130;0,76699271002392;0,0674401579319724;0,857690734163355;0,925130892095327
"436";"AGES";2021-09-06;2021;36;"All";"25-49 anos";25029;63569;42;88640;2580312;2710589;796;5291697;181904;2927081;3108985;0,774505404523585;0,0546002309427923;0,878591447072408;0,933191678015201
"437";"AGES";2021-09-13;2021;37;"All";"25-49 anos";18683;66696;45;85424;2598995;2777285;841;5377121;131451;2997852;3129303;0,780113286234291;0,039456278903493;0,899834041760004;0,939290320663497
"438";"AGES";2021-09-20;2021;38;"All";"25-49 anos";16573;32046;43;48662;2615568;2809331;884;5425783;112807;3034074;3146881;0,785087831199849;0,0338601034169868;0,910706422604899;0,944566526021886
"439";"AGES";2021-09-27;2021;39;"All";"25-49 anos";10955;21154;38;32147;2626523;2830485;922;5457930;99619;3059086;3158705;0,788376079561503;0,0299015986800182;0,918214014391452;0,94811561307147
"440";"AGES";2021-10-04;2021;40;"All";"25-49 anos";6169;17270;90;23529;2632692;2847755;1012;5481459;88089;3077962;3166051;0,790227764102173;0,0264407585513217;0,923879826903965;0,950320585455287
"441";"AGES";2021-01-04;2021;1;"All";"50-64 anos";13017;7;0;13024;22282;9;0;22291;22275;10;22285;0,0102484567752179;0,0102452371720662;4,59943307387931e-06;0,0102498366051401
"442";"AGES";2021-01-11;2021;2;"All";"50-64 anos";11715;309;0;12024;33997;318;0;34315;33671;329;34000;0,0156366926212675;0,015486751103059;0,000151321348130629;0,0156380724511897
"443";"AGES";2021-01-18;2021;3;"All";"50-64 anos";27473;8601;2;36076;61470;8919;2;70391;52521;8952;61473;0,0282727151051361;0,0241566824473215;0,00411741248773676;0,0282740949350583
"444";"AGES";2021-01-25;2021;4;"All";"50-64 anos";10812;12435;4;23251;72282;21354;6;93642;50885;21400;72285;0,0332456221446145;0,0234042151964349;0,00984278677810173;0,0332470019745366
"445";"AGES";2021-02-01;2021;5;"All";"50-64 anos";5584;9231;0;14815;77866;30585;6;108457;47233;30638;77871;0,0358139455730687;0,0217245022378542;0,0140917430517514;0,0358162452896056
"446";"AGES";2021-02-08;2021;6;"All";"50-64 anos";6917;22306;4;29227;84783;52891;10;137684;31787;53001;84788;0,038995373430271;0,0146202179119402;0,0243774552348677;0,0389976731468079
"447";"AGES";2021-02-15;2021;7;"All";"50-64 anos";25168;12988;1;38157;109951;65879;11;175841;43849;66107;109956;0,0505712265906104;0,0201680540856534;0,030405472221494;0,0505735263071474
"448";"AGES";2021-02-22;2021;8;"All";"50-64 anos";49884;4971;4;54859;159835;70850;15;230700;88583;71257;159840;0,07351503853635;0,0407431579983451;0,0327741802545418;0,0735173382528869
"449";"AGES";2021-03-01;2021;9;"All";"50-64 anos";30255;6006;3;36264;190090;76856;18;266964;112750;77352;190102;0,0874306233013719;0,0518586079079893;0,0355775347130713;0,0874361426210605
"450";"AGES";2021-03-08;2021;10;"All";"50-64 anos";22435;4298;1;26734;212525;81154;19;293698;130823;81724;212547;0,0977494514026201;0,0601711633024113;0,0375884068529713;0,0977595701553826
"451";"AGES";2021-03-15;2021;11;"All";"50-64 anos";4800;2349;1;7150;217325;83503;20;300848;133269;84097;217366;0,0999571792780822;0,0612961846322822;0,0386798523214029;0,0999760369536851
"452";"AGES";2021-03-22;2021;12;"All";"50-64 anos";34725;1011;2;35738;252050;84514;22;336586;166853;85247;252100;0,115928710627128;0,0767429206675985;0,039208787124899;0,115951707792497
"453";"AGES";2021-03-29;2021;13;"All";"50-64 anos";7872;818;1;8691;259922;85332;23;345277;173904;86089;259993;0,119549384342886;0,0799859809279908;0,0395960593897196;0,11958204031771
"454";"AGES";2021-04-05;2021;14;"All";"50-64 anos";15271;985;1;16257;275193;86317;24;361534;188144;87161;275305;0,126573178590007;0,086535573625195;0,0400891186152395;0,126624692240434
"455";"AGES";2021-04-12;2021;15;"All";"50-64 anos";88084;629;0;88713;363277;86946;24;450247;275512;87888;363400;0,167086824877966;0,126719900505064;0,0404234973997105;0,167143397904774
"456";"AGES";2021-04-19;2021;16;"All";"50-64 anos";14538;1858;4;16400;377815;88804;28;466647;287941;89999;377940;0,173773480680771;0,132436535872588;0,0413944377216064;0,173830973594195
"457";"AGES";2021-04-26;2021;17;"All";"50-64 anos";33049;2992;4;36045;410864;91796;32;502692;318118;93136;411254;0,188974147046635;0,146316245059634;0,0428372798768824;0,189153524936516
"458";"AGES";2021-05-03;2021;18;"All";"50-64 anos";151618;14898;9;166525;562482;106694;41;669217;460129;108405;568534;0,258709831426178;0,211633254085101;0,0498601542373887;0,26149340832249
"459";"AGES";2021-05-10;2021;19;"All";"50-64 anos";166799;109956;10;276765;729281;216650;51;945982;526055;219005;745060;0,335427915155178;0,241955476567958;0,100729884034494;0,342685360602452
"460";"AGES";2021-05-17;2021;20;"All";"50-64 anos";224856;75943;12;300811;954137;292593;63;1246793;689733;298441;988174;0,438848927481199;0,3172380772346;0,137265940600162;0,454504017834762
"461";"AGES";2021-05-24;2021;21;"All";"50-64 anos";175366;98673;80;274119;1129503;391266;143;1520912;801143;406549;1207692;0,519507345524591;0,368480361110689;0,186989491675256;0,555469852785946
"462";"AGES";2021-05-31;2021;22;"All";"50-64 anos";163798;169117;13;332928;1293301;560383;156;1853840;837530;583942;1421472;0,594845139388119;0,385216318236614;0,268580214802723;0,653796533039338
"463";"AGES";2021-06-07;2021;23;"All";"50-64 anos";210031;139522;42;349595;1503332;699905;198;2203435;920531;734563;1655094;0,691447492182114;0,42339207269312;0,337857335704801;0,761249408397921
"464";"AGES";2021-06-14;2021;24;"All";"50-64 anos";86411;231489;63;317963;1589743;931394;261;2521398;785258;972744;1758002;0,731191653316812;0,361174161672832;0,447407092601766;0,808581254274598
"465";"AGES";2021-06-21;2021;25;"All";"50-64 anos";86627;184005;210;270842;1676370;1115399;471;2792240;695873;1164735;1860608;0,771035162205907;0,320062129141962;0,535712068130482;0,855774197272444
"466";"AGES";2021-06-28;2021;26;"All";"50-64 anos";59455;179149;72;238676;1735825;1294548;543;3030916;575622;1351442;1927064;0,798381091546656;0,264753486485256;0,621586703222961;0,886340189708217
"467";"AGES";2021-07-05;2021;27;"All";"50-64 anos";41463;258421;46;299930;1777288;1552969;589;3330846;358204;1617346;1975550;0,817451720900882;0,164753532479587;0,743887468430641;0,908641000910228
"468";"AGES";2021-07-12;2021;28;"All";"50-64 anos";15442;134741;33;150216;1792730;1687710;622;3481062;243818;1758323;2002141;0,824554165453566;0,112142457320711;0,80872889607627;0,92087135339698
"469";"AGES";2021-07-19;2021;29;"All";"50-64 anos";10959;115148;25;126132;1803689;1802858;647;3607194;151414;1880190;2031604;0,829594684159231;0,0696418559448362;0,864780807117715;0,934422663062551
"470";"AGES";2021-07-26;2021;30;"All";"50-64 anos";9857;87498;22;97377;1813546;1890356;669;3704571;83727;1974460;2058187;0,834128345340153;0,0385096732976693;0,908139662705175;0,946649336002844
"471";"AGES";2021-08-02;2021;31;"All";"50-64 anos";8629;54037;13;62679;1822175;1944393;682;3767250;46779;2034649;2081428;0,838097196139604;0,0215156879763;0,935823190433547;0,957338878409847
"472";"AGES";2021-08-09;2021;32;"All";"50-64 anos";7378;24414;5;31797;1829553;1968807;687;3799047;35636;2064311;2099947;0,841490657861512;0,0163905397020763;0,949466028817288;0,965856568519364
"473";"AGES";2021-08-16;2021;33;"All";"50-64 anos";7537;13056;13;20606;1837090;1981863;700;3819653;33427;2081600;2115027;0,844957250569295;0,0153745249360564;0,957417988658718;0,972792513594774
"474";"AGES";2021-08-23;2021;34;"All";"50-64 anos";11305;8247;2;19554;1848395;1990110;702;3839207;36668;2094637;2131305;0,850156909659315;0,0168652011953007;0,963414269557134;0,980279470752435
"475";"AGES";2021-08-30;2021;35;"All";"50-64 anos";12899;6113;11;19023;1861294;1996223;713;3858230;41118;2106181;2147299;0,856089718381312;0,018911948913177;0,968723855097621;0,987635804010798
"476";"AGES";2021-09-06;2021;36;"All";"50-64 anos";5575;3991;24;9590;1866869;2000214;737;3867820;41019;2112488;2153507;0,85865390232;0,0188664145257456;0,971624717537316;0,990491132063062
"477";"AGES";2021-09-13;2021;37;"All";"50-64 anos";3641;7340;33;11014;1870510;2007554;770;3878834;36591;2121024;2157615;0,860328555902199;0,0168297855606318;0,97555079360918;0,992380579169811
"478";"AGES";2021-09-20;2021;38;"All";"50-64 anos";3235;6580;48;9863;1873745;2014134;818;3888697;32500;2128687;2161187;0,861816472501599;0,0149481574901078;0,979075339173693;0,994023496663801
"479";"AGES";2021-09-27;2021;39;"All";"50-64 anos";1996;5001;40;7037;1875741;2019135;858;3895734;29032;2134378;2163410;0,862734519343146;0,0133530741000864;0,981692876536038;0,995045950636125
"480";"AGES";2021-10-04;2021;40;"All";"50-64 anos";1008;3816;71;4895;1876749;2022951;929;3900629;26245;2138466;2164711;0,863198142196993;0,0120712121023963;0,98357312477664;0,995644336879036
"481";"AGES";2021-01-04;2021;1;"All";"65-79 anos";2311;3;0;2314;3281;5;0;3286;3277;5;3282;0,00201528446775238;0,00201282755282674;3,07114365704416e-06;0,00201589869648379
"482";"AGES";2021-01-11;2021;2;"All";"65-79 anos";5556;30;0;5586;8837;35;0;8872;8794;44;8838;0,00542793929945985;0,00540152746400927;2,70260641819886e-05;0,00542855352819126
"483";"AGES";2021-01-18;2021;3;"All";"65-79 anos";14150;918;0;15068;22987;953;0;23940;22005;983;22988;0,0141192758488948;0,0135161032346513;0,000603786842974882;0,0141198900776262
"484";"AGES";2021-01-25;2021;4;"All";"65-79 anos";6613;2158;0;8771;29600;3111;0;32711;26444;3157;29601;0,0181811704497014;0,0162426645733751;0,00193912010505768;0,0181817846784328
"485";"AGES";2021-02-01;2021;5;"All";"65-79 anos";2829;4181;0;7010;32429;7292;0;39721;25091;7339;32430;0,019918823530857;0,015411613099779;0,00450782465980942;0,0199194377595884
"486";"AGES";2021-02-08;2021;6;"All";"65-79 anos";3800;11557;1;15358;36229;18849;1;55079;17311;18919;36230;0,0222528927102106;0,0106329135694183;0,0116205933695237;0,022253506938942
"487";"AGES";2021-02-15;2021;7;"All";"65-79 anos";5160;7284;0;12444;41389;26133;1;67523;15155;26235;41390;0,0254223129642801;0,00930863642450085;0,0161142907685107;0,0254229271930116
"488";"AGES";2021-02-22;2021;8;"All";"65-79 anos";11694;2487;4;14185;53083;28620;5;81708;24303;28781;53084;0,032605103749375;0,0149276008594288;0,0176781171186776;0,0326057179781064
"489";"AGES";2021-03-01;2021;9;"All";"65-79 anos";13340;3830;1;17171;66423;32450;6;98879;33802;32632;66434;0,0407989150263688;0,0207621595790813;0,020043511963333;0,0408056715424143
"490";"AGES";2021-03-08;2021;10;"All";"65-79 anos";15975;3600;0;19575;82398;36050;6;118454;46169;36258;82427;0,0506112190106249;0,0283583263004144;0,0222707053434214;0,0506290316438358
"491";"AGES";2021-03-15;2021;11;"All";"65-79 anos";18193;6866;4;25063;100591;42916;10;143517;57492;43136;100628;0,0617858823211458;0,0353132382261566;0,0264953705580514;0,0618086087842079
"492";"AGES";2021-03-22;2021;12;"All";"65-79 anos";52885;2241;3;55129;153476;45157;13;198646;108078;45444;153522;0,0942693687817019;0,0663846128332037;0,027913010470143;0,0942976233033467
"493";"AGES";2021-03-29;2021;13;"All";"65-79 anos";88353;7440;3;95796;241829;52597;16;294442;188959;52932;241891;0,148538319887866;0,116064046858281;0,0325123552109323;0,148576402069214
"494";"AGES";2021-04-05;2021;14;"All";"65-79 anos";201450;5373;8;206831;443279;57970;24;501273;384936;58423;443359;0,272274697830176;0,23643875095359;0,0358850851750982;0,272323836128688
"495";"AGES";2021-04-12;2021;15;"All";"65-79 anos";233804;3649;8;237461;677083;61619;32;738734;614959;62208;677167;0,415883832148486;0,377725486438444;0,0382099409234806;0,415935427361924
"496";"AGES";2021-04-19;2021;16;"All";"65-79 anos";175902;13319;12;189233;852985;74938;44;927967;777355;75717;853072;0,523927894460762;0,477473775504313;0,0465075568560825;0,523981332360395
"497";"AGES";2021-04-26;2021;17;"All";"65-79 anos";293322;46461;11;339794;1146307;121399;55;1267761;1024975;122424;1147399;0,704094694415064;0,629569093975767;0,0751963382139948;0,704765432189762
"498";"AGES";2021-05-03;2021;18;"All";"65-79 anos";202510;164478;11;366999;1348817;285877;66;1634760;1069255;287194;1356449;0,828482154812666;0,656767142202551;0,176402806288228;0,833169948490779
"499";"AGES";2021-05-10;2021;19;"All";"65-79 anos";91567;80348;10;171925;1440384;366225;76;1806685;1087845;368006;1455851;0,884725237061579;0,668185654319441;0,226039858530839;0,894225512850279
"500";"AGES";2021-05-17;2021;20;"All";"65-79 anos";41344;111858;12;153214;1481728;478083;88;1959899;1017060;485334;1502394;0,910119909732946;0,624707473566667;0,298106087129574;0,922813560696241
"501";"AGES";2021-05-24;2021;21;"All";"65-79 anos";23642;202828;27;226497;1505370;680911;115;2186396;833638;697038;1530676;0,924641505400913;0,512044411194196;0,428140766483749;0,940185177677945
"502";"AGES";2021-05-31;2021;22;"All";"65-79 anos";18707;137683;16;156406;1524077;818594;131;2342802;717245;837853;1555098;0,936131882279378;0,440552486459328;0,514633385297084;0,955185871756412
"503";"AGES";2021-06-07;2021;23;"All";"65-79 anos";16108;71802;8;87918;1540185;890396;139;2430720;660794;912532;1573326;0,946025878684912;0,405878660342568;0,560503372729964;0,966382033072532
"504";"AGES";2021-06-14;2021;24;"All";"65-79 anos";10910;62745;13;73668;1551095;953141;152;2504388;608215;977379;1585594;0,952727114144582;0,373583127873823;0,600334263275633;0,973917391149455
"505";"AGES";2021-06-21;2021;25;"All";"65-79 anos";10323;97340;21;107684;1561418;1050481;173;2612072;520516;1077321;1597837;0,959067797338915;0,319715882358;0,661721511150094;0,981437393508094
"506";"AGES";2021-06-28;2021;26;"All";"65-79 anos";9073;182535;43;191651;1570491;1233016;216;2803723;345601;1262700;1608301;0,964640694618988;0,212278063803624;0,775586619149932;0,987864682953556
"507";"AGES";2021-07-05;2021;27;"All";"65-79 anos";8168;204240;24;212432;1578659;1437256;240;3016155;147647;1469919;1617566;0,969657714897135;0,0906890295063198;0,902866482643739;0,993555512150059
"508";"AGES";2021-07-12;2021;28;"All";"65-79 anos";5491;57892;12;63395;1584150;1495148;252;3079550;94239;1531092;1625331;0,973030444861301;0,0578843014192369;0,940440696830211;0,998324998249448
"509";"AGES";2021-07-19;2021;29;"All";"65-79 anos";7156;42663;8;49827;1591306;1537811;260;3129377;56399;1578821;1635220;0,977425865663263;0,0346418862227267;0,969757219951623;1
"510";"AGES";2021-07-26;2021;30;"All";"65-79 anos";8635;32455;10;41100;1599941;1570266;270;3170477;28723;1617347;1646070;0,982729730758978;0,0176424918522559;0,99342099605788;1
"511";"AGES";2021-08-02;2021;31;"All";"65-79 anos";7631;11742;6;19379;1607572;1582008;276;3189856;20839;1634673;1655512;0,987416910208359;0,0127999125338286;1;1
"512";"AGES";2021-08-09;2021;32;"All";"65-79 anos";4605;6293;5;10903;1612177;1588301;281;3200759;17534;1644045;1661579;0,990245433516496;0,0107698865765225;1;1
"513";"AGES";2021-08-16;2021;33;"All";"65-79 anos";3693;2990;8;6691;1615870;1591291;289;3207450;17193;1649236;1666429;0,992513780221589;0,010560434579112;1;1
"514";"AGES";2021-08-23;2021;34;"All";"65-79 anos";4308;2517;4;6829;1620178;1593808;293;3214279;18192;1653885;1672077;0,995159877596498;0,0111740490817895;1;1
"515";"AGES";2021-08-30;2021;35;"All";"65-79 anos";4905;2249;5;7159;1625083;1596057;298;3221438;19715;1658437;1678152;0,998172669524059;0,0121095194397251;1;1
"516";"AGES";2021-09-06;2021;36;"All";"65-79 anos";2252;1382;10;3644;1627335;1597439;308;3225082;19840;1660777;1680617;0,999555912627191;0,0121862980311512;1;1
"517";"AGES";2021-09-13;2021;37;"All";"65-79 anos";1635;3289;30;4954;1628970;1600728;338;3230036;17809;1664586;1682395;1,00056017660304;0,0109387994776599;1;1
"518";"AGES";2021-09-20;2021;38;"All";"65-79 anos";1409;3370;39;4818;1630379;1604098;377;3234854;15490;1668392;1683882;1,0014256248856;0,00951440304952281;1;1
"519";"AGES";2021-09-27;2021;39;"All";"65-79 anos";887;2727;19;3633;1631266;1606825;396;3238487;13457;1671368;1684825;1,00197044577036;0,00826567603856865;1;1
"520";"AGES";2021-10-04;2021;40;"All";"65-79 anos";460;2207;34;2701;1631726;1609032;430;3241188;11730;1673670;1685400;1,00225299098681;0,0072049030194256;1;1
"521";"AGES";2021-01-04;2021;1;"All";"80 ou mais anos";3780;8;1;3789;4047;8;2;4057;4038;9;4047;0,00593758711248698;0,00592438269340806;1,32044190789184e-05;0,00593758711248698
"522";"AGES";2021-01-11;2021;2;"All";"80 ou mais anos";14500;1;1;14502;18547;9;3;18559;18512;35;18547;0,0272113734063;0,0271600228876597;5,13505186402383e-05;0,0272113734063
"523";"AGES";2021-01-18;2021;3;"All";"80 ou mais anos";39052;256;1;39309;57599;265;4;57868;57197;402;57599;0,0845068149474024;0,0839170175618774;0,000589797385525022;0,0845068149474024
"524";"AGES";2021-01-25;2021;4;"All";"80 ou mais anos";7382;3397;2;10781;64981;3662;6;68649;61150;3831;64981;0,0953373729074664;0,0897166918528734;0,00562068105459294;0,0953373729074664
"525";"AGES";2021-02-01;2021;5;"All";"80 ou mais anos";4540;10654;0;15194;69521;14316;6;83843;55028;14493;69521;0,101998268753943;0,080734752563858;0,0212635161900849;0,101998268753943
"526";"AGES";2021-02-08;2021;6;"All";"80 ou mais anos";14831;31567;1;46399;84352;45883;7;130242;38191;46161;84352;0,123757684238325;0,0560322187825526;0,0677254654557725;0,123757684238325
"527";"AGES";2021-02-15;2021;7;"All";"80 ou mais anos";48623;9281;2;57906;132975;55164;9;188148;77455;55520;132975;0,19509529189102;0,113638697750847;0,0814565941401722;0,19509529189102
"528";"AGES";2021-02-22;2021;8;"All";"80 ou mais anos";102560;5204;1;107765;235535;60368;10;295913;174672;60863;235535;0,345566983083672;0,256271365483649;0,0892956176000235;0,345566983083672
"529";"AGES";2021-03-01;2021;9;"All";"80 ou mais anos";87221;12780;1;100002;322756;73148;11;395915;249052;73705;322757;0,473533942692821;0,365398553382532;0,108136856467965;0,473535409850497
"530";"AGES";2021-03-08;2021;10;"All";"80 ou mais anos";40161;37300;0;77461;362917;110448;11;473376;251891;111028;362919;0,532456462095981;0,369563814023093;0,162895582388239;0,532459396411332
"531";"AGES";2021-03-15;2021;11;"All";"80 ou mais anos";54373;97454;5;151832;417290;207902;16;625208;208761;208531;417292;0,612230226382429;0,306285303481565;0,305947857216215;0,61223316069778
"532";"AGES";2021-03-22;2021;12;"All";"80 ou mais anos";124564;16925;2;141491;541854;224827;18;766699;316282;225574;541856;0,794985255065362;0,464035563902053;0,33095262547866;0,794988189380713
"533";"AGES";2021-03-29;2021;13;"All";"80 ou mais anos";36746;75510;4;112260;578600;300337;22;878959;277464;301140;578604;0,84889743100691;0,407083437257002;0,44181986238061;0,848903299637612
"534";"AGES";2021-04-05;2021;14;"All";"80 ou mais anos";30376;45898;12;76286;608976;346235;34;955245;261877;347104;608981;0,893463812555935;0,384214850569991;0,509256297774322;0,893471148344313
"535";"AGES";2021-04-12;2021;15;"All";"80 ou mais anos";10512;49516;15;60043;619488;395751;49;1015288;222803;396690;619493;0,908886574040112;0,326887131560029;0,58200677826846;0,908893909828489
"536";"AGES";2021-04-19;2021;16;"All";"80 ou mais anos";8421;123348;13;131782;627909;519099;62;1147070;107779;520135;627914;0,921241508824953;0,15812878710075;0,763120057512581;0,921248844613331
"537";"AGES";2021-04-26;2021;17;"All";"80 ou mais anos";6136;39858;4;45998;634045;558957;66;1193068;74016;560045;634061;0,930243988321425;0,108593142505025;0,821674320339207;0,930267462844232
"538";"AGES";2021-05-03;2021;18;"All";"80 ou mais anos";5107;31856;6;36969;639152;590813;72;1230037;47320;591996;639316;0,937736762569873;0,0694259012016021;0,868551475227043;0,937977376428645
"539";"AGES";2021-05-10;2021;19;"All";"80 ou mais anos";3783;9991;2;13776;642935;600804;74;1243813;41183;602117;643300;0,943287020056045;0,0604219545474552;0,883400578060124;0,943822532607579
"540";"AGES";2021-05-17;2021;20;"All";"80 ou mais anos";4754;8386;3;13143;647689;609190;77;1256956;36492;611998;648490;0,950261887645065;0,0535395178919879;0,897897563051101;0,951437080943089
"541";"AGES";2021-05-24;2021;21;"All";"80 ou mais anos";4456;6376;0;10832;652145;615566;77;1267788;32740;620682;653422;0,956799542246805;0,0480347422937543;0,910638360304582;0,958673102598336
"542";"AGES";2021-05-31;2021;22;"All";"80 ou mais anos";3057;6160;2;9219;655202;621726;79;1277007;29237;627842;657079;0,961284643260611;0,0428952889567042;0,921143209260699;0,964038498217403
"543";"AGES";2021-06-07;2021;23;"All";"80 ou mais anos";2756;4825;1;7582;657958;626551;80;1284589;26682;633531;660213;0,965328129814111;0,0391467010959668;0,929489869276251;0,968636570372218
"544";"AGES";2021-06-14;2021;24;"All";"80 ou mais anos";2632;4790;0;7422;660590;631341;80;1292011;23848;639269;663117;0,969189688815857;0,0349887762437829;0,937908420017899;0,972897196261682
"545";"AGES";2021-06-21;2021;25;"All";"80 ou mais anos";3401;4832;3;8236;663991;636173;83;1300247;21096;645885;666981;0,974179492070013;0,0309511583209848;0,94761513519858;0,978566293519565
"546";"AGES";2021-06-28;2021;26;"All";"80 ou mais anos";3275;5432;1;8708;667266;641605;84;1308955;17567;653111;670678;0,978984433457064;0,0257735588843733;0,958216816561276;0,983990375445649
"547";"AGES";2021-07-05;2021;27;"All";"80 ou mais anos";2669;5265;2;7936;669935;646870;86;1316891;13801;659878;673679;0,982900277292801;0,0202482430786837;0,968145072550947;0,988393315629631
"548";"AGES";2021-07-12;2021;28;"All";"80 ou mais anos";2106;3558;2;5666;672041;650428;88;1322557;11413;664870;676283;0,985990111357268;0,016744670549744;0,97546912366672;0,992213794216464
"549";"AGES";2021-07-19;2021;29;"All";"80 ou mais anos";2208;3090;2;5300;674249;653518;90;1327857;9548;669543;679091;0,989229595504629;0,014008421485057;0,98232515148403;0,996333572969087
"550";"AGES";2021-07-26;2021;30;"All";"80 ou mais anos";2597;2893;1;5491;676846;656411;91;1333348;7892;674303;682195;0,993039803987735;0,011578808374536;0,989308822019102;1
"551";"AGES";2021-08-02;2021;31;"All";"80 ou mais anos";2490;2103;1;4594;679336;658514;92;1337942;6909;678235;685144;0,996693026599569;0,010136592379583;0,995077685998914;1
"552";"AGES";2021-08-09;2021;32;"All";"80 ou mais anos";1580;1723;1;3304;680916;660237;93;1341246;6112;681041;687153;0,999011135726757;0,00896726771226104;0,999194530436186;1
"553";"AGES";2021-08-16;2021;33;"All";"80 ou mais anos";1347;1128;1;2476;682263;661365;94;1343722;5755;683056;688811;1,00098739711557;0,00844349242213061;1;1
"554";"AGES";2021-08-23;2021;34;"All";"80 ou mais anos";1537;973;0;2510;683800;662338;94;1346232;5876;684849;690725;1,00324241846271;0,00862101850085829;1;1
"555";"AGES";2021-08-30;2021;35;"All";"80 ou mais anos";1668;820;0;2488;685468;663158;94;1348720;6277;686435;692712;1,00568963746534;0,00920934872870787;1;1
"556";"AGES";2021-09-06;2021;36;"All";"80 ou mais anos";769;574;1;1344;686237;663732;95;1350064;6211;687342;693553;1,00681788171775;0,00911251632212914;1;1
"557";"AGES";2021-09-13;2021;37;"All";"80 ou mais anos";550;960;6;1516;686787;664692;101;1351580;5676;688469;694145;1,00762481843924;0,00832758696577121;1;1
"558";"AGES";2021-09-20;2021;38;"All";"80 ou mais anos";598;1044;6;1648;687385;665736;107;1353228;5050;689713;694763;1,00850217872915;0,00740914626094866;1;1
"559";"AGES";2021-09-27;2021;39;"All";"80 ou mais anos";364;795;10;1169;687749;666531;117;1354397;4544;690612;695156;1,00903622412301;0,00666676447717836;1;1
"560";"AGES";2021-10-04;2021;40;"All";"80 ou mais anos";165;560;7;732;687914;667091;124;1355129;4152;691203;695355;1,00927830513945;0,00609163866840769;1;1
"561";"AGES";2021-01-04;2021;1;"All";"Desconhecido";1;0;0;1;1;0;0;1;1;0;1;NA;NA;NA;NA
"562";"AGES";2021-01-11;2021;2;"All";"Desconhecido";0;0;0;0;1;0;0;1;1;0;1;NA;NA;NA;NA
"563";"AGES";2021-01-18;2021;3;"All";"Desconhecido";0;0;0;0;1;0;0;1;1;0;1;NA;NA;NA;NA
"564";"AGES";2021-01-25;2021;4;"All";"Desconhecido";0;0;0;0;1;0;0;1;1;0;1;NA;NA;NA;NA
"565";"AGES";2021-02-01;2021;5;"All";"Desconhecido";0;0;0;0;1;0;0;1;1;0;1;NA;NA;NA;NA
"566";"AGES";2021-02-08;2021;6;"All";"Desconhecido";2;0;0;2;3;0;0;3;3;0;3;NA;NA;NA;NA
"567";"AGES";2021-02-15;2021;7;"All";"Desconhecido";0;0;0;0;3;0;0;3;3;0;3;NA;NA;NA;NA
"568";"AGES";2021-02-22;2021;8;"All";"Desconhecido";1;0;0;1;4;0;0;4;4;0;4;NA;NA;NA;NA
"569";"AGES";2021-03-01;2021;9;"All";"Desconhecido";0;0;0;0;4;0;0;4;4;0;4;NA;NA;NA;NA
"570";"AGES";2021-03-08;2021;10;"All";"Desconhecido";1;0;0;1;5;0;0;5;5;0;5;NA;NA;NA;NA
"571";"AGES";2021-03-15;2021;11;"All";"Desconhecido";0;1;0;1;5;1;0;6;4;1;5;NA;NA;NA;NA
"572";"AGES";2021-03-22;2021;12;"All";"Desconhecido";0;1;0;1;5;2;0;7;3;2;5;NA;NA;NA;NA
"573";"AGES";2021-03-29;2021;13;"All";"Desconhecido";0;0;0;0;5;2;0;7;3;2;5;NA;NA;NA;NA
"574";"AGES";2021-04-05;2021;14;"All";"Desconhecido";0;0;0;0;5;2;0;7;3;2;5;NA;NA;NA;NA
"575";"AGES";2021-04-12;2021;15;"All";"Desconhecido";1;0;0;1;6;2;0;8;4;2;6;NA;NA;NA;NA
"576";"AGES";2021-04-19;2021;16;"All";"Desconhecido";0;0;0;0;6;2;0;8;4;2;6;NA;NA;NA;NA
"577";"AGES";2021-04-26;2021;17;"All";"Desconhecido";1;0;0;1;7;2;0;9;5;2;7;NA;NA;NA;NA
"578";"AGES";2021-05-03;2021;18;"All";"Desconhecido";1;0;0;1;8;2;0;10;6;2;8;NA;NA;NA;NA
"579";"AGES";2021-05-10;2021;19;"All";"Desconhecido";0;1;0;1;8;3;0;11;5;3;8;NA;NA;NA;NA
"580";"AGES";2021-05-17;2021;20;"All";"Desconhecido";0;0;0;0;8;3;0;11;5;3;8;NA;NA;NA;NA
"581";"AGES";2021-05-24;2021;21;"All";"Desconhecido";0;2;0;2;8;5;0;13;3;5;8;NA;NA;NA;NA
"582";"AGES";2021-05-31;2021;22;"All";"Desconhecido";0;0;0;0;8;5;0;13;3;5;8;NA;NA;NA;NA
"583";"AGES";2021-06-07;2021;23;"All";"Desconhecido";1;0;0;1;9;5;0;14;4;5;9;NA;NA;NA;NA
"584";"AGES";2021-06-14;2021;24;"All";"Desconhecido";0;0;0;0;9;5;0;14;4;5;9;NA;NA;NA;NA
"585";"AGES";2021-06-21;2021;25;"All";"Desconhecido";1;0;0;1;10;5;0;15;5;5;10;NA;NA;NA;NA
"586";"AGES";2021-06-28;2021;26;"All";"Desconhecido";2;1;0;3;12;6;0;18;6;6;12;NA;NA;NA;NA
"587";"AGES";2021-07-05;2021;27;"All";"Desconhecido";1;2;0;3;13;8;0;21;6;8;14;NA;NA;NA;NA
"588";"AGES";2021-07-12;2021;28;"All";"Desconhecido";2;2;0;4;15;10;0;25;6;10;16;NA;NA;NA;NA
"589";"AGES";2021-07-19;2021;29;"All";"Desconhecido";1;0;0;1;16;10;0;26;7;10;17;NA;NA;NA;NA
"590";"AGES";2021-07-26;2021;30;"All";"Desconhecido";2;2;0;4;18;12;0;30;8;12;20;NA;NA;NA;NA
"591";"AGES";2021-08-02;2021;31;"All";"Desconhecido";1;0;0;1;19;12;0;31;9;12;21;NA;NA;NA;NA
"592";"AGES";2021-08-09;2021;32;"All";"Desconhecido";1;1;0;2;20;13;0;33;10;13;23;NA;NA;NA;NA
"593";"AGES";2021-08-16;2021;33;"All";"Desconhecido";1;1;0;2;21;14;0;35;10;14;24;NA;NA;NA;NA
"594";"AGES";2021-08-23;2021;34;"All";"Desconhecido";2;0;0;2;23;14;0;37;12;14;26;NA;NA;NA;NA
"595";"AGES";2021-08-30;2021;35;"All";"Desconhecido";0;2;0;2;23;16;0;39;10;16;26;NA;NA;NA;NA
"596";"AGES";2021-09-06;2021;36;"All";"Desconhecido";2;1;0;3;25;17;0;42;11;17;28;NA;NA;NA;NA
"597";"AGES";2021-09-13;2021;37;"All";"Desconhecido";1;0;0;1;26;17;0;43;12;17;29;NA;NA;NA;NA
"598";"AGES";2021-09-20;2021;38;"All";"Desconhecido";0;0;0;0;26;17;0;43;12;17;29;NA;NA;NA;NA
"599";"AGES";2021-09-27;2021;39;"All";"Desconhecido";3;3;0;6;29;20;0;49;13;20;33;NA;NA;NA;NA
"600";"AGES";2021-10-04;2021;40;"All";"Desconhecido";0;1;0;1;29;21;0;50;12;21;33;NA;NA;NA;NA
"601";"GENERAL";2021-01-04;2021;1;"All";"All";48980;100;1;49081;84943;116;4;85063;84832;122;84954;0,0082087250234154;0,00819799820098625;1,17898408680725e-05;0,00820978804185432
"602";"GENERAL";2021-01-11;2021;2;"All";"All";50114;1210;1;51325;135057;1326;5;136388;133680;1388;135068;0,0130516437550759;0,0129185731741305;0,0001341335993843;0,0130527067735148
"603";"GENERAL";2021-01-18;2021;3;"All";"All";122485;32813;9;155307;257542;34139;14;291695;223155;34399;257554;0,024888354072501;0,0215652617943829;0,00332425193459692;0,0248895137289798
"604";"GENERAL";2021-01-25;2021;4;"All";"All";42075;45931;17;88023;299617;80070;31;379718;219217;80414;299631;0,0289543996013874;0,0211847011932479;0,00777105134069818;0,028955752533946
"605";"GENERAL";2021-02-01;2021;5;"All";"All";24139;37604;2;61745;323756;117674;33;441463;205734;118045;323779;0,0312871452465874;0,0198817305012461;0,0114076374202591;0,0312893679215052
"606";"GENERAL";2021-02-08;2021;6;"All";"All";41012;99536;11;140559;364768;217210;44;582022;146906;217886;364792;0,0352504645390578;0,0141967078898775;0,021056075962138;0,0352527838520155
"607";"GENERAL";2021-02-15;2021;7;"All";"All";103792;50412;10;154214;468560;267622;54;736236;199680;268904;468584;0,0452807199765904;0,0192966838076779;0,0259863554818701;0,0452830392895481
"608";"GENERAL";2021-02-22;2021;8;"All";"All";177256;20783;11;198050;645816;288405;65;934286;355510;290330;645840;0,0624103923775007;0,0343557895656429;0,0280569221248154;0,0624127116904583
"609";"GENERAL";2021-03-01;2021;9;"All";"All";139522;33761;12;173295;785338;322166;77;1107581;460922;324471;785393;0,07589352498074;0,0445425986278171;0,0313562414451175;0,0758988400729347
"610";"GENERAL";2021-03-08;2021;10;"All";"All";96554;52221;4;148779;881892;374387;81;1256360;505016;376982;881998;0,0852243142854603;0,0488037563592662;0,0364308015584237;0,0852345579176899
"611";"GENERAL";2021-03-15;2021;11;"All";"All";82437;110486;17;192940;964329;484873;98;1449300;476876;487597;964473;0,0931908643808807;0,0460843619164174;0,0471204183422092;0,0932047802586266
"612";"GENERAL";2021-03-22;2021;12;"All";"All";258032;22171;7;280210;1222361;507044;105;1729510;712248;510286;1222534;0,118126571092934;0,0688302506442858;0,049313038829551;0,118143289473837
"613";"GENERAL";2021-03-29;2021;13;"All";"All";138488;85168;10;223666;1360849;592212;115;1953176;765420;595669;1361089;0,131509779962914;0,0739686885019674;0,0575642845905234;0,131532973092491
"614";"GENERAL";2021-04-05;2021;14;"All";"All";257131;53866;22;311019;1617980;646078;137;2264195;968443;649917;1618360;0,156358415801015;0,0935884332770385;0,0628067049791397;0,156395138256178
"615";"GENERAL";2021-04-12;2021;15;"All";"All";426186;54844;23;481053;2044166;700922;160;2745248;1339348;705235;2044583;0,197544195474788;0,129431965466976;0,0681525280704515;0,197584493537428
"616";"GENERAL";2021-04-19;2021;16;"All";"All";211501;139607;31;351139;2255667;840529;191;3096387;1410285;845809;2256094;0,217983237552151;0,136287178103521;0,081737323891668;0,218024501995189
"617";"GENERAL";2021-04-26;2021;17;"All";"All";346525;90600;22;437147;2602192;931129;213;3533534;1666965;937044;2604009;0,251470734329272;0,161092230185626;0,0905540954621482;0,251646325647774
"618";"GENERAL";2021-05-03;2021;18;"All";"All";371817;220316;30;592163;2974009;1151445;243;4125697;1829958;1158370;2988328;0,287402400411601;0,176843554223411;0,11194260628155;0,288786160504961
"619";"GENERAL";2021-05-10;2021;19;"All";"All";290040;306372;32;596444;3264049;1457817;275;4722141;1829812;1466438;3296250;0,315431297504844;0,176829445069585;0,141713693958151;0,318543139027736
"620";"GENERAL";2021-05-17;2021;20;"All";"All";306364;220868;34;527266;3570413;1678685;309;5249407;1928026;1698626;3626652;0,345037713961452;0,186320653520543;0,164151887166971;0,350472540687514
"621";"GENERAL";2021-05-24;2021;21;"All";"All";232731;329808;113;562652;3803144;2008493;422;5812059;1857481;2051468;3908949;0,367528381625939;0,17950332299564;0,198249846442155;0,377753169437795
"622";"GENERAL";2021-05-31;2021;22;"All";"All";231147;339847;55;571049;4034291;2348340;477;6383108;1790290;2406515;4196805;0,38986597463522;0,173010116456569;0,232560892595323;0,405571009051892
"623";"GENERAL";2021-06-07;2021;23;"All";"All";360906;251588;73;612567;4395197;2599928;550;6995675;1907410;2678525;4585935;0,424743223064176;0,184328363689919;0,258847405829129;0,443175769519048
"624";"GENERAL";2021-06-14;2021;24;"All";"All";344425;389717;120;734262;4739622;2989645;670;7729937;1877656;3088408;4966064;0,458027779957502;0,181452995450668;0,298457695538376;0,479910690989044
"625";"GENERAL";2021-06-21;2021;25;"All";"All";376998;346090;403;723491;5116620;3335735;1073;8453428;1926372;3461111;5387483;0,494460127724565;0,186160814202545;0,334474982924058;0,520635797126603
"626";"GENERAL";2021-06-28;2021;26;"All";"All";389889;432511;247;822647;5506509;3768246;1320;9276075;1879698;3923836;5803534;0,532138236464006;0,181650330328148;0,379191819937819;0,560842150265967
"627";"GENERAL";2021-07-05;2021;27;"All";"All";433615;621581;105;1055301;5940124;4389827;1425;10331376;1693321;4582264;6275585;0,574041940136213;0,163639222365289;0,442821011274567;0,606460233639856
"628";"GENERAL";2021-07-12;2021;28;"All";"All";246077;521456;114;767647;6186201;4911283;1539;11099023;1499920;5137503;6637423;0,597822339081235;0,144949328810158;0,496478219911843;0,641427548722001
"629";"GENERAL";2021-07-19;2021;29;"All";"All";143985;525009;90;669084;6330186;5436292;1629;11768107;1220442;5694092;6914534;0,611736767256558;0,117941122694361;0,550265889902987;0,668207012597348
"630";"GENERAL";2021-07-26;2021;30;"All";"All";105386;500106;75;605567;6435572;5936398;1704;12373674;896717;6225413;7122130;0,621921063729695;0,0866569732270109;0,601611709901882;0,688268683128892
"631";"GENERAL";2021-08-02;2021;31;"All";"All";130123;508155;62;638340;6565695;6444553;1766;13012014;601566;6767595;7369161;0,634495895395893;0,0581341591118268;0,654007115652154;0,712141274763981
"632";"GENERAL";2021-08-09;2021;32;"All";"All";314613;353124;56;667793;6880308;6797677;1822;13679807;654520;7171807;7826327;0,664899479043655;0,0632515298768097;0,693069371037116;0,756320900913925
"633";"GENERAL";2021-08-16;2021;33;"All";"All";362914;238634;67;601615;7243222;7036311;1889;14281422;840378;7457727;8298105;0,699970776656734;0,081212482696959;0,720700119405962;0,801912602102921
"634";"GENERAL";2021-08-23;2021;34;"All";"All";294296;139259;35;433590;7537518;7175570;1924;14715012;997110;7636512;8633622;0,728410965247801;0,0963587559669158;0,737977551369883;0,834336307336799
"635";"GENERAL";2021-08-30;2021;35;"All";"All";130784;300229;53;431066;7668302;7475799;1977;15146078;812370;7967706;8780076;0,741049674658375;0,0785058444753772;0,769983490357263;0,84848933483264
"636";"GENERAL";2021-09-06;2021;36;"All";"All";67128;310715;106;377949;7735430;7786514;2083;15524027;558859;8291989;8850848;0,747536793000932;0,0540070383417222;0,801321563850879;0,855328602192601
"637";"GENERAL";2021-09-13;2021;37;"All";"All";46439;257729;150;304318;7781869;8044243;2233;15828345;341804;8558353;8900157;0,752024566935952;0,0330312685907429;0,827062458711397;0,86009372730214
"638";"GENERAL";2021-09-20;2021;38;"All";"All";34608;103353;158;138119;7816477;8147596;2391;15966464;266562;8670010;8936572;0,755369016220888;0,0257600291924191;0,837852772332761;0,86361280152518
"639";"GENERAL";2021-09-27;2021;39;"All";"All";22381;58271;127;80779;7838858;8205867;2518;16047243;225054;8735378;8960432;0,75753187219194;0,0217487774321572;0,84416980772509;0,865918585157248
"640";"GENERAL";2021-10-04;2021;40;"All";"All";13101;44144;222;57467;7851959;8250011;2740;16104710;192922;8782671;8975593;0,758797927152699;0,0186436039340186;0,848740110546187;0,867383714480205
