;TYPE;DATE;YEAR;WEEK;REGION;AGEGROUP;TOTAL_VAC_1;TOTAL_VAC_2;TOTAL_VAC_UNK;TOTAL;CUMUL_VAC_1;CUMUL_VAC_2;CUMUL_VAC_UNK;CUMUL;COVER_1_VAC;COVER;RECEIVED;DISTRIBUTED
1;REGIONAL;04/01/2021;2021;1;Outro;All;194;1;0;195;306;1;0;307;NA;NA;NA;NA
2;REGIONAL;11/01/2021;2021;2;Outro;All;52;6;0;58;358;7;0;365;NA;NA;NA;NA
3;REGIONAL;18/01/2021;2021;3;Outro;All;135;99;0;234;493;106;0;599;NA;NA;NA;NA
4;REGIONAL;25/01/2021;2021;4;Outro;All;103;179;1;283;596;285;1;882;NA;NA;NA;NA
5;REGIONAL;01/02/2021;2021;5;Outro;All;29;40;0;69;625;325;1;951;NA;NA;NA;NA
6;REGIONAL;08/02/2021;2021;6;Outro;All;69;120;0;189;694;445;1;1140;NA;NA;NA;NA
7;REGIONAL;15/02/2021;2021;7;Outro;All;147;106;1;254;841;551;2;1394;NA;NA;NA;NA
8;REGIONAL;22/02/2021;2021;8;Outro;All;73;19;0;92;914;570;2;1486;NA;NA;NA;NA
9;REGIONAL;01/03/2021;2021;9;Outro;All;55;42;0;97;969;612;2;1583;NA;NA;NA;NA
10;REGIONAL;08/03/2021;2021;10;Outro;All;282;13;0;295;1251;625;2;1878;NA;NA;NA;NA
11;REGIONAL;15/03/2021;2021;11;Outro;All;19;27;0;46;1270;652;2;1924;NA;NA;NA;NA
12;REGIONAL;22/03/2021;2021;12;Outro;All;315;5;0;320;1585;657;2;2244;NA;NA;NA;NA
13;REGIONAL;29/03/2021;2021;13;Outro;All;318;11;0;329;1903;668;2;2573;NA;NA;NA;NA
14;REGIONAL;05/04/2021;2021;14;Outro;All;60;16;0;76;1963;684;2;2649;NA;NA;NA;NA
15;REGIONAL;12/04/2021;2021;15;Outro;All;249;8;0;257;2212;692;2;2906;NA;NA;NA;NA
16;REGIONAL;19/04/2021;2021;16;Outro;All;93;25;0;118;2305;717;2;3024;NA;NA;NA;NA
17;REGIONAL;26/04/2021;2021;17;Outro;All;184;17;0;201;2489;734;2;3225;NA;NA;NA;NA
18;REGIONAL;03/05/2021;2021;18;Outro;All;111;66;0;177;2600;800;2;3402;NA;NA;NA;NA
19;REGIONAL;10/05/2021;2021;19;Outro;All;129;272;0;401;2729;1072;2;3803;NA;NA;NA;NA
20;REGIONAL;17/05/2021;2021;20;Outro;All;125;192;0;317;2854;1264;2;4120;NA;NA;NA;NA
21;REGIONAL;24/05/2021;2021;21;Outro;All;147;194;0;341;3001;1458;2;4461;NA;NA;NA;NA
22;REGIONAL;31/05/2021;2021;22;Outro;All;237;356;0;593;3238;1814;2;5054;NA;NA;NA;NA
23;REGIONAL;07/06/2021;2021;23;Outro;All;217;315;1;533;3455;2129;3;5587;NA;NA;NA;NA
24;REGIONAL;14/06/2021;2021;24;Outro;All;355;366;1;722;3810;2495;4;6309;NA;NA;NA;NA
25;REGIONAL;04/01/2021;2021;1;ARS Alentejo;All;3467;0;0;3467;4691;0;0;4691;0,01005164;0;NA;NA
26;REGIONAL;11/01/2021;2021;2;ARS Alentejo;All;5343;10;0;5353;10034;10;0;10044;0,021500354;2,14E-05;NA;NA
27;REGIONAL;18/01/2021;2021;3;ARS Alentejo;All;10439;1135;0;11574;20473;1145;0;21618;0,043868521;0,002453449;NA;NA
28;REGIONAL;25/01/2021;2021;4;ARS Alentejo;All;2305;3105;0;5410;22778;4250;0;27028;0,04880756;0,009106688;NA;NA
29;REGIONAL;01/02/2021;2021;5;ARS Alentejo;All;1445;4338;0;5783;24223;8588;0;32811;0,051903833;0,018401937;NA;NA
30;REGIONAL;08/02/2021;2021;6;ARS Alentejo;All;3336;8777;1;12114;27559;17365;1;44925;0,059052047;0,037208854;NA;NA
31;REGIONAL;15/02/2021;2021;7;ARS Alentejo;All;4053;2807;0;6860;31612;20172;1;51785;0,067736613;0,043223553;NA;NA
32;REGIONAL;22/02/2021;2021;8;ARS Alentejo;All;12033;1647;0;13680;43645;21819;1;65465;0,093520324;0,046752662;NA;NA
33;REGIONAL;01/03/2021;2021;9;ARS Alentejo;All;10433;2828;0;13261;54078;24647;1;78726;0,115875635;0,052812359;NA;NA
34;REGIONAL;08/03/2021;2021;10;ARS Alentejo;All;5807;1670;0;7477;59885;26317;1;86203;0,128318584;0,056390752;NA;NA
35;REGIONAL;15/03/2021;2021;11;ARS Alentejo;All;3685;7721;0;11406;63570;34038;1;97609;0,136214618;0,072934925;NA;NA
36;REGIONAL;22/03/2021;2021;12;ARS Alentejo;All;11877;2098;0;13975;75447;36136;1;111584;0,16166406;0,077430414;NA;NA
37;REGIONAL;29/03/2021;2021;13;ARS Alentejo;All;6121;6265;0;12386;81568;42401;1;123970;0,174779832;0,090854743;NA;NA
38;REGIONAL;05/04/2021;2021;14;ARS Alentejo;All;14030;4289;0;18319;95598;46690;1;142289;0,204842615;0,100044998;NA;NA
39;REGIONAL;12/04/2021;2021;15;ARS Alentejo;All;21834;2951;0;24785;117432;49641;1;167074;0,251627419;0,106368253;NA;NA
40;REGIONAL;19/04/2021;2021;16;ARS Alentejo;All;11302;5943;2;17247;128734;55584;3;184321;0,275844779;0,119102616;NA;NA
41;REGIONAL;26/04/2021;2021;17;ARS Alentejo;All;20149;2760;0;22909;148883;58344;3;207230;0,319019049;0,125016606;NA;NA
42;REGIONAL;03/05/2021;2021;18;ARS Alentejo;All;13612;14280;1;27893;162495;72624;4;235123;0,348186162;0,155615076;NA;NA
43;REGIONAL;10/05/2021;2021;19;ARS Alentejo;All;17401;15209;0;32610;179896;87833;4;267733;0,385472155;0,188204161;NA;NA
44;REGIONAL;17/05/2021;2021;20;ARS Alentejo;All;13184;12168;1;25353;193080;100001;5;293086;0,413722171;0,214277143;NA;NA
45;REGIONAL;24/05/2021;2021;21;ARS Alentejo;All;7129;18456;4;25589;200209;118457;9;318675;0,428997836;0,253823737;NA;NA
46;REGIONAL;31/05/2021;2021;22;ARS Alentejo;All;17306;7226;0;24532;217515;125683;9;343207;0,466080267;0,269307249;NA;NA
47;REGIONAL;07/06/2021;2021;23;ARS Alentejo;All;13706;15212;0;28918;231221;140895;9;372125;0,495448799;0,301902762;NA;NA
48;REGIONAL;14/06/2021;2021;24;ARS Alentejo;All;10122;18991;1;29114;241343;159886;10;401239;0,517137715;0,342595727;NA;NA
49;REGIONAL;04/01/2021;2021;1;ARS Algarve;All;1236;0;0;1236;2291;0;0;2291;0,00522575;0;NA;NA
50;REGIONAL;11/01/2021;2021;2;ARS Algarve;All;1350;3;0;1353;3641;3;0;3644;0,008305087;6,84E-06;NA;NA
51;REGIONAL;18/01/2021;2021;3;ARS Algarve;All;3386;946;0;4332;7027;949;0;7976;0,016028522;0,00216466;NA;NA
52;REGIONAL;25/01/2021;2021;4;ARS Algarve;All;2139;1220;0;3359;9166;2169;0;11335;0,020907561;0,004947469;NA;NA
53;REGIONAL;01/02/2021;2021;5;ARS Algarve;All;1205;1242;0;2447;10371;3411;0;13782;0,023656154;0,007780459;NA;NA
54;REGIONAL;08/02/2021;2021;6;ARS Algarve;All;2384;2896;1;5281;12755;6307;1;19063;0,029094036;0,014386208;NA;NA
55;REGIONAL;15/02/2021;2021;7;ARS Algarve;All;3179;2115;0;5294;15934;8422;1;24357;0,036345305;0,019210504;NA;NA
56;REGIONAL;22/02/2021;2021;8;ARS Algarve;All;8480;1065;0;9545;24414;9487;1;33902;0,055688106;0,021639759;NA;NA
57;REGIONAL;01/03/2021;2021;9;ARS Algarve;All;4620;550;0;5170;29034;10037;1;39072;0,066226283;0,022894303;NA;NA
58;REGIONAL;08/03/2021;2021;10;ARS Algarve;All;5079;1535;0;6614;34113;11572;1;45686;0,077811435;0,026395624;NA;NA
59;REGIONAL;15/03/2021;2021;11;ARS Algarve;All;2662;2995;0;5657;36775;14567;1;51343;0,083883432;0,033227191;NA;NA
60;REGIONAL;22/03/2021;2021;12;ARS Algarve;All;9386;4283;0;13669;46161;18850;1;65012;0,105292811;0,042996674;NA;NA
61;REGIONAL;29/03/2021;2021;13;ARS Algarve;All;4202;2907;0;7109;50363;21757;1;72121;0,114877534;0,049627514;NA;NA
62;REGIONAL;05/04/2021;2021;14;ARS Algarve;All;8617;1767;0;10384;58980;23524;1;82505;0,13453283;0,053658025;NA;NA
63;REGIONAL;12/04/2021;2021;15;ARS Algarve;All;13596;2146;0;15742;72576;25670;1;98247;0,16554518;0,058553031;NA;NA
64;REGIONAL;19/04/2021;2021;16;ARS Algarve;All;7183;5483;0;12666;79759;31153;1;110913;0,181929536;0,071059703;NA;NA
65;REGIONAL;26/04/2021;2021;17;ARS Algarve;All;16325;3227;0;19552;96084;34380;1;130465;0,219166708;0,07842046;NA;NA
66;REGIONAL;03/05/2021;2021;18;ARS Algarve;All;16454;8895;1;25350;112538;43275;2;155815;0,256698129;0,098709872;NA;NA
67;REGIONAL;10/05/2021;2021;19;ARS Algarve;All;9671;11265;0;20936;122209;54540;2;176751;0,27875759;0,124405232;NA;NA
68;REGIONAL;17/05/2021;2021;20;ARS Algarve;All;11956;10850;2;22808;134165;65390;4;199559;0,306029115;0,149153981;NA;NA
69;REGIONAL;24/05/2021;2021;21;ARS Algarve;All;7515;18732;7;26254;141680;84122;11;225813;0,32317076;0,191881498;NA;NA
70;REGIONAL;31/05/2021;2021;22;ARS Algarve;All;8089;12719;0;20808;149769;96841;11;246621;0,341621693;0,220893418;NA;NA
71;REGIONAL;07/06/2021;2021;23;ARS Algarve;All;16979;6258;0;23237;166748;103099;11;269858;0,380350634;0,235167858;NA;NA
72;REGIONAL;14/06/2021;2021;24;ARS Algarve;All;15270;13320;0;28590;182018;116419;11;298448;0,415181362;0,265550654;NA;NA
73;REGIONAL;04/01/2021;2021;1;ARS Centro;All;8983;4;0;8987;15570;4;0;15574;0,009575699;2,46E-06;NA;NA
74;REGIONAL;11/01/2021;2021;2;ARS Centro;All;12615;22;0;12637;28185;26;0;28211;0,017334044;1,60E-05;NA;NA
75;REGIONAL;18/01/2021;2021;3;ARS Centro;All;36735;6291;2;43028;64920;6317;2;71239;0,03992642;0,003885015;NA;NA
76;REGIONAL;25/01/2021;2021;4;ARS Centro;All;4839;8477;2;13318;69759;14794;4;84557;0,042902451;0,009098451;NA;NA
77;REGIONAL;01/02/2021;2021;5;ARS Centro;All;2663;9147;0;11810;72422;23941;4;96367;0,044540222;0,014723944;NA;NA
78;REGIONAL;08/02/2021;2021;6;ARS Centro;All;7479;27108;4;34591;79901;51049;8;130958;0,049139878;0,031395623;NA;NA
79;REGIONAL;15/02/2021;2021;7;ARS Centro;All;25470;9957;3;35430;105371;61006;11;166388;0,064804172;0,037519273;NA;NA
80;REGIONAL;22/02/2021;2021;8;ARS Centro;All;38332;3080;1;41413;143703;64086;12;207801;0,088378718;0,039413502;NA;NA
81;REGIONAL;01/03/2021;2021;9;ARS Centro;All;28398;5883;1;34282;172101;69969;13;242083;0,105843759;0,043031603;NA;NA
82;REGIONAL;08/03/2021;2021;10;ARS Centro;All;17507;13465;0;30972;189608;83434;13;273055;0,116610732;0,051312707;NA;NA
83;REGIONAL;15/03/2021;2021;11;ARS Centro;All;16532;24096;2;40630;206140;107530;15;313685;0,126778069;0,066131977;NA;NA
84;REGIONAL;22/03/2021;2021;12;ARS Centro;All;47697;4251;0;51948;253837;111781;15;365633;0,15611218;0,068746383;NA;NA
85;REGIONAL;29/03/2021;2021;13;ARS Centro;All;24224;16643;2;40869;278061;128424;17;406502;0,171010172;0,078981987;NA;NA
86;REGIONAL;05/04/2021;2021;14;ARS Centro;All;49756;10105;0;59861;327817;138529;17;466363;0,201610587;0,085196659;NA;NA
87;REGIONAL;12/04/2021;2021;15;ARS Centro;All;77480;11914;1;89395;405297;150443;18;555758;0,249261527;0,092523882;NA;NA
88;REGIONAL;19/04/2021;2021;16;ARS Centro;All;29909;24083;6;53998;435206;174526;24;609756;0,267655848;0,107335157;NA;NA
89;REGIONAL;26/04/2021;2021;17;ARS Centro;All;56570;17836;0;74406;491776;192362;24;684162;0,302446939;0,118304468;NA;NA
90;REGIONAL;03/05/2021;2021;18;ARS Centro;All;59867;49006;1;108874;551643;241368;25;793036;0,339265715;0,148443626;NA;NA
91;REGIONAL;10/05/2021;2021;19;ARS Centro;All;50630;55509;0;106139;602273;296877;25;899175;0,370403649;0,182582191;NA;NA
92;REGIONAL;17/05/2021;2021;20;ARS Centro;All;44803;41535;5;86343;647076;338412;30;985518;0,397957922;0,208126613;NA;NA
93;REGIONAL;24/05/2021;2021;21;ARS Centro;All;24007;56137;10;80154;671083;394549;40;1065672;0,412722457;0,242651405;NA;NA
94;REGIONAL;31/05/2021;2021;22;ARS Centro;All;44093;37452;2;81547;715176;432001;42;1147219;0,439840073;0,265684742;NA;NA
95;REGIONAL;07/06/2021;2021;23;ARS Centro;All;57982;40562;0;98544;773158;472563;42;1245763;0,475499557;0,29063076;NA;NA
96;REGIONAL;14/06/2021;2021;24;ARS Centro;All;51586;65382;10;116978;824744;537945;52;1362741;0,50722544;0,330841315;NA;NA
97;REGIONAL;04/01/2021;2021;1;ARS Lisboa e Vale do Tejo;All;12631;4;0;12635;23298;4;0;23302;0,006309659;1,08E-06;NA;NA
98;REGIONAL;11/01/2021;2021;2;ARS Lisboa e Vale do Tejo;All;13170;1100;0;14270;36468;1104;0;37572;0,009876412;0,00029899;NA;NA
99;REGIONAL;18/01/2021;2021;3;ARS Lisboa e Vale do Tejo;All;37790;9027;0;46817;74258;10131;0;84389;0,020110854;0,002743719;NA;NA
100;REGIONAL;25/01/2021;2021;4;ARS Lisboa e Vale do Tejo;All;17647;11407;0;29054;91905;21538;0;113443;0,024890086;0,005833009;NA;NA
101;REGIONAL;01/02/2021;2021;5;ARS Lisboa e Vale do Tejo;All;8624;8912;1;17537;100529;30450;1;130980;0,027225673;0,008246593;NA;NA
102;REGIONAL;08/02/2021;2021;6;ARS Lisboa e Vale do Tejo;All;14290;30364;0;44654;114819;60814;1;175634;0,031095749;0,016469895;NA;NA
103;REGIONAL;15/02/2021;2021;7;ARS Lisboa e Vale do Tejo;All;32893;19010;2;51905;147712;79824;3;227539;0,040003965;0,02161826;NA;NA
104;REGIONAL;22/02/2021;2021;8;ARS Lisboa e Vale do Tejo;All;49045;6661;0;55706;196757;86485;3;283245;0,053286531;0,02342222;NA;NA
105;REGIONAL;01/03/2021;2021;9;ARS Lisboa e Vale do Tejo;All;44776;12738;1;57515;241533;99223;4;340760;0,06541295;0,026871977;NA;NA
106;REGIONAL;08/03/2021;2021;10;ARS Lisboa e Vale do Tejo;All;33022;16457;2;49481;274555;115680;6;390241;0,074356102;0,031328928;NA;NA
107;REGIONAL;15/03/2021;2021;11;ARS Lisboa e Vale do Tejo;All;25583;28861;1;54445;300138;144541;7;444686;0,081284594;0,039145182;NA;NA
108;REGIONAL;22/03/2021;2021;12;ARS Lisboa e Vale do Tejo;All;88520;7417;2;95939;388658;151958;9;540625;0,105257941;0,041153884;NA;NA
109;REGIONAL;29/03/2021;2021;13;ARS Lisboa e Vale do Tejo;All;45115;23661;4;68780;433773;175619;13;609405;0,117476169;0,047561852;NA;NA
110;REGIONAL;05/04/2021;2021;14;ARS Lisboa e Vale do Tejo;All;86853;19358;1;106212;520626;194977;14;715617;0,140998052;0,052804464;NA;NA
111;REGIONAL;12/04/2021;2021;15;ARS Lisboa e Vale do Tejo;All;162875;14040;0;176915;683501;209017;14;892532;0,185108522;0,056606834;NA;NA
112;REGIONAL;19/04/2021;2021;16;ARS Lisboa e Vale do Tejo;All;78473;53348;3;131824;761974;262365;17;1024356;0,206360899;0,071054757;NA;NA
113;REGIONAL;26/04/2021;2021;17;ARS Lisboa e Vale do Tejo;All;106766;25268;3;132037;868740;287633;20;1156393;0,235275702;0,077897939;NA;NA
114;REGIONAL;03/05/2021;2021;18;ARS Lisboa e Vale do Tejo;All;106864;64584;5;171453;975604;352217;25;1327846;0,264217045;0,095388841;NA;NA
115;REGIONAL;10/05/2021;2021;19;ARS Lisboa e Vale do Tejo;All;89557;112108;9;201674;1065161;464325;34;1529520;0,288471236;0,125750386;NA;NA
116;REGIONAL;17/05/2021;2021;20;ARS Lisboa e Vale do Tejo;All;109280;70363;5;179648;1174441;534688;39;1709168;0,31806689;0,14480638;NA;NA
117;REGIONAL;24/05/2021;2021;21;ARS Lisboa e Vale do Tejo;All;109499;87939;43;197481;1283940;622627;82;1906649;0,347721855;0,168622378;NA;NA
118;REGIONAL;31/05/2021;2021;22;ARS Lisboa e Vale do Tejo;All;91176;85877;13;177066;1375116;708504;95;2083715;0,37241451;0,191879936;NA;NA
119;REGIONAL;07/06/2021;2021;23;ARS Lisboa e Vale do Tejo;All;150592;52885;6;203483;1525708;761389;101;2287198;0,413198449;0,206202467;NA;NA
120;REGIONAL;14/06/2021;2021;24;ARS Lisboa e Vale do Tejo;All;146001;118893;8;264902;1671709;880282;109;2552100;0,452739033;0,238401553;NA;NA
121;REGIONAL;04/01/2021;2021;1;ARS Norte;All;16481;2;0;16483;29744;3;0;29747;0,008319213;8,39E-07;NA;NA
122;REGIONAL;11/01/2021;2021;2;ARS Norte;All;15093;21;0;15114;44837;24;0;44861;0,012540633;6,71E-06;NA;NA
123;REGIONAL;18/01/2021;2021;3;ARS Norte;All;31925;12673;1;44599;76762;12697;1;89460;0,021469858;0,003551273;NA;NA
124;REGIONAL;25/01/2021;2021;4;ARS Norte;All;14390;15412;1;29803;91152;28109;2;119263;0,025494653;0,007861914;NA;NA
125;REGIONAL;01/02/2021;2021;5;ARS Norte;All;5464;12174;0;17638;96616;40283;2;136901;0,0270229;0,011266907;NA;NA
126;REGIONAL;08/02/2021;2021;6;ARS Norte;All;8682;28606;5;37293;105298;68889;7;174194;0,029451202;0,019267829;NA;NA
127;REGIONAL;15/02/2021;2021;7;ARS Norte;All;32871;15023;3;47897;138169;83912;10;222091;0,038645018;0,023469669;NA;NA
128;REGIONAL;22/02/2021;2021;8;ARS Norte;All;64602;4228;1;68831;202771;88140;11;290922;0,056713799;0,024652215;NA;NA
129;REGIONAL;01/03/2021;2021;9;ARS Norte;All;47743;6947;0;54690;250514;95087;11;345612;0,070067222;0,026595248;NA;NA
130;REGIONAL;08/03/2021;2021;10;ARS Norte;All;25237;13862;0;39099;275751;108949;11;384711;0,077125855;0,030472364;NA;NA
131;REGIONAL;15/03/2021;2021;11;ARS Norte;All;26563;42160;4;68727;302314;151109;15;453438;0,084555362;0,042264256;NA;NA
132;REGIONAL;22/03/2021;2021;12;ARS Norte;All;88633;2161;0;90794;390947;153270;15;544232;0,109345466;0,042868674;NA;NA
133;REGIONAL;29/03/2021;2021;13;ARS Norte;All;53718;32487;1;86206;444665;185757;16;630438;0,12437006;0,051955088;NA;NA
134;REGIONAL;05/04/2021;2021;14;ARS Norte;All;82022;13438;2;95462;526687;199195;18;725900;0,147311107;0,055713614;NA;NA
135;REGIONAL;12/04/2021;2021;15;ARS Norte;All;135274;18993;1;154268;661961;218188;19;880168;0,185146411;0,061025839;NA;NA
136;REGIONAL;19/04/2021;2021;16;ARS Norte;All;64531;46227;0;110758;726492;264415;19;990926;0,203195334;0,073955246;NA;NA
137;REGIONAL;26/04/2021;2021;17;ARS Norte;All;125820;36495;0;162315;852312;300910;19;1153241;0,238386413;0,084162672;NA;NA
138;REGIONAL;03/05/2021;2021;18;ARS Norte;All;154478;72733;2;227213;1006790;373643;21;1380454;0,281592957;0,104505644;NA;NA
139;REGIONAL;10/05/2021;2021;19;ARS Norte;All;99093;100337;7;199437;1105883;473980;28;1579891;0,309308658;0,132569284;NA;NA
140;REGIONAL;17/05/2021;2021;20;ARS Norte;All;110042;70422;6;180470;1215925;544402;34;1760361;0,340086727;0,152265884;NA;NA
141;REGIONAL;24/05/2021;2021;21;ARS Norte;All;72154;127946;15;200115;1288079;672348;49;1960476;0,360267757;0,188051591;NA;NA
142;REGIONAL;31/05/2021;2021;22;ARS Norte;All;54293;171244;34;225571;1342372;843592;83;2186047;0,375453174;0,235947482;NA;NA
143;REGIONAL;07/06/2021;2021;23;ARS Norte;All;104989;105329;11;210329;1447361;948921;94;2396376;0,40481795;0,265407354;NA;NA
144;REGIONAL;14/06/2021;2021;24;ARS Norte;All;102808;150233;9;253050;1550169;1099154;103;2649426;0,433572714;0,307426599;NA;NA
145;REGIONAL;04/01/2021;2021;1;RA_Madeira;All;1725;0;0;1725;2365;0;0;2365;0,009301722;0;NA;NA
146;REGIONAL;11/01/2021;2021;2;RA_Madeira;All;1760;0;0;1760;4125;0;0;4125;0,016223934;0;NA;NA
147;REGIONAL;18/01/2021;2021;3;RA_Madeira;All;1079;538;0;1617;5204;538;0;5742;0,020467721;0,002115994;NA;NA
148;REGIONAL;25/01/2021;2021;4;RA_Madeira;All;408;1632;0;2040;5612;2170;0;7782;0,022072416;0,008534772;NA;NA
149;REGIONAL;01/02/2021;2021;5;RA_Madeira;All;2232;1521;0;3753;7844;3691;0;11535;0,030851039;0,014516979;NA;NA
150;REGIONAL;08/02/2021;2021;6;RA_Madeira;All;3161;1086;0;4247;11005;4777;0;15782;0,043283488;0,018788298;NA;NA
151;REGIONAL;15/02/2021;2021;7;RA_Madeira;All;2496;639;0;3135;13501;5416;0;18917;0,053100443;0,021301533;NA;NA
152;REGIONAL;22/02/2021;2021;8;RA_Madeira;All;2257;2156;0;4413;15758;7572;0;23330;0,061977393;0,029781242;NA;NA
153;REGIONAL;01/03/2021;2021;9;RA_Madeira;All;1433;3117;0;4550;17191;10689;0;27880;0,067613489;0,042040637;NA;NA
154;REGIONAL;08/03/2021;2021;10;RA_Madeira;All;4891;2399;0;7290;22082;13088;0;35170;0,086850158;0,051476083;NA;NA
155;REGIONAL;15/03/2021;2021;11;RA_Madeira;All;3110;2350;0;5460;25192;15438;0;40630;0,09908202;0,060718809;NA;NA
156;REGIONAL;22/03/2021;2021;12;RA_Madeira;All;5284;182;0;5466;30476;15620;0;46096;0,119864388;0,061434628;NA;NA
157;REGIONAL;29/03/2021;2021;13;RA_Madeira;All;1206;1260;0;2466;31682;16880;0;48562;0,124607676;0,066390303;NA;NA
158;REGIONAL;05/04/2021;2021;14;RA_Madeira;All;10219;1301;0;11520;41901;18181;0;60082;0,164799767;0,071507233;NA;NA
159;REGIONAL;12/04/2021;2021;15;RA_Madeira;All;8432;1300;0;9732;50333;19481;0;69814;0,197963454;0,07662023;NA;NA
160;REGIONAL;19/04/2021;2021;16;RA_Madeira;All;9817;2129;0;11946;60150;21610;0;81760;0,236574449;0,084993746;NA;NA
161;REGIONAL;26/04/2021;2021;17;RA_Madeira;All;8825;804;0;9629;68975;22414;0;91389;0,271283834;0,088155939;NA;NA
162;REGIONAL;03/05/2021;2021;18;RA_Madeira;All;7607;5288;0;12895;76582;27702;0;104284;0,301202734;0,108954038;NA;NA
163;REGIONAL;10/05/2021;2021;19;RA_Madeira;All;11600;6434;0;18034;88182;34136;0;122318;0,346826402;0,134259441;NA;NA
164;REGIONAL;17/05/2021;2021;20;RA_Madeira;All;2331;7613;0;9944;90513;41749;0;132262;0,355994399;0,16420194;NA;NA
165;REGIONAL;24/05/2021;2021;21;RA_Madeira;All;3438;8975;0;12413;93951;50724;0;144675;0,36951631;0,199501286;NA;NA
166;REGIONAL;31/05/2021;2021;22;RA_Madeira;All;7557;10932;0;18489;101508;61656;0;163164;0,399238557;0,24249766;NA;NA
167;REGIONAL;07/06/2021;2021;23;RA_Madeira;All;3591;15297;0;18888;105099;76953;0;182052;0,413362228;0,302661905;NA;NA
168;REGIONAL;14/06/2021;2021;24;RA_Madeira;All;3499;8097;0;11596;108598;85050;0;193648;0,427124057;0,334508012;NA;NA
169;REGIONAL;04/01/2021;2021;1;RA_Acores;All;3499;2;0;3501;5433;2;0;5435;0,02237681;8,24E-06;NA;NA
170;REGIONAL;11/01/2021;2021;2;RA_Acores;All;1;0;0;1;5434;2;0;5436;0,022380929;8,24E-06;NA;NA
171;REGIONAL;18/01/2021;2021;3;RA_Acores;All;24;1884;0;1908;5458;1886;0;7344;0,022479777;0,007767838;NA;NA
172;REGIONAL;25/01/2021;2021;4;RA_Acores;All;272;3435;0;3707;5730;5321;0;11051;0,023600059;0,021915518;NA;NA
173;REGIONAL;01/02/2021;2021;5;RA_Acores;All;1860;17;0;1877;7590;5338;0;12928;0,031260812;0,021985535;NA;NA
174;REGIONAL;08/02/2021;2021;6;RA_Acores;All;1052;1;0;1053;8642;5339;0;13981;0,035593667;0,021989654;NA;NA
175;REGIONAL;15/02/2021;2021;7;RA_Acores;All;2057;322;0;2379;10699;5661;0;16360;0,0440658;0,02331587;NA;NA
176;REGIONAL;22/02/2021;2021;8;RA_Acores;All;1467;1615;0;3082;12166;7276;0;19442;0,05010791;0,029967545;NA;NA
177;REGIONAL;01/03/2021;2021;9;RA_Acores;All;754;1162;0;1916;12920;8438;0;21358;0,053213397;0,034753456;NA;NA
178;REGIONAL;08/03/2021;2021;10;RA_Acores;All;2613;2052;0;4665;15533;10490;0;26023;0,063975519;0,043204995;NA;NA
179;REGIONAL;15/03/2021;2021;11;RA_Acores;All;2522;1438;0;3960;18055;11928;0;29983;0,07436284;0,049127663;NA;NA
180;REGIONAL;22/03/2021;2021;12;RA_Acores;All;4111;726;0;4837;22166;12654;0;34820;0,09129475;0,052117827;NA;NA
181;REGIONAL;29/03/2021;2021;13;RA_Acores;All;1964;758;0;2722;24130;13412;0;37542;0,099383845;0,05523979;NA;NA
182;REGIONAL;05/04/2021;2021;14;RA_Acores;All;3871;2345;0;6216;28001;15757;0;43758;0,115327271;0,064898104;NA;NA
183;REGIONAL;12/04/2021;2021;15;RA_Acores;All;4222;2404;0;6626;32223;18161;0;50384;0,132716354;0,07479942;NA;NA
184;REGIONAL;19/04/2021;2021;16;RA_Acores;All;7967;1057;0;9024;40190;19218;0;59408;0,16552991;0,079152869;NA;NA
185;REGIONAL;26/04/2021;2021;17;RA_Acores;All;9248;2949;2;12199;49438;22167;2;71607;0,203619499;0,091298868;NA;NA
186;REGIONAL;03/05/2021;2021;18;RA_Acores;All;9757;2824;0;12581;59195;24991;2;84188;0,243805499;0,102930032;NA;NA
187;REGIONAL;10/05/2021;2021;19;RA_Acores;All;8852;2302;1;11155;68047;27293;3;95343;0,28026409;0,112411242;NA;NA
188;REGIONAL;17/05/2021;2021;20;RA_Acores;All;11211;4929;0;16140;79258;32222;3;111483;0,326438656;0,132712236;NA;NA
189;REGIONAL;24/05/2021;2021;21;RA_Acores;All;5364;8106;3;13473;84622;40328;6;124956;0,348531277;0,166098288;NA;NA
190;REGIONAL;31/05/2021;2021;22;RA_Acores;All;5428;9358;2;14789;90050;49687;8;139745;0,370887494;0,204645052;NA;NA
191;REGIONAL;07/06/2021;2021;23;RA_Acores;All;7128;10584;1;17713;97178;60271;9;157458;0,400245474;0,248237203;NA;NA
192;REGIONAL;14/06/2021;2021;24;RA_Acores;All;8982;6216;2;15200;106160;66487;11;172658;0,437239493;0,273838943;NA;NA
193;AGES;04/01/2021;2021;1;All;0-17 anos;4;0;0;4;4;0;0;4;2,33E-06;0;NA;NA
194;AGES;04/01/2021;2021;1;All;18-24 anos;1783;1;0;1784;3138;1;0;3139;0,004045373;1,29E-06;NA;NA
195;AGES;04/01/2021;2021;1;All;25-49 anos;27433;5;0;27438;51158;6;0;51164;0,015222637;1,79E-06;NA;NA
196;AGES;04/01/2021;2021;1;All;50-64 anos;12948;4;0;12952;22139;4;0;22143;0,010239672;1,85E-06;NA;NA
197;AGES;04/01/2021;2021;1;All;65-79 anos;2283;1;0;2284;3229;1;0;3230;0,002012388;6,23E-07;NA;NA
198;AGES;04/01/2021;2021;1;All;80 ou mais anos;3764;2;0;3766;4029;2;0;4031;0,005961267;2,96E-06;NA;NA
199;AGES;04/01/2021;2021;1;All;Desconhecido;1;0;0;1;1;0;0;1;NA;NA;NA;NA
200;AGES;11/01/2021;2021;2;All;0-17 anos;15;0;0;15;19;0;0;19;1,11E-05;0;NA;NA
201;AGES;11/01/2021;2021;2;All;18-24 anos;1395;55;0;1450;4533;56;0;4589;0,005843746;7,22E-05;NA;NA
202;AGES;11/01/2021;2021;2;All;25-49 anos;16340;779;0;17119;67498;785;0;68283;0,020084787;0,000233586;NA;NA
203;AGES;11/01/2021;2021;2;All;50-64 anos;11654;301;0;11955;33793;305;0;34098;0,015629849;0,000141068;NA;NA
204;AGES;11/01/2021;2021;2;All;65-79 anos;5512;27;0;5539;8741;28;0;8769;0,005447596;1,75E-05;NA;NA
205;AGES;11/01/2021;2021;2;All;80 ou mais anos;14468;0;0;14468;18497;2;0;18499;0,027367973;2,96E-06;NA;NA
206;AGES;11/01/2021;2021;2;All;Desconhecido;0;0;0;0;1;0;0;1;NA;NA;NA;NA
207;AGES;18/01/2021;2021;3;All;0-17 anos;69;0;0;69;88;0;0;88;5,13E-05;0;NA;NA
208;AGES;18/01/2021;2021;3;All;18-24 anos;3805;1191;0;4996;8338;1247;0;9585;0,010748987;0,001607578;NA;NA
209;AGES;18/01/2021;2021;3;All;25-49 anos;37305;21712;2;59019;104803;22497;2;127302;0,031185308;0,006694235;NA;NA
210;AGES;18/01/2021;2021;3;All;50-64 anos;27339;8528;1;35868;61132;8833;1;69966;0,028274611;0,004085416;NA;NA
211;AGES;18/01/2021;2021;3;All;65-79 anos;14012;904;0;14916;22753;932;0;23685;0,014180203;0,000580844;NA;NA
212;AGES;18/01/2021;2021;3;All;80 ou mais anos;38983;258;0;39241;57480;260;0;57740;0,085046822;0,000384693;NA;NA
213;AGES;18/01/2021;2021;3;All;Desconhecido;0;0;0;0;1;0;0;1;NA;NA;NA;NA
214;AGES;25/01/2021;2021;4;All;0-17 anos;14;3;0;17;102;3;0;105;5,94E-05;1,75E-06;NA;NA
215;AGES;25/01/2021;2021;4;All;18-24 anos;1420;1570;0;2990;9758;2817;0;12575;0,012579589;0,003631554;NA;NA
216;AGES;25/01/2021;2021;4;All;25-49 anos;15957;25617;4;41578;120760;48114;6;168880;0,035933493;0,01431686;NA;NA
217;AGES;25/01/2021;2021;4;All;50-64 anos;10906;12165;0;23071;72038;20998;1;93037;0,033318826;0,00971194;NA;NA
218;AGES;25/01/2021;2021;4;All;65-79 anos;6452;2129;0;8581;29205;3061;0;32266;0,01820124;0,001907687;NA;NA
219;AGES;25/01/2021;2021;4;All;80 ou mais anos;7354;3383;0;10737;64834;3643;0;68477;0,095927725;0,005390146;NA;NA
220;AGES;25/01/2021;2021;4;All;Desconhecido;0;0;0;0;1;0;0;1;NA;NA;NA;NA
221;AGES;01/02/2021;2021;5;All;0-17 anos;34;1;0;35;136;4;0;140;7,92E-05;2,33E-06;NA;NA
222;AGES;01/02/2021;2021;5;All;18-24 anos;968;933;0;1901;10726;3750;0;14476;0,013827493;0,004834337;NA;NA
223;AGES;01/02/2021;2021;5;All;25-49 anos;9871;12487;0;22358;130631;60601;6;191238;0,038870719;0,018032507;NA;NA
224;AGES;01/02/2021;2021;5;All;50-64 anos;5473;9183;1;14657;77511;30181;2;107694;0,035850183;0,013959236;NA;NA
225;AGES;01/02/2021;2021;5;All;65-79 anos;2661;4157;0;6818;31866;7218;0;39084;0,019859638;0,004498427;NA;NA
226;AGES;01/02/2021;2021;5;All;80 ou mais anos;4515;10630;0;15145;69349;14273;0;83622;0,102608073;0,021118185;NA;NA
227;AGES;01/02/2021;2021;5;All;Desconhecido;0;0;0;0;1;0;0;1;NA;NA;NA;NA
228;AGES;08/02/2021;2021;6;All;0-17 anos;37;67;0;104;173;71;0;244;0,000100754;4,13E-05;NA;NA
229;AGES;08/02/2021;2021;6;All;18-24 anos;1453;3040;0;4493;12179;6790;0;18969;0,015700637;0,008753373;NA;NA
230;AGES;08/02/2021;2021;6;All;25-49 anos;13714;30721;5;44440;144345;91322;11;235678;0,042951474;0,027173886;NA;NA
231;AGES;08/02/2021;2021;6;All;50-64 anos;6794;22176;1;28971;84305;52357;3;136665;0,038992526;0,024216022;NA;NA
232;AGES;08/02/2021;2021;6;All;65-79 anos;3632;11453;3;15088;35498;18671;3;54172;0,022123185;0,011636205;NA;NA
233;AGES;08/02/2021;2021;6;All;80 ou mais anos;14823;31501;2;46326;84172;45774;2;129948;0,124540033;0,067726743;NA;NA
234;AGES;08/02/2021;2021;6;All;Desconhecido;0;0;0;0;1;0;0;1;NA;NA;NA;NA
235;AGES;15/02/2021;2021;7;All;0-17 anos;30;16;0;46;203;87;0;290;0,000118226;5,07E-05;NA;NA
236;AGES;15/02/2021;2021;7;All;18-24 anos;2310;1729;0;4039;14489;8519;0;23008;0,018678589;0,010982324;NA;NA
237;AGES;15/02/2021;2021;7;All;25-49 anos;22201;18917;4;41122;166546;110239;15;276800;0,049557631;0,032802851;NA;NA
238;AGES;15/02/2021;2021;7;All;50-64 anos;25015;12897;1;37913;109320;65254;4;174578;0,050562398;0,030181108;NA;NA
239;AGES;15/02/2021;2021;7;All;65-79 anos;5002;7186;2;12190;40500;25857;5;66362;0,025240549;0,016114688;NA;NA
240;AGES;15/02/2021;2021;7;All;80 ou mais anos;48608;9234;2;57844;132780;55008;4;187792;0,196459933;0,081389276;NA;NA
241;AGES;15/02/2021;2021;7;All;Desconhecido;0;0;0;0;1;0;0;1;NA;NA;NA;NA
242;AGES;22/02/2021;2021;8;All;0-17 anos;21;32;0;53;224;119;0;343;0,000130456;6,93E-05;NA;NA
243;AGES;22/02/2021;2021;8;All;18-24 anos;1262;692;0;1954;15751;9211;0;24962;0,020305504;0,011874421;NA;NA
244;AGES;22/02/2021;2021;8;All;25-49 anos;11271;7233;1;18505;177817;117472;16;295305;0,052911443;0,034955111;NA;NA
245;AGES;22/02/2021;2021;8;All;50-64 anos;49667;4925;1;54593;158987;70179;5;229171;0,073534248;0,032459006;NA;NA
246;AGES;22/02/2021;2021;8;All;65-79 anos;11551;2404;0;13955;52051;28261;5;80317;0,032439402;0,017612917;NA;NA
247;AGES;22/02/2021;2021;8;All;80 ou mais anos;102517;5185;0;107702;235297;60193;4;295494;0,348143041;0,089060949;NA;NA
248;AGES;22/02/2021;2021;8;All;Desconhecido;0;0;0;0;1;0;0;1;NA;NA;NA;NA
249;AGES;01/03/2021;2021;9;All;0-17 anos;8;28;0;36;232;147;0;379;0,000135115;8,56E-05;NA;NA
250;AGES;01/03/2021;2021;9;All;18-24 anos;881;1021;0;1902;16632;10232;0;26864;0,021441251;0,013190649;NA;NA
251;AGES;01/03/2021;2021;9;All;25-49 anos;7219;9857;0;17076;185036;127329;16;312381;0,055059538;0,037888172;NA;NA
252;AGES;01/03/2021;2021;9;All;50-64 anos;29914;5911;1;35826;188901;76090;6;264997;0,087369992;0,035192946;NA;NA
253;AGES;01/03/2021;2021;9;All;65-79 anos;13048;3724;0;16772;65099;31985;5;97089;0,040571222;0,019933801;NA;NA
254;AGES;01/03/2021;2021;9;All;80 ou mais anos;87142;12726;1;99869;322439;72919;5;395363;0,477077455;0,107890209;NA;NA
255;AGES;01/03/2021;2021;9;All;Desconhecido;0;0;0;0;1;0;0;1;NA;NA;NA;NA
256;AGES;08/03/2021;2021;10;All;0-17 anos;12;24;0;36;244;171;0;415;0,000142104;9,96E-05;NA;NA
257;AGES;08/03/2021;2021;10;All;18-24 anos;1306;630;0;1936;17938;10862;0;28800;0,02312489;0,014002818;NA;NA
258;AGES;08/03/2021;2021;10;All;25-49 anos;15796;5925;0;21721;200832;133254;16;334102;0,059759815;0,039651223;NA;NA
259;AGES;08/03/2021;2021;10;All;50-64 anos;21766;4172;0;25938;210667;80262;6;290935;0,097437145;0,037122568;NA;NA
260;AGES;08/03/2021;2021;10;All;65-79 anos;15480;3461;0;18941;80579;35446;5;116030;0,05021872;0,022090777;NA;NA
261;AGES;08/03/2021;2021;10;All;80 ou mais anos;40078;37241;2;77321;362517;110160;7;472684;0,536376455;0,162991612;NA;NA
262;AGES;08/03/2021;2021;10;All;Desconhecido;0;0;0;0;1;0;0;1;NA;NA;NA;NA
263;AGES;15/03/2021;2021;11;All;0-17 anos;1;23;0;24;245;194;0;439;0,000142687;0,000112984;NA;NA
264;AGES;15/03/2021;2021;11;All;18-24 anos;229;370;1;600;18167;11232;1;29400;0,023420106;0,014479806;NA;NA
265;AGES;15/03/2021;2021;11;All;25-49 anos;4097;2958;0;7055;204929;136212;16;341157;0,060978923;0,040531409;NA;NA
266;AGES;15/03/2021;2021;11;All;50-64 anos;4063;2242;0;6305;214730;82504;6;297240;0,099316353;0,038159532;NA;NA
267;AGES;15/03/2021;2021;11;All;65-79 anos;17954;6738;2;24694;98533;42184;7;140724;0,061408074;0,026290057;NA;NA
268;AGES;15/03/2021;2021;11;All;80 ou mais anos;54332;97317;4;151653;416849;207477;11;624337;0,616765528;0,306980853;NA;NA
269;AGES;15/03/2021;2021;11;All;Desconhecido;0;0;0;0;1;0;0;1;NA;NA;NA;NA
270;AGES;22/03/2021;2021;12;All;0-17 anos;24;7;0;31;269;201;0;470;0,000156664;0,000117061;NA;NA
271;AGES;22/03/2021;2021;12;All;18-24 anos;3125;113;0;3238;21292;11345;1;32638;0,027448721;0,014625481;NA;NA
272;AGES;22/03/2021;2021;12;All;25-49 anos;41667;1196;0;42863;246596;137408;16;384020;0,073377406;0,040887292;NA;NA
273;AGES;22/03/2021;2021;12;All;50-64 anos;33950;865;0;34815;248680;83369;6;332055;0,115018818;0,03855961;NA;NA
274;AGES;22/03/2021;2021;12;All;65-79 anos;52558;2084;0;54642;151091;44268;7;195366;0,09416345;0,027588855;NA;NA
275;AGES;22/03/2021;2021;12;All;80 ou mais anos;124499;16858;2;141359;541348;224335;13;765696;0,800972978;0,331923777;NA;NA
276;AGES;22/03/2021;2021;12;All;Desconhecido;0;0;0;0;1;0;0;1;NA;NA;NA;NA
277;AGES;29/03/2021;2021;13;All;0-17 anos;7;12;0;19;276;213;0;489;0,000160741;0,00012405;NA;NA
278;AGES;29/03/2021;2021;13;All;18-24 anos;620;65;1;686;21912;11410;2;33324;0,028247998;0,014709276;NA;NA
279;AGES;29/03/2021;2021;13;All;25-49 anos;4205;742;1;4948;250801;138150;17;388968;0,074628651;0,041108082;NA;NA
280;AGES;29/03/2021;2021;13;All;50-64 anos;7473;652;1;8126;256153;84021;7;340181;0,11847521;0,038861171;NA;NA
281;AGES;29/03/2021;2021;13;All;65-79 anos;87842;7219;1;95062;238933;51487;8;290428;0,148908642;0,032087904;NA;NA
282;AGES;29/03/2021;2021;13;All;80 ou mais anos;36721;75302;3;112026;578069;299637;16;877722;0,855304995;0,443339848;NA;NA
283;AGES;29/03/2021;2021;13;All;Desconhecido;0;0;0;0;1;0;0;1;NA;NA;NA;NA
284;AGES;05/04/2021;2021;14;All;0-17 anos;14;1;0;15;290;214;0;504;0,000168894;0,000124632;NA;NA
285;AGES;05/04/2021;2021;14;All;18-24 anos;710;105;0;815;22622;11515;2;34139;0,029163299;0,014844637;NA;NA
286;AGES;05/04/2021;2021;14;All;25-49 anos;8509;867;0;9376;259310;139017;17;398344;0,077160599;0,041366068;NA;NA
287;AGES;05/04/2021;2021;14;All;50-64 anos;14861;753;0;15614;271014;84774;7;355795;0,12534868;0,039209447;NA;NA
288;AGES;05/04/2021;2021;14;All;65-79 anos;200973;5148;0;206121;439906;56635;8;496549;0,274159723;0,035296259;NA;NA
289;AGES;05/04/2021;2021;14;All;80 ou mais anos;30361;45745;3;76109;608430;345382;19;953831;0,900226821;0,511023684;NA;NA
290;AGES;05/04/2021;2021;14;All;Desconhecido;0;0;0;0;1;0;0;1;NA;NA;NA;NA
291;AGES;12/04/2021;2021;15;All;0-17 anos;37;2;0;39;327;216;0;543;0,000190443;0,000125797;NA;NA
292;AGES;12/04/2021;2021;15;All;18-24 anos;4242;55;0;4297;26864;11570;2;38436;0,034631901;0,014915541;NA;NA
293;AGES;12/04/2021;2021;15;All;25-49 anos;88710;481;0;89191;348020;139498;17;487535;0,103557255;0,041509195;NA;NA
294;AGES;12/04/2021;2021;15;All;50-64 anos;87596;399;0;87995;358610;85173;7;443790;0,165863351;0,039393991;NA;NA
295;AGES;12/04/2021;2021;15;All;65-79 anos;232889;3418;1;236308;672795;60053;9;732857;0,419301603;0,037426436;NA;NA
296;AGES;12/04/2021;2021;15;All;80 ou mais anos;10488;49401;1;59890;618918;394783;20;1013721;0,915744759;0,584116899;NA;NA
297;AGES;12/04/2021;2021;15;All;Desconhecido;0;0;0;0;1;0;0;1;NA;NA;NA;NA
298;AGES;19/04/2021;2021;16;All;0-17 anos;20;4;0;24;347;220;0;567;0,000202091;0,000128127;NA;NA
299;AGES;19/04/2021;2021;16;All;18-24 anos;1260;56;0;1316;28124;11626;2;39752;0,036256238;0,014987734;NA;NA
300;AGES;19/04/2021;2021;16;All;25-49 anos;10336;504;0;10840;358356;140002;17;498375;0,106632848;0,041659166;NA;NA
301;AGES;19/04/2021;2021;16;All;50-64 anos;13962;1584;0;15546;372572;86757;7;459336;0,172321019;0,040126619;NA;NA
302;AGES;19/04/2021;2021;16;All;65-79 anos;175287;13083;2;188372;848082;73136;11;921229;0,528544568;0,045580068;NA;NA
303;AGES;19/04/2021;2021;16;All;80 ou mais anos;8410;123064;9;131483;627328;517847;29;1145204;0,928188109;0,766201138;NA;NA
304;AGES;19/04/2021;2021;16;All;Desconhecido;0;0;0;0;1;0;0;1;NA;NA;NA;NA
305;AGES;26/04/2021;2021;17;All;0-17 anos;43;14;0;57;390;234;0;624;0,000227134;0,00013628;NA;NA
306;AGES;26/04/2021;2021;17;All;18-24 anos;2616;79;0;2695;30740;11705;2;42447;0,039628671;0,015089577;NA;NA
307;AGES;26/04/2021;2021;17;All;25-49 anos;10058;630;1;10689;368414;140632;18;509064;0,109625719;0,041846629;NA;NA
308;AGES;26/04/2021;2021;17;All;50-64 anos;32392;2769;0;35161;404964;89526;7;494497;0,187302881;0,041407329;NA;NA
309;AGES;26/04/2021;2021;17;All;65-79 anos;292645;46152;0;338797;1140727;119288;11;1260026;0,710927786;0,074343076;NA;NA
310;AGES;26/04/2021;2021;17;All;80 ou mais anos;6133;39712;4;45849;633461;557559;33;1191053;0,937262433;0,824958608;NA;NA
311;AGES;26/04/2021;2021;17;All;Desconhecido;0;0;0;0;1;0;0;1;NA;NA;NA;NA
312;AGES;03/05/2021;2021;18;All;0-17 anos;98;8;0;106;488;242;0;730;0,000284208;0,000140939;NA;NA
313;AGES;03/05/2021;2021;18;All;18-24 anos;1721;720;0;2441;32461;12425;2;44888;0,04184731;0,01601777;NA;NA
314;AGES;03/05/2021;2021;18;All;25-49 anos;9220;7448;0;16668;377634;148080;18;525732;0,112369233;0,044062865;NA;NA
315;AGES;03/05/2021;2021;18;All;50-64 anos;150680;14275;0;164955;555644;103801;7;659452;0,256994997;0,048009765;NA;NA
316;AGES;03/05/2021;2021;18;All;65-79 anos;201935;163496;7;365438;1342662;282784;18;1625464;0,836778409;0,176237613;NA;NA
317;AGES;03/05/2021;2021;18;All;80 ou mais anos;5096;31729;3;36828;638557;589288;36;1227881;0,944802423;0,871904513;NA;NA
318;AGES;03/05/2021;2021;18;All;Desconhecido;0;0;0;0;1;0;0;1;NA;NA;NA;NA
319;AGES;10/05/2021;2021;19;All;0-17 anos;133;31;0;164;621;273;0;894;0,000361667;0,000158994;NA;NA
320;AGES;10/05/2021;2021;19;All;18-24 anos;2093;5316;2;7411;34554;17741;4;52299;0,044545514;0,022870926;NA;NA
321;AGES;10/05/2021;2021;19;All;25-49 anos;23922;99383;4;123309;401556;247463;22;649041;0,119487492;0,073635392;NA;NA
322;AGES;10/05/2021;2021;19;All;50-64 anos;165745;108950;6;274701;721389;212751;13;934153;0,333654937;0,098401031;NA;NA
323;AGES;10/05/2021;2021;19;All;65-79 anos;91273;79822;3;171098;1433935;362606;21;1796562;0,89366188;0,225984553;NA;NA
324;AGES;10/05/2021;2021;19;All;80 ou mais anos;3767;9934;2;13703;642324;599222;38;1241584;0,950376038;0,886602758;NA;NA
325;AGES;10/05/2021;2021;19;All;Desconhecido;0;0;0;0;1;0;0;1;NA;NA;NA;NA
326;AGES;17/05/2021;2021;20;All;0-17 anos;274;16;0;290;895;289;0;1184;0,000521243;0,000168312;NA;NA
327;AGES;17/05/2021;2021;20;All;18-24 anos;1925;2387;2;4314;36479;20128;6;56613;0,047027141;0,025948142;NA;NA
328;AGES;17/05/2021;2021;20;All;25-49 anos;30955;21115;2;52072;432511;268578;24;701113;0,1286985;0,079918397;NA;NA
329;AGES;17/05/2021;2021;20;All;50-64 anos;223914;74895;4;298813;945303;287646;17;1232966;0,43721905;0,133041269;NA;NA
330;AGES;17/05/2021;2021;20;All;65-79 anos;41131;111320;10;152461;1475066;473926;31;1949023;0,919295683;0,295361784;NA;NA
331;AGES;17/05/2021;2021;20;All;80 ou mais anos;4733;8339;1;13073;647057;607561;39;1254657;0,957378936;0,898941058;NA;NA
332;AGES;17/05/2021;2021;20;All;Desconhecido;0;0;0;0;1;0;0;1;NA;NA;NA;NA
333;AGES;24/05/2021;2021;21;All;0-17 anos;243;35;0;278;1138;324;0;1462;0,000662765;0,000188696;NA;NA
334;AGES;24/05/2021;2021;21;All;18-24 anos;2117;3180;5;5302;38596;23308;11;61915;0,049756285;0,03004766;NA;NA
335;AGES;24/05/2021;2021;21;All;25-49 anos;25011;17534;26;42571;457522;286112;50;743684;0,136140804;0,085135835;NA;NA
336;AGES;24/05/2021;2021;21;All;50-64 anos;174025;97557;31;271613;1119328;385203;48;1504579;0,517708633;0,178163075;NA;NA
337;AGES;24/05/2021;2021;21;All;65-79 anos;23428;201878;20;225326;1498494;675804;51;2174349;0,933896561;0,421176883;NA;NA
338;AGES;24/05/2021;2021;21;All;80 ou mais anos;4429;6301;0;10730;651486;613862;39;1265387;0,963932039;0,908263953;NA;NA
339;AGES;24/05/2021;2021;21;All;Desconhecido;0;0;0;0;1;0;0;1;NA;NA;NA;NA
340;AGES;31/05/2021;2021;22;All;0-17 anos;248;91;0;339;1386;415;0;1801;0,000807198;0,000241694;NA;NA
341;AGES;31/05/2021;2021;22;All;18-24 anos;2187;2516;1;4704;40783;25824;12;66619;0,05257567;0,033291178;NA;NA
342;AGES;31/05/2021;2021;22;All;25-49 anos;41392;22205;9;63606;498914;308317;59;807290;0,148457458;0,091743182;NA;NA
343;AGES;31/05/2021;2021;22;All;50-64 anos;162754;167389;12;330155;1282082;552592;60;1834734;0,592985184;0,255583394;NA;NA
344;AGES;31/05/2021;2021;22;All;65-79 anos;18553;136996;24;155574;1517047;812801;75;2329923;0,945459225;0,506556622;NA;NA
345;AGES;31/05/2021;2021;22;All;80 ou mais anos;3045;5967;5;9017;654531;619829;44;1274404;0,96843739;0,917092665;NA;NA
346;AGES;31/05/2021;2021;22;All;Desconhecido;0;0;0;0;1;0;0;1;NA;NA;NA;NA
347;AGES;07/06/2021;2021;23;All;0-17 anos;363;127;0;490;1749;542;0;2291;0,001018607;0,000315658;NA;NA
348;AGES;07/06/2021;2021;23;All;18-24 anos;2531;2706;1;5238;43314;28530;13;71857;0,055838525;0,036779635;NA;NA
349;AGES;07/06/2021;2021;23;All;25-49 anos;125282;29963;7;155252;624196;338280;66;962542;0,185736522;0,100659009;NA;NA
350;AGES;07/06/2021;2021;23;All;50-64 anos;208327;137664;8;345999;1490409;690256;68;2180733;0,689340039;0,319255384;NA;NA
351;AGES;07/06/2021;2021;23;All;65-79 anos;15944;71197;2;87143;1532991;883998;77;2417066;0,9553959;0,55092826;NA;NA
352;AGES;07/06/2021;2021;23;All;80 ou mais anos;2736;4785;1;7522;657267;624614;45;1281926;0,972485548;0,924172502;NA;NA
353;AGES;07/06/2021;2021;23;All;Desconhecido;1;0;0;1;2;0;0;2;NA;NA;NA;NA
355;AGES;14/06/2021;2021;24;All;0-17 anos;539;265;0;804;2288;807;0;3095;0,001332518;0,000469992;NA;NA
356;AGES;14/06/2021;2021;24;All;18-24 anos;2611;4139;3;6753;45925;32669;16;78610;0,059204513;0,042115454;NA;NA
357;AGES;14/06/2021;2021;24;All;25-49 anos;236862;81896;11;318769;861058;420176;77;1281311;0,256217467;0,125028082;NA;NA
358;AGES;14/06/2021;2021;24;All;50-64 anos;85349;228695;15;314059;1575758;918951;83;2494792;0,728815433;0,425030792;NA;NA
359;AGES;14/06/2021;2021;24;All;65-79 anos;10725;61896;2;72623;1543716;945894;79;2489689;0,962079971;0,589503297;NA;NA
360;AGES;14/06/2021;2021;24;All;80 ou mais anos;2537;4607;0;7144;659804;629221;45;1289070;0,976239267;0,930988973;NA;NA
361;AGES;14/06/2021;2021;24;All;Desconhecido;0;0;0;0;2;0;0;2;NA;NA;NA;NA
363;GENERAL;04/01/2021;2021;1;All;All;48216;13;0;48229;83698;14;0;83712;0,008129248;1,36E-06;NA;NA
364;GENERAL;11/01/2021;2021;2;All;All;49384;1162;0;50546;133082;1176;0;134258;0,012925716;0,00011422;NA;NA
365;GENERAL;18/01/2021;2021;3;All;All;121513;32593;3;154109;254595;33769;3;288367;0,024727783;0,003279846;NA;NA
366;GENERAL;25/01/2021;2021;4;All;All;42103;44867;4;86974;296698;78636;7;375341;0,028817077;0,007637597;NA;NA
367;GENERAL;01/02/2021;2021;5;All;All;23522;37391;1;60914;320220;116027;8;436255;0,031101673;0,011269233;NA;NA
368;GENERAL;08/02/2021;2021;6;All;All;40453;98958;11;139422;360673;214985;19;575677;0,03503071;0,020880624;651900;571981
369;GENERAL;15/02/2021;2021;7;All;All;103166;49979;9;153154;463839;264964;28;728831;0,045050806;0,025734882;830730;718143
370;GENERAL;22/02/2021;2021;8;All;All;176289;20471;2;196762;640128;285435;30;925593;0,062173044;0,027723147;1002999;933847
371;GENERAL;01/03/2021;2021;9;All;All;138212;33267;2;171481;778340;318702;32;1097074;0,075597016;0,030954236;1186389;1095103
372;GENERAL;08/03/2021;2021;10;All;All;94438;51453;2;145893;872778;370155;34;1242967;0,084769397;0,035951658;1468929;1264093
373;GENERAL;15/03/2021;2021;11;All;All;80676;109648;7;190331;953454;479803;41;1433298;0,092605131;0,046601325;1713540;1462079
374;GENERAL;22/03/2021;2021;12;All;All;255823;21123;2;276948;1209277;500926;43;1710246;0,117452184;0,048652916;1883850;1753999
375;GENERAL;29/03/2021;2021;13;All;All;136868;83992;7;220867;1346145;584918;50;1931113;0,130745619;0,05681072;2344530;1996561
376;GENERAL;05/04/2021;2021;14;All;All;255428;52619;3;308050;1601573;637537;53;2239163;0,155554308;0,06192139;2684460;2360167
377;GENERAL;12/04/2021;2021;15;All;All;423962;53756;2;477720;2025535;691293;55;2716883;0,196732022;0,067142493;2983590;2679813
378;GENERAL;19/04/2021;2021;16;All;All;209275;138295;11;347581;2234810;829588;66;3064464;0,217058057;0,080574527;3400260;3039329
379;GENERAL;26/04/2021;2021;17;All;All;343887;89356;5;433248;2578697;918944;71;3497712;0,25045841;0,089253314;4128420;3581288
380;GENERAL;03/05/2021;2021;18;All;All;368750;217676;10;586436;2947447;1136620;81;4084148;0,286273606;0,110395304;4655370;4171038
381;GENERAL;10/05/2021;2021;19;All;All;286933;303436;17;590386;3234380;1440056;98;4674534;0,314142248;0,139866815;5197920;4686071
382;GENERAL;17/05/2021;2021;20;All;All;302932;218072;19;521023;3537312;1658128;117;5195557;0,343564808;0,161047266;5728470;5126418
383;GENERAL;24/05/2021;2021;21;All;All;229253;326485;82;555820;3766565;1984613;199;5751377;0,365831225;0,192757434;6254220;5644760
384;GENERAL;31/05/2021;2021;22;All;All;228179;335164;51;563395;3994744;2319778;250;6314772;0,387993328;0,225310655;7263540;6299315
385;GENERAL;07/06/2021;2021;23;All;All;355184;246442;19;601645;4349928;2566220;269;6916417;0,422490914;0,24924657;7880400;6896272
386;GENERAL;14/06/2021;2021;24;All;All;338623;381498;31;720152;4688551;2947718;300;7636569;0,455379996;0,286299927;8604606;7566600
