"";"TYPE";"DATE";"YEAR";"WEEK";"REGION";"AGEGROUP";"TOTAL_VAC_1";"TOTAL_VAC_2";"TOTAL_VAC_UNK";"TOTAL";"CUMUL_VAC_1";"CUMUL_VAC_2";"CUMUL_VAC_UNK";"CUMUL";"CUMUL_VAC_INIT";"CUMUL_VAC_COMPLETE";"CUMUL_VAC_LEAST";"COVER_1_VAC";"COVER_INIT";"COVER_COMPLETE";"COVER_LEAST"
"1";"REGIONAL";2021-01-04;2021;1;"ARS Alentejo";"All";3489;2;0;3491;4718;3;0;4721;4715;3;4718;0,0100639502391201;0,0100575509490147;6,39929010541764e-06;0,0100639502391201
"2";"REGIONAL";2021-01-11;2021;2;"ARS Alentejo";"All";5366;12;0;5378;10084;15;0;10099;10068;16;10084;0,0215101471410105;0,0214760175937816;3,41295472288941e-05;0,0215101471410105
"3";"REGIONAL";2021-01-18;2021;3;"ARS Alentejo";"All";10439;1133;0;11572;20523;1148;0;21671;19370;1153;20523;0,0437775436111621;0,0413180831139799;0,00245946049718218;0,0437775436111621
"4";"REGIONAL";2021-01-25;2021;4;"ARS Alentejo";"All";2357;3123;0;5480;22880;4271;0;27151;18601;4279;22880;0,0488052525373185;0,0396777317502912;0,00912752078702736;0,0488052525373185
"5";"REGIONAL";2021-02-01;2021;5;"ARS Alentejo";"All";1458;4347;0;5805;24338;8618;0;32956;15711;8627;24338;0,0519153075285515;0,0335130822820722;0,0184022252464793;0,0519153075285515
"6";"REGIONAL";2021-02-08;2021;6;"ARS Alentejo";"All";3290;8788;0;12078;27628;17406;0;45034;10209;17419;27628;0,0589331956774928;0,0217767842287362;0,0371564114487566;0,0589331956774928
"7";"REGIONAL";2021-02-15;2021;7;"ARS Alentejo";"All";4065;2834;0;6899;31693;20240;0;51933;11440;20253;31693;0,0676042337703337;0,0244026262686593;0,0432016075016745;0,0676042337703337
"8";"REGIONAL";2021-02-22;2021;8;"ARS Alentejo";"All";12043;1634;0;13677;43736;21874;0;65610;21845;21891;43736;0,0932931173501819;0,0465974974509494;0,0466956198992325;0,0932931173501819
"9";"REGIONAL";2021-03-01;2021;9;"ARS Alentejo";"All";10473;2839;1;13313;54209;24713;1;78923;29473;24736;54209;0,115633039108195;0,0628687590923247;0,0527642800158702;0,115633039108195
"10";"REGIONAL";2021-03-08;2021;10;"ARS Alentejo";"All";5847;1677;0;7524;60056;26390;1;86447;33634;26422;60056;0,128105255523654;0,071744574468539;0,056360681055115;0,128105255523654
"11";"REGIONAL";2021-03-15;2021;11;"ARS Alentejo";"All";3723;7748;0;11471;63779;34138;1;97918;29609;34171;63780;0,136046774544477;0,0631588602437703;0,0728900473974087;0,136048907641179
"12";"REGIONAL";2021-03-22;2021;12;"ARS Alentejo";"All";11921;2121;0;14042;75700;36259;1;111960;39408;36294;75702;0,161475420326705;0,0840610748247661;0,0774186116953426;0,161479686520109
"13";"REGIONAL";2021-03-29;2021;13;"ARS Alentejo";"All";6164;6309;0;12473;81864;42568;1;124433;39260;42606;81866;0,174623828396637;0,0837453765128988;0,0908827180771413;0,17462809459004
"14";"REGIONAL";2021-04-05;2021;14;"ARS Alentejo";"All";14061;4325;0;18386;95925;46893;1;142819;48993;46936;95929;0,204617301120729;0,104506806711575;0,100119026795961;0,204625833507536
"15";"REGIONAL";2021-04-12;2021;15;"ARS Alentejo";"All";21914;2978;0;24892;117839;49871;1;167711;67926;49918;117844;0,251361982244103;0,144892726566866;0,106479921160746;0,251372647727612
"16";"REGIONAL";2021-04-19;2021;16;"ARS Alentejo";"All";11381;5983;1;17365;129220;55854;2;185076;73321;55904;129225;0,275638755807356;0,156400783273109;0,119248638017756;0,275649421290865
"17";"REGIONAL";2021-04-26;2021;17;"ARS Alentejo";"All";20235;2794;0;23029;149455;58648;2;208105;90765;58701;149466;0,318801967568398;0,193610522139411;0,125214909492707;0,318825431632118
"18";"REGIONAL";2021-05-03;2021;18;"ARS Alentejo";"All";13692;14352;1;28045;163147;73000;3;236150;93208;73065;166273;0,348008327609524;0,198821677381922;0,155854710517447;0,354676387899369
"19";"REGIONAL";2021-05-10;2021;19;"ARS Alentejo";"All";17442;15299;0;32741;180589;88299;3;268891;95838;88383;184221;0,385213800282422;0,204431721707672;0,188529485795709;0,392961207503381
"20";"REGIONAL";2021-05-17;2021;20;"ARS Alentejo";"All";13231;12250;1;25482;193820;100549;4;294373;100118;100748;200866;0,413436802744016;0,213561375591401;0,214905226513539;0,42846660210494
"21";"REGIONAL";2021-05-24;2021;21;"ARS Alentejo";"All";7205;18567;0;25772;201025;119116;4;320145;90436;119765;210201;0,428805764480527;0,192908733324517;0,255470326491781;0,448379059816298
"22";"REGIONAL";2021-05-31;2021;22;"ARS Alentejo";"All";17413;7331;0;24744;218438;126447;4;344889;100106;127850;227956;0,465949377349073;0,213535778430979;0,272716413325882;0,486252191756861
"23";"REGIONAL";2021-06-07;2021;23;"ARS Alentejo";"All";13831;15297;0;29128;232269;141744;4;374017;98679;143744;242423;0,49545223783175;0,210491849437502;0,306619852304384;0,517111701741887
"24";"REGIONAL";2021-06-14;2021;24;"ARS Alentejo";"All";10251;19273;1;29525;242520;161017;5;403542;90866;163484;254350;0,517318612121962;0,193825964906293;0,348727181198032;0,542553146104325
"25";"REGIONAL";2021-06-21;2021;25;"ARS Alentejo";"All";10562;14224;1;24787;253082;175241;6;428329;89295;178404;267699;0,539848379486436;0,190474869987756;0,380552983988976;0,571027853976732
"26";"REGIONAL";2021-06-28;2021;26;"ARS Alentejo";"All";10998;28810;3;39811;264080;204051;9;468140;72924;207868;280792;0,563308177012897;0,155553943882492;0,443402545210985;0,598956489093477
"27";"REGIONAL";2021-07-05;2021;27;"ARS Alentejo";"All";15342;27900;1;43243;279422;231951;10;511383;59688;237152;296840;0,596034146612002;0,127320275937389;0,505868149026668;0,633188424964057
"28";"REGIONAL";2021-07-12;2021;28;"ARS Alentejo";"All";8205;20359;1;28565;287627;252310;11;539948;49546;258984;308530;0,61353620505032;0,105686409187674;0,552437916220494;0,658124325408168
"29";"REGIONAL";2021-07-19;2021;29;"ARS Alentejo";"All";3528;16772;3;20303;291155;269082;14;560251;39379;277025;316404;0,621061770214291;0,0839992150204137;0,590921113817774;0,674920328838188
"30";"REGIONAL";2021-07-26;2021;30;"ARS Alentejo";"All";2255;16542;0;18797;293410;285624;14;579048;28698;294586;323284;0,625871903276863;0,0612156091484251;0,628380424998187;0,689596034146612
"31";"REGIONAL";2021-08-02;2021;31;"ARS Alentejo";"All";4961;20018;13;24992;298371;305642;27;604040;18613;315725;334338;0,636454196014522;0,0397033289107128;0,673471956177661;0,713175285088374
"32";"REGIONAL";2021-08-09;2021;32;"ARS Alentejo";"All";14874;14443;0;29317;313245;320085;27;633357;24692;331827;356519;0,668181876357183;0,0526704237609908;0,70781907927014;0,76048950303113
"33";"REGIONAL";2021-08-16;2021;33;"ARS Alentejo";"All";22215;6589;0;28804;335460;326674;27;662161;41934;340620;382554;0,7155686195878;0,0894492770935278;0,726575398569119;0,816024675662646
"34";"REGIONAL";2021-08-23;2021;34;"ARS Alentejo";"All";12973;4610;0;17583;348433;331284;27;679744;51014;346648;397662;0,743241283100328;0,108817795145925;0,739433705487605;0,84825150063353
"35";"REGIONAL";2021-08-30;2021;35;"ARS Alentejo";"All";4749;15829;2;20580;353182;347113;29;700324;40612;363425;404037;0,753371359337204;0,0866293232537404;0,775220668853802;0,861849992107542
"36";"REGIONAL";2021-09-06;2021;36;"ARS Alentejo";"All";2607;15196;5;17808;355789;362309;34;718132;27610;379120;406730;0,758932342438812;0,0588947999368603;0,808699621588645;0,867594421525505
"37";"REGIONAL";2021-09-13;2021;37;"ARS Alentejo";"All";1823;15815;4;17642;357612;378124;38;735774;13404;395178;408582;0,762820977726204;0,028592028191006;0,842952888426244;0,87154491661725
"38";"REGIONAL";2021-09-20;2021;38;"ARS Alentejo";"All";1600;3608;6;5214;359212;381732;44;740988;11143;399055;410198;0,766233932449094;0,0237690965482229;0,851222904339145;0,874992000887368
"39";"REGIONAL";2021-09-27;2021;39;"ARS Alentejo";"All";1115;2401;5;3521;360327;384133;49;744509;9567;401821;411388;0,768612335271607;0,0204073361461769;0,85712304981634;0,877530385962517
"40";"REGIONAL";2021-01-04;2021;1;"ARS Algarve";"All";1264;3;0;1267;2334;3;0;2337;2330;4;2334;0,00499256676541995;0,00498401052417673;8,55624124322185e-06;0,00499256676541995
"41";"REGIONAL";2021-01-11;2021;2;"ARS Algarve";"All";1368;5;0;1373;3702;8;0;3710;3691;11;3702;0,00791880127060183;0,00789527160718296;2,35296634188601e-05;0,00791880127060183
"42";"REGIONAL";2021-01-18;2021;3;"ARS Algarve";"All";3413;947;0;4360;7115;955;0;8070;6157;958;7115;0,0152194141113809;0,0131701943336292;0,00204921977775163;0,0152194141113809
"43";"REGIONAL";2021-01-25;2021;4;"ARS Algarve";"All";2161;1235;0;3396;9276;2190;0;11466;7083;2193;9276;0,0198419234430315;0,0151509641814351;0,00469095926159638;0,0198419234430315
"44";"REGIONAL";2021-02-01;2021;5;"ARS Algarve";"All";1233;1249;0;2482;10509;3439;0;13948;7068;3442;10510;0,0224793848062546;0,015118878276773;0,0073626455897924;0,0224815238665654
"45";"REGIONAL";2021-02-08;2021;6;"ARS Algarve";"All";2417;2901;0;5318;12926;6340;0;19266;6582;6345;12927;0,0276494935774714;0,0140792949657216;0,0135723376720607;0,0276516326377822
"46";"REGIONAL";2021-02-15;2021;7;"ARS Algarve";"All";3218;2120;0;5338;16144;8460;0;24604;7677;8468;16145;0,0345329896576434;0,0164215660060535;0,0181135627119007;0,0345351287179542
"47";"REGIONAL";2021-02-22;2021;8;"ARS Algarve";"All";8529;1070;1;9600;24673;9530;1;34204;15127;9547;24674;0,0527770350485032;0,0323575653215542;0,0204216087872598;0,052779174108814
"48";"REGIONAL";2021-03-01;2021;9;"ARS Algarve";"All";4675;566;0;5241;29348;10096;1;39445;19230;10120;29350;0,0627771420015187;0,0411341297767891;0,0216472903453513;0,0627814201221403
"49";"REGIONAL";2021-03-08;2021;10;"ARS Algarve";"All";5150;1557;0;6707;34498;11653;1;46152;22824;11677;34501;0,0737933026021669;0,0488219125338239;0,0249778072492754;0,0737997197830993
"50";"REGIONAL";2021-03-15;2021;11;"ARS Algarve";"All";2735;3022;0;5757;37233;14675;1;51909;22537;14699;37236;0,0796436325522198;0,0482080022246227;0,0314420475085295;0,0796500497331522
"51";"REGIONAL";2021-03-22;2021;12;"ARS Algarve";"All";9463;4325;0;13788;46696;19000;1;65697;27670;19029;46699;0,0998855602733719;0,0591877987999872;0,0407041786543172;0,0998919774543043
"52";"REGIONAL";2021-03-29;2021;13;"ARS Algarve";"All";4245;2942;0;7187;50941;21942;1;72884;28974;21971;50945;0,108965871292741;0,0619771334452775;0,0469972940887068;0,108974427533984
"53";"REGIONAL";2021-04-05;2021;14;"ARS Algarve";"All";8686;1824;0;10510;59627;23766;1;83394;35840;23797;59637;0,127545749152397;0,0766639215392678;0,0509032182162376;0,127567139755505
"54";"REGIONAL";2021-04-12;2021;15;"ARS Algarve";"All";13690;2189;0;15879;73317;25955;1;99273;47342;25986;73328;0,156829484807324;0,101267393234152;0,0555856212365908;0,156853014470743
"55";"REGIONAL";2021-04-19;2021;16;"ARS Algarve";"All";7283;5539;0;12822;80600;31494;1;112095;49083;31529;80612;0,17240826105092;0,104991497235265;0,0674424325393854;0,17243392977465
"56";"REGIONAL";2021-04-26;2021;17;"ARS Algarve";"All";16409;3283;0;19692;97009;34777;1;131787;62197;34829;97026;0,207508101690927;0,133043134151167;0,0745013315650435;0,207544465716211
"57";"REGIONAL";2021-05-03;2021;18;"ARS Algarve";"All";16586;8981;2;25569;113595;43758;3;157356;70342;43823;114165;0,242986556005947;0,150465780382678;0,0937400400004278;0,244205820383106
"58";"REGIONAL";2021-05-10;2021;19;"ARS Algarve";"All";9752;11352;0;21104;123347;55110;3;178460;70701;55183;125884;0,263846672156921;0,151233703034257;0,118039765131178;0,269273468165435
"59";"REGIONAL";2021-05-17;2021;20;"ARS Algarve";"All";12053;10927;2;22982;135400;66037;5;201442;74303;66164;140467;0,28962876608306;0,158938598273778;0,141528786404133;0,300467384677911
"60";"REGIONAL";2021-05-24;2021;21;"ARS Algarve";"All";7650;18833;0;26483;143050;84870;5;227925;68812;85094;153906;0,305992577460722;0,147193018107146;0,18202119808768;0,329214216194826
"61";"REGIONAL";2021-05-31;2021;22;"ARS Algarve";"All";8201;12777;2;20980;151251;97647;7;248905;72638;97966;170604;0,323535011069637;0,155377062856287;0,209555182408368;0,364932245264655
"62";"REGIONAL";2021-06-07;2021;23;"ARS Algarve";"All";17087;6370;0;23457;168338;104017;7;272362;84399;104647;189046;0,36008513460037;0,18053455117167;0,223846244344859;0,40438079551653
"63";"REGIONAL";2021-06-14;2021;24;"ARS Algarve";"All";15387;13472;0;28859;183725;117489;7;301221;86324;118337;204661;0,392998855602734;0,184652242269971;0,253129979999786;0,437782222269757
"64";"REGIONAL";2021-06-21;2021;25;"ARS Algarve";"All";19389;10264;2;29655;203114;127753;9;330876;96351;129077;225428;0,434473095968941;0,206100600006417;0,276103487737837;0,482204087744254
"65";"REGIONAL";2021-06-28;2021;26;"ARS Algarve";"All";17222;16507;7;33736;220336;144260;16;364612;99125;145990;245115;0,471311992641633;0,212034353308592;0,31228141477449;0,524315768083081
"66";"REGIONAL";2021-07-05;2021;27;"ARS Algarve";"All";19212;31812;1;51025;239548;176072;17;415637;87135;178445;265580;0,512407619332827;0,186387020182034;0,381704617161681;0,568091637343715
"67";"REGIONAL";2021-07-12;2021;28;"ARS Algarve";"All";9837;27040;4;36881;249385;203112;21;452518;75916;206003;281919;0,53344955561022;0,162388902555108;0,440652841206858;0,603041743761965
"68";"REGIONAL";2021-07-19;2021;29;"ARS Algarve";"All";4358;27269;1;31628;253743;230381;22;484146;58145;233907;292052;0,542771580444711;0,124375661771784;0,500341180119574;0,624716841891357
"69";"REGIONAL";2021-07-26;2021;30;"ARS Algarve";"All";4005;24780;3;28788;257748;255161;25;512934;41391;259316;300707;0,551338516989487;0,0885378453245489;0,554692563556829;0,643230408881378
"70";"REGIONAL";2021-08-02;2021;31;"ARS Algarve";"All";3950;22672;1;26623;261698;277833;26;539557;26003;282648;308651;0,559787805217168;0,0556219852618745;0,604601118728542;0,660223103990417
"71";"REGIONAL";2021-08-09;2021;32;"ARS Algarve";"All";11476;14046;3;25525;273174;291879;29;565082;28143;297623;325766;0,584335661343972;0,0601995743269981;0,636633546882854;0,696833121209853
"72";"REGIONAL";2021-08-16;2021;33;"ARS Algarve";"All";16665;7794;3;24462;289839;299673;32;589544;39365;306589;345954;0,619983101423545;0,0842041091348571;0,655812361629536;0,740016470764393
"73";"REGIONAL";2021-08-23;2021;34;"ARS Algarve";"All";13583;5315;0;18898;303422;304988;32;608442;48133;313040;361173;0,649037957625215;0,102959389939999;0,669611439694542;0,772570829634542
"74";"REGIONAL";2021-08-30;2021;35;"ARS Algarve";"All";6495;12163;4;18662;309917;317151;36;627104;42527;326325;368852;0,662931154343897;0,0909678178376239;0,698028855923593;0,788996673761217
"75";"REGIONAL";2021-09-06;2021;36;"ARS Algarve";"All";3299;15742;1;19042;313216;332893;37;646146;30288;342512;372800;0,669987914309244;0,0647878586936759;0,732653825174601;0,797441683868277
"76";"REGIONAL";2021-09-13;2021;37;"ARS Algarve";"All";2258;12071;4;14333;315474;344964;41;660479;21210;354883;376093;0,674817912491043;0,0453694691921839;0,759116140279575;0,804485609471759
"77";"REGIONAL";2021-09-20;2021;38;"ARS Algarve";"All";1856;6655;7;8518;317330;351619;48;668997;16938;361791;378729;0,678788008427898;0,0362314035444229;0,773892768906619;0,810124172451042
"78";"REGIONAL";2021-09-27;2021;39;"ARS Algarve";"All";1150;3884;5;5039;318480;355503;53;674036;14385;365948;380333;0,681247927785324;0,0307703825709366;0,782784842618638;0,813555225189574
"79";"REGIONAL";2021-01-04;2021;1;"ARS Centro";"All";9094;18;0;9112;15772;20;0;15792;15753;21;15774;0,00950177721549491;0,00949033074281583;1,26513645400325e-05;0,00950298210735587
"80";"REGIONAL";2021-01-11;2021;2;"ARS Centro";"All";12712;26;1;12739;28484;46;1;28531;28428;58;28486;0,0171600698837279;0,0171263329116212;3,49418639677089e-05;0,0171612747755889
"81";"REGIONAL";2021-01-18;2021;3;"ARS Centro";"All";36821;6326;2;43149;65305;6372;3;71680;58895;6412;65307;0,0393427314898488;0,0354810530754865;0,00386288330622327;0,0393439363817097
"82";"REGIONAL";2021-01-25;2021;4;"ARS Centro";"All";4905;8554;3;13462;70210;14926;6;85142;55242;14970;70212;0,0422977287788421;0,0332803180914513;0,00901861557925176;0,0422989336707031
"83";"REGIONAL";2021-02-01;2021;5;"ARS Centro";"All";2739;9174;0;11913;72949;24100;6;97055;48804;24148;72952;0,0439478281824206;0,0294017711910356;0,0145478643291765;0,0439496355202121
"84";"REGIONAL";2021-02-08;2021;6;"ARS Centro";"All";7573;27156;5;34734;80522;51256;11;131789;29194;51331;80525;0,0485101512139285;0,0175878064943671;0,0309241520573529;0,04851195855172
"85";"REGIONAL";2021-02-15;2021;7;"ARS Centro";"All";25571;10025;3;35599;106093;61281;14;167388;44644;61452;106096;0,0639152961021748;0,0268955961202482;0,0370215073197181;0,0639171034399663
"86";"REGIONAL";2021-02-22;2021;8;"ARS Centro";"All";38447;3166;1;41614;144540;64447;15;209002;79886;64657;144543;0,0870775347912525;0,0481269956021447;0,0389523465268992;0,0870793421290439
"87";"REGIONAL";2021-03-01;2021;9;"ARS Centro";"All";28582;5964;1;34547;173122;70411;16;243549;102484;70652;173136;0,104296644376167;0,0617410687390807;0,0425640098801133;0,104305078619194
"88";"REGIONAL";2021-03-08;2021;10;"ARS Centro";"All";17770;13594;0;31364;190892;84005;16;274913;106637;84284;190921;0,115002108560757;0,0642430266883547;0,0507765528043858;0,115019579492741
"89";"REGIONAL";2021-03-15;2021;11;"ARS Centro";"All";16752;24295;2;41049;207644;108300;18;315962;99095;108591;207686;0,12509428278812;0,0596993794806916;0,0654202060365082;0,1251195855172
"90";"REGIONAL";2021-03-22;2021;12;"ARS Centro";"All";47940;4447;1;52388;255584;112747;19;368350;142483;113151;255634;0,153975540695223;0,0858383035122598;0,0681673594794867;0,154005662991746
"91";"REGIONAL";2021-03-29;2021;13;"ARS Centro";"All";24452;16893;2;41347;280036;129640;21;409697;150029;130075;280104;0,168706548587264;0,0903843605036448;0,078363154406892;0,168747514910537
"92";"REGIONAL";2021-04-05;2021;14;"ARS Centro";"All";49942;10327;1;60270;329978;139967;22;469967;189578;140486;330064;0,198793903247184;0,114210494608109;0,0846352189890957;0,198845713597205
"93";"REGIONAL";2021-04-12;2021;15;"ARS Centro";"All";77702;12113;2;89817;407680;152080;24;559784;254986;152787;407773;0,245605156937165;0,153615278028797;0,0920459063799024;0,245661184408699
"94";"REGIONAL";2021-04-19;2021;16;"ARS Centro";"All";30094;24291;8;54393;437774;176371;32;614177;260642;177228;437870;0,263735164768962;0,157022712211579;0,106770287366709;0,263792999578288
"95";"REGIONAL";2021-04-26;2021;17;"ARS Centro";"All";56681;18000;0;74681;494455;194371;32;688858;300420;195408;495828;0,297882402554371;0,180986806434123;0,117722754382794;0,298709560816917
"96";"REGIONAL";2021-05-03;2021;18;"ARS Centro";"All";60034;49258;1;109293;554489;243629;33;798151;316806;244902;561708;0,334049641544671;0,190858485450931;0,147540213265859;0,33839869871679
"97";"REGIONAL";2021-05-10;2021;19;"ARS Centro";"All";50733;55853;1;106587;605222;299482;34;904738;317536;300942;618478;0,364613530935599;0,19129827098018;0,181301283209832;0,372599554190011
"98";"REGIONAL";2021-05-17;2021;20;"ARS Centro";"All";44955;41819;3;86777;650177;341301;37;991515;327648;343560;671208;0,391696487740225;0,19739020422917;0,206976323874932;0,404366528104103
"99";"REGIONAL";2021-05-24;2021;21;"ARS Centro";"All";24278;56391;6;80675;674455;397692;43;1072190;302863;400965;703828;0,406322670040364;0,18245858184228;0,241559732514007;0,424018314356287
"100";"REGIONAL";2021-05-31;2021;22;"ARS Centro";"All";44369;37874;0;82243;718824;435566;43;1154433;308794;441766;750560;0,433052593529731;0,186031688655943;0,266140128923429;0,452171817579372
"101";"REGIONAL";2021-06-07;2021;23;"ARS Centro";"All";58459;40982;1;99442;777283;476548;44;1253875;325493;485297;810790;0,468270980179529;0,196091933248991;0,292365202723056;0,488457135972046
"102";"REGIONAL";2021-06-14;2021;24;"ARS Centro";"All";52063;65906;8;117977;829346;542454;52;1371852;315096;553661;868757;0,499636122657991;0,189828302909814;0,333550816314236;0,52337911922405
"103";"REGIONAL";2021-06-21;2021;25;"ARS Centro";"All";59628;47837;3;107468;888974;590291;55;1479320;329676;605038;934714;0,535558768600518;0,198611964576179;0,364502680884391;0,56311464546057
"104";"REGIONAL";2021-06-28;2021;26;"ARS Centro";"All";49984;77288;2;127274;938958;667579;57;1606594;301234;685703;986937;0,565671425989517;0,181477197421531;0,413098981866378;0,594576179287909
"105";"REGIONAL";2021-07-05;2021;27;"ARS Centro";"All";59543;105102;9;164654;998501;772681;66;1771248;259289;795236;1054525;0,601542864027954;0,156207602867643;0,479086691969396;0,635294294837038
"106";"REGIONAL";2021-07-12;2021;28;"ARS Centro";"All";28610;82282;6;110898;1027111;854963;72;1882146;215720;881816;1097536;0,618778842098922;0,129959636122658;0,531246460630158;0,661206096752816
"107";"REGIONAL";2021-07-19;2021;29;"ARS Centro";"All";16923;80839;15;97777;1044034;935802;87;1979923;162877;967147;1130024;0,628974034580396;0,0981245858184228;0,582653774323754;0,680778360142177
"108";"REGIONAL";2021-07-26;2021;30;"ARS Centro";"All";14424;69097;4;83525;1058458;1004899;91;2063448;116082;1041440;1157522;0,637663714681607;0,069933128501717;0,627411289836737;0,697344418338454
"109";"REGIONAL";2021-08-02;2021;31;"ARS Centro";"All";19278;75253;5;94536;1077736;1080152;96;2157984;74386;1121531;1195917;0,649277667329357;0,0448135429845171;0,67566178685463;0,720475329839147
"110";"REGIONAL";2021-08-09;2021;32;"ARS Centro";"All";50567;47011;6;97584;1128303;1127163;102;2255568;92677;1177249;1269926;0,679741550695825;0,0558328814988855;0,709228869208989;0,765061750707874
"111";"REGIONAL";2021-08-16;2021;33;"ARS Centro";"All";61372;36071;7;97450;1189675;1163234;109;2353018;131116;1221066;1352182;0,716714862341105;0,0789903006205193;0,735626242544732;0,814616543165251
"112";"REGIONAL";2021-08-23;2021;34;"ARS Centro";"All";51143;18448;3;69594;1240818;1181682;112;2422612;163455;1245608;1409063;0,747525754563528;0,0984727995662389;0,750411470570516;0,848884270136755
"113";"REGIONAL";2021-08-30;2021;35;"ARS Centro";"All";20717;48280;2;68999;1261535;1229962;114;2491611;132959;1298404;1431363;0,760006626905235;0,0801006084703898;0,782218205916019;0,862318814386409
"114";"REGIONAL";2021-09-06;2021;36;"ARS Centro";"All";7779;50997;9;58785;1269314;1280959;123;2550396;88781;1350839;1439620;0,764693053798422;0,0534857521537442;0,813807458280619;0,867293210434363
"115";"REGIONAL";2021-09-13;2021;37;"ARS Centro";"All";5862;42605;8;48475;1275176;1323564;131;2598871;51190;1394509;1445699;0,768224591842882;0,0308392071811555;0,840116272064582;0,870955479245738
"116";"REGIONAL";2021-09-20;2021;38;"ARS Centro";"All";4032;18673;8;22713;1279208;1342237;139;2621584;35943;1413865;1449808;0,770653653834568;0,0216537140791614;0,851777215494909;0,873430929574071
"117";"REGIONAL";2021-09-27;2021;39;"ARS Centro";"All";2871;9780;8;12659;1282079;1352017;147;2634243;28491;1424328;1452819;0,77238327610097;0,0171642870052413;0,858080607265498;0,875244894270739
"118";"REGIONAL";2021-01-04;2021;1;"ARS Lisboa e Vale do Tejo";"All";12786;26;0;12812;23565;31;0;23596;23536;31;23567;0,00640078270721193;0,00639290565656439;8,42029551977805e-06;0,00640132595208417
"119";"REGIONAL";2021-01-11;2021;2;"ARS Lisboa e Vale do Tejo";"All";13297;1117;0;14414;36862;1148;0;38010;35703;1161;36864;0,0100125462403245;0,00969773583685922;0,000315353648337494;0,0100130894851967
"120";"REGIONAL";2021-01-18;2021;3;"ARS Lisboa e Vale do Tejo";"All";37918;9065;0;46983;74780;10213;0;84993;64434;10349;74783;0,0203119257731936;0,0175017200490767;0,00281102059142526;0,020312740640502
"121";"REGIONAL";2021-01-25;2021;4;"ARS Lisboa e Vale do Tejo";"All";17359;11909;1;29269;92139;22122;1;114262;69819;22324;92143;0,0250270196418332;0,018964406867593;0,00606369926398468;0,0250281061315777
"122";"REGIONAL";2021-02-01;2021;5;"ARS Lisboa e Vale do Tejo";"All";8782;8942;0;17724;100921;31064;1;131986;69644;31284;100928;0,0274124078758555;0,0189168729412717;0,00849743629163666;0,0274143092329084
"123";"REGIONAL";2021-02-08;2021;6;"ARS Lisboa e Vale do Tejo";"All";14454;30460;0;44914;115375;61524;1;176900;53445;61938;115383;0,0313384385675611;0,0145168610985335;0,0168237504485165;0,03134061154705
"124";"REGIONAL";2021-02-15;2021;7;"ARS Lisboa e Vale do Tejo";"All";33068;19096;0;52164;148443;80620;1;229064;67266;81185;148451;0,0403204492852391;0,0182709547881739;0,0220516674765542;0,0403226222647281
"125";"REGIONAL";2021-02-22;2021;8;"ARS Lisboa e Vale do Tejo";"All";49471;6692;0;56163;197914;87312;1;285227;109731;88191;197922;0,0537578828226243;0,0298054015380892;0,0239546542640241;0,0537600558021133
"126";"REGIONAL";2021-03-01;2021;9;"ARS Lisboa e Vale do Tejo";"All";45299;12867;0;58166;243213;100179;1;343393;141946;101284;243230;0,066062107556509;0,0385557183177553;0,0275110068201677;0,0660667251379231
"127";"REGIONAL";2021-03-08;2021;10;"ARS Lisboa e Vale do Tejo";"All";34043;16631;1;50675;277256;116810;2;394068;159271;118015;277286;0,0753089501494059;0,0432615770235668;0,0320555217989228;0,0753170988224896
"128";"REGIONAL";2021-03-15;2021;11;"ARS Lisboa e Vale do Tejo";"All";26374;29090;1;55465;303630;145900;3;449533;156495;147176;303671;0,0824727202796842;0,0425075531408925;0,0399763036586727;0,0824838567995652
"129";"REGIONAL";2021-03-22;2021;12;"ARS Lisboa e Vale do Tejo";"All";89617;7743;0;97360;393247;153643;3;546893;238109;155190;393299;0,106814708137618;0,064675746642543;0,0421530858617534;0,106828832504296
"130";"REGIONAL";2021-03-29;2021;13;"ARS Lisboa e Vale do Tejo";"All";45785;24037;0;69822;439032;177680;3;616715;259791;179309;439100;0,119250941375458;0,0705650643025374;0,0487043473985769;0,119269411701114
"131";"REGIONAL";2021-04-05;2021;14;"ARS Lisboa e Vale do Tejo";"All";87628;19808;1;107437;526660;197488;4;724152;327482;199304;526786;0,143052672207945;0,0889514586260631;0,0541354380088337;0,143086896634897
"132";"REGIONAL";2021-04-12;2021;15;"ARS Lisboa e Vale do Tejo";"All";163845;14479;1;178325;690505;211967;5;902477;476724;213924;690648;0,187556650254334;0,129488934237764;0,0581065580249355;0,187595492262699
"133";"REGIONAL";2021-04-19;2021;16;"ARS Lisboa e Vale do Tejo";"All";79451;53903;1;133355;769956;265870;6;1035832;502018;268084;770102;0,209137324426653;0,13635935213703;0,0728176291652961;0,209176981302326
"134";"REGIONAL";2021-04-26;2021;17;"ARS Lisboa e Vale do Tejo";"All";107897;25733;2;133632;877853;291603;8;1169464;584071;293960;878031;0,238444570416894;0,158646787888138;0,0798461313223857;0,238492919210524
"135";"REGIONAL";2021-05-03;2021;18;"ARS Lisboa e Vale do Tejo";"All";108061;65764;3;173828;985914;357367;11;1343292;628921;359884;988805;0,26779636248666;0,170829054148204;0,097752568801284;0,268581622949488
"136";"REGIONAL";2021-05-10;2021;19;"ARS Lisboa e Vale do Tejo";"All";90693;113441;3;204137;1076607;470808;14;1547429;608468;473623;1082091;0,292430616085861;0,165273560462204;0,12864663306335;0,293920193525553
"137";"REGIONAL";2021-05-17;2021;20;"ARS Lisboa e Vale do Tejo";"All";110250;71430;2;181682;1186857;542238;16;1729111;648926;546056;1194982;0,322376989668297;0,176262860982822;0,148321060978965;0,324583921961788
"138";"REGIONAL";2021-05-24;2021;21;"ARS Lisboa e Vale do Tejo";"All";110964;89176;2;200142;1297821;631414;18;1929253;675784;643255;1319039;0,352517301670125;0,183558096372184;0,174722490147575;0,358280586519759
"139";"REGIONAL";2021-05-31;2021;22;"ARS Lisboa e Vale do Tejo";"All";92491;87210;7;179708;1390312;718624;25;2108961;696938;735376;1432314;0,377639932409473;0,189303997385906;0,199744620585558;0,389048617971464
"140";"REGIONAL";2021-06-07;2021;23;"ARS Lisboa e Vale do Tejo";"All";152458;54280;3;206741;1542770;772904;28;2315702;803119;796236;1599355;0,419050945775741;0,218145139275762;0,216275562047935;0,434420701323698
"141";"REGIONAL";2021-06-14;2021;24;"ARS Lisboa e Vale do Tejo";"All";147982;121665;4;269651;1690752;894569;32;2585353;831944;924577;1756521;0,459246177117928;0,225974655996975;0,251135857122253;0,477110513119228
"142";"REGIONAL";2021-06-21;2021;25;"ARS Lisboa e Vale do Tejo";"All";120374;154064;12;274450;1811126;1048633;44;2859803;805115;1086406;1891521;0,491942456243663;0,218687297658262;0,295092244337419;0,513779541995681
"143";"REGIONAL";2021-06-28;2021;26;"ARS Lisboa e Vale do Tejo";"All";130636;167003;8;297647;1941762;1215636;52;3157450;770204;1263073;2033277;0,52742612480888;0,209204686790811;0,343078965259762;0,552283652050573
"144";"REGIONAL";2021-07-05;2021;27;"ARS Lisboa e Vale do Tejo";"All";143989;274088;8;418085;2085751;1489724;60;3575535;640579;1548366;2188945;0,566536767763632;0,173995628508513;0,420570944928279;0,594566573436793
"145";"REGIONAL";2021-07-12;2021;28;"ARS Lisboa e Vale do Tejo";"All";80074;216131;16;296221;2165825;1705855;76;3871756;533140;1774444;2307584;0,588286662713655;0,144812785594015;0,48197880204184;0,626791587635855
"146";"REGIONAL";2021-07-19;2021;29;"ARS Lisboa e Vale do Tejo";"All";57151;185885;8;243044;2222976;1891740;84;4114800;444321;1971541;2415862;0,603810156560456;0,120687552440107;0,535514769334153;0,65620232177426
"147";"REGIONAL";2021-07-26;2021;30;"ARS Lisboa e Vale do Tejo";"All";36533;180645;11;217189;2259509;2072385;95;4331989;326252;2164104;2490356;0,613733339019296;0,0886173630296332;0,587819200501089;0,676436563530722
"148";"REGIONAL";2021-08-02;2021;31;"ARS Lisboa e Vale do Tejo";"All";45589;178517;9;224115;2305098;2250902;104;4556104;222029;2357283;2579312;0,626116334259656;0,0603080578697033;0,640290951088676;0,70059900895838
"149";"REGIONAL";2021-08-09;2021;32;"ARS Lisboa e Vale do Tejo";"All";107484;111231;4;218719;2412582;2362133;108;4774823;240224;2489799;2730023;0,65531140018378;0,0652502280949407;0,676285269833802;0,741535497928743
"150";"REGIONAL";2021-08-16;2021;33;"ARS Lisboa e Vale do Tejo";"All";107538;91093;8;198639;2520120;2453226;116;4973462;280827;2596931;2877758;0,684521133719454;0,0762789138687971;0,705384724660411;0,781663638529208
"151";"REGIONAL";2021-08-23;2021;34;"ARS Lisboa e Vale do Tejo";"All";89227;60909;6;150142;2609347;2514135;122;5123604;321462;2672507;2993969;0,7087571888273;0,0873162915606094;0,725912861892757;0,813229153453367
"152";"REGIONAL";2021-08-30;2021;35;"ARS Lisboa e Vale do Tejo";"All";48826;100807;15;149648;2658173;2614942;137;5273252;264434;2786754;3051188;0,722019425893387;0,0718262072734513;0,756944910352373;0,828771117625824
"153";"REGIONAL";2021-09-06;2021;36;"ARS Lisboa e Vale do Tejo";"All";27458;91700;55;119213;2685631;2706642;192;5392465;195285;2883777;3079062;0,729477634744421;0,0530437874380599;0,783298533972225;0,836342321410285
"154";"REGIONAL";2021-09-13;2021;37;"ARS Lisboa e Vale do Tejo";"All";19738;81674;86;101498;2705369;2788316;278;5493963;129680;2969332;3099012;0,734838918388594;0,0352239975162844;0,806537191494632;0,841761189010917
"155";"REGIONAL";2021-09-20;2021;38;"ARS Lisboa e Vale do Tejo";"All";15090;31696;112;46898;2720459;2820012;390;5540861;108587;3005661;3114248;0,738937700949673;0,0294946654711658;0,816404962976504;0,84589962844767
"156";"REGIONAL";2021-09-27;2021;39;"ARS Lisboa e Vale do Tejo";"All";9195;20361;64;29620;2729654;2840373;454;5570481;94184;3029638;3123822;0,741435269249814;0,0255824875237025;0,822917654127398;0,8485001416511
"157";"REGIONAL";2021-01-04;2021;1;"ARS Norte";"All";16798;39;0;16837;30240;46;0;30286;30197;50;30247;0,00844127549235889;0,00842927235591142;1,39571354040326e-05;0,00844322949131545
"158";"REGIONAL";2021-01-11;2021;2;"ARS Norte";"All";15509;41;0;15550;45749;87;0;45836;45640;116;45756;0,0127704997519817;0,0127400731968009;3,23805541373555e-05;0,0127724537509383
"159";"REGIONAL";2021-01-18;2021;3;"ARS Norte";"All";32600;12757;1;45358;78349;12844;1;91194;65444;12912;78356;0,0218705520354109;0,0182682153876301;0,00360429064673737;0,0218725060343675
"160";"REGIONAL";2021-01-25;2021;4;"ARS Norte";"All";14464;15763;1;30228;92813;28607;2;121422;64135;28686;92821;0,0259080721650895;0,0179028175827526;0,00800748772400156;0,0259103053067541
"161";"REGIONAL";2021-02-01;2021;5;"ARS Norte";"All";5753;12311;1;18065;98566;40918;3;139487;57577;41001;98578;0,0275139801646774;0,0160721997031596;0,0114451301740148;0,0275173298771744
"162";"REGIONAL";2021-02-08;2021;6;"ARS Norte";"All";9005;28999;5;38009;107571;69917;8;177496;37513;70070;107583;0,0300276602509437;0,0104714804082295;0,0195595295552112;0,0300310099634407
"163";"REGIONAL";2021-02-15;2021;7;"ARS Norte";"All";33148;15247;4;48399;140719;85164;12;225895;55071;85660;140731;0,0392806827384011;0,0153726680767095;0,0239113643741886;0,0392840324508981
"164";"REGIONAL";2021-02-22;2021;8;"ARS Norte";"All";64952;4397;0;69349;205671;89561;12;295244;115353;90330;205683;0,0574115599136556;0,0321999488052273;0,0252149608209252;0,0574149096261525
"165";"REGIONAL";2021-03-01;2021;9;"ARS Norte";"All";48209;7169;2;55380;253880;96730;14;350624;156298;97603;253901;0,0708687507275157;0,0436294469875896;0,0272451657367958;0,0708746127243854
"166";"REGIONAL";2021-03-08;2021;10;"ARS Norte";"All";25918;14274;0;40192;279798;111004;14;390816;167838;111999;279837;0,07810357143555;0,0468507538388403;0,0312637041623248;0,0781144580011651
"167";"REGIONAL";2021-03-15;2021;11;"ARS Norte";"All";27114;42513;3;69630;306912;153517;17;460446;152416;154547;306963;0,0856722468224488;0,0425458149948205;0,0431406681057404;0,0856864831005609
"168";"REGIONAL";2021-03-22;2021;12;"ARS Norte";"All";89291;2547;0;91838;396203;156064;17;552284;239063;157197;396260;0,110597178369678;0,0667326932218847;0,0438803962821541;0,110613089504039
"169";"REGIONAL";2021-03-29;2021;13;"ARS Norte";"All";54333;32895;1;87229;450536;188959;18;639513;260442;190180;450622;0,125763839127824;0,0727004851779409;0,0530873602227782;0,125787845400719
"170";"REGIONAL";2021-04-05;2021;14;"ARS Norte";"All";82659;13871;5;96535;533195;202830;23;736048;329204;204127;533331;0,148837496235063;0,0918948960709826;0,0569805635723791;0,148875459643362
"171";"REGIONAL";2021-04-12;2021;15;"ARS Norte";"All";136218;19339;2;155559;669413;222169;25;891607;445978;223580;669558;0,186861757644393;0,124491506664393;0,062410726672672;0,186902233337065
"172";"REGIONAL";2021-04-19;2021;16;"ARS Norte";"All";65490;46640;2;112132;734903;268809;27;1003739;464415;270635;735050;0,205142813596595;0,129638060773276;0,075545786801407;0,205183847574683
"173";"REGIONAL";2021-04-26;2021;17;"ARS Norte";"All";127114;36918;2;164034;862017;305727;29;1167773;554435;307758;862193;0,240625759791559;0,154766487354696;0,085908401553485;0,240674888908181
"174";"REGIONAL";2021-05-03;2021;18;"ARS Norte";"All";156009;73589;3;229601;1018026;379316;32;1397374;636572;381850;1018422;0,284174534536513;0,177694431968316;0,106590643080597;0,284285075048913
"175";"REGIONAL";2021-05-10;2021;19;"ARS Norte";"All";100283;101385;7;201675;1118309;480701;39;1599049;641120;484357;1125477;0,312167802730965;0,178963973004667;0,13520472465782;0,314168697662487
"176";"REGIONAL";2021-05-17;2021;20;"ARS Norte";"All";111301;71478;4;182783;1229610;552179;43;1781832;679487;564953;1244440;0,343236665283049;0,189673841285597;0,157702510358288;0,347376351643885
"177";"REGIONAL";2021-05-24;2021;21;"ARS Norte";"All";73443;129582;9;203034;1303053;681761;52;1984866;630441;707633;1338074;0,363737743192617;0,175983008025074;0,197530591947235;0,373513599972309
"178";"REGIONAL";2021-05-31;2021;22;"ARS Norte";"All";55427;173059;9;228495;1358480;854820;61;2213361;530866;886947;1417813;0,379209786073403;0,148187372867943;0,247584787504009;0,395772160371952
"179";"REGIONAL";2021-06-07;2021;23;"ARS Norte";"All";107394;107059;9;214462;1465874;961879;70;2427823;528818;1004142;1532960;0,409188038065016;0,147615688601794;0,280298917177521;0,427914605779315
"180";"REGIONAL";2021-06-14;2021;24;"ARS Norte";"All";105615;153105;14;258734;1571489;1114984;84;2686557;486961;1167327;1654288;0,438669695178954;0,135931612269662;0,325850819995662;0,461782432265324
"181";"REGIONAL";2021-06-21;2021;25;"ARS Norte";"All";146755;105835;6;252596;1718244;1220819;90;2939153;530947;1286693;1817640;0,47963528330333;0,148209983427297;0,359170968488417;0,507380951915715
"182";"REGIONAL";2021-06-28;2021;26;"ARS Norte";"All";164074;117915;9;281998;1882318;1338734;99;3221151;568026;1420193;1988219;0,525435343988955;0,15856031590022;0,396436520017184;0,554996835917404
"183";"REGIONAL";2021-07-05;2021;27;"ARS Norte";"All";176447;159214;12;335673;2058765;1497948;111;3556824;581160;1597896;2179056;0,574689237401662;0,162226576228151;0,44604101667124;0,608267592899391
"184";"REGIONAL";2021-07-12;2021;28;"ARS Norte";"All";105655;157650;21;263326;2164420;1655598;132;3820150;562090;1772201;2334291;0,604182060223923;0,156903324785053;0,494696986403238;0,651600311188291
"185";"REGIONAL";2021-07-19;2021;29;"ARS Norte";"All";51978;190237;12;242227;2216398;1845835;144;4062377;462393;1975759;2438152;0,618691339904539;0,129073634217536;0,551518717774719;0,680592351992255
"186";"REGIONAL";2021-07-26;2021;30;"ARS Norte";"All";35531;185989;17;221537;2251929;2031824;161;4283914;336169;2173267;2509436;0,628609559465352;0,0938391250327644;0,606651635762312;0,700490760795077
"187";"REGIONAL";2021-08-02;2021;31;"ARS Norte";"All";42067;190500;8;232575;2293996;2222324;169;4516489;214392;2375631;2590023;0,640352255766181;0,0598459634708269;0,663140070740345;0,722986034211172
"188";"REGIONAL";2021-08-09;2021;32;"ARS Norte";"All";119612;148594;6;268212;2413608;2370918;175;4784701;227169;2542058;2769227;0,673741073365124;0,0634125698519734;0,709596954218084;0,773009524070057
"189";"REGIONAL";2021-08-16;2021;33;"ARS Norte";"All";149053;81417;8;230478;2562661;2452335;183;5015179;313474;2643142;2956616;0,715348131432669;0,087503981272874;0,737813815721708;0,825317796994582
"190";"REGIONAL";2021-08-23;2021;34;"ARS Norte";"All";119391;34231;7;153629;2682052;2486566;190;5168808;386180;2693155;3079335;0,748675258493126;0,107799331006586;0,751774579980946;0,859573910987532
"191";"REGIONAL";2021-08-30;2021;35;"ARS Norte";"All";44974;111619;13;156606;2727026;2598185;203;5325414;310620;2815292;3125912;0,761229422646345;0,0867073079840118;0,785868232917792;0,872575540901804
"192";"REGIONAL";2021-09-06;2021;36;"ARS Norte";"All";22425;129273;19;151717;2749451;2727458;222;5477131;200052;2949410;3149462;0,767489197875054;0,0558430570369504;0,823306294640153;0,879149351677103
"193";"REGIONAL";2021-09-13;2021;37;"ARS Norte";"All";14954;97242;16;112212;2764405;2824700;238;5589343;116039;3049249;3165288;0,771663497931692;0,0323914407029707;0,851175623472217;0,883567064175188
"194";"REGIONAL";2021-09-20;2021;38;"ARS Norte";"All";10432;37150;7;47589;2774837;2861850;245;5636932;87740;3088408;3176148;0,774575514662389;0,0244919812069963;0,862106572777947;0,886598553984944
"195";"REGIONAL";2021-09-27;2021;39;"ARS Norte";"All";6666;18847;19;25532;2781503;2880697;264;5662464;73974;3109082;3183056;0,776436279954455;0,0206493026875581;0,867877569124807;0,888526871812365
"196";"REGIONAL";2021-01-04;2021;1;"RA Madeira";"All";1834;3;0;1837;2541;3;0;2544;2538;3;2541;0,0101210865928463;0,010109137258026;1,19493348203617e-05;0,0101210865928463
"197";"REGIONAL";2021-01-11;2021;2;"RA Madeira";"All";1801;3;0;1804;4342;6;0;4348;4334;8;4342;0,0172946705966701;0,0172628057038158;3,18648928542978e-05;0,0172946705966701
"198";"REGIONAL";2021-01-18;2021;3;"RA Madeira";"All";1169;599;1;1769;5511;605;1;6117;4904;607;5511;0,0219509280650044;0,0195331793196845;0,00241774874531984;0,0219509280650044
"199";"REGIONAL";2021-01-25;2021;4;"RA Madeira";"All";487;1727;3;2217;5998;2332;4;8334;3664;2334;5998;0,0238907034175098;0,0145941209272684;0,00929658249024138;0,0238907034175098
"200";"REGIONAL";2021-02-01;2021;5;"RA Madeira";"All";2260;1544;0;3804;8258;3876;4;12138;4380;3878;8258;0,0328925356488489;0,017446028837728;0,0154465068111208;0,0328925356488489
"201";"REGIONAL";2021-02-08;2021;6;"RA Madeira";"All";3183;1161;1;4345;11441;5037;5;16483;6402;5039;11441;0,0455707798932526;0,0254998805066518;0,0200708993866008;0,0455707798932526
"202";"REGIONAL";2021-02-15;2021;7;"RA Madeira";"All";2597;712;1;3310;14038;5749;6;19793;8286;5752;14038;0,055914920736079;0,0330040627738389;0,0229108579622401;0,055914920736079
"203";"REGIONAL";2021-02-22;2021;8;"RA Madeira";"All";2273;2164;1;4438;16311;7913;7;24231;8395;7916;16311;0,0649685334183064;0,0334382219389787;0,0315303114793277;0,0649685334183064
"204";"REGIONAL";2021-03-01;2021;9;"RA Madeira";"All";1462;3132;3;4597;17773;11045;10;28828;6725;11048;17773;0,0707918425874293;0,0267864255556441;0,0440054170317852;0,0707918425874293
"205";"REGIONAL";2021-03-08;2021;10;"RA Madeira";"All";5000;2393;0;7393;22773;13438;10;36221;9332;13441;22773;0,0907074006213654;0,0371703975145384;0,0535370031068271;0,0907074006213654
"206";"REGIONAL";2021-03-15;2021;11;"RA Madeira";"All";3139;2329;2;5470;25912;15767;12;41691;10141;15771;25912;0,10321038795507;0,0403927348044292;0,0628176531506413;0,10321038795507
"207";"REGIONAL";2021-03-22;2021;12;"RA Madeira";"All";5556;195;0;5751;31468;15962;12;47442;15503;15966;31469;0,12534055604238;0,0617501792400223;0,0635943599139648;0,125344539153987
"208";"REGIONAL";2021-03-29;2021;13;"RA Madeira";"All";1228;1265;1;2494;32696;17227;13;49936;15466;17232;32698;0,130231817095515;0,0616028041105712;0,0686369792081574;0,130239783318729
"209";"REGIONAL";2021-04-05;2021;14;"RA Madeira";"All";10224;1306;0;11530;42920;18533;13;61466;24382;18540;42922;0,170955150163308;0,0971162271966861;0,0738468891898351;0,170963116386521
"210";"REGIONAL";2021-04-12;2021;15;"RA Madeira";"All";8536;1315;0;9851;51456;19848;13;71317;31598;19861;51459;0,204954990838843;0,125858360551263;0,079108579622401;0,204966940173664
"211";"REGIONAL";2021-04-19;2021;16;"RA Madeira";"All";9841;2149;0;11990;61297;21997;13;83307;39222;22079;61301;0,244152792161236;0,156225603441408;0,0879431211662551;0,244168724607664
"212";"REGIONAL";2021-04-26;2021;17;"RA Madeira";"All";8828;832;1;9661;70125;22829;14;92968;47223;22924;70147;0,279315701425954;0,188094479407313;0,0913088504739903;0,279403329881303
"213";"REGIONAL";2021-05-03;2021;18;"RA Madeira";"All";7662;5354;0;13016;77787;28183;14;105984;49531;28299;77830;0,309834302557158;0,197287500995778;0,112718075360472;0,310005576356249
"214";"REGIONAL";2021-05-10;2021;19;"RA Madeira";"All";11610;6566;5;18181;89397;34749;19;124165;54565;34876;89441;0,356078228311957;0,217338484824345;0,138915000398311;0,356253485222656
"215";"REGIONAL";2021-05-17;2021;20;"RA Madeira";"All";2407;7722;7;10136;91804;42471;26;134301;49252;42604;91856;0,365665577949494;0,196176212857484;0,169696486895563;0,365872699753047
"216";"REGIONAL";2021-05-24;2021;21;"RA Madeira";"All";3520;8999;3;12522;95324;51470;29;146823;43765;51620;95385;0,379686130805385;0,174320879471043;0,205608221142356;0,379929100613399
"217";"REGIONAL";2021-05-31;2021;22;"RA Madeira";"All";7653;11034;5;18692;102977;62504;34;165515;40683;62695;103378;0,410168883932128;0,162044929498925;0,249721182187525;0,411766111686449
"218";"REGIONAL";2021-06-07;2021;23;"RA Madeira";"All";3724;15301;4;19029;106701;77805;38;184544;31167;78034;109201;0,425001991555803;0,124141639448737;0,310818131124034;0,434959770572771
"219";"REGIONAL";2021-06-14;2021;24;"RA Madeira";"All";3768;8377;5;12150;110469;86182;43;196694;29053;86448;115501;0,440010356090178;0,115721341511989;0,344332032183542;0,460053373695531
"220";"REGIONAL";2021-06-21;2021;25;"RA Madeira";"All";12644;3754;14;16412;123113;89936;57;213106;37936;90343;128279;0,490372819246395;0,15110332191508;0,359846251891978;0,510949573807058
"221";"REGIONAL";2021-06-28;2021;26;"RA Madeira";"All";10170;12376;21;22567;133283;102312;78;235673;35809;102833;138642;0,530881064287421;0,142631243527444;0,40959531586075;0,552226559388194
"222";"REGIONAL";2021-07-05;2021;27;"RA Madeira";"All";12798;7024;10;19832;146081;109336;88;255505;41644;110208;151852;0,581856926631084;0,165872699753047;0,438970763960806;0,604843463713853
"223";"REGIONAL";2021-07-12;2021;28;"RA Madeira";"All";10667;5927;9;16603;156748;115263;97;272108;47271;116728;163999;0,624344778140683;0,188285668764439;0,464940651637059;0,653226320401498
"224";"REGIONAL";2021-07-19;2021;29;"RA Madeira";"All";4281;14867;7;19155;161029;130130;104;291263;38964;131849;170813;0,64139647892934;0,155197960646857;0,525169282243288;0,680367242890146
"225";"REGIONAL";2021-07-26;2021;30;"RA Madeira";"All";5574;13910;5;19489;166603;144040;109;310752;33566;146174;179740;0,663598343025572;0,13369712419342;0,582227356010515;0,715924480203935
"226";"REGIONAL";2021-08-02;2021;31;"RA Madeira";"All";4566;14400;1;18967;171169;158440;110;329719;25511;160932;186443;0,681785230622162;0,101613160200749;0,641010117103481;0,74262327730423
"227";"REGIONAL";2021-08-09;2021;32;"RA Madeira";"All";5421;11067;4;16492;176590;169507;114;346211;21328;172252;193580;0,703377678642556;0,0849518043495579;0,686098940492313;0,77105074484187
"228";"REGIONAL";2021-08-16;2021;33;"RA Madeira";"All";3627;8174;4;11805;180217;177681;118;358016;17844;180634;198478;0,717824424440373;0,0710746435115112;0,719485381980403;0,790560025491914
"229";"REGIONAL";2021-08-23;2021;34;"RA Madeira";"All";2194;6295;2;8491;182411;183976;120;366507;14529;187105;201634;0,726563371305664;0,0578706285350115;0,745260097187923;0,803130725722935
"230";"REGIONAL";2021-08-30;2021;35;"RA Madeira";"All";1804;5871;2;7677;184215;189847;122;374184;11276;193204;204480;0,733748904644308;0,0449135664781327;0,769553094877719;0,814466661355851
"231";"REGIONAL";2021-09-06;2021;36;"RA Madeira";"All";1306;4795;2;6103;185521;194642;124;380287;8212;198219;206431;0,738950848402772;0,0327093125149367;0,789528399585756;0,822237712100693
"232";"REGIONAL";2021-09-13;2021;37;"RA Madeira";"All";844;2887;2;3733;186365;197529;126;384020;6352;201320;207672;0,742312594598901;0,0253007249263124;0,801880028678404;0,827180753604716
"233";"REGIONAL";2021-09-20;2021;38;"RA Madeira";"All";812;2132;1;2945;187177;199661;127;386965;5039;203707;208746;0,745546881223612;0,0200708993866008;0,811387716083805;0,831458615470405
"234";"REGIONAL";2021-09-27;2021;39;"RA Madeira";"All";787;1354;6;2147;187964;201015;133;389112;4347;205224;209571;0,748681590058153;0,0173145861547041;0,817430096391301;0,834744682546005
"235";"REGIONAL";2021-01-04;2021;1;"RA Acores";"All";3688;3;1;3692;5729;4;4;5737;5725;4;5729;0,0242080310322534;0,0241911289334353;1,69020988181207e-05;0,0242080310322534
"236";"REGIONAL";2021-01-11;2021;2;"RA Acores";"All";29;3;0;32;5758;7;4;5769;5751;7;5758;0,0243305712486848;0,0243009925757531;2,95786729317113e-05;0,0243305712486848
"237";"REGIONAL";2021-01-18;2021;3;"RA Acores";"All";88;1985;5;2078;5846;1992;9;7847;3854;1992;5846;0,0247024174226835;0,0162851722112593;0,00841724521142413;0,0247024174226835
"238";"REGIONAL";2021-01-25;2021;4;"RA Acores";"All";316;3617;9;3942;6162;5609;18;11789;553;5609;6162;0,026037683229315;0,00233671516160519;0,0237009680677098;0,026037683229315
"239";"REGIONAL";2021-02-01;2021;5;"RA Acores";"All";1886;36;1;1923;8048;5645;19;13712;2403;5645;8048;0,0340070228220589;0,010153935864986;0,0238530869570729;0,0340070228220589
"240";"REGIONAL";2021-02-08;2021;6;"RA Acores";"All";1065;59;1;1125;9113;5704;20;14837;3409;5704;9113;0,0385072066323836;0,0144048137177434;0,0241023929146402;0,0385072066323836
"241";"REGIONAL";2021-02-15;2021;7;"RA Acores";"All";2097;370;2;2469;11210;6074;22;17306;5136;6074;11210;0,0473681319377834;0,021702294882467;0,0256658370553163;0,0473681319377834
"242";"REGIONAL";2021-02-22;2021;8;"RA Acores";"All";1504;1642;8;3154;12714;7716;30;20460;4997;7717;12714;0,0537233210933968;0,0211149469485373;0,0326083741448594;0,0537233210933968
"243";"REGIONAL";2021-03-01;2021;9;"RA Acores";"All";786;1202;5;1993;13500;8918;35;22453;4581;8919;13500;0,0570445835111575;0,0193571286714528;0,0376874548397047;0,0570445835111575
"244";"REGIONAL";2021-03-08;2021;10;"RA Acores";"All";2774;2075;3;4852;16274;10993;38;27305;5270;11004;16274;0,0687661890415242;0,0222685151928741;0,0464976738486502;0,0687661890415242
"245";"REGIONAL";2021-03-15;2021;11;"RA Acores";"All";2535;1459;9;4003;18809;12452;47;31308;6341;12469;18810;0,0794778941675083;0,0267940521514259;0,0526880675407869;0,0794821196922128
"246";"REGIONAL";2021-03-22;2021;12;"RA Acores";"All";4167;752;6;4925;22976;13204;53;36233;9746;13231;22977;0,0970856556112855;0,0411819637703512;0,0559079173656389;0,0970898811359901
"247";"REGIONAL";2021-03-29;2021;13;"RA Acores";"All";2228;779;4;3011;25204;13983;57;39244;11191;14015;25206;0,106500124652979;0,0472878469683973;0,0592207287339905;0,106508575702388
"248";"REGIONAL";2021-04-05;2021;14;"RA Acores";"All";3900;2379;15;6294;29104;16362;72;45538;12698;16412;29110;0,122979671000647;0,0536557126981243;0,0693493114507494;0,123005024148874
"249";"REGIONAL";2021-04-12;2021;15;"RA Acores";"All";4241;2397;18;6656;33345;18759;90;52194;14526;18826;33352;0,140900121272559;0,0613799718580055;0,0795497280874853;0,140929699945491
"250";"REGIONAL";2021-04-19;2021;16;"RA Acores";"All";7918;1072;18;9008;41263;19831;108;61202;21315;19955;41270;0,174357825883029;0,0900670590770609;0,0843203454788998;0,174387404555961
"251";"REGIONAL";2021-04-26;2021;17;"RA Acores";"All";9314;2985;16;12315;50577;22816;124;73517;27599;23003;50602;0,213714362981023;0,116620256320329;0,0971997447783079;0,213820001098636
"252";"REGIONAL";2021-05-03;2021;18;"RA Acores";"All";9728;2959;20;12707;60305;25775;144;86224;34348;26015;60363;0,254820267306693;0,145138322551203;0,109927025188353;0,255065347739556
"253";"REGIONAL";2021-05-10;2021;19;"RA Acores";"All";9460;2424;15;11899;69765;28199;159;98123;41354;28472;69826;0,294793731011548;0,174742348631141;0,120309139387383;0,295051488018525
"254";"REGIONAL";2021-05-17;2021;20;"RA Acores";"All";12102;5185;14;17301;81867;33384;173;115424;48238;33697;81935;0,345931030985773;0,203830860697127;0,142387505968554;0,346218366665681
"255";"REGIONAL";2021-05-24;2021;21;"RA Acores";"All";5607;8183;93;13883;87474;41567;266;129307;45647;41905;87552;0,369623548004073;0,192882526187689;0,177070612743337;0,369953138931027
"256";"REGIONAL";2021-05-31;2021;22;"RA Acores";"All";5526;10497;32;16055;93000;52064;298;145362;40706;52439;93145;0,392973797521307;0,172004208622606;0,221582289980858;0,393586498603464
"257";"REGIONAL";2021-06-07;2021;23;"RA Acores";"All";7874;12223;56;20153;100874;64287;354;165515;36328;64715;101043;0,426245579044778;0,153504861466173;0,273454831253671;0,426959692719843
"258";"REGIONAL";2021-06-14;2021;24;"RA Acores";"All";9272;7860;88;17220;110146;72147;442;182735;38142;72637;110779;0,465424644105182;0,16116996328019;0,306929437962959;0,468099401243149
"259";"REGIONAL";2021-06-21;2021;25;"RA Acores";"All";7559;10023;366;17948;117705;82170;808;200683;38148;82745;120893;0,497365385346725;0,161195316428418;0,34964104167635;0,510836358104768
"260";"REGIONAL";2021-06-28;2021;26;"RA Acores";"All";6739;12491;195;19425;124444;94661;1003;220108;33796;95358;129154;0,525841196330554;0,142805832914302;0,402937584774589;0,545743417688892
"261";"REGIONAL";2021-07-05;2021;27;"RA Acores";"All";6218;16321;65;22604;130662;110982;1068;242712;25473;111830;137303;0,552115508943323;0,107636790798497;0,472540427707611;0,580177218506108
"262";"REGIONAL";2021-07-12;2021;28;"RA Acores";"All";2968;11919;57;14944;133630;122901;1125;257656;18151;123850;142001;0,564656866266369;0,0766974989119274;0,523331234656063;0,600028733567991
"263";"REGIONAL";2021-07-19;2021;29;"RA Acores";"All";5700;9033;42;14775;139330;131934;1167;272431;16494;133087;149581;0,588742357082191;0,0696958044765209;0,562362406351809;0,63205821082833
"264";"REGIONAL";2021-07-26;2021;30;"RA Acores";"All";7001;9021;30;16052;146331;140955;1197;288483;16894;142465;159359;0,618325255538607;0,0713860143583329;0,601989377030893;0,673375391389226
"265";"REGIONAL";2021-08-02;2021;31;"RA Acores";"All";9605;6686;24;16315;155936;147641;1221;304798;23151;149474;172625;0,658911420325619;0,0978251224345783;0,631606079684945;0,729431202119523
"266";"REGIONAL";2021-08-09;2021;32;"RA Acores";"All";5030;6613;33;11676;160966;154254;1254;316474;22922;156343;179265;0,680165809589406;0,0968574772772409;0,660631208880363;0,757488686157604
"267";"REGIONAL";2021-08-16;2021;33;"RA Acores";"All";2359;7383;36;9778;163325;161637;1290;326252;18582;163847;182429;0,690133822367393;0,0785187000595799;0,692339546263157;0,770858246322737
"268";"REGIONAL";2021-08-23;2021;34;"RA Acores";"All";5727;9357;14;15098;169052;170994;1304;341350;15247;173330;188577;0,714333402350237;0,0644265751699717;0,732410197036217;0,796836772206189
"269";"REGIONAL";2021-08-30;2021;35;"RA Acores";"All";3146;5540;13;8699;172198;176534;1317;350049;12992;178963;191955;0,727626903070689;0,0548980169612562;0,756212577696835;0,811110594658092
"270";"REGIONAL";2021-09-06;2021;36;"RA Acores";"All";2097;2899;15;5011;174295;179433;1332;355060;11673;182613;194286;0,736487828376089;0,0493245498759809;0,771635742868371;0,820960292744352
"271";"REGIONAL";2021-09-13;2021;37;"RA Acores";"All";867;5316;30;6213;175162;184749;1362;361273;7016;188243;195259;0,740151358294916;0,0296462813269838;0,795425446954876;0,825071728281859
"272";"REGIONAL";2021-09-20;2021;38;"RA Acores";"All";779;3371;20;4170;175941;188120;1382;365443;4349;191784;196133;0,743443042039745;0,0183768069400018;0,810388029933617;0,828764836873619
"273";"REGIONAL";2021-09-27;2021;39;"RA Acores";"All";520;1593;23;2136;176461;189713;1405;367579;3284;193519;196803;0,745640314886101;0,0138766231296771;0,817719315295977;0,831595938425654
"274";"REGIONAL";2021-01-04;2021;1;"Outro";"All";0;0;0;0;0;0;0;0;0;0;0;NA;NA;NA;NA
"275";"REGIONAL";2021-01-11;2021;2;"Outro";"All";0;0;0;0;0;0;0;0;0;0;0;NA;NA;NA;NA
"276";"REGIONAL";2021-01-18;2021;3;"Outro";"All";0;0;0;0;0;0;0;0;0;0;0;NA;NA;NA;NA
"277";"REGIONAL";2021-01-25;2021;4;"Outro";"All";0;0;0;0;0;0;0;0;0;0;0;NA;NA;NA;NA
"278";"REGIONAL";2021-02-01;2021;5;"Outro";"All";0;0;0;0;0;0;0;0;0;0;0;NA;NA;NA;NA
"279";"REGIONAL";2021-02-08;2021;6;"Outro";"All";0;0;0;0;0;0;0;0;0;0;0;NA;NA;NA;NA
"280";"REGIONAL";2021-02-15;2021;7;"Outro";"All";0;0;0;0;0;0;0;0;0;0;0;NA;NA;NA;NA
"281";"REGIONAL";2021-02-22;2021;8;"Outro";"All";0;0;0;0;0;0;0;0;0;0;0;NA;NA;NA;NA
"282";"REGIONAL";2021-03-01;2021;9;"Outro";"All";0;0;0;0;0;0;0;0;0;0;0;NA;NA;NA;NA
"283";"REGIONAL";2021-03-08;2021;10;"Outro";"All";0;0;0;0;0;0;0;0;0;0;0;NA;NA;NA;NA
"284";"REGIONAL";2021-03-15;2021;11;"Outro";"All";0;0;0;0;0;0;0;0;0;0;0;NA;NA;NA;NA
"285";"REGIONAL";2021-03-22;2021;12;"Outro";"All";0;0;0;0;0;0;0;0;0;0;0;NA;NA;NA;NA
"286";"REGIONAL";2021-03-29;2021;13;"Outro";"All";0;0;0;0;0;0;0;0;0;0;0;NA;NA;NA;NA
"287";"REGIONAL";2021-04-05;2021;14;"Outro";"All";0;0;0;0;0;0;0;0;0;0;0;NA;NA;NA;NA
"288";"REGIONAL";2021-04-12;2021;15;"Outro";"All";0;0;0;0;0;0;0;0;0;0;0;NA;NA;NA;NA
"289";"REGIONAL";2021-04-19;2021;16;"Outro";"All";0;0;0;0;0;0;0;0;0;0;0;NA;NA;NA;NA
"290";"REGIONAL";2021-04-26;2021;17;"Outro";"All";0;0;0;0;0;0;0;0;0;0;0;NA;NA;NA;NA
"291";"REGIONAL";2021-05-03;2021;18;"Outro";"All";0;0;0;0;0;0;0;0;0;0;0;NA;NA;NA;NA
"292";"REGIONAL";2021-05-10;2021;19;"Outro";"All";0;0;0;0;0;0;0;0;0;0;0;NA;NA;NA;NA
"293";"REGIONAL";2021-05-17;2021;20;"Outro";"All";0;0;0;0;0;0;0;0;0;0;0;NA;NA;NA;NA
"294";"REGIONAL";2021-05-24;2021;21;"Outro";"All";0;0;0;0;0;0;0;0;0;0;0;NA;NA;NA;NA
"295";"REGIONAL";2021-05-31;2021;22;"Outro";"All";0;0;0;0;0;0;0;0;0;0;0;NA;NA;NA;NA
"296";"REGIONAL";2021-06-07;2021;23;"Outro";"All";0;0;0;0;0;0;0;0;0;0;0;NA;NA;NA;NA
"297";"REGIONAL";2021-06-14;2021;24;"Outro";"All";0;0;0;0;0;0;0;0;0;0;0;NA;NA;NA;NA
"298";"REGIONAL";2021-06-21;2021;25;"Outro";"All";0;0;0;0;0;0;0;0;0;0;0;NA;NA;NA;NA
"299";"REGIONAL";2021-06-28;2021;26;"Outro";"All";0;0;0;0;0;0;0;0;0;0;0;NA;NA;NA;NA
"300";"REGIONAL";2021-07-05;2021;27;"Outro";"All";0;0;0;0;0;0;0;0;0;0;0;NA;NA;NA;NA
"301";"REGIONAL";2021-07-12;2021;28;"Outro";"All";0;0;0;0;0;0;0;0;0;0;0;NA;NA;NA;NA
"302";"REGIONAL";2021-07-19;2021;29;"Outro";"All";0;0;0;0;0;0;0;0;0;0;0;NA;NA;NA;NA
"303";"REGIONAL";2021-07-26;2021;30;"Outro";"All";0;0;0;0;0;0;0;0;0;0;0;NA;NA;NA;NA
"304";"REGIONAL";2021-08-02;2021;31;"Outro";"All";0;0;0;0;0;0;0;0;0;0;0;NA;NA;NA;NA
"305";"REGIONAL";2021-08-09;2021;32;"Outro";"All";0;0;0;0;0;0;0;0;0;0;0;NA;NA;NA;NA
"306";"REGIONAL";2021-08-16;2021;33;"Outro";"All";0;0;0;0;0;0;0;0;0;0;0;NA;NA;NA;NA
"307";"REGIONAL";2021-08-23;2021;34;"Outro";"All";0;0;0;0;0;0;0;0;0;0;0;NA;NA;NA;NA
"308";"REGIONAL";2021-08-30;2021;35;"Outro";"All";0;0;0;0;0;0;0;0;0;0;0;NA;NA;NA;NA
"309";"REGIONAL";2021-09-06;2021;36;"Outro";"All";0;0;0;0;0;0;0;0;0;0;0;NA;NA;NA;NA
"310";"REGIONAL";2021-09-13;2021;37;"Outro";"All";0;0;0;0;0;0;0;0;0;0;0;NA;NA;NA;NA
"311";"REGIONAL";2021-09-20;2021;38;"Outro";"All";0;0;0;0;0;0;0;0;0;0;0;NA;NA;NA;NA
"312";"REGIONAL";2021-09-27;2021;39;"Outro";"All";0;0;0;0;0;0;0;0;0;0;0;NA;NA;NA;NA
"313";"AGES";2021-01-04;2021;1;"All";"12-17 anos";5;0;0;5;7;0;0;7;7;0;7;1,12451786296625e-05;1,12451786296625e-05;0;1,12451786296625e-05
"314";"AGES";2021-01-11;2021;2;"All";"12-17 anos";15;0;0;15;22;0;0;22;22;0;22;3,53419899789394e-05;3,53419899789394e-05;0;3,53419899789394e-05
"315";"AGES";2021-01-18;2021;3;"All";"12-17 anos";70;1;0;71;92;1;0;93;91;1;92;0,000147793776275565;0,000146187322185613;1,60645408995179e-06;0,000147793776275565
"316";"AGES";2021-01-25;2021;4;"All";"12-17 anos";15;3;0;18;107;4;0;111;103;4;107;0,000171890587624842;0,000165464771265034;6,42581635980716e-06;0,000171890587624842
"317";"AGES";2021-02-01;2021;5;"All";"12-17 anos";35;4;0;39;142;8;0;150;134;8;142;0,000228116480773154;0,00021526484805354;1,28516327196143e-05;0,000228116480773154
"318";"AGES";2021-02-08;2021;6;"All";"12-17 anos";38;66;0;104;180;74;0;254;106;74;180;0,000289161736191322;0,00017028413353489;0,000118877602656432;0,000289161736191322
"319";"AGES";2021-02-15;2021;7;"All";"12-17 anos";32;16;0;48;212;90;0;302;122;90;212;0,00034056826706978;0,000195987398974118;0,000144580868095661;0,00034056826706978
"320";"AGES";2021-02-22;2021;8;"All";"12-17 anos";23;33;0;56;235;123;0;358;112;123;235;0,000377516711138671;0,000179922858074601;0,00019759385306407;0,000377516711138671
"321";"AGES";2021-03-01;2021;9;"All";"12-17 anos";12;30;0;42;247;153;0;400;94;153;247;0,000396794160218092;0,000151006684455468;0,000245787475762624;0,000396794160218092
"322";"AGES";2021-03-08;2021;10;"All";"12-17 anos";19;25;0;44;266;178;0;444;87;179;266;0,000427316787927176;0,000139761505825806;0,00028755528210137;0,000427316787927176
"323";"AGES";2021-03-15;2021;11;"All";"12-17 anos";5;23;0;28;271;201;0;472;69;202;271;0,000435349058376935;0,000110845332206674;0,000324503726170262;0,000435349058376935
"324";"AGES";2021-03-22;2021;12;"All";"12-17 anos";33;11;0;44;304;212;0;516;91;213;304;0,000488362043345344;0,000146187322185613;0,000342174721159731;0,000488362043345344
"325";"AGES";2021-03-29;2021;13;"All";"12-17 anos";15;14;0;29;319;226;0;545;92;227;319;0,000512458854694621;0,000147793776275565;0,000364665078419056;0,000512458854694621
"326";"AGES";2021-04-05;2021;14;"All";"12-17 anos";32;5;0;37;351;231;0;582;119;232;351;0,000563865385573078;0,000191168036704263;0,000372697348868815;0,000563865385573078
"327";"AGES";2021-04-12;2021;15;"All";"12-17 anos";47;9;0;56;398;240;0;638;157;241;398;0,000639368727800813;0,000252213292122431;0,000387155435678381;0,000639368727800813
"328";"AGES";2021-04-19;2021;16;"All";"12-17 anos";31;14;0;45;429;254;0;683;172;257;429;0,000689168804589318;0,000276310103471708;0,00041285870111761;0,000689168804589318
"329";"AGES";2021-04-26;2021;17;"All";"12-17 anos";50;27;0;77;479;281;0;760;194;285;479;0,000769491509086908;0,000311652093450647;0,00045783941563626;0,000769491509086908
"330";"AGES";2021-05-03;2021;18;"All";"12-17 anos";110;15;0;125;589;296;0;885;288;301;589;0,000946201458981604;0,000462658777906116;0,000483542681075489;0,000946201458981604
"331";"AGES";2021-05-10;2021;19;"All";"12-17 anos";167;45;0;212;756;341;0;1097;410;346;756;0,00121447929200355;0,000658646176880234;0,000555833115123319;0,00121447929200355
"332";"AGES";2021-05-17;2021;20;"All";"12-17 anos";316;26;0;342;1072;367;0;1439;700;372;1072;0,00172211878442832;0,00112451786296625;0,000597600921462066;0,00172211878442832
"333";"AGES";2021-05-24;2021;21;"All";"12-17 anos";303;40;0;343;1375;407;0;1782;957;418;1375;0,00220887437368371;0,00153737656408386;0,000671497809599848;0,00220887437368371
"334";"AGES";2021-05-31;2021;22;"All";"12-17 anos";279;116;0;395;1654;523;0;2177;1108;546;1654;0,00265707506478026;0,00177995113166658;0,000877123933113678;0,00265707506478026
"335";"AGES";2021-06-07;2021;23;"All";"12-17 anos";402;165;0;567;2056;688;0;2744;1340;717;2057;0,00330286960894088;0,0021526484805354;0,00115182758249543;0,00330447606303083
"336";"AGES";2021-06-14;2021;24;"All";"12-17 anos";585;335;0;920;2641;1023;0;3664;1587;1057;2644;0,00424264525156268;0,00254944264075349;0,00169802197307904;0,00424746461383253
"337";"AGES";2021-06-21;2021;25;"All";"12-17 anos";413;294;2;709;3054;1317;2;4373;1699;1362;3061;0,00490611079071277;0,00272936549882809;0,00218799047051434;0,00491735596934243
"338";"AGES";2021-06-28;2021;26;"All";"12-17 anos";230;282;0;512;3284;1599;2;4885;1642;1649;3291;0,00527559523140168;0,00263779761570084;0,0026490427943305;0,00528684041003134
"339";"AGES";2021-07-05;2021;27;"All";"12-17 anos";442;664;1;1107;3726;2263;3;5992;1410;2324;3734;0,00598564793916037;0,00226510026683202;0,00373339930504796;0,00599849957187999
"340";"AGES";2021-07-12;2021;28;"All";"12-17 anos";275;320;2;597;4001;2583;5;6589;1360;2665;4025;0,00642742281389711;0,00218477756233443;0,00428120014972152;0,00646597771205596
"341";"AGES";2021-07-19;2021;29;"All";"12-17 anos";272;277;1;550;4273;2860;6;7139;1341;2967;4308;0,006864378326364;0,00215425493462535;0,00476634928488696;0,00692060421951231
"342";"AGES";2021-07-26;2021;30;"All";"12-17 anos";1628;390;0;2018;5901;3250;6;9157;2541;3404;5945;0,00947968558480551;0,0040819998425675;0,00546836972219589;0,00955036956476339
"343";"AGES";2021-08-02;2021;31;"All";"12-17 anos";4622;214;1;4837;10523;3464;7;13994;6815;3781;10596;0,0169047163885627;0,0109479846230215;0,00607400291410772;0,0170219875371292
"344";"AGES";2021-08-09;2021;32;"All";"12-17 anos";142685;417;2;143104;153208;3881;9;157098;137931;15475;153406;0,246121618213334;0,22157981908114;0,024859877042004;0,246439696123144
"345";"AGES";2021-08-16;2021;33;"All";"12-17 anos";177904;1582;1;179487;331112;5463;10;336585;302072;29304;331376;0,531916226632117;0,485264799859917;0,0470755306519473;0,532340330511864
"346";"AGES";2021-08-23;2021;34;"All";"12-17 anos";132394;3935;3;136332;463506;9398;13;472917;421723;42071;463794;0,744601109417194;0,677478638176739;0,0675851300183618;0,745063768195101
"347";"AGES";2021-08-30;2021;35;"All";"12-17 anos";42098;110086;13;152197;505604;119484;26;625114;349053;156846;505899;0,812229613695985;0,560737619459942;0,251965898192579;0,812703517652521
"348";"AGES";2021-09-06;2021;36;"All";"12-17 anos";20507;162691;14;183212;526111;282175;40;808326;205043;321366;526409;0,845173167718626;0,329392165965985;0,516259725071447;0,845651891037432
"349";"AGES";2021-09-13;2021;37;"All";"12-17 anos";12793;126855;31;139679;538904;409030;71;948005;89730;449474;539204;0,86572453489138;0,144147125491374;0,722059345626991;0,866206471118365
"350";"AGES";2021-09-20;2021;38;"All";"12-17 anos";5632;41652;16;47300;544536;450682;87;995305;52762;492075;544837;0,874772084325988;0,0847597306940364;0,790495896313027;0,875255627007064
"351";"AGES";2021-09-27;2021;39;"All";"12-17 anos";3212;17197;14;20423;547748;467879;101;1015728;37978;510071;548049;0,879932014862913;0,0610099134281891;0,8194056441158;0,880415557543989
"352";"AGES";2021-01-04;2021;1;"All";"18-24 anos";1851;3;0;1854;3219;4;0;3223;3214;5;3219;0,00412071558869651;0,00411431497423753;6,40061445898806e-06;0,00412071558869651
"353";"AGES";2021-01-11;2021;2;"All";"18-24 anos";1442;56;0;1498;4661;60;0;4721;4599;62;4661;0,00596665279866867;0,00588728517937722;7,9367619291452e-05;0,00596665279866867
"354";"AGES";2021-01-18;2021;3;"All";"18-24 anos";3874;1201;0;5075;8535;1261;0;9796;7270;1265;8535;0,0109258488814926;0,00930649342336864;0,00161935545812398;0,0109258488814926
"355";"AGES";2021-01-25;2021;4;"All";"18-24 anos";1398;1646;1;3045;9933;2907;1;12841;7023;2912;9935;0,0127154606842257;0,00899030306909463;0,00372771786091465;0,0127180209300093
"356";"AGES";2021-02-01;2021;5;"All";"18-24 anos";997;944;0;1941;10930;3851;1;14782;7075;3858;10933;0,0139917432073479;0,00905686945946811;0,00493871411655519;0,0139955835760233
"357";"AGES";2021-02-08;2021;6;"All";"18-24 anos";1482;3072;0;4554;12412;6923;1;19336;5473;6942;12415;0,015888885332992;0,00700611258680833;0,00888661311485903;0,0158927257016674
"358";"AGES";2021-02-15;2021;7;"All";"18-24 anos";2332;1749;1;4082;14744;8672;2;23418;6019;8728;14747;0,018874131916664;0,00770505968572983;0,0111729125996096;0,0188779722853394
"359";"AGES";2021-02-22;2021;8;"All";"18-24 anos";1335;705;0;2040;16079;9377;2;25458;6620;9462;16082;0,0205830959772138;0,0084744135437002;0,012112522802189;0,0205869363458892
"360";"AGES";2021-03-01;2021;9;"All";"18-24 anos";956;1044;1;2001;17035;10421;3;27459;6510;10530;17040;0,0218068934617723;0,00833360002560246;0,0134796940506289;0,0218132940762313
"361";"AGES";2021-03-08;2021;10;"All";"18-24 anos";1396;647;1;2044;18431;11068;4;29503;7250;11189;18439;0,0235939450187218;0,00928089096553269;0,0143232950363235;0,0236041860018562
"362";"AGES";2021-03-15;2021;11;"All";"18-24 anos";282;399;2;683;18713;11467;6;30186;7132;11590;18722;0,0239549396742087;0,00912983646430057;0,0148366243159343;0,0239664607802349
"363";"AGES";2021-03-22;2021;12;"All";"18-24 anos";3279;177;0;3456;21992;11644;6;33642;10218;11784;22002;0,0281524626364131;0,013080295708388;0,0150849681569431;0,0281652638653311
"364";"AGES";2021-03-29;2021;13;"All";"18-24 anos";685;107;0;792;22677;11751;6;34434;10784;11906;22690;0,0290293468172945;0,0138048452651455;0,0152411431497424;0,0290459884148878
"365";"AGES";2021-04-05;2021;14;"All";"18-24 anos";807;193;0;1000;23484;11944;6;35434;11406;12106;23512;0,0300624059909751;0,0146010817038436;0,0154971677281019;0,0300982494319455
"366";"AGES";2021-04-12;2021;15;"All";"18-24 anos";4303;106;0;4409;27787;12050;6;39843;15590;12232;27822;0,0355707747943803;0,0199571158831248;0,0156584632124684;0,0356155790955932
"367";"AGES";2021-04-19;2021;16;"All";"18-24 anos";1315;105;0;1420;29102;12155;6;41263;16758;12379;29137;0,0372541363970941;0,0214522994207444;0,0158466412775626;0,037298940698307
"368";"AGES";2021-04-26;2021;17;"All";"18-24 anos";2684;184;0;2868;31786;12339;6;44131;19257;12594;31851;0,0406899862386789;0,0246513265273466;0,0161218676992991;0,0407731942266458
"369";"AGES";2021-05-03;2021;18;"All";"18-24 anos";1850;841;0;2691;33636;13180;6;46822;20282;13469;33751;0,0430582135885045;0,0259634524914392;0,017241975229622;0,0432054277210612
"370";"AGES";2021-05-10;2021;19;"All";"18-24 anos";2262;5419;0;7681;35898;18599;6;54503;17105;18923;36028;0,0459538515697507;0,0218965020641982;0,0242237654814862;0,0461202675456844
"371";"AGES";2021-05-17;2021;20;"All";"18-24 anos";2108;2476;0;4584;38006;21075;6;59087;16673;21468;38141;0,0486523506256601;0,0213434889749416;0,0274816782411111;0,0488251672160527
"372";"AGES";2021-05-24;2021;21;"All";"18-24 anos";2283;3300;0;5583;40289;24375;6;64670;15460;24986;40446;0,051574871187634;0,0197906999071911;0,0319851505744551;0,0517758504816462
"373";"AGES";2021-05-31;2021;22;"All";"18-24 anos";2383;2691;2;5076;42672;27066;8;69746;14902;27936;42838;0,0546254040387877;0,019076391333568;0,0357615131052581;0,0548379044388261
"374";"AGES";2021-06-07;2021;23;"All";"18-24 anos";2865;2935;1;5801;45537;30001;9;75547;14639;31096;45735;0,0582929561237879;0,0187397190130252;0,0398067014433386;0,0585464204563638
"375";"AGES";2021-06-14;2021;24;"All";"18-24 anos";3138;4582;2;7722;48675;34583;11;83269;13213;35941;49154;0,0623099817582488;0,0169142637693219;0,046008896854098;0,0629231606234198
"376";"AGES";2021-06-21;2021;25;"All";"18-24 anos";2889;3031;7;5927;51564;37614;18;89196;13244;39312;52556;0,0660082567926521;0,0169539475789676;0,0503241911223477;0,0672781387013153
"377";"AGES";2021-06-28;2021;26;"All";"18-24 anos";2098;3085;7;5190;53662;40699;25;94386;12518;42631;55149;0,0686939546196435;0,0160245783595225;0,054572919000224;0,0705974973597465
"378";"AGES";2021-07-05;2021;27;"All";"18-24 anos";11885;5092;13;16990;65547;45791;38;111376;19998;48663;68661;0,0839082151886581;0,0255998975901687;0,0622946202835472;0,0878945178737159
"379";"AGES";2021-07-12;2021;28;"All";"18-24 anos";14151;7855;6;22012;79698;53646;44;133388;31195;57759;88954;0,102023234230486;0,0399334336096265;0,0739386181073383;0,113872051716965
"380";"AGES";2021-07-19;2021;29;"All";"18-24 anos";19492;19659;0;39151;99190;73305;44;172539;46298;79482;125780;0,126975389637405;0,0592671296444459;0,101746727685858;0,161013857330304
"381";"AGES";2021-07-26;2021;30;"All";"18-24 anos";20999;22603;11;43613;120189;95908;55;216152;61871;104352;166223;0,153856690242263;0,0792024834384101;0,133583384004864;0,212785867443275
"382";"AGES";2021-08-02;2021;31;"All";"18-24 anos";53899;56462;4;110365;174088;152370;59;326517;101684;166484;268168;0,222854033987263;0,130168016129548;0,213119979518034;0,343287995647582
"383";"AGES";2021-08-09;2021;32;"All";"18-24 anos";87646;82590;7;170243;261734;234960;66;496760;165560;260377;425937;0,335051684961756;0,211937145966013;0,333314558197587;0,5452517041636
"384";"AGES";2021-08-16;2021;33;"All";"18-24 anos";94259;74389;13;168661;355993;309349;79;665421;229645;346669;576314;0,455714788619707;0,293973821486863;0,443778922776587;0,737752744263449
"385";"AGES";2021-08-23;2021;34;"All";"18-24 anos";56309;43765;6;100080;412302;353114;85;765501;249895;397034;646929;0,527797228533939;0,319896310045764;0,508252312221973;0,828148622267738
"386";"AGES";2021-08-30;2021;35;"All";"18-24 anos";22653;100453;5;123111;434955;453567;90;888612;171332;501867;673199;0,556795852401831;0,219326015297469;0,642451435337792;0,861777450635261
"387";"AGES";2021-09-06;2021;36;"All";"18-24 anos";12888;78449;15;91352;447843;532016;105;979964;104601;582382;686983;0,573294076231318;0,133902134604922;0,745520529970877;0,879422664575799
"388";"AGES";2021-09-13;2021;37;"All";"18-24 anos";9041;52530;5;61576;456884;584546;110;1041540;60270;636334;696604;0,58486766729606;0,0771530066886421;0,814585720229142;0,891738726917784
"389";"AGES";2021-09-20;2021;38;"All";"18-24 anos";7144;18637;7;25788;464028;603183;117;1067328;47689;656425;704114;0,594012865235063;0,0610477805869363;0,840304669248248;0,901352449835184
"390";"AGES";2021-09-27;2021;39;"All";"18-24 anos";4935;11370;6;16311;468963;614553;123;1083639;40158;669188;709346;0,600330271706084;0,0514071750888085;0,856642877716261;0,908050052805069
"391";"AGES";2021-01-04;2021;1;"All";"25-49 anos";27995;74;0;28069;52073;85;2;52160;51992;88;52080;0,015630210582967;0,0156058976557836;2,64140443473795e-05;0,015632311700131
"392";"AGES";2021-01-11;2021;2;"All";"25-49 anos";16856;811;0;17667;68929;896;2;69827;68027;909;68936;0,0206897007138696;0,0204189567593089;0,000272845071724636;0,0206918018310336
"393";"AGES";2021-01-18;2021;3;"All";"25-49 anos";37839;21836;6;59681;106768;22732;8;129508;83990;22786;106776;0,0320474396236479;0,0252104043720046;0,00683943652840215;0,0320498409004067
"394";"AGES";2021-01-25;2021;4;"All";"25-49 anos";15843;26291;10;42144;122611;49023;18;171652;73520;49099;122619;0,0368028680849608;0,0220677334138561;0,0147375359478635;0,0368052693617196
"395";"AGES";2021-02-01;2021;5;"All";"25-49 anos";10142;12588;2;22732;132753;61611;20;194384;71071;61696;132767;0,0398470866959963;0,0213326425660524;0,0185186463642719;0,0398512889303243
"396";"AGES";2021-02-08;2021;6;"All";"25-49 anos";13934;30961;5;44900;146687;92572;25;239284;53939;92763;146702;0,0440295104907279;0,0161903083869694;0,0278437044976814;0,0440340128846508
"397";"AGES";2021-02-15;2021;7;"All";"25-49 anos";22467;19093;6;41566;169154;111665;31;280850;56981;112188;169169;0,0507731961083708;0,0171033938745231;0,0336743046277706;0,0507776985022937
"398";"AGES";2021-02-22;2021;8;"All";"25-49 anos";11742;7372;2;19116;180896;119037;33;299966;61114;119797;180911;0,0542976700711768;0,0183439534800654;0,0359582189850343;0,0543021724650997
"399";"AGES";2021-03-01;2021;9;"All";"25-49 anos";7724;10062;6;17792;188620;129099;39;317758;58608;130038;188646;0,0566161027818491;0,0175917535353547;0,0390321533959606;0,0566239069313154
"400";"AGES";2021-03-08;2021;10;"All";"25-49 anos";16543;6343;2;22888;205163;135442;41;340646;68680;136528;205208;0,0615816429595616;0,0206149609747503;0,0409801891665799;0,0615951501413301
"401";"AGES";2021-03-15;2021;11;"All";"25-49 anos";4765;3375;5;8145;209928;138817;46;348791;70038;139945;209983;0,0630119034290532;0,0210225777045655;0,0420058345022048;0,0630284122067703
"402";"AGES";2021-03-22;2021;12;"All";"25-49 anos";42502;1778;0;44280;252430;140595;46;393071;110600;141894;252494;0,0757692865296478;0,0331976511911383;0,0425908455525803;0,0757884967437186
"403";"AGES";2021-03-29;2021;13;"All";"25-49 anos";4794;1249;2;6045;257224;141844;48;399116;114099;143214;257313;0,0772082516273903;0,0342479096135415;0,042987056217791;0,0772349658313325
"404";"AGES";2021-04-05;2021;14;"All";"25-49 anos";9179;1396;1;10576;266403;143240;49;409692;121843;144712;266555;0,0799634165485789;0,0365723455161109;0,0434366952908862;0,0800090408069971
"405";"AGES";2021-04-12;2021;15;"All";"25-49 anos";89414;922;0;90336;355817;144162;49;500028;210200;145784;355984;0,106801886563086;0,0630935468388542;0,0437584663765724;0,106852013215427
"406";"AGES";2021-04-19;2021;16;"All";"25-49 anos";11272;950;1;12223;367089;145112;50;512251;220144;147117;367261;0,110185285516309;0,0660783338501081;0,0441585791165163;0,110236912966624
"407";"AGES";2021-04-26;2021;17;"All";"25-49 anos";11251;1058;3;12312;378340;146170;53;524563;230259;148330;378589;0,11356238111804;0,0691144481520825;0,0445226727050773;0,11363712085716
"408";"AGES";2021-05-03;2021;18;"All";"25-49 anos";10591;8202;4;18797;388931;154372;57;543360;232533;156748;389281;0,116741371387167;0,0697970110707863;0,04704941617458;0,116846427245366
"409";"AGES";2021-05-10;2021;19;"All";"25-49 anos";25409;100589;9;126007;414340;254961;66;669367;157038;257755;414793;0,124368126532878;0,0471364624570884;0,0773676363722591;0,124504098829348
"410";"AGES";2021-05-17;2021;20;"All";"25-49 anos";32936;22154;7;55097;447276;277115;73;724464;167174;280695;447869;0,134254182949074;0,0501788801105548;0,0842532974782692;0,134432177588824
"411";"AGES";2021-05-24;2021;21;"All";"25-49 anos";26628;18559;6;45193;473904;295674;79;769657;173349;301424;474773;0,142246832640915;0,0520323656087942;0,0904753057200514;0,142507671328846
"412";"AGES";2021-05-31;2021;22;"All";"25-49 anos";42862;24050;22;66934;516766;319724;101;836591;190070;327966;518036;0,155112273195658;0,0570513341943912;0,0984421416867348;0,155493475881126
"413";"AGES";2021-06-07;2021;23;"All";"25-49 anos";128682;32317;21;161020;645448;352041;122;997611;283209;365608;648817;0,193737410180993;0,0850078986997387;0,109740749156326;0,194748647856065
"414";"AGES";2021-06-14;2021;24;"All";"25-49 anos";240677;85748;42;326467;886125;437789;164;1324078;445344;461442;906786;0,265978920992292;0,133674274611811;0,138506243769812;0,272180518381623
"415";"AGES";2021-06-21;2021;25;"All";"25-49 anos";273270;56527;160;329957;1159395;494316;324;1654035;673855;531728;1205583;0,348003533478751;0,202264043792084;0,159603261053902;0,361867304845987
"416";"AGES";2021-06-28;2021;26;"All";"25-49 anos";315701;61949;122;377772;1475096;556265;446;2031807;926766;611351;1538117;0,442764217734569;0,278177707086858;0,183502868475168;0,461680575562026
"417";"AGES";2021-07-05;2021;27;"All";"25-49 anos";368922;147829;20;516771;1844018;704094;466;2548578;1152355;783021;1935376;0,553499695788251;0,34589040993096;0,235031266124198;0,580921676055159
"418";"AGES";2021-07-12;2021;28;"All";"25-49 anos";208541;316997;59;525597;2052559;1021091;525;3074175;1118080;1121501;2239581;0,616095277859238;0,335602439817251;0,336629285791255;0,672231725608506
"419";"AGES";2021-07-19;2021;29;"All";"25-49 anos";103840;344092;53;447985;2156399;1365183;578;3522160;955700;1481651;2437351;0,647263850189146;0,286862524804439;0,444731763878854;0,731594288683293
"420";"AGES";2021-07-26;2021;30;"All";"25-49 anos";61605;354173;29;415807;2218004;1719356;607;3937967;712292;1849957;2562249;0,665755182030285;0,213801278139587;0,555282343622104;0,769083621761691
"421";"AGES";2021-08-02;2021;31;"All";"25-49 anos";52754;383505;37;436296;2270758;2102861;644;4374263;418906;2248031;2666937;0,68158980129735;0,125738655242993;0,674768074185044;0,800506729428037
"422";"AGES";2021-08-09;2021;32;"All";"25-49 anos";70590;237592;37;308219;2341348;2340453;681;4682482;292157;2504626;2796783;0,702778067098276;0,0876937267545154;0,75178752542727;0,839481252181785
"423";"AGES";2021-08-16;2021;33;"All";"25-49 anos";78058;145390;31;223479;2419406;2485843;712;4905961;252732;2665752;2918484;0,726207924753592;0,0758599347272945;0,800151040308132;0,876010975035426
"424";"AGES";2021-08-23;2021;34;"All";"25-49 anos";88287;79737;18;168042;2507693;2565580;730;5074003;265188;2761770;3026958;0,752708114904695;0,0795987226408281;0,828971764287071;0,9085704869279
"425";"AGES";2021-08-30;2021;35;"All";"25-49 anos";46468;80409;17;126894;2554161;2645989;747;5200897;225349;2855535;3080884;0,766655930958491;0,0676406645413366;0,857116228698799;0,924756893240136
"426";"AGES";2021-09-06;2021;36;"All";"25-49 anos";24940;63526;41;88507;2579101;2709515;788;5289404;182535;2925109;3107644;0,774141911254214;0,0547896316471468;0,877999532351351;0,932789163998498
"427";"AGES";2021-09-13;2021;37;"All";"25-49 anos";18645;66640;45;85330;2597746;2776155;833;5374734;132112;2995812;3127924;0,779738386900315;0,0396546843956932;0,899221716186496;0,93887640058219
"428";"AGES";2021-09-20;2021;38;"All";"25-49 anos";16570;32008;45;48623;2614316;2808163;878;5423357;113514;3031982;3145496;0,784712031387089;0,0340723162505504;0,910078488732459;0,94415080498301
"429";"AGES";2021-09-27;2021;39;"All";"25-49 anos";10908;21124;39;32071;2625224;2829287;917;5455428;100325;3056947;3157272;0,787986172247784;0,0301135113539869;0,917571973018054;0,947685484372041
"430";"AGES";2021-01-04;2021;1;"All";"50-64 anos";13010;6;0;13016;22273;8;0;22281;22267;9;22276;0,0102443172854514;0,0102415576256071;4,13948976649138e-06;0,0102456971153736
"431";"AGES";2021-01-11;2021;2;"All";"50-64 anos";11714;309;0;12023;33987;317;0;34304;33662;328;33990;0,0156320931881936;0,0154826116132925;0,000150861404823241;0,0156334730181158
"432";"AGES";2021-01-18;2021;3;"All";"50-64 anos";27469;8600;2;36071;61456;8917;2;70375;52509;8950;61459;0,0282662758988327;0,0241511631276329;0,00411649260112199;0,0282676557287549
"433";"AGES";2021-01-25;2021;4;"All";"50-64 anos";10809;12433;4;23246;72265;21350;6;93621;50872;21396;72268;0,0332378031083889;0,0233982359334388;0,00984094700487218;0,033239182938311
"434";"AGES";2021-02-01;2021;5;"All";"50-64 anos";5578;9232;0;14810;77843;30582;6;108431;47213;30635;77848;0,0358033668769987;0,0217153033717064;0,0140903632218293;0,0358056665935357
"435";"AGES";2021-02-08;2021;6;"All";"50-64 anos";6913;22305;4;29222;84756;52887;10;137653;31766;52995;84761;0,0389829549609715;0,014610559102485;0,0243746955750234;0,0389852546775084
"436";"AGES";2021-02-15;2021;7;"All";"50-64 anos";25162;12987;1;38150;109918;65874;11;175803;43825;66098;109923;0,0505560484614666;0,0201570154462761;0,0304013327317275;0,0505583481780036
"437";"AGES";2021-02-22;2021;8;"All";"50-64 anos";49873;4969;4;54846;159791;70843;15;230649;88552;71244;159796;0,0734948010308249;0,0407288997558161;0,0327682009915458;0,0734971007473619
"438";"AGES";2021-03-01;2021;9;"All";"50-64 anos";30246;6003;3;36252;190037;76846;18;266901;112712;77336;190048;0,0874062463060803;0,0518411300623085;0,0355701756201531;0,0874113056824616
"439";"AGES";2021-03-08;2021;10;"All";"50-64 anos";22417;4296;1;26714;212454;81142;19;293615;130772;81703;212475;0,0977167954277956;0,0601477061937346;0,0375787480435162;0,0977264542372507
"440";"AGES";2021-03-15;2021;11;"All";"50-64 anos";4763;2346;1;7110;217217;83488;20;300725;133184;84073;217257;0,0999075054008843;0,0612570894511543;0,0386688136820256;0,0999259031331798
"441";"AGES";2021-03-22;2021;12;"All";"50-64 anos";34705;1007;2;35714;251922;84495;22;336439;166756;85214;251970;0,115869837883782;0,0766983061667819;0,0391936089957552;0,115891915162537
"442";"AGES";2021-03-29;2021;13;"All";"50-64 anos";7860;809;1;8670;259782;85304;23;345109;173806;86044;259850;0,119484992279852;0,0799409064838668;0,0395753619408872;0,119516268424754
"443";"AGES";2021-04-05;2021;14;"All";"50-64 anos";15260;980;1;16241;275042;86284;24;361350;188044;87107;275151;0,126503727150591;0,0864895792944562;0,0400642816766405;0,126553860971097
"444";"AGES";2021-04-12;2021;15;"All";"50-64 anos";88073;620;0;88693;363115;86904;24;450043;275410;87825;363235;0,167012314062169;0,12667298628771;0,0403945209713451;0,167067507259055
"445";"AGES";2021-04-19;2021;16;"All";"50-64 anos";14528;1855;4;16387;377643;88759;28;466430;287833;89932;377765;0,173694370431901;0,13238686199539;0,0413636215200114;0,173750483515402
"446";"AGES";2021-04-26;2021;17;"All";"50-64 anos";33040;2981;4;36025;410683;91740;32;502455;318014;93055;411069;0,188890897307998;0,146268410955666;0,042800024468984;0,18906843542465
"447";"AGES";2021-05-03;2021;18;"All";"50-64 anos";151610;14885;9;166504;562293;106625;41;668959;460033;108308;568341;0,258622902141082;0,211589099527592;0,0498155397365721;0,261404639264164
"448";"AGES";2021-05-10;2021;19;"All";"50-64 anos";166786;109940;10;276736;729079;216565;51;945695;525968;218885;744853;0,335335006607086;0,241915461500215;0,100674690837607;0,342590152337823
"449";"AGES";2021-05-17;2021;20;"All";"50-64 anos";224843;75925;12;300780;953922;292490;63;1246475;689715;298239;987954;0,43875003967011;0,317229798255067;0,137173032052069;0,454402830307136
"450";"AGES";2021-05-24;2021;21;"All";"50-64 anos";175359;98644;80;274083;1129281;391134;143;1520558;801254;406210;1207464;0,519405238110351;0,36853141481781;0,186833570894052;0,555364985711861
"451";"AGES";2021-05-31;2021;22;"All";"50-64 anos";163794;169089;13;332896;1293075;560223;156;1853454;837753;583485;1421238;0,594741192200649;0,385318885594162;0,268370020711247;0,653688906305409
"452";"AGES";2021-06-07;2021;23;"All";"50-64 anos";210017;139489;42;349548;1503092;699712;198;2203002;920865;733981;1654846;0,691337105788341;0,423545693757787;0,337589648699901;0,761135342457689
"453";"AGES";2021-06-14;2021;24;"All";"50-64 anos";86398;231464;63;317925;1589490;931176;261;2520927;785653;972087;1757740;0,731075287660043;0,36135583927925;0,447104909848812;0,808460749128062
"454";"AGES";2021-06-21;2021;25;"All";"50-64 anos";86621;183988;210;270819;1676111;1115164;471;2791746;696402;1163936;1860338;0,770916036889293;0,32030543915157;0,535344573427879;0,85565001257945
"455";"AGES";2021-06-28;2021;26;"All";"50-64 anos";59441;179126;72;238639;1735552;1294290;543;3030385;576249;1350529;1926778;0,798255527023739;0,265041870938988;0,621166774983316;0,886208645922304
"456";"AGES";2021-07-05;2021;27;"All";"50-64 anos";41458;258401;46;299905;1777010;1552691;589;3330290;358891;1616366;1975257;0,817323856661428;0,165069513531762;0,743436723989401;0,908506237521163
"457";"AGES";2021-07-12;2021;28;"All";"50-64 anos";15443;134718;33;150194;1792453;1687409;622;3480484;244569;1757279;2001848;0,82442676115742;0,112487874744559;0,808248715263357;0,920736590007916
"458";"AGES";2021-07-19;2021;29;"All";"50-64 anos";10954;115130;25;126109;1803407;1802539;647;3606593;152225;1879078;2031303;0,829464980146547;0,0700148699671279;0,864269350159899;0,934284220127027
"459";"AGES";2021-07-26;2021;30;"All";"50-64 anos";9858;87475;21;97354;1813265;1890014;668;3703947;84593;1973292;2057885;0,833999101270777;0,0389079842018673;0,907602448922146;0,946510433124013
"460";"AGES";2021-08-02;2021;31;"All";"50-64 anos";8623;54025;13;62661;1821888;1944039;681;3766608;47702;2033416;2081118;0,837965192410383;0,0219402156490191;0,935256080335538;0,957196295984557
"461";"AGES";2021-08-09;2021;32;"All";"50-64 anos";7364;24393;5;31762;1829252;1968432;686;3798370;36596;2063022;2099618;0,841352214925988;0,0168320852771687;0,948873161894065;0,965705247171234
"462";"AGES";2021-08-16;2021;33;"All";"50-64 anos";7535;13046;12;20593;1836787;1981478;698;3818963;34411;2080283;2114694;0,844817887747156;0,0158271091505261;0,956812243322888;0,972639352473414
"463";"AGES";2021-08-23;2021;34;"All";"50-64 anos";11302;8239;2;19543;1848089;1989717;700;3838506;37687;2093281;2130968;0,850016167007255;0,017333883425529;0,962790586432316;0,980124469857845
"464";"AGES";2021-08-30;2021;35;"All";"50-64 anos";12896;6090;11;18997;1860985;1995807;711;3857503;42180;2104776;2146956;0,855947595899329;0,0194004087056229;0,968077634750741;0,987478043456364
"465";"AGES";2021-09-06;2021;36;"All";"50-64 anos";5559;3984;24;9567;1866544;1999791;735;3867070;42086;2111060;2153146;0,858504420745099;0,0193571740347285;0,970967918494366;0,990325092529095
"466";"AGES";2021-09-13;2021;37;"All";"50-64 anos";3631;7330;32;10993;1870175;2007121;767;3878063;37661;2119582;2157243;0,860174474894224;0,0173219248995369;0,974887555359926;0,992209480259463
"467";"AGES";2021-09-20;2021;38;"All";"50-64 anos";3233;6574;48;9855;1873408;2013695;815;3887918;33582;2127231;2160813;0,86166147160701;0,0154458161487015;0,978405661718137;0,993851477866838
"468";"AGES";2021-09-27;2021;39;"All";"50-64 anos";1992;4998;44;7034;1875400;2018693;859;3894952;30117;2132915;2163032;0,862577678675327;0,0138521125886023;0,98101997947733;0,994872092065932
"469";"AGES";2021-01-04;2021;1;"All";"65-79 anos";2311;3;0;2314;3279;5;0;3284;3275;5;3280;0,00201405601028956;0,00201159909536392;3,07114365704416e-06;0,00201467023902097
"470";"AGES";2021-01-11;2021;2;"All";"65-79 anos";5555;30;0;5585;8834;35;0;8869;8791;44;8835;0,00542609661326562;0,00539968477781504;2,70260641819886e-05;0,00542671084199703
"471";"AGES";2021-01-18;2021;3;"All";"65-79 anos";14146;918;0;15064;22980;953;0;23933;22000;981;22981;0,014114976247775;0,0135130320909943;0,000602558385512064;0,0141155904765064
"472";"AGES";2021-01-25;2021;4;"All";"65-79 anos";6604;2158;0;8762;29584;3111;0;32695;26430;3155;29585;0,0181713427899989;0,0162340653711354;0,00193789164759486;0,0181719570187303
"473";"AGES";2021-02-01;2021;5;"All";"65-79 anos";2820;4181;0;7001;32404;7292;0;39696;25068;7337;32405;0,0199034678125718;0,0153974858389566;0,0045065962023466;0,0199040820413032
"474";"AGES";2021-02-08;2021;6;"All";"65-79 anos";3790;11556;1;15347;36194;18848;1;55043;17279;18916;36195;0,0222313947046113;0,0106132582500132;0,0116187506833295;0,0222320089333427
"475";"AGES";2021-02-15;2021;7;"All";"65-79 anos";5150;7282;0;12432;41344;26130;1;67475;15116;26229;41345;0,0253946726713667;0,0092846815039759;0,0161106053961222;0,0253952869000982
"476";"AGES";2021-02-22;2021;8;"All";"65-79 anos";11689;2483;4;14176;53033;28613;5;81651;24263;28771;53034;0,0325743923128046;0,0149030317101725;0,0176719748313635;0,032575006541536
"477";"AGES";2021-03-01;2021;9;"All";"65-79 anos";13331;3823;1;17155;66364;32436;6;98806;33760;32615;66375;0,0407626755312157;0,0207363619723622;0,0200330700748991;0,0407694320472612
"478";"AGES";2021-03-08;2021;10;"All";"65-79 anos";15965;3595;0;19560;82329;36031;6;118366;46119;36236;82355;0,0505688372281577;0,0283276148638439;0,0222571923113304;0,0505848071751743
"479";"AGES";2021-03-15;2021;11;"All";"65-79 anos";18183;6862;4;25049;100512;42893;10;143415;57437;43109;100546;0,0617373582513645;0,0352794556459291;0,0264787863823033;0,0617582420282324
"480";"AGES";2021-03-22;2021;12;"All";"65-79 anos";52876;2233;3;55112;153388;45126;13;198527;108024;45407;153431;0,0942153166533379;0,0663514444817077;0,0278902840070808;0,0942417284887885
"481";"AGES";2021-03-29;2021;13;"All";"65-79 anos";88336;7434;1;95771;241724;52560;14;294298;188895;52888;241783;0,148473825871068;0,116024736219471;0,0324853291467503;0,148510065366222
"482";"AGES";2021-04-05;2021;14;"All";"65-79 anos";201446;5369;8;206823;443170;57929;22;501121;384873;58374;443247;0,272207746898452;0,236400054543511;0,0358549879672592;0,27225504251077
"483";"AGES";2021-04-12;2021;15;"All";"65-79 anos";233796;3639;8;237443;676966;61568;30;738564;614901;62146;677047;0,415811967386911;0,377689861172022;0,0381718587421333;0,415861719914155
"484";"AGES";2021-04-19;2021;16;"All";"65-79 anos";175892;13308;12;189212;852858;74876;42;927776;777305;75637;852942;0,523849887411874;0,477443064067742;0,0464584185575698;0,523901482625312
"485";"AGES";2021-04-26;2021;17;"All";"65-79 anos";293316;46442;10;339768;1146174;121318;52;1267544;1024939;122322;1147261;0,704013001993786;0,629546981741437;0,0751336868833911;0,704680668624828
"486";"AGES";2021-05-03;2021;18;"All";"65-79 anos";202503;164462;11;366976;1348677;285780;63;1634520;1069233;287071;1356304;0,828396162790269;0,65675362917046;0,176327256154265;0,833080885324724
"487";"AGES";2021-05-10;2021;19;"All";"65-79 anos";91564;80335;10;171909;1440241;366115;73;1806429;1087836;367866;1455702;0,884637402352987;0,668180126260858;0,225953866508441;0,894133992769299
"488";"AGES";2021-05-17;2021;20;"All";"65-79 anos";41341;111843;11;153195;1481582;477958;84;1959624;1017153;485088;1502241;0,91003023233816;0,624764596838688;0,297954986861647;0,922719583700335
"489";"AGES";2021-05-24;2021;21;"All";"65-79 anos";23637;202811;27;226475;1505219;680769;111;2186099;833902;696615;1530517;0,924548756862471;0,512206567579288;0,427880947730363;0,940087515309651
"490";"AGES";2021-05-31;2021;22;"All";"65-79 anos";18704;137676;16;156396;1523923;818445;127;2342495;717563;837373;1554936;0,936037291054741;0,440747811195916;0,514338555506008;0,955086366701923
"491";"AGES";2021-06-07;2021;23;"All";"65-79 anos";16104;71781;8;87893;1540027;890226;135;2430388;661162;911998;1573160;0,945928830545349;0,406104696515726;0,560175374587392;0,966280071103118
"492";"AGES";2021-06-14;2021;24;"All";"65-79 anos";10908;62740;13;73661;1550935;952966;148;2504049;608615;976811;1585426;0,952628837547557;0,373828819366386;0,599985381356193;0,973814200722579
"493";"AGES";2021-06-21;2021;25;"All";"65-79 anos";10317;97327;22;107666;1561252;1050293;170;2611715;520976;1076687;1597663;0,958965835369502;0,319998427574448;0,661332090134381;0,981330517708829
"494";"AGES";2021-06-28;2021;26;"All";"65-79 anos";9075;182516;43;191634;1570327;1232809;213;2803349;346122;1262006;1608128;0,964539961107037;0,212598076972688;0,775160344410334;0,987758421383022
"495";"AGES";2021-07-05;2021;27;"All";"65-79 anos";8169;204212;24;212405;1578496;1437021;237;3015754;148230;1469164;1617394;0,969557595613916;0,0910471248567312;0,902402739951525;0,993449864808256
"496";"AGES";2021-07-12;2021;28;"All";"65-79 anos";5489;57865;12;63366;1583985;1494886;249;3079120;94886;1530271;1625157;0,972929097120619;0,0582817074084584;0,939936415041725;0,998218122450183
"497";"AGES";2021-07-19;2021;29;"All";"65-79 anos";7152;42655;8;49815;1591137;1537541;257;3128935;57108;1577934;1635042;0,977322061007655;0,0350773743932956;0,969212399066864;1
"498";"AGES";2021-07-26;2021;30;"All";"65-79 anos";8634;32448;8;41090;1599771;1569989;265;3170025;29497;1616394;1645891;0,982625311874638;0,0181179048903663;0,992835636076847;1
"499";"AGES";2021-08-02;2021;31;"All";"65-79 anos";7627;11737;5;19369;1607398;1581726;270;3189394;21684;1633644;1655328;0,987310034409093;0,0133189358118691;1;1
"500";"AGES";2021-08-09;2021;32;"All";"65-79 anos";4596;6288;4;10888;1611994;1588014;274;3200282;18404;1642983;1661387;0,990133029658649;0,0113042655728481;1;1
"501";"AGES";2021-08-16;2021;33;"All";"65-79 anos";3691;2985;8;6684;1615685;1590999;282;3206966;18092;1648143;1666235;0,992400147906279;0,0111126262086486;1;1
"502";"AGES";2021-08-23;2021;34;"All";"65-79 anos";4309;2516;3;6828;1619994;1593515;285;3213794;19115;1652767;1671882;0,995046859509919;0,0117409822008798;1;1
"503";"AGES";2021-08-30;2021;35;"All";"65-79 anos";4906;2248;5;7159;1624900;1595763;290;3220953;20673;1657285;1677958;0,998060265666211;0,0126979505644148;1;1
"504";"AGES";2021-09-06;2021;36;"All";"65-79 anos";2250;1379;11;3640;1627150;1597142;301;3224593;20812;1659608;1680420;0,999442280311881;0,0127833283580806;1;1
"505";"AGES";2021-09-13;2021;37;"All";"65-79 anos";1634;3288;31;4953;1628784;1600430;332;3229546;18788;1663409;1682197;1,000445930059;0,0115401294057091;1;1
"506";"AGES";2021-09-20;2021;38;"All";"65-79 anos";1409;3367;40;4816;1630193;1603797;372;3234362;16476;1667208;1683684;1,00131137834156;0,0101200325786919;1;1
"507";"AGES";2021-09-27;2021;39;"All";"65-79 anos";887;2728;19;3634;1631080;1606525;391;3237996;14446;1670181;1684627;1,00185619922632;0,00887314825393199;1;1
"508";"AGES";2021-01-04;2021;1;"All";"80 ou mais anos";3780;8;1;3789;4047;8;2;4057;4038;9;4047;0,00593758711248698;0,00592438269340806;1,32044190789184e-05;0,00593758711248698
"509";"AGES";2021-01-11;2021;2;"All";"80 ou mais anos";14500;1;1;14502;18547;9;3;18559;18513;34;18547;0,0272113734063;0,0271614900453352;4,98833609648029e-05;0,0272113734063
"510";"AGES";2021-01-18;2021;3;"All";"80 ou mais anos";39050;256;1;39307;57597;265;4;57866;57197;400;57597;0,0845038806320515;0,0839170175618774;0,000586863070174152;0,0845038806320515
"511";"AGES";2021-01-25;2021;4;"All";"80 ou mais anos";7380;3397;2;10779;64977;3662;6;68645;61148;3829;64977;0,0953315042767646;0,0897137575375226;0,00561774673924207;0,0953315042767646
"512";"AGES";2021-02-01;2021;5;"All";"80 ou mais anos";4538;10654;0;15192;69515;14316;6;83837;55024;14491;69515;0,10198946580789;0,0807288839331563;0,0212605818747341;0,10198946580789
"513";"AGES";2021-02-08;2021;6;"All";"80 ou mais anos";14828;31564;2;46394;84343;45880;8;130231;38187;46156;84343;0,123744479819246;0,0560263501518508;0,0677181296673953;0,123744479819246
"514";"AGES";2021-02-15;2021;7;"All";"80 ou mais anos";48621;9277;2;57900;132964;55157;10;188131;77453;55511;132964;0,19507915315659;0,113635763435496;0,0814433897210933;0,19507915315659
"515";"AGES";2021-02-22;2021;8;"All";"80 ou mais anos";102556;5203;1;107760;235520;60360;11;295891;174668;60852;235520;0,34554497571854;0,256265496852947;0,0892794788655937;0,34554497571854
"516";"AGES";2021-03-01;2021;9;"All";"80 ou mais anos";87217;12777;1;99995;322737;73137;12;395886;249048;73690;322738;0,473506066696988;0,36539268475183;0,108114849102833;0,473507533854663
"517";"AGES";2021-03-08;2021;10;"All";"80 ou mais anos";40160;37295;0;77455;362897;110432;12;473341;251891;111007;362898;0,532427118942473;0,369563814023093;0,162864772077055;0,532428586100148
"518";"AGES";2021-03-15;2021;11;"All";"80 ou mais anos";54374;97450;5;151829;417271;207882;17;625170;208768;208504;417272;0,612202350386596;0,306295573585293;0,305908243958978;0,612203817544271
"519";"AGES";2021-03-22;2021;12;"All";"80 ou mais anos";124559;16923;2;141484;541830;224805;19;766654;316287;225544;541831;0,794950043281151;0,46404289969043;0,330908610748397;0,794951510438827
"520";"AGES";2021-03-29;2021;13;"All";"80 ou mais anos";36745;75507;4;112256;578575;300312;23;878910;277471;301107;578578;0,848860752065024;0,40709370736073;0,441771446177321;0,848865153538051
"521";"AGES";2021-04-05;2021;14;"All";"80 ou mais anos";30376;45897;12;76285;608951;346209;35;955195;261886;347069;608955;0,893427133614049;0,38422805498907;0,509204947255682;0,893433002244751
"522";"AGES";2021-04-12;2021;15;"All";"80 ou mais anos";10512;49514;15;60041;619463;395723;50;1015236;222815;396652;619467;0,908849895098226;0,326904737452134;0,581951026276794;0,908855763728928
"523";"AGES";2021-04-19;2021;16;"All";"80 ou mais anos";8420;123345;13;131778;627883;519068;63;1147014;107797;520090;627887;0,921203362725392;0,158155195938908;0,763054035417186;0,921209231356094
"524";"AGES";2021-04-26;2021;17;"All";"80 ou mais anos";6136;39853;4;45993;634019;558921;67;1193007;74039;559995;634034;0,930205842221864;0,10862688713156;0,821600962455435;0,930227849586995
"525";"AGES";2021-05-03;2021;18;"All";"80 ou mais anos";5106;31851;6;36963;639125;590772;73;1229970;47350;591938;639288;0,937697149312637;0,0694699159318652;0,868466380081867;0,937936296013733
"526";"AGES";2021-05-10;2021;19;"All";"80 ou mais anos";3783;9991;2;13776;642908;600763;75;1243746;41215;602057;643272;0,943247406798809;0,0604689035930691;0,883312548599598;0,943781452192667
"527";"AGES";2021-05-17;2021;20;"All";"80 ou mais anos";4754;8387;3;13144;647662;609150;78;1256890;36546;611916;648462;0,950222274387828;0,0536187444064614;0,897777256121715;0,951396000528177
"528";"AGES";2021-05-24;2021;21;"All";"80 ou mais anos";4456;6374;0;10830;652118;615524;78;1267720;32817;620577;653394;0,956759928989569;0,0481477134347628;0,910484308748661;0,958632022183424
"529";"AGES";2021-05-31;2021;22;"All";"80 ou mais anos";3057;6158;2;9217;655175;621682;80;1276937;29327;627724;657051;0,961245030003374;0,0430273331474934;0,920970084654998;0,963997417802491
"530";"AGES";2021-06-07;2021;23;"All";"80 ou mais anos";2756;4825;1;7582;657931;626507;81;1284519;26779;633406;660185;0,965288516556874;0,039289015390484;0,929306474566822;0,968595489957306
"531";"AGES";2021-06-14;2021;24;"All";"80 ou mais anos";2630;4788;0;7418;660561;631295;81;1291937;23964;639123;663087;0,969147141243269;0,0351589665341334;0,937694214997286;0,972853181531419
"532";"AGES";2021-06-21;2021;25;"All";"80 ou mais anos";3400;4830;3;8233;663961;636125;84;1300170;21283;645667;666950;0,97413547733975;0,0312255168062912;0,947295294825335;0,978520811631626
"533";"AGES";2021-06-28;2021;26;"All";"80 ou mais anos";3275;5430;1;8706;667236;641555;85;1308876;17811;652836;670647;0,978940418726801;0,0261315453571795;0,957813348200531;0,983944893557711
"534";"AGES";2021-07-05;2021;27;"All";"80 ou mais anos";2672;5261;2;7935;669908;646816;87;1316811;14074;659577;673651;0,982860664035564;0,0206487771240775;0,967703458090641;0,988352235214718
"535";"AGES";2021-07-12;2021;28;"All";"80 ou mais anos";2114;3549;2;5665;672022;650365;89;1322476;11734;664529;676263;0,985962235361434;0,0172156281635587;0,974968822899397;0,992184451062956
"536";"AGES";2021-07-19;2021;29;"All";"80 ou mais anos";2208;3088;1;5297;674230;653453;90;1327773;9891;669180;679071;0,989201719508796;0,0145116565677313;0,981792573247847;0,996304229815578
"537";"AGES";2021-07-26;2021;30;"All";"80 ou mais anos";2597;2893;1;5491;676827;656346;91;1333264;8247;673928;682175;0,993011927991901;0,0120996493493156;0,988758637890814;1
"538";"AGES";2021-08-02;2021;31;"All";"80 ou mais anos";2490;2102;1;4593;679317;658448;92;1337857;7282;677842;685124;0,996665150603735;0,0106838421925204;0,994501093032468;1
"539";"AGES";2021-08-09;2021;32;"All";"80 ou mais anos";1576;1723;1;3300;680893;660171;93;1341157;6489;680640;687129;0,998977391100222;0,00952038615590018;0,998606200208336;1
"540";"AGES";2021-08-16;2021;33;"All";"80 ou mais anos";1347;1128;1;2476;682240;661299;94;1343633;6140;682647;688787;1,00095365248903;0,00900834812717323;1;1
"541";"AGES";2021-08-23;2021;34;"All";"80 ou mais anos";1536;973;0;2509;683776;662272;94;1346142;6263;684437;690700;1,0032072066785;0,00918880852125178;1;1
"542";"AGES";2021-08-30;2021;35;"All";"80 ou mais anos";1668;820;0;2488;685444;663092;94;1348630;6670;686017;692687;1,00565442568113;0,00978594169515398;1;1
"543";"AGES";2021-09-06;2021;36;"All";"80 ou mais anos";768;572;1;1341;686212;663664;95;1349971;6608;686918;693526;1,00678120277586;0,00969497791927698;1;1
"544";"AGES";2021-09-13;2021;37;"All";"80 ou mais anos";549;961;6;1516;686761;664625;101;1351487;6069;688048;694117;1,00758667233968;0,00890417993221732;1;1
"545";"AGES";2021-09-20;2021;38;"All";"80 ou mais anos";598;1043;5;1646;687359;665668;106;1353133;5446;689289;694735;1,00846403262959;0,00799014070042108;1;1
"546";"AGES";2021-09-27;2021;39;"All";"80 ou mais anos";364;794;8;1166;687723;666462;114;1354299;4941;690187;695128;1,00899807802345;0,00724922607432621;1;1
"547";"AGES";2021-01-04;2021;1;"All";"Desconhecido";1;0;0;1;1;0;0;1;1;0;1;NA;NA;NA;NA
"548";"AGES";2021-01-11;2021;2;"All";"Desconhecido";0;0;0;0;1;0;0;1;1;0;1;NA;NA;NA;NA
"549";"AGES";2021-01-18;2021;3;"All";"Desconhecido";0;0;0;0;1;0;0;1;1;0;1;NA;NA;NA;NA
"550";"AGES";2021-01-25;2021;4;"All";"Desconhecido";0;0;0;0;1;0;0;1;1;0;1;NA;NA;NA;NA
"551";"AGES";2021-02-01;2021;5;"All";"Desconhecido";0;0;0;0;1;0;0;1;1;0;1;NA;NA;NA;NA
"552";"AGES";2021-02-08;2021;6;"All";"Desconhecido";2;0;0;2;3;0;0;3;3;0;3;NA;NA;NA;NA
"553";"AGES";2021-02-15;2021;7;"All";"Desconhecido";0;0;0;0;3;0;0;3;3;0;3;NA;NA;NA;NA
"554";"AGES";2021-02-22;2021;8;"All";"Desconhecido";1;0;0;1;4;0;0;4;4;0;4;NA;NA;NA;NA
"555";"AGES";2021-03-01;2021;9;"All";"Desconhecido";0;0;0;0;4;0;0;4;4;0;4;NA;NA;NA;NA
"556";"AGES";2021-03-08;2021;10;"All";"Desconhecido";1;0;0;1;5;0;0;5;5;0;5;NA;NA;NA;NA
"557";"AGES";2021-03-15;2021;11;"All";"Desconhecido";0;1;0;1;5;1;0;6;4;1;5;NA;NA;NA;NA
"558";"AGES";2021-03-22;2021;12;"All";"Desconhecido";0;1;0;1;5;2;0;7;3;2;5;NA;NA;NA;NA
"559";"AGES";2021-03-29;2021;13;"All";"Desconhecido";0;0;0;0;5;2;0;7;3;2;5;NA;NA;NA;NA
"560";"AGES";2021-04-05;2021;14;"All";"Desconhecido";0;0;0;0;5;2;0;7;3;2;5;NA;NA;NA;NA
"561";"AGES";2021-04-12;2021;15;"All";"Desconhecido";1;0;0;1;6;2;0;8;4;2;6;NA;NA;NA;NA
"562";"AGES";2021-04-19;2021;16;"All";"Desconhecido";0;0;0;0;6;2;0;8;4;2;6;NA;NA;NA;NA
"563";"AGES";2021-04-26;2021;17;"All";"Desconhecido";1;0;0;1;7;2;0;9;5;2;7;NA;NA;NA;NA
"564";"AGES";2021-05-03;2021;18;"All";"Desconhecido";1;0;0;1;8;2;0;10;6;2;8;NA;NA;NA;NA
"565";"AGES";2021-05-10;2021;19;"All";"Desconhecido";0;1;0;1;8;3;0;11;5;3;8;NA;NA;NA;NA
"566";"AGES";2021-05-17;2021;20;"All";"Desconhecido";0;0;0;0;8;3;0;11;5;3;8;NA;NA;NA;NA
"567";"AGES";2021-05-24;2021;21;"All";"Desconhecido";0;2;0;2;8;5;0;13;3;5;8;NA;NA;NA;NA
"568";"AGES";2021-05-31;2021;22;"All";"Desconhecido";0;0;0;0;8;5;0;13;3;5;8;NA;NA;NA;NA
"569";"AGES";2021-06-07;2021;23;"All";"Desconhecido";1;0;0;1;9;5;0;14;4;5;9;NA;NA;NA;NA
"570";"AGES";2021-06-14;2021;24;"All";"Desconhecido";0;0;0;0;9;5;0;14;4;5;9;NA;NA;NA;NA
"571";"AGES";2021-06-21;2021;25;"All";"Desconhecido";1;0;0;1;10;5;0;15;5;5;10;NA;NA;NA;NA
"572";"AGES";2021-06-28;2021;26;"All";"Desconhecido";2;1;0;3;12;6;0;18;6;6;12;NA;NA;NA;NA
"573";"AGES";2021-07-05;2021;27;"All";"Desconhecido";1;2;0;3;13;8;0;21;6;8;14;NA;NA;NA;NA
"574";"AGES";2021-07-12;2021;28;"All";"Desconhecido";2;2;0;4;15;10;0;25;6;10;16;NA;NA;NA;NA
"575";"AGES";2021-07-19;2021;29;"All";"Desconhecido";1;0;0;1;16;10;0;26;7;10;17;NA;NA;NA;NA
"576";"AGES";2021-07-26;2021;30;"All";"Desconhecido";2;2;0;4;18;12;0;30;8;12;20;NA;NA;NA;NA
"577";"AGES";2021-08-02;2021;31;"All";"Desconhecido";1;0;0;1;19;12;0;31;9;12;21;NA;NA;NA;NA
"578";"AGES";2021-08-09;2021;32;"All";"Desconhecido";1;1;0;2;20;13;0;33;10;13;23;NA;NA;NA;NA
"579";"AGES";2021-08-16;2021;33;"All";"Desconhecido";1;1;0;2;21;14;0;35;10;14;24;NA;NA;NA;NA
"580";"AGES";2021-08-23;2021;34;"All";"Desconhecido";2;0;0;2;23;14;0;37;12;14;26;NA;NA;NA;NA
"581";"AGES";2021-08-30;2021;35;"All";"Desconhecido";0;2;0;2;23;16;0;39;10;16;26;NA;NA;NA;NA
"582";"AGES";2021-09-06;2021;36;"All";"Desconhecido";2;1;0;3;25;17;0;42;11;17;28;NA;NA;NA;NA
"583";"AGES";2021-09-13;2021;37;"All";"Desconhecido";1;0;0;1;26;17;0;43;12;17;29;NA;NA;NA;NA
"584";"AGES";2021-09-20;2021;38;"All";"Desconhecido";0;0;0;0;26;17;0;43;12;17;29;NA;NA;NA;NA
"585";"AGES";2021-09-27;2021;39;"All";"Desconhecido";3;3;0;6;29;20;0;49;13;20;33;NA;NA;NA;NA
"586";"GENERAL";2021-01-04;2021;1;"All";"All";48953;94;1;49048;84899;110;4;85013;84794;116;84910;0,0082044729496597;0,00819432595546996;1,12100126286591e-05;0,00820553596809862
"587";"GENERAL";2021-01-11;2021;2;"All";"All";50082;1207;1;51290;134981;1317;5;136303;133615;1377;134992;0,0130442992640433;0,0129122917015369;0,000133070580945375;0,0130453622824823
"588";"GENERAL";2021-01-18;2021;3;"All";"All";122448;32812;9;155269;257429;34129;14;291572;223058;34383;257441;0,024877433973992;0,0215558879045123;0,00332270572595849;0,0248785936304708
"589";"GENERAL";2021-01-25;2021;4;"All";"All";42049;45928;17;87994;299478;80057;31;379566;219097;80395;299492;0,028940966913841;0,0211731046284596;0,00776921521794004;0,0289423198463996
"590";"GENERAL";2021-02-01;2021;5;"All";"All";24111;37603;2;61716;323589;117660;33;441282;205587;118025;323612;0,0312710066939237;0,0198675247093804;0,0114057046594611;0,0312732293688415
"591";"GENERAL";2021-02-08;2021;6;"All";"All";40987;99524;12;140523;364576;217184;45;581805;146754;217846;364600;0,0352319100353966;0,0141820189078123;0,0210522104405419;0,0352342293483542
"592";"GENERAL";2021-02-15;2021;7;"All";"All";103764;50404;10;154178;468340;267588;55;735983;199520;268844;468364;0,0452594596078119;0,0192812217212936;0,025980557199476;0,0452617789207696
"593";"GENERAL";2021-02-22;2021;8;"All";"All";177219;20765;11;197995;645559;288353;66;933978;355334;290249;645583;0,0623855564012458;0,0343387812706201;0,0280490944435833;0,0623878757142034
"594";"GENERAL";2021-03-01;2021;9;"All";"All";139486;33739;12;173237;785045;322092;78;1107215;460737;324362;785099;0,0758652100350487;0,0445247205904352;0,0313457078987682;0,0758704284892034
"595";"GENERAL";2021-03-08;2021;10;"All";"All";96502;52201;4;148707;881547;374293;82;1255922;504806;376842;881648;0,085190974161694;0,0487834623708867;0,0364172722328374;0,0852007346037241
"596";"GENERAL";2021-03-15;2021;11;"All";"All";82372;110456;17;192845;963919;484749;99;1448767;476634;487424;964058;0,0931512427845207;0,046060975510761;0,0471036999613061;0,0931646754720672
"597";"GENERAL";2021-03-22;2021;12;"All";"All";257955;22130;7;280092;1221874;506879;106;1728859;711982;510058;1222040;0,118079508367501;0,0688045449256718;0,0492910053564533;0,118095550282125
"598";"GENERAL";2021-03-29;2021;13;"All";"All";138435;85120;8;223563;1360309;591999;114;1952422;765153;595388;1360541;0,131457595421367;0,0739428861453135;0,0575371293013108;0,131480015446624
"599";"GENERAL";2021-04-05;2021;14;"All";"All";257100;53840;22;310962;1617409;645839;136;2263384;968177;649602;1617779;0,156303235480231;0,0935627275584245;0,0627762639965705;0,156338991554995
"600";"GENERAL";2021-04-12;2021;15;"All";"All";426146;54810;23;480979;2043555;700649;159;2744363;1339080;704882;2043962;0,197485149632408;0,129406066472282;0,068118414842366;0,197524481314648
"601";"GENERAL";2021-04-19;2021;16;"All";"All";211458;139577;30;351065;2255013;840226;189;3095428;1410016;845414;2255430;0,217920036274055;0,136261182470787;0,0816991518659066;0,217960334336694
"602";"GENERAL";2021-04-26;2021;17;"All";"All";346478;90545;21;437044;2601491;930771;210;3532472;1666710;936583;2603293;0,251402991063301;0,161067587485451;0,0905095453257533;0,251577132811204
"603";"GENERAL";2021-05-03;2021;18;"All";"All";371772;220257;30;592059;2973263;1151028;240;4124531;1829728;1157838;2987566;0,287330308433834;0,176821327474233;0,111891194844322;0,288712522318555
"604";"GENERAL";2021-05-10;2021;19;"All";"All";289973;306320;31;596324;3263236;1457348;271;4720855;1829582;1465836;3295418;0,315352730778404;0,176807218320408;0,14165551785813;0,318462736178538
"605";"GENERAL";2021-05-17;2021;20;"All";"All";306299;220811;33;527143;3569535;1678159;304;5247998;1927972;1697782;3625754;0,344952865762418;0,186315435066388;0,164070324661293;0,350385759727682
"606";"GENERAL";2021-05-24;2021;21;"All";"All";232667;329731;113;562511;3802202;2007890;417;5810509;1857748;2050237;3907985;0,367437348592351;0,179529125352294;0,198130885015035;0,377660010367329
"607";"GENERAL";2021-05-31;2021;22;"All";"All";231080;339782;55;570917;4033282;2347672;472;6381426;1790731;2405039;4195770;0,389768466852959;0,173052733832166;0,232418254848427;0,405470988680593
"608";"GENERAL";2021-06-07;2021;23;"All";"All";360827;251512;73;612412;4394109;2599184;545;6993838;1908003;2676815;4584818;0,424638080876762;0,184385670047581;0,258682154780896;0,443067824828477
"609";"GENERAL";2021-06-14;2021;24;"All";"All";344338;389658;120;734116;4738447;2988842;665;7727954;1878386;3086471;4964857;0,457914230260617;0,181523541219796;0,298270507655086;0,479794048874882
"610";"GENERAL";2021-06-21;2021;25;"All";"All";376911;346001;404;723316;5115358;3334843;1069;8451270;1927468;3458706;5386174;0,494338170518208;0,186266729494278;0,334242568438093;0,520509297932371
"611";"GENERAL";2021-06-28;2021;26;"All";"All";389823;432390;245;822458;5505181;3767233;1314;9273728;1881118;3921018;5802136;0,532009901147016;0,181787556344809;0,378919493941375;0,560707050286184
"612";"GENERAL";2021-07-05;2021;27;"All";"All";433549;621461;106;1055116;5938730;4388694;1420;10328844;1694968;4579133;6274101;0,57390722670859;0,163798385217008;0,442518437571633;0,606316822788641
"613";"GENERAL";2021-07-12;2021;28;"All";"All";246016;521308;114;767438;6184746;4910002;1534;11096282;1501834;5134026;6635860;0,597681730733177;0,145134294018531;0,496142209447103;0,641276503465633
"614";"GENERAL";2021-07-19;2021;29;"All";"All";143919;524902;88;668909;6328665;5434904;1622;11765191;1222573;5690315;6912888;0,611589780797867;0,118147058357393;0,549900888026276;0,668047946383669
"615";"GENERAL";2021-07-26;2021;30;"All";"All";105323;499984;70;605377;6433988;5934888;1692;12370568;899052;6221352;7120404;0,62176798907449;0,0868826230501826;0,601219262821838;0,688101885872021
"616";"GENERAL";2021-08-02;2021;31;"All";"All";130016;508046;61;638123;6564004;6442934;1753;13008691;604085;6763224;7367309;0,634332480470419;0,0583775903343406;0,653584710779741;0,711962301114082
"617";"GENERAL";2021-08-09;2021;32;"All";"All";314464;353005;56;667525;6878468;6795939;1809;13676216;657155;7167151;7824306;0,664721665050234;0,0635061711119521;0,692619424323331;0,756125595435283
"618";"GENERAL";2021-08-16;2021;33;"All";"All";362829;238521;66;601416;7241297;7034460;1875;14277632;843142;7452829;8295971;0,699784748429922;0,0814795902392487;0,720226786286521;0,80170637652577
"619";"GENERAL";2021-08-23;2021;34;"All";"All";294238;139165;32;433435;7535535;7173625;1907;14711067;1000020;7631393;8631413;0,728219332014675;0,0966399726630313;0,737482861243623;0,834122833906655
"620";"GENERAL";2021-08-30;2021;35;"All";"All";130711;300109;51;430871;7666246;7473734;1958;15141938;815420;7962367;8777787;0,740850986848336;0,078800590497079;0,769467539862225;0,848268130359304
"621";"GENERAL";2021-09-06;2021;36;"All";"All";66971;310602;106;377679;7733217;7784336;2064;15519617;561901;8286490;8848391;0,747322933018628;0,0543010112591048;0,800790151269457;0,855091162528561
"622";"GENERAL";2021-09-13;2021;37;"All";"All";46346;257610;150;304106;7779563;8041946;2214;15823723;344891;8552714;8897605;0,751801719615937;0,0333295902199211;0,826517516804389;0,85984710702431
"623";"GENERAL";2021-09-20;2021;38;"All";"All";34601;103285;161;138047;7814164;8145231;2375;15961770;269739;8664271;8934010;0,755145492434594;0,0260670482451885;0,837298166621762;0,863365214866951
"624";"GENERAL";2021-09-27;2021;39;"All";"All";22304;58220;130;80654;7836468;8203451;2505;16042424;228232;8729560;8957792;0,757300907276574;0,0220558931229665;0,843607567608939;0,865663460731906
