;TYPE;DATE;YEAR;WEEK;REGION;AGEGROUP;TOTAL_VAC_1;TOTAL_VAC_2;TOTAL_VAC_UNK;TOTAL;CUMUL_VAC_1;CUMUL_VAC_2;CUMUL_VAC_UNK;CUMUL;COVER_1_VAC;COVER;RECEIVED;DISTRIBUTED
1;REGIONAL;08/02/21;2021;6;Outro;All;69;120;0;189;692;444;1;1137;NA;NA;NA;NA
2;REGIONAL;15/02/21;2021;7;Outro;All;147;106;1;254;839;550;2;1391;NA;NA;NA;NA
3;REGIONAL;22/02/21;2021;8;Outro;All;73;19;0;92;912;569;2;1483;NA;NA;NA;NA
4;REGIONAL;01/03/21;2021;9;Outro;All;55;42;0;97;967;611;2;1580;NA;NA;NA;NA
5;REGIONAL;08/03/21;2021;10;Outro;All;280;13;0;293;1247;624;2;1873;NA;NA;NA;NA
6;REGIONAL;15/03/21;2021;11;Outro;All;19;27;0;46;1266;651;2;1919;NA;NA;NA;NA
7;REGIONAL;22/03/21;2021;12;Outro;All;313;4;0;317;1579;655;2;2236;NA;NA;NA;NA
8;REGIONAL;29/03/21;2021;13;Outro;All;317;11;0;328;1896;666;2;2564;NA;NA;NA;NA
9;REGIONAL;05/04/21;2021;14;Outro;All;59;16;0;75;1955;682;2;2639;NA;NA;NA;NA
10;REGIONAL;12/04/21;2021;15;Outro;All;248;8;0;256;2203;690;2;2895;NA;NA;NA;NA
11;REGIONAL;19/04/21;2021;16;Outro;All;91;25;0;116;2294;715;2;3011;NA;NA;NA;NA
12;REGIONAL;26/04/21;2021;17;Outro;All;184;15;0;199;2478;730;2;3210;NA;NA;NA;NA
13;REGIONAL;03/05/21;2021;18;Outro;All;111;66;0;177;2589;796;2;3387;NA;NA;NA;NA
14;REGIONAL;10/05/21;2021;19;Outro;All;126;271;0;397;2715;1067;2;3784;NA;NA;NA;NA
15;REGIONAL;17/05/21;2021;20;Outro;All;116;192;0;308;2831;1259;2;4092;NA;NA;NA;NA
16;REGIONAL;24/05/21;2021;21;Outro;All;141;194;0;335;2972;1453;2;4427;NA;NA;NA;NA
17;REGIONAL;31/05/21;2021;22;Outro;All;237;355;0;592;3209;1808;2;5019;NA;NA;NA;NA
18;REGIONAL;08/02/21;2021;6;ARS Alentejo;All;3336;8777;1;12114;27555;17362;1;44918;0,059043476;0,037202426;NA;NA
19;REGIONAL;15/02/21;2021;7;ARS Alentejo;All;4054;2807;0;6861;31609;20169;1;51779;0,067730185;0,043217125;NA;NA
20;REGIONAL;22/02/21;2021;8;ARS Alentejo;All;12033;1647;0;13680;43642;21816;1;65459;0,093513896;0,046746234;NA;NA
21;REGIONAL;01/03/21;2021;9;ARS Alentejo;All;10432;2828;0;13260;54074;24644;1;78719;0,115867064;0,052805931;NA;NA
22;REGIONAL;08/03/21;2021;10;ARS Alentejo;All;5800;1670;0;7470;59874;26314;1;86189;0,128295014;0,056384324;NA;NA
23;REGIONAL;15/03/21;2021;11;ARS Alentejo;All;3682;7721;0;11403;63556;34035;1;97592;0,136184619;0,072928496;NA;NA
24;REGIONAL;22/03/21;2021;12;ARS Alentejo;All;11859;2098;0;13957;75415;36133;1;111549;0,161595492;0,077423986;NA;NA
25;REGIONAL;29/03/21;2021;13;ARS Alentejo;All;6117;6264;0;12381;81532;42397;1;123930;0,174702693;0,090846172;NA;NA
26;REGIONAL;05/04/21;2021;14;ARS Alentejo;All;14025;4287;0;18312;95557;46684;1;142242;0,204754762;0,100032141;NA;NA
27;REGIONAL;12/04/21;2021;15;ARS Alentejo;All;21832;2950;0;24782;117389;49634;1;167024;0,25153528;0,106353254;NA;NA
28;REGIONAL;19/04/21;2021;16;ARS Alentejo;All;11300;5941;2;17243;128689;55575;3;184267;0,275748355;0,119083332;NA;NA
29;REGIONAL;26/04/21;2021;17;ARS Alentejo;All;20148;2759;0;22907;148837;58334;3;207174;0,318920483;0,124995179;NA;NA
30;REGIONAL;03/05/21;2021;18;ARS Alentejo;All;13608;14275;1;27884;162445;72609;4;235058;0,348079025;0,155582935;NA;NA
31;REGIONAL;10/05/21;2021;19;ARS Alentejo;All;17333;15209;0;32542;179778;87818;4;267600;0,38521931;0,18817202;NA;NA
32;REGIONAL;17/05/21;2021;20;ARS Alentejo;All;13141;12164;1;25306;192919;99982;5;292906;0,413377188;0,214236431;NA;NA
33;REGIONAL;24/05/21;2021;21;ARS Alentejo;All;7122;18432;4;25558;200041;118414;9;318464;0,428637854;0,253731599;NA;NA
34;REGIONAL;31/05/21;2021;22;ARS Alentejo;All;17304;7204;0;24508;217345;125618;9;342972;0,465716;0,26916797;NA;NA
35;REGIONAL;08/02/21;2021;6;ARS Algarve;All;2381;2896;1;5278;12747;6307;1;19055;0,029075788;0,014386208;NA;NA
36;REGIONAL;15/02/21;2021;7;ARS Algarve;All;3179;2114;0;5293;15926;8421;1;24348;0,036327058;0,019208223;NA;NA
37;REGIONAL;22/02/21;2021;8;ARS Algarve;All;8478;1065;0;9543;24404;9486;1;33891;0,055665297;0,021637478;NA;NA
38;REGIONAL;01/03/21;2021;9;ARS Algarve;All;4617;549;0;5166;29021;10035;1;39057;0,066196631;0,022889741;NA;NA
39;REGIONAL;08/03/21;2021;10;ARS Algarve;All;5075;1535;0;6610;34096;11570;1;45667;0,077772658;0,026391062;NA;NA
40;REGIONAL;15/03/21;2021;11;ARS Algarve;All;2653;2994;0;5647;36749;14564;1;51314;0,083824126;0,033220348;NA;NA
41;REGIONAL;22/03/21;2021;12;ARS Algarve;All;9356;4284;0;13640;46105;18848;1;64954;0,105165075;0,042992112;NA;NA
42;REGIONAL;29/03/21;2021;13;ARS Algarve;All;4196;2907;0;7103;50301;21755;1;72057;0,114736112;0,049622952;NA;NA
43;REGIONAL;05/04/21;2021;14;ARS Algarve;All;8606;1765;0;10371;58907;23520;1;82428;0,134366318;0,053648901;NA;NA
44;REGIONAL;12/04/21;2021;15;ARS Algarve;All;13584;2141;0;15725;72491;25661;1;98153;0,165351295;0,058532502;NA;NA
45;REGIONAL;19/04/21;2021;16;ARS Algarve;All;7173;5480;0;12653;79664;31141;1;110806;0,181712842;0,071032331;NA;NA
46;REGIONAL;26/04/21;2021;17;ARS Algarve;All;16320;3224;0;19544;95984;34365;1;130350;0,218938609;0,078386245;NA;NA
47;REGIONAL;03/05/21;2021;18;ARS Algarve;All;16441;8890;1;25332;112425;43255;2;155682;0,256440377;0,098664252;NA;NA
48;REGIONAL;10/05/21;2021;19;ARS Algarve;All;9638;11259;0;20897;122063;54514;2;176579;0,278424565;0,124345926;NA;NA
49;REGIONAL;17/05/21;2021;20;ARS Algarve;All;11910;10847;2;22759;133973;65361;4;199338;0,305591164;0,149087832;NA;NA
50;REGIONAL;24/05/21;2021;21;ARS Algarve;All;7512;18720;7;26239;141485;84081;11;225577;0,322725966;0,191787977;NA;NA
51;REGIONAL;31/05/21;2021;22;ARS Algarve;All;8089;12713;0;20802;149574;96794;11;246379;0,3411769;0,220786212;NA;NA
52;REGIONAL;08/02/21;2021;6;ARS Centro;All;7478;27106;4;34588;79890;51039;8;130937;0,049133113;0,031389473;NA;NA
53;REGIONAL;15/02/21;2021;7;ARS Centro;All;25463;9954;3;35420;105353;60993;11;166357;0,064793102;0,037511278;NA;NA
54;REGIONAL;22/02/21;2021;8;ARS Centro;All;38325;3080;1;41406;143678;64073;12;207763;0,088363343;0,039405507;NA;NA
55;REGIONAL;01/03/21;2021;9;ARS Centro;All;28388;5881;1;34270;172066;69954;13;242033;0,105822234;0,043022378;NA;NA
56;REGIONAL;08/03/21;2021;10;ARS Centro;All;17495;13462;0;30957;189561;83416;13;272990;0,116581826;0,051301637;NA;NA
57;REGIONAL;15/03/21;2021;11;ARS Centro;All;16503;24089;2;40594;206064;107505;15;313584;0,126731329;0,066116602;NA;NA
58;REGIONAL;22/03/21;2021;12;ARS Centro;All;47557;4250;0;51807;253621;111755;15;365391;0,155979338;0,068730393;NA;NA
59;REGIONAL;29/03/21;2021;13;ARS Centro;All;24200;16636;2;40838;277821;128391;17;406229;0,170862569;0,078961692;NA;NA
60;REGIONAL;05/04/21;2021;14;ARS Centro;All;49745;10100;0;59845;327566;138491;17;466074;0,20145622;0,085173288;NA;NA
61;REGIONAL;12/04/21;2021;15;ARS Centro;All;77464;11905;1;89370;405030;150396;18;555444;0,24909732;0,092494977;NA;NA
62;REGIONAL;19/04/21;2021;16;ARS Centro;All;29898;24079;6;53983;434928;174475;24;609427;0,267484875;0,107303792;NA;NA
63;REGIONAL;26/04/21;2021;17;ARS Centro;All;56554;17823;0;74377;491482;192298;24;683804;0,302266126;0,118265107;NA;NA
64;REGIONAL;03/05/21;2021;18;ARS Centro;All;59841;48984;1;108826;551323;241282;25;792630;0,339068912;0,148390735;NA;NA
65;REGIONAL;10/05/21;2021;19;ARS Centro;All;50475;55496;0;105971;601798;296778;25;898601;0,37011152;0,182521305;NA;NA
66;REGIONAL;17/05/21;2021;20;ARS Centro;All;44647;41521;5;86173;646445;338299;30;984774;0,397569851;0,208057117;NA;NA
67;REGIONAL;24/05/21;2021;21;ARS Centro;All;23995;56103;10;80108;670440;394402;40;1064882;0,412327006;0,242560998;NA;NA
68;REGIONAL;31/05/21;2021;22;ARS Centro;All;44076;37425;2;81503;714516;431827;42;1146385;0,439434167;0,265577731;NA;NA
69;REGIONAL;08/02/21;2021;6;ARS Lisboa e Vale do Tejo;All;14289;30347;0;44636;114796;60798;1;175595;0,03108952;0,016465562;NA;NA
70;REGIONAL;15/02/21;2021;7;ARS Lisboa e Vale do Tejo;All;32891;19003;2;51896;147687;79801;3;227491;0,039997194;0,021612032;NA;NA
71;REGIONAL;22/02/21;2021;8;ARS Lisboa e Vale do Tejo;All;49037;6659;0;55696;196724;86460;3;283187;0,053277594;0,023415449;NA;NA
72;REGIONAL;01/03/21;2021;9;ARS Lisboa e Vale do Tejo;All;44759;12718;1;57478;241483;99178;4;340665;0,065399409;0,02685979;NA;NA
73;REGIONAL;08/03/21;2021;10;ARS Lisboa e Vale do Tejo;All;32973;16452;2;49427;274456;115630;6;390092;0,074329291;0,031315387;NA;NA
74;REGIONAL;15/03/21;2021;11;ARS Lisboa e Vale do Tejo;All;25545;28858;1;54404;300001;144488;7;444496;0,081247491;0,039130828;NA;NA
75;REGIONAL;22/03/21;2021;12;ARS Lisboa e Vale do Tejo;All;88275;7415;2;95692;388276;151903;9;540188;0,105154486;0,041138989;NA;NA
76;REGIONAL;29/03/21;2021;13;ARS Lisboa e Vale do Tejo;All;45079;23657;4;68740;433355;175560;13;608928;0,117362964;0,047545874;NA;NA
77;REGIONAL;05/04/21;2021;14;ARS Lisboa e Vale do Tejo;All;86826;19349;1;106176;520181;194909;14;715104;0,140877535;0,052786048;NA;NA
78;REGIONAL;12/04/21;2021;15;ARS Lisboa e Vale do Tejo;All;162842;14028;0;176870;683023;208937;14;891974;0,184979068;0,056585168;NA;NA
79;REGIONAL;19/04/21;2021;16;ARS Lisboa e Vale do Tejo;All;78428;53324;3;131755;761451;262261;17;1023729;0,206219258;0,071026591;NA;NA
80;REGIONAL;26/04/21;2021;17;ARS Lisboa e Vale do Tejo;All;106735;25254;3;131992;868186;287515;20;1155721;0,235125665;0,077865982;NA;NA
81;REGIONAL;03/05/21;2021;18;ARS Lisboa e Vale do Tejo;All;106816;64559;5;171380;975002;352074;25;1327101;0,264054009;0,095350113;NA;NA
82;REGIONAL;10/05/21;2021;19;ARS Lisboa e Vale do Tejo;All;89372;112079;8;201459;1064374;464153;33;1528560;0,288258098;0,125703804;NA;NA
83;REGIONAL;17/05/21;2021;20;ARS Lisboa e Vale do Tejo;All;108804;70328;4;179136;1173178;534481;37;1707696;0,317724839;0,144750319;NA;NA
84;REGIONAL;24/05/21;2021;21;ARS Lisboa e Vale do Tejo;All;109479;87809;43;197331;1282657;622290;80;1905027;0,347374388;0,16853111;NA;NA
85;REGIONAL;31/05/21;2021;22;ARS Lisboa e Vale do Tejo;All;91156;85676;13;176845;1373813;707966;93;2081872;0,372061627;0,191734233;NA;NA
86;REGIONAL;08/02/21;2021;6;ARS Norte;All;8677;28603;5;37285;105271;68871;6;174148;0,02944365;0,019262794;NA;NA
87;REGIONAL;15/02/21;2021;7;ARS Norte;All;32868;15017;3;47888;138139;83888;9;222036;0,038636627;0,023462957;NA;NA
88;REGIONAL;22/02/21;2021;8;ARS Norte;All;64591;4220;1;68812;202730;88108;10;290848;0,056702331;0,024643264;NA;NA
89;REGIONAL;01/03/21;2021;9;ARS Norte;All;47722;6942;0;54664;250452;95050;10;345512;0,070049881;0,026584899;NA;NA
90;REGIONAL;08/03/21;2021;10;ARS Norte;All;25216;13846;0;39062;275668;108896;10;384574;0,07710264;0,03045754;NA;NA
91;REGIONAL;15/03/21;2021;11;ARS Norte;All;26539;42156;4;68699;302207;151052;14;453273;0,084525435;0,042248313;NA;NA
92;REGIONAL;22/03/21;2021;12;ARS Norte;All;88362;2156;0;90518;390569;153208;14;543791;0,109239742;0,042851333;NA;NA
93;REGIONAL;29/03/21;2021;13;ARS Norte;All;53693;32475;1;86169;444262;185683;15;629960;0,124257343;0,051934391;NA;NA
94;REGIONAL;05/04/21;2021;14;ARS Norte;All;81983;13426;2;95411;526245;199109;17;725371;0,147187483;0,05568956;NA;NA
95;REGIONAL;12/04/21;2021;15;ARS Norte;All;135251;18984;1;154236;661496;218093;18;879607;0,185016354;0,060999268;NA;NA
96;REGIONAL;19/04/21;2021;16;ARS Norte;All;64495;46209;0;110704;725991;264302;18;990311;0,203055208;0,07392364;NA;NA
97;REGIONAL;26/04/21;2021;17;ARS Norte;All;125772;36474;0;162246;851763;300776;18;1152557;0,238232861;0,084125193;NA;NA
98;REGIONAL;03/05/21;2021;18;ARS Norte;All;154436;72675;2;227113;1006199;373451;20;1379670;0,281427658;0,104451943;NA;NA
99;REGIONAL;10/05/21;2021;19;ARS Norte;All;98747;100306;7;199060;1104946;473757;27;1578730;0,309046585;0,132506913;NA;NA
100;REGIONAL;17/05/21;2021;20;ARS Norte;All;109543;70369;6;179918;1214489;544126;33;1758648;0,339685087;0,152188688;NA;NA
101;REGIONAL;24/05/21;2021;21;ARS Norte;All;72132;127708;15;199855;1286621;671834;48;1958503;0,359859963;0,187907829;NA;NA
102;REGIONAL;31/05/21;2021;22;ARS Norte;All;54201;171013;34;225248;1340822;842847;82;2183751;0,375019648;0,235739111;NA;NA
103;REGIONAL;08/02/21;2021;6;RA_Madeira;All;3160;1086;0;4246;10997;4775;0;15772;0,043252024;0,018780432;NA;NA
104;REGIONAL;15/02/21;2021;7;RA_Madeira;All;2495;638;0;3133;13492;5413;0;18905;0,053065045;0,021289734;NA;NA
105;REGIONAL;22/02/21;2021;8;RA_Madeira;All;2257;2155;0;4412;15749;7568;0;23317;0,061941995;0,02976551;NA;NA
106;REGIONAL;01/03/21;2021;9;RA_Madeira;All;1432;3116;0;4548;17181;10684;0;27865;0,067574158;0,042020971;NA;NA
107;REGIONAL;08/03/21;2021;10;RA_Madeira;All;4885;2399;0;7284;22066;13083;0;35149;0,086787229;0,051456418;NA;NA
108;REGIONAL;15/03/21;2021;11;RA_Madeira;All;3104;2348;0;5452;25170;15431;0;40601;0,098995493;0,060691277;NA;NA
109;REGIONAL;22/03/21;2021;12;RA_Madeira;All;5275;181;0;5456;30445;15612;0;46057;0,119742462;0,061403164;NA;NA
110;REGIONAL;29/03/21;2021;13;RA_Madeira;All;1205;1260;0;2465;31650;16872;0;48522;0,124481817;0,066358838;NA;NA
111;REGIONAL;05/04/21;2021;14;RA_Madeira;All;10214;1299;0;11513;41864;18171;0;60035;0,164654243;0,071467902;NA;NA
112;REGIONAL;12/04/21;2021;15;RA_Madeira;All;8429;1299;0;9728;50293;19470;0;69763;0,197806131;0,076576966;NA;NA
113;REGIONAL;19/04/21;2021;16;RA_Madeira;All;9811;2128;0;11939;60104;21598;0;81702;0,236393528;0,08494655;NA;NA
114;REGIONAL;26/04/21;2021;17;RA_Madeira;All;8822;802;0;9624;68926;22400;0;91326;0,271091114;0,088100876;NA;NA
115;REGIONAL;03/05/21;2021;18;RA_Madeira;All;7603;5287;0;12890;76529;27687;0;104216;0,300994281;0,108895042;NA;NA
116;REGIONAL;10/05/21;2021;19;RA_Madeira;All;11598;6432;0;18030;88127;34119;0;122246;0,346610083;0,134192579;NA;NA
117;REGIONAL;17/05/21;2021;20;RA_Madeira;All;2328;7610;0;9938;90455;41729;0;132184;0,355766281;0,164123278;NA;NA
118;REGIONAL;24/05/21;2021;21;RA_Madeira;All;3436;8970;0;12406;93891;50699;0;144590;0,369280326;0,199402959;NA;NA
119;REGIONAL;31/05/21;2021;22;RA_Madeira;All;7557;10932;0;18489;101448;61631;0;163079;0,399002572;0,242399333;NA;NA
120;REGIONAL;08/02/21;2021;6;RA_Acores;All;1051;1;0;1052;8653;5334;0;13987;0,035638973;0,02196906;NA;NA
121;REGIONAL;15/02/21;2021;7;RA_Acores;All;2057;322;0;2379;10710;5656;0;16366;0,044111106;0,023295277;NA;NA
122;REGIONAL;22/02/21;2021;8;RA_Acores;All;1466;1611;8;3085;12176;7267;8;19451;0,050149096;0,029930477;NA;NA
123;REGIONAL;01/03/21;2021;9;RA_Acores;All;755;1155;14;1924;12931;8422;22;21375;0,053258703;0,034687557;NA;NA
124;REGIONAL;08/03/21;2021;10;RA_Acores;All;2599;2053;0;4652;15530;10475;22;26027;0,063963162;0,043143215;NA;NA
125;REGIONAL;15/03/21;2021;11;RA_Acores;All;2522;1438;0;3960;18052;11913;22;29987;0,074350484;0,049065882;NA;NA
126;REGIONAL;22/03/21;2021;12;RA_Acores;All;4104;726;0;4830;22156;12639;22;34817;0,091253563;0,052056047;NA;NA
127;REGIONAL;29/03/21;2021;13;RA_Acores;All;1964;758;0;2722;24120;13397;22;37539;0,099342658;0,05517801;NA;NA
128;REGIONAL;05/04/21;2021;14;RA_Acores;All;3837;2327;0;6164;27957;15724;22;43703;0,115146049;0,064762187;NA;NA
129;REGIONAL;12/04/21;2021;15;RA_Acores;All;4215;2404;0;6619;32172;18128;22;50322;0,132506302;0,074663504;NA;NA
130;REGIONAL;19/04/21;2021;16;RA_Acores;All;7820;1054;0;8874;39992;19182;22;59196;0,16471441;0,079004596;NA;NA
131;REGIONAL;26/04/21;2021;17;RA_Acores;All;9066;2612;1;11679;49058;21794;23;70875;0,2020544;0,089762599;NA;NA
132;REGIONAL;03/05/21;2021;18;RA_Acores;All;9017;2727;0;11744;58075;24521;23;82619;0,239192573;0,10099425;NA;NA
133;REGIONAL;10/05/21;2021;19;RA_Acores;All;8238;2242;0;10480;66313;26763;23;93099;0,273122292;0,11022834;NA;NA
134;REGIONAL;17/05/21;2021;20;RA_Acores;All;11022;4131;0;15153;77335;30894;23;108252;0,318518427;0,127242623;NA;NA
135;REGIONAL;24/05/21;2021;21;RA_Acores;All;4802;7164;3;11969;82137;38058;26;120221;0,338296348;0,156748876;NA;NA
136;REGIONAL;31/05/21;2021;22;RA_Acores;All;3721;8451;2;12174;85858;46509;28;132395;0,353621971;0,191555874;NA;NA
137;AGES;08/02/21;2021;6;All;0-17 anos;37;67;0;104;173;71;0;244;0,000100754;4,13E-05;NA;NA
138;AGES;08/02/21;2021;6;All;18-24 anos;1453;3040;0;4493;12176;6790;0;18966;0,01569677;0,008753373;NA;NA
139;AGES;08/02/21;2021;6;All;25-49 anos;13705;30712;5;44422;144311;91291;10;235612;0,042941357;0,027164661;NA;NA
140;AGES;08/02/21;2021;6;All;50-64 anos;6793;22174;1;28968;84288;52346;3;136637;0,038984663;0,024210934;NA;NA
141;AGES;08/02/21;2021;6;All;65-79 anos;3632;11444;3;15079;35483;18661;3;54147;0,022113837;0,011629972;NA;NA
142;AGES;08/02/21;2021;6;All;80 ou mais anos;14821;31499;2;46322;84169;45771;2;129942;0,124535594;0,067722305;NA;NA
143;AGES;08/02/21;2021;6;All;Desconhecido;0;0;0;0;0;0;0;0;NA;NA;NA;NA
144;AGES;15/02/21;2021;7;All;0-17 anos;30;16;0;46;203;87;0;290;0,000118226;5,07E-05;NA;NA
145;AGES;15/02/21;2021;7;All;18-24 anos;2308;1727;0;4035;14484;8517;0;23001;0,018672143;0,010979746;NA;NA
146;AGES;15/02/21;2021;7;All;25-49 anos;22195;18908;4;41107;166506;110199;14;276719;0,049545728;0,032790949;NA;NA
147;AGES;15/02/21;2021;7;All;50-64 anos;25015;12891;1;37907;109303;65237;4;174544;0,050554535;0,030173245;NA;NA
148;AGES;15/02/21;2021;7;All;65-79 anos;5001;7185;2;12188;40484;25846;5;66335;0,025230577;0,016107833;NA;NA
149;AGES;15/02/21;2021;7;All;80 ou mais anos;48605;9234;2;57841;132774;55005;4;187783;0,196451056;0,081384837;NA;NA
150;AGES;15/02/21;2021;7;All;Desconhecido;0;0;0;0;0;0;0;0;NA;NA;NA;NA
151;AGES;22/02/21;2021;8;All;0-17 anos;21;32;0;53;224;119;0;343;0,000130456;6,93E-05;NA;NA
152;AGES;22/02/21;2021;8;All;18-24 anos;1261;692;0;1953;15745;9209;0;24954;0,020297769;0,011871842;NA;NA
153;AGES;22/02/21;2021;8;All;25-49 anos;11259;7224;7;18490;177765;117423;21;295209;0,05289597;0,034940531;NA;NA
154;AGES;22/02/21;2021;8;All;50-64 anos;49654;4920;3;54577;158957;70157;7;229121;0,073520372;0,032448831;NA;NA
155;AGES;22/02/21;2021;8;All;65-79 anos;11548;2404;0;13952;52032;28250;5;80287;0,032427561;0,017606062;NA;NA
156;AGES;22/02/21;2021;8;All;80 ou mais anos;102517;5184;0;107701;235291;60189;4;295484;0,348134163;0,08905503;NA;NA
157;AGES;22/02/21;2021;8;All;Desconhecido;0;0;0;0;0;0;0;0;NA;NA;NA;NA
158;AGES;01/03/21;2021;9;All;0-17 anos;8;28;0;36;232;147;0;379;0,000135115;8,56E-05;NA;NA
159;AGES;01/03/21;2021;9;All;18-24 anos;881;1021;0;1902;16626;10230;0;26856;0,021433516;0,013188071;NA;NA
160;AGES;01/03/21;2021;9;All;25-49 anos;7201;9839;8;17048;184966;127262;29;312257;0,055038708;0,037868236;NA;NA
161;AGES;01/03/21;2021;9;All;50-64 anos;29899;5902;5;35806;188856;76059;12;264927;0,087349179;0,035178608;NA;NA
162;AGES;01/03/21;2021;9;All;65-79 anos;13035;3721;2;16758;65067;31971;7;97045;0,040551279;0,019925076;NA;NA
163;AGES;01/03/21;2021;9;All;80 ou mais anos;87136;12720;1;99857;322427;72909;5;395341;0,4770597;0,107875413;NA;NA
164;AGES;01/03/21;2021;9;All;Desconhecido;0;0;0;0;0;0;0;0;NA;NA;NA;NA
165;AGES;08/03/21;2021;10;All;0-17 anos;12;24;0;36;244;171;0;415;0,000142104;9,96E-05;NA;NA
166;AGES;08/03/21;2021;10;All;18-24 anos;1302;626;0;1928;17928;10856;0;28784;0,023111998;0,013995083;NA;NA
167;AGES;08/03/21;2021;10;All;25-49 anos;15755;5918;0;21673;200721;133180;29;333930;0,059726785;0,039629203;NA;NA
168;AGES;08/03/21;2021;10;All;50-64 anos;21738;4164;0;25902;210594;80223;12;290829;0,097403381;0,03710453;NA;NA
169;AGES;08/03/21;2021;10;All;65-79 anos;15450;3461;0;18911;80517;35432;7;115956;0,05018008;0,022082052;NA;NA
170;AGES;08/03/21;2021;10;All;80 ou mais anos;40066;37237;2;77305;362493;110146;7;472646;0,536340945;0,162970898;NA;NA
171;AGES;08/03/21;2021;10;All;Desconhecido;0;0;0;0;0;0;0;0;NA;NA;NA;NA
172;AGES;15/03/21;2021;11;All;0-17 anos;1;23;0;24;245;194;0;439;0,000142687;0,000112984;NA;NA
173;AGES;15/03/21;2021;11;All;18-24 anos;227;368;1;596;18155;11224;1;29380;0,023404637;0,014469493;NA;NA
174;AGES;15/03/21;2021;11;All;25-49 anos;4071;2953;0;7024;204792;136133;29;340954;0,060938157;0,040507901;NA;NA
175;AGES;15/03/21;2021;11;All;50-64 anos;4022;2239;0;6261;214616;82462;12;297090;0,099263626;0,038140107;NA;NA
176;AGES;15/03/21;2021;11;All;65-79 anos;17918;6735;2;24655;98435;42167;9;140611;0,061346998;0,026279462;NA;NA
177;AGES;15/03/21;2021;11;All;80 ou mais anos;54328;97313;4;151645;416821;207459;11;624291;0,616724099;0,30695422;NA;NA
178;AGES;15/03/21;2021;11;All;Desconhecido;0;0;0;0;0;0;0;0;NA;NA;NA;NA
179;AGES;22/03/21;2021;12;All;0-17 anos;24;7;0;31;269;201;0;470;0,000156664;0,000117061;NA;NA
180;AGES;22/03/21;2021;12;All;18-24 anos;3105;113;0;3218;21260;11337;1;32598;0,027407468;0,014615167;NA;NA
181;AGES;22/03/21;2021;12;All;25-49 anos;41386;1188;0;42574;246178;137321;29;383528;0,073253026;0,040861404;NA;NA
182;AGES;22/03/21;2021;12;All;50-64 anos;33724;868;0;34592;248340;83330;12;331682;0,114861562;0,038541572;NA;NA
183;AGES;22/03/21;2021;12;All;65-79 anos;52372;2081;0;54453;150807;44248;9;195064;0,093986455;0,02757639;NA;NA
184;AGES;22/03/21;2021;12;All;80 ou mais anos;124490;16857;2;141349;541311;224316;13;765640;0,800918233;0,331895665;NA;NA
185;AGES;22/03/21;2021;12;All;Desconhecido;0;0;0;0;0;0;0;0;NA;NA;NA;NA
186;AGES;29/03/21;2021;13;All;0-17 anos;7;12;0;19;276;213;0;489;0,000160741;0,00012405;NA;NA
187;AGES;29/03/21;2021;13;All;18-24 anos;617;64;1;682;21877;11401;2;33280;0,028202877;0,014697673;NA;NA
188;AGES;29/03/21;2021;13;All;25-49 anos;4186;736;1;4923;250364;138057;30;388451;0,074498617;0,041080409;NA;NA
189;AGES;29/03/21;2021;13;All;50-64 anos;7446;646;1;8093;255786;83976;13;339775;0,118305466;0,038840358;NA;NA
190;AGES;29/03/21;2021;13;All;65-79 anos;87800;7216;1;95017;238607;51464;10;290081;0,148705471;0,03207357;NA;NA
191;AGES;29/03/21;2021;13;All;80 ou mais anos;36715;75294;3;112012;578026;299610;16;877652;0,855241373;0,4432999;NA;NA
192;AGES;29/03/21;2021;13;All;Desconhecido;0;0;0;0;0;0;0;0;NA;NA;NA;NA
193;AGES;05/04/21;2021;14;All;0-17 anos;14;1;0;15;290;214;0;504;0,000168894;0,000124632;NA;NA
194;AGES;05/04/21;2021;14;All;18-24 anos;708;105;0;813;22585;11506;2;34093;0,0291156;0,014833035;NA;NA
195;AGES;05/04/21;2021;14;All;25-49 anos;8465;844;0;9309;258829;138901;30;397760;0,077017472;0,041331551;NA;NA
196;AGES;05/04/21;2021;14;All;50-64 anos;14828;741;0;15569;270614;84717;13;355344;0,125163673;0,039183083;NA;NA
197;AGES;05/04/21;2021;14;All;65-79 anos;200922;5139;0;206061;439529;56603;10;496142;0,273924768;0,035276315;NA;NA
198;AGES;05/04/21;2021;14;All;80 ou mais anos;30358;45739;3;76100;608384;345349;19;953752;0,90015876;0,510974857;NA;NA
199;AGES;05/04/21;2021;14;All;Desconhecido;0;0;0;0;0;0;0;0;NA;NA;NA;NA
200;AGES;12/04/21;2021;15;All;0-17 anos;37;2;0;39;327;216;0;543;0,000190443;0,000125797;NA;NA
201;AGES;12/04/21;2021;15;All;18-24 anos;4239;55;0;4294;26824;11561;2;38387;0,034580334;0,014903939;NA;NA
202;AGES;12/04/21;2021;15;All;25-49 anos;88695;474;0;89169;347524;139375;30;486929;0,103409665;0,041472595;NA;NA
203;AGES;12/04/21;2021;15;All;50-64 anos;87565;391;0;87956;358179;85108;13;443300;0,165664006;0,039363928;NA;NA
204;AGES;12/04/21;2021;15;All;65-79 anos;232843;3404;1;236248;672372;60007;11;732390;0,41903798;0,037397768;NA;NA
205;AGES;12/04/21;2021;15;All;80 ou mais anos;10486;49393;1;59880;618870;394742;20;1013632;0,915673739;0,584056236;NA;NA
206;AGES;12/04/21;2021;15;All;Desconhecido;0;0;0;0;0;0;0;0;NA;NA;NA;NA
207;AGES;19/04/21;2021;16;All;0-17 anos;20;4;0;24;347;220;0;567;0,000202091;0,000128127;NA;NA
208;AGES;19/04/21;2021;16;All;18-24 anos;1258;55;0;1313;28082;11616;2;39700;0,036202093;0,014974842;NA;NA
209;AGES;19/04/21;2021;16;All;25-49 anos;10294;497;0;10791;357818;139872;30;497720;0,10647276;0,041620483;NA;NA
210;AGES;19/04/21;2021;16;All;50-64 anos;13856;1566;0;15422;372035;86674;13;458722;0,172072647;0,04008823;NA;NA
211;AGES;19/04/21;2021;16;All;65-79 anos;175181;13071;2;188254;847553;73078;13;920644;0,528214882;0,045543921;NA;NA
212;AGES;19/04/21;2021;16;All;80 ou mais anos;8407;123047;9;131463;627277;517789;29;1145095;0,92811265;0,766115322;NA;NA
213;AGES;19/04/21;2021;16;All;Desconhecido;0;0;0;0;0;0;0;0;NA;NA;NA;NA
214;AGES;26/04/21;2021;17;All;0-17 anos;43;14;0;57;390;234;0;624;0,000227134;0,00013628;NA;NA
215;AGES;26/04/21;2021;17;All;18-24 anos;2606;77;0;2683;30688;11693;2;42383;0,039561635;0,015074107;NA;NA
216;AGES;26/04/21;2021;17;All;25-49 anos;9920;597;1;10518;367738;140469;31;508238;0,109424567;0,041798127;NA;NA
217;AGES;26/04/21;2021;17;All;50-64 anos;32304;2660;0;34964;404339;89334;13;493686;0,187013808;0,041318526;NA;NA
218;AGES;26/04/21;2021;17;All;65-79 anos;292612;45967;0;338579;1140165;119045;13;1259223;0,710577535;0,074191632;NA;NA
219;AGES;26/04/21;2021;17;All;80 ou mais anos;6116;39648;3;45767;633393;557437;32;1190862;0,937161821;0,824778099;NA;NA
220;AGES;26/04/21;2021;17;All;Desconhecido;0;0;0;0;0;0;0;0;NA;NA;NA;NA
221;AGES;03/05/21;2021;18;All;0-17 anos;98;8;0;106;488;242;0;730;0,000284208;0,000140939;NA;NA
222;AGES;03/05/21;2021;18;All;18-24 anos;1697;704;0;2401;32385;12397;2;44784;0,041749334;0,015981673;NA;NA
223;AGES;03/05/21;2021;18;All;25-49 anos;8964;7371;0;16335;376702;147840;31;524573;0,112091906;0,04399145;NA;NA
224;AGES;03/05/21;2021;18;All;50-64 anos;150258;14226;0;164484;554597;103560;13;658170;0,256510741;0,047898298;NA;NA
225;AGES;03/05/21;2021;18;All;65-79 anos;201779;163434;7;365220;1341944;282479;20;1624443;0,836330934;0,17604753;NA;NA
226;AGES;03/05/21;2021;18;All;80 ou mais anos;5077;31720;3;36800;638470;589157;35;1227662;0,944673699;0,871710687;NA;NA
227;AGES;03/05/21;2021;18;All;Desconhecido;0;0;0;0;0;0;0;0;NA;NA;NA;NA
228;AGES;10/05/21;2021;19;All;0-17 anos;131;31;0;162;619;273;0;892;0,000360502;0,000158994;NA;NA
229;AGES;10/05/21;2021;19;All;18-24 anos;2070;5312;2;7384;34455;17709;4;52168;0,044417888;0,022829673;NA;NA
230;AGES;10/05/21;2021;19;All;25-49 anos;23533;99347;4;122884;400235;247187;35;647457;0,119094414;0,073553265;NA;NA
231;AGES;10/05/21;2021;19;All;50-64 anos;165030;108888;4;273922;719627;212448;17;932092;0,332839981;0,098260888;NA;NA
232;AGES;10/05/21;2021;19;All;65-79 anos;91014;79792;3;170809;1432958;362271;23;1795252;0,893052991;0,225775773;NA;NA
233;AGES;10/05/21;2021;19;All;80 ou mais anos;3749;9924;2;13675;642219;599081;37;1241337;0,950220681;0,886394136;NA;NA
234;AGES;10/05/21;2021;19;All;Desconhecido;0;0;0;0;0;0;0;0;NA;NA;NA;NA
235;AGES;17/05/21;2021;20;All;0-17 anos;270;16;0;286;889;289;0;1178;0,000517748;0,000168312;NA;NA
236;AGES;17/05/21;2021;20;All;18-24 anos;1894;2377;2;4273;36349;20086;6;56441;0,04685955;0,025893998;NA;NA
237;AGES;17/05/21;2021;20;All;25-49 anos;30629;21007;2;51638;430864;268194;37;699095;0,128208417;0,079804133;NA;NA
238;AGES;17/05/21;2021;20;All;50-64 anos;223013;74166;4;297183;942640;286614;21;1229275;0,435987366;0,132563951;NA;NA
239;AGES;17/05/21;2021;20;All;65-79 anos;41006;111263;9;152278;1473964;473534;32;1947530;0,918608891;0,295117481;NA;NA
240;AGES;17/05/21;2021;20;All;80 ou mais anos;4699;8333;1;13033;646918;607414;38;1254370;0,957173273;0,898723558;NA;NA
241;AGES;17/05/21;2021;20;All;Desconhecido;0;0;0;0;0;0;0;0;NA;NA;NA;NA
242;AGES;24/05/21;2021;21;All;0-17 anos;218;35;0;253;1107;324;0;1431;0,00064471;0,000188696;NA;NA
243;AGES;24/05/21;2021;21;All;18-24 anos;2016;3142;5;5163;38365;23228;11;61604;0,04945849;0,029944528;NA;NA
244;AGES;24/05/21;2021;21;All;25-49 anos;24686;17103;26;41815;455550;285297;63;740910;0,135554013;0,084893323;NA;NA
245;AGES;24/05/21;2021;21;All;50-64 anos;173887;96888;31;270806;1116527;383502;52;1500081;0,516413122;0,177376333;NA;NA
246;AGES;24/05/21;2021;21;All;65-79 anos;23395;201690;20;225105;1497359;675224;52;2172635;0,933189203;0,420815413;NA;NA
247;AGES;24/05/21;2021;21;All;80 ou mais anos;4417;6242;0;10659;651335;613656;38;1265029;0,963708621;0,907959157;NA;NA
248;AGES;24/05/21;2021;21;All;Desconhecido;0;0;0;0;0;0;0;0;NA;NA;NA;NA
249;AGES;31/05/21;2021;22;All;0-17 anos;186;89;0;275;1293;413;0;1706;0,000753036;0,000240529;NA;NA
250;AGES;31/05/21;2021;22;All;18-24 anos;2007;2481;1;4489;40372;25709;12;66093;0,052045827;0,033142925;NA;NA
251;AGES;31/05/21;2021;22;All;25-49 anos;40237;21659;9;61905;495787;306956;72;802815;0,147526984;0,091338201;NA;NA
252;AGES;31/05/21;2021;22;All;50-64 anos;162363;166850;12;329225;1278890;550352;64;1829306;0,591508829;0,254547355;NA;NA
253;AGES;31/05/21;2021;22;All;65-79 anos;18515;136750;24;155289;1515874;811974;76;2327924;0,944728184;0,506041216;NA;NA
254;AGES;31/05/21;2021;22;All;80 ou mais anos;3033;5940;5;8978;654368;619596;43;1274007;0,968196217;0,916747921;NA;NA
255;AGES;31/05/21;2021;22;All;Desconhecido;0;0;0;0;1;0;0;1;NA;NA;NA;NA
256;GENERAL;08/02/21;2021;6;All;All;40441;98936;11;139388;360601;214930;18;575549;0,035023717;0,020875282;651900;571981
257;GENERAL;15/02/21;2021;7;All;All;103154;49961;9;153124;463755;264891;27;728673;0,045042648;0,025727791;830730;718143
258;GENERAL;22/02/21;2021;8;All;All;176260;20456;10;196726;640015;285347;37;925399;0,062162068;0,0277146;1002999;933847
259;GENERAL;01/03/21;2021;9;All;All;138160;33231;16;171407;778175;318578;53;1096806;0,07558099;0,030942193;1186389;1095103
260;GENERAL;08/03/21;2021;10;All;All;94323;51430;2;145755;872498;370008;55;1242561;0,084742202;0,035937381;1468929;1264093
261;GENERAL;15/03/21;2021;11;All;All;80567;109631;7;190205;953065;479639;62;1432766;0,092567349;0,046585396;1713540;1462079
262;GENERAL;22/03/21;2021;12;All;All;255101;21114;2;276217;1208166;500753;64;1708983;0,117344277;0,048636114;1883850;1753999
263;GENERAL;29/03/21;2021;13;All;All;136771;83968;7;220746;1344937;584721;71;1929729;0,130628291;0,056791586;2344530;1996561
264;GENERAL;05/04/21;2021;14;All;All;255295;52569;3;307867;1600232;637290;74;2237596;0,155424062;0,0618974;2684460;2360167
265;GENERAL;12/04/21;2021;15;All;All;423865;53719;2;477586;2024097;691009;76;2715182;0,196592355;0,067114909;2983590;2679813
266;GENERAL;19/04/21;2021;16;All;All;209016;138240;11;347267;2233113;829249;87;3062449;0,216893234;0,080541602;3400260;3039329
267;GENERAL;26/04/21;2021;17;All;All;343601;88963;4;432568;2576714;918212;91;3495017;0,250265809;0,089182218;4128420;3581288
268;GENERAL;03/05/21;2021;18;All;All;367873;217463;10;585346;2944587;1135675;101;4080363;0,285995826;0,11030352;4655370;4171038
269;GENERAL;10/05/21;2021;19;All;All;285527;303294;15;588836;3230114;1438969;116;4669199;0,313727909;0,139761239;5197920;4686071
270;GENERAL;17/05/21;2021;20;All;All;301511;217162;18;518691;3531625;1656131;134;5187890;0,343012453;0,160853306;5728470;5126418
271;GENERAL;24/05/21;2021;21;All;All;228619;325100;82;553801;3760244;1981231;216;5741691;0,365217292;0,192428954;6254220;5644760
272;GENERAL;31/05/21;2021;22;All;All;226341;333769;51;560161;3986585;2315000;267;6301852;0,387200878;0,224846587;7263540;6299315