"";"TYPE";"DATE";"YEAR";"WEEK";"REGION";"AGEGROUP";"TOTAL_VAC_1";"TOTAL_VAC_2";"TOTAL_VAC_UNK";"TOTAL";"CUMUL_VAC_1";"CUMUL_VAC_2";"CUMUL_VAC_UNK";"CUMUL";"CUMUL_VAC_INIT";"CUMUL_VAC_COMPLETE";"CUMUL_VAC_LEAST";"COVER_1_VAC";"COVER_INIT";"COVER_COMPLETE";"COVER_LEAST"
"1";"REGIONAL";2021-01-04;2021;1;"ARS Alentejo";"All";3477;1;0;3478;4704;1;0;4705;4703;1;4704;0,0100340868852949;0,0100319537885931;2,13309670180588e-06;0,0100340868852949
"2";"REGIONAL";2021-01-11;2021;2;"ARS Alentejo";"All";5357;11;0;5368;10061;12;0;10073;10047;14;10061;0,021461085916869;0,0214312225630437;2,98633538252823e-05;0,021461085916869
"3";"REGIONAL";2021-01-18;2021;3;"ARS Alentejo";"All";10430;1133;0;11563;20491;1145;0;21636;19340;1151;20491;0,0437092845167043;0,0412540902129257;0,00245519430377857;0,0437092845167043
"4";"REGIONAL";2021-01-25;2021;4;"ARS Alentejo";"All";2298;3122;0;5420;22789;4267;0;27056;18513;4276;22789;0,0486111407374542;0,0394900192405322;0,00912112149692194;0,0486111407374542
"5";"REGIONAL";2021-02-01;2021;5;"ARS Alentejo";"All";1454;4342;0;5796;24243;8609;0;32852;15624;8619;24243;0,0517126633418799;0,0333275028690151;0,0183851604728649;0,0517126633418799
"6";"REGIONAL";2021-02-08;2021;6;"ARS Alentejo";"All";3335;8782;0;12117;27578;17391;0;44969;10173;17405;27578;0,0588265408424025;0,0216999927474712;0,0371265480949313;0,0588265408424025
"7";"REGIONAL";2021-02-15;2021;7;"ARS Alentejo";"All";4060;2812;0;6872;31638;20203;0;51841;11421;20217;31638;0,0674869134517344;0,024362097431325;0,0431248160204095;0,0674869134517344
"8";"REGIONAL";2021-02-22;2021;8;"ARS Alentejo";"All";12033;1652;0;13685;43671;21855;0;65526;21798;21873;43671;0,0931544660645646;0,0464972419059646;0,0466572241586;0,0931544660645646
"9";"REGIONAL";2021-03-01;2021;9;"ARS Alentejo";"All";10462;2836;1;13299;54133;24691;1;78825;29419;24714;54133;0,115470923758858;0,0627535718704272;0,0527173518884305;0,115470923758858
"10";"REGIONAL";2021-03-08;2021;10;"ARS Alentejo";"All";5832;1672;0;7504;59965;26363;1;86329;33570;26395;59965;0,12791114372379;0,0716080562796234;0,0563030874441662;0,12791114372379
"11";"REGIONAL";2021-03-15;2021;11;"ARS Alentejo";"All";3712;7732;0;11444;63677;34095;1;97773;29550;34128;63678;0,135829198680893;0,0630330075383637;0,0727983242392311;0,135831331777595
"12";"REGIONAL";2021-03-22;2021;12;"ARS Alentejo";"All";11913;2110;0;14023;75590;36205;1;111796;39352;36240;75592;0,161240779689506;0,083941621409465;0,0773034244734451;0,16124504588291
"13";"REGIONAL";2021-03-29;2021;13;"ARS Alentejo";"All";6157;6281;0;12438;81747;42486;1;124234;39225;42524;81749;0,174374256082525;0,0836707181283356;0,0907078041475932;0,174378522275929
"14";"REGIONAL";2021-04-05;2021;14;"ARS Alentejo";"All";14056;4306;0;18362;95803;46792;1;142596;48972;46835;95807;0,204357063323109;0,104462011680838;0,0999035840290784;0,204365595709916
"15";"REGIONAL";2021-04-12;2021;15;"ARS Alentejo";"All";21911;2967;0;24878;117714;49759;1;167474;67913;49806;117719;0,251095345156377;0,144864996309743;0,106241014330144;0,251106010639886
"16";"REGIONAL";2021-04-19;2021;16;"ARS Alentejo";"All";11373;5960;1;17334;129087;55719;2;184808;73323;55769;129092;0,275355053946016;0,156405049466513;0,118960669963012;0,275365719429525
"17";"REGIONAL";2021-04-26;2021;17;"ARS Alentejo";"All";20219;2781;0;23000;149306;58500;2;207808;90764;58553;149317;0,318484136159829;0,193608389042709;0,12489921118084;0,318507600223549
"18";"REGIONAL";2021-05-03;2021;18;"ARS Alentejo";"All";13679;14321;1;28001;162985;72821;3;235809;93227;72884;166111;0,347662765943831;0,198862206219257;0,15546862001442;0,354330826233676
"19";"REGIONAL";2021-05-10;2021;19;"ARS Alentejo";"All";17432;15263;0;32695;180417;88084;3;268504;95884;88165;184049;0,384846907649711;0,204529844155955;0,188064470714715;0,39259431487067
"20";"REGIONAL";2021-05-17;2021;20;"ARS Alentejo";"All";13220;12215;1;25436;193637;100299;4;293940;100189;100494;200683;0,413046446047585;0,213712825457229;0,21436341995128;0,428076245408509
"21";"REGIONAL";2021-05-24;2021;21;"ARS Alentejo";"All";7199;18514;0;25713;200836;118813;4;319653;90550;119461;210011;0,428402609203886;0,193151906348522;0,254821865094432;0,447973771442955
"22";"REGIONAL";2021-05-31;2021;22;"ARS Alentejo";"All";17396;7296;0;24692;218232;126109;4;344345;100246;127502;227748;0,465509959428501;0,213834411969232;0,271974095673653;0,485808507642885
"23";"REGIONAL";2021-06-07;2021;23;"ARS Alentejo";"All";13812;15263;0;29075;232044;141372;4;373420;98834;143360;242194;0,494972291073844;0,210822479426282;0,305800743170891;0,516623222597173
"24";"REGIONAL";2021-06-14;2021;24;"ARS Alentejo";"All";10229;19238;1;29468;242273;160610;5;402888;91030;163067;254097;0,516791737236616;0,194175792765389;0,347837679873379;0,542013472638769
"25";"REGIONAL";2021-06-21;2021;25;"ARS Alentejo";"All";10551;14178;1;24730;252824;174788;6;427618;89478;177940;267418;0,53929804053737;0,190865226684187;0,379563227119338;0,570428453803525
"26";"REGIONAL";2021-06-28;2021;26;"ARS Alentejo";"All";10978;28743;3;39724;263802;203531;9;467342;73155;207337;280492;0,562715176129795;0,156046689220609;0,442269870862326;0,598316560082935
"27";"REGIONAL";2021-07-05;2021;27;"ARS Alentejo";"All";15350;27800;1;43151;279152;231331;10;510493;60034;236513;296547;0,595458210502515;0,128058327396214;0,504505100234214;0,632563427630428
"28";"REGIONAL";2021-07-12;2021;28;"ARS Alentejo";"All";8192;20297;1;28490;287344;251628;11;538983;49931;258286;308217;0,612932538683709;0,106507651417869;0,550949014722633;0,657456666140503
"29";"REGIONAL";2021-07-19;2021;29;"ARS Alentejo";"All";3519;16730;3;20252;290863;268358;14;559235;39784;276290;316074;0,620438905977364;0,0848631191846451;0,589353287741947;0,674216406926592
"30";"REGIONAL";2021-07-26;2021;30;"ARS Alentejo";"All";2244;16493;0;18737;293107;284851;14;577972;29124;293806;322930;0,625225574976216;0,0621243083433944;0,626716609570778;0,688840917914173
"31";"REGIONAL";2021-08-02;2021;31;"ARS Alentejo";"All";4954;19961;13;24928;298061;304812;27;602900;19072;314889;333961;0,635792936036962;0,0406824202968417;0,671688687334952;0,712371107631793
"32";"REGIONAL";2021-08-09;2021;32;"ARS Alentejo";"All";14848;14406;0;29254;312909;319218;27;632154;25154;330951;356105;0,667465155865376;0,0536559144372251;0,705950486559358;0,759606400996583
"33";"REGIONAL";2021-08-16;2021;33;"ARS Alentejo";"All";22145;6564;0;28709;335054;325782;27;660863;42351;339713;382064;0,714702582326867;0,0903387784181808;0,724640679860581;0,814979458278762
"34";"REGIONAL";2021-08-23;2021;34;"ARS Alentejo";"All";12927;4576;0;17503;347981;330358;27;678366;51412;345709;397121;0,742277123391112;0,109666767633244;0,737430727684609;0,847097495317853
"35";"REGIONAL";2021-08-30;2021;35;"ARS Alentejo";"All";4730;15763;3;20496;352711;346121;30;698862;41057;362415;403472;0,752366670790654;0,087578551286044;0,773066241184978;0,860644792471022
"36";"REGIONAL";2021-01-04;2021;1;"ARS Algarve";"All";1256;3;0;1259;2319;3;0;2322;2315;4;2319;0,00496048086075787;0,00495192461951465;8,55624124322185e-06;0,00496048086075787
"37";"REGIONAL";2021-01-11;2021;2;"ARS Algarve";"All";1358;4;0;1362;3677;7;0;3684;3667;10;3677;0,00786532476283169;0,00784393415972363;2,13906031080546e-05;0,00786532476283169
"38";"REGIONAL";2021-01-18;2021;3;"ARS Algarve";"All";3394;946;0;4340;7071;953;0;8024;6115;956;7071;0,0151252954577054;0,0130803538005754;0,00204494165713002;0,0151252954577054
"39";"REGIONAL";2021-01-25;2021;4;"ARS Algarve";"All";2149;1229;0;3378;9220;2182;0;11402;7035;2185;9220;0,0197221360656264;0,0150482892865164;0,00467384677910994;0,0197221360656264
"40";"REGIONAL";2021-02-01;2021;5;"ARS Algarve";"All";1218;1244;0;2462;10438;3426;0;13864;7010;3429;10439;0,0223275115241874;0,0149948127787463;0,00733483780575193;0,0223296505844982
"41";"REGIONAL";2021-02-08;2021;6;"ARS Algarve";"All";2404;2897;0;5301;12842;6323;0;19165;6515;6328;12843;0,0274698125113638;0,0139359779248976;0,013535973646777;0,0274719515716746
"42";"REGIONAL";2021-02-15;2021;7;"ARS Algarve";"All";3207;2112;0;5319;16049;8435;0;24484;7607;8443;16050;0,0343297789281169;0,0162718317842972;0,0180600862041305;0,0343319179884277
"43";"REGIONAL";2021-02-22;2021;8;"ARS Algarve";"All";8517;1066;0;9583;24566;9501;0;34067;15048;9519;24567;0,052548155595247;0,0321885795570006;0,0203617150985572;0,0525502946555578
"44";"REGIONAL";2021-03-01;2021;9;"ARS Algarve";"All";4662;563;0;5225;29228;10064;0;39292;19141;10089;29230;0,0625204547642221;0,0409437534091274;0,0215809794757163;0,0625247328848437
"45";"REGIONAL";2021-03-08;2021;10;"ARS Algarve";"All";5136;1551;0;6687;34364;11615;0;45979;22727;11640;34367;0,0735066685205189;0,0486144236836758;0,0248986620177756;0,0735130857014513
"46";"REGIONAL";2021-03-15;2021;11;"ARS Algarve";"All";2714;3017;0;5731;37078;14632;0;51710;22424;14657;37081;0,079312078204045;0,0479662884095017;0,0313522069754757;0,0793184953849774
"47";"REGIONAL";2021-03-22;2021;12;"ARS Algarve";"All";9439;4313;0;13752;46517;18945;0;65462;27546;18974;46520;0,0995026684777377;0,0589225553214473;0,0405865303372229;0,0995090856586701
"48";"REGIONAL";2021-03-29;2021;13;"ARS Algarve";"All";4234;2927;0;7161;50751;21872;0;72623;28854;21901;50755;0,108559449833688;0,0617204462079808;0,0468475598669504;0,108568006074931
"49";"REGIONAL";2021-04-05;2021;14;"ARS Algarve";"All";8674;1807;0;10481;59425;23679;0;83104;35723;23710;59433;0,127113658969615;0,0764136514829036;0,0507171199691975;0,127130771452101
"50";"REGIONAL";2021-04-12;2021;15;"ARS Algarve";"All";13678;2172;0;15850;73103;25851;0;98954;47229;25882;73111;0,156371725900812;0,101025679419031;0,055363158964267;0,156388838383298
"51";"REGIONAL";2021-04-19;2021;16;"ARS Algarve";"All";7268;5517;0;12785;80371;31368;0;111739;48977;31403;80380;0,171918416239746;0,104764756842319;0,067172910940224;0,171937667782543
"52";"REGIONAL";2021-04-26;2021;17;"ARS Algarve";"All";16394;3261;0;19655;96765;34629;0;131394;62100;34679;96779;0,206986170975091;0,132835645301019;0,0741804725184227;0,207016117819442
"53";"REGIONAL";2021-05-03;2021;18;"ARS Algarve";"All";16571;8956;2;25529;113336;43585;2;156923;70254;43647;113901;0,242432539385448;0,150277543075327;0,093363565385726;0,243641108461053
"54";"REGIONAL";2021-05-10;2021;19;"ARS Algarve";"All";9732;11321;0;21053;123068;54906;2;177976;70622;54976;125598;0,263249874330207;0,151064717269703;0,117596979646841;0,268661696916545
"55";"REGIONAL";2021-05-17;2021;20;"ARS Algarve";"All";12023;10908;3;22934;135091;65814;5;200910;74211;65938;140149;0,288967796447021;0,158741804725184;0,141045358773891;0,299787163499075
"56";"REGIONAL";2021-05-24;2021;21;"ARS Algarve";"All";7620;18810;1;26431;142711;84624;6;227341;68711;84842;153553;0,305267436015358;0,146976973015754;0,181482154889357;0,328459127905111
"57";"REGIONAL";2021-05-31;2021;22;"ARS Algarve";"All";8182;12745;1;20928;150893;97369;7;248269;72544;97682;170226;0,322769227478369;0,155175991187072;0,208947689280099;0,364123680467171
"58";"REGIONAL";2021-06-07;2021;23;"ARS Algarve";"All";17058;6349;0;23407;167951;103718;7;271676;84297;104340;188637;0,359257318260088;0,180316367019968;0,223189552829442;0,40350591984941
"59";"REGIONAL";2021-06-14;2021;24;"ARS Algarve";"All";15361;13429;0;28790;183312;117147;7;300466;86238;117984;204222;0,392115423694371;0,184468283083242;0,252374891710072;0,436843174793313
"60";"REGIONAL";2021-06-21;2021;25;"ARS Algarve";"All";19352;10198;2;29552;202664;127345;9;330018;96286;128662;224948;0,433510518829078;0,205961561086215;0,275215777708853;0,481177338795067
"61";"REGIONAL";2021-06-28;2021;26;"ARS Algarve";"All";17183;16426;7;33616;219847;143771;16;363634;99093;145495;244588;0,470265992149649;0,211965903378646;0,311222579920641;0,523188483299287
"62";"REGIONAL";2021-07-05;2021;27;"ARS Algarve";"All";19192;31699;1;50892;239039;175470;17;414526;87192;177836;265028;0,511318837634627;0,18650894661975;0,3804019294324;0,56691087605215
"63";"REGIONAL";2021-07-12;2021;28;"ARS Algarve";"All";9820;26968;4;36792;248859;202438;21;451318;76024;205320;281344;0,532324409886737;0,162619921068675;0,439191863014578;0,601811784083252
"64";"REGIONAL";2021-07-19;2021;29;"ARS Algarve";"All";4342;27199;1;31542;253201;229637;22;482860;58304;233152;291456;0,541612209756254;0,124715772361202;0,498726189584915;0,623441961946117
"65";"REGIONAL";2021-07-26;2021;30;"ARS Algarve";"All";3983;24720;3;28706;257184;254357;25;511566;41580;258502;300082;0,550132086974192;0,0889421277232912;0,552951368463834;0,641893496187125
"66";"REGIONAL";2021-08-02;2021;31;"ARS Algarve";"All";3931;22605;1;26537;261115;276962;26;538103;26231;281766;307997;0,558540733055969;0,0561096910127381;0,602714467534412;0,65882415854715
"67";"REGIONAL";2021-08-09;2021;32;"ARS Algarve";"All";11424;13999;2;25425;272539;290961;28;563528;28350;296697;325047;0,58297735804661;0,0606423598113349;0,634652777035049;0,695295136846383
"68";"REGIONAL";2021-08-16;2021;33;"ARS Algarve";"All";16587;7747;2;24336;289126;298708;30;587864;39523;305614;345137;0,61845795142194;0,0845420806639643;0,653726777826501;0,738268858490465
"69";"REGIONAL";2021-08-23;2021;34;"ARS Algarve";"All";13545;5281;0;18826;302671;303989;30;606690;48289;312025;360314;0,6474315233318;0,103293083348485;0,667440293479075;0,77073337682756
"70";"REGIONAL";2021-08-30;2021;35;"ARS Algarve";"All";6478;12128;4;18610;309149;316117;34;625300;42708;325267;367975;0,661288356025198;0,0913549877538797;0,695765730114761;0,78712071786864
"71";"REGIONAL";2021-01-04;2021;1;"ARS Centro";"All";9060;15;0;9075;15712;16;0;15728;15696;18;15714;0,00946563045966625;0,0094559913247786;1,08440267485993e-05;0,0094668353515272
"72";"REGIONAL";2021-01-11;2021;2;"ARS Centro";"All";12667;25;1;12693;28379;41;1;28421;28327;54;28381;0,0170968130610278;0,0170654858726429;3,25320802457979e-05;0,0170980179528887
"73";"REGIONAL";2021-01-18;2021;3;"ARS Centro";"All";36782;6318;2;43102;65161;6359;3;71523;58763;6400;65163;0,03925597927586;0,0354015302126634;0,00385565395505753;0,0392571841677209
"74";"REGIONAL";2021-01-25;2021;4;"ARS Centro";"All";4882;8541;3;13426;70043;14900;6;84949;55100;14945;70045;0,0421971203084523;0,0331947707693235;0,00900355443098982;0,0421983252003133
"75";"REGIONAL";2021-02-01;2021;5;"ARS Centro";"All";2715;9163;0;11878;72758;24063;6;96827;48649;24112;72761;0,0438327610096994;0,0293083920718116;0,0145261762756793;0,0438345683474908
"76";"REGIONAL";2021-02-08;2021;6;"ARS Centro";"All";7546;27127;4;34677;80304;51190;10;131504;29039;51268;80307;0,0483788180010844;0,0174944273751431;0,0308861979637328;0,0483806253388758
"77";"REGIONAL";2021-02-15;2021;7;"ARS Centro";"All";25548;9998;3;35549;105852;61188;13;167053;44502;61353;105855;0,0637701066329297;0,0268100487981204;0,0369618651726008;0,0637719139707211
"78";"REGIONAL";2021-02-22;2021;8;"ARS Centro";"All";38428;3125;1;41554;144280;64313;14;208607;79767;64516;144283;0,0869208988493283;0,0480553045364179;0,0388674016507018;0,0869227061871197
"79";"REGIONAL";2021-03-01;2021;9;"ARS Centro";"All";28543;5944;1;34488;172823;70257;15;243095;102346;70490;172836;0,104116513042954;0,0616579312006747;0,0424664136393759;0,104124344840051
"80";"REGIONAL";2021-03-08;2021;10;"ARS Centro";"All";17739;13562;0;31301;190562;83819;15;274396;106498;84092;190590;0,114803301403699;0,0641592867040183;0,0506608831857341;0,114820169889752
"81";"REGIONAL";2021-03-15;2021;11;"ARS Centro";"All";16709;24224;2;40935;207271;108043;17;315331;98983;108327;207310;0,124869570456052;0,0596319055364781;0,0652611603108621;0,12489306584734
"82";"REGIONAL";2021-03-22;2021;12;"ARS Centro";"All";47886;4397;1;52284;255157;112440;18;367615;142357;112846;255203;0,153718296282909;0,0857623953250196;0,067983613470691;0,153746008795711
"83";"REGIONAL";2021-03-29;2021;13;"ARS Centro";"All";24414;16816;2;41232;279571;129256;20;408847;149939;129693;279632;0,168426411229592;0,0903301403699018;0,0781330200614495;0,168463160431351
"84";"REGIONAL";2021-04-05;2021;14;"ARS Centro";"All";49902;10263;1;60166;329473;139519;21;469013;189508;140040;329548;0,198489668052292;0,114168323392975;0,0843665281041027;0,198534851497078
"85";"REGIONAL";2021-04-12;2021;15;"ARS Centro";"All";77676;12057;2;89735;407149;151576;23;558748;254952;152278;407230;0,245285258148081;0,153594794867161;0,0917392614012892;0,24533405626845
"86";"REGIONAL";2021-04-19;2021;16;"ARS Centro";"All";30053;24213;7;54273;437202;175789;30;613021;260649;176637;437286;0,263390565696729;0,157026929333092;0,106414241821796;0,263441171154889
"87";"REGIONAL";2021-04-26;2021;17;"ARS Centro";"All";56620;17961;0;74581;493822;193750;30;687602;300406;194777;495183;0,297501054280378;0,180978372191096;0,117342611000663;0,298320983191759
"88";"REGIONAL";2021-05-03;2021;18;"ARS Centro";"All";59991;49174;1;109166;553813;242924;31;796768;316837;244183;561020;0,333642388095668;0,190877161274776;0,147107054641846;0,337984215916621
"89";"REGIONAL";2021-05-10;2021;19;"ARS Centro";"All";50678;55784;0;106462;604491;298708;31;903230;317585;300147;617732;0,364173142960419;0,191327790830773;0,180822338695102;0,372150129525875
"90";"REGIONAL";2021-05-17;2021;20;"ARS Centro";"All";44882;41759;3;86644;649373;340467;34;989874;327707;342672;670379;0,391212121212121;0,197425748539069;0,206441351888668;0,403867100427737
"91";"REGIONAL";2021-05-24;2021;21;"ARS Centro";"All";24224;56307;6;80537;673597;396774;40;1070411;302935;400002;702937;0,405805771432014;0,182501957949274;0,240979577082957;0,423481535032231
"92";"REGIONAL";2021-05-31;2021;22;"ARS Centro";"All";44298;37776;0;82074;717895;434550;40;1152485;308876;440716;749592;0,432492921260317;0,186081089222242;0,265507560696428;0,45158864991867
"93";"REGIONAL";2021-06-07;2021;23;"ARS Centro";"All";58362;40880;1;99243;776257;475430;41;1251728;325582;484141;809723;0,467652870654859;0,196145550936803;0,291668775227423;0,487814326164227
"94";"REGIONAL";2021-06-14;2021;24;"ARS Centro";"All";52001;65759;6;117766;828258;541189;47;1369494;315265;552354;867619;0,498980661485632;0,189930116272065;0,332763419483101;0,522693535755166
"95";"REGIONAL";2021-06-21;2021;25;"ARS Centro";"All";59567;47730;3;107300;887825;588919;50;1476794;329850;603658;933508;0,534866558226399;0,198716790168082;0,363671305500331;0,562388095668414
"96";"REGIONAL";2021-06-28;2021;26;"ARS Centro";"All";49909;77115;2;127026;937734;666034;52;1603820;301488;684156;985644;0,564934032170613;0,181630218687873;0,412166998011928;0,593797216699801
"97";"REGIONAL";2021-07-05;2021;27;"ARS Centro";"All";59479;104877;9;164365;997213;770911;61;1768185;259686;793465;1053151;0,600766913669498;0,156446773902042;0,47801976022652;0,634466534128562
"98";"REGIONAL";2021-07-12;2021;28;"ARS Centro";"All";28557;82095;8;110660;1025770;853006;69;1878845;216235;879860;1096095;0,617970962106151;0,130269895776854;0,530068076390144;0,660337972166998
"99";"REGIONAL";2021-07-19;2021;29;"ARS Centro";"All";16885;80722;15;97622;1042655;933728;84;1976467;163455;965081;1128536;0,628143261642268;0,0984727995662389;0,581409121031387;0,679881920597626
"100";"REGIONAL";2021-07-26;2021;30;"ARS Centro";"All";14384;68944;5;83333;1057039;1002672;89;2059800;116751;1039229;1155980;0,636808843906259;0,0703361648292066;0,626079281884451;0,696415446713657
"101";"REGIONAL";2021-08-02;2021;31;"ARS Centro";"All";19243;75080;4;94327;1076282;1077752;93;2154127;75153;1119165;1194318;0,648401710946443;0,0452756190131936;0,674236399783119;0,719512018796313
"102";"REGIONAL";2021-08-09;2021;32;"ARS Centro";"All";50454;46867;4;97325;1126736;1124619;97;2251452;93431;1174745;1268176;0,678797517922766;0,0562871257304657;0,707720344599072;0,764007470329538
"103";"REGIONAL";2021-08-16;2021;33;"ARS Centro";"All";61143;35925;6;97074;1187879;1160544;103;2348526;131760;1218400;1350160;0,715632869449967;0,079378275799747;0,734020121694078;0,813398397493825
"104";"REGIONAL";2021-08-23;2021;34;"ARS Centro";"All";50973;18343;2;69318;1238852;1178887;105;2417844;164012;1242840;1406852;0,746341345864209;0,098808361949515;0,748743900234954;0,847552262184469
"105";"REGIONAL";2021-08-30;2021;35;"ARS Centro";"All";20652;48105;3;68760;1259504;1226992;108;2486604;133639;1295444;1429083;0,758783059220435;0,0805102717031146;0,780434965961805;0,86094523766492
"106";"REGIONAL";2021-01-04;2021;1;"ARS Lisboa e Vale do Tejo";"All";12748;18;0;12766;23495;20;0;23515;23475;20;23495;0,0063817691366834;0,00637633668796096;5,43244872243745e-06;0,0063817691366834
"107";"REGIONAL";2021-01-11;2021;2;"ARS Lisboa e Vale do Tejo";"All";13247;1111;0;14358;36742;1131;0;37873;35597;1145;36742;0,00997995154798985;0,0096689438586303;0,000311007689359544;0,00997995154798985
"108";"REGIONAL";2021-01-18;2021;3;"ARS Lisboa e Vale do Tejo";"All";37829;9064;0;46893;74571;10195;0;84766;64237;10335;74572;0,0202551566840442;0,0174482104291607;0,00280721787731955;0,0202554283064803
"109";"REGIONAL";2021-01-25;2021;4;"ARS Lisboa e Vale do Tejo";"All";17296;11897;1;29194;91867;22092;1;113960;69571;22298;91869;0,0249531383392081;0,0188970445034348;0,00605663708064552;0,0249536815840803
"110";"REGIONAL";2021-02-01;2021;5;"ARS Lisboa e Vale do Tejo";"All";8736;8934;0;17670;100603;31026;1;131630;69358;31250;100608;0,0273260319411688;0,0188391889245408;0,00848820112880852;0,0273273900533494
"111";"REGIONAL";2021-02-08;2021;6;"ARS Lisboa e Vale do Tejo";"All";14400;30418;0;44818;115003;61444;1;176448;53148;61860;115008;0,0312373950213237;0,0144361892350053;0,016802563898499;0,0312387531335043
"112";"REGIONAL";2021-02-15;2021;7;"ARS Lisboa e Vale do Tejo";"All";33022;19068;0;52090;148025;80512;1;228538;66950;81080;148030;0,0402069111069402;0,0181851220983594;0,0220231471207614;0,0402082692191208
"113";"REGIONAL";2021-02-22;2021;8;"ARS Lisboa e Vale do Tejo";"All";49386;6670;0;56056;197411;87182;1;284594;109353;88063;197416;0,053621256737255;0,0297027282572351;0,0239198865922005;0,0536226148494356
"114";"REGIONAL";2021-03-01;2021;9;"ARS Lisboa e Vale do Tejo";"All";45199;12824;0;58023;242610;100006;1;342617;141510;101112;242622;0,0658983192275275;0,0384372909356062;0,0274642877611548;0,065901578696761
"115";"REGIONAL";2021-03-08;2021;10;"ARS Lisboa e Vale do Tejo";"All";33913;16589;0;50502;276523;116595;1;393119;158747;117800;276547;0,0751098509037286;0,0431192468670389;0,0319971229751566;0,0751163698421955
"116";"REGIONAL";2021-03-15;2021;11;"ARS Lisboa e Vale do Tejo";"All";26209;29029;1;55239;302732;145624;2;448358;155866;146900;302766;0,0822288033320468;0,0423367026285718;0,0399013358663031;0,0822380384948749
"117";"REGIONAL";2021-03-22;2021;12;"ARS Lisboa e Vale do Tejo";"All";89461;7677;0;97138;392193;153301;2;545496;237389;154847;392236;0,106528418089946;0,0644801784885352;0,0420599193661636;0,106540097854699
"118";"REGIONAL";2021-03-29;2021;13;"ARS Lisboa e Vale do Tejo";"All";45674;23919;0;69593;437867;177220;2;615089;259073;178849;437922;0,118934501237376;0,0703700393934019;0,0485794010779608;0,118949440471363
"119";"REGIONAL";2021-04-05;2021;14;"ARS Lisboa e Vale do Tejo";"All";87513;19720;0;107233;525380;196940;2;722322;326736;198753;525489;0,142704995489709;0,0887488282887162;0,0539857740465306;0,142734602335247
"120";"REGIONAL";2021-04-12;2021;15;"ARS Lisboa e Vale do Tejo";"All";163714;14391;1;178106;689094;211331;3;900428;475936;213281;689217;0,187173390996966;0,1292748957581;0,0579319047985091;0,187206800556609
"121";"REGIONAL";2021-04-19;2021;16;"ARS Lisboa e Vale do Tejo";"All";79353;53754;1;133108;768447;265085;4;1033536;501282;267291;768573;0,208727446170545;0,136159438024045;0,0726022325734515;0,208761670597496
"122";"REGIONAL";2021-04-26;2021;17;"ARS Lisboa e Vale do Tejo";"All";107774;25626;1;133401;876221;290711;5;1166937;583318;293059;876377;0,238001282601143;0,158442256193739;0,0796013995074399;0,238043655701178
"123";"REGIONAL";2021-05-03;2021;18;"ARS Lisboa e Vale do Tejo";"All";107936;65524;5;173465;984157;356235;10;1340402;628287;358737;987024;0,267319121866394;0,170656845523703;0,0974410178670522;0,268097863390755
"124";"REGIONAL";2021-05-10;2021;19;"ARS Lisboa e Vale do Tejo";"All";90567;113182;3;203752;1074724;469417;13;1544154;607958;472216;1080174;0,291919151038643;0,165135033019781;0,128264460295726;0,293399493315508
"125";"REGIONAL";2021-05-17;2021;20;"ARS Lisboa e Vale do Tejo";"All";110111;71243;1;181355;1184835;540660;14;1725509;648453;544468;1192921;0,321827769102459;0,176134383570537;0,147889724550404;0,32402410812094
"126";"REGIONAL";2021-05-24;2021;21;"ARS Lisboa e Vale do Tejo";"All";110821;88914;4;199739;1295656;629574;18;1925248;675343;641472;1316815;0,351929239095921;0,183438310877854;0,17423818734397;0,357676498221824
"127";"REGIONAL";2021-05-31;2021;22;"ARS Lisboa e Vale do Tejo";"All";92288;86860;8;179156;1387944;716434;26;2104404;696621;733248;1429869;0,376996730480736;0,189217893073655;0,199166608041491;0,388384501115146
"128";"REGIONAL";2021-06-07;2021;23;"ARS Lisboa e Vale do Tejo";"All";152187;54028;3;206218;1540131;770462;29;2310622;802763;793852;1596615;0,418334134166816;0,218048441688503;0,215628014160221;0,433676455848724
"129";"REGIONAL";2021-06-14;2021;24;"ARS Lisboa e Vale do Tejo";"All";147708;121334;4;269046;1687839;891796;33;2579668;831622;921850;1753472;0,458454940961505;0,225887193572544;0,250395142738948;0,476282336311492
"130";"REGIONAL";2021-06-21;2021;25;"ARS Lisboa e Vale do Tejo";"All";120145;153720;13;273878;1807984;1045516;46;2853546;804757;1083455;1888212;0,491089018549368;0,21859005682613;0,294290686528423;0,512880743354553
"131";"REGIONAL";2021-06-28;2021;26;"ARS Lisboa e Vale do Tejo";"All";130426;166542;8;296976;1938410;1212058;54;3150522;769987;1259737;2029724;0,526515646402999;0,209145744722172;0,342172832812859;0,551318577535032
"132";"REGIONAL";2021-07-05;2021;27;"ARS Lisboa e Vale do Tejo";"All";143785;273479;8;417272;2082195;1485537;62;3567794;640701;1544444;2185145;0,565570878380783;0,17402876644572;0,419505641733809;0,593534408179529
"133";"REGIONAL";2021-07-12;2021;28;"ARS Lisboa e Vale do Tejo";"All";79917;215615;14;295546;2162112;1701152;76;3863340;533553;1770022;2303575;0,587278128608334;0,144924965660134;0,480777687629309;0,625702653289443
"134";"REGIONAL";2021-07-19;2021;29;"ARS Lisboa e Vale do Tejo";"All";57033;185486;7;242526;2219145;1886638;83;4105866;444911;1966769;2411680;0,602769571007673;0,120847809677418;0,534218587068979;0,655066396746398
"135";"REGIONAL";2021-07-26;2021;30;"ARS Lisboa e Vale do Tejo";"All";36359;180256;10;216625;2255504;2066894;93;4322491;327002;2158951;2485953;0,612645491162628;0,0888210798567246;0,586419530087753;0,675240609944478
"136";"REGIONAL";2021-08-02;2021;31;"ARS Lisboa e Vale do Tejo";"All";45415;178103;7;223525;2300919;2244997;100;4546016;222902;2351767;2574669;0,624981224099103;0,0605451842564377;0,638792681731028;0,699337865987466
"137";"REGIONAL";2021-08-09;2021;32;"ARS Lisboa e Vale do Tejo";"All";107181;110781;3;217965;2408100;2355778;103;4763981;241131;2483834;2724965;0,654093988425081;0,0654965896445033;0,674665042002335;0,740161631646839
"138";"REGIONAL";2021-08-16;2021;33;"ARS Lisboa e Vale do Tejo";"All";106945;90676;8;197629;2515045;2446454;111;4961610;281438;2590578;2872016;0,683142649856135;0,0764448751772676;0,703659107323729;0,780103982500996
"139";"REGIONAL";2021-08-23;2021;34;"ARS Lisboa e Vale do Tejo";"All";88900;60567;5;149472;2603945;2507021;116;5111082;321998;2665822;2987820;0,70728988442737;0,0874618811863707;0,724097065907283;0,811558947093654
"140";"REGIONAL";2021-08-30;2021;35;"ARS Lisboa e Vale do Tejo";"All";48638;100409;13;149060;2652583;2607430;129;5260142;265155;2779672;3044827;0,720501056475465;0,0720220470498951;0,755021280259758;0,827043327309653
"141";"REGIONAL";2021-01-04;2021;1;"ARS Norte";"All";16717;30;0;16747;30098;37;0;30135;30064;41;30105;0,00840163722781143;0,00839214637573669;1,14448510313067e-05;0,008403591226768
"142";"REGIONAL";2021-01-11;2021;2;"ARS Norte";"All";15430;35;0;15465;45528;72;0;45600;45434;101;45535;0,0127088092134959;0,0126825697989363;2,81934135161458e-05;0,0127107632124524
"143";"REGIONAL";2021-01-18;2021;3;"ARS Norte";"All";32511;12748;1;45260;78039;12820;1;90860;65160;12886;78046;0,0217840177959059;0,0181889388585352;0,00359703293632727;0,0217859717948625
"144";"REGIONAL";2021-01-25;2021;4;"ARS Norte";"All";14412;15733;1;30146;92451;28553;2;121006;63829;28630;92459;0,0258070225047643;0,0178173999140799;0,00799185573234904;0,0258092556464289
"145";"REGIONAL";2021-02-01;2021;5;"ARS Norte";"All";5694;12296;1;17991;98145;40849;3;138997;57227;40930;98157;0,0273964610845755;0,0159744997553314;0,011425311041741;0,0273998107970725
"146";"REGIONAL";2021-02-08;2021;6;"ARS Norte";"All";8953;28959;6;37918;107098;69808;9;176915;37151;69959;107110;0,0298956257500216;0,0103704307479043;0,0195285447146143;0,0298989754625185
"147";"REGIONAL";2021-02-15;2021;7;"ARS Norte";"All";33090;15214;4;48308;140188;85022;13;225223;54663;85537;140200;0,0391324579604103;0,0152587778518126;0,0238770298210946;0,0391358076729073
"148";"REGIONAL";2021-02-22;2021;8;"ARS Norte";"All";64887;4362;0;69249;205075;89384;13;294472;114919;90168;205087;0,0572451908596395;0,0320788008699203;0,0251697397022161;0,0572485405721365
"149";"REGIONAL";2021-03-01;2021;9;"ARS Norte";"All";48134;7133;2;55269;253209;96517;15;349741;155822;97405;253227;0,0706814459703936;0,0434965750585432;0,0271898954805958;0,070686470539139
"150";"REGIONAL";2021-03-08;2021;10;"ARS Norte";"All";25785;14213;0;39998;278994;110730;15;389739;167266;111760;279026;0,0778791406982531;0,0466910842098182;0,0311969890550936;0,0778880732649117
"151";"REGIONAL";2021-03-15;2021;11;"ARS Norte";"All";27002;42445;4;69451;305996;153175;19;459190;151801;154238;306039;0,0854165521018469;0,0423741422293509;0,0430544130089434;0,0854285552382944
"152";"REGIONAL";2021-03-22;2021;12;"ARS Norte";"All";89170;2461;0;91631;395166;155636;19;550821;238407;156808;395215;0,110307707381399;0,0665495756053838;0,0437718097687107;0,110321385374094
"153";"REGIONAL";2021-03-29;2021;13;"ARS Norte";"All";54235;32771;1;87007;449401;188407;20;637828;259812;189662;449474;0,125447012154153;0,0725246252718501;0,0529427642999924;0,125467389571843
"154";"REGIONAL";2021-04-05;2021;14;"ARS Norte";"All";82565;13777;5;96347;531966;202184;25;734175;328557;203525;532082;0,148494429846832;0,0917142907388545;0,0568125196621145;0,148526810400969
"155";"REGIONAL";2021-04-12;2021;15;"ARS Norte";"All";136124;19235;1;155360;668090;221419;26;889535;445349;222865;668214;0,186492451841602;0,12431592590101;0,0622111396363943;0,186527065537404
"156";"REGIONAL";2021-04-19;2021;16;"ARS Norte";"All";65351;46548;2;111901;733441;267967;28;1001436;463749;269818;733567;0,204734706957381;0,129452151729694;0,0753177272089051;0,204769878938599
"157";"REGIONAL";2021-04-26;2021;17;"ARS Norte";"All";126986;36808;3;163797;860427;304775;31;1165233;553755;306823;860578;0,24018192288571;0,154576670313201;0,0856474031214296;0,240224073434631
"158";"REGIONAL";2021-05-03;2021;18;"ARS Norte";"All";155820;73393;3;229216;1016247;378168;34;1394449;635919;380695;1016614;0,283677939658837;0,17751215177994;0,106268233252763;0,283780385032703
"159";"REGIONAL";2021-05-10;2021;19;"ARS Norte";"All";100141;101199;8;201348;1116388;479367;42;1595797;640527;482993;1123520;0,311631569588742;0,178798441378775;0,134823974003998;0,313622415382773
"160";"REGIONAL";2021-05-17;2021;20;"ARS Norte";"All";111154;71299;4;182457;1227542;550666;46;1778254;678849;563474;1242323;0,342659398162739;0,189495748237842;0,157289658293037;0,346785406530879
"161";"REGIONAL";2021-05-24;2021;21;"ARS Norte";"All";73252;129341;10;202603;1300794;680007;56;1980857;629709;706047;1335756;0,363107159815062;0,175778675562759;0,197087871612219;0,372866547174978
"162";"REGIONAL";2021-05-31;2021;22;"ARS Norte";"All";55214;172762;12;227988;1356008;852769;68;2208845;530196;885067;1415263;0,378519745299027;0,148000347253529;0,247059999212818;0,395060346466346
"163";"REGIONAL";2021-06-07;2021;23;"ARS Norte";"All";107087;106807;7;213901;1463095;959576;75;2422746;528086;1002000;1530086;0,40841230047926;0,147411356139479;0,279700993496812;0,427112349636291
"164";"REGIONAL";2021-06-14;2021;24;"ARS Norte";"All";105355;152755;13;258123;1568450;1112331;88;2680869;486299;1164840;1651139;0,437821380489097;0,135746819796913;0,325156592080666;0,460903411877578
"165";"REGIONAL";2021-06-21;2021;25;"ARS Norte";"All";146506;105583;5;252094;1714956;1217914;93;2932963;530269;1283956;1814225;0,478717462079161;0,148020724671219;0,3584069548964;0,506427679567619
"166";"REGIONAL";2021-06-28;2021;26;"ARS Norte";"All";163866;117559;8;281433;1878822;1335473;101;3214396;567453;1417101;1984554;0,524459461081505;0,15840036712849;0,395573410763799;0,553973777892288
"167";"REGIONAL";2021-07-05;2021;27;"ARS Norte";"All";176241;158650;12;334903;2055063;1494123;113;3549299;580921;1594202;2175123;0,573655851096347;0,16215986112092;0,44500986350759;0,60716972462851
"168";"REGIONAL";2021-07-12;2021;28;"ARS Norte";"All";105476;157189;20;262685;2160539;1651312;133;3811984;562082;1768044;2330126;0,603098707373862;0,156901091643389;0,493536590165747;0,650437681809135
"169";"REGIONAL";2021-07-19;2021;29;"ARS Norte";"All";51815;189861;13;241689;2212354;1841173;146;4053673;462544;1971246;2433790;0,617562486793061;0,129115784766457;0,550258946733151;0,679374731499608
"170";"REGIONAL";2021-07-26;2021;30;"ARS Norte";"All";35359;185605;15;220979;2247713;2026778;161;4274652;336472;2168388;2504860;0,627432693808084;0,0939237052733128;0,605289698489587;0,6992134037629
"171";"REGIONAL";2021-08-02;2021;31;"ARS Norte";"All";41811;190100;7;231918;2289524;2216878;168;4506570;214775;2370373;2585148;0,639103929575644;0,0599528751280218;0,661672338381257;0,721625213509279
"172";"REGIONAL";2021-08-09;2021;32;"ARS Norte";"All";119195;148220;6;267421;2408719;2365098;174;4773991;227483;2536373;2763856;0,672376344665318;0,0635002206623107;0,708010027922645;0,771510248584956
"173";"REGIONAL";2021-08-16;2021;33;"ARS Norte";"All";148445;81057;5;229507;2557164;2446155;179;5003498;313496;2637058;2950554;0,71381368396635;0,0875101224124518;0,736115511485745;0,823625633898197
"174";"REGIONAL";2021-08-23;2021;34;"ARS Norte";"All";118965;33969;3;152937;2676129;2480124;182;5156435;386053;2686778;3072831;0,747021896233165;0,10776387988266;0,749994486931515;0,857758366814175
"175";"REGIONAL";2021-08-30;2021;35;"ARS Norte";"All";44789;111252;10;156051;2720918;2591376;192;5312486;310695;2808515;3119210;0,759524418985389;0,0867282436871179;0,78397648278513;0,870704726472248
"176";"REGIONAL";2021-01-04;2021;1;"RA Madeira";"All";1831;2;0;1833;2535;2;0;2537;2533;2;2535;0,0100971879232056;0,010089221699992;7,96622321357444e-06;0,0100971879232056
"177";"REGIONAL";2021-01-11;2021;2;"RA Madeira";"All";1797;3;0;1800;4332;5;0;4337;4324;8;4332;0,0172548394806022;0,0172229745877479;3,18648928542978e-05;0,0172548394806022
"178";"REGIONAL";2021-01-18;2021;3;"RA Madeira";"All";1162;596;1;1759;5494;601;1;6096;4890;604;5494;0,021883215167689;0,0194774157571895;0,00240579941049948;0,021883215167689
"179";"REGIONAL";2021-01-25;2021;4;"RA Madeira";"All";481;1724;3;2208;5975;2325;4;8304;3647;2328;5975;0,0237990918505537;0,014526408029953;0,00927268382060065;0,0237990918505537
"180";"REGIONAL";2021-02-01;2021;5;"RA Madeira";"All";2254;1544;0;3798;8229;3869;4;12102;4357;3872;8229;0,0327770254122521;0,0173544172707719;0,0154226081414801;0,0327770254122521
"181";"REGIONAL";2021-02-08;2021;6;"RA Madeira";"All";3180;1160;1;4341;11409;5029;5;16443;6377;5032;11409;0,0454433203218354;0,0254003027164821;0,0200430176053533;0,0454433203218354
"182";"REGIONAL";2021-02-15;2021;7;"RA Madeira";"All";2590;710;1;3301;13999;5739;6;19744;8256;5743;13999;0,0557595793834143;0,0328845694256353;0,022875009957779;0,0557595793834143
"183";"REGIONAL";2021-02-22;2021;8;"RA Madeira";"All";2271;2161;1;4433;16270;7900;7;24177;8366;7904;16270;0,0648052258424281;0,0333227117023819;0,0314825141400462;0,0648052258424281
"184";"REGIONAL";2021-03-01;2021;9;"RA Madeira";"All";1457;3130;3;4590;17727;11030;10;28767;6693;11034;17727;0,0706086194535171;0,0266589659842269;0,0439496534692902;0,0706086194535171
"185";"REGIONAL";2021-03-08;2021;10;"RA Madeira";"All";4980;2391;0;7371;22707;13421;10;36138;9282;13425;22707;0,0904445152553175;0,036971241934199;0,0534732733211185;0,0904445152553175
"186";"REGIONAL";2021-03-15;2021;11;"RA Madeira";"All";3126;2329;2;5457;25833;15750;12;41595;10078;15755;25833;0,102895722138134;0,0401417987732016;0,0627539233649327;0,102895722138134
"187";"REGIONAL";2021-03-22;2021;12;"RA Madeira";"All";5493;193;0;5686;31326;15943;12;47281;15378;15948;31326;0,124774954194217;0,0612522902891739;0,0635226639050426;0,124774954194217
"188";"REGIONAL";2021-03-29;2021;13;"RA Madeira";"All";1222;1260;1;2483;32548;17203;13;49764;15340;17209;32549;0,12964231657771;0,061100932048116;0,0685453676412013;0,129646299689317
"189";"REGIONAL";2021-04-05;2021;14;"RA Madeira";"All";10222;1300;0;11522;42770;18503;13;61286;24260;18511;42771;0,170357683422289;0,096630287580658;0,0737313789532383;0,170361666533896
"190";"REGIONAL";2021-04-12;2021;15;"RA Madeira";"All";8530;1307;0;9837;51300;19810;13;71123;31478;19824;51302;0,204333625428185;0,125380387158448;0,0789612044929499;0,204341591651398
"191";"REGIONAL";2021-04-19;2021;16;"RA Madeira";"All";9831;2143;1;11975;61131;21953;14;83098;39096;22038;61134;0,24349159563451;0,155723731378953;0,0877798135903768;0,24350354496933
"192";"REGIONAL";2021-04-26;2021;17;"RA Madeira";"All";8818;828;1;9647;69949;22781;15;92745;47091;22879;69970;0,278614673783159;0,187568708675217;0,0911296104516849;0,278698319126902
"193";"REGIONAL";2021-05-03;2021;18;"RA Madeira";"All";7657;5348;0;13005;77606;28129;15;105750;49400;28248;77648;0,309113359356329;0,196765713375289;0,112514936668525;0,309280650043814
"194";"REGIONAL";2021-05-10;2021;19;"RA Madeira";"All";11597;6559;5;18161;89203;34688;20;123911;54427;34819;89246;0,355305504660241;0,216788815422608;0,138687963036724;0,355476778459332
"195";"REGIONAL";2021-05-17;2021;20;"RA Madeira";"All";2395;7711;7;10113;91598;42399;27;134024;49113;42536;91649;0,364845056958496;0,195622560344141;0,169425635306301;0,365048195650442
"196";"REGIONAL";2021-05-24;2021;21;"RA Madeira";"All";3498;8989;3;12490;95096;51388;30;146514;43614;51542;95156;0,378777981359038;0,173719429618418;0,205297538437027;0,379016968055445
"197";"REGIONAL";2021-05-31;2021;22;"RA Madeira";"All";7640;11012;5;18657;102736;62400;35;165171;40542;62593;103135;0,409208954034892;0,161483310762368;0,249314904803633;0,410798215566
"198";"REGIONAL";2021-06-07;2021;23;"RA Madeira";"All";3715;15284;5;19004;106451;77684;40;184175;31033;77915;108948;0,424006213654107;0,123607902493428;0,310344140842826;0,433952043336254
"199";"REGIONAL";2021-06-14;2021;24;"RA Madeira";"All";3760;8354;5;12119;110211;86038;45;196294;28928;86308;115236;0,438982713295627;0,115223452561141;0,343774396558592;0,458997849119732
"200";"REGIONAL";2021-06-21;2021;25;"RA Madeira";"All";12620;3744;14;16378;122831;89782;59;212672;37795;90194;127989;0,489249581773281;0,150541703178523;0,359252768262567;0,50979447144109
"201";"REGIONAL";2021-06-28;2021;26;"RA Madeira";"All";10153;12368;21;22542;132984;102150;80;235214;35658;102677;138335;0,529690113916992;0,142029793674819;0,408973950450092;0,55100374412491
"202";"REGIONAL";2021-07-05;2021;27;"RA Madeira";"All";12785;7007;10;19802;145769;109157;90;255016;41495;110035;151530;0,580614195809767;0,165279216123636;0,438281685652832;0,603560901776468
"203";"REGIONAL";2021-07-12;2021;28;"RA Madeira";"All";10663;5911;8;16582;156432;115068;98;271598;47132;116539;163671;0,623086114872939;0,187732016251095;0,464187843543376;0,651919859794471
"204";"REGIONAL";2021-07-19;2021;29;"RA Madeira";"All";4265;14840;8;19113;160697;129908;106;290711;38832;131633;170465;0,640074085875886;0,154672189914761;0,524308930136222;0,678981120050984
"205";"REGIONAL";2021-07-26;2021;30;"RA Madeira";"All";5569;13886;5;19460;166266;143794;111;310171;33448;145934;179382;0,662256034414084;0,133227117023819;0,581271409224887;0,714498526248705
"206";"REGIONAL";2021-08-02;2021;31;"RA Madeira";"All";4557;14372;1;18930;170823;158166;112;329101;25407;160663;186070;0,680407074006214;0,101198916593643;0,639938660081255;0,741137576674898
"207";"REGIONAL";2021-08-09;2021;32;"RA Madeira";"All";5416;11048;3;16467;176239;169214;115;345568;21233;171965;193198;0,701979606468573;0,0845734087469131;0,684955787461165;0,769529196208078
"208";"REGIONAL";2021-08-16;2021;33;"RA Madeira";"All";3621;8156;4;11781;179860;177370;119;357349;17759;180329;198088;0,71640245359675;0,0707360790249343;0,718270532940333;0,789006611965267
"209";"REGIONAL";2021-08-23;2021;34;"RA Madeira";"All";2192;6282;2;8476;182052;183652;121;365825;14451;186788;201239;0,725133434238827;0,0575599458296822;0,743997450808572;0,801557396638254
"210";"REGIONAL";2021-08-30;2021;35;"RA Madeira";"All";1647;5170;2;6819;183699;188822;123;372644;11674;192152;203826;0,731693619055206;0,046498844897634;0,765362861467378;0,811861706365012
"211";"REGIONAL";2021-01-04;2021;1;"RA Acores";"All";3682;3;1;3686;5721;4;4;5729;5717;4;5721;0,0241742268346172;0,0241573247357991;1,69020988181207e-05;0,0241742268346172
"212";"REGIONAL";2021-01-11;2021;2;"RA Acores";"All";23;3;0;26;5744;7;4;5755;5737;7;5744;0,0242714139028214;0,0242418352298897;2,95786729317113e-05;0,0242714139028214
"213";"REGIONAL";2021-01-18;2021;3;"RA Acores";"All";83;1983;5;2071;5827;1990;9;7826;3837;1990;5827;0,0246221324532974;0,0162133382912823;0,00840879416201507;0,0246221324532974
"214";"REGIONAL";2021-01-25;2021;4;"RA Acores";"All";311;3612;9;3932;6138;5602;18;11758;536;5602;6138;0,0259362706364063;0,00226488124162818;0,0236713893947781;0,0259362706364063
"215";"REGIONAL";2021-02-01;2021;5;"RA Acores";"All";1875;35;1;1911;8013;5637;19;13669;2376;5637;8013;0,0338591294574004;0,0100398466979637;0,0238192827594367;0,0338591294574004
"216";"REGIONAL";2021-02-08;2021;6;"RA Acores";"All";1065;55;1;1121;9078;5692;20;14790;3386;5692;9078;0,038359313267725;0,0143076266495392;0,0240516866181858;0,038359313267725
"217";"REGIONAL";2021-02-15;2021;7;"RA Acores";"All";2096;363;2;2461;11174;6055;22;17251;5119;6055;11174;0,0472160130484203;0,02163046096249;0,0255855520859303;0,0472160130484203
"218";"REGIONAL";2021-02-22;2021;8;"RA Acores";"All";1496;1641;8;3145;12670;7696;30;20396;4973;7697;12670;0,0535373980063974;0,0210135343556286;0,0325238636507688;0,0535373980063974
"219";"REGIONAL";2021-03-01;2021;9;"RA Acores";"All";783;1196;5;1984;13453;8892;35;22380;4560;8893;13453;0,0568459838500446;0,0192683926526576;0,0375775911973869;0,0568459838500446
"220";"REGIONAL";2021-03-08;2021;10;"RA Acores";"All";2762;2072;3;4837;16215;10964;38;27217;5240;10975;16215;0,068516883083957;0,0221417494517382;0,0463751336322188;0,068516883083957
"221";"REGIONAL";2021-03-15;2021;11;"RA Acores";"All";2517;1455;9;3981;18732;12419;47;31198;6297;12436;18733;0,0791525287652594;0,0266081290644266;0,0525486252255374;0,079156754289964
"222";"REGIONAL";2021-03-22;2021;12;"RA Acores";"All";4157;747;6;4910;22889;13166;53;36108;9697;13193;22890;0,0967180349619914;0,0409749130598292;0,0557473474268667;0,0967222604866959
"223";"REGIONAL";2021-03-29;2021;13;"RA Acores";"All";2222;776;4;3002;25111;13942;57;39110;11140;13973;25113;0,106107150855457;0,0470723452084663;0,0590432566964003;0,106115601904867
"224";"REGIONAL";2021-04-05;2021;14;"RA Acores";"All";3887;2361;15;6263;28998;16303;72;45373;12652;16352;29004;0,122531765381966;0,0534613385617159;0,0690957799684776;0,122557118530193
"225";"REGIONAL";2021-04-12;2021;15;"RA Acores";"All";4217;2388;18;6623;33215;18691;90;51996;14465;18757;33222;0,14035080306097;0,0611222148510291;0,0792581668828727;0,140380381733902
"226";"REGIONAL";2021-04-19;2021;16;"RA Acores";"All";7862;1071;18;8951;41077;19762;108;60947;21199;19885;41084;0,173571878287986;0,0895768982113354;0,0840245587495827;0,173601456960918
"227";"REGIONAL";2021-04-26;2021;17;"RA Acores";"All";9297;2978;16;12291;50374;22740;124;73238;27472;22926;50398;0,212856581466004;0,116083614682853;0,096874379376059;0,212957994058912
"228";"REGIONAL";2021-05-03;2021;18;"RA Acores";"All";9717;2950;20;12687;60091;25690;144;85925;34219;25929;60148;0,253916005019923;0,144593229864318;0,109563630063763;0,254156859928082
"229";"REGIONAL";2021-05-10;2021;19;"RA Acores";"All";9434;2417;15;11866;69525;28107;159;97791;41206;28379;69585;0,293779605082461;0,174116970974871;0,119916165589862;0,294033136564733
"230";"REGIONAL";2021-05-17;2021;20;"RA Acores";"All";12082;5177;14;17273;81607;33284;173;115064;48077;33596;81673;0,344832394562595;0,203150551219698;0,141960727973396;0,345111279193094
"231";"REGIONAL";2021-05-24;2021;21;"RA Acores";"All";5598;8171;93;13862;87205;41455;266;128926;45490;41791;87281;0,368486881858555;0,192219118809078;0,176588902927021;0,368808021736099
"232";"REGIONAL";2021-05-31;2021;22;"RA Acores";"All";5521;10481;31;16033;92726;51936;297;144959;40560;52309;92869;0,391816003752266;0,171387282015744;0,221032971769269;0,392420253785014
"233";"REGIONAL";2021-06-07;2021;23;"RA Acores";"All";7865;12189;57;20111;100591;64125;354;165070;36207;64550;100757;0,425049755553396;0,152993572976924;0,272757619677423;0,425751192654348
"234";"REGIONAL";2021-06-14;2021;24;"RA Acores";"All";9246;7847;88;17181;109837;71972;442;182251;38006;72460;110466;0,464118956971482;0,160595291920374;0,306181520090257;0,466776812010631
"235";"REGIONAL";2021-06-21;2021;25;"RA Acores";"All";7547;10015;366;17928;117384;81987;808;200179;38006;82560;120566;0,496008991916571;0,160595291920374;0,348859319606012;0,509454611526386
"236";"REGIONAL";2021-06-28;2021;26;"RA Acores";"All";6720;12479;195;19394;124104;94466;1003;219573;33642;95161;128803;0,524404517931014;0,142155102109804;0,402105156407797;0,544260258517601
"237";"REGIONAL";2021-07-05;2021;27;"RA Acores";"All";6205;16301;65;22571;130309;110767;1068;242144;25322;111613;136935;0,550623898722624;0,106998736568113;0,471623488846728;0,578622225414841
"238";"REGIONAL";2021-07-12;2021;28;"RA Acores";"All";2965;11902;56;14923;133274;122669;1124;257067;18014;123615;141629;0,563152579471556;0,0761186020274068;0,522338236350499;0,598456838377906
"239";"REGIONAL";2021-07-19;2021;29;"RA Acores";"All";5696;9009;42;14747;138970;131678;1166;271814;16374;132828;149202;0,58722116818856;0,0691887415119773;0,561267995453335;0,630456736965313
"240";"REGIONAL";2021-07-26;2021;30;"RA Acores";"All";6985;8999;30;16014;145955;140677;1196;287828;16775;142183;158958;0,616736458249703;0,0708831769184939;0,600797779064215;0,671680955982709
"241";"REGIONAL";2021-08-02;2021;31;"RA Acores";"All";9590;6651;24;16265;155545;147328;1220;304093;23039;149154;172193;0,657259240166148;0,0973518636676709;0,630253911779495;0,727605775447166
"242";"REGIONAL";2021-08-09;2021;32;"RA Acores";"All";5000;6557;33;11590;160545;153885;1253;315683;22831;155962;178793;0,678386863688799;0,0964729545291287;0,659021283967937;0,755494238497065
"243";"REGIONAL";2021-08-16;2021;33;"RA Acores";"All";2253;7179;35;9467;162798;161064;1288;325150;18591;163249;181840;0,687906970848105;0,0785567297819207;0,689812682489848;0,768369412271769
"244";"REGIONAL";2021-08-23;2021;34;"RA Acores";"All";5690;9323;14;15027;168488;170387;1302;340177;15248;172698;187946;0,711950206416882;0,0644308006946763;0,729739665422954;0,79417046611763
"245";"REGIONAL";2021-08-30;2021;35;"RA Acores";"All";3113;5488;13;8614;171601;175875;1315;348791;13009;178282;191291;0,725104264822084;0,0549698508812332;0,75333499537305;0,808304846254284
"246";"REGIONAL";2021-01-04;2021;1;"Outro";"All";0;0;0;0;0;0;0;0;0;0;0;NA;NA;NA;NA
"247";"REGIONAL";2021-01-11;2021;2;"Outro";"All";0;0;0;0;0;0;0;0;0;0;0;NA;NA;NA;NA
"248";"REGIONAL";2021-01-18;2021;3;"Outro";"All";0;0;0;0;0;0;0;0;0;0;0;NA;NA;NA;NA
"249";"REGIONAL";2021-01-25;2021;4;"Outro";"All";0;0;0;0;0;0;0;0;0;0;0;NA;NA;NA;NA
"250";"REGIONAL";2021-02-01;2021;5;"Outro";"All";0;0;0;0;0;0;0;0;0;0;0;NA;NA;NA;NA
"251";"REGIONAL";2021-02-08;2021;6;"Outro";"All";0;0;0;0;0;0;0;0;0;0;0;NA;NA;NA;NA
"252";"REGIONAL";2021-02-15;2021;7;"Outro";"All";0;0;0;0;0;0;0;0;0;0;0;NA;NA;NA;NA
"253";"REGIONAL";2021-02-22;2021;8;"Outro";"All";0;0;0;0;0;0;0;0;0;0;0;NA;NA;NA;NA
"254";"REGIONAL";2021-03-01;2021;9;"Outro";"All";0;0;0;0;0;0;0;0;0;0;0;NA;NA;NA;NA
"255";"REGIONAL";2021-03-08;2021;10;"Outro";"All";0;0;0;0;0;0;0;0;0;0;0;NA;NA;NA;NA
"256";"REGIONAL";2021-03-15;2021;11;"Outro";"All";0;0;0;0;0;0;0;0;0;0;0;NA;NA;NA;NA
"257";"REGIONAL";2021-03-22;2021;12;"Outro";"All";0;0;0;0;0;0;0;0;0;0;0;NA;NA;NA;NA
"258";"REGIONAL";2021-03-29;2021;13;"Outro";"All";0;0;0;0;0;0;0;0;0;0;0;NA;NA;NA;NA
"259";"REGIONAL";2021-04-05;2021;14;"Outro";"All";0;0;0;0;0;0;0;0;0;0;0;NA;NA;NA;NA
"260";"REGIONAL";2021-04-12;2021;15;"Outro";"All";0;0;0;0;0;0;0;0;0;0;0;NA;NA;NA;NA
"261";"REGIONAL";2021-04-19;2021;16;"Outro";"All";0;0;0;0;0;0;0;0;0;0;0;NA;NA;NA;NA
"262";"REGIONAL";2021-04-26;2021;17;"Outro";"All";0;0;0;0;0;0;0;0;0;0;0;NA;NA;NA;NA
"263";"REGIONAL";2021-05-03;2021;18;"Outro";"All";0;0;0;0;0;0;0;0;0;0;0;NA;NA;NA;NA
"264";"REGIONAL";2021-05-10;2021;19;"Outro";"All";0;0;0;0;0;0;0;0;0;0;0;NA;NA;NA;NA
"265";"REGIONAL";2021-05-17;2021;20;"Outro";"All";0;0;0;0;0;0;0;0;0;0;0;NA;NA;NA;NA
"266";"REGIONAL";2021-05-24;2021;21;"Outro";"All";0;0;0;0;0;0;0;0;0;0;0;NA;NA;NA;NA
"267";"REGIONAL";2021-05-31;2021;22;"Outro";"All";0;0;0;0;0;0;0;0;0;0;0;NA;NA;NA;NA
"268";"REGIONAL";2021-06-07;2021;23;"Outro";"All";0;0;0;0;0;0;0;0;0;0;0;NA;NA;NA;NA
"269";"REGIONAL";2021-06-14;2021;24;"Outro";"All";0;0;0;0;0;0;0;0;0;0;0;NA;NA;NA;NA
"270";"REGIONAL";2021-06-21;2021;25;"Outro";"All";0;0;0;0;0;0;0;0;0;0;0;NA;NA;NA;NA
"271";"REGIONAL";2021-06-28;2021;26;"Outro";"All";0;0;0;0;0;0;0;0;0;0;0;NA;NA;NA;NA
"272";"REGIONAL";2021-07-05;2021;27;"Outro";"All";0;0;0;0;0;0;0;0;0;0;0;NA;NA;NA;NA
"273";"REGIONAL";2021-07-12;2021;28;"Outro";"All";0;0;0;0;0;0;0;0;0;0;0;NA;NA;NA;NA
"274";"REGIONAL";2021-07-19;2021;29;"Outro";"All";0;0;0;0;0;0;0;0;0;0;0;NA;NA;NA;NA
"275";"REGIONAL";2021-07-26;2021;30;"Outro";"All";0;0;0;0;0;0;0;0;0;0;0;NA;NA;NA;NA
"276";"REGIONAL";2021-08-02;2021;31;"Outro";"All";0;0;0;0;0;0;0;0;0;0;0;NA;NA;NA;NA
"277";"REGIONAL";2021-08-09;2021;32;"Outro";"All";0;0;0;0;0;0;0;0;0;0;0;NA;NA;NA;NA
"278";"REGIONAL";2021-08-16;2021;33;"Outro";"All";0;0;0;0;0;0;0;0;0;0;0;NA;NA;NA;NA
"279";"REGIONAL";2021-08-23;2021;34;"Outro";"All";0;0;0;0;0;0;0;0;0;0;0;NA;NA;NA;NA
"280";"REGIONAL";2021-08-30;2021;35;"Outro";"All";0;0;0;0;0;0;0;0;0;0;0;NA;NA;NA;NA
"281";"AGES";2021-01-04;2021;1;"All";"12-17 anos";5;0;0;5;7;0;0;7;7;0;7;1,12451786296625e-05;1,12451786296625e-05;0;1,12451786296625e-05
"282";"AGES";2021-01-11;2021;2;"All";"12-17 anos";15;0;0;15;22;0;0;22;22;0;22;3,53419899789394e-05;3,53419899789394e-05;0;3,53419899789394e-05
"283";"AGES";2021-01-18;2021;3;"All";"12-17 anos";70;1;0;71;92;1;0;93;91;1;92;0,000147793776275565;0,000146187322185613;1,60645408995179e-06;0,000147793776275565
"284";"AGES";2021-01-25;2021;4;"All";"12-17 anos";14;3;0;17;106;4;0;110;102;4;106;0,00017028413353489;0,000163858317175083;6,42581635980716e-06;0,00017028413353489
"285";"AGES";2021-02-01;2021;5;"All";"12-17 anos";35;4;0;39;141;8;0;149;133;8;141;0,000226510026683202;0,000213658393963588;1,28516327196143e-05;0,000226510026683202
"286";"AGES";2021-02-08;2021;6;"All";"12-17 anos";38;66;0;104;179;74;0;253;105;74;179;0,00028755528210137;0,000168677679444938;0,000118877602656432;0,00028755528210137
"287";"AGES";2021-02-15;2021;7;"All";"12-17 anos";32;16;0;48;211;90;0;301;121;90;211;0,000338961812979828;0,000194380944884167;0,000144580868095661;0,000338961812979828
"288";"AGES";2021-02-22;2021;8;"All";"12-17 anos";23;32;0;55;234;122;0;356;112;122;234;0,000375910257048719;0,000179922858074601;0,000195987398974118;0,000375910257048719
"289";"AGES";2021-03-01;2021;9;"All";"12-17 anos";12;30;0;42;246;152;0;398;94;152;246;0,00039518770612814;0,000151006684455468;0,000244181021672672;0,00039518770612814
"290";"AGES";2021-03-08;2021;10;"All";"12-17 anos";17;25;0;42;263;177;0;440;85;178;263;0,000422497425657321;0,000136548597645902;0,000285948828011419;0,000422497425657321
"291";"AGES";2021-03-15;2021;11;"All";"12-17 anos";5;23;0;28;268;200;0;468;67;201;268;0,00043052969610708;0,00010763242402677;0,00032289727208031;0,00043052969610708
"292";"AGES";2021-03-22;2021;12;"All";"12-17 anos";31;11;0;42;299;211;0;510;87;212;299;0,000480329772895585;0,000139761505825806;0,00034056826706978;0,000480329772895585
"293";"AGES";2021-03-29;2021;13;"All";"12-17 anos";16;14;0;30;315;225;0;540;89;226;315;0,000506033038334814;0,000142974414005709;0,000363058624329105;0,000506033038334814
"294";"AGES";2021-04-05;2021;14;"All";"12-17 anos";29;4;0;33;344;229;0;573;114;230;344;0,000552620206943416;0,000183135766254504;0,000369484440688912;0,000552620206943416
"295";"AGES";2021-04-12;2021;15;"All";"12-17 anos";46;6;0;52;390;235;0;625;154;236;390;0,000626517095081198;0,000247393929852576;0,000379123165228623;0,000626517095081198
"296";"AGES";2021-04-19;2021;16;"All";"12-17 anos";32;14;0;46;422;249;0;671;170;252;422;0,000677923625959656;0,000273097195291804;0,000404826430667851;0,000677923625959656
"297";"AGES";2021-04-26;2021;17;"All";"12-17 anos";49;28;0;77;471;277;0;748;190;281;471;0,000756639876367293;0,00030522627709084;0,000451413599276453;0,000756639876367293
"298";"AGES";2021-05-03;2021;18;"All";"12-17 anos";110;15;1;126;581;292;1;874;284;297;581;0,00093334982626199;0,000456232961546308;0,000477116864715682;0,00093334982626199
"299";"AGES";2021-05-10;2021;19;"All";"12-17 anos";162;44;0;206;743;336;1;1080;402;341;743;0,00119359538883418;0,00064579454416062;0,00054780084467356;0,00119359538883418
"300";"AGES";2021-05-17;2021;20;"All";"12-17 anos";314;25;0;339;1057;361;1;1419;691;366;1057;0,00169802197307904;0,00111005977615669;0,000587962196922355;0,00169802197307904
"301";"AGES";2021-05-24;2021;21;"All";"12-17 anos";301;40;0;341;1358;401;1;1760;946;412;1358;0,00218156465415453;0,00151970556909439;0,000661859085060138;0,00218156465415453
"302";"AGES";2021-05-31;2021;22;"All";"12-17 anos";272;112;0;384;1630;513;1;2144;1095;535;1630;0,00261852016662142;0,00175906722849721;0,000859452938124208;0,00261852016662142
"303";"AGES";2021-06-07;2021;23;"All";"12-17 anos";393;164;0;557;2023;677;1;2701;1319;705;2024;0,00324985662397247;0,00211891294464641;0,00113255013341601;0,00325146307806242
"304";"AGES";2021-06-14;2021;24;"All";"12-17 anos";579;331;0;910;2602;1008;1;3611;1563;1041;2604;0,00417999354205456;0,00251088774259465;0,00167231870763981;0,00418320645023446
"305";"AGES";2021-06-21;2021;25;"All";"12-17 anos";404;290;2;696;3006;1298;3;4307;1671;1341;3012;0,00482900099439508;0,00268438478430944;0,00215425493462535;0,00483863971893479
"306";"AGES";2021-06-28;2021;26;"All";"12-17 anos";218;273;0;491;3224;1571;3;4798;1611;1619;3230;0,00517920798600457;0,00258799753891233;0,00260084917163195;0,00518884671054428
"307";"AGES";2021-07-05;2021;27;"All";"12-17 anos";426;658;1;1085;3650;2229;4;5883;1368;2288;3656;0,00586355742832403;0,00219762919505405;0,0036755669578097;0,00587319615286375
"308";"AGES";2021-07-12;2021;28;"All";"12-17 anos";259;314;2;575;3909;2543;6;6458;1307;2623;3930;0,00627962903762155;0,00209963549556699;0,00421372907794355;0,00631336457351054
"309";"AGES";2021-07-19;2021;29;"All";"12-17 anos";257;267;1;525;4166;2810;7;6983;1284;2914;4198;0,00669248773873916;0,0020626870514981;0,00468120721811952;0,00674389426961762
"310";"AGES";2021-07-26;2021;30;"All";"12-17 anos";1613;377;0;1990;5779;3187;7;8973;2481;3339;5820;0,0092836981858314;0,00398561259717039;0,00536395020634903;0,00934956280351942
"311";"AGES";2021-08-02;2021;31;"All";"12-17 anos";4578;199;1;4778;10357;3386;8;13751;6728;3700;10428;0,0166380450096307;0,0108082231171956;0,00594388013282162;0,0167521032500173
"312";"AGES";2021-08-09;2021;32;"All";"12-17 anos";142506;403;2;142911;152863;3789;10;156662;137695;15364;153059;0,245567391552301;0,221200695915912;0,0246815606380193;0,245882256553931
"313";"AGES";2021-08-16;2021;33;"All";"12-17 anos";177116;1565;1;178682;329979;5354;11;335344;301026;29214;330240;0,530096114148202;0,483584448881828;0,0469309497838516;0,530515398665679
"314";"AGES";2021-08-23;2021;34;"All";"12-17 anos";131896;3923;3;135822;461875;9277;14;471166;420172;41989;462161;0,741980982796483;0,674987027883224;0,0674534007829857;0,742440428666209
"315";"AGES";2021-08-30;2021;35;"All";"12-17 anos";41855;109404;14;151273;503730;118681;28;622439;347935;156088;504023;0,809219118731415;0,558941603787376;0,250748205992395;0,809689809779771
"316";"AGES";2021-01-04;2021;1;"All";"18-24 anos";1834;3;0;1837;3197;4;0;3201;3192;5;3197;0,00409255288507697;0,00408615227061798;6,40061445898806e-06;0,00409255288507697
"317";"AGES";2021-01-11;2021;2;"All";"18-24 anos";1432;56;0;1488;4629;60;0;4689;4567;62;4629;0,00592568886613115;0,0058463212468397;7,9367619291452e-05;0,00592568886613115
"318";"AGES";2021-01-18;2021;3;"All";"18-24 anos";3851;1199;0;5050;8480;1259;0;9739;7216;1264;8480;0,0108554421224438;0,00923736678721157;0,00161807533523218;0,0108554421224438
"319";"AGES";2021-01-25;2021;4;"All";"18-24 anos";1391;1643;1;3035;9871;2902;1;12774;6965;2908;9873;0,0126360930649342;0,00891605594137037;0,00372259736934746;0,0126386533107178
"320";"AGES";2021-02-01;2021;5;"All";"18-24 anos";987;944;0;1931;10858;3846;1;14705;7007;3854;10861;0,0138995743591385;0,00896982110282587;0,004933593624988;0,0139034147278139
"321";"AGES";2021-02-08;2021;6;"All";"18-24 anos";1473;3070;0;4543;12331;6916;1;19248;5398;6936;12334;0,0157851953787564;0,00691010336992351;0,00887893237750824;0,0157890357474318
"322";"AGES";2021-02-15;2021;7;"All";"18-24 anos";2327;1744;1;4072;14658;8660;2;23320;5939;8722;14661;0,0187640413479694;0,00760264985438602;0,0111652318622588;0,0187678817166448
"323";"AGES";2021-02-22;2021;8;"All";"18-24 anos";1327;699;0;2026;15985;9359;2;25346;6541;9447;15988;0,0204627644253848;0,00837328383524818;0,012093320958812;0,0204666047940602
"324";"AGES";2021-03-01;2021;9;"All";"18-24 anos";948;1039;1;1988;16933;10398;3;27334;6427;10511;16938;0,021676320926809;0,00822734982558326;0,0134553717156847;0,021682721541268
"325";"AGES";2021-03-08;2021;10;"All";"18-24 anos";1377;643;1;2021;18310;11041;4;29355;7150;11168;18318;0,0234390501488143;0,00915287867635293;0,0142964124555957;0,0234492911319487
"326";"AGES";2021-03-15;2021;11;"All";"18-24 anos";269;389;2;660;18579;11430;6;30015;7029;11559;18588;0,0237834032067078;0,00899798380644542;0,0147969405062886;0,023794924312734
"327";"AGES";2021-03-22;2021;12;"All";"18-24 anos";3221;166;0;3387;21800;11596;6;33402;10066;11744;21810;0,027906679041188;0,0128857170288348;0,0150337632412712;0,0279194802701059
"328";"AGES";2021-03-29;2021;13;"All";"18-24 anos";675;95;0;770;22475;11691;6;34172;10633;11854;22487;0,0287707619931513;0,013611546708484;0,0151745767593689;0,0287861234678529
"329";"AGES";2021-04-05;2021;14;"All";"18-24 anos";794;170;0;964;23269;11861;6;35136;11264;12030;23294;0,0297871795692386;0,0144193042532083;0,0153998783883253;0,0298191826415336
"330";"AGES";2021-04-12;2021;15;"All";"18-24 anos";4295;96;0;4391;27564;11957;6;39527;15453;12143;27596;0,0352853073895094;0,0197817390469485;0,0155445322750984;0,0353262713220469
"331";"AGES";2021-04-19;2021;16;"All";"18-24 anos";1304;97;0;1401;28868;12054;6;40928;16619;12281;28900;0,0369545876404135;0,0212743623387845;0,0157211892341665;0,036995551572951
"332";"AGES";2021-04-26;2021;17;"All";"18-24 anos";2669;174;0;2843;31537;12228;6;43771;19114;12484;31598;0,0403712356386213;0,0244682689538196;0,0159810541812014;0,040449323135021
"333";"AGES";2021-05-03;2021;18;"All";"18-24 anos";1834;833;1;2668;33371;13061;7;46439;20131;13351;33482;0,0427189810221781;0,0257701539347777;0,0170909207283899;0,0428610746631677
"334";"AGES";2021-05-10;2021;19;"All";"18-24 anos";2234;5406;0;7640;35605;18467;7;54079;16938;18793;35731;0,045578775562454;0,021682721541268;0,0240573495055525;0,0457400710468205
"335";"AGES";2021-05-17;2021;20;"All";"18-24 anos";2087;2458;0;4545;37692;20925;7;58624;16502;21320;37822;0,0482503920376356;0,0211245879604442;0,0272922200531251;0,0484168080135693
"336";"AGES";2021-05-24;2021;21;"All";"18-24 anos";2252;3278;0;5530;39944;24203;7;64154;15277;24817;40094;0,0511332287899638;0,0195564374179921;0,0317688098057414;0,0513252472237335
"337";"AGES";2021-05-31;2021;22;"All";"18-24 anos";2318;2671;2;4991;42262;26874;9;69145;14695;27725;42420;0,0541005536531507;0,0188114058949659;0,0354914071750888;0,0543028130700547
"338";"AGES";2021-06-07;2021;23;"All";"18-24 anos";2806;2909;1;5716;45068;29783;10;74861;14397;30856;45253;0,0576925784875348;0,0184299292732102;0,0394994719493071;0,0579294012225174
"339";"AGES";2021-06-14;2021;24;"All";"18-24 anos";3033;4547;2;7582;48101;34330;12;82443;12896;35667;48563;0,061575191218357;0,016508464812622;0,0456581431817455;0,0621666079943675
"340";"AGES";2021-06-21;2021;25;"All";"18-24 anos";2752;3001;7;5760;50853;37331;19;88203;12807;39012;51819;0,065098089416584;0,016394533875252;0,0499401542548085;0,0663346881300605
"341";"AGES";2021-06-28;2021;26;"All";"18-24 anos";2000;3052;7;5059;52853;40383;26;93262;12011;42300;54311;0,0676583352001792;0,0153755560533811;0,054149198323039;0,0695247543764201
"342";"AGES";2021-07-05;2021;27;"All";"18-24 anos";11771;5051;12;16834;64624;45434;38;110096;19405;48289;67694;0,0827266617595289;0,0248407847153327;0,0618158543220149;0,0866566390373476
"343";"AGES";2021-07-12;2021;28;"All";"18-24 anos";14065;7790;7;21862;78689;53224;45;131958;30567;57312;87879;0,100731590232662;0,0391295164335776;0,0733664031747048;0,112495919608282
"344";"AGES";2021-07-19;2021;29;"All";"18-24 anos";19436;19599;0;39035;98125;72823;45;170993;45659;78973;124632;0,125612058757641;0,0584491311165872;0,101095145133933;0,15954427625052
"345";"AGES";2021-07-26;2021;30;"All";"18-24 anos";20916;22524;11;43451;119041;95347;56;214444;61220;103749;164969;0,15238710916248;0,0783691234358498;0,132811469901111;0,21118059333696
"346";"AGES";2021-08-02;2021;31;"All";"18-24 anos";53775;56335;4;110114;172816;151682;60;324558;100996;165733;266729;0,221225717668896;0,129287291579992;0,212158607226294;0,341445898806285
"347";"AGES";2021-08-09;2021;32;"All";"18-24 anos";87270;82393;7;169670;260086;234075;67;494228;164649;259374;424023;0,332942042436074;0,210770954011585;0,332030594937114;0,542801548948699
"348";"AGES";2021-08-16;2021;33;"All";"18-24 anos";93812;74081;11;167904;353898;308156;78;662132;228540;345302;573842;0,453032931161391;0,292559285691426;0,442028994783499;0,734588280474926
"349";"AGES";2021-08-23;2021;34;"All";"18-24 anos";56083;43507;6;99596;409981;351663;84;761728;248822;395363;644185;0,524826063302077;0,318522738182866;0,50611322686978;0,824635965052645
"350";"AGES";2021-08-30;2021;35;"All";"18-24 anos";22529;100041;5;122575;432510;451704;89;884303;170540;499757;670297;0,553665951931385;0,218312157967165;0,639750376036099;0,858062534003264
"351";"AGES";2021-01-04;2021;1;"All";"25-49 anos";27871;56;0;27927;51850;65;2;51917;51788;68;51856;0,0155632749933139;0,0155446650984328;2,04108524502478e-05;0,0155650759508831
"352";"AGES";2021-01-11;2021;2;"All";"25-49 anos";16711;801;0;17512;68561;866;2;69429;67688;879;68567;0,0205792419829623;0,0203172026566525;0,000263840283878938;0,0205810429405315
"353";"AGES";2021-01-18;2021;3;"All";"25-49 anos";37696;21818;6;59520;106257;22684;8;128949;83527;22737;106264;0,0318940580706762;0,025071430479586;0,00682472870825418;0,0318961591878402
"354";"AGES";2021-01-25;2021;4;"All";"25-49 anos";15739;26261;10;42010;121996;48945;18;170959;72983;49020;122003;0,036618269934124;0,0219065477114182;0,0147138233398698;0,036620371051288
"355";"AGES";2021-02-01;2021;5;"All";"25-49 anos";10073;12568;2;22643;132069;61513;20;193602;70485;61597;132082;0,0396417775331144;0,0211567490434664;0,0184889305643811;0,0396456796078475
"356";"AGES";2021-02-08;2021;6;"All";"25-49 anos";13878;30914;5;44797;145947;92427;25;238399;53339;92621;145960;0,0438073923905341;0,0160102126300554;0,0278010818352118;0,0438112944652672
"357";"AGES";2021-02-15;2021;7;"All";"25-49 anos";22415;19063;6;41484;168362;111490;31;279883;56354;112021;168375;0,0505354697092444;0,016915193808548;0,0336241779754295;0,0505393717839775
"358";"AGES";2021-02-22;2021;8;"All";"25-49 anos";11652;7327;2;18981;180014;118817;33;298864;60442;119585;180027;0,0540329293085133;0,0181422462323217;0,0358945851509247;0,0540368313832465
"359";"AGES";2021-03-01;2021;9;"All";"25-49 anos";7633;10024;6;17663;187647;128841;39;316527;57881;129788;187669;0,0563240474960537;0,017373537509894;0,0389571134972465;0,0563306510071405
"360";"AGES";2021-03-08;2021;10;"All";"25-49 anos";16411;6265;2;22678;204058;135106;41;339205;67883;136214;204097;0,0612499666072451;0,0203757337776496;0,0408859390537949;0,0612616728314445
"361";"AGES";2021-03-15;2021;11;"All";"25-49 anos";4647;3291;5;7943;208705;138397;46;347148;69208;139545;208753;0,0626448082445436;0,0207734452408346;0,0418857706642622;0,0626592159050967
"362";"AGES";2021-03-22;2021;12;"All";"25-49 anos";42369;1646;0;44015;251074;140043;46;391163;109753;141375;251128;0,0753622701190223;0,0329434160142948;0,0424350627228497;0,0753784787371445
"363";"AGES";2021-03-29;2021;13;"All";"25-49 anos";4695;1117;2;5814;255769;141160;48;396977;113284;142563;255847;0,0767715194168739;0,0340032795437334;0,0427916523215394;0,0767949318652728
"364";"AGES";2021-04-05;2021;14;"All";"25-49 anos";9097;1273;1;10371;264866;142433;49;407348;121055;143946;265001;0,0795020712512843;0,0363358197553639;0,043206773041226;0,0795425927965899
"365";"AGES";2021-04-12;2021;15;"All";"25-49 anos";89281;814;0;90095;354147;143247;49;497443;209389;144904;354293;0,106300620039675;0,0628501174074255;0,0434943259330986;0,106344443340524
"366";"AGES";2021-04-19;2021;16;"All";"25-49 anos";11120;874;1;11995;365267;144121;50;509438;219260;146158;365418;0,10963839473448;0,0658129927682549;0,0438707260650488;0,109683718833304
"367";"AGES";2021-04-26;2021;17;"All";"25-49 anos";11087;972;2;12061;376354;145093;52;521499;229291;147287;376578;0,112966264162655;0,0688238936642613;0,0442096062476419;0,113033499911903
"368";"AGES";2021-05-03;2021;18;"All";"25-49 anos";10384;8081;4;18469;386738;153174;56;539968;231476;155584;387060;0,116083121395646;0,0694797423790229;0,046700030406167;0,11617977278519
"369";"AGES";2021-05-10;2021;19;"All";"25-49 anos";25167;100393;8;125568;411905;253567;64;665536;155928;256395;412323;0,123637237919402;0,0468032853067976;0,0769594193232542;0,123762704630052
"370";"AGES";2021-05-17;2021;20;"All";"25-49 anos";32641;22020;7;54668;444546;275587;71;720204;165892;279200;445092;0,133434747255116;0,0497940755099486;0,0838045588839586;0,133598634393907
"371";"AGES";2021-05-24;2021;21;"All";"25-49 anos";26316;18404;7;44727;470862;293991;78;764931;171888;299787;471675;0,141333747153361;0,0515938324407087;0,0899839444632711;0,14157777690398
"372";"AGES";2021-05-31;2021;22;"All";"25-49 anos";42526;23842;22;66390;513388;317833;100;831321;188468;326117;514585;0,154098334084233;0,0565704785234309;0,097887146595845;0,154457625119276
"373";"AGES";2021-06-07;2021;23;"All";"25-49 anos";128186;32101;22;160309;641574;349934;122;991630;281324;363526;644850;0,192574591910519;0,084442097863434;0,109115816879835;0,193557914743269
"374";"AGES";2021-06-14;2021;24;"All";"25-49 anos";240254;85471;40;325765;881828;435405;162;1317395;443279;459071;902350;0,264689135213193;0,133054445048432;0,137794565370407;0,27084901041884
"375";"AGES";2021-06-21;2021;25;"All";"25-49 anos";272897;56272;160;329329;1154725;491677;322;1646724;671590;529135;1200725;0,34660178817077;0,201584182309734;0,158824947224439;0,360409129534173
"376";"AGES";2021-06-28;2021;26;"All";"25-49 anos";315306;61525;122;376953;1470031;553202;444;2023677;924472;608319;1532791;0,441243909386621;0,277489140976257;0,182592784583563;0,46008192555982
"377";"AGES";2021-07-05;2021;27;"All";"25-49 anos";368588;147170;19;515777;1838619;700372;463;2539454;1150347;779282;1929629;0,55187913413562;0,345287689464488;0,233908969399029;0,579196658863518
"378";"AGES";2021-07-12;2021;28;"All";"25-49 anos";208260;316276;57;524593;2046879;1016648;520;3064047;1116464;1117000;2233464;0,614390371360452;0,335117381911963;0,335278267454806;0,670395649366768
"379";"AGES";2021-07-19;2021;29;"All";"25-49 anos";103593;343457;53;447103;2150472;1360105;573;3511150;954410;1476496;2430906;0,645484804270431;0,286475318927074;0,443184441167369;0,729659760094442
"380";"AGES";2021-07-26;2021;30;"All";"25-49 anos";61328;353460;30;414818;2211800;1713565;603;3925968;711377;1844066;2555443;0,663892991903795;0,213526632110293;0,553514103448804;0,767040735559097
"381";"AGES";2021-08-02;2021;31;"All";"25-49 anos";52451;382677;35;435163;2264251;2096242;638;4361131;418435;2241300;2659735;0,679636662813618;0,125597280073815;0,672747699952065;0,79834498002588
"382";"AGES";2021-08-09;2021;32;"All";"25-49 anos";70236;236853;34;307123;2334487;2333095;672;4668254;291968;2497136;2789104;0,700718672117965;0,0876369965910875;0,749539330061794;0,837176326652881
"383";"AGES";2021-08-16;2021;33;"All";"25-49 anos";77654;144630;30;222314;2412141;2477725;702;4890568;252849;2657441;2910290;0,724027265296958;0,0758950533998927;0,797656413915279;0,873551467315172
"384";"AGES";2021-08-23;2021;34;"All";"25-49 anos";88005;79283;14;167302;2500146;2557008;716;5057870;265436;2752978;3018414;0,750442810442312;0,0796731622203526;0,826332761129092;0,906005923349445
"385";"AGES";2021-08-30;2021;35;"All";"25-49 anos";46254;79837;16;126107;2546400;2636845;732;5183977;225959;2846102;3072061;0,764326392342809;0,0678237618941991;0,854284823240517;0,922108585134716
"386";"AGES";2021-01-04;2021;1;"All";"50-64 anos";12991;5;0;12996;22234;5;0;22239;22230;7;22237;0,0102263794964633;0,0102245397232337;3,21960315171552e-06;0,0102277593263854
"387";"AGES";2021-01-11;2021;2;"All";"50-64 anos";11691;305;0;11996;33925;310;0;34235;33605;323;33928;0,0156035767031356;0,0154563948447714;0,000148561688286302;0,0156049565330577
"388";"AGES";2021-01-18;2021;3;"All";"50-64 anos";27435;8596;2;36033;61360;8906;2;70268;52422;8941;61363;0,0282221213413235;0,0241111480598901;0,00411235311135549;0,0282235011712456
"389";"AGES";2021-01-25;2021;4;"All";"50-64 anos";10777;12412;4;23193;72137;21318;6;93461;50774;21366;72140;0,0331789303650432;0,0233531614893148;0,00982714870565054;0,0331803101949654
"390";"AGES";2021-02-01;2021;5;"All";"50-64 anos";5553;9220;0;14773;77690;30538;6;108234;47102;30593;77695;0,0357329955509684;0,0216642496645863;0,014071045602919;0,0357352952675053
"391";"AGES";2021-02-08;2021;6;"All";"50-64 anos";6893;22286;3;29182;84583;52824;9;137416;31654;52934;84588;0,0389033847687934;0,0145590454520576;0,0243466390332728;0,0389056844853303
"392";"AGES";2021-02-15;2021;7;"All";"50-64 anos";25114;12961;1;38076;109697;65785;10;175492;43686;66016;109702;0,0504544009905339;0,0200930833265492;0,0303636173805217;0,0504567007070708
"393";"AGES";2021-02-22;2021;8;"All";"50-64 anos";49819;4961;4;54784;159516;70746;14;230276;88368;71153;159521;0,0733683166212933;0,0406442701872567;0,0327263461505735;0,0733706163378302
"394";"AGES";2021-03-01;2021;9;"All";"50-64 anos";30179;5985;3;36167;189695;76731;17;266443;112482;77222;189704;0,0872489456949536;0,0517353431016093;0,0355177420831108;0,0872530851847201
"395";"AGES";2021-03-08;2021;10;"All";"50-64 anos";22302;4281;0;26583;211997;81012;17;293026;130434;81580;212014;0,0975066013363193;0,0599922453558374;0,0375221750167074;0,0975144203725449
"396";"AGES";2021-03-15;2021;11;"All";"50-64 anos";4592;2313;1;6906;216589;83325;18;299932;132706;83916;216622;0,0996186610038447;0,0610372365502228;0,0385966025827656;0,0996338391329885
"397";"AGES";2021-03-22;2021;12;"All";"50-64 anos";34579;978;2;35559;251168;84303;20;335491;166178;85031;251209;0,115523040630012;0,0764324589351117;0,0391094393705032;0,115541898305615
"398";"AGES";2021-03-29;2021;13;"All";"50-64 anos";7792;764;1;8557;258960;85067;21;344048;173199;85819;259018;0,119106918881179;0,0796617208962823;0,0394718746967249;0,119133595593007
"399";"AGES";2021-04-05;2021;14;"All";"50-64 anos";15180;939;1;16120;274140;86006;22;360168;187387;86845;274232;0,126088858287327;0,0861873965415023;0,0399437765301049;0,126131173071607
"400";"AGES";2021-04-12;2021;15;"All";"50-64 anos";88013;577;0;88590;362153;86583;22;448758;274740;87515;362255;0,166569848600462;0,12636482427176;0,0402519385460548;0,166616762817815
"401";"AGES";2021-04-19;2021;16;"All";"50-64 anos";14434;1803;4;16241;376587;88386;26;464999;287123;89568;376691;0,173208670299299;0,132060302247145;0,0411962021561222;0,173256504403267
"402";"AGES";2021-04-26;2021;17;"All";"50-64 anos";32923;2942;4;35869;409510;91328;30;500868;317228;92650;409878;0,188351383808432;0,145906895516059;0,0426137474294918;0,188520642945551
"403";"AGES";2021-05-03;2021;18;"All";"50-64 anos";151481;14788;10;166279;560991;106116;40;667147;459230;107789;567019;0,258024055954863;0,21121976505176;0,0495768291600377;0,260796594211797
"404";"AGES";2021-05-10;2021;19;"All";"50-64 anos";166698;109717;11;276426;727689;215833;51;943573;525309;218125;743434;0,334695685409816;0,241612358860647;0,100325133923993;0,341937492784639
"405";"AGES";2021-05-17;2021;20;"All";"50-64 anos";224767;75769;12;300548;952456;291602;63;1244121;689121;297325;986446;0,43807576278148;0,316956591930479;0,136752643869117;0,453709235799595
"406";"AGES";2021-05-24;2021;21;"All";"50-64 anos";175271;98440;82;273793;1127727;390042;145;1517914;800686;405155;1205841;0,51869048621067;0,368270167019213;0,186348330704757;0,554618497723971
"407";"AGES";2021-05-31;2021;22;"All";"50-64 anos";163687;168795;14;332496;1291414;558837;159;1850410;837329;582155;1419484;0,593977226367078;0,385123869631829;0,267758296112421;0,65288216574425
"408";"AGES";2021-06-07;2021;23;"All";"50-64 anos";209865;139186;41;349092;1501279;698023;200;2199502;920575;732342;1652917;0,690503228572046;0,423412310198645;0,336835801619092;0,760248111817737
"409";"AGES";2021-06-14;2021;24;"All";"50-64 anos";86268;231046;63;317377;1587547;929069;263;2516879;785654;970013;1755667;0,730181617813788;0,361356299222558;0,446150987429289;0,807507286651847
"410";"AGES";2021-06-21;2021;25;"All";"50-64 anos";86531;183671;211;270413;1674078;1112740;474;2787292;696563;1161595;1858158;0,769980972145373;0,32037949002406;0,534267846145284;0,854647336169344
"411";"AGES";2021-06-28;2021;26;"All";"50-64 anos";59370;178778;72;238220;1733448;1291518;546;3025512;576639;1347870;1924509;0,797287806304995;0,265221248828869;0,619943785728971;0,88516503455784
"412";"AGES";2021-07-05;2021;27;"All";"50-64 anos";41414;257897;48;299359;1774862;1549415;594;3324871;359714;1613204;1972918;0,816335898437159;0,165448046873742;0,74198238325144;0,907430430125183
"413";"AGES";2021-07-12;2021;28;"All";"50-64 anos";15403;134373;31;149807;1790265;1683788;625;3474678;245668;1753781;1999449;0,823420405200855;0,112993352439378;0,806639833574114;0,919633186013492
"414";"AGES";2021-07-19;2021;29;"All";"50-64 anos";10921;114890;25;125836;1801186;1798678;650;3600514;153479;1875375;2028854;0,828443446060839;0,0705916388745923;0,862566180092642;0,933157818967234
"415";"AGES";2021-07-26;2021;30;"All";"50-64 anos";9817;87290;19;97126;1811003;1885968;669;3697640;85953;1969422;2055375;0,832958709509466;0,0395335070999149;0,905822468322555;0,945355975422469
"416";"AGES";2021-08-02;2021;31;"All";"50-64 anos";8599;53877;12;62488;1819602;1939845;681;3760128;49122;2029439;2078561;0,836913762009695;0,02259333514551;0,933426885802056;0,956020220947566
"417";"AGES";2021-08-09;2021;32;"All";"50-64 anos";7337;24254;5;31596;1826939;1964099;686;3791724;38072;2058922;2096994;0,840288366056;0,0175109615988733;0,946987394333774;0,964498355932648
"418";"AGES";2021-08-16;2021;33;"All";"50-64 anos";7503;12930;12;20445;1834442;1977029;698;3812169;35928;2076079;2112007;0,843739320691332;0,0165248431478336;0,954878641658629;0,971403484806463
"419";"AGES";2021-08-23;2021;34;"All";"50-64 anos";11282;8165;2;19449;1845724;1985194;700;3831618;39227;2089019;2128246;0,848928401085282;0,0180421961189064;0,960830308056229;0,978872504175135
"420";"AGES";2021-08-30;2021;35;"All";"50-64 anos";12847;6002;9;18858;1858571;1991196;709;3850476;43741;2100410;2144151;0,854837292755295;0,0201183802084555;0,966069522270685;0,98618790247914
"421";"AGES";2021-01-04;2021;1;"All";"65-79 anos";2301;1;0;2302;3263;2;0;3265;3261;2;3263;0,00200422835058702;0,0020029998931242;1,22845746281766e-06;0,00200422835058702
"422";"AGES";2021-01-11;2021;2;"All";"65-79 anos";5540;29;0;5569;8803;31;0;8834;8763;40;8803;0,00540705552259195;0,00538248637333559;2,45691492563533e-05;0,00540705552259195
"423";"AGES";2021-01-18;2021;3;"All";"65-79 anos";14101;918;0;15019;22904;949;0;23853;21926;978;22904;0,0140682948641879;0,01346757916487;0,000600715699317838;0,0140682948641879
"424";"AGES";2021-01-25;2021;4;"All";"65-79 anos";6545;2153;0;8698;29449;3102;0;32551;26302;3147;29449;0,0180884219112587;0,0161554440935151;0,00193297781774359;0,0180884219112587
"425";"AGES";2021-02-01;2021;5;"All";"65-79 anos";2772;4177;0;6949;32221;7279;0;39500;24896;7325;32221;0,019791063954724;0,0152918384971543;0,00449922545756969;0,019791063954724
"426";"AGES";2021-02-08;2021;6;"All";"65-79 anos";3766;11529;2;15297;35987;18808;2;54797;17112;18875;35987;0,0221042493572096;0,0105106820518679;0,0115935673053417;0,0221042493572096
"427";"AGES";2021-02-15;2021;7;"All";"65-79 anos";5111;7241;0;12352;41098;26049;2;67149;14950;26148;41098;0,0252435724034402;0,00918271953456204;0,0160608528688781;0,0252435724034402
"428";"AGES";2021-02-22;2021;8;"All";"65-79 anos";11659;2463;3;14125;52757;28512;5;81274;24087;28670;52757;0,0324048651829357;0,0147949274534445;0,0176099377294912;0,0324048651829357
"429";"AGES";2021-03-01;2021;9;"All";"65-79 anos";13282;3804;1;17087;66039;32316;6;98361;33553;32495;66048;0,0405630511935079;0,0206092166249605;0,01995936262713;0,0405685792520905
"430";"AGES";2021-03-08;2021;10;"All";"65-79 anos";15904;3570;0;19474;81943;35886;6;117835;45876;36090;81966;0,0503317449378339;0,0281783572821116;0,0221675149165447;0,0503458721986563
"431";"AGES";2021-03-15;2021;11;"All";"65-79 anos";18127;6837;4;24968;100070;42723;10;142803;57164;42937;100101;0,0614658691520818;0,0351117712022545;0,026373139040501;0,0614849102427555
"432";"AGES";2021-03-22;2021;12;"All";"65-79 anos";52795;2197;3;54995;152865;44920;13;197798;107708;45196;152904;0,0938940750268111;0,0661573482025825;0,0277606817447536;0,093918029947336
"433";"AGES";2021-03-29;2021;13;"All";"65-79 anos";88246;7359;1;95606;241111;52279;14;293404;188564;52595;241159;0,148097303658715;0,115821426509375;0,0323053601284475;0,148126786637822
"434";"AGES";2021-04-05;2021;14;"All";"65-79 anos";201352;5330;7;206689;442463;57609;21;500093;384488;58040;442528;0,271773487185346;0,236163576481919;0,0356498355709686;0,271813412052888
"435";"AGES";2021-04-12;2021;15;"All";"65-79 anos";233715;3573;8;237296;676178;61182;29;737389;614506;61740;676246;0,415327955146561;0,377447240823116;0,0379224818771813;0,415369722700297
"436";"AGES";2021-04-19;2021;16;"All";"65-79 anos";175782;13218;12;189012;851960;74400;41;926401;776899;75132;852031;0,523298310011068;0,47719368720279;0,0461482330482084;0,523341920250998
"437";"AGES";2021-04-26;2021;17;"All";"65-79 anos";293242;46352;11;339605;1145202;120752;52;1266006;1024557;121717;1146274;0,703415971666857;0,629312346366039;0,0747620785008888;0,704074424866927
"438";"AGES";2021-05-03;2021;18;"All";"65-79 anos";202457;164161;10;366628;1347659;284913;62;1632634;1069125;286143;1355268;0,827770877941695;0,656687292467467;0,175757251891517;0,832444544358985
"439";"AGES";2021-05-10;2021;19;"All";"65-79 anos";91538;80191;10;171739;1439197;365104;72;1804373;1087851;366783;1454634;0,883996147557397;0,668189339691829;0,225288656792326;0,893477996484155
"440";"AGES";2021-05-17;2021;20;"All";"65-79 anos";41308;111674;11;152993;1480505;476778;83;1957366;1017243;483892;1501135;0,909368707994433;0,624819877424514;0,297220369298882;0,922040246723397
"441";"AGES";2021-05-24;2021;21;"All";"65-79 anos";23622;202531;28;226181;1504127;679309;111;2183547;834131;695260;1529391;0,923878019087772;0,51234722595878;0,427048667799304;0,939395893758085
"442";"AGES";2021-05-31;2021;22;"All";"65-79 anos";18682;137450;16;156148;1522809;816759;127;2339695;717974;835805;1553779;0,935353040247952;0,441000259204525;0,513375444855159;0,954375704059683
"443";"AGES";2021-06-07;2021;23;"All";"65-79 anos";16084;71628;8;87720;1538893;888387;135;2427415;661700;910283;1571983;0,945232295163931;0,406435151573224;0,559121972313026;0,96555712388625
"444";"AGES";2021-06-14;2021;24;"All";"65-79 anos";10897;62545;12;73454;1549790;950932;147;2500869;609329;974905;1584234;0,951925545650094;0,374267378680612;0,598814661394127;0,973082040074739
"445";"AGES";2021-06-21;2021;25;"All";"65-79 anos";10300;97124;21;107445;1560090;1048056;168;2608314;521843;1074609;1596452;0,958252101583605;0,320530963884579;0,660055722830513;0,980586686715092
"446";"AGES";2021-06-28;2021;26;"All";"65-79 anos";9066;182187;42;191295;1569156;1230243;210;2799609;347285;1259618;1606903;0,963820699262557;0,213312424987316;0,77369356619973;0,987005991187046
"447";"AGES";2021-07-05;2021;27;"All";"65-79 anos";8161;203803;24;211988;1577317;1434046;234;3011597;149780;1466378;1616158;0,968833419939584;0,0919991793904148;0,90069149870582;0,992690678096235
"448";"AGES";2021-07-12;2021;28;"All";"65-79 anos";5490;57690;12;63192;1582807;1491736;246;3074789;96584;1527337;1623921;0,972205535675019;0,0593246677943906;0,938134267943771;0,997458935738162
"449";"AGES";2021-07-19;2021;29;"All";"65-79 anos";7143;42551;9;49703;1589950;1534287;255;3124492;58854;1574942;1633796;0,976592971503472;0,0361498177583354;0,967374626702489;1
"450";"AGES";2021-07-26;2021;30;"All";"65-79 anos";8621;32363;7;40991;1598571;1566650;262;3165483;31258;1613368;1644626;0,981888237396948;0,0191995616863773;0,990976979935604;1
"451";"AGES";2021-08-02;2021;31;"All";"65-79 anos";7611;11692;4;19307;1606182;1578342;266;3184790;23404;1630640;1654044;0,9865631322717;0,0143754092298923;1;1
"452";"AGES";2021-08-09;2021;32;"All";"65-79 anos";4589;6254;2;10845;1610771;1584596;268;3195635;20126;1639965;1660091;0,989381827920136;0,0123619674483342;1;1
"453";"AGES";2021-08-16;2021;33;"All";"65-79 anos";3682;2971;5;6658;1614453;1587567;273;3202293;19803;1645125;1664928;0,991643418109183;0,0121635715680891;1;1
"454";"AGES";2021-08-23;2021;34;"All";"65-79 anos";4295;2493;1;6789;1618748;1590060;274;3209082;20817;1649740;1670557;0,994281530510584;0,0127863995017377;1;1
"455";"AGES";2021-08-30;2021;35;"All";"65-79 anos";4880;2223;4;7107;1623628;1592283;278;3216189;22357;1654240;1676597;0,997278966719859;0,0137323117481073;1;1
"456";"AGES";2021-01-04;2021;1;"All";"80 ou mais anos";3768;7;1;3776;4032;7;2;4041;4024;8;4032;0,00591557974735545;0,00590384248595197;1,1737261403483e-05;0,00591557974735545
"457";"AGES";2021-01-11;2021;2;"All";"80 ou mais anos";14490;1;1;14492;18522;8;3;18533;18487;35;18522;0,0271746944644141;0,0271233439457739;5,13505186402383e-05;0,0271746944644141
"458";"AGES";2021-01-18;2021;3;"All";"80 ou mais anos";39038;256;1;39295;57560;264;4;57828;57159;401;57560;0,0844495957980604;0,0838612655702108;0,000588330227849587;0,0844495957980604
"459";"AGES";2021-01-25;2021;4;"All";"80 ou mais anos";7363;3386;2;10751;64923;3650;6;68579;61104;3819;64923;0,0952522777622911;0,0896492025998034;0,00560307516248771;0,0952522777622911
"460";"AGES";2021-02-01;2021;5;"All";"80 ou mais anos";4525;10645;0;15170;69448;14295;6;83749;54976;14472;69448;0,101891166243636;0,0806584603647354;0,0212327058789008;0,101891166243636
"461";"AGES";2021-02-08;2021;6;"All";"80 ou mais anos";14834;31533;2;46369;84282;45828;8;130118;38178;46104;84282;0,123654983201045;0,0560131457327719;0,0676418374682727;0,123654983201045
"462";"AGES";2021-02-15;2021;7;"All";"80 ou mais anos";48614;9252;2;57868;132896;55080;10;187986;77465;55431;132896;0,19497938643466;0,113653369327602;0,0813260171070585;0,19497938643466
"463";"AGES";2021-02-22;2021;8;"All";"80 ou mais anos";102538;5195;1;107734;235434;60275;11;295720;174671;60763;235434;0,345418800158453;0,256269898325973;0,0891489018324799;0,345418800158453
"464";"AGES";2021-03-01;2021;9;"All";"80 ou mais anos";87186;12744;1;99931;322620;73019;12;395651;249051;73569;322620;0,473334409248962;0,365397086224857;0,107937323024105;0,473334409248962
"465";"AGES";2021-03-08;2021;10;"All";"80 ou mais anos";40135;37266;0;77401;362755;110285;12;473052;251898;110857;362755;0,532218782552561;0,369574084126821;0,16264469842574;0,532218782552561
"466";"AGES";2021-03-15;2021;11;"All";"80 ou mais anos";54349;97378;6;151733;417104;207663;18;624785;208821;208283;417104;0,611957335054798;0,306373332942091;0,305584002112707;0,611957335054798
"467";"AGES";2021-03-22;2021;12;"All";"80 ou mais anos";124524;16900;2;141426;541628;224563;20;766211;316330;225298;541628;0,794653677430713;0,464105987470473;0,33054768996024;0,794653677430713
"468";"AGES";2021-03-29;2021;13;"All";"80 ou mais anos";36734;75401;4;112139;578362;299964;24;878350;277610;300754;578364;0,848548247480157;0,407297642277616;0,441253539517892;0,848551181795508
"469";"AGES";2021-04-05;2021;14;"All";"80 ou mais anos";30367;45818;12;76197;608729;345782;36;954547;262096;346635;608731;0,893101424610103;0,384536158100911;0,508568200824543;0,893104358925454
"470";"AGES";2021-04-12;2021;15;"All";"80 ou mais anos";10500;49451;14;59965;619229;395233;50;1014512;223076;396155;619231;0,908506580202174;0,327287665605423;0,581221848912103;0,908509514517525
"471";"AGES";2021-04-19;2021;16;"All";"80 ou mais anos";8418;123200;13;131631;627647;518433;63;1146143;108199;519450;627649;0,920857113513989;0,158744993324433;0,762115054504908;0,92086004782934
"472";"AGES";2021-04-26;2021;17;"All";"80 ou mais anos";6137;39775;4;45916;633784;558208;67;1192059;74520;559277;633797;0,929861060168136;0,109332589973444;0,820547543244472;0,929880133217917
"473";"AGES";2021-05-03;2021;18;"All";"80 ou mais anos";5103;31787;6;36896;638887;589995;73;1228955;47890;591158;639048;0,937347965785883;0,0702621810766003;0,867321997095028;0,937584178171628
"474";"AGES";2021-05-10;2021;19;"All";"80 ou mais anos";3780;9973;2;13755;642667;599968;75;1242710;41773;601256;643029;0,942893821799029;0,0612875775759621;0,882137355301574;0,943424932877536
"475";"AGES";2021-05-17;2021;20;"All";"80 ou mais anos";4749;8366;3;13118;647416;608334;78;1255828;37141;611073;648214;0,949861353599671;0,0544917032233454;0,896540442201323;0,951032145424669
"476";"AGES";2021-05-24;2021;21;"All";"80 ou mais anos";4449;6352;0;10801;651865;614686;78;1266629;33415;619723;653138;0,956388738097683;0,0490250737246732;0,909231356093839;0,958256429818513
"477";"AGES";2021-05-31;2021;22;"All";"80 ou mais anos";3053;6060;3;9116;654918;620746;81;1275745;30016;626775;656791;0,960867970480788;0,0440382047858683;0,91957775202101;0,963615956806878
"478";"AGES";2021-06-07;2021;23;"All";"80 ou mais anos";2752;4812;1;7565;657670;625558;82;1283310;27479;632441;659920;0,964905588403586;0,0403160257632888;0,927890667410027;0,968206693173315
"479";"AGES";2021-06-14;2021;24;"All";"80 ou mais anos";2628;4775;0;7403;660298;630333;82;1290713;24659;638160;662819;0,96876127877463;0,036178641118561;0,936281342155841;0,972459983274403
"480";"AGES";2021-06-21;2021;25;"All";"80 ou mais anos";3404;4805;3;8212;663702;635138;85;1298925;21962;644722;666684;0,973755483501812;0,0322217168679118;0,945908830822048;0,97813054768996
"481";"AGES";2021-06-28;2021;26;"All";"80 ou mais anos";3273;5416;1;8690;666975;640554;86;1307615;18452;651926;670378;0,978557490573512;0,0270719934271336;0,956478234715885;0,983550228143019
"482";"AGES";2021-07-05;2021;27;"All";"80 ou mais anos";2677;5233;2;7912;669652;645787;88;1315527;14732;658654;673386;0,982485071670652;0,021614166874514;0,966349271556214;0,987963438430728
"483";"AGES";2021-07-12;2021;28;"All";"80 ou mais anos";2113;3532;2;5647;671765;649319;90;1321174;12378;663618;675996;0,985585175838847;0,0181604777065391;0,973632242257075;0,991792719963615
"484";"AGES";2021-07-19;2021;29;"All";"80 ou mais anos";2205;3082;1;5288;673970;652401;91;1326462;10516;668283;678799;0,988820258513182;0,0154286301148784;0,980476532812981;0,99590516292786
"485";"AGES";2021-07-26;2021;30;"All";"80 ou mais anos";2588;2887;1;5476;676558;655288;92;1331938;8862;673031;681893;0,992617262577209;0,0130019513197083;0,987442597455949;1
"486";"AGES";2021-08-02;2021;31;"All";"80 ou mais anos";2487;2091;1;4579;679045;657379;93;1336517;7893;676946;684839;0,996266083716017;0,0115802755322114;0,993186519755278;1
"487";"AGES";2021-08-09;2021;32;"All";"80 ou mais anos";1575;1720;1;3296;680620;659099;94;1339813;7097;679746;686843;0,998576857054828;0,0104124180225649;0,997294561246497;1
"488";"AGES";2021-08-16;2021;33;"All";"80 ou mais anos";1338;1127;1;2466;681958;660226;95;1342279;6734;681758;688492;1,00053991402456;0,00987983978638184;1;1
"489";"AGES";2021-08-23;2021;34;"All";"80 ou mais anos";1533;970;0;2503;683491;661196;95;1344782;6855;683547;690402;1,002789066741;0,0100573658651095;1;1
"490";"AGES";2021-08-30;2021;35;"All";"80 ou mais anos";1662;806;0;2468;685153;662002;95;1347250;7258;685119;692377;1,00522748279758;0,01064863040831;1;1
"491";"AGES";2021-01-04;2021;1;"All";"Desconhecido";1;0;0;1;1;0;0;1;1;0;1;NA;NA;NA;NA
"492";"AGES";2021-01-11;2021;2;"All";"Desconhecido";0;0;0;0;1;0;0;1;1;0;1;NA;NA;NA;NA
"493";"AGES";2021-01-18;2021;3;"All";"Desconhecido";0;0;0;0;1;0;0;1;1;0;1;NA;NA;NA;NA
"494";"AGES";2021-01-25;2021;4;"All";"Desconhecido";0;0;0;0;1;0;0;1;1;0;1;NA;NA;NA;NA
"495";"AGES";2021-02-01;2021;5;"All";"Desconhecido";0;0;0;0;1;0;0;1;1;0;1;NA;NA;NA;NA
"496";"AGES";2021-02-08;2021;6;"All";"Desconhecido";1;0;0;1;2;0;0;2;2;0;2;NA;NA;NA;NA
"497";"AGES";2021-02-15;2021;7;"All";"Desconhecido";0;0;0;0;2;0;0;2;2;0;2;NA;NA;NA;NA
"498";"AGES";2021-02-22;2021;8;"All";"Desconhecido";0;0;0;0;2;0;0;2;2;0;2;NA;NA;NA;NA
"499";"AGES";2021-03-01;2021;9;"All";"Desconhecido";0;0;0;0;2;0;0;2;2;0;2;NA;NA;NA;NA
"500";"AGES";2021-03-08;2021;10;"All";"Desconhecido";0;0;0;0;2;0;0;2;2;0;2;NA;NA;NA;NA
"501";"AGES";2021-03-15;2021;11;"All";"Desconhecido";0;0;0;0;2;0;0;2;2;0;2;NA;NA;NA;NA
"502";"AGES";2021-03-22;2021;12;"All";"Desconhecido";0;0;0;0;2;0;0;2;2;0;2;NA;NA;NA;NA
"503";"AGES";2021-03-29;2021;13;"All";"Desconhecido";0;0;0;0;2;0;0;2;2;0;2;NA;NA;NA;NA
"504";"AGES";2021-04-05;2021;14;"All";"Desconhecido";0;0;0;0;2;0;0;2;2;0;2;NA;NA;NA;NA
"505";"AGES";2021-04-12;2021;15;"All";"Desconhecido";0;0;0;0;2;0;0;2;2;0;2;NA;NA;NA;NA
"506";"AGES";2021-04-19;2021;16;"All";"Desconhecido";0;0;0;0;2;0;0;2;2;0;2;NA;NA;NA;NA
"507";"AGES";2021-04-26;2021;17;"All";"Desconhecido";1;0;0;1;3;0;0;3;3;0;3;NA;NA;NA;NA
"508";"AGES";2021-05-03;2021;18;"All";"Desconhecido";1;0;0;1;4;0;0;4;4;0;4;NA;NA;NA;NA
"509";"AGES";2021-05-10;2021;19;"All";"Desconhecido";0;1;0;1;4;1;0;5;3;1;4;NA;NA;NA;NA
"510";"AGES";2021-05-17;2021;20;"All";"Desconhecido";0;0;0;0;4;1;0;5;3;1;4;NA;NA;NA;NA
"511";"AGES";2021-05-24;2021;21;"All";"Desconhecido";0;1;0;1;4;2;0;6;2;2;4;NA;NA;NA;NA
"512";"AGES";2021-05-31;2021;22;"All";"Desconhecido";0;0;0;0;4;2;0;6;2;2;4;NA;NA;NA;NA
"513";"AGES";2021-06-07;2021;23;"All";"Desconhecido";0;0;0;0;4;2;0;6;2;2;4;NA;NA;NA;NA
"514";"AGES";2021-06-14;2021;24;"All";"Desconhecido";0;0;0;0;4;2;0;6;2;2;4;NA;NA;NA;NA
"515";"AGES";2021-06-21;2021;25;"All";"Desconhecido";0;0;0;0;4;2;0;6;2;2;4;NA;NA;NA;NA
"516";"AGES";2021-06-28;2021;26;"All";"Desconhecido";1;0;0;1;5;2;0;7;3;2;5;NA;NA;NA;NA
"517";"AGES";2021-07-05;2021;27;"All";"Desconhecido";0;1;0;1;5;3;0;8;2;3;5;NA;NA;NA;NA
"518";"AGES";2021-07-12;2021;28;"All";"Desconhecido";0;2;0;2;5;5;0;10;0;5;5;NA;NA;NA;NA
"519";"AGES";2021-07-19;2021;29;"All";"Desconhecido";0;0;0;0;5;5;0;10;0;5;5;NA;NA;NA;NA
"520";"AGES";2021-07-26;2021;30;"All";"Desconhecido";0;2;0;2;5;7;0;12;-1;7;6;NA;NA;NA;NA
"521";"AGES";2021-08-02;2021;31;"All";"Desconhecido";0;0;0;0;5;7;0;12;-1;7;6;NA;NA;NA;NA
"522";"AGES";2021-08-09;2021;32;"All";"Desconhecido";0;1;0;1;5;8;0;13;-1;8;7;NA;NA;NA;NA
"523";"AGES";2021-08-16;2021;33;"All";"Desconhecido";1;0;0;1;6;8;0;14;0;8;8;NA;NA;NA;NA
"524";"AGES";2021-08-23;2021;34;"All";"Desconhecido";0;0;0;0;6;8;0;14;0;8;8;NA;NA;NA;NA
"525";"AGES";2021-08-30;2021;35;"All";"Desconhecido";0;1;0;1;6;9;0;15;-1;9;8;NA;NA;NA;NA
"526";"GENERAL";2021-01-04;2021;1;"All";"All";48771;72;1;48844;84584;83;4;84671;84503;90;84593;0,00817403196709049;0,00816620428585841;8,69742359120099e-06;0,00817490170944962
"527";"GENERAL";2021-01-11;2021;2;"All";"All";49879;1192;1;51072;134463;1275;5;135743;133133;1339;134472;0,012994240759374;0,012865712166304;0,00012939833542909;0,0129951105017331
"528";"GENERAL";2021-01-18;2021;3;"All";"All";122191;32788;9;154988;256654;34063;14;290731;222342;34322;256664;0,0248025394930678;0,0214866950679423;0,00331681080552445;0,0248035058734668
"529";"GENERAL";2021-01-25;2021;4;"All";"All";41829;45858;17;87704;298483;79921;31;378435;218231;80264;298495;0,0288448120641383;0,0210894160859043;0,00775655563471285;0,0288459717206171
"530";"GENERAL";2021-02-01;2021;5;"All";"All";23946;37558;2;61506;322429;117479;33;439941;204601;117849;322450;0,0311589065676372;0,0197722396020368;0,0113886963644383;0,0311609359664751
"531";"GENERAL";2021-02-08;2021;6;"All";"All";40883;99398;12;140293;363312;216877;45;580234;145789;217544;363333;0,0351097595529602;0,0140887631993067;0,0210230257524914;0,0351117889517981
"532";"GENERAL";2021-02-15;2021;7;"All";"All";103613;50277;10;153900;466925;267154;55;734134;198518;268428;466946;0,0451227167813502;0,0191843904053115;0,0259403557748767;0,0451247461801882
"533";"GENERAL";2021-02-22;2021;8;"All";"All";177018;20677;10;197705;643943;287831;65;931839;354224;289740;643964;0,0622293893287638;0,0342315130463287;0,0279999056812731;0,0622314187276017
"534";"GENERAL";2021-03-01;2021;9;"All";"All";139240;33626;12;172878;783183;321457;77;1104717;459491;323737;783228;0,0756852700047507;0,044404309592717;0,0312853091238293;0,0756896187165463
"535";"GENERAL";2021-03-08;2021;10;"All";"All";96147;52050;3;148200;879330;373507;80;1252917;503330;376087;879417;0,0849767276272307;0,0486408246239911;0,0363443105127112;0,0849851351367022
"536";"GENERAL";2021-03-15;2021;11;"All";"All";81989;110231;18;192238;961319;483738;98;1445155;474999;486441;961440;0,0928999838807749;0,0459029723155209;0,0470087047680822;0,0929116770836031
"537";"GENERAL";2021-03-22;2021;12;"All";"All";257519;21898;7;279424;1218838;505636;105;1724579;710126;508856;1218982;0,117786115278358;0,0686251847236133;0,0491748464324908;0,117800031156104
"538";"GENERAL";2021-03-29;2021;13;"All";"All";138158;84750;8;222916;1356996;590386;113;1947495;763383;593811;1357194;0,131137433595171;0,0737718368146865;0,057384731112385;0,131156567927072
"539";"GENERAL";2021-04-05;2021;14;"All";"All";256819;53534;21;310374;1613815;643920;134;2257869;966408;647726;1614134;0,155955918364823;0,0933917748658374;0,0625949710337139;0,155986745899551
"540";"GENERAL";2021-04-12;2021;15;"All";"All";425850;54517;22;480389;2039665;698437;156;2738258;1337322;702693;2040015;0,197109227657189;0,129236176798134;0,06790687417302;0,197143050971154
"541";"GENERAL";2021-04-19;2021;16;"All";"All";211091;139206;30;350327;2250756;837643;186;3088585;1408275;842841;2251116;0,217508648138191;0,136092935643318;0,0814505021892382;0,217543437832556
"542";"GENERAL";2021-04-26;2021;17;"All";"All";346108;90243;21;436372;2596864;927886;207;3524957;1664906;933696;2598602;0,250955846852673;0,160893252461468;0,0902305513045556;0,251123803766023
"543";"GENERAL";2021-05-03;2021;18;"All";"All";371371;219666;32;591069;2968235;1147552;239;4116026;1828143;1154323;2982466;0,286844412369205;0,176668156180988;0,111551512134066;0,288219668315054
"544";"GENERAL";2021-05-10;2021;19;"All";"All";289581;305725;31;595337;3257816;1453277;270;4711363;1828209;1461695;3289904;0,314828952602134;0,176674534291622;0,141255339734895;0,317929874026517
"545";"GENERAL";2021-05-17;2021;20;"All";"All";305867;220312;33;526212;3563683;1673589;303;5237575;1926599;1693178;3619777;0,34438733995291;0,186182751037603;0,163625403125583;0,349808154163186
"546";"GENERAL";2021-05-24;2021;21;"All";"All";232212;329046;117;561375;3795895;2002635;420;5798950;1856352;2045157;3901509;0,366827852474688;0,17939421864859;0,197639963772332;0,377034182420922
"547";"GENERAL";2021-05-31;2021;22;"All";"All";230539;338932;57;569528;4026434;2341567;477;6368478;1789585;2399117;4188702;0,389106689555709;0,172941986638438;0,231845964376126;0,404787951014564
"548";"GENERAL";2021-06-07;2021;23;"All";"All";360086;250800;73;610959;4386520;2592367;550;6979437;1906802;2670158;4576960;0,423904694791944;0,184269607761658;0,258038835349267;0,442308443110925
"549";"GENERAL";2021-06-14;2021;24;"All";"All";343660;388716;117;732493;4730180;2981083;667;7711930;1877388;3078863;4956251;0,457115323584746;0,181427096455974;0,29753528544751;0,478962381903483
"550";"GENERAL";2021-06-21;2021;25;"All";"All";376288;345168;404;721860;5106468;3326251;1071;8433790;1926441;3450425;5376866;0,493479058343477;0,186167482227298;0,333442308829663;0,519609791056961
"551";"GENERAL";2021-06-28;2021;26;"All";"All";389235;431232;244;820711;5495703;3757483;1315;9254501;1880476;3911664;5792140;0,531093965804823;0,181725514723192;0,378015541716129;0,559741056439321
"552";"GENERAL";2021-07-05;2021;27;"All";"All";433037;619813;106;1052956;5928740;4377296;1421;10307457;1695351;4568108;6263459;0,572941812689966;0,163835397586291;0,441453003181711;0,605288400768002
"553";"GENERAL";2021-07-12;2021;28;"All";"All";245590;519977;111;765678;6174330;4897273;1532;11073135;1502971;5121686;6624657;0,596675148909556;0,145244171469899;0,494949696034709;0,640193867504609
"554";"GENERAL";2021-07-19;2021;29;"All";"All";143555;523847;89;667491;6317885;5421120;1621;11740626;1224204;5676999;6901203;0,610548022727721;0,118304675000474;0,548614055886938;0,666918730887412
"555";"GENERAL";2021-07-26;2021;30;"All";"All";104883;498903;68;603854;6422768;5920023;1689;12344480;901152;6206993;7108145;0,620683710266787;0,0870855629339773;0,599831637206882;0,68691720014086
"556";"GENERAL";2021-08-02;2021;31;"All";"All";129501;506872;57;636430;6552269;6426895;1746;12980910;606579;6747777;7354356;0,633198433072166;0,0586186056058567;0,652091942977372;0,710710548583228
"557";"GENERAL";2021-08-09;2021;32;"All";"All";313518;351878;51;665447;6865787;6778773;1797;13646357;659613;7150527;7810140;0,663496198066234;0,0637437074140318;0,691012913547996;0,754756620962028
"558";"GENERAL";2021-08-16;2021;33;"All";"All";361139;237304;60;598503;7226926;7016077;1857;14244860;844918;7434941;8279859;0,698395963158487;0,0816512193981151;0,71849812502875;0,800149344426865
"559";"GENERAL";2021-08-23;2021;34;"All";"All";293192;138341;26;431559;7520118;7154418;1883;14676419;1001463;7612660;8614123;0,726729463353502;0,0967794213546102;0,735672540842135;0,832451962196745
"560";"GENERAL";2021-08-30;2021;35;"All";"All";130047;298315;48;428410;7650165;7452733;1931;15104829;817937;7941747;8759684;0,739296950528668;0,0790438284435129;0,767474863479441;0,846518691922954
