;TYPE;DATE;YEAR;WEEK;REGION;AGEGROUP;TOTAL_VAC_1;TOTAL_VAC_2;TOTAL_VAC_UNK;TOTAL;CUMUL_VAC_1;CUMUL_VAC_2;CUMUL_VAC_UNK;CUMUL;CUMUL_VAC_INIT;CUMUL_VAC_COMPLETE;CUMUL_VAC_LEAST;COVER_1_VAC;COVER_INIT;COVER_COMPLETE;COVER_LEAST
1;REGIONAL;04/01/2021;2021;1;ARS Alentejo;All;3468;3;0;3471;4702;4;0;4706;4698;4;4702;0,010029821;0,010021288;8,53E-06;0,010029821
2;REGIONAL;11/01/2021;2021;2;ARS Alentejo;All;5377;11;0;5388;10079;15;0;10094;10063;16;10079;0,021499482;0,021465352;3,41E-05;0,021499482
3;REGIONAL;18/01/2021;2021;3;ARS Alentejo;All;10457;1138;0;11595;20536;1153;0;21689;19378;1158;20536;0,043805274;0,041335148;0,002470126;0,043805274
4;REGIONAL;25/01/2021;2021;4;ARS Alentejo;All;2374;3105;0;5479;22910;4258;0;27168;18644;4266;22910;0,048869245;0,039769455;0,009099791;0,048869245
5;REGIONAL;01/02/2021;2021;5;ARS Alentejo;All;1455;4354;0;5809;24365;8612;0;32977;15744;8621;24365;0,051972901;0,033583474;0,018389427;0,051972901
6;REGIONAL;08/02/2021;2021;6;ARS Alentejo;All;3291;8800;0;12091;27656;17412;0;45068;10231;17425;27656;0,058992922;0,021823712;0,03716921;0,058992922
7;REGIONAL;15/02/2021;2021;7;ARS Alentejo;All;4081;2844;0;6925;31737;20256;0;51993;11468;20269;31737;0,06769809;0,024462353;0,043235737;0,06769809
8;REGIONAL;22/02/2021;2021;8;ARS Alentejo;All;12067;1640;0;13707;43804;21896;0;65700;21890;21914;43804;0,093438168;0,046693487;0,046744681;0,093438168
9;REGIONAL;01/03/2021;2021;9;ARS Alentejo;All;10487;2836;1;13324;54291;24732;1;79024;29535;24756;54291;0,115807953;0,063001011;0,052806942;0,115807953
10;REGIONAL;08/03/2021;2021;10;ARS Alentejo;All;5850;1697;0;7547;60141;26429;1;86571;33680;26461;60141;0,128286569;0,071842697;0,056443872;0,128286569
11;REGIONAL;15/03/2021;2021;11;ARS Alentejo;All;3738;7749;0;11487;63879;34178;1;98058;29669;34211;63880;0,136260084;0,063286846;0,072975371;0,136262217
12;REGIONAL;22/03/2021;2021;12;ARS Alentejo;All;11927;2123;0;14050;75806;36301;1;112108;39472;36336;75808;0,161701529;0,084197593;0,077508202;0,161705795
13;REGIONAL;29/03/2021;2021;13;ARS Alentejo;All;6168;6321;0;12489;81974;42622;1;124597;39317;42660;81977;0,174858469;0,083866963;0,090997905;0,174864868
14;REGIONAL;05/04/2021;2021;14;ARS Alentejo;All;14066;4339;0;18405;96040;46961;1;143002;49041;47004;96045;0,204862607;0,104609195;0,100264077;0,204873273
15;REGIONAL;12/04/2021;2021;15;ARS Alentejo;All;21937;2983;0;24920;117977;49944;1;167922;67992;49991;117983;0,25165635;0,145033511;0,106635637;0,251669148
16;REGIONAL;19/04/2021;2021;16;ARS Alentejo;All;11414;5993;0;17407;129391;55937;1;185329;73410;55987;129397;0,276003515;0,156590629;0,119425685;0,276016314
17;REGIONAL;26/04/2021;2021;17;ARS Alentejo;All;20278;2807;0;23085;149669;58744;1;208414;90886;58797;149683;0,31925845;0,193868627;0,125419687;0,319288314
18;REGIONAL;03/05/2021;2021;18;ARS Alentejo;All;13729;14357;1;28087;163398;73101;2;236501;93366;73166;166532;0,348543735;0,199158707;0,156070153;0,35522886
19;REGIONAL;10/05/2021;2021;19;ARS Alentejo;All;17483;15307;0;32790;180881;88408;2;269291;96028;88493;184521;0,385836665;0,20483701;0,188764126;0,393601137
20;REGIONAL;17/05/2021;2021;20;ARS Alentejo;All;13274;12283;1;25558;194155;100691;3;294849;100318;100894;201212;0,41415139;0,213987995;0,215216659;0,429204654
21;REGIONAL;24/05/2021;2021;21;ARS Alentejo;All;7232;18613;0;25845;201387;119304;3;320694;90624;119964;210588;0,429577945;0,193309756;0,255894813;0,449204568
22;REGIONAL;31/05/2021;2021;22;ARS Alentejo;All;17433;7354;0;24787;218820;126658;3;345481;100292;128076;228368;0,46676422;0,213932534;0,273198493;0,487131028
23;REGIONAL;07/06/2021;2021;23;ARS Alentejo;All;13872;15305;0;29177;232692;141963;3;374658;98896;143983;242879;0,496354538;0,210954731;0,307129662;0,518084394
24;REGIONAL;14/06/2021;2021;24;ARS Alentejo;All;10291;19303;1;29595;242983;161266;4;404253;91086;163760;254846;0,518306236;0,194295246;0,349315916;0,543611162
25;REGIONAL;21/06/2021;2021;25;ARS Alentejo;All;10616;14372;0;24988;253599;175638;4;429241;89546;178828;268374;0,54095119;0,191010277;0,381457417;0,572467694
26;REGIONAL;28/06/2021;2021;26;ARS Alentejo;All;11029;29044;3;40076;264628;204682;7;469317;73171;208534;281705;0,564477114;0,156080819;0,444823188;0,600904006
27;REGIONAL;05/07/2021;2021;27;ARS Alentejo;All;15354;27963;0;43317;279982;232645;7;512634;59871;237892;297763;0,597228681;0,127710633;0,507446641;0,635157273
28;REGIONAL;12/07/2021;2021;28;ARS Alentejo;All;8212;20421;1;28634;288194;253066;8;541268;49661;259803;309464;0,614745671;0,105931715;0,554184922;0,660116638
29;REGIONAL;19/07/2021;2021;29;ARS Alentejo;All;3527;16781;2;20310;291721;269847;10;561578;39462;277862;317324;0,622269103;0,084176262;0,592706516;0,676882778
30;REGIONAL;26/07/2021;2021;30;ARS Alentejo;All;2261;16588;0;18849;293982;286435;10;580427;28739;295477;324216;0,627092035;0,061303066;0,630281014;0,69158408
31;REGIONAL;02/08/2021;2021;31;ARS Alentejo;All;4970;20043;13;25026;298952;306478;23;605453;18640;316641;335281;0,637693525;0,039760923;0,675425873;0,715186795
32;REGIONAL;09/08/2021;2021;32;ARS Alentejo;All;14886;14453;0;29339;313838;320931;23;634792;24723;332753;357476;0,669446803;0,05273655;0,709794327;0,762530877
33;REGIONAL;16/08/2021;2021;33;ARS Alentejo;All;22247;6604;0;28851;336085;327535;23;663643;41982;341568;383550;0,716901805;0,089551666;0,728597574;0,81814924
34;REGIONAL;23/08/2021;2021;34;ARS Alentejo;All;12992;4614;0;17606;349077;332149;23;681249;51061;347614;398675;0,744614997;0,108918051;0,741494277;0,850412328
35;REGIONAL;30/08/2021;2021;35;ARS Alentejo;All;4763;15837;2;20602;353840;347986;25;701851;40659;364405;405064;0,754774937;0,086729579;0,777311104;0,864040682
36;REGIONAL;06/09/2021;2021;36;ARS Alentejo;All;2621;15210;6;17837;356461;363196;31;719688;27660;380109;407769;0,760365783;0,059001455;0,810809254;0,869810709
37;REGIONAL;13/09/2021;2021;37;ARS Alentejo;All;1848;15845;3;17696;358309;379041;34;737384;13449;396196;409645;0,764307746;0,028688018;0,845124381;0,873812398
38;REGIONAL;20/09/2021;2021;38;ARS Alentejo;All;1619;3616;6;5241;359928;382657;40;742625;11201;400081;411282;0,76776123;0,023892816;0,853411462;0,877304278
39;REGIONAL;27/09/2021;2021;39;ARS Alentejo;All;1132;2416;5;3553;361060;385073;45;746178;9633;402863;412496;0,770175895;0,020548121;0,859345737;0,879893857
40;REGIONAL;04/10/2021;2021;40;ARS Alentejo;All;479;1681;3;2163;361539;386754;48;748341;8442;404644;413086;0,771197648;0,018007602;0,863144782;0,881152384
41;REGIONAL;11/10/2021;2021;41;ARS Alentejo;All;706;1609;0;2315;362245;388363;48;750656;7398;406395;413793;0,772703615;0,015780649;0,866879834;0,882660484
42;REGIONAL;18/10/2021;2021;42;ARS Alentejo;All;586;1235;0;1821;362831;389598;48;752477;6613;407768;414381;0,773953609;0,014106168;0,869808576;0,883914744
43;REGIONAL;25/10/2021;2021;43;ARS Alentejo;All;449;743;0;1192;363280;390341;48;753669;6199;408631;414830;0,77491137;0,013223066;0,871649438;0,884872505
44;REGIONAL;04/01/2021;2021;1;ARS Algarve;All;1278;4;0;1282;2352;4;0;2356;2348;5;2353;0,00503107;0,005022514;1,07E-05;0,005033209
45;REGIONAL;11/01/2021;2021;2;ARS Algarve;All;1379;6;0;1385;3731;10;0;3741;3720;13;3733;0,007980834;0,007957304;2,78E-05;0,007985112
46;REGIONAL;18/01/2021;2021;3;ARS Algarve;All;3416;952;0;4368;7147;962;0;8109;6184;965;7149;0,015287864;0,013227949;0,002064193;0,015292142
47;REGIONAL;25/01/2021;2021;4;ARS Algarve;All;2175;1251;0;3426;9322;2213;0;11535;7108;2216;9324;0,01994032;0,015204441;0,004740158;0,019944598
48;REGIONAL;01/02/2021;2021;5;ARS Algarve;All;1248;1254;0;2502;10570;3467;0;14037;7103;3470;10573;0,022609867;0,015193745;0,007422539;0,022616285
49;REGIONAL;08/02/2021;2021;6;ARS Algarve;All;2442;2898;0;5340;13012;6365;0;19377;6645;6370;13015;0,027833453;0,014214056;0,013625814;0,02783987
50;REGIONAL;15/02/2021;2021;7;ARS Algarve;All;3239;2125;0;5364;16251;8490;0;24741;7756;8498;16254;0,034761869;0,016590552;0,018177735;0,034768286
51;REGIONAL;22/02/2021;2021;8;ARS Algarve;All;8529;1073;1;9603;24780;9563;1;34344;15205;9578;24783;0,053005915;0,032524412;0,02048792;0,053012332
52;REGIONAL;01/03/2021;2021;9;ARS Algarve;All;4682;567;0;5249;29462;10130;1;39593;19313;10153;29466;0,063020995;0,041311672;0,021717879;0,063029551
53;REGIONAL;08/03/2021;2021;10;ARS Algarve;All;5177;1564;0;6741;34639;11694;1;46334;22926;11718;34644;0,07409491;0,049040097;0,025065509;0,074105605
54;REGIONAL;15/03/2021;2021;11;ARS Algarve;All;2754;3031;1;5786;37393;14725;2;52120;22649;14749;37398;0,079985882;0,048447577;0,031549001;0,079996578
55;REGIONAL;22/03/2021;2021;12;ARS Algarve;All;9497;4324;0;13821;46890;19049;2;65941;27817;19078;46895;0,100300538;0,059502241;0,040808993;0,100311233
56;REGIONAL;29/03/2021;2021;13;ARS Algarve;All;4262;2947;0;7209;51152;21996;2;73150;29133;22025;51158;0,109417213;0,062317244;0,047112803;0,109430047
57;REGIONAL;05/04/2021;2021;14;ARS Algarve;All;8706;1841;0;10547;59858;23837;2;83697;36002;23868;59870;0,128039872;0,077010449;0,051055091;0,128065541
58;REGIONAL;12/04/2021;2021;15;ARS Algarve;All;13718;2203;0;15921;73576;26040;2;99618;47518;26071;73589;0,157383501;0,101643868;0,055767441;0,157411309
59;REGIONAL;19/04/2021;2021;16;ARS Algarve;All;7310;5560;0;12870;80886;31600;2;112488;49265;31635;80900;0,173020032;0,105380806;0,067669173;0,173049979
60;REGIONAL;26/04/2021;2021;17;ARS Algarve;All;16449;3304;0;19753;97335;34904;2;132241;62400;34955;97355;0,208205435;0,133477363;0,074770853;0,208248217
61;REGIONAL;03/05/2021;2021;18;ARS Algarve;All;16623;9010;0;25633;113958;43914;2;157874;70554;43978;114532;0,243763035;0,150919261;0,094071594;0,244990856
62;REGIONAL;10/05/2021;2021;19;ARS Algarve;All;9779;11392;0;21171;123737;55306;2;179045;70908;55377;126285;0,264680906;0,151676489;0,118454743;0,270131231
63;REGIONAL;17/05/2021;2021;20;ARS Algarve;All;12081;10949;2;23032;135818;66255;4;202077;74520;66379;140899;0,290522893;0,159402774;0,141988684;0,301391459
64;REGIONAL;24/05/2021;2021;21;ARS Algarve;All;7674;18870;0;26544;143492;85125;4;228621;69021;85348;154369;0,306938042;0,147640082;0,182564519;0,330204601
65;REGIONAL;31/05/2021;2021;22;ARS Algarve;All;8207;12806;2;21015;151699;97931;6;249636;72821;98250;171071;0,32449331;0,155768511;0,210162676;0,365931186
66;REGIONAL;07/06/2021;2021;23;ARS Algarve;All;17133;6400;0;23533;168832;104331;6;273169;84611;104958;189569;0,36114183;0,180988032;0,224511492;0,405499524
67;REGIONAL;14/06/2021;2021;24;ARS Algarve;All;15438;13503;0;28941;184270;117834;6;302110;86554;118681;205235;0,394164643;0,185144226;0,253865817;0,439010043
68;REGIONAL;21/06/2021;2021;25;ARS Algarve;All;19419;10295;0;29714;203689;128129;6;331824;96569;129460;226029;0,435703056;0,206566915;0,276922748;0,483489663
69;REGIONAL;28/06/2021;2021;26;ARS Algarve;All;17287;16552;7;33846;220976;144681;13;365670;99369;146419;245788;0,472680991;0,212556284;0,313199072;0,525755356
70;REGIONAL;05/07/2021;2021;27;ARS Algarve;All;19253;31898;1;51152;240229;176579;14;416822;87347;178957;266304;0,513864319;0,186840501;0,382799816;0,569640317
71;REGIONAL;12/07/2021;2021;28;ARS Algarve;All;9851;27135;4;36990;250080;203714;18;453812;76071;206612;282683;0,534936203;0,162720457;0,441955529;0,604675986
72;REGIONAL;19/07/2021;2021;29;ARS Algarve;All;4360;27321;0;31681;254440;231035;18;485493;58267;234567;292834;0,544262505;0,124636627;0,50175296;0,626389587
73;REGIONAL;26/07/2021;2021;30;ARS Algarve;All;4027;24839;5;28871;258467;255874;23;514364;41481;260030;301511;0,552876501;0,088730361;0,556219853;0,644950213
74;REGIONAL;02/08/2021;2021;31;ARS Algarve;All;3955;22729;1;26685;262422;278603;24;541049;26051;283417;309468;0,561336485;0,05572466;0,606246056;0,661970716
75;REGIONAL;09/08/2021;2021;32;ARS Algarve;All;11564;14125;3;25692;273986;292728;27;566741;28257;298473;326730;0,586072578;0,060443427;0,638451748;0,698895175
76;REGIONAL;16/08/2021;2021;33;ARS Algarve;All;16698;7800;3;24501;290684;300528;30;591242;39502;307445;346947;0,621790607;0,08449716;0,657643397;0,742140558
77;REGIONAL;23/08/2021;2021;34;ARS Algarve;All;13619;5353;0;18972;304303;305881;30;610214;48285;313926;362211;0,65092247;0,103284527;0,671506647;0,774791174
78;REGIONAL;30/08/2021;2021;35;ARS Algarve;All;6507;12199;4;18710;310810;318080;34;628924;42665;327251;369916;0,664841335;0,091263008;0,700009626;0,791272634
79;REGIONAL;06/09/2021;2021;36;ARS Algarve;All;3336;15778;1;19115;314146;333858;35;648039;30444;343472;373916;0,67197724;0,065121552;0,734707323;0,799828875
80;REGIONAL;13/09/2021;2021;37;ARS Algarve;All;2290;12114;4;14408;316436;345972;39;662447;21363;355888;377251;0,676875689;0,045696745;0,761265896;0,806962641
81;REGIONAL;20/09/2021;2021;38;ARS Algarve;All;1880;6677;6;8563;318316;352649;45;671010;17104;362819;379923;0,680897122;0,036586488;0,776091723;0,81267821
82;REGIONAL;27/09/2021;2021;39;ARS Algarve;All;1165;3902;5;5072;319481;356551;50;676082;14549;366995;381544;0,683389127;0,031121188;0,785024439;0,816145627
83;REGIONAL;04/10/2021;2021;40;ARS Algarve;All;765;3037;1;3803;320246;359588;51;679885;12344;370152;382496;0,685025508;0,02640456;0,791777452;0,818182013
84;REGIONAL;11/10/2021;2021;41;ARS Algarve;All;1080;1938;0;3018;321326;361526;51;682903;11295;372315;383610;0,687335693;0,024160686;0,79640424;0,820564926
85;REGIONAL;18/10/2021;2021;42;ARS Algarve;All;754;1614;0;2368;322080;363140;51;685271;10337;374095;384432;0,688948545;0,022111466;0,800211767;0,822323233
86;REGIONAL;25/10/2021;2021;43;ARS Algarve;All;877;1212;0;2089;322957;364352;51;687360;9778;375533;385311;0,690824501;0,020915732;0,803287736;0,824203467
87;REGIONAL;04/01/2021;2021;1;ARS Centro;All;9067;20;0;9087;15698;22;0;15720;15677;23;15700;0,009457196;0,009444545;1,39E-05;0,009458401
88;REGIONAL;11/01/2021;2021;2;ARS Centro;All;12754;25;1;12780;28452;47;1;28500;28396;58;28454;0,017140792;0,017107055;3,49E-05;0,017141997
89;REGIONAL;18/01/2021;2021;3;ARS Centro;All;36930;6275;1;43206;65382;6322;2;71706;59024;6361;65385;0,03938912;0,035558769;0,003832159;0,039390927
90;REGIONAL;25/01/2021;2021;4;ARS Centro;All;4906;8529;3;13438;70288;14851;5;85144;55397;14894;70291;0,04234472;0,033373697;0,00897283;0,042346527
91;REGIONAL;01/02/2021;2021;5;ARS Centro;All;2772;9200;0;11972;73060;24051;5;97116;48966;24098;73064;0,0440147;0,029499367;0,014517742;0,044017109
92;REGIONAL;08/02/2021;2021;6;ARS Centro;All;7595;27224;3;34822;80655;51275;8;131938;29307;51352;80659;0,048590277;0,017655883;0,030936803;0,048592686
93;REGIONAL;15/02/2021;2021;7;ARS Centro;All;25600;10044;3;35647;106255;61319;11;167585;44766;61493;106259;0,064012892;0,026969095;0,037046208;0,064015302
94;REGIONAL;22/02/2021;2021;8;ARS Centro;All;38499;3181;1;41681;144754;64500;12;209266;80046;64712;144758;0,087206458;0,048223387;0,038985481;0,087208868
95;REGIONAL;01/03/2021;2021;9;ARS Centro;All;28621;5991;0;34612;173375;70491;12;243878;102656;70733;173389;0,104449063;0,061844689;0,042612808;0,104457497
96;REGIONAL;08/03/2021;2021;10;ARS Centro;All;17823;13621;0;31444;191198;84112;12;275322;106835;84393;191228;0,115186457;0,064362311;0,050842219;0,11520453
97;REGIONAL;15/03/2021;2021;11;ARS Centro;All;16791;24314;1;41106;207989;108426;13;316428;99315;108718;208033;0,125302127;0,059831918;0,065496717;0,125328634
98;REGIONAL;22/03/2021;2021;12;ARS Centro;All;47998;4479;1;52478;255987;112905;14;368906;142718;113323;256041;0,154218326;0,085979878;0,06827098;0,154250858
99;REGIONAL;29/03/2021;2021;13;ARS Centro;All;24517;16923;1;41441;280504;129828;15;410347;150303;130275;280578;0,168988493;0,090549431;0,078483644;0,169033074
100;REGIONAL;05/04/2021;2021;14;ARS Centro;All;50023;10353;1;60377;330527;140181;16;470724;189907;140713;330620;0,199124646;0,114408699;0,084771974;0,199180674
101;REGIONAL;12/04/2021;2021;15;ARS Centro;All;77832;12148;0;89980;408359;152329;16;560704;255414;153046;408460;0,246014218;0,153873125;0,09220194;0,246075065
102;REGIONAL;19/04/2021;2021;16;ARS Centro;All;30193;24327;0;54520;438552;176656;16;615224;261133;177523;438656;0,264203868;0,157318513;0,106948009;0,264266522
103;REGIONAL;26/04/2021;2021;17;ARS Centro;All;56823;18035;0;74858;495375;194691;16;690082;301014;195740;496754;0,298436653;0,181344659;0,117922766;0,299267426
104;REGIONAL;03/05/2021;2021;18;ARS Centro;All;60185;49338;0;109523;555560;244029;16;799605;317469;245319;562788;0,334694861;0,191257907;0,147791433;0,33904934
105;REGIONAL;10/05/2021;2021;19;ARS Centro;All;50863;55905;1;106769;606423;299934;17;906374;318282;301412;619694;0,365337068;0,191747696;0,181584433;0,373332128
106;REGIONAL;17/05/2021;2021;20;ARS Centro;All;45071;41911;5;86987;651494;341845;22;993361;328430;344119;672549;0,392489909;0,197861317;0,207313091;0,405174408
107;REGIONAL;24/05/2021;2021;21;ARS Centro;All;24376;56469;4;80849;675870;398314;26;1074210;303662;401615;705277;0,407175131;0,182939936;0,241951322;0,424891259
108;REGIONAL;31/05/2021;2021;22;ARS Centro;All;44472;37967;0;82439;720342;436281;26;1156649;309599;442531;752130;0,433967106;0,186516658;0,266601;0,453117658
109;REGIONAL;07/06/2021;2021;23;ARS Centro;All;58548;41059;1;99608;778890;477340;27;1256257;326313;486145;812458;0,469239111;0,196585939;0,292876077;0,489462016
110;REGIONAL;14/06/2021;2021;24;ARS Centro;All;52186;66020;8;118214;831076;543360;35;1374471;315916;554638;870554;0,500678354;0,190322309;0,334139406;0,524461715
111;REGIONAL;21/06/2021;2021;25;ARS Centro;All;59783;47954;3;107740;890859;591314;38;1482211;330482;606211;936693;0,536694379;0,199097536;0,36520935;0,564306886
112;REGIONAL;28/06/2021;2021;26;ARS Centro;All;50074;77450;3;127527;940933;668764;41;1609738;301960;687064;989024;0,566861257;0,181914573;0,413918911;0,595833484
113;REGIONAL;05/07/2021;2021;27;ARS Centro;All;59668;105258;10;164936;1000601;774022;51;1774674;259985;796777;1056762;0,602808;0,156626905;0,480015061;0,636641966
114;REGIONAL;12/07/2021;2021;28;ARS Centro;All;28631;82394;6;111031;1029232;856416;57;1885705;216311;883492;1099803;0,62005663;0,130315682;0,53225616;0,662571842
115;REGIONAL;19/07/2021;2021;29;ARS Centro;All;16952;80946;17;97915;1046184;937362;74;1983620;163401;968939;1132340;0,630269293;0,098440267;0,583733357;0,682173625
116;REGIONAL;26/07/2021;2021;30;ARS Centro;All;14466;69206;7;83679;1060650;1006568;81;2067299;116568;1043348;1159916;0,638984276;0,070225917;0,628560757;0,698786674
117;REGIONAL;02/08/2021;2021;31;ARS Centro;All;19337;75406;6;94749;1079987;1081974;87;2162048;74815;1123617;1198432;0,650633773;0,045071992;0,676918489;0,721990481
118;REGIONAL;09/08/2021;2021;32;ARS Centro;All;50715;47176;7;97898;1130702;1129150;94;2259946;93182;1179528;1272710;0,681186818;0,056137117;0,710601843;0,76673896
119;REGIONAL;16/08/2021;2021;33;ARS Centro;All;61463;36163;7;97633;1192165;1165313;101;2357579;131660;1223458;1355118;0,718214953;0,079318031;0,737067293;0,816385324
120;REGIONAL;23/08/2021;2021;34;ARS Centro;All;51308;18497;4;69809;1243473;1183810;105;2427388;164105;1248075;1412180;0,749125249;0,098864389;0,751897705;0,850762094
121;REGIONAL;30/08/2021;2021;35;ARS Centro;All;20803;48370;3;69176;1264276;1232180;108;2496564;133591;1300988;1434579;0,761657931;0,080481354;0,783774926;0,86425628
122;REGIONAL;06/09/2021;2021;36;ARS Centro;All;7896;51107;11;59014;1272172;1283287;119;2555578;89425;1353542;1442967;0,766414844;0,053873727;0,81543587;0,869309597
123;REGIONAL;13/09/2021;2021;37;ARS Centro;All;5955;42709;7;48671;1278127;1325996;126;2604249;51822;1397323;1449145;0,77000241;0,031219953;0,841811555;0,873031508
124;REGIONAL;20/09/2021;2021;38;ARS Centro;All;4076;18731;6;22813;1282203;1344727;132;2627062;36561;1416739;1453300;0,772457979;0,022026026;0,853508645;0,875534671
125;REGIONAL;27/09/2021;2021;39;ARS Centro;All;2911;9819;4;12734;1285114;1354546;136;2639796;29103;1427249;1456352;0,774211699;0,017532984;0,859840352;0,877373336
126;REGIONAL;04/10/2021;2021;40;ARS Centro;All;1559;5513;15;7087;1286673;1360059;151;2646883;24975;1433072;1458047;0,775150913;0,015046087;0,863348394;0,878394482
127;REGIONAL;11/10/2021;2021;41;ARS Centro;All;2145;4709;0;6854;1288818;1364768;151;2653737;21978;1438229;1460207;0,776443159;0,013240557;0,866455208;0,879695765
128;REGIONAL;18/10/2021;2021;42;ARS Centro;All;1746;3745;0;5491;1290564;1368513;151;2659228;19572;1442383;1461955;0,77749503;0,011791072;0,868957769;0,88074884
129;REGIONAL;25/10/2021;2021;43;ARS Centro;All;1746;2881;0;4627;1292310;1371394;151;2663855;17969;1445732;1463701;0,7785469;0,010825351;0,87097536;0,881800711
130;REGIONAL;04/01/2021;2021;1;ARS Lisboa e Vale do Tejo;All;12865;31;0;12896;23717;36;0;23753;23684;36;23720;0,006442069;0,006433106;9,78E-06;0,006442884
131;REGIONAL;11/01/2021;2021;2;ARS Lisboa e Vale do Tejo;All;13354;1128;0;14482;37071;1164;0;38235;35896;1178;37074;0,010069315;0,009750159;0,000319971;0,01007013
132;REGIONAL;18/01/2021;2021;3;ARS Lisboa e Vale do Tejo;All;38059;9112;0;47171;75130;10276;0;85406;64721;10413;75134;0,020406994;0,017579676;0,002828404;0,02040808
133;REGIONAL;25/01/2021;2021;4;ARS Lisboa e Vale do Tejo;All;17429;11968;0;29397;92559;22244;0;114803;70119;22445;92564;0,025141101;0,019045894;0,006096566;0,025142459
134;REGIONAL;01/02/2021;2021;5;ARS Lisboa e Vale do Tejo;All;8849;8954;0;17803;101408;31198;0;132606;69999;31417;101416;0,027544688;0,019013299;0,008533562;0,027546861
135;REGIONAL;08/02/2021;2021;6;ARS Lisboa e Vale do Tejo;All;14472;30563;0;45035;115880;61761;0;177641;53718;62171;115889;0,031475608;0,014591014;0,016887038;0,031478052
136;REGIONAL;15/02/2021;2021;7;ARS Lisboa e Vale do Tejo;All;33102;19133;0;52235;148982;80894;0;229876;67535;81457;148992;0,040466854;0,018344021;0,022125549;0,04046957
137;REGIONAL;22/02/2021;2021;8;ARS Lisboa e Vale do Tejo;All;49510;6730;0;56240;198492;87624;0;286116;110000;88502;198502;0,053914881;0,029878468;0,024039129;0,053917597
138;REGIONAL;01/03/2021;2021;9;ARS Lisboa e Vale do Tejo;All;45339;12911;0;58250;243831;100535;0;344366;142208;101643;243851;0,06622997;0,038626883;0,027608519;0,066235403
139;REGIONAL;08/03/2021;2021;10;ARS Lisboa e Vale do Tejo;All;34173;16643;2;50818;278004;117178;2;395184;159652;118387;278039;0,075512124;0,043365065;0,032156565;0,075521631
140;REGIONAL;15/03/2021;2021;11;ARS Lisboa e Vale do Tejo;All;26442;29148;1;55591;304446;146326;3;450775;156888;147606;304494;0,082694364;0,042614301;0,040093101;0,082707402
141;REGIONAL;22/03/2021;2021;12;ARS Lisboa e Vale do Tejo;All;89680;7800;1;97481;394126;154126;4;548256;238512;155676;394188;0,107053464;0,06478521;0,042285094;0,107070305
142;REGIONAL;29/03/2021;2021;13;ARS Lisboa e Vale do Tejo;All;45824;24113;1;69938;439950;178239;5;618194;260154;179875;440029;0,119500291;0,070663663;0,048858086;0,119521749
143;REGIONAL;05/04/2021;2021;14;ARS Lisboa e Vale do Tejo;All;87602;19893;1;107496;527552;198132;6;725690;327720;199975;527695;0,143294959;0,089016105;0,054317697;0,143333801
144;REGIONAL;12/04/2021;2021;15;ARS Lisboa e Vale do Tejo;All;163807;14558;1;178366;691359;212690;7;904056;476847;214674;691521;0,187788616;0,129522344;0,058310275;0,187832619
145;REGIONAL;19/04/2021;2021;16;ARS Lisboa e Vale do Tejo;All;79427;53950;2;133379;770786;266640;9;1037435;502067;268884;770951;0,209362771;0,136372662;0,073034927;0,209407589
146;REGIONAL;26/04/2021;2021;17;ARS Lisboa e Vale do Tejo;All;107843;25765;1;133609;878629;292405;10;1171044;584036;294792;878828;0,238655349;0,158637281;0,080072121;0,238709402
147;REGIONAL;03/05/2021;2021;18;ARS Lisboa e Vale do Tejo;All;107968;65851;3;173822;986597;358256;13;1344866;628704;360804;989508;0,267981881;0,170770112;0,098002461;0,268772574
148;REGIONAL;10/05/2021;2021;19;ARS Lisboa e Vale do Tejo;All;90646;113545;1;204192;1077243;471801;14;1549058;608099;474650;1082749;0,292603368;0,165173332;0,128925589;0,294098921
149;REGIONAL;17/05/2021;2021;20;ARS Lisboa e Vale do Tejo;All;110218;71505;3;181726;1187461;543306;17;1730784;648442;547154;1195596;0,32254105;0,176131396;0,148619302;0,324750698
150;REGIONAL;24/05/2021;2021;21;ARS Lisboa e Vale do Tejo;All;110997;89184;0;200181;1298458;632490;17;1930965;675322;644349;1319671;0,352690325;0,183432607;0,175019645;0,358452252
151;REGIONAL;31/05/2021;2021;22;ARS Lisboa e Vale do Tejo;All;92491;87319;4;179814;1390949;719809;21;2110779;696363;736585;1432948;0,377812956;0,189147814;0,200073012;0,389220827
152;REGIONAL;07/06/2021;2021;23;ARS Lisboa e Vale do Tejo;All;152498;54429;2;206929;1543447;774238;23;2317708;802485;797582;1600067;0,419234834;0,217972931;0,216641166;0,434614096
153;REGIONAL;14/06/2021;2021;24;ARS Lisboa e Vale do Tejo;All;148045;121746;4;269795;1691492;895984;27;2587503;831402;925960;1757362;0,459447178;0,225827437;0,251511511;0,477338948
154;REGIONAL;21/06/2021;2021;25;ARS Lisboa e Vale do Tejo;All;120515;154194;11;274720;1812007;1050178;38;2862223;804544;1088013;1892557;0,492181756;0,218532201;0,295528742;0,514060943
155;REGIONAL;28/06/2021;2021;26;ARS Lisboa e Vale do Tejo;All;130892;167163;8;298063;1942899;1217341;46;3160286;769727;1264897;2034624;0,52773496;0,209075123;0,343574405;0,552649527
156;REGIONAL;05/07/2021;2021;27;ARS Lisboa e Vale do Tejo;All;144236;274240;4;418480;2087135;1491581;50;3578766;640342;1550315;2190657;0,566912693;0,173931254;0,421100337;0,595031591
157;REGIONAL;12/07/2021;2021;28;ARS Lisboa e Vale do Tejo;All;80365;216536;23;296924;2167500;1708117;73;3875690;533090;1776766;2309856;0,58874163;0,144799204;0,482609509;0,627408714
158;REGIONAL;19/07/2021;2021;29;ARS Lisboa e Vale do Tejo;All;57331;186233;8;243572;2224831;1894350;81;4119262;444268;1974231;2418499;0,604314016;0,120673156;0,536245434;0,65691859
159;REGIONAL;26/07/2021;2021;30;ARS Lisboa e Vale do Tejo;All;36794;181199;13;218006;2261625;2075549;94;4337268;326195;2167370;2493565;0,614308092;0,088601881;0,588706319;0,6773082
160;REGIONAL;02/08/2021;2021;31;ARS Lisboa e Vale do Tejo;All;45787;178884;13;224684;2307412;2254433;107;4561952;221890;2360973;2582863;0,626744869;0,060270302;0,641293238;0,70156354
161;REGIONAL;09/08/2021;2021;32;ARS Lisboa e Vale do Tejo;All;107942;111882;7;219831;2415354;2366315;114;4781783;240302;2494145;2734447;0,656064338;0,065271415;0,677465741;0,742737156
162;REGIONAL;16/08/2021;2021;33;ARS Lisboa e Vale do Tejo;All;107715;91499;10;199224;2523069;2457814;124;4981007;280868;2601699;2882567;0,685322148;0,07629005;0,70667982;0,782969871
163;REGIONAL;23/08/2021;2021;34;ARS Lisboa e Vale do Tejo;All;89429;61312;8;150749;2612498;2519126;132;5131756;321483;2677688;2999171;0,709613071;0,087321996;0,727320138;0,814642133
164;REGIONAL;30/08/2021;2021;35;ARS Lisboa e Vale do Tejo;All;49099;101215;20;150334;2661597;2620341;152;5282090;264412;2792343;3056755;0,722949461;0,071820232;0,758463008;0,83028324
165;REGIONAL;06/09/2021;2021;36;ARS Lisboa e Vale do Tejo;All;28019;91989;54;120062;2689616;2712330;206;5402152;195561;2889660;3085221;0,73056005;0,053118755;0,784896489;0,838015244
166;REGIONAL;13/09/2021;2021;37;ARS Lisboa e Vale do Tejo;All;20088;81897;80;102065;2709704;2794227;286;5504217;130105;2975430;3105535;0,736016402;0,035339437;0,808193545;0,843532982
167;REGIONAL;20/09/2021;2021;38;ARS Lisboa e Vale do Tejo;All;15263;31870;102;47235;2724967;2826097;388;5551452;109025;3011929;3120954;0,740162175;0,029613636;0,818107492;0,847721129
168;REGIONAL;27/09/2021;2021;39;ARS Lisboa e Vale do Tejo;All;9353;20505;69;29927;2734320;2846602;457;5581379;94662;3036035;3130697;0,74270266;0,025712323;0,824655223;0,850367546
169;REGIONAL;04/10/2021;2021;40;ARS Lisboa e Vale do Tejo;All;4514;17842;57;22413;2738834;2864444;514;5603792;81303;3055098;3136401;0,743928763;0,022083719;0,829833161;0,85191688
170;REGIONAL;11/10/2021;2021;41;ARS Lisboa e Vale do Tejo;All;6838;14724;0;21562;2745672;2879168;514;5625354;71641;3071607;3143248;0,745786117;0,019459303;0,834317376;0,853776679
171;REGIONAL;18/10/2021;2021;42;ARS Lisboa e Vale do Tejo;All;5222;12060;0;17282;2750894;2891228;514;5642636;63337;3085139;3148476;0,74720453;0,01720375;0,837992971;0,855196721
172;REGIONAL;25/10/2021;2021;43;ARS Lisboa e Vale do Tejo;All;5287;6109;1;11397;2756181;2897337;515;5654033;60850;3092930;3153780;0,748640598;0,016528225;0,840109181;0,856637407
173;REGIONAL;04/01/2021;2021;1;ARS Norte;All;16846;44;0;16890;30300;51;0;30351;30252;55;30307;0,008458024;0,008444625;1,54E-05;0,008459978
174;REGIONAL;11/01/2021;2021;2;ARS Norte;All;15506;43;0;15549;45806;94;0;45900;45691;123;45814;0,012786411;0,012754309;3,43E-05;0,012788644
175;REGIONAL;18/01/2021;2021;3;ARS Norte;All;32471;12756;1;45228;78277;12850;1;91128;65364;12921;78285;0,021850454;0,018245884;0,003606803;0,021852687
176;REGIONAL;25/01/2021;2021;4;ARS Norte;All;14474;15777;1;30252;92751;28627;2;121380;64052;28708;92760;0,025890765;0,017879649;0,008013629;0,025893278
177;REGIONAL;01/02/2021;2021;5;ARS Norte;All;5744;12306;1;18051;98495;40933;3;139431;57491;41018;98509;0,027494161;0,016048193;0,011449876;0,027498069
178;REGIONAL;08/02/2021;2021;6;ARS Norte;All;9009;28920;4;37933;107504;69853;7;177364;37512;70006;107518;0,030008958;0,010471201;0,019541664;0,030012866
179;REGIONAL;15/02/2021;2021;7;ARS Norte;All;33154;15244;2;48400;140658;85097;9;225764;55106;85566;140672;0,039263655;0,015382438;0,023885125;0,039267563
180;REGIONAL;22/02/2021;2021;8;ARS Norte;All;64987;4387;0;69374;205645;89484;9;295138;115483;90176;205659;0,057404302;0,032236237;0,025171973;0,05740821
181;REGIONAL;01/03/2021;2021;9;ARS Norte;All;48247;7175;4;55426;253892;96659;13;350564;156472;97444;253916;0,0708721;0,043678018;0,027200782;0,0708788
182;REGIONAL;08/03/2021;2021;10;ARS Norte;All;25926;14287;0;40213;279818;110946;13;390777;168004;111858;279862;0,078109154;0,046897092;0,031224345;0,078121437
183;REGIONAL;15/03/2021;2021;11;ARS Norte;All;27173;42550;2;69725;306991;153496;15;460502;152603;154444;307047;0,085694299;0,042598015;0,043111916;0,085709931
184;REGIONAL;22/03/2021;2021;12;ARS Norte;All;89348;2581;0;91929;396339;156077;15;552431;239273;157127;396400;0,110635142;0,066791313;0,043860856;0,110652169
185;REGIONAL;29/03/2021;2021;13;ARS Norte;All;54360;32945;0;87305;450699;189022;15;639736;260656;190135;450791;0,125809339;0,072760222;0,053074799;0,125835021
186;REGIONAL;05/04/2021;2021;14;ARS Norte;All;82707;13905;2;96614;533406;202927;17;736350;329430;204118;533548;0,148896395;0,091957982;0,056978051;0,148936034
187;REGIONAL;12/04/2021;2021;15;ARS Norte;All;136229;19388;0;155617;669635;222315;17;891967;446159;223628;669787;0,186923727;0,124542031;0,062424126;0,186966157
188;REGIONAL;19/04/2021;2021;16;ARS Norte;All;65536;46678;2;112216;735171;268993;19;1004183;464605;270720;735325;0,205217624;0,129691098;0,075569514;0,205260612
189;REGIONAL;26/04/2021;2021;17;ARS Norte;All;127121;36973;0;164094;862292;305966;19;1168277;554583;307897;862480;0,240702524;0,1548078;0,085947202;0,240755003
190;REGIONAL;03/05/2021;2021;18;ARS Norte;All;156025;73678;1;229704;1018317;379644;20;1397981;636647;382085;1018732;0,284255765;0,177715368;0,106656242;0,284371609
191;REGIONAL;10/05/2021;2021;19;ARS Norte;All;100333;101427;8;201768;1118650;481071;28;1599749;641183;484646;1125829;0,31226299;0,178981559;0,135285397;0,314266956
192;REGIONAL;17/05/2021;2021;20;ARS Norte;All;111323;71527;5;182855;1229973;552598;33;1782604;679382;565431;1244813;0,343337994;0,189644531;0,157835941;0,347480472
193;REGIONAL;24/05/2021;2021;21;ARS Norte;All;73460;129672;7;203139;1303433;682270;40;1985743;630106;708351;1338457;0,363843817;0,175889495;0,197731016;0,373620512
194;REGIONAL;31/05/2021;2021;22;ARS Norte;All;55472;173135;9;228616;1358905;855405;49;2214359;530395;887844;1418239;0,379328422;0,148055897;0,247835179;0,395891075
195;REGIONAL;07/06/2021;2021;23;ARS Norte;All;107442;107087;11;214540;1466347;962492;60;2428899;528255;1005137;1533392;0,409320073;0,147458531;0,280576664;0,428035195
196;REGIONAL;14/06/2021;2021;24;ARS Norte;All;105558;153136;10;258704;1571905;1115628;70;2687603;486185;1168424;1654609;0,438785819;0,135714998;0,32615704;0,461872037
197;REGIONAL;21/06/2021;2021;25;ARS Norte;All;146595;105738;5;252338;1718500;1221366;75;2939941;529818;1287820;1817638;0,479706744;0,147894831;0,359485562;0,507380394
198;REGIONAL;28/06/2021;2021;26;ARS Norte;All;163804;117777;8;281589;1882304;1339143;83;3221530;566419;1421291;1987710;0,525431436;0,158111734;0,396743019;0,554854752
199;REGIONAL;05/07/2021;2021;27;ARS Norte;All;176151;159229;12;335392;2058455;1498372;95;3556922;579104;1599065;2178169;0,574602703;0,161652659;0,446367334;0,608019993
200;REGIONAL;12/07/2021;2021;28;ARS Norte;All;105449;157465;23;262937;2163904;1655837;118;3819859;559730;1773226;2332956;0,604038023;0,156244548;0,494983108;0,651227656
201;REGIONAL;19/07/2021;2021;29;ARS Norte;All;51930;190116;12;242058;2215834;1845953;130;4061917;459926;1976693;2436619;0,618533903;0,128384989;0,551779437;0,680164426
202;REGIONAL;26/07/2021;2021;30;ARS Norte;All;35379;185584;19;220982;2251213;2031537;149;4282899;333606;2173830;2507436;0,628409693;0,093123682;0,606808793;0,699932475
203;REGIONAL;02/08/2021;2021;31;ARS Norte;All;42118;190252;9;232379;2293331;2221789;158;4515278;211902;2376004;2587906;0,640166626;0,059150898;0,663244191;0,722395089
204;REGIONAL;09/08/2021;2021;32;ARS Norte;All;119297;148051;9;267357;2412628;2369840;167;4782635;224355;2541912;2766267;0,673467514;0,062627062;0,709556199;0,772183262
205;REGIONAL;16/08/2021;2021;33;ARS Norte;All;149003;81246;10;230259;2561631;2451086;177;5012894;310539;2642871;2953410;0,715060614;0,086684697;0,737738168;0,824422865
206;REGIONAL;23/08/2021;2021;34;ARS Norte;All;119184;34034;10;153228;2680815;2485120;187;5166122;382981;2692762;3075743;0,748329959;0,106906353;0,751664877;0,85857123
207;REGIONAL;30/08/2021;2021;35;ARS Norte;All;44798;111437;12;156247;2725613;2596557;199;5322369;307290;2814751;3122041;0,760834994;0,085777763;0,785717217;0,871494979
208;REGIONAL;06/09/2021;2021;36;ARS Norte;All;22067;129166;21;151254;2747680;2725723;220;5473623;196436;2948755;3145191;0,766994836;0,054833677;0,823123456;0,877957133
209;REGIONAL;13/09/2021;2021;37;ARS Norte;All;14788;97215;18;112021;2762468;2822938;238;5585644;112256;3048575;3160831;0,771122799;0,031335444;0,850987481;0,882322925
210;REGIONAL;20/09/2021;2021;38;ARS Norte;All;10371;37138;7;47516;2772839;2860076;245;5633160;83876;3087736;3171612;0,774017788;0,023413374;0,861918989;0,885332363
211;REGIONAL;27/09/2021;2021;39;ARS Norte;All;6821;18873;15;25709;2779660;2878949;260;5658869;70234;3108445;3178679;0,77592182;0,019605309;0,867699755;0,887305064
212;REGIONAL;04/10/2021;2021;40;ARS Norte;All;4889;14815;25;19729;2784549;2893764;285;5678598;59531;3124396;3183927;0,777286549;0,016617645;0,872152361;0,888770005
213;REGIONAL;11/10/2021;2021;41;ARS Norte;All;5780;12541;0;18321;2790329;2906305;285;5696919;51368;3138361;3189729;0,778899993;0,014339003;0,876050588;0,890389591
214;REGIONAL;18/10/2021;2021;42;ARS Norte;All;4207;9808;0;14015;2794536;2916113;285;5710934;44474;3149474;3193948;0,780074347;0,012414593;0,879152701;0,891567294
215;REGIONAL;25/10/2021;2021;43;ARS Norte;All;4077;6328;0;10405;2798613;2922441;285;5721339;40874;3157152;3198026;0,781212412;0,011409679;0,881295959;0,892705638
216;REGIONAL;04/01/2021;2021;1;RA Madeira;All;1836;4;0;1840;2542;5;0;2547;2537;5;2542;0,01012507;0,010105154;1,99E-05;0,01012507
217;REGIONAL;11/01/2021;2021;2;RA Madeira;All;1804;4;0;1808;4346;9;0;4355;4335;11;4346;0,017310603;0,017266789;4,38E-05;0,017310603
218;REGIONAL;18/01/2021;2021;3;RA Madeira;All;1172;596;1;1769;5518;605;1;6124;4911;607;5518;0,02197881;0,019561061;0,002417749;0,02197881
219;REGIONAL;25/01/2021;2021;4;RA Madeira;All;488;1722;4;2214;6006;2327;5;8338;3677;2329;6006;0,023922568;0,014645901;0,009276667;0,023922568
220;REGIONAL;01/02/2021;2021;5;RA Madeira;All;2264;1546;0;3810;8270;3873;5;12148;4395;3875;8270;0,032940333;0,017505776;0,015434557;0,032940333
221;REGIONAL;08/02/2021;2021;6;RA Madeira;All;3188;1160;1;4349;11458;5033;6;16497;6423;5035;11458;0,045638493;0,025583526;0,020054967;0,045638493
222;REGIONAL;15/02/2021;2021;7;RA Madeira;All;2595;707;2;3304;14053;5740;8;19801;8310;5743;14053;0,055974667;0,033099657;0,02287501;0,055974667
223;REGIONAL;22/02/2021;2021;8;RA Madeira;All;2281;2164;1;4446;16334;7904;9;24247;8427;7907;16334;0,065060145;0,033565682;0,031494463;0,065060145
224;REGIONAL;01/03/2021;2021;9;RA Madeira;All;1466;3135;1;4602;17800;11039;10;28849;6758;11042;17800;0,070899387;0,026917868;0,043981518;0,070899387
225;REGIONAL;08/03/2021;2021;10;RA Madeira;All;5006;2397;0;7403;22806;13436;10;36252;9367;13439;22806;0,090838843;0,037309806;0,053529037;0,090838843
226;REGIONAL;15/03/2021;2021;11;RA Madeira;All;3151;2331;1;5483;25957;15767;11;41735;10186;15771;25957;0,103389628;0,040571975;0,062817653;0,103389628
227;REGIONAL;22/03/2021;2021;12;RA Madeira;All;5599;204;0;5803;31556;15971;11;47538;15582;15975;31557;0,12569107;0,062064845;0,063630208;0,125695053
228;REGIONAL;29/03/2021;2021;13;RA Madeira;All;1238;1276;0;2514;32794;17247;11;50052;15545;17252;32797;0,130622162;0,06191747;0,068716641;0,130634111
229;REGIONAL;05/04/2021;2021;14;RA Madeira;All;10219;1309;0;11528;43013;18556;11;61580;24454;18562;43016;0,17132558;0,097403011;0,073934518;0,171337529
230;REGIONAL;12/04/2021;2021;15;RA Madeira;All;8536;1326;0;9862;51549;19882;11;71442;31659;19894;51553;0,20532542;0,12610133;0,079240022;0,205341353
231;REGIONAL;19/04/2021;2021;16;RA Madeira;All;9844;2151;1;11996;61393;22033;12;83438;39284;22114;61398;0,244535171;0,156472556;0,08808253;0,244555086
232;REGIONAL;26/04/2021;2021;17;RA Madeira;All;8823;839;1;9663;70216;22872;13;93101;47275;22964;70239;0,279678165;0,188301601;0,091468175;0,279769776
233;REGIONAL;03/05/2021;2021;18;RA Madeira;All;7661;5359;0;13020;77877;28231;13;106121;49578;28343;77921;0,310192783;0,197474707;0,112893332;0,31036804
234;REGIONAL;10/05/2021;2021;19;RA Madeira;All;11613;6568;4;18185;89490;34799;17;124306;54615;34922;89537;0,356448658;0,21753764;0,139098224;0,356635864
235;REGIONAL;17/05/2021;2021;20;RA Madeira;All;2413;7721;4;10138;91903;42520;21;134444;49309;42649;91958;0,366059906;0,19640325;0,169875727;0,366278977
236;REGIONAL;24/05/2021;2021;21;RA Madeira;All;3530;8995;1;12526;95433;51515;22;146970;43837;51660;95497;0,38012029;0,174607664;0,205767546;0,380375209
237;REGIONAL;31/05/2021;2021;22;RA Madeira;All;7647;11053;3;18703;103080;62568;25;165673;40733;62754;103487;0,410579144;0,162244085;0,249956186;0,412200271
238;REGIONAL;07/06/2021;2021;23;RA Madeira;All;3730;15301;8;19039;106810;77869;33;184712;31223;78094;109317;0,425436151;0,124364694;0,311057118;0,435421812
239;REGIONAL;14/06/2021;2021;24;RA Madeira;All;3671;8494;3;12168;110481;86363;36;196880;28895;86629;115524;0,440058153;0,11509201;0,345052975;0,460144985
240;REGIONAL;21/06/2021;2021;25;RA Madeira;All;12660;3763;9;16432;123141;90126;45;213312;37788;90533;128321;0,490484346;0,150513821;0,360603043;0,511116864
241;REGIONAL;28/06/2021;2021;26;RA Madeira;All;10160;12392;8;22560;133301;102518;53;235872;35640;103034;138674;0,53095276;0,141958098;0,410395921;0,552354019
242;REGIONAL;05/07/2021;2021;27;RA Madeira;All;12809;7037;8;19854;146110;109555;61;255726;41479;110418;151897;0,581972437;0,165215486;0,439807217;0,605022704
243;REGIONAL;12/07/2021;2021;28;RA Madeira;All;10661;5931;13;16605;156771;115486;74;272331;47099;116937;164036;0,62443639;0,187600574;0,465773122;0,653373696
244;REGIONAL;19/07/2021;2021;29;RA Madeira;All;4294;14886;7;19187;161065;130372;81;291518;38790;132075;170865;0,641539871;0,154504899;0,526069465;0,680574365
245;REGIONAL;26/07/2021;2021;30;RA Madeira;All;5582;13924;8;19514;166647;144296;89;311032;33398;146411;179809;0,6637736;0,133027961;0,583171353;0,716199315
246;REGIONAL;02/08/2021;2021;31;RA Madeira;All;4576;14416;3;18995;171223;158712;92;330027;25344;161182;186526;0,682000319;0,100947981;0,642005895;0,742953876
247;REGIONAL;09/08/2021;2021;32;RA Madeira;All;5422;11068;5;16495;176645;169780;97;346522;21163;172503;193666;0,70359675;0,084294591;0,687098702;0,771393292
248;REGIONAL;16/08/2021;2021;33;RA Madeira;All;3632;8178;5;11815;180277;177958;102;358337;17678;180892;198570;0,718063411;0,070413447;0,720513025;0,790926472
249;REGIONAL;23/08/2021;2021;34;RA Madeira;All;2201;6310;3;8514;182478;184268;105;366851;14356;187377;201733;0,72683024;0,05718155;0,746343504;0,803525054
250;REGIONAL;30/08/2021;2021;35;RA Madeira;All;1801;5882;2;7685;184279;190150;107;374536;11103;193485;204588;0,734003824;0,044224488;0,770672349;0,814896837
251;REGIONAL;06/09/2021;2021;36;RA Madeira;All;1307;4804;2;6113;185586;194954;109;380649;8038;198509;206547;0,739209751;0,032016251;0,790683502;0,822699753
252;REGIONAL;13/09/2021;2021;37;RA Madeira;All;852;2895;2;3749;186438;197849;111;384398;6179;201620;207799;0,742603362;0,024611647;0,803074962;0,827686609
253;REGIONAL;20/09/2021;2021;38;RA Madeira;All;816;2141;1;2958;187254;199990;112;387356;4867;204014;208881;0,745853581;0,019385804;0,812610531;0,831996336
254;REGIONAL;27/09/2021;2021;39;RA Madeira;All;788;1359;7;2154;188042;201349;119;389510;4169;205538;209707;0,748992273;0,016605592;0,818680793;0,835286386
255;REGIONAL;04/10/2021;2021;40;RA Madeira;All;641;868;118;1627;188683;202217;237;391137;3822;206560;210382;0,751545447;0,015223453;0,822751533;0,837974986
256;REGIONAL;11/10/2021;2021;41;RA Madeira;All;627;710;6;1343;189310;202927;243;392480;3646;207382;211028;0,754042858;0,014522425;0,826025651;0,840548076
257;REGIONAL;18/10/2021;2021;42;RA Madeira;All;603;704;2;1309;189913;203631;245;393789;3483;208156;211639;0,756444675;0,013873178;0,82910858;0,842981757
258;REGIONAL;25/10/2021;2021;43;RA Madeira;All;257;309;0;566;190170;203940;245;394355;3391;208506;211897;0,757468334;0,013506731;0,830502669;0,8440094
259;REGIONAL;04/01/2021;2021;1;RA Acores;All;3682;3;1;3686;5726;3;3;5732;5723;3;5726;0,024195354;0,024182678;1,27E-05;0,024195354
260;REGIONAL;11/01/2021;2021;2;RA Acores;All;27;3;0;30;5753;6;3;5762;5747;6;5753;0,024309444;0,02428409;2,54E-05;0,024309444
261;REGIONAL;18/01/2021;2021;3;RA Acores;All;81;1987;2;2070;5834;1993;5;7832;3841;1993;5834;0,024651711;0,01623024;0,008421471;0,024651711
262;REGIONAL;25/01/2021;2021;4;RA Acores;All;315;3621;3;3939;6149;5614;8;11771;535;5614;6149;0,025982751;0,002260656;0,023722096;0,025982751
263;REGIONAL;01/02/2021;2021;5;RA Acores;All;1894;34;1;1929;8043;5648;9;13700;2395;5648;8043;0,033985895;0,010120132;0,023865764;0,033985895
264;REGIONAL;08/02/2021;2021;6;RA Acores;All;1070;55;1;1126;9113;5703;10;14826;3410;5703;9113;0,038507207;0,014409039;0,024098167;0,038507207
265;REGIONAL;15/02/2021;2021;7;RA Acores;All;2094;370;1;2465;11207;6073;11;17291;5134;6073;11207;0,047355455;0,021693844;0,025661612;0,047355455
266;REGIONAL;22/02/2021;2021;8;RA Acores;All;1504;1645;3;3152;12711;7718;14;20443;4992;7719;12711;0,053710645;0,021093819;0,032616825;0,053710645
267;REGIONAL;01/03/2021;2021;9;RA Acores;All;791;1212;4;2007;13502;8930;18;22450;4571;8931;13502;0,057053035;0,019314873;0,037738161;0,057053035
268;REGIONAL;08/03/2021;2021;10;RA Acores;All;2777;2077;2;4856;16279;11007;20;27306;5263;11017;16280;0,068787317;0,022238937;0,046552606;0,068791542
269;REGIONAL;15/03/2021;2021;11;RA Acores;All;2551;1463;4;4018;18830;12470;24;31324;6346;12486;18832;0,07956663;0,02681518;0,052759901;0,079575081
270;REGIONAL;22/03/2021;2021;12;RA Acores;All;4174;752;4;4930;23004;13222;28;36254;9759;13247;23006;0,09720397;0,041236896;0,055975526;0,097212421
271;REGIONAL;29/03/2021;2021;13;RA Acores;All;2236;784;2;3022;25240;14006;30;39276;11208;14035;25243;0,106652244;0,047359681;0,059305239;0,10666492
272;REGIONAL;05/04/2021;2021;14;RA Acores;All;3904;2387;5;6296;29144;16393;35;45572;12710;16443;29153;0,123148692;0,053706419;0,069480303;0,123186722
273;REGIONAL;12/04/2021;2021;15;RA Acores;All;4249;2411;8;6668;33393;18804;43;52240;14534;18870;33404;0,141102946;0,061413776;0,079735651;0,141149427
274;REGIONAL;19/04/2021;2021;16;RA Acores;All;7928;1074;13;9015;41321;19878;56;61255;21331;20001;41332;0,174602906;0,090134667;0,08451472;0,174649387
275;REGIONAL;26/04/2021;2021;17;RA Acores;All;9314;3002;8;12324;50635;22880;64;73579;27603;23066;50669;0,213959443;0,116637158;0,097465953;0,214103111
276;REGIONAL;03/05/2021;2021;18;RA Acores;All;9739;2959;11;12709;60374;25839;75;86288;34363;26079;60442;0,255111829;0,145201705;0,110197459;0,255399164
277;REGIONAL;10/05/2021;2021;19;RA Acores;All;9458;2439;10;11907;69832;28278;85;98195;41354;28549;69903;0,295076841;0,174742349;0,120634505;0,295376853
278;REGIONAL;17/05/2021;2021;20;RA Acores;All;12106;5188;10;17304;81938;33466;95;115499;48237;33779;82016;0,346231043;0,203826635;0,142733999;0,346560634
279;REGIONAL;24/05/2021;2021;21;RA Acores;All;5620;8205;79;13904;87558;41671;174;129403;45643;42007;87650;0,369978492;0,192865624;0,177501616;0,37036724
280;REGIONAL;31/05/2021;2021;22;RA Acores;All;5522;10519;23;16064;93080;52190;197;145467;40680;52561;93241;0,393311839;0,171894345;0,222097804;0,393992149
281;REGIONAL;07/06/2021;2021;23;RA Acores;All;7886;12247;34;20167;100966;64437;231;165634;36292;64861;101153;0,426634327;0,153352743;0,274071758;0,4274245
282;REGIONAL;14/06/2021;2021;24;RA Acores;All;9292;7915;38;17245;110258;72352;269;182879;38105;72844;110949;0,465897903;0,161013619;0,307804122;0,46881774
283;REGIONAL;21/06/2021;2021;25;RA Acores;All;7570;10360;47;17977;117828;82712;316;200856;38069;83296;121365;0,497885125;0,1608615;0,351969306;0,512830806
284;REGIONAL;28/06/2021;2021;26;RA Acores;All;6756;12563;128;19447;124584;95275;444;220303;33694;95986;129680;0,52643277;0,142374829;0,405591214;0,547966044
285;REGIONAL;05/07/2021;2021;27;RA Acores;All;6236;16368;48;22652;130820;111643;492;242955;25334;112511;137845;0,552783142;0,107049443;0,47541801;0,582467453
286;REGIONAL;12/07/2021;2021;28;RA Acores;All;2982;11966;41;14989;133802;123609;533;257944;17978;124582;142560;0,565383657;0,075966483;0,526424319;0,602390802
287;REGIONAL;19/07/2021;2021;29;RA Acores;All;5716;9078;33;14827;139518;132687;566;272771;16294;133868;150162;0,589536756;0,0688507;0,565662541;0,634513241
288;REGIONAL;26/07/2021;2021;30;RA Acores;All;7014;9051;28;16093;146532;141738;594;288864;16685;143282;159967;0,619174586;0,07050288;0,605441631;0,67594451
289;REGIONAL;02/08/2021;2021;31;RA Acores;All;9646;6730;25;16401;156178;148468;619;305265;22967;150341;173308;0,659933997;0,097047626;0,63526961;0,732317235
290;REGIONAL;09/08/2021;2021;32;RA Acores;All;5063;6656;32;11751;161241;155124;651;317016;22736;157262;179998;0,681327829;0,09607153;0,664514466;0,760585996
291;REGIONAL;16/08/2021;2021;33;RA Acores;All;2389;7430;35;9854;163630;162554;686;326870;18373;164821;183194;0,691422607;0,077635565;0,696455207;0,774090773
292;REGIONAL;23/08/2021;2021;34;RA Acores;All;5742;9391;14;15147;169372;171945;700;342017;15031;174337;189368;0,71568557;0,063513862;0,7366653;0,800179162
293;REGIONAL;30/08/2021;2021;35;RA Acores;All;3154;5563;13;8730;172526;177508;713;350747;12760;179995;192755;0,729012875;0,053917695;0,760573319;0,814491014
294;REGIONAL;06/09/2021;2021;36;RA Acores;All;2098;2916;15;5029;174624;180424;728;355776;11424;183664;195088;0,737878026;0,048272394;0,776076769;0,824349164
295;REGIONAL;13/09/2021;2021;37;RA Acores;All;872;5327;31;6230;175496;185751;759;362006;6761;189305;196066;0,741562684;0,028568773;0,799912954;0,828481727
296;REGIONAL;20/09/2021;2021;38;RA Acores;All;783;3387;20;4190;176279;189138;779;366196;4081;192863;196944;0,744871269;0,017244366;0,814947371;0,832191737
297;REGIONAL;27/09/2021;2021;39;RA Acores;All;534;1611;29;2174;176813;190749;808;368370;3013;194617;197630;0,7471277;0,012731506;0,822358941;0,835090447
298;REGIONAL;04/10/2021;2021;40;RA Acores;All;411;719;20;1150;177224;191468;828;369520;2653;195468;198121;0,74886439;0,011210317;0,825954863;0,83716518
299;REGIONAL;11/10/2021;2021;41;RA Acores;All;392;746;0;1138;177616;192214;828;370658;2267;196335;198602;0,750520796;0,009579265;0,829618393;0,839197657
300;REGIONAL;18/10/2021;2021;42;RA Acores;All;281;452;0;733;177897;192666;828;371391;2062;196871;198933;0,751708168;0,008713032;0,831883274;0,840596306
301;REGIONAL;25/10/2021;2021;43;RA Acores;All;234;355;1;590;178131;193021;829;371981;1912;197298;199210;0,752696941;0,008079203;0,833687573;0,841766776
302;REGIONAL;04/01/2021;2021;1;Outro;All;0;0;0;0;0;0;0;0;0;0;0;NA;NA;NA;NA
303;REGIONAL;11/01/2021;2021;2;Outro;All;0;0;0;0;0;0;0;0;0;0;0;NA;NA;NA;NA
304;REGIONAL;18/01/2021;2021;3;Outro;All;0;0;0;0;0;0;0;0;0;0;0;NA;NA;NA;NA
305;REGIONAL;25/01/2021;2021;4;Outro;All;0;0;0;0;0;0;0;0;0;0;0;NA;NA;NA;NA
306;REGIONAL;01/02/2021;2021;5;Outro;All;0;0;0;0;0;0;0;0;0;0;0;NA;NA;NA;NA
307;REGIONAL;08/02/2021;2021;6;Outro;All;0;0;0;0;0;0;0;0;0;0;0;NA;NA;NA;NA
308;REGIONAL;15/02/2021;2021;7;Outro;All;0;0;0;0;0;0;0;0;0;0;0;NA;NA;NA;NA
309;REGIONAL;22/02/2021;2021;8;Outro;All;0;0;0;0;0;0;0;0;0;0;0;NA;NA;NA;NA
310;REGIONAL;01/03/2021;2021;9;Outro;All;0;0;0;0;0;0;0;0;0;0;0;NA;NA;NA;NA
311;REGIONAL;08/03/2021;2021;10;Outro;All;0;0;0;0;0;0;0;0;0;0;0;NA;NA;NA;NA
312;REGIONAL;15/03/2021;2021;11;Outro;All;0;0;0;0;0;0;0;0;0;0;0;NA;NA;NA;NA
313;REGIONAL;22/03/2021;2021;12;Outro;All;0;0;0;0;0;0;0;0;0;0;0;NA;NA;NA;NA
314;REGIONAL;29/03/2021;2021;13;Outro;All;0;0;0;0;0;0;0;0;0;0;0;NA;NA;NA;NA
315;REGIONAL;05/04/2021;2021;14;Outro;All;0;0;0;0;0;0;0;0;0;0;0;NA;NA;NA;NA
316;REGIONAL;12/04/2021;2021;15;Outro;All;0;0;0;0;0;0;0;0;0;0;0;NA;NA;NA;NA
317;REGIONAL;19/04/2021;2021;16;Outro;All;0;0;0;0;0;0;0;0;0;0;0;NA;NA;NA;NA
318;REGIONAL;26/04/2021;2021;17;Outro;All;0;0;0;0;0;0;0;0;0;0;0;NA;NA;NA;NA
319;REGIONAL;03/05/2021;2021;18;Outro;All;0;0;0;0;0;0;0;0;0;0;0;NA;NA;NA;NA
320;REGIONAL;10/05/2021;2021;19;Outro;All;0;0;0;0;0;0;0;0;0;0;0;NA;NA;NA;NA
321;REGIONAL;17/05/2021;2021;20;Outro;All;0;0;0;0;0;0;0;0;0;0;0;NA;NA;NA;NA
322;REGIONAL;24/05/2021;2021;21;Outro;All;0;0;0;0;0;0;0;0;0;0;0;NA;NA;NA;NA
323;REGIONAL;31/05/2021;2021;22;Outro;All;0;0;0;0;0;0;0;0;0;0;0;NA;NA;NA;NA
324;REGIONAL;07/06/2021;2021;23;Outro;All;0;0;0;0;0;0;0;0;0;0;0;NA;NA;NA;NA
325;REGIONAL;14/06/2021;2021;24;Outro;All;0;0;0;0;0;0;0;0;0;0;0;NA;NA;NA;NA
326;REGIONAL;21/06/2021;2021;25;Outro;All;0;0;0;0;0;0;0;0;0;0;0;NA;NA;NA;NA
327;REGIONAL;28/06/2021;2021;26;Outro;All;0;0;0;0;0;0;0;0;0;0;0;NA;NA;NA;NA
328;REGIONAL;05/07/2021;2021;27;Outro;All;0;0;0;0;0;0;0;0;0;0;0;NA;NA;NA;NA
329;REGIONAL;12/07/2021;2021;28;Outro;All;0;0;0;0;0;0;0;0;0;0;0;NA;NA;NA;NA
330;REGIONAL;19/07/2021;2021;29;Outro;All;0;0;0;0;0;0;0;0;0;0;0;NA;NA;NA;NA
331;REGIONAL;26/07/2021;2021;30;Outro;All;0;0;0;0;0;0;0;0;0;0;0;NA;NA;NA;NA
332;REGIONAL;02/08/2021;2021;31;Outro;All;0;0;0;0;0;0;0;0;0;0;0;NA;NA;NA;NA
333;REGIONAL;09/08/2021;2021;32;Outro;All;0;0;0;0;0;0;0;0;0;0;0;NA;NA;NA;NA
334;REGIONAL;16/08/2021;2021;33;Outro;All;0;0;0;0;0;0;0;0;0;0;0;NA;NA;NA;NA
335;REGIONAL;23/08/2021;2021;34;Outro;All;0;0;0;0;0;0;0;0;0;0;0;NA;NA;NA;NA
336;REGIONAL;30/08/2021;2021;35;Outro;All;0;0;0;0;0;0;0;0;0;0;0;NA;NA;NA;NA
337;REGIONAL;06/09/2021;2021;36;Outro;All;0;0;0;0;0;0;0;0;0;0;0;NA;NA;NA;NA
338;REGIONAL;13/09/2021;2021;37;Outro;All;0;0;0;0;0;0;0;0;0;0;0;NA;NA;NA;NA
339;REGIONAL;20/09/2021;2021;38;Outro;All;0;0;0;0;0;0;0;0;0;0;0;NA;NA;NA;NA
340;REGIONAL;27/09/2021;2021;39;Outro;All;0;0;0;0;0;0;0;0;0;0;0;NA;NA;NA;NA
341;REGIONAL;04/10/2021;2021;40;Outro;All;0;0;0;0;0;0;0;0;0;0;0;NA;NA;NA;NA
342;REGIONAL;11/10/2021;2021;41;Outro;All;0;0;0;0;0;0;0;0;0;0;0;NA;NA;NA;NA
343;REGIONAL;18/10/2021;2021;42;Outro;All;0;0;0;0;0;0;0;0;0;0;0;NA;NA;NA;NA
344;REGIONAL;25/10/2021;2021;43;Outro;All;0;0;0;0;0;0;0;0;0;0;0;NA;NA;NA;NA
345;AGES;04/01/2021;2021;1;All;12-17 anos;5;0;0;5;7;0;0;7;7;0;7;1,12E-05;1,12E-05;0;1,12E-05
346;AGES;11/01/2021;2021;2;All;12-17 anos;15;0;0;15;22;0;0;22;22;0;22;3,53E-05;3,53E-05;0;3,53E-05
347;AGES;18/01/2021;2021;3;All;12-17 anos;70;1;0;71;92;1;0;93;91;1;92;0,000147794;0,000146187;1,61E-06;0,000147794
348;AGES;25/01/2021;2021;4;All;12-17 anos;16;3;0;19;108;4;0;112;104;4;108;0,000173497;0,000167071;6,43E-06;0,000173497
349;AGES;01/02/2021;2021;5;All;12-17 anos;35;4;0;39;143;8;0;151;135;8;143;0,000229723;0,000216871;1,29E-05;0,000229723
350;AGES;08/02/2021;2021;6;All;12-17 anos;38;66;0;104;181;74;0;255;107;74;181;0,000290768;0,000171891;0,000118878;0,000290768
351;AGES;15/02/2021;2021;7;All;12-17 anos;32;16;0;48;213;90;0;303;123;90;213;0,000342175;0,000197594;0,000144581;0,000342175
352;AGES;22/02/2021;2021;8;All;12-17 anos;24;33;0;57;237;123;0;360;114;123;237;0,00038073;0,000183136;0,000197594;0,00038073
353;AGES;01/03/2021;2021;9;All;12-17 anos;12;30;0;42;249;153;0;402;96;153;249;0,000400007;0,00015422;0,000245787;0,000400007
354;AGES;08/03/2021;2021;10;All;12-17 anos;20;25;0;45;269;178;0;447;90;179;269;0,000432136;0,000144581;0,000287555;0,000432136
355;AGES;15/03/2021;2021;11;All;12-17 anos;6;23;0;29;275;201;0;476;73;202;275;0,000441775;0,000117271;0,000324504;0,000441775
356;AGES;22/03/2021;2021;12;All;12-17 anos;33;11;0;44;308;212;0;520;95;213;308;0,000494788;0,000152613;0,000342175;0,000494788
357;AGES;29/03/2021;2021;13;All;12-17 anos;16;14;0;30;324;226;0;550;97;227;324;0,000520491;0,000155826;0,000364665;0,000520491
358;AGES;05/04/2021;2021;14;All;12-17 anos;34;6;0;40;358;232;0;590;125;233;358;0,000575111;0,000200807;0,000374304;0,000575111
359;AGES;12/04/2021;2021;15;All;12-17 anos;48;11;0;59;406;243;0;649;162;244;406;0,00065222;0,000260246;0,000391975;0,00065222
360;AGES;19/04/2021;2021;16;All;12-17 anos;31;14;0;45;437;257;0;694;177;260;437;0,00070202;0,000284342;0,000417678;0,00070202
361;AGES;26/04/2021;2021;17;All;12-17 anos;51;29;0;80;488;286;0;774;198;290;488;0,00078395;0,000318078;0,000465872;0,00078395
362;AGES;03/05/2021;2021;18;All;12-17 anos;110;16;0;126;598;302;0;900;291;307;598;0,00096066;0,000467478;0,000493181;0,00096066
363;AGES;10/05/2021;2021;19;All;12-17 anos;174;46;0;220;772;348;0;1120;419;353;772;0,001240183;0,000673104;0,000567078;0,001240183
364;AGES;17/05/2021;2021;20;All;12-17 anos;318;27;0;345;1090;375;0;1465;710;380;1090;0,001751035;0,001140582;0,000610453;0,001751035
365;AGES;24/05/2021;2021;21;All;12-17 anos;307;40;0;347;1397;415;0;1812;971;426;1397;0,002244216;0,001559867;0,000684349;0,002244216
366;AGES;31/05/2021;2021;22;All;12-17 anos;281;120;0;401;1678;535;0;2213;1120;558;1678;0,00269563;0,001799229;0,000896401;0,00269563
367;AGES;07/06/2021;2021;23;All;12-17 anos;405;169;0;574;2083;704;0;2787;1351;733;2084;0,003346244;0,002170319;0,001177531;0,00334785
368;AGES;14/06/2021;2021;24;All;12-17 anos;589;337;0;926;2672;1041;0;3713;1600;1075;2675;0,004292445;0,002570327;0,001726938;0,004297265
369;AGES;21/06/2021;2021;25;All;12-17 anos;414;298;1;713;3086;1339;1;4426;1712;1384;3096;0,004957517;0,002750249;0,002223332;0,004973582
370;AGES;28/06/2021;2021;26;All;12-17 anos;239;286;0;525;3325;1625;1;4951;1660;1675;3335;0,00534146;0,002666714;0,002690811;0,005357524
371;AGES;05/07/2021;2021;27;All;12-17 anos;444;669;1;1114;3769;2294;2;6065;1425;2355;3780;0,006054725;0,002289197;0,003783199;0,006072396
372;AGES;12/07/2021;2021;28;All;12-17 anos;281;322;1;604;4050;2616;3;6669;1380;2697;4077;0,006506139;0,002216907;0,004332607;0,006549513
373;AGES;19/07/2021;2021;29;All;12-17 anos;275;284;2;561;4325;2900;5;7230;1359;3004;4363;0,006947914;0,002183171;0,004825788;0,007008959
374;AGES;26/07/2021;2021;30;All;12-17 anos;1634;398;0;2032;5959;3298;5;9262;2557;3449;6006;0,00957286;0,004107703;0,00554066;0,009648363
375;AGES;02/08/2021;2021;31;All;12-17 anos;4634;218;1;4853;10593;3516;6;14115;6841;3829;10670;0,017017168;0,010989752;0,006151113;0,017140865
376;AGES;09/08/2021;2021;32;All;12-17 anos;142703;425;2;143130;153296;3941;8;157245;137965;15534;153499;0,246262986;0,221634439;0,024954658;0,246589096
377;AGES;16/08/2021;2021;33;All;12-17 anos;177941;1589;1;179531;331237;5530;9;336776;302118;29388;331506;0,532117033;0,485338697;0,047210473;0,53254917
378;AGES;23/08/2021;2021;34;All;12-17 anos;132442;3946;4;136392;463679;9476;13;473168;421791;42181;463972;0,744879026;0,677587877;0,06776184;0,745349717
379;AGES;30/08/2021;2021;35;All;12-17 anos;42142;110138;14;152294;505821;119614;27;625462;349104;157018;506122;0,812578214;0,560819549;0,252242208;0,813061757
380;AGES;06/09/2021;2021;36;All;12-17 anos;20555;162768;15;183338;526376;282382;42;808800;205067;321613;526680;0,845598878;0,329430721;0,516656519;0,84608724
381;AGES;13/09/2021;2021;37;All;12-17 anos;12834;126937;33;139804;539210;409319;75;948604;89714;449801;539515;0,86621611;0,144121422;0,722584656;0,866706078
382;AGES;20/09/2021;2021;38;All;12-17 anos;5667;41689;16;47372;544877;451008;91;995976;52746;492437;545183;0,875319885;0,084734027;0,791077433;0,87581146
383;AGES;27/09/2021;2021;39;All;12-17 anos;3259;17228;15;20502;548136;468236;106;1016478;37982;510462;548444;0,880555319;0,061016339;0,820033768;0,881050107
384;AGES;04/10/2021;2021;40;All;12-17 anos;2322;10964;4;13290;550458;479200;110;1029768;28935;521832;550767;0,884285505;0,046482749;0,838299151;0,8847819
385;AGES;11/10/2021;2021;41;All;12-17 anos;2592;6743;0;9335;553050;485943;110;1039103;24292;529068;553360;0,888449434;0,039023983;0,849923452;0,888947435
386;AGES;18/10/2021;2021;42;All;12-17 anos;2059;4123;0;6182;555109;490066;110;1045285;21732;533687;555419;0,891757123;0,03491146;0,857343664;0,892255124
387;AGES;25/10/2021;2021;43;All;12-17 anos;2054;2640;0;4694;557163;492706;110;1049979;20595;536878;557473;0,89505678;0,033084922;0,862469859;0,895554781
388;AGES;04/01/2021;2021;1;All;18-24 anos;1854;4;0;1858;3225;5;0;3230;3219;6;3225;0,004128396;0,004120716;7,68E-06;0,004128396
389;AGES;11/01/2021;2021;2;All;18-24 anos;1451;59;0;1510;4676;64;0;4740;4612;66;4678;0,005985855;0,005903927;8,45E-05;0,005988415
390;AGES;18/01/2021;2021;3;All;18-24 anos;3875;1202;0;5077;8551;1266;0;9817;7283;1271;8554;0,010946331;0,009323135;0,001627036;0,010950171
391;AGES;25/01/2021;2021;4;All;18-24 anos;1401;1648;1;3050;9952;2914;1;12867;7037;2920;9957;0,012739783;0,009008225;0,003737959;0,012746184
392;AGES;01/02/2021;2021;5;All;18-24 anos;1001;947;0;1948;10953;3861;1;14815;7090;3869;10959;0,014021186;0,009076071;0,004952795;0,014028867
393;AGES;08/02/2021;2021;6;All;18-24 anos;1488;3077;0;4565;12441;6938;1;19380;5489;6958;12447;0,015926009;0,007026595;0,008907095;0,01593369
394;AGES;15/02/2021;2021;7;All;18-24 anos;2333;1751;1;4085;14774;8689;2;23465;6032;8748;14780;0,018912536;0,007721701;0,011198515;0,018920216
395;AGES;22/02/2021;2021;8;All;18-24 anos;1341;708;0;2049;16115;9397;2;25514;6636;9485;16121;0,02062918;0,008494896;0,012141966;0,020636861
396;AGES;01/03/2021;2021;9;All;18-24 anos;961;1050;1;2012;17076;10447;3;27526;6525;10559;17084;0,021859379;0,008352802;0,013516818;0,021869619
397;AGES;08/03/2021;2021;10;All;18-24 anos;1399;649;1;2049;18475;11096;4;29575;7266;11220;18486;0,02365027;0,009301373;0,014362979;0,023664352
398;AGES;15/03/2021;2021;11;All;18-24 anos;289;404;1;694;18764;11500;5;30269;7151;11626;18777;0,024020226;0,009154159;0,014882709;0,024036868
399;AGES;22/03/2021;2021;12;All;18-24 anos;3312;183;0;3495;22076;11683;5;33764;10265;11825;22090;0,028259993;0,013140461;0,015137453;0,028277915
400;AGES;29/03/2021;2021;13;All;18-24 anos;699;109;0;808;22775;11792;5;34572;10843;11949;22792;0,029154799;0,013880373;0,015296188;0,029176561
401;AGES;05/04/2021;2021;14;All;18-24 anos;813;199;0;1012;23588;11991;5;35584;11465;12155;23620;0,030195539;0,014676609;0,015559894;0,030236503
402;AGES;12/04/2021;2021;15;All;18-24 anos;4311;113;0;4424;27899;12104;5;40008;15650;12288;27938;0,035714149;0,020033923;0,01573015;0,035764073
403;AGES;19/04/2021;2021;16;All;18-24 anos;1318;114;0;1432;29217;12218;5;41440;16813;12443;29256;0,037401351;0,021522706;0,015928569;0,037451275
404;AGES;26/04/2021;2021;17;All;18-24 anos;2688;188;0;2876;31905;12406;5;44316;19312;12662;31974;0,040842321;0,024721733;0,016208916;0,040930649
405;AGES;03/05/2021;2021;18;All;18-24 anos;1855;852;0;2707;33760;13258;5;47023;20331;13549;33880;0,043216949;0,026026179;0,017344385;0,043370564
406;AGES;10/05/2021;2021;19;All;18-24 anos;2272;5432;1;7705;36032;18690;6;54728;17150;19017;36167;0,046125388;0,021954108;0,024344097;0,046298205
407;AGES;17/05/2021;2021;20;All;18-24 anos;2123;2487;0;4610;38155;21177;6;59338;16720;21575;38295;0,048843089;0,021403655;0,027618651;0,049022306
408;AGES;24/05/2021;2021;21;All;18-24 anos;2293;3311;1;5605;40448;24488;7;64943;15505;25106;40611;0,051778411;0,019848305;0,032138765;0,051987071
409;AGES;31/05/2021;2021;22;All;18-24 anos;2399;2715;1;5115;42847;27203;8;70058;14940;28081;43021;0,054849426;0,019125036;0,035947131;0,055072167
410;AGES;07/06/2021;2021;23;All;18-24 anos;2891;2950;1;5842;45738;30153;9;75900;14695;31253;45948;0,058550261;0,018811406;0,040007681;0,058819087
411;AGES;14/06/2021;2021;24;All;18-24 anos;3117;4666;2;7785;48855;34819;11;83685;13158;36188;49346;0,062540404;0,016843857;0,046325087;0,063168944
412;AGES;21/06/2021;2021;25;All;18-24 anos;2948;3062;2;6012;51803;37881;13;89697;13222;39600;52822;0,066314206;0,016925785;0,050692867;0,067618651
413;AGES;28/06/2021;2021;26;All;18-24 anos;2144;3118;7;5269;53947;40999;20;94966;12509;42959;55468;0,06905879;0,016013057;0,054992799;0,071005857
414;AGES;05/07/2021;2021;27;All;18-24 anos;11934;5121;13;17068;65881;46120;33;112034;20019;49022;69041;0,084335776;0,02562678;0,062754184;0,088380965
415;AGES;12/07/2021;2021;28;All;18-24 anos;14203;7899;3;22105;80084;54019;36;134139;31242;58156;89398;0,102517362;0,039993599;0,074446827;0,114440426
416;AGES;19/07/2021;2021;29;All;18-24 anos;19530;19697;2;39229;99614;73716;38;173368;46355;79920;126275;0,127518162;0,059340097;0,102307422;0,161647518
417;AGES;26/07/2021;2021;30;All;18-24 anos;21046;22637;15;43698;120660;96353;53;217066;61949;104824;166773;0,154459628;0,079302333;0,134187602;0,213489935
418;AGES;02/08/2021;2021;31;All;18-24 anos;54004;56528;5;110537;174664;152881;58;327603;101838;167023;268861;0,223591385;0,130365155;0,213809966;0,344175121
419;AGES;09/08/2021;2021;32;All;18-24 anos;87830;82661;7;170498;262494;235542;65;498101;165870;260982;426852;0,336024578;0,212333984;0,334089033;0,546423017
420;AGES;16/08/2021;2021;33;All;18-24 anos;94400;74476;15;168891;356894;310018;80;666992;230025;347378;577403;0,456868179;0,294460268;0,44468653;0,739146798
421;AGES;23/08/2021;2021;34;All;18-24 anos;56397;43842;7;100246;413291;353860;87;767238;250286;397833;648119;0,52906327;0,320396838;0,50927513;0,829671969
422;AGES;30/08/2021;2021;35;All;18-24 anos;22718;100558;7;123283;436009;454418;94;890521;171690;502770;674460;0,558145102;0,219784299;0,643607386;0,863391686
423;AGES;06/09/2021;2021;36;All;18-24 anos;12967;78545;17;91529;448976;532963;111;982050;104957;583368;688325;0,574744455;0,134357858;0,746782731;0,881140589
424;AGES;13/09/2021;2021;37;All;18-24 anos;9124;52625;7;61756;458100;585588;118;1043806;60623;637410;698033;0,586424297;0,07760489;0,815963132;0,893568023
425;AGES;20/09/2021;2021;38;All;18-24 anos;7174;18694;6;25874;465274;604282;124;1069680;48016;657557;705573;0,595607898;0,061466381;0,841753768;0,903220149
426;AGES;27/09/2021;2021;39;All;18-24 anos;5020;11447;7;16474;470294;615729;131;1086154;40499;670396;710895;0,602034115;0,051843697;0,858189266;0,910032963
427;AGES;04/10/2021;2021;40;All;18-24 anos;2964;9410;17;12391;473258;625139;148;1098545;33760;680547;714307;0,6058284;0,043216949;0,871183794;0,914400742
428;AGES;11/10/2021;2021;41;All;18-24 anos;4154;7695;1;11850;477412;632834;149;1110395;29101;689387;718488;0,61114603;0,037252856;0,88250008;0,919752936
429;AGES;18/10/2021;2021;42;All;18-24 anos;2940;6065;0;9005;480352;638899;149;1119400;24977;696479;721456;0,614909591;0,031973629;0,891578712;0,923552341
430;AGES;25/10/2021;2021;43;All;18-24 anos;2893;3403;2;6298;483245;642302;151;1125698;23280;701079;724359;0,618612987;0,029801261;0,897467277;0,927268538
431;AGES;04/01/2021;2021;1;All;25-49 anos;28059;84;0;28143;52173;95;1;52269;52082;98;52180;0,015660227;0,015632912;2,94E-05;0,015662328
432;AGES;11/01/2021;2021;2;All;25-49 anos;16930;819;0;17749;69103;914;1;70018;68182;928;69110;0,020741928;0,020465481;0,000278548;0,02074403
433;AGES;18/01/2021;2021;3;All;25-49 anos;37900;21840;2;59742;107003;22754;3;129760;84202;22809;107011;0,032117977;0,025274038;0,00684634;0,032120378
434;AGES;25/01/2021;2021;4;All;25-49 anos;15882;26315;7;42204;122885;49069;10;171964;73748;49145;122893;0,036885112;0,02213617;0,014751343;0,036887513
435;AGES;01/02/2021;2021;5;All;25-49 anos;10178;12601;2;22781;133063;61670;12;194745;71322;61755;133077;0,039940136;0,021407983;0,018536356;0,039944338
436;AGES;08/02/2021;2021;6;All;25-49 anos;13958;30981;5;44944;147021;92651;17;239689;54188;92848;147036;0,044129764;0,016265048;0,027869218;0,044134266
437;AGES;15/02/2021;2021;7;All;25-49 anos;22503;19102;6;41611;169524;111753;23;281300;57257;112283;169540;0,050884255;0,017186238;0,03370282;0,050889058
438;AGES;22/02/2021;2021;8;All;25-49 anos;11800;7395;0;19195;181324;119148;23;300495;61427;119913;181340;0,054426138;0,018437903;0,035993037;0,054430941
439;AGES;01/03/2021;2021;9;All;25-49 anos;7770;10089;6;17865;189094;129237;29;318360;58936;130185;189121;0,056758378;0,017690206;0,039076277;0,056766483
440;AGES;08/03/2021;2021;10;All;25-49 anos;16615;6372;2;22989;205709;135609;31;341349;69047;136709;205756;0,06174553;0,02072512;0,041034518;0,061759638
441;AGES;15/03/2021;2021;11;All;25-49 anos;4831;3432;4;8267;210540;139041;35;349616;70415;140183;210598;0,063195601;0,021135738;0,042077272;0,06321301
442;AGES;22/03/2021;2021;12;All;25-49 anos;42589;1847;1;44437;253129;140888;36;394053;110993;142205;253198;0,075979098;0,033315614;0,042684195;0,075999809
443;AGES;29/03/2021;2021;13;All;25-49 anos;4853;1323;1;6177;257982;142211;37;400230;114482;143597;258079;0,077435773;0,034362871;0,043102017;0,077464888
444;AGES;05/04/2021;2021;14;All;25-49 anos;9232;1456;1;10689;267214;143667;38;410919;122215;145162;267377;0,080206846;0,036684005;0,043571767;0,080255772
445;AGES;12/04/2021;2021;15;All;25-49 anos;89490;978;1;90469;356704;144645;39;501388;210595;146290;356885;0,107068128;0,06321211;0,043910347;0,107122457
446;AGES;19/04/2021;2021;16;All;25-49 anos;11375;986;2;12363;368079;145631;41;513751;220609;147656;368265;0,110482444;0,066217908;0,044320365;0,110538273
447;AGES;26/04/2021;2021;17;All;25-49 anos;11358;1122;2;12482;379437;146753;43;526233;230774;148933;379707;0,113891656;0,06926903;0,044703669;0,113972699
448;AGES;03/05/2021;2021;18;All;25-49 anos;10698;8285;2;18985;390135;155038;45;545218;233077;157432;390509;0,117102764;0,069960298;0,047254725;0,117215023
449;AGES;10/05/2021;2021;19;All;25-49 anos;25543;100688;8;126239;415678;255726;53;671457;157617;258540;416157;0,12476974;0,047310255;0,077603262;0,124913517
450;AGES;17/05/2021;2021;20;All;25-49 anos;33059;22256;8;55323;448737;277982;61;726780;167772;281584;449356;0,134692716;0,050358376;0,084520139;0,134878515
451;AGES;24/05/2021;2021;21;All;25-49 anos;26800;18645;6;45451;475537;296627;67;772231;174037;302398;476435;0,142736993;0,052238875;0,090767661;0,143006537
452;AGES;31/05/2021;2021;22;All;25-49 anos;42988;24203;13;67204;518525;320830;80;839435;190734;329101;519835;0,155640254;0,05725064;0,098782823;0,156033463
453;AGES;07/06/2021;2021;23;All;25-49 anos;128885;32403;19;161307;647410;353233;99;1000742;283992;366836;650828;0,194326323;0,085242924;0,110109345;0,195352269
454;AGES;14/06/2021;2021;24;All;25-49 anos;240802;85920;30;326752;888212;439153;129;1327494;446095;462847;908942;0,266605354;0,133899694;0,138927968;0,272827662
455;AGES;21/06/2021;2021;25;All;25-49 anos;273432;56814;28;330274;1161644;495967;157;1657768;674577;533480;1208057;0,348678592;0,202480759;0,160129141;0,3626099
456;AGES;28/06/2021;2021;26;All;25-49 anos;315847;62227;79;378153;1477491;558194;236;2035921;927384;613418;1540802;0,4434831;0,278363206;0,184123298;0,462486504
457;AGES;05/07/2021;2021;27;All;25-49 anos;369074;148071;17;517162;1846565;706265;253;2553083;1152928;785331;1938259;0,554264202;0,346062401;0,235724635;0,581787036
458;AGES;12/07/2021;2021;28;All;25-49 anos;208633;317317;67;526017;2055198;1023582;320;3079100;1118498;1124109;2242607;0,616887399;0,335727907;0,337412102;0,673140009
459;AGES;19/07/2021;2021;29;All;25-49 anos;103981;344371;48;448400;2159179;1367953;368;3527500;956036;1484527;2440563;0,648098294;0,286963378;0,445595023;0,732558401
460;AGES;26/07/2021;2021;30;All;25-49 anos;61738;354444;31;416213;2220917;1722397;399;3943713;712538;1853107;2565645;0,666629547;0,213875117;0,556227846;0,770102964
461;AGES;02/08/2021;2021;31;All;25-49 anos;52977;383768;43;436788;2273894;2106165;442;4380501;419139;2251453;2670592;0,682531102;0,125808592;0,67579522;0,801603813
462;AGES;09/08/2021;2021;32;All;25-49 anos;70769;237849;43;308661;2344663;2344014;485;4689162;292335;2508319;2800654;0,703773096;0,087747155;0,752896015;0,84064317
463;AGES;16/08/2021;2021;33;All;25-49 anos;78177;145633;34;223844;2422840;2489647;519;4913006;252804;2669707;2922511;0,727238673;0,075881546;0,801338172;0,877219718
464;AGES;23/08/2021;2021;34;All;25-49 anos;88378;79941;22;168341;2511218;2569588;541;5081347;265134;2765966;3031100;0,753766177;0,079582514;0,830231234;0,909813748
465;AGES;30/08/2021;2021;35;All;25-49 anos;46555;80585;21;127161;2557773;2650173;562;5208508;225211;2859914;3085125;0,767740107;0,067599243;0,858430628;0,92602987
466;AGES;06/09/2021;2021;36;All;25-49 anos;25138;63672;44;88854;2582911;2713845;606;5297362;182469;2929630;3112099;0,775285519;0,054769821;0,879356554;0,934126375
467;AGES;13/09/2021;2021;37;All;25-49 anos;18816;66806;44;85666;2601727;2780651;650;5383028;132047;3000505;3132552;0,780933322;0,039635174;0,900630365;0,940265539
468;AGES;20/09/2021;2021;38;All;25-49 anos;16668;32157;42;48867;2618395;2812808;692;5431895;113412;3036820;3150232;0,785936382;0,0340417;0,911530661;0,945572361
469;AGES;27/09/2021;2021;39;All;25-49 anos;11124;21258;45;32427;2629519;2834066;737;5464322;100317;3061922;3162239;0,789275358;0,03011111;0,919065267;0,949176377
470;AGES;04/10/2021;2021;40;All;25-49 anos;6268;17458;100;23826;2635787;2851524;837;5488148;88703;3080999;3169702;0,791156758;0,026625057;0,924791412;0,951416468
471;AGES;11/10/2021;2021;41;All;25-49 anos;8651;16259;4;24914;2644438;2867783;841;5513062;79001;3099450;3178451;0,793753439;0,023712908;0,930329656;0,954042564
472;AGES;18/10/2021;2021;42;All;25-49 anos;6463;13416;1;19880;2650901;2881199;842;5532942;70401;3114598;3184999;0,79569337;0,021131536;0,934876474;0,956008009
473;AGES;25/10/2021;2021;43;All;25-49 anos;6289;7873;0;14162;2657190;2889072;842;5547104;66986;3124342;3191328;0,797581074;0,020106491;0,937801229;0,95790772
474;AGES;04/01/2021;2021;1;All;50-64 anos;13020;10;0;13030;22287;12;0;22299;22279;13;22292;0,010250756;0,010247077;5,98E-06;0,010253056
475;AGES;11/01/2021;2021;2;All;50-64 anos;11720;310;0;12030;34007;322;0;34329;33679;333;34012;0,015641292;0,015490431;0,000153161;0,015643592
476;AGES;18/01/2021;2021;3;All;50-64 anos;27485;8599;2;36086;61492;8921;2;70415;52543;8954;61497;0,028282834;0,024166801;0,004118332;0,028285134
477;AGES;25/01/2021;2021;4;All;50-64 anos;10822;12443;2;23267;72314;21364;4;93682;50911;21408;72319;0,03326034;0,023416174;0,009846466;0,03326264
478;AGES;01/02/2021;2021;5;All;50-64 anos;5598;9234;0;14832;77912;30598;4;108514;47271;30649;77920;0,035835103;0,02174198;0,014096802;0,035838783
479;AGES;08/02/2021;2021;6;All;50-64 anos;6926;22310;3;29239;84838;52908;7;137753;31831;53015;84846;0,03902067;0,014640455;0,024383894;0,03902435
480;AGES;15/02/2021;2021;7;All;50-64 anos;25179;12998;1;38178;110017;65906;8;175931;43896;66129;110025;0,050601583;0,020189671;0,030415591;0,050605262
481;AGES;22/02/2021;2021;8;All;50-64 anos;49914;4974;3;54891;159931;70880;11;230822;88662;71277;159939;0,073559193;0,040779494;0,032783379;0,073562873
482;AGES;01/03/2021;2021;9;All;50-64 anos;30280;6012;3;36295;190211;76892;14;267117;112848;77378;190226;0,087486276;0,051903682;0,035589493;0,087493176
483;AGES;08/03/2021;2021;10;All;50-64 anos;22499;4305;1;26805;212710;81197;15;293922;130980;81756;212736;0,097834541;0,060243374;0,037603125;0,097846499
484;AGES;15/03/2021;2021;11;All;50-64 anos;4861;2358;1;7220;217571;83555;16;301142;133479;84138;217617;0,100070325;0,061392773;0,03869871;0,100091483
485;AGES;22/03/2021;2021;12;All;50-64 anos;34779;1020;2;35801;252350;84575;18;336943;167108;85297;252405;0,116066694;0,076860206;0,039231784;0,116091991
486;AGES;29/03/2021;2021;13;All;50-64 anos;7907;836;0;8743;260257;85411;18;345686;174178;86157;260335;0,119703465;0,080112005;0,039627336;0,119739341
487;AGES;05/04/2021;2021;14;All;50-64 anos;15295;1012;1;16308;275552;86423;19;361994;188407;87268;275675;0,126738298;0,086656539;0,040138333;0,126794871
488;AGES;12/04/2021;2021;15;All;50-64 anos;88112;662;0;88774;363664;87085;19;450768;275772;88028;363800;0,167264823;0,126839486;0,040487889;0,167327375
489;AGES;19/04/2021;2021;16;All;50-64 anos;14580;1879;2;16461;378244;88964;21;467229;288223;90159;378382;0,173970796;0,13256624;0,041468029;0,174034269
490;AGES;26/04/2021;2021;17;All;50-64 anos;33090;3006;4;36100;411334;91970;25;503329;318433;93307;411740;0,18919032;0,146461127;0,04291593;0,189377057
491;AGES;03/05/2021;2021;18;All;50-64 anos;151654;14944;6;166604;562988;106914;31;669933;460441;108625;569066;0,258942563;0,211776756;0,049961342;0,261738098
492;AGES;10/05/2021;2021;19;All;50-64 anos;166826;110024;9;276859;729814;216938;40;946792;526329;219294;745623;0,335673065;0,242081501;0,100862808;0,342944309
493;AGES;17/05/2021;2021;20;All;50-64 anos;224876;76021;13;300910;954690;292959;53;1247702;689969;298789;988758;0,439103276;0,317346624;0,137426001;0,454772625
494;AGES;24/05/2021;2021;21;All;50-64 anos;175383;98750;71;274204;1130073;391709;124;1521906;801394;406905;1208299;0,519769513;0,368595807;0,187153231;0,555749038
495;AGES;31/05/2021;2021;22;All;50-64 anos;163808;169195;12;333015;1293881;560904;136;1854921;837748;584346;1422094;0,595111907;0,385316586;0,268766032;0,654082618
496;AGES;07/06/2021;2021;23;All;50-64 anos;210067;139600;30;349697;1503948;700504;166;2204618;920763;734992;1655755;0,691730817;0,42349878;0,338054651;0,761553431
497;AGES;14/06/2021;2021;24;All;50-64 anos;86435;231606;25;318066;1590383;932110;191;2522684;785467;973258;1758725;0,731486017;0,36127029;0,447643503;0,808913793
498;AGES;21/06/2021;2021;25;All;50-64 anos;86629;184264;35;270928;1677012;1116374;226;2793612;695983;1165502;1861485;0,771330446;0,320112723;0,536064845;0,856177568
499;AGES;28/06/2021;2021;26;All;50-64 anos;59432;179280;51;238763;1736444;1295654;277;3032375;575605;1352324;1927929;0,798665796;0,264745667;0,621992373;0,886738041
500;AGES;05/07/2021;2021;27;All;50-64 anos;41427;258559;33;300019;1777871;1554213;310;3332394;358047;1618339;1976386;0,817719868;0,164681321;0,744344192;0,909025514
501;AGES;12/07/2021;2021;28;All;50-64 anos;15435;134813;29;150277;1793306;1689026;339;3482671;243609;1759364;2002973;0,824819093;0,112046329;0,809207697;0,921254026
502;AGES;19/07/2021;2021;29;All;50-64 anos;10955;115225;21;126201;1804261;1804251;360;3608872;151156;1881275;2032431;0,829857772;0,069523191;0,865279846;0,934803036
503;AGES;26/07/2021;2021;30;All;50-64 anos;9868;87537;23;97428;1814129;1891788;383;3706300;83463;1975561;2059024;0,834396492;0,038388248;0,90864606;0,947034309
504;AGES;02/08/2021;2021;31;All;50-64 anos;8638;54083;14;62735;1822767;1945871;397;3769035;46488;2035791;2082279;0,838369483;0,021381844;0,936348446;0,95773029
505;AGES;09/08/2021;2021;32;All;50-64 anos;7385;24451;6;31842;1830152;1970322;403;3800877;35327;2065485;2100812;0,841766164;0,016248417;0,950006002;0,966254419
506;AGES;16/08/2021;2021;33;All;50-64 anos;7549;13091;13;20653;1837701;1983413;416;3821530;33101;2082809;2115910;0,845238276;0,015224583;0,95797406;0,973198644
507;AGES;23/08/2021;2021;34;All;50-64 anos;11309;8284;3;19596;1849010;1991697;419;3841126;36313;2095883;2132196;0,850439775;0,016701921;0,963987359;0,98068928
508;AGES;30/08/2021;2021;35;All;50-64 anos;12908;6146;11;19065;1861918;1997843;430;3860191;40754;2107451;2148205;0,856376723;0,01874453;0,969307983;0,988052513
509;AGES;06/09/2021;2021;36;All;50-64 anos;5596;4021;24;9641;1867514;2001864;454;3869832;40654;2113782;2154436;0,858950566;0,018698535;0,972219884;0,990918419
510;AGES;13/09/2021;2021;37;All;50-64 anos;3670;7371;34;11075;1871184;2009235;488;3880907;36225;2122352;2158577;0,860638558;0,016661446;0,976161598;0,992823045
511;AGES;20/09/2021;2021;38;All;50-64 anos;3266;6597;46;9909;1874450;2015832;534;3890816;32143;2130038;2162181;0,862140733;0,014783958;0,979696723;0,99448068
512;AGES;27/09/2021;2021;39;All;50-64 anos;2023;5017;38;7078;1876473;2020849;572;3897894;28690;2135745;2164435;0,863071198;0,013195773;0,982321619;0,995517393
513;AGES;04/10/2021;2021;40;All;50-64 anos;1019;3845;78;4942;1877492;2024694;650;3902836;25886;2139870;2165756;0,86353988;0,011906092;0,984218885;0,996124978
514;AGES;11/10/2021;2021;41;All;50-64 anos;1332;3412;1;4745;1878824;2028106;651;3907581;23564;2143569;2167133;0,864152525;0,010838104;0,985920215;0,99675832
515;AGES;18/10/2021;2021;42;All;50-64 anos;1150;3300;1;4451;1879974;2031406;652;3912032;21175;2147130;2168305;0,864681459;0,0097393;0,987558074;0,997297373
516;AGES;25/10/2021;2021;43;All;50-64 anos;1026;1950;0;2976;1881000;2033356;652;3915008;20033;2149306;2169339;0,865153361;0,009214044;0,98855891;0,997772955
517;AGES;04/01/2021;2021;1;All;65-79 anos;2318;3;0;2321;3290;5;0;3295;3286;5;3291;0,002020813;0,002018356;3,07E-06;0,002021427
518;AGES;11/01/2021;2021;2;All;65-79 anos;5570;31;0;5601;8860;36;0;8896;8816;45;8861;0,005442067;0,00541504;2,76E-05;0,005442681
519;AGES;18/01/2021;2021;3;All;65-79 anos;14179;918;0;15097;23039;954;0;23993;22056;984;23040;0,014151216;0,013547429;0,000604401;0,01415183
520;AGES;25/01/2021;2021;4;All;65-79 anos;6645;2163;0;8808;29684;3117;0;32801;26522;3163;29685;0,018232766;0,016290574;0,001942805;0,01823338
521;AGES;01/02/2021;2021;5;All;65-79 anos;2861;4194;0;7055;32545;7311;0;39856;25188;7358;32546;0,019990074;0,015471193;0,004519495;0,019990688
522;AGES;08/02/2021;2021;6;All;65-79 anos;3823;11575;1;15399;36368;18886;1;55255;17415;18954;36369;0,022338271;0,010696793;0,011642091;0,022338885
523;AGES;15/02/2021;2021;7;All;65-79 anos;5183;7301;0;12484;41551;26187;1;67739;15272;26280;41552;0,025521818;0,009380501;0,016141931;0,025522432
524;AGES;22/02/2021;2021;8;All;65-79 anos;11714;2494;3;14211;53265;28681;4;81950;24447;28819;53266;0,032716893;0,01501605;0,017701458;0,032717508
525;AGES;01/03/2021;2021;9;All;65-79 anos;13366;3846;0;17212;66631;32527;4;99162;33959;32683;66642;0,040926675;0,020858593;0,020074838;0,040933431
526;AGES;08/03/2021;2021;10;All;65-79 anos;16017;3612;0;19629;82648;36139;4;118791;46357;36320;82677;0,050764776;0,028473801;0,022308788;0,050782589
527;AGES;15/03/2021;2021;11;All;65-79 anos;18220;6888;3;25111;100868;43027;7;143902;57686;43219;100905;0,061956024;0,035432399;0,026546352;0,06197875
528;AGES;22/03/2021;2021;12;All;65-79 anos;52928;2258;1;55187;153796;45285;8;199089;108297;45546;153843;0,094465922;0,066519129;0,027975662;0,094494791
529;AGES;29/03/2021;2021;13;All;65-79 anos;88382;7474;0;95856;242178;52759;8;294945;189180;53062;242242;0,148752686;0,116199791;0,032592205;0,148791996
530;AGES;05/04/2021;2021;14;All;65-79 anos;201480;5415;4;206899;443658;58174;12;501844;385145;58597;443742;0,272507491;0,236567125;0,035991961;0,272559086
531;AGES;12/04/2021;2021;15;All;65-79 anos;233825;3703;3;237531;677483;61877;15;739375;615134;62437;677571;0,416129524;0,377832976;0,038350599;0,416183576
532;AGES;19/04/2021;2021;16;All;65-79 anos;175934;13352;10;189296;853417;75229;25;928671;777533;75975;853508;0,524193241;0,477583108;0,046666028;0,524249136
533;AGES;26/04/2021;2021;17;All;65-79 anos;293324;46498;4;339826;1146741;121727;29;1268497;1025121;122716;1147837;0,70436127;0,629658771;0,075375693;0,705034464
534;AGES;03/05/2021;2021;18;All;65-79 anos;202501;164579;7;367087;1349242;286306;36;1635584;1069291;287588;1356879;0,828743202;0,656789254;0,176644812;0,833434067
535;AGES;10/05/2021;2021;19;All;65-79 anos;91571;80389;5;171965;1440813;366695;41;1807549;1087845;368440;1456285;0,884988741;0,668185654;0,226306434;0,894492088
536;AGES;17/05/2021;2021;20;All;65-79 anos;41351;111898;7;153256;1482164;478593;48;1960805;1017050;485783;1502833;0,910387713;0,624701331;0,298381876;0,923083207
537;AGES;24/05/2021;2021;21;All;65-79 anos;23645;202874;13;226532;1505809;681467;61;2187337;833629;697490;1531119;0,924911152;0,512038883;0,428418398;0,940457281
538;AGES;31/05/2021;2021;22;All;65-79 anos;18705;137735;13;156453;1524514;819202;74;2343790;717180;838363;1555543;0,9364003;0,440512562;0,514946642;0,955459204
539;AGES;07/06/2021;2021;23;All;65-79 anos;16104;71867;5;87976;1540618;891069;79;2431766;660676;913095;1573771;0,94629184;0,405806181;0,560849184;0,966655365
540;AGES;14/06/2021;2021;24;All;65-79 anos;10904;62786;7;73697;1551522;953855;86;2505463;608064;977970;1586034;0,95298939;0,373490379;0,600697272;0,974187652
541;AGES;21/06/2021;2021;25;All;65-79 anos;10329;97393;7;107729;1561851;1051248;93;2613192;520320;1077968;1598288;0,959333758;0,319595494;0,662118917;0,981714411
542;AGES;28/06/2021;2021;26;All;65-79 anos;9063;182588;27;191678;1570914;1233836;120;2804870;345349;1263393;1608742;0,964900513;0,212123278;0,77601228;0,988135558
543;AGES;05/07/2021;2021;27;All;65-79 anos;8156;204298;17;212471;1579070;1438134;137;3017341;147330;1470667;1617997;0,969910163;0,090494319;0,903325926;0,993820245
544;AGES;12/07/2021;2021;28;All;65-79 anos;5488;57929;9;63426;1584558;1496063;146;3080767;93883;1531875;1625758;0,97328105;0,057665636;0,940921638;0,998587274
545;AGES;19/07/2021;2021;29;All;65-79 anos;7158;42687;5;49850;1591716;1538750;151;3130617;56039;1579615;1635654;0,977677699;0,034420764;0,970244918;1
546;AGES;26/07/2021;2021;30;All;65-79 anos;8637;32477;10;41124;1600353;1571227;161;3171741;28357;1618151;1646508;0,982982793;0,017417684;0,993914836;1
547;AGES;02/08/2021;2021;31;All;65-79 anos;7638;11757;6;19401;1607991;1582984;167;3191142;20469;1635490;1655959;0,987674272;0,012572648;1;1
548;AGES;09/08/2021;2021;32;All;65-79 anos;4610;6298;4;10912;1612601;1589282;171;3202054;17172;1644860;1662032;0,990505866;0,010547536;1;1
549;AGES;16/08/2021;2021;33;All;65-79 anos;3696;2999;6;6701;1616297;1592281;177;3208755;16831;1650054;1666885;0,992776056;0,010338084;1;1
550;AGES;23/08/2021;2021;34;All;65-79 anos;4310;2521;2;6833;1620607;1594802;179;3215588;17832;1654704;1672536;0,995423382;0,010952927;1;1
551;AGES;30/08/2021;2021;35;All;65-79 anos;4909;2251;3;7163;1625516;1597053;182;3222751;19359;1659256;1678615;0,998438631;0,011890854;1;1
552;AGES;06/09/2021;2021;36;All;65-79 anos;2259;1386;7;3652;1627775;1598439;189;3226403;19492;1661595;1681087;0,999826173;0,011972546;1;1
553;AGES;13/09/2021;2021;37;All;65-79 anos;1643;3292;24;4959;1629418;1601731;213;3231362;17469;1665405;1682874;1,000835351;0,010729962;1;1
554;AGES;20/09/2021;2021;38;All;65-79 anos;1418;3371;37;4826;1630836;1605102;250;3236188;15158;1669212;1684370;1,001706327;0,009310479;1;1
555;AGES;27/09/2021;2021;39;All;65-79 anos;906;2730;23;3659;1631742;1607832;273;3239847;13143;1672191;1685334;1,002262819;0,008072808;1;1
556;AGES;04/10/2021;2021;40;All;65-79 anos;466;2221;37;2724;1632208;1610053;310;3242571;11411;1674505;1685916;1,002549049;0,007008964;1;1
557;AGES;11/10/2021;2021;41;All;65-79 anos;578;2081;0;2659;1632786;1612134;310;3245230;9851;1676659;1686510;1,002904073;0,006050767;1;1
558;AGES;18/10/2021;2021;42;All;65-79 anos;509;1994;0;2503;1633295;1614128;310;3247733;8302;1678728;1687030;1,003216716;0,005099327;1;1
559;AGES;25/10/2021;2021;43;All;65-79 anos;432;1428;0;1860;1633727;1615556;310;3249593;7245;1680220;1687465;1,003482063;0,004450087;1;1
560;AGES;04/01/2021;2021;1;All;80 ou mais anos;3784;8;1;3793;4052;8;2;4062;4043;9;4052;0,005944923;0,005931718;1,32E-05;0,005944923
561;AGES;11/01/2021;2021;2;All;80 ou mais anos;14514;1;1;14516;18566;9;3;18578;18533;33;18566;0,027239249;0,027190833;4,84E-05;0,027239249
562;AGES;18/01/2021;2021;3;All;80 ou mais anos;39076;255;1;39332;57642;264;4;57910;57244;398;57642;0,084569903;0,083985974;0,000583929;0,084569903
563;AGES;25/01/2021;2021;4;All;80 ou mais anos;7394;3400;1;10795;65036;3664;5;68705;61206;3830;65036;0,095418067;0,089798853;0,005619214;0,095418067
564;AGES;01/02/2021;2021;5;All;80 ou mais anos;4552;10667;0;15219;69588;14331;5;83924;55083;14505;69588;0,102096568;0,080815446;0,021281122;0,102096568
565;AGES;08/02/2021;2021;6;All;80 ou mais anos;14832;31610;0;46442;84420;45941;5;130366;38211;46209;84420;0,123857451;0,056061562;0,067795889;0,123857451
566;AGES;15/02/2021;2021;7;All;80 ou mais anos;48633;9298;0;57931;133053;55239;5;188297;77489;55564;133053;0,19520973;0,113688581;0,081521149;0,19520973
567;AGES;22/02/2021;2021;8;All;80 ou mais anos;102581;5215;0;107796;235634;60454;5;296093;174749;60885;235634;0,345712232;0,256384337;0,089327895;0,345712232
568;AGES;01/03/2021;2021;9;All;80 ou mais anos;87243;12799;0;100042;322877;73253;5;396135;249141;73737;322878;0,473711469;0,36552913;0,108183806;0,473712936
569;AGES;08/03/2021;2021;10;All;80 ou mais anos;40179;37322;0;77501;363056;110575;5;473636;251977;111081;363058;0,532660397;0,36968999;0,162973342;0,532663331
570;AGES;15/03/2021;2021;11;All;80 ou mais anos;54392;97479;1;151872;417448;208054;6;625508;208843;208607;417450;0,612462037;0,30640561;0,306059361;0,612464972
571;AGES;22/03/2021;2021;12;All;80 ou mais anos;124579;16942;2;141523;542027;224996;8;767031;316365;225664;542029;0,795239073;0,464157338;0,33108467;0,795242008
572;AGES;29/03/2021;2021;13;All;80 ou mais anos;36746;75553;3;112302;578773;300549;11;879333;277524;301253;578777;0,849151249;0,407171467;0,441985651;0,849157118
573;AGES;05/04/2021;2021;14;All;80 ou mais anos;30370;45938;3;76311;609143;346487;14;955644;261893;347255;609148;0,893708828;0,384238325;0,509477839;0,893716164
574;AGES;12/04/2021;2021;15;All;80 ou mais anos;10518;49549;5;60072;619661;396036;19;1015716;222793;396873;619666;0,909140392;0,32687246;0,582275268;0,909147728
575;AGES;19/04/2021;2021;16;All;80 ou mais anos;8412;123387;4;131803;628073;519423;23;1147519;107722;520356;628078;0,921482123;0,158045159;0,763444299;0,921489458
576;AGES;26/04/2021;2021;17;All;80 ou mais anos;6137;39881;0;46018;634210;559304;23;1193537;73939;560287;634226;0,930486069;0,108480171;0,822029372;0,930509544
577;AGES;03/05/2021;2021;18;All;80 ou mais anos;5109;31873;1;36983;639319;591177;24;1230520;47230;592254;639484;0,937981778;0,069293857;0,868930002;0,938223859
578;AGES;10/05/2021;2021;19;All;80 ou mais anos;3785;10000;1;13786;643104;601177;25;1244306;41088;602382;643470;0,94353497;0,060282575;0,883789375;0,944071949
579;AGES;17/05/2021;2021;20;All;80 ou mais anos;4755;8393;2;13150;647859;609570;27;1257456;36393;612269;648662;0,950511304;0,053394269;0,898295163;0,951689432
580;AGES;24/05/2021;2021;21;All;80 ou mais anos;4457;6385;0;10842;652316;615955;27;1268298;32654;620941;653595;0,957050426;0,047908567;0,911018354;0,958926921
581;AGES;31/05/2021;2021;22;All;80 ou mais anos;3059;6180;2;9241;655375;622135;29;1277539;29136;628119;657255;0,961538462;0,042747106;0,921549612;0,964296718
582;AGES;07/06/2021;2021;23;All;80 ou mais anos;2754;4836;1;7591;658129;626971;30;1285130;26572;633815;660387;0,965579014;0,038985314;0,929906542;0,968891856
583;AGES;14/06/2021;2021;24;All;80 ou mais anos;2631;4797;0;7428;660760;631768;30;1292558;23734;639557;663291;0,969439106;0,03482152;0,938330961;0,973152482
584;AGES;21/06/2021;2021;25;All;80 ou mais anos;3404;4838;2;8244;664164;636606;32;1300802;20980;646179;667159;0,97443331;0,030780968;0,94804648;0,978827448
585;AGES;28/06/2021;2021;26;All;80 ou mais anos;3274;5436;1;8711;667438;642042;33;1309513;17453;653402;670855;0,979236785;0,025606303;0,958643759;0,984250062
586;AGES;05/07/2021;2021;27;All;80 ou mais anos;2670;5271;2;7943;670108;647313;35;1317456;13694;660163;673857;0,983154096;0,020091257;0,968563212;0,98865447
587;AGES;12/07/2021;2021;28;All;80 ou mais anos;2107;3563;2;5672;672215;650876;37;1323128;11308;665154;676462;0,986245397;0,016590619;0,975885796;0,992476415
588;AGES;19/07/2021;2021;29;All;80 ou mais anos;2208;3092;1;5301;674423;653968;38;1328429;9444;669826;679270;0,989484881;0,013855837;0,982740357;0,996596194
589;AGES;26/07/2021;2021;30;All;80 ou mais anos;2597;2894;1;5492;677020;656862;39;1333921;7789;674584;682373;0,993295089;0,011427691;0,989721093;1
590;AGES;02/08/2021;2021;31;All;80 ou mais anos;2493;2103;1;4597;679513;658965;40;1338518;6811;678514;685325;0,996952714;0,009992811;0,995487023;1
591;AGES;09/08/2021;2021;32;All;80 ou mais anos;1581;1723;1;3305;681094;660688;41;1341823;6018;681317;687335;0,99927229;0,008829355;0,999599466;1
592;AGES;16/08/2021;2021;33;All;80 ou mais anos;1348;1129;1;2478;682442;661817;42;1344301;5660;683334;688994;1,001250018;0,008304112;1;1
593;AGES;23/08/2021;2021;34;All;80 ou mais anos;1537;973;0;2510;683979;662790;42;1346811;5786;685122;690908;1,00350504;0,008488974;1;1
594;AGES;30/08/2021;2021;35;All;80 ou mais anos;1669;821;0;2490;685648;663611;42;1349301;6186;686710;692896;1,005953726;0,009075837;1;1
595;AGES;06/09/2021;2021;36;All;80 ou mais anos;769;574;3;1346;686417;664185;45;1350647;6122;687615;693737;1,00708197;0,008981939;1;1
596;AGES;13/09/2021;2021;37;All;80 ou mais anos;551;961;3;1515;686968;665146;48;1352162;5586;688744;694330;1,007890374;0,008195543;1;1
597;AGES;20/09/2021;2021;38;All;80 ou mais anos;599;1046;1;1646;687567;666192;49;1353808;4960;689989;694949;1,008769201;0,007277102;1;1
598;AGES;27/09/2021;2021;39;All;80 ou mais anos;367;798;6;1171;687934;666990;55;1354979;4455;690890;695345;1,009307648;0,006536187;1;1
599;AGES;04/10/2021;2021;40;All;80 ou mais anos;167;573;3;743;688101;667563;58;1355722;4051;691495;695546;1,009552664;0,005943456;1;1
600;AGES;11/10/2021;2021;41;All;80 ou mais anos;237;782;0;1019;688338;668345;58;1356741;3442;692343;695785;1,00990038;0,005049957;1;1
601;AGES;18/10/2021;2021;42;All;80 ou mais anos;268;714;0;982;688606;669059;58;1357723;2946;693109;696055;1,010293578;0,004322247;1;1
602;AGES;25/10/2021;2021;43;All;80 ou mais anos;230;640;0;870;688836;669699;58;1358593;2490;693798;696288;1,010631025;0,003653223;1;1
603;AGES;04/01/2021;2021;1;All;Desconhecido;1;0;0;1;2;0;0;2;2;0;2;NA;NA;NA;NA
604;AGES;11/01/2021;2021;2;All;Desconhecido;1;0;0;1;3;0;0;3;3;0;3;NA;NA;NA;NA
605;AGES;18/01/2021;2021;3;All;Desconhecido;1;1;0;2;4;1;0;5;3;1;4;NA;NA;NA;NA
606;AGES;25/01/2021;2021;4;All;Desconhecido;1;1;0;2;5;2;0;7;3;2;5;NA;NA;NA;NA
607;AGES;01/02/2021;2021;5;All;Desconhecido;0;1;0;1;5;3;0;8;2;3;5;NA;NA;NA;NA
608;AGES;08/02/2021;2021;6;All;Desconhecido;2;1;0;3;7;4;0;11;3;4;7;NA;NA;NA;NA
609;AGES;15/02/2021;2021;7;All;Desconhecido;2;1;0;3;9;5;0;14;4;5;9;NA;NA;NA;NA
610;AGES;22/02/2021;2021;8;All;Desconhecido;3;1;0;4;12;6;0;18;6;6;12;NA;NA;NA;NA
611;AGES;01/03/2021;2021;9;All;Desconhecido;1;1;0;2;13;7;0;20;6;7;13;NA;NA;NA;NA
612;AGES;08/03/2021;2021;10;All;Desconhecido;2;1;0;3;15;8;0;23;7;8;15;NA;NA;NA;NA
613;AGES;15/03/2021;2021;11;All;Desconhecido;1;2;0;3;16;10;0;26;6;10;16;NA;NA;NA;NA
614;AGES;22/03/2021;2021;12;All;Desconhecido;2;2;0;4;18;12;0;30;6;12;18;NA;NA;NA;NA
615;AGES;29/03/2021;2021;13;All;Desconhecido;2;0;0;2;20;12;0;32;8;12;20;NA;NA;NA;NA
616;AGES;05/04/2021;2021;14;All;Desconhecido;3;1;0;4;23;13;0;36;10;13;23;NA;NA;NA;NA
617;AGES;12/04/2021;2021;15;All;Desconhecido;3;1;0;4;26;14;0;40;12;14;26;NA;NA;NA;NA
618;AGES;19/04/2021;2021;16;All;Desconhecido;2;1;0;3;28;15;0;43;13;15;28;NA;NA;NA;NA
619;AGES;26/04/2021;2021;17;All;Desconhecido;3;1;0;4;31;16;0;47;15;16;31;NA;NA;NA;NA
620;AGES;03/05/2021;2021;18;All;Desconhecido;2;2;0;4;33;18;0;51;15;18;33;NA;NA;NA;NA
621;AGES;10/05/2021;2021;19;All;Desconhecido;2;4;0;6;35;22;0;57;14;22;36;NA;NA;NA;NA
622;AGES;17/05/2021;2021;20;All;Desconhecido;3;2;0;5;38;24;0;62;16;24;40;NA;NA;NA;NA
623;AGES;24/05/2021;2021;21;All;Desconhecido;3;2;0;5;41;26;0;67;17;26;43;NA;NA;NA;NA
624;AGES;31/05/2021;2021;22;All;Desconhecido;3;3;0;6;44;29;0;73;18;29;47;NA;NA;NA;NA
625;AGES;07/06/2021;2021;23;All;Desconhecido;2;3;0;5;46;32;0;78;18;32;50;NA;NA;NA;NA
626;AGES;14/06/2021;2021;24;All;Desconhecido;2;4;0;6;48;36;0;84;17;36;53;NA;NA;NA;NA
627;AGES;21/06/2021;2021;25;All;Desconhecido;2;4;0;6;50;40;0;90;16;40;56;NA;NA;NA;NA
628;AGES;28/06/2021;2021;26;All;Desconhecido;1;4;0;5;51;44;0;95;14;44;58;NA;NA;NA;NA
629;AGES;05/07/2021;2021;27;All;Desconhecido;2;4;0;6;53;48;0;101;13;48;61;NA;NA;NA;NA
630;AGES;12/07/2021;2021;28;All;Desconhecido;3;3;0;6;56;51;0;107;14;51;65;NA;NA;NA;NA
631;AGES;19/07/2021;2021;29;All;Desconhecido;3;4;0;7;59;55;0;114;14;55;69;NA;NA;NA;NA
632;AGES;26/07/2021;2021;30;All;Desconhecido;3;4;0;7;62;59;0;121;14;59;73;NA;NA;NA;NA
633;AGES;02/08/2021;2021;31;All;Desconhecido;3;2;0;5;65;61;0;126;16;61;77;NA;NA;NA;NA
634;AGES;09/08/2021;2021;32;All;Desconhecido;3;3;0;6;68;64;0;132;17;64;81;NA;NA;NA;NA
635;AGES;16/08/2021;2021;33;All;Desconhecido;2;3;0;5;70;67;0;137;17;67;84;NA;NA;NA;NA
636;AGES;23/08/2021;2021;34;All;Desconhecido;3;3;1;7;73;70;1;144;18;70;88;NA;NA;NA;NA
637;AGES;30/08/2021;2021;35;All;Desconhecido;2;3;0;5;75;73;1;149;18;73;91;NA;NA;NA;NA
638;AGES;06/09/2021;2021;36;All;Desconhecido;2;3;0;5;77;76;1;154;17;76;93;NA;NA;NA;NA
639;AGES;13/09/2021;2021;37;All;Desconhecido;2;3;0;5;79;79;1;159;17;79;96;NA;NA;NA;NA
640;AGES;20/09/2021;2021;38;All;Desconhecido;1;2;0;3;80;81;1;162;17;81;98;NA;NA;NA;NA
641;AGES;27/09/2021;2021;39;All;Desconhecido;2;1;0;3;82;82;1;165;18;82;100;NA;NA;NA;NA
642;AGES;04/10/2021;2021;40;All;Desconhecido;1;3;0;4;83;85;1;169;17;85;102;NA;NA;NA;NA
643;AGES;11/10/2021;2021;41;All;Desconhecido;1;1;0;2;84;86;1;171;17;86;103;NA;NA;NA;NA
644;AGES;18/10/2021;2021;42;All;Desconhecido;0;1;0;1;84;87;1;172;16;87;103;NA;NA;NA;NA
645;AGES;25/10/2021;2021;43;All;Desconhecido;1;1;0;2;85;88;1;174;16;88;104;NA;NA;NA;NA
646;GENERAL;04/01/2021;2021;1;All;All;49042;109;1;49152;85037;125;3;85165;84919;131;85050;0,008217809;0,008206406;1,27E-05;0,008219065
647;GENERAL;11/01/2021;2021;2;All;All;50201;1220;1;51422;135238;1345;4;136587;133848;1405;135253;0,013069135;0,012934808;0,000135776;0,013070585
648;GENERAL;18/01/2021;2021;3;All;All;122586;32816;5;155407;257824;34161;9;291994;223423;34418;257841;0,024915606;0,021591161;0,003326088;0,024917249
649;GENERAL;25/01/2021;2021;4;All;All;42161;45973;11;88145;299985;80134;20;380139;219532;80472;300004;0,028989962;0,021215142;0,007776656;0,028991799
650;GENERAL;01/02/2021;2021;5;All;All;24226;37648;2;61876;324211;117782;22;442015;206093;118147;324240;0,031331116;0,019916424;0,011417495;0,031333918
651;GENERAL;08/02/2021;2021;6;All;All;41067;99620;9;140696;365278;217402;31;582711;147246;218062;365308;0,03529975;0,014229565;0,021073084;0,035302649
652;GENERAL;15/02/2021;2021;7;All;All;103865;50467;8;154340;469143;267869;39;737051;200075;269099;469174;0,04533706;0,019334856;0,0260052;0,045340056
653;GENERAL;22/02/2021;2021;8;All;All;177377;20820;6;198203;646520;288689;45;935254;356043;290508;646551;0,062478426;0,034407298;0,028074124;0,062481421
654;GENERAL;01/03/2021;2021;9;All;All;139633;33827;10;173470;786153;322516;55;1108724;461513;324702;786215;0,075972285;0,044599712;0,031378565;0,075978277
655;GENERAL;08/03/2021;2021;10;All;All;96732;52286;4;149022;882885;374802;59;1257746;505727;377273;883000;0,085320276;0,048872466;0,036458923;0,085331389
656;GENERAL;15/03/2021;2021;11;All;All;82600;110586;10;193196;965485;485388;69;1450942;477656;487985;965641;0,093302578;0,04615974;0,047157914;0,093317653
657;GENERAL;22/03/2021;2021;12;All;All;258223;22263;6;280492;1223708;507651;75;1731434;713133;510762;1223895;0,118256743;0,068915775;0,049359039;0,118274814
658;GENERAL;29/03/2021;2021;13;All;All;138605;85309;4;223918;1362313;592960;79;1955352;766316;596257;1362573;0,131651258;0,074055276;0,057621108;0,131676384
659;GENERAL;05/04/2021;2021;14;All;All;257227;54027;9;311263;1619540;646987;88;2266615;969264;650683;1619947;0,156509171;0,093667773;0,06288073;0,156548503
660;GENERAL;12/04/2021;2021;15;All;All;426308;55017;9;481334;2045848;702004;97;2747949;1340123;706174;2046297;0,197706741;0,12950686;0,068243271;0,197750131
661;GENERAL;19/04/2021;2021;16;All;All;211652;139733;18;351403;2257500;841737;115;3099352;1411095;846864;2257959;0,218160375;0,136365455;0,081839277;0,218204732
662;GENERAL;26/04/2021;2021;17;All;All;346651;90725;10;437386;2604151;932462;125;3536738;1667797;938211;2606008;0,251660048;0,161172633;0,090666872;0,251839505
663;GENERAL;03/05/2021;2021;18;All;All;371930;220552;16;592498;2976081;1153014;141;4129236;1830681;1159774;2990455;0,287602634;0,176913424;0,112078286;0,28899171
664;GENERAL;10/05/2021;2021;19;All;All;290175;306583;24;596782;3266256;1459597;165;4726018;1830469;1468049;3298518;0,315644578;0,176892936;0,141869378;0,318762314
665;GENERAL;17/05/2021;2021;20;All;All;306486;221084;30;527600;3572742;1680681;195;5253618;1928638;1700405;3629043;0,345262784;0,186379796;0,164323806;0,350703602
666;GENERAL;24/05/2021;2021;21;All;All;232889;330008;91;562988;3805631;2010689;286;5816606;1858215;2053294;3911509;0,36776872;0,179574255;0,198426308;0,378000563
667;GENERAL;31/05/2021;2021;22;All;All;231244;340153;41;571438;4036875;2350842;327;6388044;1790883;2408601;4199484;0,390115687;0,173067423;0,23276248;0,405829902
668;GENERAL;07/06/2021;2021;23;All;All;361109;251828;56;612993;4397984;2602670;383;7001037;1908075;2680760;4588835;0,425012553;0,184392628;0,259063392;0,44345602
669;GENERAL;14/06/2021;2021;24;All;All;344481;390117;64;734662;4742465;2992787;447;7735699;1878143;3090936;4969079;0,458302522;0,181500058;0,298701997;0,480202055
670;GENERAL;21/06/2021;2021;25;All;All;377158;346676;75;723909;5119623;3339463;522;8459608;1926816;3464161;5390977;0,494750332;0,186203721;0,334769729;0,52097345
671;GENERAL;28/06/2021;2021;26;All;All;390002;432941;165;823108;5509625;3772404;687;9282716;1879980;3927225;5807205;0,532439361;0,181677582;0,379519326;0,561196909
672;GENERAL;05/07/2021;2021;27;All;All;433707;621993;83;1055783;5943332;4394397;770;10338499;1693462;4585935;6279397;0,574351955;0,163652848;0,44317577;0,606828618
673;GENERAL;12/07/2021;2021;28;All;All;246151;521848;111;768110;6189483;4916245;881;11106609;1499940;5141418;6641358;0,598139505;0,144951262;0,496856558;0,641807819
674;GENERAL;19/07/2021;2021;29;All;All;144110;525361;79;669550;6333593;5441606;960;11776159;1220408;5698235;6918643;0,612066013;0,117937837;0,550666261;0,668604098
675;GENERAL;26/07/2021;2021;30;All;All;105523;500391;80;605994;6439116;5941997;1040;12382153;896672;6229748;7126420;0,622263549;0,086652625;0,602030636;0,68868326
676;GENERAL;02/08/2021;2021;31;All;All;130389;508460;70;638919;6569505;6450457;1110;13021072;601609;6772175;7373784;0,634864086;0,058138315;0,654449718;0,712588032
677;GENERAL;09/08/2021;2021;32;All;All;314889;353411;63;668363;6884394;6803868;1173;13689435;654718;7176576;7831294;0,665294342;0,063270664;0,693530238;0,756800902
678;GENERAL;16/08/2021;2021;33;All;All;363147;238920;70;602137;7247541;7042788;1243;14291572;840602;7462754;8303356;0,700388156;0,08123413;0,721185919;0,802420048
679;GENERAL;23/08/2021;2021;34;All;All;294475;139511;39;434025;7542016;7182299;1282;14725597;997302;7641779;8639081;0,728845643;0,09637731;0,738486544;0,834863854
680;GENERAL;30/08/2021;2021;35;All;All;130925;300503;56;431484;7672941;7482802;1338;15157081;812480;7973218;8785698;0,741497979;0,078516475;0,770516159;0,849032634
681;GENERAL;06/09/2021;2021;36;All;All;67344;310970;110;378424;7740285;7793772;1448;15535505;558988;8297711;8856699;0,748005971;0,054019505;0,801874527;0,855894031
682;GENERAL;13/09/2021;2021;37;All;All;46693;258002;145;304840;7786978;8051774;1593;15840345;341935;8564337;8906272;0,752518291;0,033043928;0,827640741;0,860684669
683;GENERAL;20/09/2021;2021;38;All;All;34808;103560;148;138516;7821786;8155334;1741;15978861;266715;8676181;8942896;0,755882068;0,025774815;0,838449126;0,86422394
684;GENERAL;27/09/2021;2021;39;All;All;22704;58485;134;81323;7844490;8213819;1875;16060184;225363;8741742;8967105;0,758076138;0,021778639;0,844784812;0,866563451
685;GENERAL;04/10/2021;2021;40;All;All;13258;44475;239;57972;7857748;8258294;2114;16118156;193070;8789390;8982460;0,759357365;0,018657906;0,849389422;0,868047328
686;GENERAL;11/10/2021;2021;41;All;All;17568;36977;6;54551;7875316;8295271;2120;16172707;169593;8830624;9000217;0,761055102;0,016389135;0,853374194;0,86976333
687;GENERAL;18/10/2021;2021;42;All;All;13399;29618;2;43019;7888715;8324889;2122;16215726;149878;8863886;9013764;0,762349955;0,014483916;0,856588569;0,871072485
688;GENERAL;25/10/2021;2021;43;All;All;12927;17937;2;30866;7901642;8342826;2124;16246592;140973;8885782;9026755;0,763599195;0,013623354;0,858704555;0,87232791