"";"TYPE";"DATE";"YEAR";"WEEK";"REGION";"AGEGROUP";"TOTAL_VAC_1";"TOTAL_VAC_2";"TOTAL_VAC_UNK";"TOTAL";"CUMUL_VAC_1";"CUMUL_VAC_2";"CUMUL_VAC_UNK";"CUMUL";"CUMUL_VAC_INIT";"CUMUL_VAC_COMPLETE";"CUMUL_VAC_LEAST";"COVER_1_VAC";"COVER_INIT";"COVER_COMPLETE";"COVER_LEAST"
"1";"REGIONAL";2021-01-04;2021;1;"ARS Alentejo";"All";3468;3;0;3471;4702;4;0;4706;4698;4;4702;0,0100298206918912;0,010021288305084;8,53238680722352e-06;0,0100298206918912
"2";"REGIONAL";2021-01-11;2021;2;"ARS Alentejo";"All";5377;11;0;5388;10079;15;0;10094;10063;16;10079;0,0214994816575015;0,0214653521102726;3,41295472288941e-05;0,0214994816575015
"3";"REGIONAL";2021-01-18;2021;3;"ARS Alentejo";"All";10457;1138;0;11595;20536;1153;0;21689;19378;1158;20536;0,0438052738682855;0,0413351478875943;0,00247012598069121;0,0438052738682855
"4";"REGIONAL";2021-01-25;2021;4;"ARS Alentejo";"All";2374;3105;0;5479;22910;4258;0;27168;18644;4266;22910;0,0488692454383727;0,0397694549084688;0,00909979052990388;0,0488692454383727
"5";"REGIONAL";2021-02-01;2021;5;"ARS Alentejo";"All";1455;4354;0;5809;24365;8612;0;32977;15744;8621;24365;0,0519729011395003;0,0335834744732318;0,0183894266662685;0,0519729011395003
"6";"REGIONAL";2021-02-08;2021;6;"ARS Alentejo";"All";3290;8800;0;12090;27655;17412;0;45067;10230;17425;27655;0,0589907892884416;0,0218215792594741;0,0371692100289675;0,0589907892884416
"7";"REGIONAL";2021-02-15;2021;7;"ARS Alentejo";"All";4081;2844;0;6925;31736;20256;0;51992;11467;20269;31736;0,0676959569285114;0,024460219879608;0,0432357370489034;0,0676959569285114
"8";"REGIONAL";2021-02-22;2021;8;"ARS Alentejo";"All";12066;1640;0;13706;43802;21896;0;65698;21888;21914;43802;0,0934339017325011;0,0466892206091271;0,0467446811233741;0,0934339017325011
"9";"REGIONAL";2021-03-01;2021;9;"ARS Alentejo";"All";10487;2836;1;13324;54289;24732;1;79022;29533;24756;54289;0,115803686844339;0,062996744894433;0,0528069419499064;0,115803686844339
"10";"REGIONAL";2021-03-08;2021;10;"ARS Alentejo";"All";5850;1697;0;7547;60139;26429;1;86569;33678;26461;60139;0,128282302549904;0,0718384307234184;0,0564438718264854;0,128282302549904
"11";"REGIONAL";2021-03-15;2021;11;"ARS Alentejo";"All";3737;7749;0;11486;63876;34178;1;98055;29666;34211;63877;0,136253684924552;0,0632804467557732;0,072975371265481;0,136255818021254
"12";"REGIONAL";2021-03-22;2021;12;"ARS Alentejo";"All";11926;2123;0;14049;75802;36301;1;112104;39468;36336;75804;0,161692996190289;0,0841890606268745;0,0775082017568184;0,161697262383693
"13";"REGIONAL";2021-03-29;2021;13;"ARS Alentejo";"All";6168;6317;0;12485;81970;42618;1;124589;39316;42656;81972;0,174849936647028;0,0838648299282;0,0909893729122316;0,174854202840432
"14";"REGIONAL";2021-04-05;2021;14;"ARS Alentejo";"All";14066;4337;0;18403;96036;46955;1;142992;49042;46998;96040;0,204854074854629;0,104611328449964;0,100251278791473;0,204862607241437
"15";"REGIONAL";2021-04-12;2021;15;"ARS Alentejo";"All";21937;2983;0;24920;117973;49938;1;167912;67993;49985;117978;0,251647817202145;0,145035644045887;0,106622838639767;0,251658482685654
"16";"REGIONAL";2021-04-19;2021;16;"ARS Alentejo";"All";11414;5993;0;17407;129387;55931;1;185319;73411;55981;129392;0,275994982956557;0,156592761976271;0,119412886463795;0,276005648440066
"17";"REGIONAL";2021-04-26;2021;17;"ARS Alentejo";"All";20277;2807;0;23084;149664;58738;1;208403;90886;58791;149677;0,319247784779075;0,193868626840329;0,125406888195869;0,319275515036199
"18";"REGIONAL";2021-05-03;2021;18;"ARS Alentejo";"All";13729;14355;1;28085;163393;73093;2;236488;93367;73158;166525;0,348533069398168;0,19916083975751;0,156053088510715;0,355213928268224
"19";"REGIONAL";2021-05-10;2021;19;"ARS Alentejo";"All";17481;15306;0;32787;180874;88399;2;269275;96028;88484;184512;0,385821732842437;0,204837010081015;0,188744928562591;0,393581938643606
"20";"REGIONAL";2021-05-17;2021;20;"ARS Alentejo";"All";13273;12283;1;25557;194147;100682;3;294832;100317;100885;201202;0,414134325365506;0,21398586183506;0,215197460761686;0,429183322596747
"21";"REGIONAL";2021-05-24;2021;21;"ARS Alentejo";"All";7231;18613;0;25844;201378;119295;3;320676;90621;119956;210577;0,429558747616264;0,193303356214351;0,255877747961826;0,449181104176177
"22";"REGIONAL";2021-05-31;2021;22;"ARS Alentejo";"All";17433;7353;0;24786;218811;126648;3;345462;100290;128067;228357;0,466745022418846;0,213928268224112;0,273179295310174;0,487107563534285
"23";"REGIONAL";2021-06-07;2021;23;"ARS Alentejo";"All";13871;15306;0;29177;232682;141954;3;374639;98892;143975;242867;0,496333206769596;0,210946199034987;0,307112597642502;0,518058796677489
"24";"REGIONAL";2021-06-14;2021;24;"ARS Alentejo";"All";10290;19303;1;29594;242972;161257;4;404233;91081;163752;254833;0,518282771831178;0,194284580697181;0,349298851114116;0,543583431811298
"25";"REGIONAL";2021-06-21;2021;25;"ARS Alentejo";"All";10615;14371;0;24986;253587;175628;4;429219;89538;178821;268359;0,540925593320848;0,190993212486295;0,381442485313629;0,572435697799924
"26";"REGIONAL";2021-06-28;2021;26;"ARS Alentejo";"All";11027;29043;3;40073;264614;204671;7;469292;73162;208526;281688;0,564447250651661;0,156061620897522;0,444806122840773;0,600867743738295
"27";"REGIONAL";2021-07-05;2021;27;"ARS Alentejo";"All";15353;27962;0;43315;279967;232633;7;512607;59861;237884;297745;0,597196684314487;0,127689301666802;0,50742957581239;0,635118877479192
"28";"REGIONAL";2021-07-12;2021;28;"ARS Alentejo";"All";8211;20421;1;28633;288178;253054;8;541240;49649;259795;309444;0,614711541333015;0,10590611814796;0,554167857645658;0,660073975793619
"29";"REGIONAL";2021-07-19;2021;29;"ARS Alentejo";"All";3527;16780;2;20309;291705;269834;10;561549;39449;277855;317304;0,622234973400284;0,0841485317895401;0,592691584080273;0,676840115869813
"30";"REGIONAL";2021-07-26;2021;30;"ARS Alentejo";"All";2258;16587;0;18845;293963;286421;10;580394;28723;295469;324192;0,627051505752962;0,0612689365659703;0,630263949385881;0,691532885951852
"31";"REGIONAL";2021-08-02;2021;31;"ARS Alentejo";"All";4969;20040;13;25022;298932;306461;23;605416;18624;316630;335254;0,637650863264235;0,0397267929744327;0,675402408692796;0,715129201667228
"32";"REGIONAL";2021-08-09;2021;32;"ARS Alentejo";"All";14885;14453;0;29338;313817;320914;23;634754;24705;332743;357448;0,669402007670616;0,0526981540181143;0,709772995848994;0,762471149867108
"33";"REGIONAL";2021-08-16;2021;33;"ARS Alentejo";"All";22245;6603;0;28848;336062;327517;23;663602;41963;341557;383520;0,716852743802288;0,0895111368978801;0,728574110178711;0,818085247076591
"34";"REGIONAL";2021-08-23;2021;34;"ARS Alentejo";"All";12990;4614;0;17604;349052;332131;23;681206;51040;347603;398643;0,744561669958746;0,108873255660172;0,741470812837829;0,850344068498001
"35";"REGIONAL";2021-08-30;2021;35;"ARS Alentejo";"All";4762;15836;2;20600;353814;347967;25;701806;40638;364393;405031;0,754719476452746;0,0866847837679873;0,77728550646115;0,863970290229137
"36";"REGIONAL";2021-09-06;2021;36;"ARS Alentejo";"All";2620;15209;6;17835;356434;363176;31;719641;27639;380096;407735;0,760308189811477;0,0589566597412127;0,810781523969608;0,86973818371082
"37";"REGIONAL";2021-09-13;2021;37;"ARS Alentejo";"All";1848;15840;3;17691;358282;379016;34;737332;13433;396178;409611;0,764250152516414;0,0286538879953584;0,84508598512805;0,873739873123408
"38";"REGIONAL";2021-09-20;2021;38;"ARS Alentejo";"All";1618;3616;6;5240;359900;382632;40;742572;11183;400064;411247;0,767701502979936;0,0238544204162952;0,853375198911267;0,877229619327563
"39";"REGIONAL";2021-09-27;2021;39;"ARS Alentejo";"All";1130;2415;5;3550;361030;385047;45;746122;9612;402847;412459;0,770111902252977;0,0205033254977581;0,859311607032393;0,879814932530151
"40";"REGIONAL";2021-10-04;2021;40;"ARS Alentejo";"All";478;1680;3;2161;361508;386727;48;748283;8421;404627;413048;0,77113152247644;0,0179628073259073;0,863108519161608;0,881071326487515
"41";"REGIONAL";2021-10-11;2021;41;"ARS Alentejo";"All";706;1609;0;2315;362214;388336;48;750598;7377;406378;413755;0,772637488747915;0,015735854369222;0,86684357148647;0,882579425855692
"42";"REGIONAL";2021-10-18;2021;42;"ARS Alentejo";"All";585;1233;0;1818;362799;389569;48;752416;6593;407749;414342;0,773885350318471;0,0140635065550062;0,869768047064646;0,883831553619652
"43";"REGIONAL";2021-01-04;2021;1;"ARS Algarve";"All";1278;4;0;1282;2352;4;0;2356;2348;5;2353;0,00503106985101445;0,00502251360977123;1,06953015540273e-05;0,00503320891132525
"44";"REGIONAL";2021-01-11;2021;2;"ARS Algarve";"All";1376;6;0;1382;3728;10;0;3738;3717;13;3730;0,00797441683868277;0,00795088717526391;2,7807784040471e-05;0,00797869495930438
"45";"REGIONAL";2021-01-18;2021;3;"ARS Algarve";"All";3415;952;0;4367;7143;962;0;8105;6180;965;7145;0,0152793078000834;0,0132193927207778;0,00206419319992727;0,015283585920705
"46";"REGIONAL";2021-01-25;2021;4;"ARS Algarve";"All";2175;1251;0;3426;9318;2213;0;11531;7104;2216;9320;0,0199317639760853;0,015195884447962;0,00474015764874491;0,0199360420967069
"47";"REGIONAL";2021-02-01;2021;5;"ARS Algarve";"All";1244;1253;0;2497;10562;3466;0;14028;7096;3469;10565;0,0225927550027273;0,0151787719654756;0,00742040021818415;0,0225991721836597
"48";"REGIONAL";2021-02-08;2021;6;"ARS Algarve";"All";2438;2897;0;5335;13000;6363;0;19363;6635;6368;13003;0,027807784040471;0,0141926651621942;0,0136215360592092;0,0278142012214034
"49";"REGIONAL";2021-02-15;2021;7;"ARS Algarve";"All";3234;2125;0;5359;16234;8488;0;24722;7741;8496;16237;0,0347255050856159;0,0165584658659451;0,0181734564006032;0,0347319222665483
"50";"REGIONAL";2021-02-22;2021;8;"ARS Algarve";"All";8526;1073;1;9600;24760;9561;1;34322;15187;9576;24763;0,0529631332955433;0,0324859089402026;0,0204836415362731;0,0529695504764757
"51";"REGIONAL";2021-03-01;2021;9;"ARS Algarve";"All";4679;566;0;5245;29439;10127;1;39567;19293;10150;29443;0,062971796489802;0,0412688905763698;0,0217114621546755;0,0629803527310453
"52";"REGIONAL";2021-03-08;2021;10;"ARS Algarve";"All";5173;1564;0;6737;34612;11691;1;46304;22902;11715;34617;0,0740371554775987;0,0489887592380667;0,025059091541086;0,0740478507791527
"53";"REGIONAL";2021-03-15;2021;11;"ARS Algarve";"All";2752;3026;1;5779;37364;14717;2;52083;22628;14741;37369;0,0799238494529353;0,048402656712906;0,0315318880415833;0,0799345447544894
"54";"REGIONAL";2021-03-22;2021;12;"ARS Algarve";"All";9493;4321;0;13814;46857;19038;2;65897;27795;19067;46862;0,100229948983412;0,0594551813388378;0,0407854629461278;0,100240644284966
"55";"REGIONAL";2021-03-29;2021;13;"ARS Algarve";"All";4261;2943;0;7204;51118;21981;2;73101;29114;22010;51124;0,109344484967754;0,0622766018887903;0,0470807174408282;0,109357319329618
"56";"REGIONAL";2021-04-05;2021;14;"ARS Algarve";"All";8706;1839;0;10545;59824;23820;2;83646;35985;23851;59836;0,127967144033626;0,0769740852843346;0,0510187274730211;0,127992812757356
"57";"REGIONAL";2021-04-12;2021;15;"ARS Algarve";"All";13717;2201;0;15918;73541;26021;2;99564;47502;26052;73554;0,157308634316945;0,101609642883881;0,0557267992171039;0,157336442100985
"58";"REGIONAL";2021-04-19;2021;16;"ARS Algarve";"All";7308;5559;0;12867;80849;31580;2;112431;49248;31615;80863;0,172940887068311;0,105344442186547;0,0676263917261147;0,172970833912662
"59";"REGIONAL";2021-04-26;2021;17;"ARS Algarve";"All";16446;3302;0;19748;97295;34882;2;132179;62382;34933;97315;0,208119872939818;0,133438860308666;0,0747237938373672;0,208162654146034
"60";"REGIONAL";2021-05-03;2021;18;"ARS Algarve";"All";16617;9004;0;25621;113912;43886;2;157800;70535;43950;114485;0,243664638124472;0,150878619022663;0,0940117006599001;0,244890319682563
"61";"REGIONAL";2021-05-10;2021;19;"ARS Algarve";"All";9778;11389;0;21167;123690;55275;2;178967;70890;55346;126236;0,264580369843528;0,151637985432999;0,118388431961839;0,270026417394838
"62";"REGIONAL";2021-05-17;2021;20;"ARS Algarve";"All";12078;10947;2;23027;135768;66222;4;201994;74501;66346;140847;0,290415940277436;0,159362132215318;0,141918095380699;0,301280227596017
"63";"REGIONAL";2021-05-24;2021;21;"ARS Algarve";"All";7671;18868;0;26539;143439;85090;4;228533;69000;85314;154314;0,306824671921625;0,147595161445577;0,182491791356057;0,330086952801634
"64";"REGIONAL";2021-05-31;2021;22;"ARS Algarve";"All";8202;12799;2;21003;151641;97889;6;249536;72802;98209;171011;0,324369244590851;0,155727868747259;0,210074974063894;0,365802842811153
"65";"REGIONAL";2021-06-07;2021;23;"ARS Algarve";"All";17130;6396;0;23526;168771;104285;6;273062;84592;104913;189505;0,361011347714949;0,180947389811656;0,224415234387534;0,405362624199189
"66";"REGIONAL";2021-06-14;2021;24;"ARS Algarve";"All";15436;13501;0;28937;184207;117786;6;301999;86535;118634;205169;0,394029882672542;0,185103583995551;0,253765280912095;0,438868864907646
"67";"REGIONAL";2021-06-21;2021;25;"ARS Algarve";"All";19417;10286;2;29705;203624;128072;8;331704;96557;129404;225961;0,435564016727452;0,206541246430443;0,27680296045947;0,483344206889913
"68";"REGIONAL";2021-06-28;2021;26;"ARS Algarve";"All";17288;16543;7;33838;220912;144615;15;365542;99363;146356;245719;0,472544091380656;0,212543449662563;0,313064310848244;0,525607760510808
"69";"REGIONAL";2021-07-05;2021;27;"ARS Algarve";"All";19250;31891;1;51142;240162;176506;16;416684;87342;178889;266231;0,513721002363662;0,186829805666371;0,382654359939679;0,569484165606049
"70";"REGIONAL";2021-07-12;2021;28;"ARS Algarve";"All";9849;27125;4;36978;250011;203631;20;453662;76071;206537;282608;0,534788607364785;0,162720456903282;0,441795099412828;0,60451555631611
"71";"REGIONAL";2021-07-19;2021;29;"ARS Algarve";"All";4358;27314;0;31672;254369;230945;20;485334;58269;234488;292757;0,544110632199275;0,124640905250324;0,501583974160151;0,626224879410475
"72";"REGIONAL";2021-07-26;2021;30;"ARS Algarve";"All";4023;24830;5;28858;258392;255775;25;514192;41483;259944;301427;0,552716071829645;0,088734638873143;0,556035893432015;0,644770532305158
"73";"REGIONAL";2021-08-02;2021;31;"ARS Algarve";"All";3954;22725;1;26680;262346;278500;26;540872;26052;283330;309382;0,56117391629857;0,0557267992171039;0,606059957860512;0,661786757077616
"74";"REGIONAL";2021-08-09;2021;32;"ARS Algarve";"All";11561;14122;3;25686;273907;292622;29;566558;28254;298385;326639;0,585903592551792;0,0604370100214976;0,638263510839688;0,698700520861186
"75";"REGIONAL";2021-08-16;2021;33;"ARS Algarve";"All";16694;7798;3;24495;290601;300420;32;591053;39497;307355;346852;0,621613065380378;0,0844864650958834;0,657450881827613;0,741937346923497
"76";"REGIONAL";2021-08-23;2021;34;"ARS Algarve";"All";13617;5349;0;18966;304218;305769;32;610019;48282;313832;362114;0,650740649632616;0,103278109926309;0,6713055754607;0,77458368538701
"77";"REGIONAL";2021-08-30;2021;35;"ARS Algarve";"All";6505;12199;4;18708;310723;317968;36;628727;42660;327157;369817;0,664655236954406;0,0912523128589611;0,699808554102183;0,791060866961144
"78";"REGIONAL";2021-09-06;2021;36;"ARS Algarve";"All";3335;15778;1;19114;314058;333746;37;647841;30438;343378;373816;0,671789003090942;0,0651087177402967;0,734506251403758;0,799614969144055
"79";"REGIONAL";2021-09-13;2021;37;"ARS Algarve";"All";2286;12114;4;14404;316344;345860;41;662245;21353;355794;377147;0,676678894961443;0,0456753548166291;0,761064824222719;0,806740179039348
"80";"REGIONAL";2021-09-20;2021;38;"ARS Algarve";"All";1879;6674;6;8559;318223;352534;47;670804;17094;362723;379817;0,680698189285447;0,0365650969529086;0,77588637311629;0,812451470069199
"81";"REGIONAL";2021-09-27;2021;39;"ARS Algarve";"All";1160;3897;4;5061;319383;356431;51;675865;14539;366894;381433;0,683179499245981;0,0310997978588006;0,78480839367266;0,81590819153146
"82";"REGIONAL";2021-10-04;2021;40;"ARS Algarve";"All";761;3036;1;3798;320144;359467;52;679663;12331;370050;382381;0,684807324142504;0,0263767526925422;0,791559268013562;0,817936020706104
"83";"REGIONAL";2021-10-11;2021;41;"ARS Algarve";"All";1080;1938;0;3018;321224;361405;52;682681;11282;372213;383495;0,687117509278174;0,0241328784265072;0,796186055465834;0,820318933892341
"84";"REGIONAL";2021-10-18;2021;42;"ARS Algarve";"All";754;1614;0;2368;321978;363019;52;685049;10324;373993;384317;0,688730360752521;0,0220836586487556;0,799993582819068;0,822077241467823
"85";"REGIONAL";2021-01-04;2021;1;"ARS Centro";"All";9064;20;0;9084;15694;22;0;15716;15673;23;15696;0,00945478643291765;0,00944213506837761;1,3856256400988e-05;0,0094559913247786
"86";"REGIONAL";2021-01-11;2021;2;"ARS Centro";"All";12752;25;1;12778;28446;47;1;28494;28389;59;28448;0,0171371769383698;0,0171028375203326;3,55443098981866e-05;0,0171383818302307
"87";"REGIONAL";2021-01-18;2021;3;"ARS Centro";"All";36921;6274;1;43196;65367;6321;2;71690;59009;6361;65370;0,0393800831375384;0,0355497319115609;0,0038321585637689;0,0393818904753298
"88";"REGIONAL";2021-01-25;2021;4;"ARS Centro";"All";4899;8527;3;13429;70266;14848;5;85119;55377;14892;70269;0,0423314657509489;0,0333616482920658;0,0089716247966745;0,0423332730887403
"89";"REGIONAL";2021-02-01;2021;5;"ARS Centro";"All";2767;9197;0;11964;73033;24045;5;97083;48944;24093;73037;0,0439984336405808;0,0294861136213025;0,0145147298030002;0,0440008434243027
"90";"REGIONAL";2021-02-08;2021;6;"ARS Centro";"All";7591;27219;3;34813;80624;51264;8;131896;29286;51342;80628;0,0485716006988373;0,0176432315199711;0,0309307789625881;0,0485740104825592
"91";"REGIONAL";2021-02-15;2021;7;"ARS Centro";"All";25599;10040;3;35642;106223;61304;11;167538;44748;61479;106227;0,0639936140731369;0,0269582504970179;0,037037773359841;0,0639960238568588
"92";"REGIONAL";2021-02-22;2021;8;"ARS Centro";"All";38489;3178;1;41668;144712;64482;12;209206;80020;64696;144716;0,0871811554912947;0,0482077233568287;0,0389758419181878;0,0871835652750166
"93";"REGIONAL";2021-03-01;2021;9;"ARS Centro";"All";28615;5987;0;34602;173327;70469;12;243808;102628;70713;173341;0,104420145791915;0,0618278209530695;0,0426007590818724;0,104428580034942
"94";"REGIONAL";2021-03-08;2021;10;"ARS Centro";"All";17809;13617;0;31426;191136;84086;12;275234;106797;84369;191166;0,115149105367793;0,0643394180372312;0,0508277607084764;0,115167178745708
"95";"REGIONAL";2021-03-15;2021;11;"ARS Centro";"All";16784;24309;1;41094;207920;108395;13;316328;99273;108690;207963;0,125260557864932;0,0598066148563166;0,0654798481836255;0,125286463039942
"96";"REGIONAL";2021-03-22;2021;12;"ARS Centro";"All";47992;4471;1;52464;255912;112866;14;368792;142678;113287;255965;0,154173142960419;0,0859557804687029;0,0682492921260317;0,154205072594735
"97";"REGIONAL";2021-03-29;2021;13;"ARS Centro";"All";24512;16918;1;41431;280424;129784;15;410223;150256;130239;280495;0,16894029760829;0,0905211157298632;0,0784619555394903;0,168983071269354
"98";"REGIONAL";2021-04-05;2021;14;"ARS Centro";"All";50020;10345;1;60366;330444;140129;16;470589;189864;140670;330534;0,199074643050786;0,114382794144226;0,0847460690403036;0,199128863184529
"99";"REGIONAL";2021-04-12;2021;15;"ARS Centro";"All";77822;12140;0;89962;408266;152269;16;560551;255368;152996;408364;0,245958190252425;0,153845412374239;0,0921718175793722;0,246017229953612
"100";"REGIONAL";2021-04-19;2021;16;"ARS Centro";"All";30185;24322;0;54507;438451;176591;16;615058;261084;177468;438552;0,264143020663895;0,15728899331285;0,106914874390023;0,264203867702874
"101";"REGIONAL";2021-04-26;2021;17;"ARS Centro";"All";56818;18030;0;74848;495269;194621;16;689906;300964;195681;496645;0,29837279354178;0,181314537020302;0,117887222121815;0,299201759142117
"102";"REGIONAL";2021-05-03;2021;18;"ARS Centro";"All";60183;49327;0;109510;555452;243948;16;799416;317428;245249;562677;0,334629796975721;0,191233206819688;0,147749262003735;0,338982468823423
"103";"REGIONAL";2021-05-10;2021;19;"ARS Centro";"All";50856;55899;1;106756;606308;299847;17;906172;318239;301337;619576;0,365267787216097;0,191721790469305;0,181539249352371;0,373261039821676
"104";"REGIONAL";2021-05-17;2021;20;"ARS Centro";"All";45064;41908;5;86977;651372;341755;22;993149;328382;344042;672424;0,392416410627146;0,197832399542141;0,207266702813422;0,405099102355564
"105";"REGIONAL";2021-05-24;2021;21;"ARS Centro";"All";24371;56467;5;80843;675743;398222;27;1073992;303608;401539;705147;0,407098620398819;0,182907404060486;0,241905536478101;0,424812940538587
"106";"REGIONAL";2021-05-31;2021;22;"ARS Centro";"All";44467;37957;0;82424;720210;436179;27;1156416;309542;442451;751993;0,433887583589373;0,18648231821194;0,266552804385806;0,453035122597747
"107";"REGIONAL";2021-06-07;2021;23;"ARS Centro";"All";58538;41051;1;99590;778748;477230;28;1256006;326250;486060;812310;0,469153563467679;0,196547984818363;0,29282486896801;0,489372853786373
"108";"REGIONAL";2021-06-14;2021;24;"ARS Centro";"All";52179;66007;8;118194;830927;543237;36;1374200;315855;554542;870397;0,500588589674077;0,190285559371046;0,334081571178987;0,524367130550033
"109";"REGIONAL";2021-06-21;2021;25;"ARS Centro";"All";59774;47945;3;107722;890701;591182;39;1481922;330420;606104;936524;0,536599192722453;0,199060184348455;0,36514488824628;0,564205072594735
"110";"REGIONAL";2021-06-28;2021;26;"ARS Centro";"All";50067;77445;2;127514;940768;668627;41;1609436;301891;686954;988845;0,566761853123682;0,181873004397855;0,413852641725405;0,59572564612326
"111";"REGIONAL";2021-07-05;2021;27;"ARS Centro";"All";59664;105248;9;164921;1000432;773875;50;1774357;259916;796663;1056579;0,602706187119706;0,156585336466052;0,479946382312188;0,63653171877824
"112";"REGIONAL";2021-07-12;2021;28;"ARS Centro";"All";28625;82389;6;111020;1029057;856264;56;1885377;216232;883382;1099614;0,619951201879631;0,130268088439063;0,532189890957287;0,662457979396349
"113";"REGIONAL";2021-07-19;2021;29;"ARS Centro";"All";16945;80942;17;97904;1046002;937206;73;1983281;163314;968830;1132144;0,630159648171577;0,0983878546900416;0,583667690824748;0,68205554551479
"114";"REGIONAL";2021-07-26;2021;30;"ARS Centro";"All";14458;69199;7;83664;1060460;1006405;80;2066945;116471;1043240;1159711;0,638869811434424;0,0701674799686728;0,628495692511597;0,69866317248027
"115";"REGIONAL";2021-08-02;2021;31;"ARS Centro";"All";19332;75394;6;94732;1079792;1081799;86;2161677;74722;1123499;1198221;0,650516296162419;0,0450159648171577;0,67684740044581;0,721863365262968
"116";"REGIONAL";2021-08-09;2021;32;"ARS Centro";"All";50702;47159;7;97868;1130494;1128958;93;2259545;93074;1179406;1272480;0,681061509729502;0,0560720525332851;0,710528345081029;0,766600397614314
"117";"REGIONAL";2021-08-16;2021;33;"ARS Centro";"All";61456;36156;7;97619;1191950;1165114;100;2357164;131544;1223335;1354879;0,718085426832942;0,0792481474787638;0,736993192360986;0,816241339839749
"118";"REGIONAL";2021-08-23;2021;34;"ARS Centro";"All";51305;18489;4;69798;1243255;1183603;104;2426962;163992;1247945;1411937;0,748993915296102;0,0987963130309055;0,751819386710043;0,850615699740948
"119";"REGIONAL";2021-08-30;2021;35;"ARS Centro";"All";20800;48362;3;69165;1264055;1231965;107;2496127;133484;1300848;1434332;0,761524790650039;0,0804168925838906;0,783690583770107;0,864107476353997
"120";"REGIONAL";2021-09-06;2021;36;"ARS Centro";"All";7892;51098;11;59001;1271947;1283063;118;2555128;89320;1353396;1442716;0,766279293933369;0,0538104705102717;0,815347912524851;0,869158383035123
"121";"REGIONAL";2021-09-13;2021;37;"ARS Centro";"All";5951;42697;7;48655;1277898;1325760;125;2603783;51724;1397165;1448889;0,769864449665642;0,0311609133080306;0,841716368455931;0,872877281763962
"122";"REGIONAL";2021-09-20;2021;38;"ARS Centro";"All";4073;18721;6;22800;1281971;1344481;131;2626583;36471;1416569;1453040;0,772318211940478;0,0219718055304536;0,853406229290921;0,875378034821375
"123";"REGIONAL";2021-09-27;2021;39;"ARS Centro";"All";2907;9811;3;12721;1284878;1354292;134;2639304;29013;1427074;1456087;0,774069522260377;0,0174787637809507;0,85973492379059;0,877213687571541
"124";"REGIONAL";2021-10-04;2021;40;"ARS Centro";"All";1553;5503;13;7069;1286431;1359795;147;2646373;24889;1432887;1457776;0,775005120790409;0,0149942767636605;0,863236941984457;0,878231218748117
"125";"REGIONAL";2021-10-11;2021;41;"ARS Centro";"All";2144;4704;0;6848;1288575;1364499;147;2653221;21897;1438038;1459935;0,776296764865353;0,0131917585396711;0,866340140972348;0,879531899512019
"126";"REGIONAL";2021-10-18;2021;42;"ARS Centro";"All";1741;3741;0;5482;1290316;1368240;147;2658703;19493;1442185;1461678;0,777345623230315;0,0117434785228026;0,868838484246039;0,880581962768841
"127";"REGIONAL";2021-01-04;2021;1;"ARS Lisboa e Vale do Tejo";"All";12863;30;0;12893;23710;35;0;23745;23678;35;23713;0,0064401679604496;0,0064314760424937;9,50678526426554e-06;0,00644098282775797
"128";"REGIONAL";2021-01-11;2021;2;"ARS Lisboa e Vale do Tejo";"All";13346;1127;0;14473;37056;1162;0;38218;35883;1176;37059;0,0100652409929321;0,00974662787536116;0,000319427984879322;0,0100660558602405
"129";"REGIONAL";2021-01-18;2021;3;"ARS Lisboa e Vale do Tejo";"All";38050;9111;0;47161;75106;10273;0;85379;64699;10411;75110;0,0204004746873694;0,017573699994649;0,00282786118246482;0,0204015611771139
"130";"REGIONAL";2021-01-25;2021;4;"ARS Lisboa e Vale do Tejo";"All";17418;11967;0;29385;92524;22240;0;114764;70087;22442;92529;0,0251315942797401;0,0190372016804737;0,00609575071144707;0,0251329523919208
"131";"REGIONAL";2021-02-01;2021;5;"ARS Lisboa e Vale do Tejo";"All";8836;8953;0;17789;101360;31193;0;132553;69955;31413;101368;0,027531650125313;0,0190013475189056;0,00853247558589638;0,027533823104802
"132";"REGIONAL";2021-02-08;2021;6;"ARS Lisboa e Vale do Tejo";"All";14472;30559;0;45031;115832;61752;0;177584;53678;62163;115841;0,0314625700208688;0,0145801491261499;0,016884865496644;0,0314650146227939
"133";"REGIONAL";2021-02-15;2021;7;"ARS Lisboa e Vale do Tejo";"All";33098;19133;0;52231;148930;80885;0;229815;67490;81450;148940;0,0404527294116305;0,0183317982138652;0,0221236474221265;0,0404554456359917
"134";"REGIONAL";2021-02-22;2021;8;"ARS Lisboa e Vale do Tejo";"All";49499;6723;0;56222;198429;87608;0;286037;109951;88488;198439;0,0538977683772271;0,029865158474036;0,0240353261275523;0,0539004846015883
"135";"REGIONAL";2021-03-01;2021;9;"ARS Lisboa e Vale do Tejo";"All";45323;12904;0;58227;243752;100512;0;344264;142150;101622;243772;0,0662085120495787;0,0386111292947242;0,0276028152035769;0,0662139444983011
"136";"REGIONAL";2021-03-08;2021;10;"ARS Lisboa e Vale do Tejo";"All";34147;16638;2;50787;277899;117150;2;395051;159574;118360;277934;0,0754836033758323;0,0433438786217117;0,0321492315393848;0,0754931101610966
"137";"REGIONAL";2021-03-15;2021;11;"ARS Lisboa e Vale do Tejo";"All";26422;29139;1;55562;304321;146289;3;450613;156796;147571;304367;0,0826604113830444;0,0425893114941651;0,0400835945209409;0,082672906015106
"138";"REGIONAL";2021-03-22;2021;12;"ARS Lisboa e Vale do Tejo";"All";89666;7791;0;97457;393987;154080;3;548070;238416;155631;394047;0,107015708740348;0,0647591347304324;0,0422728713560832;0,107032006086516
"139";"REGIONAL";2021-03-29;2021;13;"ARS Lisboa e Vale do Tejo";"All";45810;24101;1;69912;439797;178181;4;617982;260057;179817;439874;0,119458732539091;0,0706373158705458;0,0488423315961268;0,119479647466673
"140";"REGIONAL";2021-04-05;2021;14;"ARS Lisboa e Vale do Tejo";"All";87589;19870;1;107460;527386;198051;5;725442;327651;199874;527525;0,14324987009657;0,0889973628177677;0,0542902627974232;0,143287625615191
"141";"REGIONAL";2021-04-12;2021;15;"ARS Lisboa e Vale do Tejo";"All";163789;14543;0;178332;691175;212594;5;903774;476775;214558;691333;0,187738637286535;0,129502786982006;0,0582787666494368;0,187781553631443
"142";"REGIONAL";2021-04-19;2021;16;"ARS Lisboa e Vale do Tejo";"All";79401;53935;2;133338;770576;266529;7;1037112;501983;268754;770737;0,209305730337048;0,136349845351766;0,0729996161974978;0,209349461549264
"143";"REGIONAL";2021-04-26;2021;17;"ARS Lisboa e Vale do Tejo";"All";107825;25753;1;133579;878401;292282;8;1170691;583944;294652;878596;0,238593419511889;0,158612291838751;0,080034094048182;0,238646385886933
"144";"REGIONAL";2021-05-03;2021;18;"ARS Lisboa e Vale do Tejo";"All";107958;65826;3;173787;986359;358108;11;1344478;628624;360640;989264;0,267917234470734;0,170748382284676;0,0979579153629921;0,268706297647668
"145";"REGIONAL";2021-05-10;2021;19;"ARS Lisboa e Vale do Tejo";"All";90629;113535;1;204165;1076988;471643;12;1548643;608013;474475;1082488;0,292534104234023;0,165149972253768;0,128878055378926;0,294028027632694
"146";"REGIONAL";2021-05-17;2021;20;"ARS Lisboa e Vale do Tejo";"All";110196;71487;3;181686;1187184;543130;15;1730329;648351;546962;1195313;0,322465810204909;0,176106678082052;0,148567150906092;0,324673828988144
"147";"REGIONAL";2021-05-24;2021;21;"ARS Lisboa e Vale do Tejo";"All";110976;89160;2;200138;1298160;632290;17;1930467;675210;644154;1319364;0,35260938167597;0,18340218509385;0,174966678717649;0,358368863811498
"148";"REGIONAL";2021-05-31;2021;22;"ARS Lisboa e Vale do Tejo";"All";92476;87297;4;179777;1390636;719587;21;2110244;696248;736375;1432623;0,377727938078776;0,189116577904982;0,200015971399244;0,389132549304226
"149";"REGIONAL";2021-06-07;2021;23;"ARS Lisboa e Vale do Tejo";"All";152482;54402;2;206886;1543118;773989;23;2317130;802364;797360;1599724;0,419145470383512;0,21794006433649;0,216580865666136;0,434520930002627
"150";"REGIONAL";2021-06-14;2021;24;"ARS Lisboa e Vale do Tejo";"All";148017;121727;4;269748;1691135;895716;27;2586878;831255;925734;1756989;0,459350208510963;0,225787508138487;0,251450124280846;0,477237632419333
"151";"REGIONAL";2021-06-21;2021;25;"ARS Lisboa e Vale do Tejo";"All";120490;154167;11;274668;1811625;1049883;38;2861546;804379;1087776;1892155;0,492077995839288;0,218487383545276;0,295464367074906;0,513951750620182
"152";"REGIONAL";2021-06-28;2021;26;"ARS Lisboa e Vale do Tejo";"All";130871;167124;8;298003;1942496;1217007;46;3159549;769545;1264649;2034194;0,527625495676993;0,209025687605406;0,34350704221909;0,552532729824497
"153";"REGIONAL";2021-07-05;2021;27;"ARS Lisboa e Vale do Tejo";"All";144216;274213;2;418431;2086712;1491220;48;3577980;640120;1550081;2190201;0,566797796924745;0,173870953810333;0,421036777406228;0,594907731216562
"154";"REGIONAL";2021-07-12;2021;28;"ARS Lisboa e Vale do Tejo";"All";80346;216502;22;296870;2167058;1707722;70;3874850;532846;1776528;2309374;0,588621573177393;0,144732928597795;0,482544863198718;0,627277791796514
"155";"REGIONAL";2021-07-19;2021;29;"ARS Lisboa e Vale do Tejo";"All";57315;186201;8;243524;2224373;1893923;78;4118374;444011;1973987;2417998;0,604189613103718;0,120603349484909;0,536179157812907;0,656782507297816
"156";"REGIONAL";2021-07-26;2021;30;"ARS Lisboa e Vale do Tejo";"All";36780;181165;12;217957;2261153;2075088;90;4336331;325931;2167113;2493044;0,614179886304281;0,0885301722276381;0,58863651241138;0,677166684639018
"157";"REGIONAL";2021-08-02;2021;31;"ARS Lisboa e Vale do Tejo";"All";45760;178858;13;224631;2306913;2253946;103;4560962;221613;2360696;2582309;0,626609328981218;0,0601950629362766;0,64121799846316;0,701413061399437
"158";"REGIONAL";2021-08-09;2021;32;"ARS Lisboa e Vale do Tejo";"All";107919;111856;7;219782;2414832;2365802;110;4780744;239991;2493868;2733859;0,655922550665054;0,0651869400673243;0,677390501526382;0,742577441593707
"159";"REGIONAL";2021-08-16;2021;33;"ARS Lisboa e Vale do Tejo";"All";107700;91472;10;199182;2522532;2457274;120;4979926;280552;2601408;2881960;0,68517628703538;0,0762042176988636;0,706600778306928;0,782804996005792
"160";"REGIONAL";2021-08-23;2021;34;"ARS Lisboa e Vale do Tejo";"All";89409;61291;8;150708;2611941;2518565;128;5130634;321145;2677395;2998540;0,7094617774266;0,0872301872483588;0,727240552360521;0,81447073960888
"161";"REGIONAL";2021-08-30;2021;35;"ARS Lisboa e Vale do Tejo";"All";49092;101188;20;150300;2661033;2619753;148;5280934;264082;2792033;3056115;0,722796266060695;0,0717305961759364;0,75837880519266;0,830109401368597
"162";"REGIONAL";2021-09-06;2021;36;"ARS Lisboa e Vale do Tejo";"All";27993;91960;54;120007;2689026;2711713;202;5400941;195224;2889328;3084552;0,730399792915055;0,0530272184694565;0,784806310115138;0,837833528584594
"163";"REGIONAL";2021-09-13;2021;37;"ARS Lisboa e Vale do Tejo";"All";20070;81875;81;102026;2709096;2793588;283;5502967;129762;2975085;3104847;0,735851255208021;0,0352462705560464;0,808099835369641;0,843346105925688
"164";"REGIONAL";2021-09-20;2021;38;"ARS Lisboa e Vale do Tejo";"All";15250;31850;102;47202;2724346;2825438;385;5550169;108683;3011569;3120252;0,739993497358879;0,0295207412250335;0,818009708329112;0,847530449554145
"165";"REGIONAL";2021-09-27;2021;39;"ARS Lisboa e Vale do Tejo";"All";9334;20487;64;29885;2733680;2845925;449;5580054;94300;3035673;3129973;0,742528821177641;0,0256139957262926;0,824556895529393;0,850170891255686
"166";"REGIONAL";2021-10-04;2021;40;"ARS Lisboa e Vale do Tejo";"All";4501;17823;50;22374;2738181;2863748;499;5602428;80945;3054718;3135663;0,743751393762625;0,021986478091885;0,829729944825335;0,851716422917219
"167";"REGIONAL";2021-10-11;2021;41;"ARS Lisboa e Vale do Tejo";"All";6833;14707;0;21540;2745014;2878455;499;5623968;71299;3071205;3142504;0,745607389868646;0,0193664080730534;0,834208183929676;0,853574592002729
"168";"REGIONAL";2021-10-18;2021;42;"ARS Lisboa e Vale do Tejo";"All";5204;12043;0;17247;2750218;2890498;499;5641215;62999;3084715;3147714;0,747020913026224;0,0171119418532419;0,837877803041682;0,854989744894924
"169";"REGIONAL";2021-01-04;2021;1;"ARS Norte";"All";16841;44;0;16885;30292;51;0;30343;30244;55;30299;0,00845579091317908;0,00844239206319121;1,53528489444358e-05;0,00845774491213565
"170";"REGIONAL";2021-01-11;2021;2;"ARS Norte";"All";15496;41;0;15537;45788;92;0;45880;45674;121;45795;0,0127813863175968;0,0127495640488757;3,37762676777588e-05;0,0127833403165534
"171";"REGIONAL";2021-01-18;2021;3;"ARS Norte";"All";32465;12756;1;45222;78253;12848;1;91102;65341;12919;78260;0,0218437543354352;0,0182394636886978;0,00360624464569393;0,0218457083343917
"172";"REGIONAL";2021-01-25;2021;4;"ARS Norte";"All";14465;15775;1;30241;92718;28623;2;121343;64022;28704;92726;0,0258815536078218;0,0178712744567394;0,00801251229274701;0,0258837867494864
"173";"REGIONAL";2021-02-01;2021;5;"ARS Norte";"All";5739;12304;1;18044;98457;40927;3;139387;57458;41012;98470;0,0274835536094967;0,016038981720898;0,0114482007438037;0,0274871824647017
"174";"REGIONAL";2021-02-08;2021;6;"ARS Norte";"All";9002;28918;4;37924;107459;69845;7;177311;37467;70005;107472;0,0299963962676387;0,0104586398436578;0,019541385279186;0,0300000251228437
"175";"REGIONAL";2021-02-15;2021;7;"ARS Norte";"All";33143;15239;2;48384;140602;85084;9;225695;55031;85584;140615;0,0392480230415557;0,0153615023683863;0,0238901495283744;0,0392516518967607
"176";"REGIONAL";2021-02-22;2021;8;"ARS Norte";"All";64974;4385;0;69359;205576;89469;9;295054;115360;90229;205589;0,0573850413563879;0,0322019028041839;0,0251867674074091;0,057388670211593
"177";"REGIONAL";2021-03-01;2021;9;"ARS Norte";"All";48235;7168;4;55407;253811;96637;13;350461;156343;97491;253834;0,0708494898806581;0,0436420084094532;0,0272139017534907;0,070855910162944
"178";"REGIONAL";2021-03-08;2021;10;"ARS Norte";"All";25913;14279;0;40192;279724;110916;13;390653;167869;111898;279767;0,078082914875152;0,0468594072627908;0,0312355107488087;0,0780949180115995
"179";"REGIONAL";2021-03-15;2021;11;"ARS Norte";"All";27152;42542;1;69695;306876;153458;14;460348;152455;154476;306931;0,0856621976849579;0,0425567015604357;0,0431208489734667;0,0856775505339023
"180";"REGIONAL";2021-03-22;2021;12;"ARS Norte";"All";89325;2570;0;91895;396201;156028;14;552243;239112;157149;396261;0,110596620084262;0,0667463712145806;0,0438669974321662;0,110613368646747
"181";"REGIONAL";2021-03-29;2021;13;"ARS Norte";"All";54348;32931;1;87280;450549;188959;15;639523;260497;190143;450640;0,125767467983029;0,0727158380268853;0,0530770319425792;0,125792869969465
"182";"REGIONAL";2021-04-05;2021;14;"ARS Norte";"All";82695;13891;0;96586;533244;202850;15;736109;329273;204112;533385;0,148851174227759;0,0919141569178402;0,0569763764317578;0,148890533349598
"183";"REGIONAL";2021-04-12;2021;15;"ARS Norte";"All";136215;19373;0;155588;669459;222223;15;891697;446003;223607;669610;0,186874598208965;0,124498485232095;0,0624182635257901;0,186916748757885
"184";"REGIONAL";2021-04-19;2021;16;"ARS Norte";"All";65520;46664;2;112186;734979;268887;17;1003883;464444;270688;735132;0,205164028442409;0,12964615591181;0,0755605813649353;0,205206737276745
"185";"REGIONAL";2021-04-26;2021;17;"ARS Norte";"All";127105;36959;1;164065;862084;305846;18;1167948;554416;307852;862268;0,240644462353;0,154761183643242;0,0859346409680446;0,240695824611287
"186";"REGIONAL";2021-05-03;2021;18;"ARS Norte";"All";156010;73660;1;229671;1018094;379506;19;1397619;636483;382022;1018505;0,284193516240662;0,177669588267297;0,106638655626386;0,284308243893683
"187";"REGIONAL";2021-05-10;2021;19;"ARS Norte";"All";100307;101413;8;201728;1118401;480919;27;1599347;641009;484567;1125576;0,312193483860108;0,17893298816407;0,135263344626517;0,314196332790587
"188";"REGIONAL";2021-05-17;2021;20;"ARS Norte";"All";111303;71517;5;182825;1229704;552436;32;1782172;679184;565356;1244540;0,343262904697609;0,189589261045049;0,157815004869645;0,347404265914693
"189";"REGIONAL";2021-05-24;2021;21;"ARS Norte";"All";73425;129655;10;203090;1303129;682091;42;1985262;629865;708283;1338148;0,363758958038431;0,175822221825219;0,197712034707488;0,373534256532707
"190";"REGIONAL";2021-05-31;2021;22;"ARS Norte";"All";55445;173117;9;228571;1358574;855208;51;2213833;530133;887769;1417902;0,379236025487962;0,14798276126292;0,247814242810051;0,395797004072971
"191";"REGIONAL";2021-06-07;2021;23;"ARS Norte";"All";107410;107072;11;214493;1465984;962280;62;2428326;527953;1005069;1533022;0,409218743762905;0,147374230159304;0,280557682467912;0,427931912627216
"192";"REGIONAL";2021-06-14;2021;24;"ARS Norte";"All";105533;153116;11;258660;1571517;1115396;73;2686986;485855;1168356;1654211;0,43867751117478;0,135622880434525;0,326138057842277;0,461760938276802
"193";"REGIONAL";2021-06-21;2021;25;"ARS Norte";"All";146577;105711;5;252293;1718094;1221107;78;2939279;529485;1287733;1817218;0,479593411897118;0,147801876788084;0,359461276904821;0,507263153692905
"194";"REGIONAL";2021-06-28;2021;26;"ARS Norte";"All";163781;117735;8;281524;1881875;1338842;86;3220803;566081;1421184;1987265;0,525311683769275;0,158017383333003;0,396713150440892;0,554730533773895
"195";"REGIONAL";2021-07-05;2021;27;"ARS Norte";"All";176129;159198;13;335340;2058004;1498040;99;3556143;578754;1598946;2177700;0,574476809800812;0,161554958872509;0,446334116514725;0,607889075387234
"196";"REGIONAL";2021-07-12;2021;28;"ARS Norte";"All";105431;157419;23;262873;2163435;1655459;122;3819016;559361;1773091;2332452;0,603907104656463;0,156141544334701;0,49494542341343;0,651086967748131
"197";"REGIONAL";2021-07-19;2021;29;"ARS Norte";"All";51914;190066;12;241992;2215349;1845525;134;4061008;459543;1976537;2436080;0,618398519203762;0,128278077499507;0,551735890801606;0,680013968301112
"198";"REGIONAL";2021-07-26;2021;30;"ARS Norte";"All";35368;185555;19;220942;2250717;2031080;153;4281950;333214;2173668;2506882;0,628271238503159;0,0930142583303861;0,606763571988253;0,699777830318639
"199";"REGIONAL";2021-08-02;2021;31;"ARS Norte";"All";42087;190227;9;232323;2292804;2221307;162;4514273;211486;2375831;2587317;0,640019517658149;0,0590347747611446;0,663195899281961;0,722230674043106
"200";"REGIONAL";2021-08-09;2021;32;"ARS Norte";"All";119263;148038;9;267310;2412067;2369345;171;4781583;223887;2541753;2765640;0,673310914451972;0,0624964234840527;0,709511815692119;0,772008239176172
"201";"REGIONAL";2021-08-16;2021;33;"ARS Norte";"All";148970;81219;10;230199;2561037;2450564;181;5011782;310046;2642695;2952741;0,714894803674746;0,0865470800695735;0,737689038931196;0,82423611900077
"202";"REGIONAL";2021-08-23;2021;34;"ARS Norte";"All";119160;34011;10;153181;2680197;2484575;191;5164963;382487;2692563;3075050;0,748157448769637;0,106768456985644;0,751609327497762;0,858377784483406
"203";"REGIONAL";2021-08-30;2021;35;"ARS Norte";"All";44781;111408;12;156201;2724978;2595983;203;5321164;306800;2814529;3121329;0,760657738380196;0,0856409828391437;0,785655247031527;0,87129622987067
"204";"REGIONAL";2021-09-06;2021;36;"ARS Norte";"All";22041;129148;20;151209;2747019;2725131;223;5472373;195932;2948520;3144452;0,766810322809002;0,0546929890796581;0,823057857629961;0,877750846709619
"205";"REGIONAL";2021-09-13;2021;37;"ARS Norte";"All";14772;97183;17;111972;2761791;2822314;240;5584345;111767;3048307;3160074;0,770933818892769;0,0311989430540501;0,850912671041205;0,882111614095255
"206";"REGIONAL";2021-09-20;2021;38;"ARS Norte";"All";10354;37119;7;47480;2772145;2859433;247;5631825;83388;3087449;3170837;0,773824062492236;0,0232771521414293;0,861838874920898;0,885116027062327
"207";"REGIONAL";2021-09-27;2021;39;"ARS Norte";"All";6793;18858;13;25664;2778938;2878291;260;5657489;69731;3108144;3177875;0,775720278908228;0,0194649001771719;0,867615733264627;0,887080633441799
"208";"REGIONAL";2021-10-04;2021;40;"ARS Norte";"All";4875;14790;22;19687;2783813;2893081;282;5677176;59036;3124073;3183109;0,777081099610121;0,0164794689142493;0,872062197461644;0,888541666375893
"209";"REGIONAL";2021-10-11;2021;41;"ARS Norte";"All";5779;12526;0;18305;2789592;2905607;282;5695481;50886;3138021;3188907;0,778694265320119;0,014204455843392;0,875955679953953;0,890160135797345
"210";"REGIONAL";2021-10-18;2021;42;"ARS Norte";"All";4121;9784;0;13905;2793713;2915391;282;5709386;43933;3149105;3193038;0,77984461242012;0,0122635765941072;0,879049697730319;0,891313274324426
"211";"REGIONAL";2021-01-04;2021;1;"RA Madeira";"All";1835;4;0;1839;2541;5;0;2546;2536;5;2541;0,0101210865928463;0,0101011710348124;1,99155580339361e-05;0,0101210865928463
"212";"REGIONAL";2021-01-11;2021;2;"RA Madeira";"All";1801;4;0;1805;4342;9;0;4351;4331;11;4342;0,0172946705966701;0,0172508563689955;4,38142276746594e-05;0,0172946705966701
"213";"REGIONAL";2021-01-18;2021;3;"RA Madeira";"All";1170;596;1;1767;5512;605;1;6118;4905;607;5512;0,0219549111766112;0,0195371624312913;0,00241774874531984;0,0219549111766112
"214";"REGIONAL";2021-01-25;2021;4;"RA Madeira";"All";486;1722;4;2212;5998;2327;5;8330;3669;2329;5998;0,0238907034175098;0,0146140364853023;0,00927666693220744;0,0238907034175098
"215";"REGIONAL";2021-02-01;2021;5;"RA Madeira";"All";2264;1544;0;3808;8262;3871;5;12138;4389;3873;8262;0,032908468095276;0,0174818768421891;0,0154265912530869;0,032908468095276
"216";"REGIONAL";2021-02-08;2021;6;"RA Madeira";"All";3188;1160;1;4349;11450;5031;6;16487;6417;5033;11450;0,0456066278977137;0,0255596271807536;0,0200470007169601;0,0456066278977137
"217";"REGIONAL";2021-02-15;2021;7;"RA Madeira";"All";2595;707;2;3304;14045;5738;8;19791;8304;5741;14045;0,0559428025173265;0,0330757587827611;0,0228670437345654;0,0559428025173265
"218";"REGIONAL";2021-02-22;2021;8;"RA Madeira";"All";2279;2164;1;4444;16324;7902;9;24235;8419;7905;16324;0,0650203138691946;0,0335338166175416;0,031486497251653;0,0650203138691946
"219";"REGIONAL";2021-03-01;2021;9;"RA Madeira";"All";1465;3135;1;4601;17789;11037;10;28836;6749;11040;17789;0,0708555723731379;0,026882020234207;0,0439735521389309;0,0708555723731379
"220";"REGIONAL";2021-03-08;2021;10;"RA Madeira";"All";5006;2397;0;7403;22795;13434;10;36239;9358;13437;22795;0,0907950290767147;0,0372739584163148;0,0535210706603999;0,0907950290767147
"221";"REGIONAL";2021-03-15;2021;11;"RA Madeira";"All";3149;2329;1;5479;25944;15763;11;41718;10177;15767;25944;0,103337847526488;0,0405361268222736;0,0628017207042141;0,103337847526488
"222";"REGIONAL";2021-03-22;2021;12;"RA Madeira";"All";5595;202;0;5797;31539;15965;11;47515;15571;15969;31540;0,125623356966462;0,0620210308292838;0,0636063092487851;0,125627340078069
"223";"REGIONAL";2021-03-29;2021;13;"RA Madeira";"All";1237;1273;0;2510;32776;17238;11;50025;15536;17243;32779;0,130550466024058;0,0618816219230463;0,0686807934358321;0,130562415358878
"224";"REGIONAL";2021-04-05;2021;14;"RA Madeira";"All";10218;1308;0;11526;42994;18546;11;61551;24445;18552;42997;0,17124990042221;0,0973671632279137;0,0738946865291165;0,17126184975703
"225";"REGIONAL";2021-04-12;2021;15;"RA Madeira";"All";8536;1325;0;9861;51530;19871;11;71412;31651;19883;51534;0,205249741097746;0,126069465466422;0,0791962080777503;0,205265673544173
"226";"REGIONAL";2021-04-19;2021;16;"RA Madeira";"All";9844;2151;1;11996;61374;22022;12;83408;39276;22103;61379;0,244459491754959;0,156440691468175;0,088038715844818;0,244479407312993
"227";"REGIONAL";2021-04-26;2021;17;"RA Madeira";"All";8823;839;1;9663;70197;22861;13;93071;47266;22954;70220;0,279602485461643;0,188265753206405;0,0914283438221939;0,279694097028599
"228";"REGIONAL";2021-05-03;2021;18;"RA Madeira";"All";7660;5359;0;13019;77857;28220;13;106090;49568;28333;77901;0,310113120369633;0,197434876125229;0,112853501155102;0,310288377280331
"229";"REGIONAL";2021-05-10;2021;19;"RA Madeira";"All";11611;6567;4;18182;89468;34787;17;124272;54603;34911;89514;0,356361029236039;0,217489843065403;0,139054409304549;0,356544252369951
"230";"REGIONAL";2021-05-17;2021;20;"RA Madeira";"All";2411;7721;4;10136;91879;42508;21;134408;49295;42638;91933;0,365964311320003;0,196347486656576;0,169831912690194;0,36617939934677
"231";"REGIONAL";2021-05-24;2021;21;"RA Madeira";"All";3530;8991;3;12524;95409;51499;24;146932;43827;51645;95472;0,380024695291962;0,174567832390664;0,205707798932526;0,38027563132319
"232";"REGIONAL";2021-05-31;2021;22;"RA Madeira";"All";7647;11052;4;18703;103056;62551;28;165635;40723;62738;103461;0,410483549749064;0,162204253963196;0,249892455986617;0,412096709949813
"233";"REGIONAL";2021-06-07;2021;23;"RA Madeira";"All";3729;15301;8;19038;106785;77852;36;184673;31212;78078;109290;0,425336572930774;0,124320879471043;0,310993388034733;0,435314267505776
"234";"REGIONAL";2021-06-14;2021;24;"RA Madeira";"All";3673;8492;3;12168;110458;86344;39;196841;28888;86611;115499;0,439966541862503;0,115064128096869;0,344981279375448;0,460045407472317
"235";"REGIONAL";2021-06-21;2021;25;"RA Madeira";"All";12658;3762;9;16429;123116;90106;48;213270;37780;90514;128294;0,490384768581216;0,150481956504421;0,360527363976739;0,51100932048116
"236";"REGIONAL";2021-06-28;2021;26;"RA Madeira";"All";10158;12390;8;22556;133274;102496;56;235826;35632;103013;138645;0,53084521628296;0,141926232773042;0,410312275949972;0,552238508723014
"237";"REGIONAL";2021-07-05;2021;27;"RA Madeira";"All";12809;7036;8;19853;146083;109532;64;255679;41471;110396;151867;0,581864892854298;0,165183621445073;0,439719588942882;0,604903210387955
"238";"REGIONAL";2021-07-12;2021;28;"RA Madeira";"All";10661;5928;13;16602;156744;115460;77;272281;47093;116913;164006;0,624328845694256;0,187576674898431;0,465677527284314;0,653254202182745
"239";"REGIONAL";2021-07-19;2021;29;"RA Madeira";"All";4294;14886;7;19187;161038;130346;84;291468;38784;132051;170835;0,641432326933801;0,154481000557636;0,52597387078786;0,680454871345495
"240";"REGIONAL";2021-07-26;2021;30;"RA Madeira";"All";5582;13923;8;19513;166620;144269;92;310981;33391;146387;179778;0,663666055922887;0,133000079662232;0,583075758782761;0,716075838444993
"241";"REGIONAL";2021-08-02;2021;31;"RA Madeira";"All";4576;14415;2;18993;171196;158684;94;329974;25338;161157;186495;0,681892774635545;0,100924081892775;0,641906317215008;0,742830399107783
"242";"REGIONAL";2021-08-09;2021;32;"RA Madeira";"All";5422;11066;5;16493;176618;169750;99;346467;21159;172476;193635;0,703489205767546;0,0842786584880108;0,686991157492233;0,771269815980244
"243";"REGIONAL";2021-08-16;2021;33;"RA Madeira";"All";3631;8176;4;11811;180249;177926;103;358278;17674;180863;198537;0,71795188401179;0,0703975145383574;0,720397514538357;0,790795029076715
"244";"REGIONAL";2021-08-23;2021;34;"RA Madeira";"All";2200;6309;3;8512;182449;184235;106;366790;14352;187347;201699;0,726714729546722;0,0571656177806102;0,746224010196766;0,803389627977376
"245";"REGIONAL";2021-08-30;2021;35;"RA Madeira";"All";1800;5881;2;7683;184249;190116;108;374473;11098;193454;204552;0,733884330438939;0,0442045726121246;0,770548872779415;0,81475344539154
"246";"REGIONAL";2021-09-06;2021;36;"RA Madeira";"All";1307;4804;2;6113;185556;194920;110;380586;8033;198478;206511;0,73909025730901;0,0319963355373218;0,790560025491914;0,822556361029236
"247";"REGIONAL";2021-09-13;2021;37;"RA Madeira";"All";852;2893;2;3747;186408;197813;112;384333;6176;201587;207763;0,742483868397993;0,0245996972835179;0,802943519477416;0,827543216760934
"248";"REGIONAL";2021-09-20;2021;38;"RA Madeira";"All";814;2141;1;2956;187222;199954;113;387289;4863;203980;208843;0,745726121245917;0,0193698717438063;0,812475105552458;0,831844977296264
"249";"REGIONAL";2021-09-27;2021;39;"RA Madeira";"All";788;1359;7;2154;188010;201313;120;389443;4165;205504;209669;0,748864813192066;0,0165896598422688;0,818545367641201;0,83513502748347
"250";"REGIONAL";2021-10-04;2021;40;"RA Madeira";"All";639;868;118;1625;188649;202181;238;391068;3815;206527;210342;0,751410021508803;0,0151955707798933;0,822620090814945;0,837815661594838
"251";"REGIONAL";2021-10-11;2021;41;"RA Madeira";"All";627;708;6;1341;189276;202889;244;392409;3641;207347;210988;0,753907432486258;0,0145025093603123;0,82588624233251;0,840388751692822
"252";"REGIONAL";2021-10-18;2021;42;"RA Madeira";"All";587;698;2;1287;189863;203587;246;393696;3469;208114;211583;0,756245518999442;0,0138174141639449;0,828941288934916;0,842758703098861
"253";"REGIONAL";2021-01-04;2021;1;"RA Acores";"All";3682;3;1;3686;5726;3;3;5732;5723;3;5726;0,0241953544581398;0,0241826778840262;1,26765741135906e-05;0,0241953544581398
"254";"REGIONAL";2021-01-11;2021;2;"RA Acores";"All";27;3;0;30;5753;6;3;5762;5747;6;5753;0,0243094436251622;0,024284090476935;2,53531482271811e-05;0,0243094436251622
"255";"REGIONAL";2021-01-18;2021;3;"RA Acores";"All";81;1987;2;2070;5834;1993;5;7832;3841;1993;5834;0,0246517111262291;0,0162302403901004;0,00842147073612866;0,0246517111262291
"256";"REGIONAL";2021-01-25;2021;4;"RA Acores";"All";314;3621;3;3938;6148;5614;8;11770;534;5614;6148;0,0259785258834516;0,00225643019221912;0,0237220956912325;0,0259785258834516
"257";"REGIONAL";2021-02-01;2021;5;"RA Acores";"All";1894;34;1;1929;8042;5648;9;13699;2394;5648;8042;0,0339816696738317;0,0101159061426453;0,0238657635311865;0,0339816696738317
"258";"REGIONAL";2021-02-08;2021;6;"RA Acores";"All";1070;55;1;1126;9112;5703;10;14825;3409;5703;9112;0,038502981107679;0,0144048137177434;0,0240981673899356;0,038502981107679
"259";"REGIONAL";2021-02-15;2021;7;"RA Acores";"All";2094;370;1;2465;11206;6073;11;17290;5133;6073;11206;0,0473512298389653;0,0216896183083534;0,0256616115306118;0,0473512298389653
"260";"REGIONAL";2021-02-22;2021;8;"RA Acores";"All";1504;1644;3;3151;12710;7717;14;20441;4992;7718;12710;0,0537064189945787;0,0210938193250147;0,032612599669564;0,0537064189945787
"261";"REGIONAL";2021-03-01;2021;9;"RA Acores";"All";790;1210;4;2004;13500;8927;18;22445;4572;8928;13500;0,0570445835111575;0,019319098949112;0,0377254845620455;0,0570445835111575
"262";"REGIONAL";2021-03-08;2021;10;"RA Acores";"All";2777;2075;2;4854;16277;11002;20;27299;5266;11012;16278;0,0687788656156378;0,022251613094056;0,0465314780462864;0,0687830911403424
"263";"REGIONAL";2021-03-15;2021;11;"RA Acores";"All";2550;1463;4;4017;18827;12465;24;31316;6348;12481;18829;0,0795539536121898;0,0268236308243576;0,0527387738372412;0,0795624046615988
"264";"REGIONAL";2021-03-22;2021;12;"RA Acores";"All";4170;752;4;4926;22997;13217;28;36242;9756;13243;22999;0,0971743916300807;0,0412242190173965;0,0559586236620932;0,0971828426794897
"265";"REGIONAL";2021-03-29;2021;13;"RA Acores";"All";2233;783;2;3018;25230;14000;30;39260;11203;14030;25233;0,106609988295297;0,0473385532648517;0,0592841116045585;0,10662266486941
"266";"REGIONAL";2021-04-05;2021;14;"RA Acores";"All";3901;2387;5;6293;29131;16387;35;45553;12702;16438;29140;0,123093760167669;0,0536726147969424;0,0694591750930672;0,12313178989001
"267";"REGIONAL";2021-04-12;2021;15;"RA Acores";"All";4246;2407;8;6661;33377;18794;43;52214;14527;18861;33388;0,141035338063104;0,06138419738271;0,0796976214521438;0,141081818834854
"268";"REGIONAL";2021-04-19;2021;16;"RA Acores";"All";7927;1074;13;9014;41304;19868;56;61228;21323;19992;41315;0,174531072395915;0,0901008632746971;0,0844766898929675;0,174577553167665
"269";"REGIONAL";2021-04-26;2021;17;"RA Acores";"All";9313;2999;8;12320;50617;22867;64;73548;27597;23054;50651;0,213883383969204;0,11661180527092;0,0974152465382389;0,214027051809158
"270";"REGIONAL";2021-05-03;2021;18;"RA Acores";"All";9738;2959;11;12708;60355;25826;75;86256;34356;26067;60423;0,255031543541919;0,145172126748839;0,110146752472988;0,255318879221827
"271";"REGIONAL";2021-05-10;2021;19;"RA Acores";"All";9458;2437;12;11907;69813;28263;87;98163;41349;28535;69884;0,294996556197366;0,174721221007619;0,120575347443769;0,295296568451387
"272";"REGIONAL";2021-05-17;2021;20;"RA Acores";"All";12105;5186;12;17303;81918;33449;99;115466;48233;33763;81996;0,346146532745704;0,203809733073604;0,142666390599053;0,346476123672657
"273";"REGIONAL";2021-05-24;2021;21;"RA Acores";"All";5619;8204;78;13901;87537;41653;177;129367;45639;41990;87629;0,369889756060459;0,192848721990053;0,177429782343222;0,370278504333276
"274";"REGIONAL";2021-05-31;2021;22;"RA Acores";"All";5523;10516;24;16063;93060;52169;201;145430;40680;52541;93221;0,393227329003579;0,171894344980288;0,22201329350072;0,393907638481008
"275";"REGIONAL";2021-06-07;2021;23;"RA Acores";"All";7884;12246;34;20164;100944;64415;235;165594;36291;64840;101131;0,426541365774095;0,153348517052105;0,273983021841737;0,427331538893842
"276";"REGIONAL";2021-06-14;2021;24;"RA Acores";"All";9290;7913;38;17241;110234;72328;273;182835;38104;72821;110925;0,46579649027918;0,161009393341418;0,307706934508593;0,468716327850011
"277";"REGIONAL";2021-06-21;2021;25;"RA Acores";"All";7569;10356;47;17972;117803;82684;320;200807;38070;83269;121339;0,497779486767769;0,160865725501464;0,351855216621524;0,512720942122988
"278";"REGIONAL";2021-06-28;2021;26;"RA Acores";"All";6755;12558;130;19443;124558;95242;450;220250;33698;95954;129652;0,526322906146871;0,142391731493258;0,405455997498489;0,547847728991747
"279";"REGIONAL";2021-07-05;2021;27;"RA Acores";"All";6236;16361;49;22646;130794;111603;499;242896;25345;112472;137817;0,552673278204321;0,107095923636318;0,475253214567919;0,582349138204237
"280";"REGIONAL";2021-07-12;2021;28;"RA Acores";"All";2982;11964;41;14987;133776;123567;540;257883;17991;124540;142531;0,56527379287323;0,0760214149592026;0,526246846702189;0,602268261661392
"281";"REGIONAL";2021-07-19;2021;29;"RA Acores";"All";5716;9073;33;14822;139492;132640;573;272705;16310;133821;150131;0,589426892084325;0,0689183079308873;0,565463941484934;0,634382249415821
"282";"REGIONAL";2021-07-26;2021;30;"RA Acores";"All";7012;9046;28;16086;146504;141686;601;288791;16702;143230;159932;0,61905627131249;0,0705747136150632;0,605221903429858;0,675796617044922
"283";"REGIONAL";2021-08-02;2021;31;"RA Acores";"All";9647;6729;25;16401;156151;148415;626;305192;22984;150289;173273;0,659819908137093;0,0971194598089218;0,635049882319137;0,732169342128059
"284";"REGIONAL";2021-08-09;2021;32;"RA Acores";"All";5061;6653;32;11746;161212;155068;658;316938;22753;157207;179960;0,68120528866672;0,0961433636021753;0,664282062225077;0,760425425827252
"285";"REGIONAL";2021-08-16;2021;33;"RA Acores";"All";2385;7429;35;9849;163597;162497;693;326787;18389;164763;183152;0,691283165087025;0,0777031737916056;0,696210126892507;0,773913300684112
"286";"REGIONAL";2021-08-23;2021;34;"RA Acores";"All";5741;9382;14;15137;169338;171879;707;341924;15051;174271;189322;0,715541902415732;0,0635983723278838;0,73638641578318;0,799984788111064
"287";"REGIONAL";2021-08-30;2021;35;"RA Acores";"All";3152;5557;13;8722;172490;177436;720;350646;12782;179923;192705;0,728860756284412;0,0540106567733048;0,760269081413184;0,814279738186489
"288";"REGIONAL";2021-09-06;2021;36;"RA Acores";"All";2098;2911;15;5024;174588;180347;735;355670;11451;183587;195038;0,737725907114516;0,0483864833915751;0,775751403930583;0,824137887322158
"289";"REGIONAL";2021-09-13;2021;37;"RA Acores";"All";872;5324;31;6227;175460;185671;766;361897;6791;189225;196016;0,741410564656866;0,0286955382684645;0,799574912214724;0,828270450483189
"290";"REGIONAL";2021-09-20;2021;38;"RA Acores";"All";779;3383;20;4182;176239;189054;786;366079;4112;192778;196890;0,744702248401695;0,0173753575850281;0,81458820148992;0,831963559074948
"291";"REGIONAL";2021-09-27;2021;39;"RA Acores";"All";532;1610;23;2165;176771;190664;809;368244;3044;194530;197574;0,746950227544505;0,0128624972005899;0,821991320772257;0,834853817972847
"292";"REGIONAL";2021-10-04;2021;40;"RA Acores";"All";405;719;7;1131;177176;191383;816;369375;2677;195382;198059;0,74866156504984;0,0113117296340273;0,825591467820517;0,836903197454544
"293";"REGIONAL";2021-10-11;2021;41;"RA Acores";"All";390;736;0;1126;177566;192119;816;370501;2300;196237;198537;0,750309519684607;0,00971870682041943;0,82920429144289;0,838922998263309
"294";"REGIONAL";2021-10-18;2021;42;"RA Acores";"All";278;446;0;724;177844;192565;816;371225;2097;196767;198864;0,751484215552466;0,0088609253053998;0,831443819536291;0,840304744841691
"295";"REGIONAL";2021-01-04;2021;1;"Outro";"All";0;0;0;0;0;0;0;0;0;0;0;NA;NA;NA;NA
"296";"REGIONAL";2021-01-11;2021;2;"Outro";"All";0;0;0;0;0;0;0;0;0;0;0;NA;NA;NA;NA
"297";"REGIONAL";2021-01-18;2021;3;"Outro";"All";0;0;0;0;0;0;0;0;0;0;0;NA;NA;NA;NA
"298";"REGIONAL";2021-01-25;2021;4;"Outro";"All";0;0;0;0;0;0;0;0;0;0;0;NA;NA;NA;NA
"299";"REGIONAL";2021-02-01;2021;5;"Outro";"All";0;0;0;0;0;0;0;0;0;0;0;NA;NA;NA;NA
"300";"REGIONAL";2021-02-08;2021;6;"Outro";"All";0;0;0;0;0;0;0;0;0;0;0;NA;NA;NA;NA
"301";"REGIONAL";2021-02-15;2021;7;"Outro";"All";0;0;0;0;0;0;0;0;0;0;0;NA;NA;NA;NA
"302";"REGIONAL";2021-02-22;2021;8;"Outro";"All";0;0;0;0;0;0;0;0;0;0;0;NA;NA;NA;NA
"303";"REGIONAL";2021-03-01;2021;9;"Outro";"All";0;0;0;0;0;0;0;0;0;0;0;NA;NA;NA;NA
"304";"REGIONAL";2021-03-08;2021;10;"Outro";"All";0;0;0;0;0;0;0;0;0;0;0;NA;NA;NA;NA
"305";"REGIONAL";2021-03-15;2021;11;"Outro";"All";0;0;0;0;0;0;0;0;0;0;0;NA;NA;NA;NA
"306";"REGIONAL";2021-03-22;2021;12;"Outro";"All";0;0;0;0;0;0;0;0;0;0;0;NA;NA;NA;NA
"307";"REGIONAL";2021-03-29;2021;13;"Outro";"All";0;0;0;0;0;0;0;0;0;0;0;NA;NA;NA;NA
"308";"REGIONAL";2021-04-05;2021;14;"Outro";"All";0;0;0;0;0;0;0;0;0;0;0;NA;NA;NA;NA
"309";"REGIONAL";2021-04-12;2021;15;"Outro";"All";0;0;0;0;0;0;0;0;0;0;0;NA;NA;NA;NA
"310";"REGIONAL";2021-04-19;2021;16;"Outro";"All";0;0;0;0;0;0;0;0;0;0;0;NA;NA;NA;NA
"311";"REGIONAL";2021-04-26;2021;17;"Outro";"All";0;0;0;0;0;0;0;0;0;0;0;NA;NA;NA;NA
"312";"REGIONAL";2021-05-03;2021;18;"Outro";"All";0;0;0;0;0;0;0;0;0;0;0;NA;NA;NA;NA
"313";"REGIONAL";2021-05-10;2021;19;"Outro";"All";0;0;0;0;0;0;0;0;0;0;0;NA;NA;NA;NA
"314";"REGIONAL";2021-05-17;2021;20;"Outro";"All";0;0;0;0;0;0;0;0;0;0;0;NA;NA;NA;NA
"315";"REGIONAL";2021-05-24;2021;21;"Outro";"All";0;0;0;0;0;0;0;0;0;0;0;NA;NA;NA;NA
"316";"REGIONAL";2021-05-31;2021;22;"Outro";"All";0;0;0;0;0;0;0;0;0;0;0;NA;NA;NA;NA
"317";"REGIONAL";2021-06-07;2021;23;"Outro";"All";0;0;0;0;0;0;0;0;0;0;0;NA;NA;NA;NA
"318";"REGIONAL";2021-06-14;2021;24;"Outro";"All";0;0;0;0;0;0;0;0;0;0;0;NA;NA;NA;NA
"319";"REGIONAL";2021-06-21;2021;25;"Outro";"All";0;0;0;0;0;0;0;0;0;0;0;NA;NA;NA;NA
"320";"REGIONAL";2021-06-28;2021;26;"Outro";"All";0;0;0;0;0;0;0;0;0;0;0;NA;NA;NA;NA
"321";"REGIONAL";2021-07-05;2021;27;"Outro";"All";0;0;0;0;0;0;0;0;0;0;0;NA;NA;NA;NA
"322";"REGIONAL";2021-07-12;2021;28;"Outro";"All";0;0;0;0;0;0;0;0;0;0;0;NA;NA;NA;NA
"323";"REGIONAL";2021-07-19;2021;29;"Outro";"All";0;0;0;0;0;0;0;0;0;0;0;NA;NA;NA;NA
"324";"REGIONAL";2021-07-26;2021;30;"Outro";"All";0;0;0;0;0;0;0;0;0;0;0;NA;NA;NA;NA
"325";"REGIONAL";2021-08-02;2021;31;"Outro";"All";0;0;0;0;0;0;0;0;0;0;0;NA;NA;NA;NA
"326";"REGIONAL";2021-08-09;2021;32;"Outro";"All";0;0;0;0;0;0;0;0;0;0;0;NA;NA;NA;NA
"327";"REGIONAL";2021-08-16;2021;33;"Outro";"All";0;0;0;0;0;0;0;0;0;0;0;NA;NA;NA;NA
"328";"REGIONAL";2021-08-23;2021;34;"Outro";"All";0;0;0;0;0;0;0;0;0;0;0;NA;NA;NA;NA
"329";"REGIONAL";2021-08-30;2021;35;"Outro";"All";0;0;0;0;0;0;0;0;0;0;0;NA;NA;NA;NA
"330";"REGIONAL";2021-09-06;2021;36;"Outro";"All";0;0;0;0;0;0;0;0;0;0;0;NA;NA;NA;NA
"331";"REGIONAL";2021-09-13;2021;37;"Outro";"All";0;0;0;0;0;0;0;0;0;0;0;NA;NA;NA;NA
"332";"REGIONAL";2021-09-20;2021;38;"Outro";"All";0;0;0;0;0;0;0;0;0;0;0;NA;NA;NA;NA
"333";"REGIONAL";2021-09-27;2021;39;"Outro";"All";0;0;0;0;0;0;0;0;0;0;0;NA;NA;NA;NA
"334";"REGIONAL";2021-10-04;2021;40;"Outro";"All";0;0;0;0;0;0;0;0;0;0;0;NA;NA;NA;NA
"335";"REGIONAL";2021-10-11;2021;41;"Outro";"All";0;0;0;0;0;0;0;0;0;0;0;NA;NA;NA;NA
"336";"REGIONAL";2021-10-18;2021;42;"Outro";"All";0;0;0;0;0;0;0;0;0;0;0;NA;NA;NA;NA
"337";"AGES";2021-01-04;2021;1;"All";"12-17 anos";5;0;0;5;7;0;0;7;7;0;7;1,12451786296625e-05;1,12451786296625e-05;0;1,12451786296625e-05
"338";"AGES";2021-01-11;2021;2;"All";"12-17 anos";15;0;0;15;22;0;0;22;22;0;22;3,53419899789394e-05;3,53419899789394e-05;0;3,53419899789394e-05
"339";"AGES";2021-01-18;2021;3;"All";"12-17 anos";70;1;0;71;92;1;0;93;91;1;92;0,000147793776275565;0,000146187322185613;1,60645408995179e-06;0,000147793776275565
"340";"AGES";2021-01-25;2021;4;"All";"12-17 anos";16;3;0;19;108;4;0;112;104;4;108;0,000173497041714793;0,000167071225354986;6,42581635980716e-06;0,000173497041714793
"341";"AGES";2021-02-01;2021;5;"All";"12-17 anos";35;4;0;39;143;8;0;151;135;8;143;0,000229722934863106;0,000216871302143492;1,28516327196143e-05;0,000229722934863106
"342";"AGES";2021-02-08;2021;6;"All";"12-17 anos";38;66;0;104;181;74;0;255;107;74;181;0,000290768190281274;0,000171890587624842;0,000118877602656432;0,000290768190281274
"343";"AGES";2021-02-15;2021;7;"All";"12-17 anos";32;16;0;48;213;90;0;303;123;90;213;0,000342174721159731;0,00019759385306407;0,000144580868095661;0,000342174721159731
"344";"AGES";2021-02-22;2021;8;"All";"12-17 anos";24;33;0;57;237;123;0;360;114;123;237;0,000380729619318574;0,000183135766254504;0,00019759385306407;0,000380729619318574
"345";"AGES";2021-03-01;2021;9;"All";"12-17 anos";12;30;0;42;249;153;0;402;96;153;249;0,000400007068397996;0,000154219592635372;0,000245787475762624;0,000400007068397996
"346";"AGES";2021-03-08;2021;10;"All";"12-17 anos";20;25;0;45;269;178;0;447;90;179;269;0,000432136150197032;0,000144580868095661;0,00028755528210137;0,000432136150197032
"347";"AGES";2021-03-15;2021;11;"All";"12-17 anos";6;23;0;29;275;201;0;476;73;202;275;0,000441774874736742;0,000117271148566481;0,000324503726170262;0,000441774874736742
"348";"AGES";2021-03-22;2021;12;"All";"12-17 anos";33;11;0;44;308;212;0;520;95;213;308;0,000494787859705151;0,00015261313854542;0,000342174721159731;0,000494787859705151
"349";"AGES";2021-03-29;2021;13;"All";"12-17 anos";15;14;0;29;323;226;0;549;96;227;323;0,000518884671054428;0,000154219592635372;0,000364665078419056;0,000518884671054428
"350";"AGES";2021-04-05;2021;14;"All";"12-17 anos";33;6;0;39;356;232;0;588;123;233;356;0,000571897656022837;0,00019759385306407;0,000374303802958767;0,000571897656022837
"351";"AGES";2021-04-12;2021;15;"All";"12-17 anos";48;11;0;59;404;243;0;647;160;244;404;0,000649007452340523;0,000257032654392286;0,000391974797948237;0,000649007452340523
"352";"AGES";2021-04-19;2021;16;"All";"12-17 anos";31;14;0;45;435;257;0;692;175;260;435;0,000698807529129029;0,000281129465741563;0,000417678063387465;0,000698807529129029
"353";"AGES";2021-04-26;2021;17;"All";"12-17 anos";51;28;0;79;486;285;0;771;197;289;486;0,00078073668771657;0,000316471455720503;0,000464265231996067;0,00078073668771657
"354";"AGES";2021-05-03;2021;18;"All";"12-17 anos";110;16;0;126;596;301;0;897;290;306;596;0,000957446637611267;0,000465871686086019;0,000491574951525248;0,000957446637611267
"355";"AGES";2021-05-10;2021;19;"All";"12-17 anos";172;46;0;218;768;347;0;1115;416;352;768;0,00123375674108298;0,000668284901419945;0,00056547183966303;0,00123375674108298
"356";"AGES";2021-05-17;2021;20;"All";"12-17 anos";316;27;0;343;1084;374;0;1458;705;379;1084;0,00174139623350774;0,00113255013341601;0,000608846100091729;0,00174139623350774
"357";"AGES";2021-05-24;2021;21;"All";"12-17 anos";304;40;0;344;1388;414;0;1802;963;425;1388;0,00222975827685308;0,00154701528862357;0,000682742988229511;0,00222975827685308
"358";"AGES";2021-05-31;2021;22;"All";"12-17 anos";281;120;0;401;1669;534;0;2203;1112;557;1669;0,00268117187612954;0,00178637694802639;0,000894794928103147;0,00268117187612954
"359";"AGES";2021-06-07;2021;23;"All";"12-17 anos";405;166;0;571;2074;700;0;2774;1346;729;2075;0,00333178578256001;0,00216228720507511;0,00117110503157486;0,00333339223664996
"360";"AGES";2021-06-14;2021;24;"All";"12-17 anos";589;336;0;925;2663;1036;0;3699;1596;1070;2666;0,00427798724154162;0,00256390072756306;0,00171890587624842;0,00428280660381147
"361";"AGES";2021-06-21;2021;25;"All";"12-17 anos";414;298;1;713;3077;1334;1;4412;1708;1379;3087;0,00494305923478166;0,00274382358563766;0,00221530019004352;0,00495912377568118
"362";"AGES";2021-06-28;2021;26;"All";"12-17 anos";235;284;0;519;3312;1618;1;4931;1654;1668;3322;0,00532057594592033;0,00265707506478026;0,00267956542203959;0,00533664048681985
"363";"AGES";2021-07-05;2021;27;"All";"12-17 anos";444;668;1;1113;3756;2286;2;6044;1420;2347;3767;0,00603384156185892;0,00228116480773154;0,00377034774911685;0,00605151255684839
"364";"AGES";2021-07-12;2021;28;"All";"12-17 anos";281;322;1;604;4037;2608;3;6648;1374;2690;4064;0,00648525516113538;0,00220726791959376;0,00432136150197032;0,00652862942156408
"365";"AGES";2021-07-19;2021;29;"All";"12-17 anos";275;281;2;558;4312;2889;5;7206;1354;2996;4350;0,00692703003587212;0,00217513883779472;0,00481293645349556;0,00698807529129029
"366";"AGES";2021-07-26;2021;30;"All";"12-17 anos";1632;397;0;2029;5944;3286;5;9235;2551;3440;5991;0,00954876311067344;0,00409806438346702;0,00552620206943416;0,00962426645290118
"367";"AGES";2021-08-02;2021;31;"All";"12-17 anos";4632;216;1;4849;10576;3502;6;14084;6835;3818;10653;0,0169898584553301;0,0109801137048205;0,00613344171543594;0,0171135554202564
"368";"AGES";2021-08-09;2021;32;"All";"12-17 anos";142699;422;2;143123;153275;3924;8;157207;137943;15535;153478;0,246229250637361;0,22159909653022;0,0249562642874011;0,246555360817621
"369";"AGES";2021-08-16;2021;33;"All";"12-17 anos";177933;1587;1;179521;331208;5511;9;336728;302084;29393;331477;0,532070446224753;0,485284077308997;0,047218505065953;0,53250258237495
"370";"AGES";2021-08-23;2021;34;"All";"12-17 anos";132430;3944;4;136378;463638;9455;13;473106;421746;42185;463931;0,744813161357068;0,677515586620808;0,0677682657846163;0,745283852405424
"371";"AGES";2021-08-30;2021;35;"All";"12-17 anos";42139;110128;14;152281;505777;119583;27;625387;349063;157015;506078;0,812507530253547;0,560753684000842;0,25223738893378;0,812991072934622
"372";"AGES";2021-09-06;2021;36;"All";"12-17 anos";20547;162756;15;183318;526324;282339;42;808705;205027;321601;526628;0,845515342439786;0,329366462700546;0,516637241782586;0,846003704483131
"373";"AGES";2021-09-13;2021;37;"All";"12-17 anos";12832;126927;33;139792;539156;409266;75;948497;89681;449780;539461;0,866129361322047;0,144068409240967;0,722550920578516;0,866619329819483
"374";"AGES";2021-09-20;2021;38;"All";"12-17 anos";5661;41680;16;47357;544817;450946;91;995854;52717;492406;545123;0,875223497925265;0,0846874402599885;0,791027632616801;0,87571507287679
"375";"AGES";2021-09-27;2021;39;"All";"12-17 anos";3248;17226;14;20488;548065;468172;105;1016342;37944;510429;548373;0,880441260809428;0,0609552939891307;0,819980754680002;0,880936048669133
"376";"AGES";2021-10-04;2021;40;"All";"12-17 anos";2316;10958;4;13278;550381;479130;109;1029620;28895;521795;550690;0,884161808481756;0,046418490929157;0,838239711866394;0,884658202795551
"377";"AGES";2021-10-11;2021;41;"All";"12-17 anos";2590;6737;0;9327;552971;485867;109;1038947;24256;529025;553281;0,888322524574731;0,0389661504058706;0,849854374936746;0,888820525342616
"378";"AGES";2021-10-18;2021;42;"All";"12-17 anos";2051;4119;0;6170;555022;489986;109;1045117;21695;533637;555332;0,891617361913223;0,0348520214815041;0,857263341199604;0,892115362681108
"379";"AGES";2021-01-04;2021;1;"All";"18-24 anos";1854;4;0;1858;3225;5;0;3230;3219;6;3225;0,0041283963260473;0,00412071558869651;7,68073735078567e-06;0,0041283963260473
"380";"AGES";2021-01-11;2021;2;"All";"18-24 anos";1448;58;0;1506;4673;63;0;4736;4609;65;4674;0,00598201427337024;0,0059000864082952;8,32079879668448e-05;0,00598329439626204
"381";"AGES";2021-01-18;2021;3;"All";"18-24 anos";3875;1202;0;5077;8548;1265;0;9813;7280;1270;8550;0,010942490479086;0,00931929465228662;0,00162575607258297;0,0109450507248696
"382";"AGES";2021-01-25;2021;4;"All";"18-24 anos";1400;1648;1;3049;9948;2913;1;12862;7033;2919;9952;0,0127346625276026;0,00900310429801261;0,00373667872115723;0,0127397830191698
"383";"AGES";2021-02-01;2021;5;"All";"18-24 anos";1001;946;0;1947;10949;3859;1;14809;7087;3867;10954;0,0140160655422921;0,00907223093416968;0,00495023522258137;0,014022466156751
"384";"AGES";2021-02-08;2021;6;"All";"18-24 anos";1487;3077;0;4564;12436;6936;1;19373;5485;6956;12441;0,0159196082823951;0,0070214740615099;0,00890453483534419;0,0159260088968541
"385";"AGES";2021-02-15;2021;7;"All";"18-24 anos";2333;1751;1;4085;14769;8687;2;23458;6028;8746;14774;0,0189061349889589;0,00771658079175601;0,0111959548116619;0,0189125356034179
"386";"AGES";2021-02-22;2021;8;"All";"18-24 anos";1341;707;0;2048;16110;9394;2;25506;6633;9482;16115;0,0206227797868595;0,00849105514129356;0,012138125260025;0,0206291804013185
"387";"AGES";2021-03-01;2021;9;"All";"18-24 anos";961;1049;1;2011;17071;10443;3;27517;6522;10556;17078;0,021852977885877;0,00834896150030403;0,0135129772458156;0,0218619387461196
"388";"AGES";2021-03-08;2021;10;"All";"18-24 anos";1399;648;1;2048;18470;11091;4;29565;7264;11216;18480;0,0236438698115019;0,00929881268601786;0,014357858354402;0,0236566710404199
"389";"AGES";2021-03-15;2021;11;"All";"18-24 anos";287;403;1;691;18757;11494;5;30256;7147;11621;18768;0,0240112650814478;0,00914903830767754;0,0148763081255801;0,0240253464332576
"390";"AGES";2021-03-22;2021;12;"All";"18-24 anos";3309;182;0;3491;22066;11676;5;33747;10258;11820;22078;0,0282471917304061;0,0131315006240599;0,0151310525810478;0,0282625532051077
"391";"AGES";2021-03-29;2021;13;"All";"18-24 anos";696;109;0;805;22762;11785;5;34552;10833;11944;22777;0,0291381572630973;0,0138675712868435;0,0152897878196307;0,0291573591064742
"392";"AGES";2021-04-05;2021;14;"All";"18-24 anos";813;199;0;1012;23575;11984;5;35564;11455;12150;23605;0,0301788971741287;0,0146638077255417;0,015553493135341;0,0302173008608826
"393";"AGES";2021-04-12;2021;15;"All";"18-24 anos";4309;112;0;4421;27884;12096;5;39985;15639;12282;27921;0,0356949467148846;0,0200198419048229;0,0157224693570583;0,0357423112618811
"394";"AGES";2021-04-19;2021;16;"All";"18-24 anos";1317;114;0;1431;29201;12210;5;41416;16801;12437;29238;0,0373808685633821;0,0215073447050917;0,0159208884052869;0,0374282331103786
"395";"AGES";2021-04-26;2021;17;"All";"18-24 anos";2688;188;0;2876;31889;12398;5;44292;19300;12656;31956;0,0408218388965341;0,0247063718116939;0,0162012353185906;0,0409076071302845
"396";"AGES";2021-05-03;2021;18;"All";"18-24 anos";1854;851;0;2705;33743;13249;5;46997;20319;13542;33861;0,0431951867379268;0,0260108170384357;0,0173354242007233;0,043346241239159
"397";"AGES";2021-05-10;2021;19;"All";"18-24 anos";2272;5430;1;7703;36015;18679;6;54700;17140;19008;36148;0,046103625948091;0,0219413063654111;0,024332575927289;0,0462738822927001
"398";"AGES";2021-05-17;2021;20;"All";"18-24 anos";2117;2487;0;4604;38132;21166;6;59304;16704;21566;38270;0,0488136461100266;0,0213831727845873;0,0276071302845073;0,0489903030690946
"399";"AGES";2021-05-24;2021;21;"All";"18-24 anos";2288;3310;1;5599;40420;24476;7;64903;15485;25096;40581;0,0517425672864595;0,019822702979486;0,0321259640925529;0,0519486670720389
"400";"AGES";2021-05-31;2021;22;"All";"18-24 anos";2395;2713;1;5109;42815;27189;8;70012;14917;28070;42987;0,0548084616123148;0,019095593176945;0,035933049572759;0,055028642749704
"401";"AGES";2021-06-07;2021;23;"All";"18-24 anos";2882;2949;1;5832;45697;30138;9;75844;14661;31243;45904;0,0584977757864755;0,0187678817166448;0,0399948795084328;0,0587627612250776
"402";"AGES";2021-06-14;2021;24;"All";"18-24 anos";3106;4663;2;7771;48803;34801;11;83615;13116;36175;49291;0,0624738374883989;0,0167900918488175;0,0463084456107786;0,0630985374595961
"403";"AGES";2021-06-21;2021;25;"All";"18-24 anos";2939;3059;2;6000;51742;37860;13;89615;13172;39584;52756;0,0662361186673921;0,0168617787307582;0,0506723845489167;0,0675341632796748
"404";"AGES";2021-06-28;2021;26;"All";"18-24 anos";2135;3114;7;5256;53877;40974;20;94871;12453;42939;55392;0,06896918104138;0,0159413703715557;0,0549671968508977;0,0709085672224534
"405";"AGES";2021-07-05;2021;27;"All";"18-24 anos";11926;5118;13;17057;65803;46092;33;111928;19956;49001;68957;0,0842359266489583;0,0255461324287132;0,0627273018209748;0,088273434249688
"406";"AGES";2021-07-12;2021;28;"All";"18-24 anos";14196;7892;3;22091;79999;53984;36;134019;31173;58131;89304;0,102408551220917;0,039905270906007;0,074414823823087;0,114320094729094
"407";"AGES";2021-07-19;2021;29;"All";"18-24 anos";19523;19689;2;39214;99522;73673;38;173233;46278;79893;126171;0,127400390437482;0,0592415271866099;0,102272858194387;0,161514385380997
"408";"AGES";2021-07-26;2021;30;"All";"18-24 anos";21036;22630;15;43681;120558;96303;53;216914;61859;104797;166656;0,154329055589337;0,0791871219637085;0,134153038691714;0,213340160655423
"409";"AGES";2021-08-02;2021;31;"All";"18-24 anos";53991;56514;5;110510;174549;152817;58;327424;101736;166987;268723;0,223444170640381;0,130234582519922;0,213763881332608;0,34399846385253
"410";"AGES";2021-08-09;2021;32;"All";"18-24 anos";87802;82645;7;170454;262351;235462;65;497878;165727;260949;426676;0,335841520785995;0,212150926488943;0,334046788491695;0,546197714980638
"411";"AGES";2021-08-16;2021;33;"All";"18-24 anos";94375;74459;15;168849;356726;309921;80;666727;229862;347334;577196;0,456653118699395;0,294251608154383;0,444630204499632;0,738881812654015
"412";"AGES";2021-08-23;2021;34;"All";"18-24 anos";56382;43827;7;100216;413108;353748;87;766943;250117;397777;647894;0,528829007584728;0,320180497327743;0,509203443530579;0,829383940858322
"413";"AGES";2021-08-30;2021;35;"All";"18-24 anos";22707;100546;7;123260;435815;454294;94;890203;171517;502704;674221;0,557896758088776;0,219562838032451;0,643522898198227;0,863085736230678
"414";"AGES";2021-09-06;2021;36;"All";"18-24 anos";12953;78537;16;91506;448768;532831;110;981709;104774;583298;688072;0,574478189906231;0,134123595865203;0,746693122539764;0,880816718404967
"415";"AGES";2021-09-13;2021;37;"All";"18-24 anos";9110;52611;6;61727;457878;585442;116;1043436;60440;637326;697766;0,586140109450507;0,0773706275802477;0,815855602137805;0,893226229718053
"416";"AGES";2021-09-20;2021;38;"All";"18-24 anos";7167;18687;6;25860;465045;604129;122;1069296;47830;657469;705299;0,595314750216021;0,0612282779146798;0,841641117547285;0,902869395461964
"417";"AGES";2021-09-27;2021;39;"All";"18-24 anos";5012;11433;6;16451;470057;615562;128;1085747;40313;670298;710611;0,60173072614971;0,0516055941370372;0,858063814126156;0,909669408263193
"418";"AGES";2021-10-04;2021;40;"All";"18-24 anos";2956;9399;17;12372;473013;624961;145;1098119;33576;680439;714015;0,605514769417864;0,0429814062149966;0,871045540371876;0,914026946586872
"419";"AGES";2021-10-11;2021;41;"All";"18-24 anos";4153;7685;1;11839;477166;632646;146;1109958;28929;689266;718195;0,6108311197875;0,0370326751368131;0,882345185137773;0,919377860274586
"420";"AGES";2021-10-18;2021;42;"All";"18-24 anos";2914;6051;0;8965;480080;638697;146;1118923;24796;696340;721136;0,614561397894198;0,0317419272250136;0,89140077447435;0,923142701699363
"421";"AGES";2021-01-04;2021;1;"All";"25-49 anos";28048;84;0;28132;52156;95;1;52252;52065;98;52163;0,0156551238293401;0,0156278093062081;2,94156402959454e-05;0,0156572249465041
"422";"AGES";2021-01-11;2021;2;"All";"25-49 anos";16918;818;0;17736;69074;913;1;69988;68154;927;69081;0,0207332238551238;0,0204570770278557;0,000278247944432055;0,0207353249722878
"423";"AGES";2021-01-18;2021;3;"All";"25-49 anos";37895;21840;2;59737;106969;22753;3;129725;84169;22808;106977;0,0321077717022141;0,0252641329394839;0,006846040039489;0,0321101729789729
"424";"AGES";2021-01-25;2021;4;"All";"25-49 anos";15871;26312;7;42190;122840;49065;10;171915;73707;49141;122848;0,0368716046321829;0,0221238632580943;0,0147501426508475;0,0368740059089418
"425";"AGES";2021-02-01;2021;5;"All";"25-49 anos";10171;12598;2;22771;133011;61663;12;194686;71277;61748;133025;0,0399245278714693;0,0213944754425928;0,0185342546632044;0,0399287301057973
"426";"AGES";2021-02-08;2021;6;"All";"25-49 anos";13952;30979;5;44936;146963;92642;17;239622;54139;92839;146978;0,0441123545389083;0,0162503403059407;0,0278665166268905;0,0441168569328312
"427";"AGES";2021-02-15;2021;7;"All";"25-49 anos";22500;19099;6;41605;169463;111741;23;281227;57208;112271;169479;0,0508659454231815;0,0171715301025555;0,0336992178741437;0,0508707479766992
"428";"AGES";2021-02-22;2021;8;"All";"25-49 anos";11791;7392;0;19183;181254;119133;23;300410;61372;119898;181270;0,0544051272061355;0,0184213946555383;0,0359885351041149;0,0544099297596532
"429";"AGES";2021-03-01;2021;9;"All";"25-49 anos";7760;10087;6;17853;189014;129220;29;318263;58873;130168;189041;0,0567343656622226;0,0176712958279917;0,039071174143292;0,0567424699712837
"430";"AGES";2021-03-08;2021;10;"All";"25-49 anos";16599;6365;2;22966;205613;135585;31;341229;68976;136684;205660;0,0617167147772471;0,0207038082148278;0,0410270140633775;0,0617308222782053
"431";"AGES";2021-03-15;2021;11;"All";"25-49 anos";4818;3428;4;8250;210431;139013;35;349479;70334;140154;210488;0,0631628837052661;0,0211114249446431;0,0420685678575298;0,0631799928021729
"432";"AGES";2021-03-22;2021;12;"All";"25-49 anos";42577;1830;0;44407;253008;140843;35;393886;110917;142159;253076;0,0759427787754749;0,0332928017827079;0,0426703878452173;0,0759631896279252
"433";"AGES";2021-03-29;2021;13;"All";"25-49 anos";4843;1311;1;6155;257851;142154;36;400041;114404;143541;257945;0,0773964516933654;0,0343394582899728;0,0430852084053091;0,0774246666952819
"434";"AGES";2021-04-05;2021;14;"All";"25-49 anos";9219;1444;1;10664;267070;143598;37;410705;122141;145088;267229;0,0801636229983482;0,0366617930753782;0,0435495552985522;0,0802113483739304
"435";"AGES";2021-04-12;2021;15;"All";"25-49 anos";89472;967;0;90439;356542;144565;37;501144;210513;146206;356719;0,107019502269357;0,0631874967920443;0,0438851337256019;0,107072630517646
"436";"AGES";2021-04-19;2021;16;"All";"25-49 anos";11355;976;2;12333;367897;145541;39;513477;220517;147562;368079;0,110427814468953;0,0661902933789896;0,0442921501362274;0,110482443515217
"437";"AGES";2021-04-26;2021;17;"All";"25-49 anos";11336;1112;2;12450;379233;146653;41;525927;230666;148831;379497;0,113830423636247;0,0692366131071891;0,0446730526621004;0,11390966576929
"438";"AGES";2021-05-03;2021;18;"All";"25-49 anos";10674;8266;2;18942;389907;154919;43;544869;232963;157311;390274;0,117034327151747;0,0699260796965747;0,0472184060264843;0,117144485723059
"439";"AGES";2021-05-10;2021;19;"All";"25-49 anos";25508;100678;8;126194;415415;255597;51;671063;157479;258407;415886;0,124690798097348;0,0472688328384202;0,0775633404281056;0,124832173266526
"440";"AGES";2021-05-17;2021;20;"All";"25-49 anos";33029;22245;8;55282;448444;277842;59;726345;167615;281440;449055;0,134604769355867;0,0503112504918865;0,0844769163764374;0,134788166868324
"441";"AGES";2021-05-24;2021;21;"All";"25-49 anos";26759;18628;5;45392;475203;296470;64;771737;173846;302245;476091;0,142636739954634;0,0521815449274379;0,0907217367474286;0,142903281674867
"442";"AGES";2021-05-31;2021;22;"All";"25-49 anos";42963;24187;13;67163;518166;320657;77;838900;190526;328938;519464;0,155532496628457;0,0571882069696458;0,0987338968129354;0,155922103782581
"443";"AGES";2021-06-07;2021;23;"All";"25-49 anos";128841;32388;19;161248;647007;353045;96;1000148;283744;366667;650411;0,194205358989375;0,0851684840829869;0,11005861816728;0,195227102250266
"444";"AGES";2021-06-14;2021;24;"All";"25-49 anos";240775;85897;30;326702;887782;438942;126;1326850;445819;462676;908495;0,266476285440969;0,133816850419368;0,138876640709865;0,272693491129233
"445";"AGES";2021-06-21;2021;25;"All";"25-49 anos";273400;56785;28;330213;1161182;495727;154;1657063;674271;533298;1207569;0,348539918674759;0,202388910183545;0,160074511617827;0,362463421801372
"446";"AGES";2021-06-28;2021;26;"All";"25-49 anos";315810;62174;79;378063;1476992;557901;233;2035126;927049;613218;1540267;0,443333320326418;0,278262652252202;0,184063266438765;0,462325918690968
"447";"AGES";2021-07-05;2021;27;"All";"25-49 anos";369041;148034;16;517091;1846033;705935;249;2552217;1152541;785144;1937685;0,554104517371887;0,345946239615604;0,235668504944079;0,581614744559682
"448";"AGES";2021-07-12;2021;28;"All";"25-49 anos";208599;317258;66;525923;2054632;1023193;315;3078140;1118073;1123908;2241981;0,616717508699375;0,335600338700087;0,337351769936075;0,672952108636162
"449";"AGES";2021-07-19;2021;29;"All";"25-49 anos";103950;344311;48;448309;2158582;1367504;363;3526449;955578;1484308;2439886;0,647919098584718;0,286825905333866;0,445529287922388;0,732355193256254
"450";"AGES";2021-07-26;2021;30;"All";"25-49 anos";61712;354395;31;416138;2220294;1721899;394;3942587;712066;1852866;2564932;0,666442547502507;0,213733442071149;0,556155507883542;0,769888949954691
"451";"AGES";2021-08-02;2021;31;"All";"25-49 anos";52935;383732;42;436709;2273229;2105631;436;4379296;418641;2251191;2669832;0,68233149565624;0,125659112950356;0,675716578504791;0,801375691455147
"452";"AGES";2021-08-09;2021;32;"All";"25-49 anos";70728;237814;43;308585;2343957;2343445;479;4687881;291794;2508048;2799842;0,703561183481257;0,0875847688215824;0,752814671560869;0,840399440382451
"453";"AGES";2021-08-16;2021;33;"All";"25-49 anos";78149;145593;33;223775;2422106;2489038;512;4911656;252252;2669410;2921662;0,727018355659704;0,0757158581217633;0,801249024106117;0,876964882227881
"454";"AGES";2021-08-23;2021;34;"All";"25-49 anos";88357;79906;22;168285;2510463;2568944;534;5079941;264579;2765647;3030226;0,753539556982448;0,0794159254475605;0,83013548303633;0,909551408483891
"455";"AGES";2021-08-30;2021;35;"All";"25-49 anos";46540;80542;21;127103;2557003;2649486;555;5207044;224677;2859554;3084231;0,767508984527073;0,067438957293593;0,858322570110528;0,925761527404121
"456";"AGES";2021-09-06;2021;36;"All";"25-49 anos";25108;63640;44;88792;2582111;2713126;599;5295836;181929;2929243;3111172;0,775045391634732;0,0546077349326637;0,879240392116488;0,933848127049152
"457";"AGES";2021-09-13;2021;37;"All";"25-49 anos";18792;66768;45;85605;2600903;2779894;644;5381441;131519;3000081;3131600;0,780685990741277;0,0394766897559432;0,900503097496939;0,939979787252882
"458";"AGES";2021-09-20;2021;38;"All";"25-49 anos";16650;32124;43;48817;2617553;2812018;687;5430258;112892;3036367;3149259;0,785683647995639;0,0338856169825496;0,911394688555905;0,945280305538455
"459";"AGES";2021-09-27;2021;39;"All";"25-49 anos";11093;21234;37;32364;2628646;2833252;724;5462622;99772;3061461;3161233;0,789013318381383;0,0299475230980312;0,918926893429236;0,948874416527268
"460";"AGES";2021-10-04;2021;40;"All";"25-49 anos";6244;17425;93;23762;2634890;2850677;817;5486384;88162;3080508;3168670;0,790887514891668;0,0264626702017463;0,92464403323247;0,951106703434216
"461";"AGES";2021-10-11;2021;41;"All";"25-49 anos";8649;16235;4;24888;2643539;2866912;821;5511272;78485;3098929;3177414;0,793483595227582;0,0235580258023191;0,930173273129323;0,953731298931642
"462";"AGES";2021-10-18;2021;42;"All";"25-49 anos";6389;13386;1;19776;2649928;2880298;822;5531048;69843;3114043;3183886;0,795401314879121;0,0209640465835685;0,934709885245985;0,955673931829554
"463";"AGES";2021-01-04;2021;1;"All";"50-64 anos";13020;9;0;13029;22285;11;0;22296;22278;12;22290;0,0102498366051401;0,0102466170019883;5,51931968865518e-06;0,010252136321677
"464";"AGES";2021-01-11;2021;2;"All";"50-64 anos";11720;310;0;12030;34005;321;0;34326;33678;332;34010;0,0156403721677266;0,0154899707062108;0,000152701178052793;0,0156426718842635
"465";"AGES";2021-01-18;2021;3;"All";"50-64 anos";27482;8597;2;36081;61487;8918;2;70407;52541;8951;61492;0,0282805341413617;0,0241658813134693;0,00411695254442937;0,0282828338578987
"466";"AGES";2021-01-25;2021;4;"All";"50-64 anos";10819;12442;2;23263;72306;21360;4;93670;50907;21404;72311;0,0332566607839918;0,0234143339491974;0,00984462655133128;0,0332589605005287
"467";"AGES";2021-02-01;2021;5;"All";"50-64 anos";5594;9234;0;14828;77900;30594;4;108498;47263;30645;77908;0,0358295836455199;0,0217383005370758;0,0140949626549032;0,035833263191979
"468";"AGES";2021-02-08;2021;6;"All";"50-64 anos";6926;22310;3;29239;84826;52904;7;137737;31823;53011;84834;0,0390151509924887;0,0146367758710061;0,0243820546679416;0,0390188305389478
"469";"AGES";2021-02-15;2021;7;"All";"50-64 anos";25171;12998;1;38170;109997;65902;8;175907;43879;66126;110005;0,0505923839827503;0,020181852384875;0,0304142111443344;0,0505960635292094
"470";"AGES";2021-02-22;2021;8;"All";"50-64 anos";49907;4972;3;54882;159904;70874;11;230789;88636;71276;159912;0,0735467746245598;0,0407675349936367;0,0327829191773822;0,0735504541710189
"471";"AGES";2021-03-01;2021;9;"All";"50-64 anos";30273;6010;3;36286;190177;76884;14;267075;112817;77375;190192;0,0874706383691146;0,0518894241095843;0,0355881134091412;0,0874775375187254
"472";"AGES";2021-03-08;2021;10;"All";"50-64 anos";22485;4304;1;26790;212662;81188;15;293865;130936;81752;212688;0,0978124636357323;0,0602231368961462;0,0376012852655782;0,0978244221617244
"473";"AGES";2021-03-15;2021;11;"All";"50-64 anos";4840;2351;1;7192;217502;83539;16;301057;133419;84128;217547;0,10003858924349;0,0613651761283904;0,0386941105639319;0,100059286692322
"474";"AGES";2021-03-22;2021;12;"All";"50-64 anos";34761;1019;2;35782;252263;84558;18;336839;167032;85285;252317;0,116026678551602;0,076825250519621;0,0392262649705797;0,116051515490201
"475";"AGES";2021-03-29;2021;13;"All";"50-64 anos";7903;832;1;8736;260166;85390;19;345575;174101;86141;260242;0,119661610509889;0,0800765897595462;0,0396199764417038;0,11969656620125
"476";"AGES";2021-04-05;2021;14;"All";"50-64 anos";15288;999;1;16288;275454;86389;20;361863;188348;87227;275575;0,126693223793235;0,0866294020599021;0,0401194748735271;0,126748876933429
"477";"AGES";2021-04-12;2021;15;"All";"50-64 anos";88105;653;0;88758;363559;87042;20;450621;275715;87978;363693;0,167216528890649;0,126813268996464;0,0404648922973754;0,167278161293839
"478";"AGES";2021-04-19;2021;16;"All";"50-64 anos";14566;1877;2;16445;378125;88919;22;467066;288153;90108;378261;0,173916063106062;0,132534043853755;0,0414445715421117;0,173978615395866
"479";"AGES";2021-04-26;2021;17;"All";"50-64 anos";33079;3003;4;36086;411204;91922;26;503152;318352;93255;411607;0,189130527771147;0,146423871793563;0,0428920131304615;0,189315884924024
"480";"AGES";2021-05-03;2021;18;"All";"50-64 anos";151646;14935;6;166587;562850;106857;32;669739;460358;108564;568922;0,258879090563297;0,211738581102493;0,0499332852232634;0,261671866325757
"481";"AGES";2021-05-10;2021;19;"All";"50-64 anos";166814;110014;9;276837;729664;216871;41;946576;526244;219223;745467;0,335604073441908;0,242042405853055;0,100830151675504;0,342872557528559
"482";"AGES";2021-05-17;2021;20;"All";"50-64 anos";224863;76006;13;300882;954527;292877;54;1247458;689877;298712;988589;0,43902830537108;0,317304309070864;0,137390585236464;0,454694894307328
"483";"AGES";2021-05-24;2021;21;"All";"50-64 anos";175374;98734;71;274179;1129901;391611;125;1521637;801291;406829;1208120;0,519690402960931;0,368548432720183;0,187118275801325;0,555666708521508
"484";"AGES";2021-05-31;2021;22;"All";"50-64 anos";163794;169178;12;332984;1293695;560789;137;1854621;837632;584266;1421898;0,59502635705123;0,385263232453968;0,268729236434317;0,653992468888285
"485";"AGES";2021-06-07;2021;23;"All";"50-64 anos";210056;139586;30;349672;1503751;700375;167;2204293;920626;734921;1655547;0,691640208427909;0,423435767307322;0,338021995408846;0,761457762716168
"486";"AGES";2021-06-14;2021;24;"All";"50-64 anos";86413;231588;26;318027;1590164;931963;193;2522320;785311;973181;1758492;0,731385289449223;0,361198538668124;0,447608087827094;0,808806626495218
"487";"AGES";2021-06-21;2021;25;"All";"50-64 anos";86620;184243;35;270898;1676784;1116206;228;2793218;695835;1165408;1861243;0,771225578735165;0,320044651296281;0,536021609976354;0,856066261272636
"488";"AGES";2021-06-28;2021;26;"All";"50-64 anos";59429;179249;51;238729;1736213;1295455;279;3031947;575470;1352210;1927680;0,798559549549922;0,264683575102533;0,621939939683035;0,886623514785568
"489";"AGES";2021-07-05;2021;27;"All";"50-64 anos";41422;258541;32;299995;1777635;1553996;311;3331942;357910;1618219;1976129;0,817611321228545;0,164618309147215;0,744288998937991;0,908907308085205
"490";"AGES";2021-07-12;2021;28;"All";"50-64 anos";15431;134797;28;150256;1793066;1688793;339;3482198;243462;1759245;2002707;0,824708706404849;0,111978717503281;0,809152963805681;0,921131681308962
"491";"AGES";2021-07-19;2021;29;"All";"50-64 anos";10954;115205;21;126180;1804020;1803998;360;3608378;151014;1881149;2032163;0,829746925393976;0,0694578786218811;0,8652218927495;0,934679771371381
"492";"AGES";2021-07-26;2021;30;"All";"50-64 anos";9865;87517;22;97404;1813885;1891515;382;3705782;83322;1975427;2058749;0,834284266121358;0,0383233962581772;0,908584427883419;0,946907824141596
"493";"AGES";2021-08-02;2021;31;"All";"50-64 anos";8633;54068;14;62715;1822518;1945583;396;3768497;46351;2035646;2081997;0,838254956694038;0,021318832240738;0,936281753911013;0,957600586151751
"494";"AGES";2021-08-09;2021;32;"All";"50-64 anos";7382;24444;6;31832;1829900;1970027;402;3800329;35191;2065334;2100525;0,841650258189176;0,0161858649302887;0,949936550820746;0,966122415751035
"495";"AGES";2021-08-16;2021;33;"All";"50-64 anos";7547;13085;13;20645;1837447;1983112;415;3820974;32966;2082654;2115620;0,845121450330032;0,0151624910713505;0,957902768904705;0,973065259976055
"496";"AGES";2021-08-23;2021;34;"All";"50-64 anos";11305;8273;3;19581;1848752;1991385;418;3840555;36182;2095719;2131901;0,850321109420053;0,0166416687479101;0,963911928215728;0,980553596963638
"497";"AGES";2021-08-30;2021;35;"All";"50-64 anos";12904;6139;11;19054;1861656;1997524;429;3859609;40622;2107284;2147906;0,856256217858587;0,0186838170327125;0,96923117256567;0,987914989598382
"498";"AGES";2021-09-06;2021;36;"All";"50-64 anos";5593;4012;24;9629;1867249;2001536;453;3869238;40524;2113609;2154133;0,858828680776807;0,0186387425885885;0,972140313984898;0,990779056573487
"499";"AGES";2021-09-13;2021;37;"All";"50-64 anos";3668;7359;34;11061;1870917;2008895;487;3880299;36100;2122169;2158269;0,860515752828306;0,0166039533967043;0,976077428696139;0,992681382092843
"500";"AGES";2021-09-20;2021;38;"All";"50-64 anos";3259;6590;46;9895;1874176;2015485;533;3890194;32019;2129846;2161865;0,862014708067084;0,0147269247592542;0,979608413466956;0,99433533822621
"501";"AGES";2021-09-27;2021;39;"All";"50-64 anos";2018;5013;35;7066;1876194;2020498;568;3897260;28565;2135549;2164114;0,862942873661393;0,0131382805755363;0,982231470148989;0,995369750724526
"502";"AGES";2021-10-04;2021;40;"All";"50-64 anos";1013;3840;74;4927;1877207;2024338;642;3902187;25762;2139668;2165430;0,863408796231776;0,0118490594849279;0,98412597663212;0,995975036117048
"503";"AGES";2021-10-11;2021;41;"All";"50-64 anos";1329;3407;1;4737;1878536;2027745;643;3906924;23442;2143361;2166803;0,864020060887295;0,0107819910117879;0,985824547266304;0,996606538278092
"504";"AGES";2021-10-18;2021;42;"All";"50-64 anos";1142;3292;1;4435;1879678;2031037;644;3911359;21053;2146914;2167967;0,864545316144332;0,00968318645043812;0,987458725837453;0,997141912287891
"505";"AGES";2021-01-04;2021;1;"All";"65-79 anos";2318;3;0;2321;3289;5;0;3294;3285;5;3290;0,00202019829760365;0,00201774138267801;3,07114365704416e-06;0,00202081252633506
"506";"AGES";2021-01-11;2021;2;"All";"65-79 anos";5565;30;0;5595;8854;35;0;8889;8811;44;8855;0,0054383811878938;0,00541196935244322;2,70260641819886e-05;0,00543899541662521
"507";"AGES";2021-01-18;2021;3;"All";"65-79 anos";14169;918;0;15087;23023;953;0;23976;22041;983;23024;0,0141413880832255;0,0135382154689821;0,000603786842974882;0,0141420023119569
"508";"AGES";2021-01-25;2021;4;"All";"65-79 anos";6635;2162;0;8797;29658;3115;0;32773;26498;3161;29659;0,0182167957161231;0,0162758329248712;0,00194157701998332;0,0182174099448545
"509";"AGES";2021-02-01;2021;5;"All";"65-79 anos";2850;4190;0;7040;32508;7305;0;39813;25157;7352;32509;0,0199673476006383;0,015452152196052;0,00451580963331773;0,0199679618293697
"510";"AGES";2021-02-08;2021;6;"All";"65-79 anos";3817;11572;1;15390;36325;18877;1;55203;17379;18947;36326;0,0223118586684258;0,0106746811231541;0,0116377917740031;0,0223124728971572
"511";"AGES";2021-02-15;2021;7;"All";"65-79 anos";5174;7300;0;12474;41499;26177;1;67677;15221;26279;41500;0,0254898781247351;0,00934917552077383;0,0161413168326927;0,0254904923534665
"512";"AGES";2021-02-22;2021;8;"All";"65-79 anos";11703;2492;3;14198;53202;28669;4;81875;24378;28825;53203;0,0326781969684127;0,0149736680142845;0,0177051431828596;0,0326788111971441
"513";"AGES";2021-03-01;2021;9;"All";"65-79 anos";13357;3838;0;17195;66559;32507;4;99070;33889;32681;66570;0,0408824501338404;0,0208155974787139;0,020073609171172;0,0408892066498859
"514";"AGES";2021-03-08;2021;10;"All";"65-79 anos";16004;3608;0;19612;82563;36115;4;118682;46278;36314;82592;0,0507125667513074;0,0284252772321379;0,0223051021523803;0,0507303793845182
"515";"AGES";2021-03-15;2021;11;"All";"65-79 anos";18212;6876;3;25091;100775;42991;7;143773;57610;43202;100812;0,061898900407725;0,0353857172164628;0,0265359096543244;0,0619216268707872
"516";"AGES";2021-03-22;2021;12;"All";"65-79 anos";52915;2252;1;55168;153690;45243;8;198941;108216;45521;153737;0,0944008137302234;0,0664693763981381;0,0279603060824614;0,0944296824805996
"517";"AGES";2021-03-29;2021;13;"All";"65-79 anos";88368;7465;0;95833;242058;52708;8;294774;189094;53028;242122;0,148678978267359;0,116146967737022;0,0325713211691475;0,148718288906169
"518";"AGES";2021-04-05;2021;14;"All";"65-79 anos";201468;5405;4;206877;443526;58113;12;501651;385058;58551;443609;0,272426412326834;0,236513686858822;0,0359637064527185;0,27247739331154
"519";"AGES";2021-04-12;2021;15;"All";"65-79 anos";233810;3690;3;237503;677336;61803;15;739154;615045;62378;677423;0,416039232017533;0,377778310109345;0,0383143598078201;0,416092669917165
"520";"AGES";2021-04-19;2021;16;"All";"65-79 anos";175916;13346;10;189272;853252;75149;25;928426;777429;75913;853342;0,524091893532049;0,477519228430437;0,0466279456874387;0,524147174117875
"521";"AGES";2021-04-26;2021;17;"All";"65-79 anos";293314;46485;5;339804;1146566;121634;30;1268230;1025019;122642;1147661;0,704253779656499;0,629596120039949;0,075330240077442;0,704926360117391
"522";"AGES";2021-05-03;2021;18;"All";"65-79 anos";202499;164551;7;367057;1349065;286185;37;1635287;1069214;287487;1356701;0,828634483538056;0,656741958824563;0,176582775306531;0,833324734131094
"523";"AGES";2021-05-10;2021;19;"All";"65-79 anos";91567;80380;7;171954;1440632;366565;44;1807241;1087772;368330;1456102;0,884877565786968;0,668140815622048;0,226238868639815;0,894379684261863
"524";"AGES";2021-05-17;2021;20;"All";"65-79 anos";41346;111889;8;153243;1481978;478454;52;1960484;1016974;485671;1502645;0,910273466915798;0,624654649895765;0,298313082212059;0,922967732107824
"525";"AGES";2021-05-24;2021;21;"All";"65-79 anos";23638;202859;21;226518;1505616;681313;73;2187002;833548;697375;1530923;0,92479260566884;0,511989130608369;0,428347761566234;0,940336892174603
"526";"AGES";2021-05-31;2021;22;"All";"65-79 anos";18700;137718;15;156433;1524316;819031;88;2343435;717107;838233;1555340;0,936278682946185;0,440467722894393;0,514866792215019;0,955334515109413
"527";"AGES";2021-06-07;2021;23;"All";"65-79 anos";16103;71849;5;87957;1540419;890880;93;2431392;660614;912952;1573566;0,946169608208061;0,405768099170914;0,560761348797156;0,96652944796807
"528";"AGES";2021-06-14;2021;24;"All";"65-79 anos";10902;62775;7;73684;1551321;953655;100;2505076;608008;977819;1585827;0,95286592983788;0,373455982526421;0,600604523917453;0,974060506443874
"529";"AGES";2021-06-21;2021;25;"All";"65-79 anos";10324;97372;9;107705;1561645;1051027;109;2612781;520277;1077797;1598074;0,959207227260945;0,319569081691193;0,662013884026245;0,981582965717438
"530";"AGES";2021-06-28;2021;26;"All";"65-79 anos";9061;182576;28;191665;1570706;1233603;137;2804446;345312;1263214;1608526;0,964772753796241;0,212100551700247;0,775902332717876;0,988002884418123
"531";"AGES";2021-07-05;2021;27;"All";"65-79 anos";8153;204277;19;212449;1578859;1437880;156;3016895;147308;1470469;1617777;0,969780560643417;0,0904808059663722;0,903204308446014;0,993685114412386
"532";"AGES";2021-07-12;2021;28;"All";"65-79 anos";5487;57914;10;63411;1584346;1495794;166;3080306;93870;1531667;1625537;0,973150833692657;0,057657651017347;0,940793878350771;0,998451529368118
"533";"AGES";2021-07-19;2021;29;"All";"65-79 anos";7156;42680;5;49841;1591502;1538474;171;3130147;56031;1579400;1635431;0,977546254494619;0,0344158500495683;0,970112858387109;1
"534";"AGES";2021-07-26;2021;30;"All";"65-79 anos";8636;32468;10;41114;1600138;1570942;181;3171261;28348;1617935;1646283;0,982850733819065;0,0174121560779776;0,993782162551948;1
"535";"AGES";2021-08-02;2021;31;"All";"65-79 anos";7637;11752;6;19395;1607775;1582694;187;3190656;20463;1635270;1655733;0,987541598640835;0,0125689625308189;1;1
"536";"AGES";2021-08-09;2021;32;"All";"65-79 anos";4610;6295;4;10909;1612385;1588989;191;3201565;17162;1644643;1661805;0,990373193092629;0,0105413934884384;1;1
"537";"AGES";2021-08-16;2021;33;"All";"65-79 anos";3693;2997;6;6696;1616078;1591986;197;3208261;16821;1649834;1666655;0,992641539797722;0,010331941491028;1;1
"538";"AGES";2021-08-23;2021;34;"All";"65-79 anos";4309;2519;2;6830;1620387;1594505;199;3215091;17822;1654483;1672305;0,995288251401363;0,0109467844511682;1;1
"539";"AGES";2021-08-30;2021;35;"All";"65-79 anos";4909;2251;3;7163;1625296;1596756;202;3222254;19347;1659037;1678384;0,998303500243849;0,0118834832665667;1;1
"540";"AGES";2021-09-06;2021;36;"All";"65-79 anos";2257;1384;7;3648;1627553;1598140;209;3225902;19481;1661373;1680854;0,999689814490639;0,0119657899165755;1;1
"541";"AGES";2021-09-13;2021;37;"All";"65-79 anos";1643;3291;24;4958;1629196;1601431;233;3230860;17455;1665186;1682641;1,00069899229634;0,0107213625067412;1;1
"542";"AGES";2021-09-20;2021;38;"All";"65-79 anos";1416;3371;36;4823;1630612;1604802;269;3235683;15143;1668992;1684135;1,00156874018002;0,00930126567972394;1;1
"543";"AGES";2021-09-27;2021;39;"All";"65-79 anos";901;2728;21;3650;1631513;1607530;290;3239333;13123;1671970;1685093;1,00212216026702;0,0080605236422781;1;1
"544";"AGES";2021-10-04;2021;40;"All";"65-79 anos";464;2220;24;2708;1631977;1609750;314;3242041;11389;1674284;1685673;1,00240716239839;0,00699545102201519;1;1
"545";"AGES";2021-10-11;2021;41;"All";"65-79 anos";577;2078;0;2655;1632554;1611828;314;3244696;9830;1676435;1686265;1,00276157237641;0,00603786842974882;1;1
"546";"AGES";2021-10-18;2021;42;"All";"65-79 anos";500;1994;0;2494;1633054;1613822;314;3247190;8274;1678502;1686776;1,00306868674212;0,00508212852367667;1;1
"547";"AGES";2021-01-04;2021;1;"All";"80 ou mais anos";3784;8;1;3793;4052;8;2;4062;4043;9;4052;0,00594492290086416;0,00593171848178524;1,32044190789184e-05;0,00594492290086416
"548";"AGES";2021-01-11;2021;2;"All";"80 ou mais anos";14508;1;1;14510;18560;9;3;18572;18526;34;18560;0,0272304464560806;0,0271805630951158;4,98833609648029e-05;0,0272304464560806
"549";"AGES";2021-01-18;2021;3;"All";"80 ou mais anos";39067;255;1;39323;57627;264;4;57895;57227;400;57627;0,0845478953623146;0,0839610322921404;0,000586863070174152;0,0845478953623146
"550";"AGES";2021-01-25;2021;4;"All";"80 ou mais anos";7389;3400;1;10790;65016;3664;5;68685;61184;3832;65016;0,0953887234261066;0,0897665752138382;0,00562214821226837;0,0953887234261066
"551";"AGES";2021-02-01;2021;5;"All";"80 ou mais anos";4547;10666;0;15213;69563;14330;5;83898;55057;14506;69563;0,102059889376311;0,0807773001364457;0,0212825892398656;0,102059889376311
"552";"AGES";2021-02-08;2021;6;"All";"80 ou mais anos";14829;31603;0;46432;84392;45933;5;130330;38184;46208;84392;0,123816370545343;0,0560219486788245;0,067794421866518;0,123816370545343
"553";"AGES";2021-02-15;2021;7;"All";"80 ou mais anos";48632;9293;0;57925;133024;55226;5;188255;77449;55575;133024;0,195167182617116;0,113629894804795;0,0815372878123212;0,195167182617116
"554";"AGES";2021-02-22;2021;8;"All";"80 ou mais anos";102568;5210;0;107778;235592;60436;5;296033;174676;60916;235592;0,345650611071172;0,25627723411435;0,0893733769568215;0,345650611071172
"555";"AGES";2021-03-01;2021;9;"All";"80 ou mais anos";87230;12791;0;100021;322822;73227;5;396054;249063;73760;322823;0,4736307750994;0,365414692116962;0,108217550140114;0,473632242257075
"556";"AGES";2021-03-08;2021;10;"All";"80 ou mais anos";40165;37316;0;77481;362987;110543;5;473535;251890;111099;362989;0,532559163133262;0,369562346865418;0,162999750583195;0,532562097448613
"557";"AGES";2021-03-15;2021;11;"All";"80 ou mais anos";54382;97474;0;151856;417369;208017;5;625391;208751;208620;417371;0,612346131838789;0,306270631904811;0,306078434249329;0,61234906615414
"558";"AGES";2021-03-22;2021;12;"All";"80 ou mais anos";124569;16934;2;141505;541938;224951;7;766896;316268;225672;541940;0,795108496310099;0,464015023694596;0,331096406930853;0,795111430625449
"559";"AGES";2021-03-29;2021;13;"All";"80 ou mais anos";36742;75535;3;112280;578680;300486;10;879176;277439;301245;578684;0,849014803620945;0,407046758315116;0,441973913936531;0,849020672251647
"560";"AGES";2021-04-05;2021;14;"All";"80 ou mais anos";30371;45923;1;76295;609051;346409;11;955471;261823;347233;609056;0,893573849381593;0,384135624055517;0,509445561114453;0,89358118516997
"561";"AGES";2021-04-12;2021;15;"All";"80 ou mais anos";10514;49538;5;60057;619565;395947;16;1015528;222730;396840;619570;0,908999545181121;0,326780029049722;0,582226851919776;0,909006880969498
"562";"AGES";2021-04-19;2021;16;"All";"80 ou mais anos";8412;123370;4;131786;627977;519317;20;1147314;107676;520306;627982;0,921341275546883;0,15797766986018;0,76337094147508;0,92134861133526
"563";"AGES";2021-04-26;2021;17;"All";"80 ou mais anos";6136;39872;0;46008;634113;559189;20;1193322;73901;560228;634129;0,930343755043355;0,10842441937235;0,821942810193812;0,930367229566161
"564";"AGES";2021-05-03;2021;18;"All";"80 ou mais anos";5109;31868;1;36978;639222;591057;21;1230300;47197;592190;639387;0,937839463607154;0,0692454408075236;0,868836103816077;0,938081544623601
"565";"AGES";2021-05-10;2021;19;"All";"80 ou mais anos";3783;9994;1;13778;643005;601051;22;1244078;41059;602312;643371;0,943389721093326;0,0602400269957012;0,883686673806834;0,943926700802535
"566";"AGES";2021-05-17;2021;20;"All";"80 ou mais anos";4755;8393;3;13151;647760;609444;25;1257229;36364;612199;648563;0,950366055840021;0,0533517217095321;0,898192461743864;0,951544183453396
"567";"AGES";2021-05-24;2021;21;"All";"80 ou mais anos";4456;6384;0;10840;652216;615828;25;1268069;32612;620883;653495;0,956903710441761;0,0478469461112986;0,910933258997344;0,958780205108643
"568";"AGES";2021-05-31;2021;22;"All";"80 ou mais anos";3056;6170;2;9228;655272;621998;27;1277297;29099;628053;657152;0,961387344297892;0,0426928211974941;0,921452779530216;0,96414560072771
"569";"AGES";2021-06-07;2021;23;"All";"80 ou mais anos";2754;4833;1;7588;658026;626831;28;1284885;26537;633747;660284;0,965427896536041;0,0389339632330287;0,929806775334145;0,968740738567174
"570";"AGES";2021-06-14;2021;24;"All";"80 ou mais anos";2630;4795;0;7425;660656;631626;28;1292310;23698;639488;663186;0,969286521222436;0,0347687025924676;0,93822972754882;0,972998430141287
"571";"AGES";2021-06-21;2021;25;"All";"80 ou mais anos";3401;4834;2;8237;664057;636460;30;1300547;20944;646107;667051;0,974276324476592;0,0307281503543186;0,947940844202526;0,978668994556845
"572";"AGES";2021-06-28;2021;26;"All";"80 ou mais anos";3274;5435;1;8710;667331;641895;31;1309257;17414;653333;670747;0,979079798705967;0,0255490837600317;0,958542525565222;0,984091609325254
"573";"AGES";2021-07-05;2021;27;"All";"80 ou mais anos";2669;5267;1;7937;670000;647162;32;1317194;13655;660093;673748;0,982995642541704;0,0200340380580701;0,968460511451166;0,988494549509236
"574";"AGES";2021-07-12;2021;28;"All";"80 ou mais anos";2107;3560;2;5669;672107;650722;34;1322863;11271;665082;676353;0,986086943763846;0,0165363341598322;0,975780161093913;0,992316495253745
"575";"AGES";2021-07-19;2021;29;"All";"80 ou mais anos";2208;3091;1;5300;674315;653813;35;1328163;9406;669755;679161;0,989326427911208;0,0138000850951452;0,982636188911222;0,996436274006367
"576";"AGES";2021-07-26;2021;30;"All";"80 ou mais anos";2597;2894;1;5492;676912;656707;36;1333655;7750;674514;682264;0,993136636394313;0,0113704719846242;0,989618392288619;1
"577";"AGES";2021-08-02;2021;31;"All";"80 ou mais anos";2493;2103;1;4597;679405;658810;37;1338252;6771;678445;685216;0,996794260479174;0,00993412462037295;0,995385789110756;1
"578";"AGES";2021-08-09;2021;32;"All";"80 ou mais anos";1581;1723;1;3305;680986;660533;38;1341557;5976;681250;687226;0,999113836764037;0,00876773426840182;0,999501166390352;1
"579";"AGES";2021-08-16;2021;33;"All";"80 ou mais anos";1348;1129;1;2478;682334;661662;39;1344035;5618;683267;688885;1,00109156531052;0,00824249182059596;1;1
"580";"AGES";2021-08-23;2021;34;"All";"80 ou mais anos";1537;973;0;2510;683871;662635;39;1346545;5743;685056;690799;1,00334658665767;0,00842588653002538;1;1
"581";"AGES";2021-08-30;2021;35;"All";"80 ou mais anos";1668;821;0;2489;685539;663456;39;1349034;6141;686645;692786;1,00579380566029;0,00900981528484866;1;1
"582";"AGES";2021-09-06;2021;36;"All";"80 ou mais anos";768;575;3;1346;686307;664031;42;1350380;6074;687552;693626;1,00692058275503;0,00891151572059449;1;1
"583";"AGES";2021-09-13;2021;37;"All";"80 ou mais anos";551;960;3;1514;686858;664991;45;1351894;5539;688680;694219;1,00772898663419;0,00812658636423656;1;1
"584";"AGES";2021-09-20;2021;38;"All";"80 ou mais anos";599;1046;1;1646;687457;666037;46;1353540;4913;689925;694838;1,00860781408178;0,00720814565941402;1;1
"585";"AGES";2021-09-27;2021;39;"All";"80 ou mais anos";367;796;6;1169;687824;666833;52;1354709;4410;690824;695234;1,00914626094866;0,00647016534867002;1;1
"586";"AGES";2021-10-04;2021;40;"All";"80 ou mais anos";167;573;2;742;687991;667406;54;1355451;4006;691429;695435;1,00939127628046;0,00587743364779413;1;1
"587";"AGES";2021-10-11;2021;41;"All";"80 ou mais anos";237;781;0;1018;688228;668187;54;1356469;3398;692276;695674;1,00973899264954;0,00498540178112942;1;1
"588";"AGES";2021-10-18;2021;42;"All";"80 ou mais anos";264;711;0;975;688492;668898;54;1357444;2902;693038;695940;1,01012632227585;0,00425769157411347;1;1
"589";"AGES";2021-01-04;2021;1;"All";"Desconhecido";1;0;0;1;2;0;0;2;2;0;2;NA;NA;NA;NA
"590";"AGES";2021-01-11;2021;2;"All";"Desconhecido";1;0;0;1;3;0;0;3;3;0;3;NA;NA;NA;NA
"591";"AGES";2021-01-18;2021;3;"All";"Desconhecido";1;1;0;2;4;1;0;5;3;1;4;NA;NA;NA;NA
"592";"AGES";2021-01-25;2021;4;"All";"Desconhecido";1;1;0;2;5;2;0;7;3;2;5;NA;NA;NA;NA
"593";"AGES";2021-02-01;2021;5;"All";"Desconhecido";0;1;0;1;5;3;0;8;2;3;5;NA;NA;NA;NA
"594";"AGES";2021-02-08;2021;6;"All";"Desconhecido";2;1;0;3;7;4;0;11;3;4;7;NA;NA;NA;NA
"595";"AGES";2021-02-15;2021;7;"All";"Desconhecido";2;1;0;3;9;5;0;14;4;5;9;NA;NA;NA;NA
"596";"AGES";2021-02-22;2021;8;"All";"Desconhecido";3;1;0;4;12;6;0;18;6;6;12;NA;NA;NA;NA
"597";"AGES";2021-03-01;2021;9;"All";"Desconhecido";1;1;0;2;13;7;0;20;6;7;13;NA;NA;NA;NA
"598";"AGES";2021-03-08;2021;10;"All";"Desconhecido";2;1;0;3;15;8;0;23;7;8;15;NA;NA;NA;NA
"599";"AGES";2021-03-15;2021;11;"All";"Desconhecido";1;2;0;3;16;10;0;26;6;10;16;NA;NA;NA;NA
"600";"AGES";2021-03-22;2021;12;"All";"Desconhecido";2;2;0;4;18;12;0;30;6;12;18;NA;NA;NA;NA
"601";"AGES";2021-03-29;2021;13;"All";"Desconhecido";2;0;0;2;20;12;0;32;8;12;20;NA;NA;NA;NA
"602";"AGES";2021-04-05;2021;14;"All";"Desconhecido";3;1;0;4;23;13;0;36;10;13;23;NA;NA;NA;NA
"603";"AGES";2021-04-12;2021;15;"All";"Desconhecido";3;1;0;4;26;14;0;40;12;14;26;NA;NA;NA;NA
"604";"AGES";2021-04-19;2021;16;"All";"Desconhecido";2;1;0;3;28;15;0;43;13;15;28;NA;NA;NA;NA
"605";"AGES";2021-04-26;2021;17;"All";"Desconhecido";3;1;0;4;31;16;0;47;15;16;31;NA;NA;NA;NA
"606";"AGES";2021-05-03;2021;18;"All";"Desconhecido";2;2;0;4;33;18;0;51;15;18;33;NA;NA;NA;NA
"607";"AGES";2021-05-10;2021;19;"All";"Desconhecido";2;4;0;6;35;22;0;57;14;22;36;NA;NA;NA;NA
"608";"AGES";2021-05-17;2021;20;"All";"Desconhecido";3;2;0;5;38;24;0;62;16;24;40;NA;NA;NA;NA
"609";"AGES";2021-05-24;2021;21;"All";"Desconhecido";3;2;0;5;41;26;0;67;17;26;43;NA;NA;NA;NA
"610";"AGES";2021-05-31;2021;22;"All";"Desconhecido";3;3;0;6;44;29;0;73;18;29;47;NA;NA;NA;NA
"611";"AGES";2021-06-07;2021;23;"All";"Desconhecido";2;3;0;5;46;32;0;78;18;32;50;NA;NA;NA;NA
"612";"AGES";2021-06-14;2021;24;"All";"Desconhecido";2;4;0;6;48;36;0;84;17;36;53;NA;NA;NA;NA
"613";"AGES";2021-06-21;2021;25;"All";"Desconhecido";2;4;0;6;50;40;0;90;16;40;56;NA;NA;NA;NA
"614";"AGES";2021-06-28;2021;26;"All";"Desconhecido";1;4;0;5;51;44;0;95;14;44;58;NA;NA;NA;NA
"615";"AGES";2021-07-05;2021;27;"All";"Desconhecido";2;4;0;6;53;48;0;101;13;48;61;NA;NA;NA;NA
"616";"AGES";2021-07-12;2021;28;"All";"Desconhecido";3;3;0;6;56;51;0;107;14;51;65;NA;NA;NA;NA
"617";"AGES";2021-07-19;2021;29;"All";"Desconhecido";3;4;0;7;59;55;0;114;14;55;69;NA;NA;NA;NA
"618";"AGES";2021-07-26;2021;30;"All";"Desconhecido";3;4;0;7;62;59;0;121;14;59;73;NA;NA;NA;NA
"619";"AGES";2021-08-02;2021;31;"All";"Desconhecido";3;2;0;5;65;61;0;126;16;61;77;NA;NA;NA;NA
"620";"AGES";2021-08-09;2021;32;"All";"Desconhecido";3;3;0;6;68;64;0;132;17;64;81;NA;NA;NA;NA
"621";"AGES";2021-08-16;2021;33;"All";"Desconhecido";2;3;0;5;70;67;0;137;17;67;84;NA;NA;NA;NA
"622";"AGES";2021-08-23;2021;34;"All";"Desconhecido";3;3;1;7;73;70;1;144;18;70;88;NA;NA;NA;NA
"623";"AGES";2021-08-30;2021;35;"All";"Desconhecido";2;3;0;5;75;73;1;149;18;73;91;NA;NA;NA;NA
"624";"AGES";2021-09-06;2021;36;"All";"Desconhecido";2;3;0;5;77;76;1;154;17;76;93;NA;NA;NA;NA
"625";"AGES";2021-09-13;2021;37;"All";"Desconhecido";2;3;0;5;79;79;1;159;17;79;96;NA;NA;NA;NA
"626";"AGES";2021-09-20;2021;38;"All";"Desconhecido";0;2;0;2;79;81;1;161;16;81;97;NA;NA;NA;NA
"627";"AGES";2021-09-27;2021;39;"All";"Desconhecido";2;1;0;3;81;82;1;164;17;82;99;NA;NA;NA;NA
"628";"AGES";2021-10-04;2021;40;"All";"Desconhecido";1;3;0;4;82;85;1;168;16;85;101;NA;NA;NA;NA
"629";"AGES";2021-10-11;2021;41;"All";"Desconhecido";1;1;0;2;83;86;1;170;16;86;102;NA;NA;NA;NA
"630";"AGES";2021-10-18;2021;42;"All";"Desconhecido";0;1;0;1;83;87;1;171;15;87;102;NA;NA;NA;NA
"631";"GENERAL";2021-01-04;2021;1;"All";"All";49031;108;1;49140;85017;124;3;85144;84900;130;85030;0,00821587623836816;0,0082045695876996;1,25629451872903e-05;0,00821713253288689
"632";"GENERAL";2021-01-11;2021;2;"All";"All";50175;1217;1;51393;135192;1341;4;136537;133804;1402;135206;0,0130646898904627;0,0129305562910784;0,000135486531942931;0,0130660428230213
"633";"GENERAL";2021-01-18;2021;3;"All";"All";122559;32814;5;155378;257751;34155;9;291915;223353;34414;257767;0,0249085514228405;0,0215843961262835;0,00332570150519545;0,024910097631479
"634";"GENERAL";2021-01-25;2021;4;"All";"All";42131;45968;11;88110;299882;80123;20;380025;219437;80463;299900;0,0289800086819615;0,0212059615620264;0,00777578660465339;0,0289817481666797
"635";"GENERAL";2021-02-01;2021;5;"All";"All";24199;37639;2;61840;324081;117762;22;441865;205980;118129;324109;0,0313185526095556;0,019905503459062;0,0114157550156109;0,0313212584746729
"636";"GENERAL";2021-02-08;2021;6;"All";"All";41051;99608;9;140668;365132;217370;31;582533;147122;218039;365161;0,0352856407855822;0,0142175817064964;0,021070861582243;0,0352884432887394
"637";"GENERAL";2021-02-15;2021;7;"All";"All";103844;50458;8;154310;468976;267828;39;736843;199914;269092;469006;0,0453209214011897;0,0193192971090151;0,0260045234333717;0,0453238205423868
"638";"GENERAL";2021-02-22;2021;8;"All";"All";177337;20807;6;198150;646313;288635;45;934993;355817;290526;646343;0,0624584214833321;0,0343854574438929;0,0280758631806362;0,0624613206245291
"639";"GENERAL";2021-03-01;2021;9;"All";"All";139594;33806;10;173410;785907;322441;55;1108403;461268;324700;785968;0,0759485120254444;0,0445760353896233;0,0313783715562551;0,0759544069458784
"640";"GENERAL";2021-03-08;2021;10;"All";"All";96675;52267;4;148946;882582;374708;59;1257349;505444;377252;882696;0,0852909945329928;0,0488451174403444;0,0364568938291973;0,0853020112695417
"641";"GENERAL";2021-03-15;2021;11;"All";"All";82546;110557;9;193112;965128;485265;68;1450461;477343;487937;965280;0,0932680781747626;0,0461294918810517;0,047153275275776;0,0932827671568277
"642";"GENERAL";2021-03-22;2021;12;"All";"All";258167;22230;5;280402;1223295;507495;73;1730863;712796;510682;1223478;0,118216831022202;0,0688832082901522;0,0493513074933523;0,118234515783505
"643";"GENERAL";2021-03-29;2021;13;"All";"All";138569;85266;5;223840;1361864;592761;78;1954703;765979;596138;1362117;0,131607867573415;0,0740227091662727;0,0576096078312375;0,13163231699751
"644";"GENERAL";2021-04-05;2021;14;"All";"All";257195;53977;7;311179;1619059;646738;85;2265882;968962;650495;1619457;0,15646268824607;0,0936385884197477;0,0628625617662032;0,156501150185951
"645";"GENERAL";2021-04-12;2021;15;"All";"All";426262;54972;8;481242;2045321;701710;93;2747124;1339819;705942;2045761;0,197655812410876;0,12947748198377;0,0682208511646623;0,197698333148433
"646";"GENERAL";2021-04-19;2021;16;"All";"All";211599;139698;18;351315;2256920;841408;111;3098439;1410769;846601;2257370;0,218104325016148;0,136333950914834;0,0818138612192705;0,218147812134104
"647";"GENERAL";2021-04-26;2021;17;"All";"All";346607;90689;11;437307;2603527;932097;122;3535746;1667455;937917;2605372;0,251599746112542;0,161139582825178;0,0906384604709829;0,251778043296161
"648";"GENERAL";2021-05-03;2021;18;"All";"All";371895;220490;16;592401;2975422;1152587;138;4128147;1830361;1159419;2989780;0,287538949961983;0,176882499353492;0,112043979585407;0,288926478938899
"649";"GENERAL";2021-05-10;2021;19;"All";"All";290120;306546;26;596692;3265542;1459133;164;4724839;1830131;1467655;3297786;0,315575578098419;0,176860272604314;0,141831302452712;0,318691575057026
"650";"GENERAL";2021-05-17;2021;20;"All";"All";306430;221049;32;527511;3571972;1680182;196;5252350;1928263;1699992;3628255;0,34518837266566;0,186343556736;0,164283894729477;0,350627451465477
"651";"GENERAL";2021-05-24;2021;21;"All";"All";232823;329958;98;562879;3804795;2010140;294;5815229;1857770;2052881;3910651;0,367687931029817;0,179531251389172;0,198386395992536;0,377917647381708
"652";"GENERAL";2021-05-31;2021;22;"All";"All";231193;340091;43;571327;4035988;2350231;337;6386556;1790418;2408150;4198568;0,390029969388934;0,173022486125677;0,232718895790563;0,40574138191624
"653";"GENERAL";2021-06-07;2021;23;"All";"All";361044;251774;56;612874;4397032;2602005;393;6999430;1907554;2680295;4587849;0,424920553867396;0,184342279567665;0,259018455159756;0,443360734727421
"654";"GENERAL";2021-06-14;2021;24;"All";"All";344418;390059;65;734542;4741450;2992064;458;7733972;1877573;3090450;4968023;0,458204434294444;0,181444974493356;0,298655030415857;0,480100004909212
"655";"GENERAL";2021-06-21;2021;25;"All";"All";377100;346598;77;723775;5118550;3338662;535;8457747;1926229;3463621;5389850;0,494646639141576;0,186146994962839;0,334717544404213;0,520864539367052
"656";"GENERAL";2021-06-28;2021;26;"All";"All";389947;432838;166;822951;5508497;3771500;701;9280698;1879372;3926636;5806008;0,532330352887332;0,18161882632714;0,379462406449545;0,561081232776685
"657";"GENERAL";2021-07-05;2021;27;"All";"All";433657;621909;82;1055648;5942154;4393409;783;10336346;1692809;4585331;6278140;0,574238115357215;0,16358974368886;0,443117400142947;0,606707143831806
"658";"GENERAL";2021-07-12;2021;28;"All";"All";246105;521748;110;767963;6188259;4915157;893;11104309;1499243;5140786;6640029;0,598021220167354;0,144883904857144;0,496795482596842;0,641679387453986
"659";"GENERAL";2021-07-19;2021;29;"All";"All";144069;525262;79;669410;6332328;5440419;972;11773719;1219680;5697569;6917249;0,611943765938029;0,117867484507956;0,550601900367727;0,668469384875683
"660";"GENERAL";2021-07-26;2021;30;"All";"All";105481;500305;79;605865;6437809;5940724;1051;12379584;895915;6229051;7124966;0,622137243024956;0,0865794695190093;0,601963279091046;0,688542748610055
"661";"GENERAL";2021-08-02;2021;31;"All";"All";130325;508388;69;638782;6568134;6449112;1120;13018366;600819;6771432;7372251;0,634731595575215;0,0580619704960199;0,654377915811259;0,712439886307279
"662";"GENERAL";2021-08-09;2021;32;"All";"All";314813;353347;63;668223;6882947;6802459;1183;13686589;653823;7175838;7829661;0,665154506830956;0,0631841731629978;0,693458918975961;0,756643092138959
"663";"GENERAL";2021-08-16;2021;33;"All";"All";363081;238853;69;602003;7246028;7041312;1252;14288592;839665;7461976;8301641;0,700241942996699;0,0811435797745087;0,721110734437507;0,802254314212015
"664";"GENERAL";2021-08-23;2021;34;"All";"All";294422;139445;39;433906;7540450;7180757;1291;14722498;996349;7640956;8637305;0,728694307980795;0,0962852144185502;0,738407010819208;0,834692225237759
"665";"GENERAL";2021-08-30;2021;35;"All";"All";130892;300431;56;431379;7671342;7481188;1347;15153877;811544;7972337;8783881;0,741343454299678;0,078426021454418;0,77043102112005;0,848857042574468
"666";"GENERAL";2021-09-06;2021;36;"All";"All";67286;310908;109;378303;7738628;7792096;1456;15532180;558037;8296783;8854820;0,747845841452539;0,0539276018729225;0,80178484661417;0,855712448487093
"667";"GENERAL";2021-09-13;2021;37;"All";"All";46651;257926;145;304722;7785279;8050022;1601;15836902;341006;8563341;8904347;0,752354102652018;0,0329541514349009;0,82754448925443;0,860498640689331
"668";"GENERAL";2021-09-20;2021;38;"All";"All";34767;103504;148;138419;7820046;8153526;1749;15975321;265794;8675132;8940926;0,755713917385299;0,0256858111777742;0,83834775237314;0,864033563550915
"669";"GENERAL";2021-09-27;2021;39;"All";"All";22644;58437;119;81200;7842690;8211963;1868;16056521;224404;8740666;8965070;0,757902189160846;0,0216859627062207;0,844680829680093;0,866366792386314
"670";"GENERAL";2021-10-04;2021;40;"All";"All";13212;44419;214;57845;7855902;8256382;2082;16114366;192114;8788264;8980378;0,759178970944034;0,0185655203977776;0,84928060710336;0,867846127501137
"671";"GENERAL";2021-10-11;2021;41;"All";"All";17559;36928;6;54493;7873461;8293310;2088;16168859;168682;8829439;8998121;0,760875838286677;0,0163010978467885;0,853259678396334;0,869560776243123
"672";"GENERAL";2021-10-18;2021;42;"All";"All";13270;29559;2;42831;7886731;8322869;2090;16211690;148908;8862628;9011536;0,76215822507618;0,0143901772457617;0,856466998302649;0,870857175548411
