;TYPE;DATE;YEAR;WEEK;REGION;AGEGROUP;TOTAL_VAC_1;TOTAL_VAC_2;TOTAL_VAC_UNK;TOTAL;CUMUL_VAC_1;CUMUL_VAC_2;CUMUL_VAC_UNK;CUMUL;CUMUL_VAC_INIT;CUMUL_VAC_COMPLETE;CUMUL_VAC_LEAST;COVER_1_VAC;COVER;COVER_INIT;COVER_COMPLETE;COVER_LEAST
1;REGIONAL;04/01/21;2021;1;ARS Alentejo;All;3474;1;0;3475;4698;1;0;4699;4697;1;4698;0,010156345;2,16E-06;0,010154183;2,16E-06;0,010156345
2;REGIONAL;11/01/21;2021;2;ARS Alentejo;All;5353;10;0;5363;10051;11;0;10062;10040;11;10051;0,021728697;2,38E-05;0,021704917;2,38E-05;0,021728697
3;REGIONAL;18/01/21;2021;3;ARS Alentejo;All;10430;1133;0;11563;20481;1144;0;21625;19337;1144;20481;0,044276733;0,00247315;0,041803583;0,00247315;0,044276733
4;REGIONAL;25/01/21;2021;4;ARS Alentejo;All;2295;3122;0;5417;22776;4266;0;27042;18510;4266;22776;0,049238166;0,009222428;0,040015738;0,009222428;0,049238166
5;REGIONAL;01/02/21;2021;5;ARS Alentejo;All;1448;4339;0;5787;24224;8605;0;32829;15619;8605;24224;0,052368517;0,01860267;0,033765846;0,01860267;0,052368517
6;REGIONAL;08/02/21;2021;6;ARS Alentejo;All;3334;8778;0;12112;27558;17383;0;44941;10175;17383;27558;0,059576106;0,03757934;0,021996766;0,03757934;0,059576106
7;REGIONAL;15/02/21;2021;7;ARS Alentejo;All;4057;2812;0;6869;31615;20195;0;51810;11420;20195;31615;0,068346708;0,043658446;0,024688262;0,043658446;0,068346708
8;REGIONAL;22/02/21;2021;8;ARS Alentejo;All;12033;1651;0;13684;43648;21846;0;65494;21802;21846;43648;0,094360181;0,047227651;0,04713253;0,047227651;0,094360181
9;REGIONAL;01/03/21;2021;9;ARS Alentejo;All;10458;2831;1;13290;54106;24677;1;78784;29429;24677;54106;0,116968748;0,053347832;0,063620916;0,053347832;0,116968748
10;REGIONAL;08/03/21;2021;10;ARS Alentejo;All;5828;1669;0;7497;59934;26346;1;86281;33588;26346;59934;0,129567977;0,05695595;0,072612027;0,05695595;0,129567977
11;REGIONAL;15/03/21;2021;11;ARS Alentejo;All;3708;7728;0;11436;63642;34074;1;97717;29569;34074;63643;0,137584096;0,073662683;0,063923574;0,073662683;0,137586258
12;REGIONAL;22/03/21;2021;12;ARS Alentejo;All;11906;2108;0;14014;75548;36182;1;111731;39368;36182;75550;0,163323014;0,078219851;0,085107487;0,078219851;0,163327338
13;REGIONAL;29/03/21;2021;13;ARS Alentejo;All;6156;6279;0;12435;81704;42461;1;124166;39245;42461;81706;0,176631328;0,091794071;0,08484158;0,091794071;0,176635651
14;REGIONAL;05/04/21;2021;14;ARS Alentejo;All;14050;4303;0;18353;95754;46764;1;142519;48994;46764;95758;0,20700524;0,101096487;0,1059174;0,101096487;0,207013888
15;REGIONAL;12/04/21;2021;15;ARS Alentejo;All;21907;2966;0;24873;117661;49730;1;167392;67936;49730;117666;0,254364764;0,107508518;0,146867055;0,107508518;0,254375573
16;REGIONAL;19/04/21;2021;16;ARS Alentejo;All;11370;5957;1;17328;129031;55687;2;184720;73349;55687;129036;0,278944934;0,120386624;0,158569118;0,120386624;0,278955743
17;REGIONAL;26/04/21;2021;17;ARS Alentejo;All;20214;2776;0;22990;149245;58463;2;207710;90793;58463;149256;0,322644454;0,126387904;0,196280331;0,126387904;0,322668235
18;REGIONAL;03/05/21;2021;18;ARS Alentejo;All;13671;14312;1;27984;162916;72775;3;235694;93263;72775;166038;0,352199028;0,15732822;0,201620086;0,15732822;0,358948306
19;REGIONAL;10/05/21;2021;19;ARS Alentejo;All;17429;15254;0;32683;180345;88029;3;268377;95944;88029;183973;0,389877813;0,190304993;0,207415991;0,190304993;0,397720984
20;REGIONAL;17/05/21;2021;20;ARS Alentejo;All;13213;12207;1;25421;193558;100236;4;293798;100364;100236;200600;0,418442261;0,216694627;0,216971343;0,216694627;0,433665969
21;REGIONAL;24/05/21;2021;21;ARS Alentejo;All;7188;18506;1;25695;200746;118742;5;319493;91173;118742;209915;0,433981598;0,256701717;0,197101832;0,256701717;0,453803549
22;REGIONAL;31/05/21;2021;22;ARS Alentejo;All;17386;7293;1;24680;218132;126035;6;344173;101607;126035;227642;0,471567424;0,272468048;0,219658515;0,272468048;0,492126563
23;REGIONAL;07/06/21;2021;23;ARS Alentejo;All;13799;15252;0;29051;231931;141287;6;373224;100787;141287;242074;0,501398713;0,305440497;0,217885803;0,305440497;0,5233263
24;REGIONAL;14/06/21;2021;24;ARS Alentejo;All;10216;19224;1;29441;242147;160511;7;402665;93450;160511;253961;0,523484115;0,346999792;0,202024351;0,346999792;0,549024143
25;REGIONAL;21/06/21;2021;25;ARS Alentejo;All;10544;14166;1;24711;252691;174677;8;427376;92593;174677;267270;0,546278601;0,377624479;0,20017165;0,377624479;0,577796129
26;REGIONAL;28/06/21;2021;26;ARS Alentejo;All;10966;28731;3;39700;263657;203408;11;467076;76922;203408;280330;0,569985386;0,439736428;0,166293388;0,439736428;0,606029816
27;REGIONAL;05/07/21;2021;27;ARS Alentejo;All;15333;27784;1;43118;278990;231192;12;510194;65172;231192;296364;0,603132945;0,49980111;0,140891718;0,49980111;0,640692828
28;REGIONAL;12/07/21;2021;28;ARS Alentejo;All;8176;20283;1;28460;287166;251475;13;538654;56543;251475;308018;0,620808184;0,543649799;0,122237163;0,543649799;0,665886961
29;REGIONAL;19/07/21;2021;29;ARS Alentejo;All;3502;16703;2;20207;290668;268178;15;558861;47674;268178;315852;0,628378963;0,579759084;0,103063766;0,579759084;0,68282285
30;REGIONAL;26/07/21;2021;30;ARS Alentejo;All;2231;16471;0;18702;292899;284649;15;577563;38041;284649;322690;0,633202037;0,615366822;0,082238719;0,615366822;0,697605541
31;REGIONAL;02/08/21;2021;31;ARS Alentejo;All;4931;19922;13;24866;297830;304571;28;602429;29115;304571;333686;0,643862092;0,658435084;0,062942097;0,658435084;0,721377181
32;REGIONAL;09/08/21;2021;32;ARS Alentejo;All;14808;14376;0;29184;312638;318947;28;631613;36832;318947;355779;0,675874682;0,689513758;0,07962505;0,689513758;0,769138808
33;REGIONAL;16/08/21;2021;33;ARS Alentejo;All;22130;6542;0;28672;334768;325489;28;660285;56232;325489;381721;0,723716297;0,703656543;0,121564829;0,703656543;0,825221373
34;REGIONAL;04/01/21;2021;1;ARS Algarve;All;1250;2;0;1252;2309;2;0;2311;2307;2;2309;0,005272051;4,57E-06;0,005267484;4,57E-06;0,005272051
35;REGIONAL;11/01/21;2021;2;ARS Algarve;All;1356;3;0;1359;3665;5;0;3670;3660;5;3665;0,008368153;1,14E-05;0,008356737;1,14E-05;0,008368153
36;REGIONAL;18/01/21;2021;3;ARS Algarve;All;3392;946;0;4338;7057;951;0;8008;6106;951;7057;0,016112976;0,002171382;0,013941594;0,002171382;0,016112976
37;REGIONAL;25/01/21;2021;4;ARS Algarve;All;2141;1229;0;3370;9198;2180;0;11378;7018;2180;9198;0,021001438;0,00497751;0,016023929;0,00497751;0,021001438
38;REGIONAL;01/02/21;2021;5;ARS Algarve;All;1215;1242;0;2457;10413;3422;0;13835;6992;3422;10414;0,023775601;0,007813321;0,015964564;0,007813321;0,023777884
39;REGIONAL;08/02/21;2021;6;ARS Algarve;All;2400;2896;0;5296;12813;6318;0;19131;6496;6318;12814;0,029255428;0,014425646;0,014832066;0,014425646;0,029257712
40;REGIONAL;15/02/21;2021;7;ARS Algarve;All;3200;2112;0;5312;16013;8430;0;24443;7584;8430;16014;0,036561865;0,019247894;0,017316255;0,019247894;0,036564148
41;REGIONAL;22/02/21;2021;8;ARS Algarve;All;8503;1065;0;9568;24516;9495;0;34011;15022;9495;24517;0,055976437;0,021679567;0,034299153;0,021679567;0,05597872
42;REGIONAL;01/03/21;2021;9;ARS Algarve;All;4655;562;0;5217;29171;10057;0;39228;19115;10057;29172;0,066605019;0,02296276;0,043644542;0,02296276;0,066607302
43;REGIONAL;08/03/21;2021;10;ARS Algarve;All;5128;1544;0;6672;34299;11601;0;45900;22699;11601;34300;0,078313583;0,026488116;0,051827751;0,026488116;0,078315866
44;REGIONAL;15/03/21;2021;11;ARS Algarve;All;2707;3009;0;5716;37006;14610;0;51616;22397;14610;37007;0,084494372;0,033358449;0,051138206;0,033358449;0,084496655
45;REGIONAL;22/03/21;2021;12;ARS Algarve;All;9431;4308;0;13739;46437;18918;0;65355;27520;18918;46438;0,10602781;0,043194739;0,062835354;0,043194739;0,106030093
46;REGIONAL;29/03/21;2021;13;ARS Algarve;All;4228;2921;0;7149;50665;21839;0;72504;28828;21839;50667;0,115681439;0,049864146;0,06582186;0,049864146;0,115686006
47;REGIONAL;05/04/21;2021;14;ARS Algarve;All;8662;1798;0;10460;59327;23637;0;82964;35695;23637;59332;0,13545905;0,05396945;0,081501016;0,05396945;0,135470466
48;REGIONAL;12/04/21;2021;15;ARS Algarve;All;13666;2165;0;15831;72993;25802;0;98795;47196;25802;72998;0,1666621;0,058912711;0,107760806;0,058912711;0,166673516
49;REGIONAL;19/04/21;2021;16;ARS Algarve;All;7261;5512;0;12773;80254;31314;0;111568;48946;31314;80260;0,183240861;0,071498048;0,111756513;0,071498048;0,183254561
50;REGIONAL;26/04/21;2021;17;ARS Algarve;All;16382;3250;0;19632;96636;34564;0;131200;62082;34564;96646;0,22064525;0,078918647;0,141749435;0,078918647;0,220668082
51;REGIONAL;03/05/21;2021;18;ARS Algarve;All;16564;8944;2;25510;113200;43508;2;156710;70251;43508;113759;0,258465192;0,099340137;0,160401397;0,099340137;0,259741535
52;REGIONAL;10/05/21;2021;19;ARS Algarve;All;9723;11312;0;21035;122923;54820;2;177745;70626;54820;125446;0,280665342;0,125168391;0,16125762;0,125168391;0,286426011
53;REGIONAL;17/05/21;2021;20;ARS Algarve;All;12006;10890;3;22899;134929;65710;5;200644;74267;65710;139977;0,308078179;0,150033107;0,169570975;0,150033107;0,319604082
54;REGIONAL;24/05/21;2021;21;ARS Algarve;All;7605;18798;1;26404;142534;84508;6;227048;68856;84508;153364;0,325442382;0,192953855;0,157216248;0,192953855;0,350170103
55;REGIONAL;31/05/21;2021;22;ARS Algarve;All;8155;12729;1;20885;150689;97237;7;247933;72771;97237;170008;0,344062379;0,22201749;0,166155216;0,22201749;0,388172706
56;REGIONAL;07/06/21;2021;23;ARS Algarve;All;17038;6335;0;23373;167727;103572;7;271306;84825;103572;188397;0,382964587;0,236481951;0,193677649;0,236481951;0,4301596
57;REGIONAL;14/06/21;2021;24;ARS Algarve;All;15345;13410;0;28755;183072;116982;7;300061;86981;116982;203963;0,418001233;0,267100486;0,198600361;0,267100486;0,465700847
58;REGIONAL;21/06/21;2021;25;ARS Algarve;All;19336;10181;2;29519;202408;127163;9;329580;97508;127163;224671;0,462150376;0,290346371;0,222636254;0,290346371;0,512982624
59;REGIONAL;28/06/21;2021;26;ARS Algarve;All;17166;16402;7;33575;219574;143565;16;363155;100727;143565;244292;0,501344841;0,327796424;0,229986072;0,327796424;0,557782497
60;REGIONAL;05/07/21;2021;27;ARS Algarve;All;19177;31664;1;50842;238751;175229;17;413997;89479;175229;264708;0,545130945;0,400093614;0,204303948;0,400093614;0,604397561
61;REGIONAL;12/07/21;2021;28;ARS Algarve;All;9809;26935;4;36748;248560;202164;21;450745;78844;202164;281008;0,567527456;0,46159326;0,180021463;0,46159326;0,641614722
62;REGIONAL;19/07/21;2021;29;ARS Algarve;All;4326;27173;1;31500;252886;229337;22;482245;61762;229337;291099;0,577404845;0,523636322;0,141018791;0,523636322;0,664655113
63;REGIONAL;26/07/21;2021;30;ARS Algarve;All;3958;24684;3;28645;256844;254021;25;510890;45669;254021;299690;0,586441994;0,579996347;0,104274265;0,579996347;0,684270612
64;REGIONAL;02/08/21;2021;31;ARS Algarve;All;3914;22581;1;26496;260758;276602;26;537386;30980;276602;307582;0,595378679;0,631554673;0,070735439;0,631554673;0,702290111
65;REGIONAL;09/08/21;2021;32;ARS Algarve;All;11391;13970;2;25363;272149;290572;28;562749;34018;290572;324590;0,62138731;0,663451835;0,077671987;0,663451835;0,741123821
66;REGIONAL;16/08/21;2021;33;ARS Algarve;All;16585;7732;2;24319;288734;298304;30;587068;46371;298304;344675;0,6592552;0,681106012;0,105877115;0,681106012;0,786983127
67;REGIONAL;04/01/21;2021;1;ARS Centro;All;9028;10;0;9038;15655;11;0;15666;15646;11;15657;0,009442777;6,63E-06;0,009437348;6,63E-06;0,009443983
68;REGIONAL;11/01/21;2021;2;ARS Centro;All;12636;24;1;12661;28291;35;1;28327;28258;35;28293;0,017064554;2,11E-05;0,017044649;2,11E-05;0,01706576
69;REGIONAL;18/01/21;2021;3;ARS Centro;All;36748;6313;2;43063;65039;6348;3;71390;58693;6348;65041;0,039230198;0,003828984;0,03540242;0,003828984;0,039231404
70;REGIONAL;25/01/21;2021;4;ARS Centro;All;4866;8539;3;13408;69905;14887;6;84798;55020;14887;69907;0,04216527;0,008979535;0,033186942;0,008979535;0,042166476
71;REGIONAL;01/02/21;2021;5;ARS Centro;All;2709;9153;0;11862;72614;24040;6;96660;48576;24040;72616;0,043799284;0,014500438;0,029300052;0,014500438;0,04380049
72;REGIONAL;08/02/21;2021;6;ARS Centro;All;7529;27115;4;34648;80143;51155;10;131308;28990;51155;80145;0,048340623;0,030855652;0,017486177;0,030855652;0,048341829
73;REGIONAL;15/02/21;2021;7;ARS Centro;All;25524;9993;3;35520;105667;61148;13;166828;44521;61148;105669;0,063736179;0,036883226;0,026854159;0,036883226;0,063737385
74;REGIONAL;22/02/21;2021;8;ARS Centro;All;38413;3119;1;41533;144080;64267;14;208361;79815;64267;144082;0,086906117;0,038764543;0,04814278;0,038764543;0,086907323
75;REGIONAL;01/03/21;2021;9;ARS Centro;All;28511;5934;1;34446;172591;70201;15;242807;102401;70201;172602;0,104103371;0,042343811;0,061766194;0,042343811;0,104110005
76;REGIONAL;08/03/21;2021;10;ARS Centro;All;17709;13534;0;31243;190300;83735;15;274050;106587;83735;190322;0,114785078;0,050507244;0,064291104;0,050507244;0,114798348
77;REGIONAL;15/03/21;2021;11;ARS Centro;All;16674;24185;2;40861;206974;107920;17;314911;99085;107920;207005;0,124842495;0,065095143;0,059766051;0,065095143;0,124861193
78;REGIONAL;22/03/21;2021;12;ARS Centro;All;47840;4365;1;52206;254814;112285;18;367117;142567;112285;254852;0,153698607;0,067728021;0,085993506;0,067728021;0,153721528
79;REGIONAL;29/03/21;2021;13;ARS Centro;All;24382;16777;2;41161;279196;129062;20;408278;150185;129062;279247;0,168405332;0,077847566;0,090588528;0,077847566;0,168436094
80;REGIONAL;05/04/21;2021;14;ARS Centro;All;49881;10233;0;60114;329077;139295;20;468392;189847;139295;329142;0,198492534;0,084019903;0,114511838;0,084019903;0,19853174
81;REGIONAL;12/04/21;2021;15;ARS Centro;All;77641;12031;2;89674;406718;151326;22;558066;255460;151326;406786;0,245324001;0,091276756;0,154088261;0,091276756;0,245365017
82;REGIONAL;19/04/21;2021;16;ARS Centro;All;30031;24189;6;54226;436749;175515;28;612292;261304;175515;436819;0,263438088;0,105867068;0,157613242;0,105867068;0,26348031
83;REGIONAL;26/04/21;2021;17;ARS Centro;All;56584;17938;3;74525;493333;193453;31;686817;301226;193453;494679;0,297568402;0,116686903;0,181693378;0,116686903;0,298380282
84;REGIONAL;03/05/21;2021;18;ARS Centro;All;59949;49144;2;109095;553282;242597;33;795912;317874;242597;560471;0,333728416;0,146329562;0,191735112;0,146329562;0,338064674
85;REGIONAL;10/05/21;2021;19;ARS Centro;All;50632;55737;0;106369;603914;298334;33;902281;318799;298334;617133;0,364268606;0,179948983;0,192293054;0,179948983;0,372242037
86;REGIONAL;17/05/21;2021;20;ARS Centro;All;44831;41716;3;86550;648745;340050;36;988831;329668;340050;669718;0,39130975;0,205111223;0,198849013;0,205111223;0,403960236
87;REGIONAL;24/05/21;2021;21;ARS Centro;All;24156;56249;7;80412;672901;396299;43;1069243;305904;396299;702203;0,405880157;0,239039473;0,184515053;0,239039473;0,423554525
88;REGIONAL;31/05/21;2021;22;ARS Centro;All;44229;37727;0;81956;717130;434026;43;1151199;314761;434026;748787;0,432558187;0,261795629;0,189857414;0,261795629;0,451653044
89;REGIONAL;07/06/21;2021;23;ARS Centro;All;58288;40806;1;99095;775418;474832;44;1250294;334008;474832;808840;0,46771632;0,286408976;0,201466812;0,286408976;0,487875788
90;REGIONAL;14/06/21;2021;24;ARS Centro;All;51932;65699;7;117638;827350;540531;51;1367932;326129;540531;866660;0,499040643;0,326037273;0,19671436;0,326037273;0,522751633
91;REGIONAL;21/06/21;2021;25;ARS Centro;All;59502;47665;3;107170;886852;588196;54;1475102;344280;588196;932476;0,534931035;0,354787829;0,207662673;0,354787829;0,562450502
92;REGIONAL;28/06/21;2021;26;ARS Centro;All;49853;77031;2;126886;936705;665227;56;1601988;319317;665227;984544;0,565001348;0,401251356;0,192605501;0,401251356;0,593856857
93;REGIONAL;05/07/21;2021;27;ARS Centro;All;59436;104774;9;164219;996141;770001;65;1766207;281991;770001;1051992;0,600851931;0,464448896;0,170091219;0,464448896;0,634540115
94;REGIONAL;12/07/21;2021;28;ARS Centro;All;28537;81984;7;110528;1024678;851985;72;1876735;242920;851985;1094905;0,618064867;0,513899972;0,146524389;0,513899972;0,660424361
95;REGIONAL;19/07/21;2021;29;ARS Centro;All;16842;80602;15;97459;1041520;932587;87;1974194;194693;932587;1127280;0,628223618;0,562517455;0,117434846;0,562517455;0,679952301
96;REGIONAL;26/07/21;2021;30;ARS Centro;All;14322;68844;4;83170;1055842;1001431;91;2057364;153227;1001431;1154658;0,636862356;0,604042751;0,092423401;0,604042751;0,696466152
97;REGIONAL;02/08/21;2021;31;ARS Centro;All;19182;74944;5;94131;1075024;1076375;96;2151495;116536;1076375;1192911;0,648432547;0,649247443;0,070292138;0,649247443;0,719539581
98;REGIONAL;09/08/21;2021;32;ARS Centro;All;50311;46766;5;97082;1125335;1123141;101;2248577;143448;1123141;1266589;0,678779116;0,67745574;0,086524907;0,67745574;0,763980648
99;REGIONAL;16/08/21;2021;33;ARS Centro;All;61072;35813;7;96892;1186407;1158954;108;2345469;189512;1158954;1348466;0,715616501;0,699057411;0,114309773;0,699057411;0,813367184
100;REGIONAL;04/01/21;2021;1;ARS Lisboa e Vale do Tejo;All;12719;21;0;12740;23439;22;0;23461;23417;22;23439;0,006362796;5,97E-06;0,006356824;5,97E-06;0,006362796
101;REGIONAL;11/01/21;2021;2;ARS Lisboa e Vale do Tejo;All;13212;1107;0;14319;36651;1129;0;37780;35522;1129;36651;0,009949351;0,000306481;0,00964287;0,000306481;0,009949351
102;REGIONAL;18/01/21;2021;3;ARS Lisboa e Vale do Tejo;All;37758;9062;0;46820;74409;10191;0;84600;64219;10191;74410;0,02019921;0,002766468;0,017433013;0,002766468;0,020199481
103;REGIONAL;25/01/21;2021;4;ARS Lisboa e Vale do Tejo;All;17265;11892;5;29162;91674;22083;5;113762;69593;22083;91676;0,024886;0,005994693;0,018891849;0,005994693;0,024886542
104;REGIONAL;01/02/21;2021;5;ARS Lisboa e Vale do Tejo;All;8699;8928;0;17627;100373;31011;5;131389;69366;31011;100377;0,027247447;0,008418305;0,018830227;0,008418305;0,027248533
105;REGIONAL;08/02/21;2021;6;ARS Lisboa e Vale do Tejo;All;14352;30386;0;44738;114725;61397;5;176127;53332;61397;114729;0,031143468;0,016666947;0,014477607;0,016666947;0,031144554
106;REGIONAL;15/02/21;2021;7;ARS Lisboa e Vale do Tejo;All;32989;19053;1;52043;147714;80450;6;228170;67268;80450;147718;0,040098725;0,021839111;0,0182607;0,021839111;0,040099811
107;REGIONAL;22/02/21;2021;8;ARS Lisboa e Vale do Tejo;All;49331;6661;0;55992;197045;87111;6;284162;109938;87111;197049;0,053490213;0,023647319;0,02984398;0,023647319;0,053491299
108;REGIONAL;01/03/21;2021;9;ARS Lisboa e Vale do Tejo;All;45115;12807;1;57923;242160;99918;7;342085;142253;99918;242171;0,065737217;0,027123932;0,038616272;0,027123932;0,065740203
109;REGIONAL;08/03/21;2021;10;ARS Lisboa e Vale do Tejo;All;33782;16558;0;50340;275942;116476;7;392425;159488;116476;275964;0,074907744;0,031618798;0,043294918;0,031618798;0,074913716
110;REGIONAL;15/03/21;2021;11;ARS Lisboa e Vale do Tejo;All;26073;29003;2;55078;302015;145479;9;447503;156564;145479;302043;0,08198557;0,039492008;0,042501163;0,039492008;0,081993171
111;REGIONAL;22/03/21;2021;12;ARS Lisboa e Vale do Tejo;All;89322;7601;1;96924;391337;153080;10;544427;238291;153080;391371;0,106233091;0,04155539;0,064686931;0,04155539;0,106242321
112;REGIONAL;29/03/21;2021;13;ARS Lisboa e Vale do Tejo;All;45584;23866;0;69450;436921;176946;10;613877;260020;176946;436966;0,118607411;0,0480341;0,070585527;0,0480341;0,118619627
113;REGIONAL;05/04/21;2021;14;ARS Lisboa e Vale do Tejo;All;87428;19647;2;107077;524349;196593;12;720954;327851;196593;524444;0,142340784;0,053367512;0,08899906;0,053367512;0,142366572
114;REGIONAL;12/04/21;2021;15;ARS Lisboa e Vale do Tejo;All;163630;14316;1;177947;687979;210909;13;898901;477179;210909;688088;0,186760097;0,057253761;0,129535925;0,057253761;0,186789686
115;REGIONAL;19/04/21;2021;16;ARS Lisboa e Vale do Tejo;All;79246;53676;1;132923;767225;264585;14;1031824;502751;264585;767336;0,208272368;0,071824751;0,136477749;0,071824751;0,2083025
116;REGIONAL;26/04/21;2021;17;ARS Lisboa e Vale do Tejo;All;107644;25568;2;133214;874869;290153;16;1165038;584856;290153;875009;0,237493614;0,078765489;0,15876613;0,078765489;0,237531619
117;REGIONAL;03/05/21;2021;18;ARS Lisboa e Vale do Tejo;All;107826;65407;7;173240;982695;355560;23;1338278;629983;355560;985543;0,266764266;0,096520998;0,171016391;0,096520998;0,26753739
118;REGIONAL;10/05/21;2021;19;ARS Lisboa e Vale do Tejo;All;90461;113052;3;203516;1073156;468612;26;1541794;609973;468612;1078585;0,291320983;0,127210311;0,165584439;0,127210311;0,292794749
119;REGIONAL;17/05/21;2021;20;ARS Lisboa e Vale do Tejo;All;109980;71104;2;181086;1183136;539716;28;1722880;651477;539716;1191193;0,321176364;0,146512339;0,176851194;0,146512339;0,323363533
120;REGIONAL;24/05/21;2021;21;ARS Lisboa e Vale do Tejo;All;110668;88770;8;199446;1293804;628486;36;1922326;686421;628486;1314907;0,351218511;0,170610013;0,186337159;0,170610013;0,356947172
121;REGIONAL;31/05/21;2021;22;ARS Lisboa e Vale do Tejo;All;92150;86689;13;178852;1385954;715175;49;2101178;712635;715175;1427810;0,376233727;0,194142775;0,193453262;0,194142775;0,387596036
122;REGIONAL;07/06/21;2021;23;ARS Lisboa e Vale do Tejo;All;151976;53870;4;205850;1537930;769045;53;2307028;825280;769045;1594325;0,417489422;0,208766428;0,224032089;0,208766428;0,432798517
123;REGIONAL;14/06/21;2021;24;ARS Lisboa e Vale do Tejo;All;147513;121161;5;268679;1685443;890206;58;2575707;860754;890206;1750960;0,457533584;0,241657025;0,233661929;0,241657025;0,475318954
124;REGIONAL;21/06/21;2021;25;ARS Lisboa e Vale do Tejo;All;119907;153474;16;273397;1805350;1043680;74;2849104;841738;1043680;1885418;0,490083768;0,283319371;0,228499809;0,283319371;0,51181918
125;REGIONAL;28/06/21;2021;26;ARS Lisboa e Vale do Tejo;All;130268;166303;11;296582;1935618;1209983;85;3145686;816749;1209983;2026732;0,525446568;0,328464302;0,221716247;0,328464302;0,550180549
126;REGIONAL;05/07/21;2021;27;ARS Lisboa e Vale do Tejo;All;143649;273168;10;416827;2079267;1483151;95;3562513;698811;1483151;2181962;0,564441801;0,40261901;0,189700572;0,40261901;0,592319582
127;REGIONAL;12/07/21;2021;28;ARS Lisboa e Vale do Tejo;All;79795;215299;15;295109;2159062;1698450;110;3857622;601769;1698450;2300219;0,586103104;0,461064489;0,163357365;0,461064489;0,624421854
128;REGIONAL;19/07/21;2021;29;ARS Lisboa e Vale do Tejo;All;56915;185196;10;242121;2215977;1883646;120;4099743;524478;1883646;2408124;0,601553359;0,51133815;0,142375802;0,51133815;0,653713952
129;REGIONAL;26/07/21;2021;30;ARS Lisboa e Vale do Tejo;All;36167;179947;21;216135;2252144;2063593;141;4315878;418551;2063593;2482144;0,611371322;0,560186907;0,113620656;0,560186907;0,673807563
130;REGIONAL;02/08/21;2021;31;ARS Lisboa e Vale do Tejo;All;45257;177746;13;223016;2297401;2241339;154;4538894;329295;2241339;2570634;0,623656874;0,608438176;0,089391051;0,608438176;0,697829228
131;REGIONAL;09/08/21;2021;32;ARS Lisboa e Vale do Tejo;All;106834;110418;3;217255;2404235;2351757;157;4756149;368692;2351757;2720449;0,652658237;0,638412458;0,100085836;0,638412458;0,738498294
132;REGIONAL;16/08/21;2021;33;ARS Lisboa e Vale do Tejo;All;106860;90471;8;197339;2511095;2442228;165;4953488;425127;2442228;2867355;0,681666657;0,662971889;0,115405789;0,662971889;0,778377678
133;REGIONAL;04/01/21;2021;1;ARS Norte;All;16670;28;0;16698;30019;32;0;30051;29994;32;30026;0,008432419;8,99E-06;0,008425397;8,99E-06;0,008434386
134;REGIONAL;11/01/21;2021;2;ARS Norte;All;15377;32;0;15409;45396;64;0;45460;45339;64;45403;0,012751861;1,80E-05;0,012735849;1,80E-05;0,012753827
135;REGIONAL;18/01/21;2021;3;ARS Norte;All;32454;12738;1;45193;77850;12802;1;90653;65055;12802;77857;0,021868279;0,003596117;0,018274128;0,003596117;0,021870245
136;REGIONAL;25/01/21;2021;4;ARS Norte;All;14395;15719;4;30118;92245;28521;5;120771;63731;28521;92252;0,025911874;0,008011627;0,017902213;0,008011627;0,02591384
137;REGIONAL;01/02/21;2021;5;ARS Norte;All;5667;12286;1;17954;97912;40807;6;138725;57116;40807;97923;0,027503749;0,011462798;0,016044041;0,011462798;0,027506839
138;REGIONAL;08/02/21;2021;6;ARS Norte;All;8927;28948;6;37881;106839;69755;12;176606;37095;69755;106850;0,030011368;0,019594371;0,010420087;0,019594371;0,030014458
139;REGIONAL;15/02/21;2021;7;ARS Norte;All;33046;15205;4;48255;139885;84960;16;224861;54936;84960;139896;0,03929408;0,023865497;0,015431673;0,023865497;0,03929717
140;REGIONAL;22/02/21;2021;8;ARS Norte;All;64843;4349;0;69192;204728;89309;16;294053;115430;89309;204739;0,057508657;0,025087143;0,032424604;0,025087143;0,057511747
141;REGIONAL;01/03/21;2021;9;ARS Norte;All;48081;7112;2;55195;252809;96421;18;349248;156404;96421;252825;0,071014741;0,027084923;0,043934313;0,027084923;0,071019236
142;REGIONAL;08/03/21;2021;10;ARS Norte;All;25722;14183;0;39905;278531;110604;18;389153;167957;110604;278561;0,078240122;0,031068967;0,047179582;0,031068967;0,078248549
143;REGIONAL;15/03/21;2021;11;ARS Norte;All;26929;42386;4;69319;305460;152990;22;458472;152506;152990;305496;0,085804552;0,042975311;0,042839354;0,042975311;0,085814664
144;REGIONAL;22/03/21;2021;12;ARS Norte;All;89090;2407;0;91497;394550;155397;22;549969;239195;155397;394592;0,110830177;0,043651444;0,067190532;0,043651444;0,110841975
145;REGIONAL;29/03/21;2021;13;ARS Norte;All;54169;32724;1;86894;448719;188121;23;636863;260662;188121;448783;0,126046398;0,052843705;0,073220671;0,052843705;0,126064376
146;REGIONAL;05/04/21;2021;14;ARS Norte;All;82499;13708;5;96212;531218;201829;28;733075;329494;201829;531323;0,149220593;0,05669432;0,092555768;0,05669432;0,149250088
147;REGIONAL;12/04/21;2021;15;ARS Norte;All;136056;19194;2;155252;667274;221023;30;888327;446363;221023;667386;0,187439097;0,062085967;0,125384591;0,062085967;0,187470558
148;REGIONAL;19/04/21;2021;16;ARS Norte;All;65261;46486;2;111749;732535;267509;32;1000076;465139;267509;732648;0,205771091;0,075144012;0,130658821;0,075144012;0,205802833
149;REGIONAL;26/04/21;2021;17;ARS Norte;All;126864;36757;2;163623;859399;304266;34;1163699;555271;304266;859537;0,241407536;0,085469154;0,155977147;0,085469154;0,241446301
150;REGIONAL;03/05/21;2021;18;ARS Norte;All;155701;73301;4;229006;1015100;377567;38;1392705;637883;377567;1015450;0,285144374;0,106059606;0,179183084;0,106059606;0,28524269
151;REGIONAL;10/05/21;2021;19;ARS Norte;All;100030;101084;8;201122;1115130;478651;46;1593827;643590;478651;1122241;0,313243076;0,134454379;0,180786196;0,134454379;0,315240575
152;REGIONAL;17/05/21;2021;20;ARS Norte;All;111020;71186;4;182210;1226150;549837;50;1776037;691057;549837;1240894;0,344428898;0,154450721;0,194119807;0,154450721;0,348570528
153;REGIONAL;24/05/21;2021;21;ARS Norte;All;73139;129168;12;202319;1299289;679005;62;1978356;655195;679005;1334200;0,364973844;0,190734367;0,184046073;0,190734367;0,374780439
154;REGIONAL;31/05/21;2021;22;ARS Norte;All;55042;172576;31;227649;1354331;851581;93;2206005;561932;851581;1413513;0,380435293;0,239211439;0,15784824;0,239211439;0,397059679
155;REGIONAL;07/06/21;2021;23;ARS Norte;All;106863;106645;9;213517;1461194;958226;102;2419522;569869;958226;1528095;0,410453402;0,269168312;0,160077765;0,269168312;0,429246077
156;REGIONAL;14/06/21;2021;24;ARS Norte;All;105183;152489;12;257684;1566377;1110715;114;2677206;538244;1110715;1648959;0,439999596;0,31200289;0,151194216;0,31200289;0,463197106
157;REGIONAL;21/06/21;2021;25;ARS Norte;All;146326;105421;5;251752;1712703;1216136;119;2928958;595710;1216136;1811846;0,48110297;0,341615938;0,167336573;0,341615938;0,508952511
158;REGIONAL;28/06/21;2021;26;ARS Norte;All;163713;117311;10;281034;1876416;1333447;129;3209992;648547;1333447;1981994;0,527090401;0,37456892;0,182178631;0,37456892;0,556747551
159;REGIONAL;05/07/21;2021;27;ARS Norte;All;176088;158040;14;334142;2052504;1491487;143;3544134;680880;1491487;2172367;0,576554003;0,418962789;0,191261059;0,418962789;0,610223849
160;REGIONAL;12/07/21;2021;28;ARS Norte;All;105341;156912;19;262272;2157845;1648399;162;3806406;678772;1648399;2327171;0,606144579;0,4630398;0,190668917;0,4630398;0,653708717
161;REGIONAL;19/07/21;2021;29;ARS Norte;All;51694;189593;13;241300;2209539;1837992;175;4047706;592670;1837992;2430662;0,620665565;0,516296994;0,166482629;0,516296994;0,682779623
162;REGIONAL;26/07/21;2021;30;ARS Norte;All;35184;185372;16;220572;2244723;2023364;191;4268278;478150;2023364;2501514;0,630548847;0,568368497;0,134313646;0,568368497;0,702682144
163;REGIONAL;02/08/21;2021;31;ARS Norte;All;41612;189820;19;231451;2286335;2213184;210;4499729;368372;2213184;2581556;0,642237772;0,621689456;0,103476705;0,621689456;0,725166161
164;REGIONAL;09/08/21;2021;32;ARS Norte;All;118887;147859;5;266751;2405222;2361043;215;4766480;398802;2361043;2759845;0,675633457;0,663223454;0,112024576;0,663223454;0,77524803
165;REGIONAL;16/08/21;2021;33;ARS Norte;All;148365;80847;6;229218;2553587;2441890;221;4995698;504506;2441890;2946396;0,717309592;0,685933599;0,141717119;0,685933599;0,827650718
166;REGIONAL;04/01/21;2021;1;Outro;All;0;0;0;0;0;0;0;0;0;0;0;NA;NA;NA;NA;NA
167;REGIONAL;11/01/21;2021;2;Outro;All;0;0;0;0;0;0;0;0;0;0;0;NA;NA;NA;NA;NA
168;REGIONAL;18/01/21;2021;3;Outro;All;0;0;0;0;0;0;0;0;0;0;0;NA;NA;NA;NA;NA
169;REGIONAL;25/01/21;2021;4;Outro;All;0;0;0;0;0;0;0;0;0;0;0;NA;NA;NA;NA;NA
170;REGIONAL;01/02/21;2021;5;Outro;All;0;0;0;0;0;0;0;0;0;0;0;NA;NA;NA;NA;NA
171;REGIONAL;08/02/21;2021;6;Outro;All;0;0;0;0;0;0;0;0;0;0;0;NA;NA;NA;NA;NA
172;REGIONAL;15/02/21;2021;7;Outro;All;0;0;0;0;0;0;0;0;0;0;0;NA;NA;NA;NA;NA
173;REGIONAL;22/02/21;2021;8;Outro;All;0;0;0;0;0;0;0;0;0;0;0;NA;NA;NA;NA;NA
174;REGIONAL;01/03/21;2021;9;Outro;All;0;0;0;0;0;0;0;0;0;0;0;NA;NA;NA;NA;NA
175;REGIONAL;08/03/21;2021;10;Outro;All;0;0;0;0;0;0;0;0;0;0;0;NA;NA;NA;NA;NA
176;REGIONAL;15/03/21;2021;11;Outro;All;0;0;0;0;0;0;0;0;0;0;0;NA;NA;NA;NA;NA
177;REGIONAL;22/03/21;2021;12;Outro;All;0;0;0;0;0;0;0;0;0;0;0;NA;NA;NA;NA;NA
178;REGIONAL;29/03/21;2021;13;Outro;All;0;0;0;0;0;0;0;0;0;0;0;NA;NA;NA;NA;NA
179;REGIONAL;05/04/21;2021;14;Outro;All;0;0;0;0;0;0;0;0;0;0;0;NA;NA;NA;NA;NA
180;REGIONAL;12/04/21;2021;15;Outro;All;0;0;0;0;0;0;0;0;0;0;0;NA;NA;NA;NA;NA
181;REGIONAL;19/04/21;2021;16;Outro;All;0;0;0;0;0;0;0;0;0;0;0;NA;NA;NA;NA;NA
182;REGIONAL;26/04/21;2021;17;Outro;All;0;0;0;0;0;0;0;0;0;0;0;NA;NA;NA;NA;NA
183;REGIONAL;03/05/21;2021;18;Outro;All;0;0;0;0;0;0;0;0;0;0;0;NA;NA;NA;NA;NA
184;REGIONAL;10/05/21;2021;19;Outro;All;0;0;0;0;0;0;0;0;0;0;0;NA;NA;NA;NA;NA
185;REGIONAL;17/05/21;2021;20;Outro;All;0;0;0;0;0;0;0;0;0;0;0;NA;NA;NA;NA;NA
186;REGIONAL;24/05/21;2021;21;Outro;All;0;0;0;0;0;0;0;0;0;0;0;NA;NA;NA;NA;NA
187;REGIONAL;31/05/21;2021;22;Outro;All;0;0;0;0;0;0;0;0;0;0;0;NA;NA;NA;NA;NA
188;REGIONAL;07/06/21;2021;23;Outro;All;0;0;0;0;0;0;0;0;0;0;0;NA;NA;NA;NA;NA
189;REGIONAL;14/06/21;2021;24;Outro;All;0;0;0;0;0;0;0;0;0;0;0;NA;NA;NA;NA;NA
190;REGIONAL;21/06/21;2021;25;Outro;All;0;0;0;0;0;0;0;0;0;0;0;NA;NA;NA;NA;NA
191;REGIONAL;28/06/21;2021;26;Outro;All;0;0;0;0;0;0;0;0;0;0;0;NA;NA;NA;NA;NA
192;REGIONAL;05/07/21;2021;27;Outro;All;0;0;0;0;0;0;0;0;0;0;0;NA;NA;NA;NA;NA
193;REGIONAL;12/07/21;2021;28;Outro;All;0;0;0;0;0;0;0;0;0;0;0;NA;NA;NA;NA;NA
194;REGIONAL;19/07/21;2021;29;Outro;All;0;0;0;0;0;0;0;0;0;0;0;NA;NA;NA;NA;NA
195;REGIONAL;26/07/21;2021;30;Outro;All;0;0;0;0;0;0;0;0;0;0;0;NA;NA;NA;NA;NA
196;REGIONAL;02/08/21;2021;31;Outro;All;0;0;0;0;0;0;0;0;0;0;0;NA;NA;NA;NA;NA
197;REGIONAL;09/08/21;2021;32;Outro;All;0;0;0;0;0;0;0;0;0;0;0;NA;NA;NA;NA;NA
198;REGIONAL;16/08/21;2021;33;Outro;All;0;0;0;0;0;0;0;0;0;0;0;NA;NA;NA;NA;NA
199;REGIONAL;04/01/21;2021;1;RA_Madeira;All;1728;0;0;1728;2370;0;0;2370;2370;0;2370;0,009333538;0;0,009333538;0;0,009333538
200;REGIONAL;11/01/21;2021;2;RA_Madeira;All;1766;0;0;1766;4136;0;0;4136;4136;0;4136;0,016288402;0;0,016288402;0;0,016288402
201;REGIONAL;18/01/21;2021;3;RA_Madeira;All;1085;540;0;1625;5221;540;0;5761;4681;540;5221;0,020561351;0,002126629;0,018434722;0,002126629;0,020561351
202;REGIONAL;25/01/21;2021;4;RA_Madeira;All;416;1632;0;2048;5637;2172;0;7809;3465;2172;5637;0,022199643;0,008553774;0,013645869;0,008553774;0,022199643
203;REGIONAL;01/02/21;2021;5;RA_Madeira;All;2239;1521;0;3760;7876;3693;0;11569;4183;3693;7876;0,031017277;0,014543779;0,016473498;0,014543779;0,031017277
204;REGIONAL;08/02/21;2021;6;RA_Madeira;All;3170;1089;0;4259;11046;4782;0;15828;6264;4782;11046;0,043501376;0,018832481;0,024668896;0,018832481;0,043501376
205;REGIONAL;15/02/21;2021;7;RA_Madeira;All;2508;640;0;3148;13554;5422;0;18976;8132;5422;13554;0,053378386;0,02135293;0,032025457;0,02135293;0,053378386
206;REGIONAL;22/02/21;2021;8;RA_Madeira;All;2266;2160;0;4426;15820;7582;0;23402;8238;7582;15820;0,062302352;0,029859446;0,032442906;0,029859446;0,062302352
207;REGIONAL;01/03/21;2021;9;RA_Madeira;All;1442;3121;0;4563;17262;10703;0;27965;6560;10703;17263;0,067981238;0,042150573;0,025834603;0,042150573;0,067985177
208;REGIONAL;08/03/21;2021;10;RA_Madeira;All;4913;2399;0;7312;22175;13102;0;35277;9074;13102;22176;0,087329624;0,051598319;0,035735243;0,051598319;0,087333562
209;REGIONAL;15/03/21;2021;11;RA_Madeira;All;3128;2354;0;5482;25303;15456;0;40759;9848;15456;25304;0,099648319;0,060868846;0,038783411;0,060868846;0,099652257
210;REGIONAL;22/03/21;2021;12;RA_Madeira;All;5305;187;0;5492;30608;15643;0;46251;14966;15643;30609;0,120540479;0,06160529;0,058939127;0,06160529;0,120544417
211;REGIONAL;29/03/21;2021;13;RA_Madeira;All;1218;1271;0;2489;31826;16914;0;48740;14913;16914;31827;0,125337209;0,066610744;0,058730403;0,066610744;0,125341147
212;REGIONAL;05/04/21;2021;14;RA_Madeira;All;10231;1305;0;11536;42057;18219;0;60276;23839;18219;42058;0,165628951;0,071750097;0,093882791;0,071750097;0,165632889
213;REGIONAL;12/04/21;2021;15;RA_Madeira;All;8447;1310;0;9757;50504;19529;0;70033;30977;19529;50506;0,198894941;0,076909142;0,121993675;0,076909142;0,198902817
214;REGIONAL;19/04/21;2021;16;RA_Madeira;All;9840;2140;0;11980;60344;21669;0;82013;38678;21669;60347;0,237646846;0,085336893;0,152321767;0,085336893;0,23765866
215;REGIONAL;26/04/21;2021;17;RA_Madeira;All;8840;812;0;9652;69184;22481;0;91665;46707;22481;69188;0,272460549;0,088534713;0,183941589;0,088534713;0,272476302
216;REGIONAL;03/05/21;2021;18;RA_Madeira;All;7632;5299;0;12931;76816;27780;0;104596;49042;27780;76822;0,302516905;0,109403244;0,19313729;0,109403244;0,302540534
217;REGIONAL;10/05/21;2021;19;RA_Madeira;All;11621;6450;0;18071;88437;34230;0;122667;54216;34230;88446;0,348282747;0,134804646;0,213513545;0,134804646;0,348318191
218;REGIONAL;17/05/21;2021;20;RA_Madeira;All;2354;7625;0;9979;90791;41855;0;132646;48945;41855;90800;0,357553274;0,164833434;0,192755284;0,164833434;0,357588718
219;REGIONAL;24/05/21;2021;21;RA_Madeira;All;3465;8993;0;12458;94256;50848;0;145104;43419;50848;94267;0,371199143;0,200249682;0,170992781;0,200249682;0,371242463
220;REGIONAL;31/05/21;2021;22;RA_Madeira;All;7583;10945;0;18528;101839;61793;0;163632;40367;61793;102160;0,401062527;0,2433533;0,15897339;0,2433533;0,40232669
221;REGIONAL;07/06/21;2021;23;RA_Madeira;All;3631;15315;0;18946;105470;77108;0;182578;30782;77108;107890;0,415362137;0,30366686;0,121225726;0,30366686;0,424892586
222;REGIONAL;14/06/21;2021;24;RA_Madeira;All;3526;8115;0;11641;108996;85223;0;194219;28713;85223;113936;0,429248237;0,335625367;0,113077587;0,335625367;0,448702953
223;REGIONAL;21/06/21;2021;25;RA_Madeira;All;12581;3704;0;16285;121577;88927;0;210504;37734;88927;126661;0,478794753;0,350212466;0,148604104;0,350212466;0,49881657
224;REGIONAL;28/06/21;2021;26;RA_Madeira;All;10008;12294;0;22302;131585;101221;0;232806;35623;101221;136844;0,518208276;0,398628718;0,140290561;0,398628718;0,538919279
225;REGIONAL;05/07/21;2021;27;RA_Madeira;All;12511;6895;0;19406;144096;108116;0;252212;41623;108116;149739;0,567479118;0,425782619;0,163919771;0,425782619;0,58970239
226;REGIONAL;12/07/21;2021;28;RA_Madeira;All;10393;5571;0;15964;154489;113687;0;268176;47688;113687;161375;0,608408848;0,447722341;0,187804964;0,447722341;0,635527306
227;REGIONAL;19/07/21;2021;29;RA_Madeira;All;4181;14656;0;18837;158670;128343;0;287013;39581;128343;167924;0,62487447;0,505440626;0,155877963;0,505440626;0,661318589
228;REGIONAL;26/07/21;2021;30;RA_Madeira;All;5512;13629;0;19141;164182;141972;0;306154;34698;141972;176670;0,646581838;0,559114377;0,136647724;0,559114377;0,695762101
229;REGIONAL;02/08/21;2021;31;RA_Madeira;All;4369;14141;0;18510;168551;156113;0;324664;26992;156113;183105;0,663787841;0,614804488;0,106299941;0,614804488;0,721104429
230;REGIONAL;09/08/21;2021;32;RA_Madeira;All;5114;10949;0;16063;173665;167062;0;340727;22779;167062;189841;0,683927805;0,657923859;0,089708297;0,657923859;0,747632156
231;REGIONAL;16/08/21;2021;33;RA_Madeira;All;3313;8079;0;11392;176978;175141;0;352119;19193;175141;194334;0,696975067;0,689740591;0,075585906;0,689740591;0,765326497
232;REGIONAL;04/01/21;2021;1;RA_Acores;All;3646;2;0;3648;5634;2;0;5636;5632;2;5634;0,023261671;8,26E-06;0,023253413;8,26E-06;0,023261671
233;REGIONAL;11/01/21;2021;2;RA_Acores;All;1;0;0;1;5635;2;0;5637;5633;2;5635;0,0232658;8,26E-06;0,023257542;8,26E-06;0,0232658
234;REGIONAL;18/01/21;2021;3;RA_Acores;All;31;1926;7;1964;5666;1928;7;7601;3738;1928;5666;0,023393793;0,00796033;0,015433462;0,00796033;0,023393793
235;REGIONAL;25/01/21;2021;4;RA_Acores;All;280;3500;47;3827;5946;5428;54;11428;518;5428;5946;0,024549857;0,022411138;0,002138719;0,022411138;0,024549857
236;REGIONAL;01/02/21;2021;5;RA_Acores;All;1881;17;0;1898;7827;5445;54;13326;2382;5445;7827;0,032316134;0,022481327;0,009834807;0,022481327;0,032316134
237;REGIONAL;08/02/21;2021;6;RA_Acores;All;1059;4;0;1063;8886;5449;54;14389;3437;5449;8886;0,036688536;0,022497843;0,014190693;0,022497843;0,036688536
238;REGIONAL;15/02/21;2021;7;RA_Acores;All;2079;322;3;2404;10965;5771;57;16793;5194;5771;10965;0,045272315;0,023827317;0,021444998;0,023827317;0,045272315
239;REGIONAL;22/02/21;2021;8;RA_Acores;All;1481;1617;13;3111;12446;7388;70;19904;5058;7388;12446;0,051387071;0,03050359;0,020883481;0,03050359;0,051387071
240;REGIONAL;01/03/21;2021;9;RA_Acores;All;762;1156;8;1926;13208;8544;78;21830;4664;8544;13208;0,054533218;0,035276485;0,019256733;0,035276485;0,054533218
241;REGIONAL;08/03/21;2021;10;RA_Acores;All;2620;2063;9;4692;15828;10607;87;26522;5222;10607;15829;0,06535068;0,043794204;0,021560605;0,043794204;0,065354809
242;REGIONAL;15/03/21;2021;11;RA_Acores;All;2541;1440;8;3989;18369;12047;95;30511;6324;12047;18371;0,075841966;0,049739679;0,026110545;0,049739679;0,075850224
243;REGIONAL;22/03/21;2021;12;RA_Acores;All;4118;744;0;4862;22487;12791;95;35373;9700;12791;22491;0,092844373;0,052811508;0,04004938;0,052811508;0,092860888
244;REGIONAL;29/03/21;2021;13;RA_Acores;All;1952;766;0;2718;24439;13557;95;38091;10887;13557;24444;0,100903795;0,05597417;0,044950269;0,05597417;0,100924439
245;REGIONAL;05/04/21;2021;14;RA_Acores;All;3894;2369;2;6265;28333;15926;97;44356;12418;15926;28344;0,11698135;0,065755302;0,051271465;0,065755302;0,117026767
246;REGIONAL;12/04/21;2021;15;RA_Acores;All;4247;2413;0;6660;32580;18339;97;51016;14252;18339;32591;0,134516373;0,075718102;0,058843688;0,075718102;0,13456179
247;REGIONAL;19/04/21;2021;16;RA_Acores;All;8000;1061;0;9061;40580;19400;97;60077;21191;19400;40591;0,16754679;0,080098761;0,087493446;0,080098761;0,167592206
248;REGIONAL;26/04/21;2021;17;RA_Acores;All;9279;2968;1;12248;49859;22368;98;72325;27505;22368;49873;0,205857944;0,092353046;0,113562702;0,092353046;0,205915748
249;REGIONAL;03/05/21;2021;18;RA_Acores;All;9759;2837;0;12596;59618;25205;98;84921;34430;25205;59635;0,246150924;0,104066457;0,142154657;0,104066457;0,246221114
250;REGIONAL;10/05/21;2021;19;RA_Acores;All;9467;2315;1;11783;69085;27520;99;96704;41583;27520;69103;0,285238294;0,113624634;0,171687978;0,113624634;0,285312612
251;REGIONAL;17/05/21;2021;20;RA_Acores;All;12181;5094;0;17275;81266;32614;99;113979;48675;32614;81289;0,335531232;0,134656752;0,200969443;0,134656752;0,335626195
252;REGIONAL;24/05/21;2021;21;RA_Acores;All;5677;8207;0;13884;86943;40821;99;127863;46145;40821;86966;0,358970442;0,168541831;0,190523573;0,168541831;0,359065404
253;REGIONAL;31/05/21;2021;22;RA_Acores;All;5494;10158;0;15652;92437;50979;99;143515;41485;50979;92464;0,381654081;0,210482203;0,171283356;0,210482203;0,381765558
254;REGIONAL;07/06/21;2021;23;RA_Acores;All;7920;12016;4;19940;100357;62995;103;163455;37391;62995;100386;0,414354193;0,260093889;0,15438004;0,260093889;0,414473929
255;REGIONAL;14/06/21;2021;24;RA_Acores;All;9314;7720;1;17035;109671;70715;104;180490;39461;70715;110176;0,452809856;0,291968241;0,16292666;0,291968241;0,454894901
256;REGIONAL;21/06/21;2021;25;RA_Acores;All;7554;10155;0;17709;117225;80870;104;198199;39680;80870;120550;0,483998827;0,333896227;0,163830868;0,333896227;0,497727094
257;REGIONAL;28/06/21;2021;26;RA_Acores;All;6714;12533;7;19254;123939;93403;111;217453;35410;93403;128813;0,511719605;0,385642504;0,146200883;0,385642504;0,531843386
258;REGIONAL;05/07/21;2021;27;RA_Acores;All;6174;16162;7;22343;130113;109565;118;239796;27163;109565;136728;0,537210829;0,452372203;0,112150652;0,452372203;0,564522855
259;REGIONAL;12/07/21;2021;28;RA_Acores;All;2849;11754;3;14606;132962;121319;121;254402;19886;121319;141205;0,548973786;0,500902143;0,082105359;0,500902143;0,583007502
260;REGIONAL;19/07/21;2021;29;RA_Acores;All;5736;8955;2;14693;138698;130274;123;269095;18454;130274;148728;0,572656595;0,537875566;0,076192914;0,537875566;0,61406848
261;REGIONAL;26/07/21;2021;30;RA_Acores;All;7165;8882;5;16052;145863;139156;128;285147;19482;139156;158638;0,602239462;0,574547587;0,080437323;0,574547587;0,654984909
262;REGIONAL;02/08/21;2021;31;RA_Acores;All;9743;6579;3;16325;155606;145735;131;301472;26301;145735;172036;0,642466381;0,601710976;0,108591624;0,601710976;0,7103026
263;REGIONAL;09/08/21;2021;32;RA_Acores;All;5030;6549;4;11583;160636;152284;135;313055;26361;152284;178645;0,663234256;0,628750501;0,108839352;0,628750501;0,737589853
264;REGIONAL;16/08/21;2021;33;RA_Acores;All;2254;7316;2;9572;162890;159600;137;322627;22039;159600;181639;0,672540576;0,658956817;0,09099467;0,658956817;0,749951487
265;AGES;04/01/21;2021;1;All;0-17 anos;4;0;0;4;6;0;0;6;6;0;6;3,53E-06;0;3,53E-06;0;3,53E-06
266;AGES;04/01/21;2021;1;All;18-24 anos;1802;2;0;1804;3162;3;0;3165;3159;3;3162;0,004047749;3,84E-06;0,004043908;3,84E-06;0,004047749
267;AGES;04/01/21;2021;1;All;25-49 anos;27615;47;0;27662;51423;52;0;51475;51377;52;51429;0,015435107;1,56E-05;0,0154213;1,56E-05;0,015436908
268;AGES;04/01/21;2021;1;All;50-64 anos;12988;8;0;12996;22207;8;0;22215;22202;8;22210;0,010213961;3,68E-06;0,010211661;3,68E-06;0,010215341
269;AGES;04/01/21;2021;1;All;65-79 anos;2309;1;0;2310;3262;1;0;3263;3261;1;3262;0,002003614;6,14E-07;0,002003;6,14E-07;0,002003614
270;AGES;04/01/21;2021;1;All;80 ou mais anos;3796;6;0;3802;4063;6;0;4069;4057;6;4063;0,005961062;8,80E-06;0,005952259;8,80E-06;0,005961062
271;AGES;04/01/21;2021;1;All;Desconhecido;1;0;0;1;1;0;0;1;1;0;1;NA;NA;NA;NA;NA
272;AGES;11/01/21;2021;2;All;0-17 anos;15;0;0;15;21;0;0;21;21;0;21;1,23E-05;0;1,23E-05;0;1,23E-05
273;AGES;11/01/21;2021;2;All;18-24 anos;1418;56;0;1474;4580;59;0;4639;4521;59;4580;0,005862963;7,55E-05;0,005787436;7,55E-05;0,005862963
274;AGES;11/01/21;2021;2;All;25-49 anos;16569;790;0;17359;67992;842;0;68834;67156;842;67998;0,020408451;0,000252734;0,020157518;0,000252734;0,020410252
275;AGES;11/01/21;2021;2;All;50-64 anos;11680;303;0;11983;33887;311;0;34198;33579;311;33890;0,015586099;0,000143042;0,015444436;0,000143042;0,015587479
276;AGES;11/01/21;2021;2;All;65-79 anos;5535;27;0;5562;8797;28;0;8825;8769;28;8797;0,00540337;1,72E-05;0,005386172;1,72E-05;0,00540337
277;AGES;11/01/21;2021;2;All;80 ou mais anos;14484;0;1;14485;18547;6;1;18554;18541;6;18547;0,027211373;8,80E-06;0,02720257;8,80E-06;0,027211373
278;AGES;11/01/21;2021;2;All;Desconhecido;0;0;0;0;1;0;0;1;1;0;1;NA;NA;NA;NA;NA
279;AGES;18/01/21;2021;3;All;0-17 anos;69;1;0;70;90;1;0;91;89;1;90;5,29E-05;5,88E-07;5,23E-05;5,88E-07;5,29E-05
280;AGES;18/01/21;2021;3;All;18-24 anos;3829;1196;0;5025;8409;1255;0;9664;7154;1255;8409;0,010764553;0,001606554;0,009157999;0,001606554;0,010764553
281;AGES;18/01/21;2021;3;All;25-49 anos;37492;21714;5;59211;105484;22556;5;128045;82935;22556;105491;0,031662035;0,0067704;0,024893736;0,0067704;0,031664136
282;AGES;18/01/21;2021;3;All;50-64 anos;27406;8579;2;35987;61293;8890;2;70185;52406;8890;61296;0,028191305;0,004088896;0,024103789;0,004088896;0,028192685
283;AGES;18/01/21;2021;3;All;65-79 anos;14085;911;1;14997;22882;939;1;23822;21943;939;22882;0,014054782;0,000576761;0,013478021;0,000576761;0,014054782
284;AGES;18/01/21;2021;3;All;80 ou mais anos;39017;257;2;39276;57564;263;3;57830;57301;263;57564;0,084455464;0,000385862;0,084069602;0,000385862;0,084455464
285;AGES;18/01/21;2021;3;All;Desconhecido;0;0;0;0;1;0;0;1;1;0;1;NA;NA;NA;NA;NA
286;AGES;25/01/21;2021;4;All;0-17 anos;14;3;0;17;104;4;0;108;100;4;104;6,11E-05;2,35E-06;5,88E-05;2,35E-06;6,11E-05
287;AGES;25/01/21;2021;4;All;18-24 anos;1373;1628;1;3002;9782;2883;1;12666;6900;2883;9783;0,012522162;0,003690594;0,008832848;0,003690594;0,012523442
288;AGES;25/01/21;2021;4;All;25-49 anos;15620;26085;12;41717;121104;48641;17;169762;72470;48641;121111;0,036350528;0,014600063;0,021752566;0,014600063;0,036352629
289;AGES;25/01/21;2021;4;All;50-64 anos;10760;12408;9;23177;72053;21298;11;93362;50758;21298;72056;0,033140295;0,009795873;0,023345802;0,009795873;0,033141675
290;AGES;25/01/21;2021;4;All;65-79 anos;6527;2139;14;8680;29409;3078;15;32502;26331;3078;29409;0,018063853;0,001890596;0,016173257;0,001890596;0,018063853
291;AGES;25/01/21;2021;4;All;80 ou mais anos;7364;3370;23;10757;64928;3633;26;68587;61295;3633;64928;0,095259614;0,005330184;0,08992943;0,005330184;0,095259614
292;AGES;25/01/21;2021;4;All;Desconhecido;0;0;0;0;1;0;0;1;1;0;1;NA;NA;NA;NA;NA
293;AGES;01/02/21;2021;5;All;0-17 anos;35;4;0;39;139;8;0;147;131;8;139;8,17E-05;4,70E-06;7,70E-05;4,70E-06;8,17E-05
294;AGES;01/02/21;2021;5;All;18-24 anos;980;941;0;1921;10762;3824;1;14587;6940;3824;10764;0,013776683;0,00489519;0,008884053;0,00489519;0,013779243
295;AGES;01/02/21;2021;5;All;25-49 anos;10032;12522;1;22555;131136;61163;18;192317;69985;61163;131148;0,039361729;0,018358661;0,021006669;0,018358661;0,039365331
296;AGES;01/02/21;2021;5;All;50-64 anos;5538;9209;0;14747;77591;30507;11;108109;47088;30507;77595;0,035687461;0,01403149;0,02165781;0,01403149;0,035689301
297;AGES;01/02/21;2021;5;All;65-79 anos;2747;4169;0;6916;32156;7247;15;39418;24909;7247;32156;0,019751139;0,004451316;0,015299823;0,004451316;0,019751139
298;AGES;01/02/21;2021;5;All;80 ou mais anos;4526;10641;0;15167;69454;14274;26;83754;55180;14274;69454;0,101899969;0,020942209;0,080957761;0,020942209;0,101899969
299;AGES;01/02/21;2021;5;All;Desconhecido;0;0;0;0;1;0;0;1;1;0;1;NA;NA;NA;NA;NA
300;AGES;08/02/21;2021;6;All;0-17 anos;37;67;0;104;176;75;0;251;101;75;176;0,000103427;4,41E-05;5,94E-05;4,41E-05;0,000103427
301;AGES;08/02/21;2021;6;All;18-24 anos;1460;3054;0;4514;12222;6878;1;19101;5346;6878;12224;0,015645662;0,008804685;0,006843537;0,008804685;0,015648222
302;AGES;08/02/21;2021;6;All;25-49 anos;13824;30798;3;44625;144960;91961;21;236942;53011;91961;144972;0,043511135;0,027602977;0,01591176;0,027602977;0,043514737
303;AGES;08/02/21;2021;6;All;50-64 anos;6876;22266;3;29145;84467;52773;14;137254;31698;52773;84471;0,038850031;0,024272588;0,014579283;0,024272588;0,038851871
304;AGES;08/02/21;2021;6;All;65-79 anos;3739;11511;2;15252;35895;18758;17;54670;17137;18758;35895;0,02204774;0,011521703;0,010526038;0,011521703;0,02204774
305;AGES;08/02/21;2021;6;All;80 ou mais anos;14834;31520;2;46356;84288;45794;28;130110;38494;45794;84288;0,123663786;0,067187019;0,056476768;0,067187019;0,123663786
306;AGES;08/02/21;2021;6;All;Desconhecido;1;0;0;1;2;0;0;2;2;0;2;NA;NA;NA;NA;NA
307;AGES;15/02/21;2021;7;All;0-17 anos;32;16;0;48;208;91;0;299;117;91;208;0,000122232;5,35E-05;6,88E-05;5,35E-05;0,000122232
308;AGES;15/02/21;2021;7;All;18-24 anos;2295;1731;0;4026;14517;8609;1;23127;5910;8609;14519;0,018583544;0,011020578;0,007565526;0,011020578;0,018586104
309;AGES;15/02/21;2021;7;All;25-49 anos;22280;18964;7;41251;167240;110925;28;278193;56327;110925;167252;0,050198691;0,033295203;0,016907089;0,033295203;0,050202293
310;AGES;15/02/21;2021;7;All;50-64 anos;25097;12950;2;38049;109564;65723;16;175303;43845;65723;109568;0,050393229;0,030228854;0,020166214;0,030228854;0,050395068
311;AGES;15/02/21;2021;7;All;65-79 anos;5091;7230;0;12321;40986;25988;17;66991;14998;25988;40986;0,025174779;0,015962576;0,009212203;0,015962576;0,025174779
312;AGES;15/02/21;2021;7;All;80 ou mais anos;48608;9246;2;57856;132896;55040;30;187966;77856;55040;132896;0,194979386;0,080752358;0,114227028;0,080752358;0,194979386
313;AGES;15/02/21;2021;7;All;Desconhecido;0;0;0;0;2;0;0;2;2;0;2;NA;NA;NA;NA;NA
314;AGES;22/02/21;2021;8;All;0-17 anos;23;32;0;55;231;123;0;354;108;123;231;0,000135748;7,23E-05;6,35E-05;7,23E-05;0,000135748
315;AGES;22/02/21;2021;8;All;18-24 anos;1305;696;1;2002;15822;9305;2;25129;6519;9305;15824;0,020254104;0,011911544;0,008345121;0,011911544;0,020256665
316;AGES;22/02/21;2021;8;All;25-49 anos;11565;7293;5;18863;178805;118218;33;297056;60599;118218;178817;0,053670036;0,035484267;0,018189371;0,035484267;0,053673638
317;AGES;22/02/21;2021;8;All;50-64 anos;49790;4957;2;54749;159354;70680;18;230052;88678;70680;159358;0,073293806;0,032508793;0,040786853;0,032508793;0,073295646
318;AGES;22/02/21;2021;8;All;65-79 anos;11643;2455;2;14100;52629;28443;19;81091;24186;28443;52629;0,032326244;0,017470508;0,014855736;0,017470508;0,032326244
319;AGES;22/02/21;2021;8;All;80 ou mais anos;102544;5189;4;107737;235440;60229;34;295703;175211;60229;235440;0,345427603;0,08836544;0,257062163;0,08836544;0,345427603
320;AGES;22/02/21;2021;8;All;Desconhecido;0;0;0;0;2;0;0;2;2;0;2;NA;NA;NA;NA;NA
321;AGES;01/03/21;2021;9;All;0-17 anos;11;30;0;41;242;153;0;395;89;153;242;0,000142212;8,99E-05;5,23E-05;8,99E-05;0,000142212
322;AGES;01/03/21;2021;9;All;18-24 anos;920;1031;1;1952;16742;10336;3;27081;6409;10336;16745;0,021431817;0,01323135;0,008204308;0,01323135;0,021435658
323;AGES;01/03/21;2021;9;All;25-49 anos;7560;9969;4;17533;186365;128187;37;314589;58201;128187;186388;0,055939243;0,038476558;0,017469589;0,038476558;0,055946147
324;AGES;01/03/21;2021;9;All;50-64 anos;30124;5967;4;36095;189478;76647;22;266147;112839;76647;189486;0,087149138;0,035253275;0,051899543;0,035253275;0,087152818
325;AGES;01/03/21;2021;9;All;65-79 anos;13232;3783;2;17017;65861;32226;21;98108;33641;32226;65867;0,040453718;0,019794135;0,020663269;0,019794135;0,040457404
326;AGES;01/03/21;2021;9;All;80 ou mais anos;87177;12743;2;99922;322617;72972;36;395625;249645;72972;322617;0,473330008;0,10706143;0,366268578;0,10706143;0,473330008
327;AGES;01/03/21;2021;9;All;Desconhecido;0;0;0;0;2;0;0;2;2;0;2;NA;NA;NA;NA;NA
328;AGES;08/03/21;2021;10;All;0-17 anos;17;25;0;42;259;178;0;437;81;178;259;0,000152202;0,000104602;4,76E-05;0,000104602;0,000152202
329;AGES;08/03/21;2021;10;All;18-24 anos;1342;643;1;1986;18084;10979;4;29067;7111;10979;18090;0,023149742;0,014054469;0,009102954;0,014054469;0,023157423
330;AGES;08/03/21;2021;10;All;25-49 anos;16238;6195;7;22440;202603;134382;44;337029;68259;134382;202641;0,060813234;0,040336047;0,020488594;0,040336047;0,06082464
331;AGES;08/03/21;2021;10;All;50-64 anos;22150;4275;1;26426;211628;80922;23;292573;130722;80922;211644;0,097336882;0,037219532;0,060124709;0,037219532;0,097344241
332;AGES;08/03/21;2021;10;All;65-79 anos;15829;3548;0;19377;81690;35774;21;117485;45933;35774;81707;0,050176345;0,021973419;0,028213368;0,021973419;0,050186787
333;AGES;08/03/21;2021;10;All;80 ou mais anos;40126;37264;0;77390;362743;110236;36;473015;252507;110236;362743;0,532201177;0,161733594;0,370467583;0,161733594;0,532201177
334;AGES;08/03/21;2021;10;All;Desconhecido;0;0;0;0;2;0;0;2;2;0;2;NA;NA;NA;NA;NA
335;AGES;15/03/21;2021;11;All;0-17 anos;5;23;0;28;264;201;0;465;63;201;264;0,00015514;0,000118118;3,70E-05;0,000118118;0,00015514
336;AGES;15/03/21;2021;11;All;18-24 anos;265;388;1;654;18349;11367;5;29721;6989;11367;18356;0,023488975;0,014551157;0,008946779;0,014551157;0,023497936
337;AGES;15/03/21;2021;11;All;25-49 anos;4570;3215;1;7786;207173;137597;45;344815;69621;137597;207218;0,062184964;0,04130106;0,020897411;0,04130106;0,062198471
338;AGES;15/03/21;2021;11;All;50-64 anos;4473;2304;2;6779;216101;83226;25;299352;132900;83226;216126;0,099394209;0,038279242;0,061126466;0,038279242;0,099405707
339;AGES;15/03/21;2021;11;All;65-79 anos;18087;6818;4;24909;99777;42592;25;142394;57208;42592;99800;0,0612859;0,02616123;0,035138797;0,02616123;0,061300027
340;AGES;15/03/21;2021;11;All;80 ou mais anos;54360;97357;8;151725;417103;207593;44;624740;209510;207593;417103;0,611955868;0,304571663;0,307384205;0,304571663;0,611955868
341;AGES;15/03/21;2021;11;All;Desconhecido;0;0;0;0;2;0;0;2;2;0;2;NA;NA;NA;NA;NA
342;AGES;22/03/21;2021;12;All;0-17 anos;30;11;0;41;294;212;0;506;82;212;294;0,00017277;0,000124582;4,82E-05;0,000124582;0,00017277
343;AGES;22/03/21;2021;12;All;18-24 anos;3145;149;0;3294;21494;11516;5;33015;9986;11516;21502;0,027514961;0,014741895;0,012783307;0,014741895;0,027525202
344;AGES;22/03/21;2021;12;All;25-49 anos;42094;1538;1;43633;249267;139135;46;388448;110183;139135;249318;0,074819882;0,041762705;0,033072485;0,041762705;0,07483519
345;AGES;22/03/21;2021;12;All;50-64 anos;34463;964;1;35428;250564;84190;26;334780;166406;84190;250596;0,115245235;0,038722627;0,076537326;0,038722627;0,115259953
346;AGES;22/03/21;2021;12;All;65-79 anos;52746;2169;0;54915;152523;44761;25;197309;107793;44761;152554;0,093684009;0,027493492;0,066209558;0,027493492;0,09370305
347;AGES;22/03/21;2021;12;All;80 ou mais anos;124534;16889;0;141423;541637;224482;44;766163;317155;224482;541637;0,794666882;0,329350489;0,465316393;0,329350489;0,794666882
348;AGES;22/03/21;2021;12;All;Desconhecido;0;0;0;0;2;0;0;2;2;0;2;NA;NA;NA;NA;NA
349;AGES;29/03/21;2021;13;All;0-17 anos;16;14;0;30;310;226;0;536;84;226;310;0,000182172;0,000132809;4,94E-05;0,000132809;0,000182172
350;AGES;29/03/21;2021;13;All;18-24 anos;554;89;0;643;22048;11605;5;33658;10453;11605;22058;0,02822415;0,014855826;0,013381125;0,014855826;0,028236951
351;AGES;29/03/21;2021;13;All;25-49 anos;4497;1044;1;5542;253764;140179;47;393990;113660;140179;253839;0,076169699;0,042076072;0,03411614;0,042076072;0,076192211
352;AGES;29/03/21;2021;13;All;50-64 anos;7695;737;1;8433;258259;84927;27;343213;173378;84927;258305;0,118784499;0,039061605;0,079744051;0,039061605;0,118805656
353;AGES;29/03/21;2021;13;All;65-79 anos;88194;7334;0;95528;240717;52095;25;292837;188660;52095;240755;0,147855298;0,031998246;0,115880392;0,031998246;0,147878638
354;AGES;29/03/21;2021;13;All;80 ou mais anos;36733;75386;1;112120;578370;299868;45;878283;278503;299868;578371;0,848559985;0,439953638;0,408607814;0,439953638;0,848561452
355;AGES;29/03/21;2021;13;All;Desconhecido;0;0;0;0;2;0;0;2;2;0;2;NA;NA;NA;NA;NA
356;AGES;05/04/21;2021;14;All;0-17 anos;29;3;0;32;339;229;0;568;110;229;339;0,000199214;0,000134572;6,46E-05;0,000134572;0,000199214
357;AGES;05/04/21;2021;14;All;18-24 anos;783;154;0;937;22831;11759;5;34595;11094;11759;22853;0,029226486;0,015052965;0,014201683;0,015052965;0,029254648
358;AGES;05/04/21;2021;14;All;25-49 anos;9033;1207;0;10240;262797;141386;47;404230;121540;141386;262926;0,078881041;0,042438364;0,036481397;0,042438364;0,078919762
359;AGES;05/04/21;2021;14;All;50-64 anos;15122;906;0;16028;273381;85833;27;359241;187628;85833;273461;0,125739761;0,039478314;0,086298243;0,039478314;0,125776557
360;AGES;05/04/21;2021;14;All;65-79 anos;201307;5289;2;206598;442024;57384;27;499435;384694;57384;442078;0,271503841;0,035246902;0,236290108;0,035246902;0,271537009
361;AGES;05/04/21;2021;14;All;80 ou mais anos;30371;45804;7;76182;608741;345672;52;954465;263070;345672;608742;0,893119031;0,507155328;0,38596517;0,507155328;0,893120498
362;AGES;05/04/21;2021;14;All;Desconhecido;0;0;0;0;2;0;0;2;2;0;2;NA;NA;NA;NA;NA
363;AGES;12/04/21;2021;15;All;0-17 anos;45;5;0;50;384;234;0;618;150;234;384;0,000225658;0,000137511;8,81E-05;0,000137511;0,000225658
364;AGES;12/04/21;2021;15;All;18-24 anos;4276;92;0;4368;27107;11851;5;38963;15285;11851;27136;0,034700291;0,015170736;0,019566678;0,015170736;0,034737415
365;AGES;12/04/21;2021;15;All;25-49 anos;89046;745;1;89792;351843;142131;48;494022;209851;142131;351982;0,105609052;0,042661983;0,062988791;0,042661983;0,105650775
366;AGES;12/04/21;2021;15;All;50-64 anos;87947;544;0;88491;361328;86377;27;447732;275039;86377;361416;0,166190395;0,039728523;0,126502347;0,039728523;0,16623087
367;AGES;12/04/21;2021;15;All;65-79 anos;233760;3541;1;237302;675784;60925;28;736737;614914;60925;675839;0,415085949;0,037421885;0,377697846;0,037421885;0,415119732
368;AGES;12/04/21;2021;15;All;80 ou mais anos;10520;49468;3;59991;619261;395140;55;1014456;224122;395140;619262;0,908553529;0,579732684;0,328822313;0,579732684;0,908554996
369;AGES;12/04/21;2021;15;All;Desconhecido;0;0;0;0;2;0;0;2;2;0;2;NA;NA;NA;NA;NA
370;AGES;19/04/21;2021;16;All;0-17 anos;34;14;0;48;418;248;0;666;170;248;418;0,000245639;0,000145738;9,99E-05;0,000145738;0,000245639
371;AGES;19/04/21;2021;16;All;18-24 anos;1295;89;0;1384;28402;11940;5;40347;16491;11940;28431;0,03635805;0,015284667;0,021110507;0,015284667;0,036395174
372;AGES;19/04/21;2021;16;All;25-49 anos;10994;798;0;11792;362837;142929;48;505814;220050;142929;362979;0,108909007;0,042901511;0,066050119;0,042901511;0,10895163
373;AGES;19/04/21;2021;16;All;50-64 anos;14403;1755;0;16158;375731;88132;27;463890;287689;88132;375821;0,172814959;0,040535724;0,13232063;0,040535724;0,172856354
374;AGES;19/04/21;2021;16;All;65-79 anos;175860;13190;2;189052;851644;74115;30;925789;777586;74115;851701;0,523104214;0,045523562;0,477615662;0,045523562;0,523139225
375;AGES;19/04/21;2021;16;All;80 ou mais anos;8423;123175;8;131606;627684;518315;63;1146062;109370;518315;627685;0,920911398;0,760449831;0,160463035;0,760449831;0,920912866
376;AGES;19/04/21;2021;16;All;Desconhecido;0;0;0;0;2;0;0;2;2;0;2;NA;NA;NA;NA;NA
377;AGES;26/04/21;2021;17;All;0-17 anos;50;28;0;78;468;276;0;744;192;276;468;0,000275021;0,000162192;0,000112829;0,000162192;0,000275021
378;AGES;26/04/21;2021;17;All;18-24 anos;2613;161;0;2774;31015;12101;5;43121;18965;12101;31066;0,039703011;0,015490767;0,024277531;0,015490767;0,039768298
379;AGES;26/04/21;2021;17;All;25-49 anos;10885;886;3;11774;373722;143815;51;517588;230097;143815;373912;0,112176244;0,043167452;0,069065822;0,043167452;0,112233274
380;AGES;26/04/21;2021;17;All;50-64 anos;32887;2908;1;35796;408618;91040;28;499686;317931;91040;408971;0,187941114;0,041873239;0,146230236;0,041873239;0,188103474
381;AGES;26/04/21;2021;17;All;65-79 anos;293224;46318;2;339544;1144868;120433;32;1265333;1025492;120433;1145925;0,703210819;0,073973409;0,62988665;0,073973409;0,703860059
382;AGES;26/04/21;2021;17;All;80 ou mais anos;6147;39768;2;45917;633831;558083;65;1191979;75760;558083;633843;0,929930017;0,818795757;0,111151865;0,818795757;0,929947622
383;AGES;26/04/21;2021;17;All;Desconhecido;1;0;0;1;3;0;0;3;3;0;3;NA;NA;NA;NA;NA
384;AGES;03/05/21;2021;18;All;0-17 anos;110;15;1;126;578;291;1;870;287;291;578;0,000339663;0,000171007;0,000168656;0,000171007;0,000339663
385;AGES;03/05/21;2021;18;All;18-24 anos;1805;795;2;2602;32820;12896;7;45723;20003;12896;32899;0,042013633;0,016508465;0,025606298;0,016508465;0,042114763
386;AGES;03/05/21;2021;18;All;25-49 anos;10193;7964;2;18159;383915;151779;53;535747;232397;151779;384176;0,115235771;0,045557923;0,069756189;0,045557923;0,115314113
387;AGES;03/05/21;2021;18;All;50-64 anos;151461;14638;3;166102;560079;105678;31;665788;460410;105678;566088;0,257604588;0,048605889;0,211762498;0,048605889;0,260368387
388;AGES;03/05/21;2021;18;All;65-79 anos;202429;164050;4;366483;1347297;284483;36;1631816;1070396;284483;1354879;0,827548527;0,174737632;0,657467977;0,174737632;0,832205609
389;AGES;03/05/21;2021;18;All;80 ou mais anos;5103;31782;4;36889;638934;589865;69;1228868;49229;589865;639094;0,937416922;0,865424962;0,072226705;0,865424962;0,937651667
390;AGES;03/05/21;2021;18;All;Desconhecido;1;0;0;1;4;0;0;4;4;0;4;NA;NA;NA;NA;NA
391;AGES;10/05/21;2021;19;All;0-17 anos;162;44;0;206;740;335;1;1076;405;335;740;0,000434863;0,000196863;0,000237999;0,000196863;0,000434863
392;AGES;10/05/21;2021;19;All;18-24 anos;2216;5367;0;7583;35036;18263;7;53306;16867;18263;35130;0,044850386;0,023378884;0,021591833;0,023378884;0,044970717
393;AGES;10/05/21;2021;19;All;25-49 anos;24987;100098;2;125087;408902;251877;55;660834;157379;251877;409256;0,122735859;0,075603298;0,047238817;0,075603298;0,122842115
394;AGES;10/05/21;2021;19;All;50-64 anos;166648;109577;6;276231;726727;215255;37;942019;527196;215255;742451;0,33425322;0,099005097;0,242480272;0,099005097;0,341485369
395;AGES;10/05/21;2021;19;All;65-79 anos;91570;80142;2;171714;1438867;364625;38;1803530;1089646;364625;1454271;0,883793452;0,223963151;0,66929188;0,223963151;0,893255031
396;AGES;10/05/21;2021;19;All;80 ou mais anos;3780;9975;2;13757;642714;599840;71;1242625;43235;599840;643075;0,942962778;0,88005986;0,063432562;0,88005986;0,943492422
397;AGES;10/05/21;2021;19;All;Desconhecido;0;1;0;1;4;1;0;5;3;1;4;NA;NA;NA;NA;NA
398;AGES;17/05/21;2021;20;All;0-17 anos;313;25;0;338;1053;360;1;1414;693;360;1053;0,000618798;0,000211555;0,000407243;0,000211555;0,000618798
399;AGES;17/05/21;2021;20;All;18-24 anos;2063;2406;1;4470;37099;20669;8;57776;16527;20669;37196;0,047491279;0,02645886;0,021156591;0,02645886;0,047615451
400;AGES;17/05/21;2021;20;All;25-49 anos;32432;21832;2;54266;441334;273709;57;715100;168100;273709;441809;0,132470635;0,082156383;0,050456828;0,082156383;0,13261321
401;AGES;17/05/21;2021;20;All;50-64 anos;224722;75604;3;300329;951449;290859;40;1242348;694535;290859;985394;0,4376126;0,13377865;0,319446725;0,13377865;0,453225375
402;AGES;17/05/21;2021;20;All;65-79 anos;41307;111591;6;152904;1480174;476216;44;1956434;1024540;476216;1500756;0,909165398;0,29250555;0,629301904;0,29250555;0,921807454
403;AGES;17/05/21;2021;20;All;80 ou mais anos;4748;8364;1;13113;647462;608204;72;1255738;40055;608204;648259;0,949928843;0,892331167;0,058767001;0,892331167;0,951098168
404;AGES;17/05/21;2021;20;All;Desconhecido;0;0;0;0;4;1;0;5;3;1;4;NA;NA;NA;NA;NA
405;AGES;24/05/21;2021;21;All;0-17 anos;295;39;0;334;1348;399;1;1748;949;399;1348;0,000792155;0,000234473;0,000557682;0,000234473;0,000792155
406;AGES;24/05/21;2021;21;All;18-24 anos;2224;3216;0;5440;39323;23885;8;63216;15555;23885;39440;0,050338272;0,030575735;0,019912312;0,030575735;0,050488047
407;AGES;24/05/21;2021;21;All;25-49 anos;26135;18250;5;44390;467469;291959;62;759490;176245;291959;468204;0,140315306;0,087634295;0,052901628;0,087634295;0,140535923
408;AGES;24/05/21;2021;21;All;50-64 anos;175183;98364;9;273556;1126632;389223;49;1515904;815427;389223;1204650;0,518186848;0,179020514;0,375050191;0,179020514;0,554070705
409;AGES;24/05/21;2021;21;All;65-79 anos;23614;202474;15;226103;1503788;678690;59;2182537;850305;678690;1528995;0,923669796;0,416870898;0,522281761;0,416870898;0,939152659
410;AGES;24/05/21;2021;21;All;80 ou mais anos;4447;6347;0;10794;651909;614551;72;1266532;38630;614551;653181;0,956453293;0,901643217;0,056676301;0,901643217;0,958319518
411;AGES;24/05/21;2021;21;All;Desconhecido;0;1;0;1;4;2;0;6;2;2;4;NA;NA;NA;NA;NA
412;AGES;31/05/21;2021;22;All;0-17 anos;269;113;0;382;1617;512;1;2130;1105;512;1617;0,000950234;0,000300878;0,000649356;0,000300878;0,000950234
413;AGES;31/05/21;2021;22;All;18-24 anos;2266;2572;1;4839;41589;26457;9;68055;15256;26457;41713;0,053239031;0,033868211;0,019529555;0,033868211;0,053397766
414;AGES;31/05/21;2021;22;All;25-49 anos;42242;23516;14;65772;509711;315475;76;825262;195332;315475;510807;0,152994647;0,094692848;0,058630774;0,094692848;0,153323622
415;AGES;31/05/21;2021;22;All;50-64 anos;163591;168519;6;332116;1290223;557742;55;1848020;860373;557742;1418115;0,593429434;0,2565297;0,395722803;0,2565297;0,652252503
416;AGES;31/05/21;2021;22;All;65-79 anos;18624;137352;23;155999;1522412;816042;82;2338536;737259;816042;1553301;0,935109191;0,501236442;0,45284566;0,501236442;0,954082103
417;AGES;31/05/21;2021;22;All;80 ou mais anos;3047;6045;2;9094;654956;620596;74;1275626;36231;620596;656827;0,960923722;0,910512185;0,05315659;0,910512185;0,963668774
418;AGES;31/05/21;2021;22;All;Desconhecido;0;0;0;0;4;2;0;6;2;2;4;NA;NA;NA;NA;NA
419;AGES;07/06/21;2021;23;All;0-17 anos;389;163;0;552;2006;675;1;2682;1332;675;2007;0,00117883;0,000396665;0,000782753;0,000396665;0,001179418
420;AGES;07/06/21;2021;23;All;18-24 anos;2780;2847;0;5627;44369;29304;9;73682;15213;29304;44517;0,056797773;0,037512721;0,01947451;0,037512721;0,056987231
421;AGES;07/06/21;2021;23;All;25-49 anos;127833;31832;4;159669;637544;347307;80;984931;293397;347307;640704;0,191364949;0,104247528;0,088065925;0,104247528;0,192313453
422;AGES;07/06/21;2021;23;All;50-64 anos;209703;139028;7;348738;1499926;696770;62;2196758;954574;696770;1651344;0,689880925;0,320474698;0,439049923;0,320474698;0,759524621
423;AGES;07/06/21;2021;23;All;65-79 anos;16057;71557;6;87620;1538469;887599;88;2426156;683874;887599;1571473;0,944971862;0,545188808;0,420055059;0,545188808;0,965243867
424;AGES;07/06/21;2021;23;All;80 ou mais anos;2752;4812;1;7565;657708;625408;75;1283191;34549;625408;659957;0,96496134;0,917572147;0,050688831;0,917572147;0,968260978
425;AGES;07/06/21;2021;23;All;Desconhecido;0;0;0;0;4;2;0;6;2;2;4;NA;NA;NA;NA;NA
426;AGES;07/06/21;2021;23;All;NA;1;0;0;1;1;0;0;1;1;0;1;NA;NA;NA;NA;NA
427;AGES;14/06/21;2021;24;All;0-17 anos;573;328;0;901;2579;1003;1;3583;1578;1003;2581;0,001515555;0,000589415;0,000927315;0,000589415;0,00151673
428;AGES;14/06/21;2021;24;All;18-24 anos;2903;4463;0;7366;47272;33767;9;81048;13922;33767;47689;0,060513969;0,04322591;0,017821871;0,04322591;0,061047781
429;AGES;14/06/21;2021;24;All;25-49 anos;239869;85019;7;324895;877413;432326;87;1309826;465427;432326;897753;0,263363931;0,129766797;0,13970238;0,129766797;0,269469177
430;AGES;14/06/21;2021;24;All;50-64 anos;86175;230766;14;316955;1586101;927536;76;2513713;826481;927536;1754017;0,72951654;0,426613976;0,380134405;0,426613976;0,80674838
431;AGES;14/06/21;2021;24;All;65-79 anos;10885;62473;5;73363;1549354;950072;93;2499519;633645;950072;1583717;0,951657742;0,583561519;0,389202965;0,583561519;0,972764484
432;AGES;14/06/21;2021;24;All;80 ou mais anos;2624;4769;0;7393;660332;630177;75;1290584;32676;630177;662853;0,968811162;0,924569022;0,047940844;0,924569022;0,972509867
433;AGES;14/06/21;2021;24;All;Desconhecido;0;0;0;0;4;2;0;6;2;2;4;NA;NA;NA;NA;NA
434;AGES;14/06/21;2021;24;All;NA;0;0;0;0;1;0;0;1;1;0;1;NA;NA;NA;NA;NA
435;AGES;21/06/21;2021;25;All;0-17 anos;403;288;1;692;2982;1291;2;4275;1700;1291;2991;0,001752379;0,000758659;0,000999009;0,000758659;0,001757668
436;AGES;21/06/21;2021;25;All;18-24 anos;2637;2936;0;5573;49909;36703;9;86621;14128;36703;50831;0,063889653;0,04698435;0,018085576;0,04698435;0,065069927
437;AGES;21/06/21;2021;25;All;25-49 anos;272525;56127;2;328654;1149938;488453;89;1638480;707404;488453;1195857;0,345164924;0,146613855;0,212334098;0,146613855;0,358947953
438;AGES;21/06/21;2021;25;All;50-64 anos;86481;183608;15;270104;1672582;1111144;91;2783817;745432;1111144;1856576;0,769292897;0,511063246;0,34285646;0,511063246;0,853919706
439;AGES;21/06/21;2021;25;All;65-79 anos;10302;97034;7;107343;1559656;1047106;100;2606862;548826;1047106;1595932;0,957985526;0,64316259;0,337104698;0,64316259;0,980267288
440;AGES;21/06/21;2021;25;All;80 ou mais anos;3402;4773;2;8177;663734;634950;77;1298761;31750;634950;666700;0,973802433;0,931571766;0,046582256;0,931571766;0,978154022
441;AGES;21/06/21;2021;25;All;Desconhecido;0;0;0;0;4;2;0;6;2;2;4;NA;NA;NA;NA;NA
442;AGES;21/06/21;2021;25;All;NA;0;0;0;0;1;0;0;1;1;0;1;NA;NA;NA;NA;NA
443;AGES;28/06/21;2021;26;All;0-17 anos;196;269;0;465;3178;1560;2;4740;1627;1560;3187;0,001867558;0,000916737;0,00095611;0,000916737;0,001872847
444;AGES;28/06/21;2021;26;All;18-24 anos;1950;3027;1;4978;51859;39730;10;91599;13534;39730;53264;0,066385893;0,050859282;0,017325183;0,050859282;0,068184466
445;AGES;28/06/21;2021;26;All;25-49 anos;314909;61272;16;376197;1464847;549725;105;2014677;977768;549725;1527493;0,439687882;0,165005233;0,293486447;0,165005233;0,45849168
446;AGES;28/06/21;2021;26;All;50-64 anos;59300;178595;11;237906;1731882;1289739;102;3021723;633096;1289739;1922835;0,796567535;0,593206821;0,291188268;0,593206821;0,884395089
447;AGES;28/06/21;2021;26;All;65-79 anos;9065;182039;11;191115;1568721;1229145;111;2797977;377233;1229145;1606378;0,96355351;0,754976174;0,231707347;0,754976174;0,986683521
448;AGES;28/06/21;2021;26;All;80 ou mais anos;3267;5403;1;8671;667001;640353;78;1307432;30033;640353;670386;0,978595637;0,939498819;0,044063146;0,939498819;0,983561965
449;AGES;28/06/21;2021;26;All;Desconhecido;1;0;0;1;5;2;0;7;3;2;5;NA;NA;NA;NA;NA
450;AGES;28/06/21;2021;26;All;NA;0;0;0;0;1;0;0;1;1;0;1;NA;NA;NA;NA;NA
451;AGES;05/07/21;2021;27;All;0-17 anos;416;657;0;1073;3594;2217;2;5813;1386;2217;3603;0,002112022;0,001302825;0,000814486;0,001302825;0,002117311
452;AGES;05/07/21;2021;27;All;18-24 anos;11690;4885;1;16576;63549;44615;11;108175;21815;44615;66430;0,08135053;0,057112683;0,027925881;0,057112683;0,085038564
453;AGES;05/07/21;2021;27;All;25-49 anos;368054;146464;6;514524;1832901;696189;111;2529201;1227426;696189;1923615;0,550162822;0,208967808;0,368423691;0,208967808;0,577391499
454;AGES;05/07/21;2021;27;All;50-64 anos;41361;257575;18;298954;1773243;1547314;120;3320677;423858;1547314;1971172;0,81559125;0,711676719;0,19495065;0,711676719;0,906627369
455;AGES;05/07/21;2021;27;All;65-79 anos;8169;203677;15;211861;1576890;1432822;126;3009838;182819;1432822;1615641;0,968571144;0,880080439;0,112292682;0,880080439;0,992373122
456;AGES;05/07/21;2021;27;All;80 ou mais anos;2678;5228;2;7908;669679;645581;80;1315340;27812;645581;673393;0,982524685;0,947169119;0,040804589;0,947169119;0,987973709
457;AGES;05/07/21;2021;27;All;Desconhecido;0;1;0;1;5;3;0;8;2;3;5;NA;NA;NA;NA;NA
458;AGES;05/07/21;2021;27;All;NA;0;0;0;0;1;0;0;1;1;0;1;NA;NA;NA;NA;NA
459;AGES;12/07/21;2021;28;All;0-17 anos;249;306;0;555;3843;2523;2;6368;1344;2523;3867;0,002258347;0,001482646;0,000789804;0,001482646;0,002272451
460;AGES;12/07/21;2021;28;All;18-24 anos;14018;7709;1;21728;77567;52324;12;129903;34216;52324;86540;0,099295292;0,06698115;0,043800685;0,06698115;0,110781835
461;AGES;12/07/21;2021;28;All;25-49 anos;207638;315352;30;523020;2040539;1011541;141;3052221;1214877;1011541;2226418;0,61248736;0,303623737;0,364656988;0,303623737;0,668280725
462;AGES;12/07/21;2021;28;All;50-64 anos;15396;134180;11;149587;1788639;1681494;131;3470264;316180;1681494;1997674;0,822672537;0,773391912;0,145424875;0,773391912;0,918816787
463;AGES;12/07/21;2021;28;All;65-79 anos;5489;57658;5;63152;1582379;1490480;131;3072990;132917;1490480;1623397;0,971942646;0,91549564;0,08164144;0,91549564;0,99713708
464;AGES;12/07/21;2021;28;All;80 ou mais anos;2110;3531;2;5643;671789;649112;82;1320983;26887;649112;675999;0,985620388;0,952349653;0,039447468;0,952349653;0,991797121
465;AGES;12/07/21;2021;28;All;Desconhecido;0;2;0;2;5;5;0;10;0;5;5;NA;NA;NA;NA;NA
466;AGES;12/07/21;2021;28;All;NA;0;0;0;0;1;0;0;1;1;0;1;NA;NA;NA;NA;NA
467;AGES;19/07/21;2021;29;All;0-17 anos;245;249;0;494;4088;2772;2;6862;1351;2772;4123;0,002402322;0,001628972;0,000793918;0,001628972;0,00242289
468;AGES;19/07/21;2021;29;All;18-24 anos;19355;19487;0;38842;96922;71811;12;168745;51318;71811;123129;0,124072071;0,091926905;0,065693347;0,091926905;0,157620252
469;AGES;19/07/21;2021;29;All;25-49 anos;103328;342744;19;446091;2143867;1354285;160;3498312;1069010;1354285;2423295;0,64350225;0,406501637;0,320873608;0,406501637;0,727375245
470;AGES;19/07/21;2021;29;All;50-64 anos;10916;114803;16;125735;1799555;1796297;147;3595999;230749;1796297;2027046;0,827693279;0,826194783;0,106131458;0,826194783;0,932326241
471;AGES;19/07/21;2021;29;All;65-79 anos;7152;42515;7;49674;1589531;1532995;138;3122664;100280;1532995;1633275;0,97633561;0,941609574;0,061594857;0,941609574;1
472;AGES;19/07/21;2021;29;All;80 ou mais anos;2200;3080;1;5281;673989;652192;83;1326264;26603;652192;678795;0,988848135;0,956868499;0,039030796;0,956868499;0,995899294
473;AGES;19/07/21;2021;29;All;Desconhecido;0;0;0;0;5;5;0;10;0;5;5;NA;NA;NA;NA;NA
474;AGES;19/07/21;2021;29;All;NA;0;0;0;0;1;0;0;1;1;0;1;NA;NA;NA;NA;NA
475;AGES;26/07/21;2021;30;All;0-17 anos;1607;370;0;1977;5695;3142;2;8839;2597;3142;5739;0,003346679;0,001846403;0,001526133;0,001846403;0,003372536
476;AGES;26/07/21;2021;30;All;18-24 anos;20813;22393;4;43210;117735;94204;16;211955;69100;94204;163304;0,150715269;0,120592697;0,088456492;0,120592697;0,209049189
477;AGES;26/07/21;2021;30;All;25-49 anos;61115;352719;24;413858;2204982;1707004;184;3912170;840444;1707004;2547448;0,661846504;0,512373629;0,252267331;0,512373629;0,76464096
478;AGES;26/07/21;2021;30;All;50-64 anos;9803;87139;16;96958;1809358;1883436;163;3692957;170089;1883436;2053525;0,832202103;0,866273783;0,078231297;0,866273783;0,94450508
479;AGES;26/07/21;2021;30;All;65-79 anos;8619;32330;5;40954;1598150;1565325;143;3163618;78777;1565325;1644102;0,981629647;0,961467589;0,048387097;0,961467589;1
480;AGES;26/07/21;2021;30;All;80 ou mais anos;2582;2876;0;5458;676571;655068;83;1331722;26811;655068;681879;0,992636336;0,961088044;0,039335964;0,961088044;1
481;AGES;26/07/21;2021;30;All;Desconhecido;0;2;0;2;5;7;0;12;-1;7;6;NA;NA;NA;NA;NA
482;AGES;26/07/21;2021;30;All;NA;0;0;0;0;1;0;0;1;1;0;1;NA;NA;NA;NA;NA
483;AGES;02/08/21;2021;31;All;0-17 anos;4577;203;0;4780;10272;3345;2;13619;7002;3345;10347;0,006036363;0,001965696;0,00411474;0,001965696;0,006080437
484;AGES;02/08/21;2021;31;All;18-24 anos;53571;56170;3;109744;171306;150374;19;321699;114385;150374;264759;0,219292732;0,1924972;0,146426857;0,1924972;0,338924057
485;AGES;02/08/21;2021;31;All;25-49 anos;52273;381750;34;434057;2257255;2088754;218;4346227;562701;2088754;2651455;0,677536746;0,626959554;0,168900104;0,626959554;0,795859659
486;AGES;02/08/21;2021;31;All;50-64 anos;8556;53794;12;62362;1817914;1937230;175;3755319;139433;1937230;2076663;0,836137378;0,891015973;0,064131275;0,891015973;0,955147249
487;AGES;02/08/21;2021;31;All;65-79 anos;7579;11694;4;19277;1605729;1577019;147;3182895;76469;1577019;1653488;0,986284887;0,96865038;0,046969457;0,96865038;1
488;AGES;02/08/21;2021;31;All;80 ou mais anos;2452;2122;1;4575;679023;657190;84;1336297;27601;657190;684791;0,996233806;0,964201353;0,040495019;0,964201353;1
489;AGES;02/08/21;2021;31;All;Desconhecido;0;0;0;0;5;7;0;12;-1;7;6;NA;NA;NA;NA;NA
490;AGES;02/08/21;2021;31;All;NA;0;0;0;0;1;0;0;1;1;0;1;NA;NA;NA;NA;NA
491;AGES;09/08/21;2021;32;All;0-17 anos;141951;465;0;142416;152223;3810;2;156035;148617;3810;152427;0,089454171;0,002238955;0,087335097;0,002238955;0,089574052
492;AGES;09/08/21;2021;32;All;18-24 anos;87002;82213;3;169218;258308;232587;22;490917;189058;232587;421645;0,330665984;0,297739943;0,242017474;0,297739943;0,539757417
493;AGES;09/08/21;2021;32;All;25-49 anos;69958;236058;12;306028;2327213;2324812;230;4652255;455495;2324812;2780307;0,698535311;0,697814628;0,136721195;0,697814628;0,834535823
494;AGES;09/08/21;2021;32;All;50-64 anos;7320;24175;1;31496;1825234;1961405;176;3786815;133638;1961405;2095043;0,839504163;0,902135103;0,061465904;0,902135103;0,963601007
495;AGES;09/08/21;2021;32;All;65-79 anos;4574;6252;2;10828;1610303;1583271;149;3193723;76246;1583271;1659517;0,989094369;0,972490538;0,046832484;0,972490538;1
496;AGES;09/08/21;2021;32;All;80 ou mais anos;1570;1723;1;3294;680593;658913;85;1339591;27878;658913;686791;0,998537244;0,966729265;0,040901422;0,966729265;1
497;AGES;09/08/21;2021;32;All;Desconhecido;0;1;0;1;5;8;0;13;-1;8;7;NA;NA;NA;NA;NA
498;AGES;09/08/21;2021;32;All;NA;0;0;0;0;1;0;0;1;1;0;1;NA;NA;NA;NA;NA
499;AGES;16/08/21;2021;33;All;0-17 anos;176953;1583;0;178536;329176;5393;2;334571;324053;5393;329446;0,193440979;0,003169208;0,190430438;0,003169208;0,193599646
500;AGES;16/08/21;2021;33;All;18-24 anos;93658;73867;4;167529;351966;306454;26;658446;264709;306454;571163;0,450559734;0,392298781;0,338860051;0,392298781;0,731158831
501;AGES;16/08/21;2021;33;All;25-49 anos;77496;144313;8;221817;2404709;2469125;238;4874072;432064;2469125;2901189;0,721796479;0,74113156;0,129688155;0,74113156;0,870819715
502;AGES;16/08/21;2021;33;All;50-64 anos;7481;12922;8;20411;1832715;1974327;184;3807226;135690;1974327;2110017;0,842944999;0,90807849;0,062409707;0,90807849;0,970488198
503;AGES;16/08/21;2021;33;All;65-79 anos;3669;2983;4;6656;1613972;1586254;153;3200379;78084;1586254;1664338;0,991347974;0,974322782;0,047961436;0,974322782;1
504;AGES;16/08/21;2021;33;All;80 ou mais anos;1322;1132;1;2455;681915;660045;86;1342046;28380;660045;688425;1,000476826;0,968390088;0,041637935;0,968390088;1
505;AGES;16/08/21;2021;33;All;Desconhecido;0;0;0;0;5;8;0;13;-1;8;7;NA;NA;NA;NA;NA
506;AGES;16/08/21;2021;33;All;NA;0;0;0;0;1;0;0;1;1;0;1;NA;NA;NA;NA;NA
507;GENERAL;04/01/21;2021;1;All;All;48515;64;0;48579;84124;70;0;84194;84063;70;84133;0,008129578;6,76E-06;0,008123684;6,76E-06;0,008130448
508;GENERAL;11/01/21;2021;2;All;All;49701;1176;1;50878;133825;1246;1;135072;132588;1246;133834;0,012932586;0,000120411;0,012813044;0,000120411;0,012933455
509;GENERAL;18/01/21;2021;3;All;All;121898;32658;10;154566;255723;33904;11;289638;221829;33904;255733;0,024712569;0,003276416;0,02143712;0,003276416;0,024713536
510;GENERAL;25/01/21;2021;4;All;All;41658;45633;59;87350;297381;79537;70;376988;217855;79537;297392;0,028738317;0,0076863;0,02105308;0,0076863;0,02873938
511;GENERAL;01/02/21;2021;5;All;All;23858;37486;1;61345;321239;117023;71;438333;204234;117023;321257;0,031043907;0,011308873;0,019736773;0,011308873;0,031045647
512;GENERAL;08/02/21;2021;6;All;All;40771;99216;10;139997;362010;216239;81;578330;145789;216239;362028;0,034983937;0,020896913;0,014088763;0,020896913;0,034985676
513;GENERAL;15/02/21;2021;7;All;All;103403;50137;11;153551;465413;266376;92;731881;199055;266376;465431;0,0449766;0,025742055;0,019236285;0,025742055;0,04497834
514;GENERAL;22/02/21;2021;8;All;All;176870;20622;14;197506;642283;286998;106;929387;355303;286998;642301;0,06206897;0,027734924;0,034335785;0,027734924;0,06207071
515;GENERAL;01/03/21;2021;9;All;All;139024;33523;13;172560;781307;320521;119;1101947;460826;320521;781347;0,075503977;0,030974521;0,044533321;0,030974521;0,075507843
516;GENERAL;08/03/21;2021;10;All;All;95702;51950;9;147661;877009;372471;128;1249608;504615;372471;877086;0,084752431;0,035994867;0,048765005;0,035994867;0,084759872
517;GENERAL;15/03/21;2021;11;All;All;81760;110105;16;191881;958769;482576;144;1441489;476293;482576;958869;0,092653557;0,046635199;0,046028022;0,046635199;0,092663221
518;GENERAL;22/03/21;2021;12;All;All;257012;21720;2;278734;1215781;504296;146;1720223;711607;504296;1215903;0,117490693;0,048734177;0,068768306;0,048734177;0,117502483
519;GENERAL;29/03/21;2021;13;All;All;137689;84604;3;222296;1353470;588900;149;1942519;764740;588900;1353640;0,130796688;0,056910142;0,073902975;0,056910142;0,130813116
520;GENERAL;05/04/21;2021;14;All;All;256645;53363;9;310017;1610115;642263;158;2252536;968138;642263;1610401;0,155598358;0,062067037;0,093558959;0,062067037;0,155625996
521;GENERAL;12/04/21;2021;15;All;All;425594;54395;5;479994;2035709;696658;163;2732530;1339363;696658;2036021;0,196726928;0,067323664;0,129433415;0,067323664;0,196757079
522;GENERAL;19/04/21;2021;16;All;All;211009;139021;10;350040;2246718;835679;173;3082570;1411358;835679;2247037;0,217118424;0,080758381;0,136390871;0,080758381;0,217149251
523;GENERAL;26/04/21;2021;17;All;All;345807;90069;8;435884;2592525;925748;181;3518454;1668440;925748;2594188;0,250536534;0,089462472;0,161234771;0,089462472;0,250697243
524;GENERAL;03/05/21;2021;18;All;All;371102;219244;16;590362;2963627;1144992;197;4108816;1832726;1144992;2977718;0,286399104;0,110649783;0,177111048;0,110649783;0,287760831
525;GENERAL;10/05/21;2021;19;All;All;289363;305204;12;594579;3252990;1450196;209;4703395;1834731;1450196;3284927;0,314362577;0,140144099;0,177304808;0,140144099;0,317448907
526;GENERAL;17/05/21;2021;20;All;All;305585;219822;13;525420;3558575;1670018;222;5228815;1944453;1670018;3614471;0,343893713;0,161387266;0,187908127;0,161387266;0,349295393
527;GENERAL;24/05/21;2021;21;All;All;231898;328691;29;560618;3790473;1998709;251;5789433;1897113;1998709;3895822;0,366303881;0,19315132;0,183333282;0,19315132;0,376484602
528;GENERAL;31/05/21;2021;22;All;All;230039;338117;46;568202;4020512;2336826;297;6357635;1845558;2336826;4182384;0,388534399;0,225826284;0,178351108;0,225826284;0,404177392
529;GENERAL;07/06/21;2021;23;All;All;359515;250239;18;609772;4380027;2587065;315;6967407;1982942;2587065;4570007;0,423277224;0,250008891;0,191627628;0,250008891;0,441636519
530;GENERAL;14/06/21;2021;24;All;All;343029;387818;26;730873;4723056;2974883;341;7698280;1973732;2974883;4948615;0,456426874;0,287486862;0,190737592;0,287486862;0,478224454
531;GENERAL;21/06/21;2021;25;All;All;375750;344766;27;720543;5098806;3319649;368;8418823;2049243;3319649;5368892;0,492738618;0,320804373;0,198034827;0,320804373;0,518839199
532;GENERAL;28/06/21;2021;26;All;All;388688;430605;40;819333;5487494;3750254;408;9238156;2033295;3750254;5783549;0,530300664;0,362417196;0,196493643;0,362417196;0,558910839
533;GENERAL;05/07/21;2021;27;All;All;432368;618487;42;1050897;5919862;4368741;450;10289053;1885119;4368741;6253860;0,57208386;0,422186567;0,182174205;0,422186567;0,604360772
534;GENERAL;12/07/21;2021;28;All;All;244900;518738;49;763687;6164762;4887479;499;11052740;1726422;4887479;6613901;0,595750516;0,472316391;0,166838038;0,472316391;0,639154429
535;GENERAL;19/07/21;2021;29;All;All;143196;522878;43;666117;6307958;5410357;542;11718857;1479312;5410357;6889669;0,609588697;0,522846296;0,142957812;0,522846296;0,665804108
536;GENERAL;26/07/21;2021;30;All;All;104539;497829;49;602417;6412497;5908186;591;12321274;1187818;5908186;7096004;0,619691141;0,570955514;0,114788403;0,570955514;0,685743918
537;GENERAL;02/08/21;2021;31;All;All;129008;505733;54;634795;6541505;6413919;645;12956069;927591;6413919;7341510;0,632158221;0,61982856;0,089640576;0,61982856;0,709469136
538;GENERAL;09/08/21;2021;32;All;All;312375;350887;19;663281;6853880;6764806;664;13619350;1030932;6764806;7795738;0,662345529;0,653737592;0,099627248;0,653737592;0,75336484
539;GENERAL;16/08/21;2021;33;All;All;360579;236800;25;597404;7214459;7001606;689;14216754;1262980;7399577;8264586;0,697191177;0,67662148;0,122051912;0,715080617;0,798673392